C1	3548	3725	BolC1t00001H	0	-	0	0	177	0.0000000
C1	3810	4929	BolC1t00002H	0	+	288	1062	1119	0.9490617
C1	4970	5360	BolC1t00003H	0	+	227	390	390	1.0000000
C1	6190	8277	BolC1t00004H	0	+	517	1552	2087	0.7436512
C1	9619	11251	BolC1t00005H	0	-	55	802	1632	0.4914216
C1	11829	12687	BolC1t00006H	0	+	51	285	858	0.3321678
C1	15536	19052	BolC1t00007H	0	+	181	1456	3516	0.4141069
C1	25727	28608	BolC1t00008H	0	-	0	0	2881	0.0000000
C1	29302	30359	BolC1t00009H	0	+	8	38	1057	0.0359508
C1	30778	30913	BolC1t00010H	0	-	0	0	135	0.0000000
C1	33422	35705	BolC1t00011H	0	-	0	0	2283	0.0000000
C1	37066	38059	BolC1t00012H	0	-	49	850	993	0.8559920
C1	45691	49329	BolC1t00013H	0	+	504	2395	3638	0.6583288
C1	49563	50153	BolC1t00014H	0	-	103	579	590	0.9813559
C1	51642	52725	BolC1t00015H	0	-	123	881	1083	0.8134811
C1	84365	84947	BolC1t00016H	0	-	36	359	582	0.6168385
C1	88008	89100	BolC1t00017H	0	-	150	980	1092	0.8974359
C1	94170	94614	BolC1t00018H	0	-	0	0	444	0.0000000
C1	98004	98277	BolC1t00019H	0	-	0	0	273	0.0000000
C1	103459	103777	BolC1t00020H	0	+	4	197	318	0.6194969
C1	114419	116024	BolC1t00021H	0	+	216	1039	1605	0.6473520
C1	116271	119220	BolC1t00022H	0	-	1427	2486	2949	0.8429976
C1	120140	121068	BolC1t00023H	0	-	143	731	928	0.7877155
C1	121867	122786	BolC1t00024H	0	+	339	919	919	1.0000000
C1	123368	127153	BolC1t00025H	0	-	1646	3635	3785	0.9603699
C1	129944	131990	BolC1t00026H	0	-	381	1589	2046	0.7766373
C1	134252	135406	BolC1t00027H	0	+	347	1154	1154	1.0000000
C1	136442	139704	BolC1t00028H	0	-	994	3109	3262	0.9530963
C1	141028	141202	BolC1t00029H	0	-	34	174	174	1.0000000
C1	143354	146278	BolC1t00030H	0	-	714	2555	2924	0.8738030
C1	153990	156971	BolC1t00031H	0	+	1066	2758	2981	0.9251929
C1	163747	165786	BolC1t00032H	0	+	7	98	2039	0.0480628
C1	165867	167109	BolC1t00033H	0	+	0	0	1242	0.0000000
C1	167321	168050	BolC1t00034H	0	+	160	729	729	1.0000000
C1	168749	170036	BolC1t00035H	0	-	450	1007	1287	0.7824398
C1	173576	178340	BolC1t00036H	0	+	1589	4024	4764	0.8446683
C1	178748	178922	BolC1t00037H	0	+	168	174	174	1.0000000
C1	179266	180580	BolC1t00038H	0	-	459	1296	1314	0.9863014
C1	181402	181844	BolC1t00039H	0	-	8	155	442	0.3506787
C1	182918	185534	BolC1t00040H	0	-	128	2191	2616	0.8375382
C1	185965	186451	BolC1t00041H	0	-	275	486	486	1.0000000
C1	187493	188040	BolC1t00042H	0	-	600	547	547	1.0000000
C1	188822	190377	BolC1t00043H	0	-	1281	1555	1555	1.0000000
C1	191587	193491	BolC1t00044H	0	-	1729	1904	1904	1.0000000
C1	197132	198038	BolC1t00045H	0	+	482	906	906	1.0000000
C1	198370	198800	BolC1t00046H	0	-	391	430	430	1.0000000
C1	201326	202115	BolC1t00047H	0	-	186	722	789	0.9150824
C1	202709	203341	BolC1t00048H	0	+	361	632	632	1.0000000
C1	204881	206192	BolC1t00049H	0	+	667	1246	1311	0.9504195
C1	206416	206812	BolC1t00050H	0	-	174	396	396	1.0000000
C1	211436	216209	BolC1t00051H	0	+	1076	4303	4773	0.9015294
C1	218169	218538	BolC1t00052H	0	+	118	369	369	1.0000000
C1	221294	223905	BolC1t00053H	0	+	1473	2467	2611	0.9448487
C1	231750	235335	BolC1t00054H	0	+	832	3108	3585	0.8669456
C1	265706	267936	BolC1t00055H	0	-	1108	2142	2230	0.9605381
C1	276157	291023	BolC1t00056H	0	+	2080	8433	14866	0.5672676
C1	291895	296027	BolC1t00057H	0	-	1626	3342	4132	0.8088093
C1	296799	299557	BolC1t00058H	0	-	1232	2758	2758	1.0000000
C1	299866	305565	BolC1t00059H	0	+	2434	5671	5699	0.9950868
C1	305780	308716	BolC1t00060H	0	-	1511	2936	2936	1.0000000
C1	309638	310796	BolC1t00061H	0	-	719	1158	1158	1.0000000
C1	312130	312538	BolC1t00062H	0	-	268	408	408	1.0000000
C1	314196	315378	BolC1t00063H	0	-	615	1182	1182	1.0000000
C1	317181	318429	BolC1t00064H	0	-	283	1171	1248	0.9383013
C1	320336	323993	BolC1t00065H	0	-	1487	3327	3657	0.9097621
C1	322225	327427	BolC1t00066H	0	+	2059	4326	5202	0.8316032
C1	328646	332814	BolC1t00067H	0	+	484	2472	4168	0.5930902
C1	333721	334626	BolC1t00068H	0	+	561	501	905	0.5535911
C1	337905	338025	BolC1t00069H	0	+	66	120	120	1.0000000
C1	339194	345951	BolC1t00070H	0	+	1843	6259	6757	0.9262987
C1	348225	350572	BolC1t00071H	0	+	1027	2282	2347	0.9723051
C1	355523	355739	BolC1t00072H	0	+	5	42	216	0.1944444
C1	356263	358175	BolC1t00073H	0	-	295	1873	1912	0.9796025
C1	359522	360048	BolC1t00074H	0	+	484	526	526	1.0000000
C1	361984	362738	BolC1t00075H	0	+	12	234	754	0.3103448
C1	364302	367353	BolC1t00076H	0	-	1548	2951	3051	0.9672239
C1	369445	370327	BolC1t00077H	0	-	362	868	882	0.9841270
C1	388971	390314	BolC1t00078H	0	-	223	1246	1343	0.9277737
C1	390626	391721	BolC1t00079H	0	+	262	893	1095	0.8155251
C1	397462	399399	BolC1t00080H	0	-	97	1033	1937	0.5332989
C1	423977	424808	BolC1t00081H	0	-	134	749	831	0.9013237
C1	429174	431646	BolC1t00082H	0	-	782	2312	2472	0.9352751
C1	435939	436639	BolC1t00083H	0	+	44	414	700	0.5914286
C1	438683	441221	BolC1t00084H	0	-	972	2431	2538	0.9578408
C1	444235	445393	BolC1t00085H	0	-	460	1146	1158	0.9896373
C1	446346	446460	BolC1t00086H	0	-	254	114	114	1.0000000
C1	450223	451606	BolC1t00087H	0	+	51	675	1383	0.4880694
C1	452736	454265	BolC1t00088H	0	+	978	1527	1529	0.9986920
C1	455074	456788	BolC1t00089H	0	+	1249	1714	1714	1.0000000
C1	457457	458000	BolC1t00090H	0	+	245	543	543	1.0000000
C1	459078	461858	BolC1t00091H	0	-	1984	2780	2780	1.0000000
C1	463406	465433	BolC1t00092H	0	-	1131	1978	2027	0.9758263
C1	466587	468390	BolC1t00093H	0	+	1337	1803	1803	1.0000000
C1	475400	477273	BolC1t00094H	0	+	243	1585	1873	0.8462360
C1	478799	481145	BolC1t00095H	0	+	861	2299	2346	0.9799659
C1	481858	481978	BolC1t00096H	0	+	251	120	120	1.0000000
C1	485491	485824	BolC1t00097H	0	+	236	260	333	0.7807808
C1	487976	489871	BolC1t00098H	0	+	1124	1895	1895	1.0000000
C1	491585	492350	BolC1t00099H	0	+	384	752	765	0.9830065
C1	493045	494723	BolC1t00100H	0	+	583	1558	1678	0.9284863
C1	495385	495726	BolC1t00101H	0	+	304	341	341	1.0000000
C1	504597	507853	BolC1t00102H	0	-	1931	3181	3256	0.9769656
C1	509041	511514	BolC1t00103H	0	-	994	2304	2473	0.9316620
C1	513426	515190	BolC1t00104H	0	-	167	1570	1764	0.8900227
C1	516113	516809	BolC1t00105H	0	-	533	696	696	1.0000000
C1	517676	517952	BolC1t00106H	0	+	56	276	276	1.0000000
C1	518253	518652	BolC1t00107H	0	-	536	399	399	1.0000000
C1	519507	521984	BolC1t00108H	0	-	404	2432	2477	0.9818329
C1	525081	525357	BolC1t00109H	0	+	238	276	276	1.0000000
C1	534479	535599	BolC1t00110H	0	-	161	886	1120	0.7910714
C1	538194	539422	BolC1t00111H	0	+	472	1139	1228	0.9275244
C1	539996	540428	BolC1t00112H	0	-	24	210	432	0.4861111
C1	544939	545497	BolC1t00113H	0	+	22	448	558	0.8028674
C1	547362	550444	BolC1t00114H	0	+	1023	2620	3082	0.8500974
C1	550706	552285	BolC1t00115H	0	-	262	1545	1579	0.9784674
C1	556777	560308	BolC1t00116H	0	+	543	2504	3531	0.7091476
C1	560639	562047	BolC1t00117H	0	-	271	1315	1408	0.9339489
C1	563812	564541	BolC1t00118H	0	-	306	729	729	1.0000000
C1	570706	572194	BolC1t00119H	0	-	220	1092	1488	0.7338710
C1	574262	577264	BolC1t00120H	0	-	1862	2949	3002	0.9823451
C1	578312	579671	BolC1t00121H	0	-	969	1359	1359	1.0000000
C1	603332	606363	BolC1t00122H	0	+	2771	3012	3031	0.9937314
C1	606964	609726	BolC1t00123H	0	+	1358	2738	2762	0.9913107
C1	610283	612159	BolC1t00124H	0	+	876	1869	1876	0.9962686
C1	612396	614835	BolC1t00125H	0	+	439	2277	2439	0.9335793
C1	615367	616513	BolC1t00126H	0	-	179	1088	1146	0.9493892
C1	620425	620578	BolC1t00127H	0	-	95	153	153	1.0000000
C1	624392	627535	BolC1t00128H	0	+	619	2944	3143	0.9366847
C1	628426	629858	BolC1t00129H	0	+	1799	1432	1432	1.0000000
C1	629946	630733	BolC1t00130H	0	+	1181	787	787	1.0000000
C1	635744	637030	BolC1t00131H	0	+	1298	1286	1286	1.0000000
C1	642901	643306	BolC1t00132H	0	-	13	188	405	0.4641975
C1	645607	647882	BolC1t00133H	0	+	1002	1994	2275	0.8764835
C1	648564	649172	BolC1t00134H	0	+	807	608	608	1.0000000
C1	651652	653246	BolC1t00135H	0	+	743	1594	1594	1.0000000
C1	662834	663362	BolC1t00136H	0	-	91	528	528	1.0000000
C1	667618	667861	BolC1t00137H	0	+	386	243	243	1.0000000
C1	684402	685437	BolC1t00138H	0	-	82	872	1035	0.8425121
C1	697687	699033	BolC1t00139H	0	-	572	1338	1346	0.9940565
C1	703822	706176	BolC1t00140H	0	+	312	1277	2354	0.5424809
C1	712243	714013	BolC1t00141H	0	-	284	1060	1770	0.5988700
C1	723054	725344	BolC1t00142H	0	-	1360	2082	2290	0.9091703
C1	727335	729766	BolC1t00143H	0	-	950	2224	2431	0.9148499
C1	745888	747661	BolC1t00144H	0	+	647	1564	1773	0.8821207
C1	748980	749724	BolC1t00145H	0	-	37	547	744	0.7352151
C1	754050	755808	BolC1t00146H	0	-	768	1658	1758	0.9431172
C1	757420	759867	BolC1t00147H	0	+	949	2447	2447	1.0000000
C1	759991	760483	BolC1t00148H	0	-	242	492	492	1.0000000
C1	763065	764667	BolC1t00149H	0	-	17	110	1602	0.0686642
C1	770850	772273	BolC1t00150H	0	+	260	1109	1423	0.7793394
C1	786178	787790	BolC1t00151H	0	-	737	1510	1612	0.9367245
C1	804716	807044	BolC1t00152H	0	-	1634	2328	2328	1.0000000
C1	807437	809487	BolC1t00153H	0	-	515	2002	2050	0.9765854
C1	813347	814139	BolC1t00154H	0	+	368	792	792	1.0000000
C1	819658	820990	BolC1t00155H	0	-	1588	1332	1332	1.0000000
C1	822504	823902	BolC1t00156H	0	-	733	1398	1398	1.0000000
C1	828197	832858	BolC1t00157H	0	+	2119	4574	4661	0.9813344
C1	833116	833417	BolC1t00158H	0	-	95	212	301	0.7043189
C1	835773	841821	BolC1t00159H	0	+	3608	5764	6048	0.9530423
C1	843619	844322	BolC1t00160H	0	+	154	684	703	0.9729730
C1	846599	847436	BolC1t00161H	0	+	337	816	837	0.9749104
C1	847983	849387	BolC1t00162H	0	-	355	1284	1404	0.9145299
C1	853151	854640	BolC1t00163H	0	+	157	1103	1489	0.7407656
C1	855016	856848	BolC1t00164H	0	-	205	1440	1832	0.7860262
C1	862300	864207	BolC1t00165H	0	-	99	1207	1907	0.6329313
C1	867241	868960	BolC1t00166H	0	-	313	1364	1719	0.7934846
C1	873251	877011	BolC1t00167H	0	-	2873	3592	3760	0.9553192
C1	879574	881292	BolC1t00168H	0	-	253	1077	1718	0.6268917
C1	897430	899748	BolC1t00169H	0	-	506	1951	2318	0.8416739
C1	902198	911701	BolC1t00170H	0	-	14760	7387	9503	0.7773335
C1	911753	913877	BolC1t00171H	0	-	197	1861	2124	0.8761770
C1	932788	935509	BolC1t00172H	0	+	1015	1674	2721	0.6152150
C1	936941	939175	BolC1t00173H	0	+	710	1981	2234	0.8867502
C1	942212	945552	BolC1t00174H	0	+	2153	3211	3340	0.9613773
C1	947105	947797	BolC1t00175H	0	-	60	504	692	0.7283237
C1	948717	948978	BolC1t00176H	0	-	66	248	261	0.9501916
C1	952957	953215	BolC1t00177H	0	+	33	197	258	0.7635659
C1	953802	956205	BolC1t00178H	0	+	1266	2313	2403	0.9625468
C1	956604	960585	BolC1t00179H	0	+	804	3167	3981	0.7955288
C1	960986	961964	BolC1t00180H	0	-	140	823	978	0.8415133
C1	987491	989835	BolC1t00181H	0	+	274	1982	2344	0.8455631
C1	990479	992353	BolC1t00182H	0	-	325	1443	1874	0.7700107
C1	999330	1001540	BolC1t00183H	0	-	1685	2058	2210	0.9312217
C1	1010885	1011479	BolC1t00184H	0	+	270	582	594	0.9797980
C1	1015289	1015501	BolC1t00185H	0	-	354	212	212	1.0000000
C1	1024974	1027112	BolC1t00186H	0	+	513	1853	2138	0.8666978
C1	1031100	1031346	BolC1t00187H	0	+	146	246	246	1.0000000
C1	1040075	1041822	BolC1t00188H	0	+	718	1715	1747	0.9816829
C1	1043271	1044333	BolC1t00189H	0	-	414	1062	1062	1.0000000
C1	1047075	1048318	BolC1t00190H	0	+	134	196	1243	0.1576830
C1	1055038	1055925	BolC1t00191H	0	+	713	397	887	0.4475761
C1	1056594	1058168	BolC1t00192H	0	-	874	1574	1574	1.0000000
C1	1060376	1063435	BolC1t00193H	0	-	3105	2954	3059	0.9656751
C1	1071145	1072133	BolC1t00194H	0	+	428	988	988	1.0000000
C1	1073343	1076027	BolC1t00195H	0	+	841	2103	2684	0.7835320
C1	1082215	1083938	BolC1t00196H	0	+	988	1723	1723	1.0000000
C1	1084128	1086513	BolC1t00197H	0	-	945	2384	2385	0.9995807
C1	1091835	1097745	BolC1t00198H	0	-	2161	5540	5910	0.9373943
C1	1105085	1107614	BolC1t00199H	0	+	1336	2529	2529	1.0000000
C1	1108254	1109329	BolC1t00200H	0	+	770	1075	1075	1.0000000
C1	1109699	1112234	BolC1t00201H	0	-	718	2449	2535	0.9660749
C1	1114518	1116129	BolC1t00202H	0	-	501	1583	1611	0.9826195
C1	1118861	1120728	BolC1t00203H	0	+	1132	1867	1867	1.0000000
C1	1122953	1124922	BolC1t00204H	0	+	522	1811	1969	0.9197562
C1	1125294	1126400	BolC1t00205H	0	-	236	921	1106	0.8327305
C1	1128232	1130451	BolC1t00206H	0	-	762	2142	2219	0.9652997
C1	1132255	1134313	BolC1t00207H	0	-	1006	2058	2058	1.0000000
C1	1138794	1140106	BolC1t00208H	0	+	1009	1312	1312	1.0000000
C1	1141622	1142039	BolC1t00209H	0	+	333	417	417	1.0000000
C1	1142155	1143587	BolC1t00210H	0	-	408	1168	1432	0.8156425
C1	1144983	1146689	BolC1t00211H	0	+	1377	1702	1706	0.9976553
C1	1147318	1148741	BolC1t00212H	0	+	487	1163	1423	0.8172874
C1	1155739	1156276	BolC1t00213H	0	+	336	537	537	1.0000000
C1	1159958	1162127	BolC1t00214H	0	+	971	2085	2169	0.9612725
C1	1162356	1166782	BolC1t00215H	0	-	1560	4006	4426	0.9051062
C1	1173836	1179688	BolC1t00216H	0	+	2254	5665	5852	0.9680451
C1	1182579	1185538	BolC1t00217H	0	+	2893	2959	2959	1.0000000
C1	1186230	1187330	BolC1t00218H	0	-	202	990	1100	0.9000000
C1	1190004	1191117	BolC1t00219H	0	-	791	1107	1113	0.9946092
C1	1194137	1196178	BolC1t00220H	0	-	854	2036	2041	0.9975502
C1	1198610	1198712	BolC1t00221H	0	+	13	91	102	0.8921568
C1	1201904	1203293	BolC1t00222H	0	+	408	1294	1389	0.9316055
C1	1204736	1205443	BolC1t00223H	0	+	772	707	707	1.0000000
C1	1205554	1208938	BolC1t00224H	0	-	2308	3384	3384	1.0000000
C1	1209294	1220158	BolC1t00225H	0	-	3012	6606	10864	0.6080633
C1	1210550	1211725	BolC1t00226H	0	+	293	1015	1175	0.8638298
C1	1230829	1232608	BolC1t00227H	0	+	513	1584	1779	0.8903878
C1	1241973	1243683	BolC1t00228H	0	+	1166	1710	1710	1.0000000
C1	1244992	1246462	BolC1t00229H	0	-	386	1438	1470	0.9782313
C1	1250205	1250415	BolC1t00230H	0	-	10	160	210	0.7619048
C1	1250474	1250893	BolC1t00231H	0	-	18	300	419	0.7159904
C1	1255697	1257249	BolC1t00232H	0	+	730	1445	1552	0.9310567
C1	1258939	1260931	BolC1t00233H	0	+	999	1947	1992	0.9774097
C1	1264782	1266723	BolC1t00234H	0	+	532	1838	1941	0.9469346
C1	1286711	1287930	BolC1t00235H	0	+	90	732	1219	0.6004922
C1	1288529	1289427	BolC1t00236H	0	+	535	898	898	1.0000000
C1	1296936	1297914	BolC1t00237H	0	+	5	144	978	0.1472393
C1	1302576	1304828	BolC1t00238H	0	+	1531	2214	2252	0.9831261
C1	1306508	1308293	BolC1t00239H	0	+	657	1462	1785	0.8190476
C1	1308399	1311133	BolC1t00240H	0	-	669	2396	2734	0.8763716
C1	1314405	1314645	BolC1t00241H	0	-	31	222	240	0.9250000
C1	1322747	1325291	BolC1t00242H	0	+	594	2400	2544	0.9433962
C1	1327726	1328979	BolC1t00243H	0	+	903	1253	1253	1.0000000
C1	1334323	1338439	BolC1t00244H	0	+	1724	3965	4116	0.9633139
C1	1338784	1339156	BolC1t00245H	0	+	40	256	372	0.6881720
C1	1340449	1340821	BolC1t00246H	0	+	12	77	372	0.2069892
C1	1341354	1342798	BolC1t00247H	0	-	85	1033	1444	0.7153739
C1	1346375	1347563	BolC1t00248H	0	+	658	1188	1188	1.0000000
C1	1348702	1359393	BolC1t00249H	0	+	4838	10367	10691	0.9696941
C1	1354151	1356793	BolC1t00250H	0	+	1639	2640	2642	0.9992430
C1	1365233	1366138	BolC1t00251H	0	-	289	886	905	0.9790055
C1	1368635	1372105	BolC1t00252H	0	+	783	3305	3470	0.9524496
C1	1377145	1381673	BolC1t00253H	0	+	612	2966	4528	0.6550353
C1	1385267	1385825	BolC1t00254H	0	-	11	231	558	0.4139785
C1	1386626	1386797	BolC1t00255H	0	+	0	0	171	0.0000000
C1	1391473	1395549	BolC1t00256H	0	+	2116	4043	4076	0.9919038
C1	1397843	1405506	BolC1t00257H	0	+	1699	6543	7663	0.8538432
C1	1420956	1422379	BolC1t00258H	0	+	678	1415	1423	0.9943781
C1	1425773	1427040	BolC1t00259H	0	-	551	1267	1267	1.0000000
C1	1434399	1435243	BolC1t00260H	0	+	431	844	844	1.0000000
C1	1435707	1436502	BolC1t00261H	0	-	1375	795	795	1.0000000
C1	1444312	1446737	BolC1t00262H	0	+	483	1971	2425	0.8127835
C1	1452137	1455837	BolC1t00263H	0	-	1198	3591	3700	0.9705405
C1	1456688	1459059	BolC1t00264H	0	-	1445	2371	2371	1.0000000
C1	1459422	1463208	BolC1t00265H	0	+	960	3481	3786	0.9194400
C1	1474227	1476214	BolC1t00266H	0	+	422	1791	1987	0.9013588
C1	1486416	1487655	BolC1t00267H	0	-	948	1239	1239	1.0000000
C1	1489035	1489447	BolC1t00268H	0	+	448	412	412	1.0000000
C1	1490597	1490825	BolC1t00269H	0	-	277	228	228	1.0000000
C1	1497636	1499079	BolC1t00270H	0	+	8	153	1443	0.1060291
C1	1507241	1509214	BolC1t00271H	0	-	411	977	1973	0.4951850
C1	1514675	1515523	BolC1t00272H	0	+	0	0	848	0.0000000
C1	1516775	1517132	BolC1t00273H	0	-	91	295	357	0.8263305
C1	1518500	1518758	BolC1t00274H	0	-	30	237	258	0.9186047
C1	1524564	1525545	BolC1t00275H	0	+	188	745	981	0.7594292
C1	1526514	1527822	BolC1t00276H	0	-	325	1244	1308	0.9510703
C1	1529312	1532744	BolC1t00277H	0	+	1349	3236	3432	0.9428905
C1	1535424	1535739	BolC1t00278H	0	-	8	118	315	0.3746032
C1	1541979	1543193	BolC1t00279H	0	-	455	1140	1214	0.9390445
C1	1544176	1545264	BolC1t00280H	0	+	805	1088	1088	1.0000000
C1	1548952	1549470	BolC1t00281H	0	+	22	338	518	0.6525096
C1	1551022	1567597	BolC1t00282H	0	+	1028	7108	16575	0.4288386
C1	1567889	1569006	BolC1t00283H	0	-	848	1117	1117	1.0000000
C1	1569360	1571897	BolC1t00284H	0	+	1872	2488	2537	0.9806858
C1	1576579	1577068	BolC1t00285H	0	+	294	489	489	1.0000000
C1	1579740	1580583	BolC1t00286H	0	+	522	843	843	1.0000000
C1	1586151	1587612	BolC1t00287H	0	+	610	1461	1461	1.0000000
C1	1588534	1590027	BolC1t00288H	0	-	604	1403	1493	0.9397187
C1	1593478	1593935	BolC1t00289H	0	+	217	350	457	0.7658643
C1	1594304	1595823	BolC1t00290H	0	-	1091	1519	1519	1.0000000
C1	1598304	1599749	BolC1t00291H	0	+	1154	1445	1445	1.0000000
C1	1600181	1601525	BolC1t00292H	0	-	1142	1344	1344	1.0000000
C1	1607937	1610451	BolC1t00293H	0	+	820	1969	2514	0.7832140
C1	1614448	1614688	BolC1t00294H	0	+	41	161	240	0.6708333
C1	1614740	1615129	BolC1t00295H	0	-	212	389	389	1.0000000
C1	1630639	1631157	BolC1t00296H	0	+	425	518	518	1.0000000
C1	1633957	1634185	BolC1t00297H	0	+	308	228	228	1.0000000
C1	1634905	1635286	BolC1t00298H	0	-	395	381	381	1.0000000
C1	1649250	1650128	BolC1t00299H	0	-	548	878	878	1.0000000
C1	1654364	1657297	BolC1t00300H	0	-	2831	2731	2933	0.9311286
C1	1658695	1661073	BolC1t00301H	0	-	950	2176	2378	0.9150547
C1	1662931	1663483	BolC1t00302H	0	-	71	552	552	1.0000000
C1	1664921	1666374	BolC1t00303H	0	+	765	1395	1453	0.9600826
C1	1666786	1669662	BolC1t00304H	0	-	1231	2840	2876	0.9874826
C1	1671094	1672229	BolC1t00305H	0	-	378	1117	1135	0.9841410
C1	1686493	1690972	BolC1t00306H	0	+	2371	4446	4479	0.9926323
C1	1691269	1692502	BolC1t00307H	0	-	775	1192	1233	0.9667478
C1	1694719	1695198	BolC1t00308H	0	-	120	479	479	1.0000000
C1	1696466	1698230	BolC1t00309H	0	-	415	1642	1764	0.9308390
C1	1698732	1700351	BolC1t00310H	0	-	712	1619	1619	1.0000000
C1	1709664	1712680	BolC1t00311H	0	+	809	3011	3016	0.9983422
C1	1716514	1718852	BolC1t00312H	0	+	1578	2208	2338	0.9443969
C1	1719270	1719459	BolC1t00313H	0	-	246	189	189	1.0000000
C1	1724981	1725848	BolC1t00314H	0	-	359	867	867	1.0000000
C1	1726208	1727974	BolC1t00315H	0	+	799	1738	1766	0.9841450
C1	1728879	1729667	BolC1t00316H	0	+	246	788	788	1.0000000
C1	1730734	1732626	BolC1t00317H	0	-	607	1857	1892	0.9815010
C1	1734045	1734691	BolC1t00318H	0	-	404	646	646	1.0000000
C1	1737493	1738249	BolC1t00319H	0	-	211	722	756	0.9550264
C1	1739139	1739982	BolC1t00320H	0	-	149	833	843	0.9881376
C1	1742557	1743457	BolC1t00321H	0	-	438	900	900	1.0000000
C1	1764029	1764803	BolC1t00322H	0	+	424	774	774	1.0000000
C1	1765464	1767971	BolC1t00323H	0	-	1529	2457	2507	0.9800559
C1	1769387	1771343	BolC1t00324H	0	-	1057	1818	1956	0.9294478
C1	1773400	1773586	BolC1t00325H	0	+	347	186	186	1.0000000
C1	1775046	1775238	BolC1t00326H	0	+	34	192	192	1.0000000
C1	1776401	1777204	BolC1t00327H	0	+	385	803	803	1.0000000
C1	1781863	1783439	BolC1t00328H	0	+	1055	1576	1576	1.0000000
C1	1783657	1785052	BolC1t00329H	0	-	340	1237	1395	0.8867384
C1	1786207	1787496	BolC1t00330H	0	+	1511	1289	1289	1.0000000
C1	1791149	1791857	BolC1t00331H	0	+	655	708	708	1.0000000
C1	1794826	1796612	BolC1t00332H	0	-	818	1651	1786	0.9244121
C1	1801556	1802141	BolC1t00333H	0	+	149	510	585	0.8717949
C1	1806169	1808448	BolC1t00334H	0	-	677	1946	2279	0.8538833
C1	1811117	1812792	BolC1t00335H	0	-	770	1675	1675	1.0000000
C1	1813345	1816705	BolC1t00336H	0	+	1200	3360	3360	1.0000000
C1	1817244	1817592	BolC1t00337H	0	+	232	348	348	1.0000000
C1	1818099	1818504	BolC1t00338H	0	+	277	405	405	1.0000000
C1	1818667	1820387	BolC1t00339H	0	-	526	1617	1720	0.9401163
C1	1821329	1822169	BolC1t00340H	0	-	233	840	840	1.0000000
C1	1825410	1826319	BolC1t00341H	0	-	31	313	909	0.3443344
C1	1834808	1841436	BolC1t00342H	0	-	609	4493	6628	0.6778817
C1	1845467	1847950	BolC1t00343H	0	-	1414	2209	2483	0.8896496
C1	1848815	1850973	BolC1t00344H	0	+	653	2103	2158	0.9745134
C1	1851281	1852647	BolC1t00345H	0	-	238	1237	1366	0.9055637
C1	1852985	1853527	BolC1t00346H	0	-	318	542	542	1.0000000
C1	1853743	1855316	BolC1t00347H	0	-	404	1413	1573	0.8982835
C1	1856336	1856762	BolC1t00348H	0	+	105	379	426	0.8896714
C1	1859257	1861882	BolC1t00349H	0	-	1179	2576	2625	0.9813333
C1	1866684	1869630	BolC1t00350H	0	+	376	2488	2946	0.8445349
C1	1870363	1874123	BolC1t00351H	0	-	481	3094	3760	0.8228723
C1	1876219	1878523	BolC1t00352H	0	+	1439	2304	2304	1.0000000
C1	1878880	1879747	BolC1t00353H	0	+	257	824	867	0.9504037
C1	1887032	1891026	BolC1t00354H	0	+	1176	3480	3994	0.8713070
C1	1893538	1896246	BolC1t00355H	0	+	1338	2708	2708	1.0000000
C1	1896718	1899162	BolC1t00356H	0	-	1161	2444	2444	1.0000000
C1	1915214	1918104	BolC1t00357H	0	+	1231	2691	2890	0.9311419
C1	1920274	1922974	BolC1t00358H	0	+	1231	2700	2700	1.0000000
C1	1924255	1924824	BolC1t00359H	0	-	174	555	569	0.9753954
C1	1925149	1926401	BolC1t00360H	0	-	644	1196	1252	0.9552715
C1	1926898	1928162	BolC1t00361H	0	-	208	852	1264	0.6740506
C1	1935357	1937238	BolC1t00362H	0	+	395	1735	1881	0.9223817
C1	1938035	1940102	BolC1t00363H	0	+	837	2030	2067	0.9820997
C1	1940853	1943253	BolC1t00364H	0	+	1316	2400	2400	1.0000000
C1	1943453	1952908	BolC1t00365H	0	-	2985	7328	9455	0.7750397
C1	1944583	1955245	BolC1t00366H	0	-	3807	8535	10662	0.8005065
C1	1957305	1958522	BolC1t00367H	0	+	169	1036	1217	0.8512736
C1	1960455	1961799	BolC1t00368H	0	-	1104	1220	1344	0.9077381
C1	1970391	1973274	BolC1t00369H	0	+	521	2589	2883	0.8980229
C1	1974221	1975805	BolC1t00370H	0	-	874	1548	1584	0.9772727
C1	1980102	1980792	BolC1t00371H	0	-	225	661	690	0.9579710
C1	2002221	2002763	BolC1t00372H	0	+	311	540	542	0.9963099
C1	2006090	2006983	BolC1t00373H	0	-	395	884	893	0.9899216
C1	2014195	2016007	BolC1t00374H	0	-	1032	1755	1812	0.9685431
C1	2024513	2026011	BolC1t00375H	0	-	1303	1498	1498	1.0000000
C1	2030215	2034188	BolC1t00376H	0	+	1160	3478	3973	0.8754090
C1	2037570	2038560	BolC1t00377H	0	+	540	990	990	1.0000000
C1	2041723	2042234	BolC1t00378H	0	-	1	63	511	0.1232877
C1	2051545	2053077	BolC1t00379H	0	-	1049	1484	1532	0.9686684
C1	2060692	2063061	BolC1t00380H	0	+	134	1825	2369	0.7703673
C1	2063889	2065884	BolC1t00381H	0	-	284	1921	1995	0.9629073
C1	2067234	2068101	BolC1t00382H	0	-	0	0	867	0.0000000
C1	2069045	2072053	BolC1t00383H	0	-	1260	2801	3008	0.9311835
C1	2073017	2079300	BolC1t00384H	0	+	1860	5663	6283	0.9013211
C1	2079378	2081541	BolC1t00385H	0	-	869	2038	2163	0.9422099
C1	2083382	2083901	BolC1t00386H	0	-	67	477	519	0.9190751
C1	2087436	2090712	BolC1t00387H	0	+	1526	3243	3276	0.9899268
C1	2090948	2092309	BolC1t00388H	0	-	242	1174	1361	0.8626010
C1	2093278	2099058	BolC1t00389H	0	+	1456	5505	5780	0.9524221
C1	2099526	2099841	BolC1t00390H	0	-	214	311	315	0.9873016
C1	2101830	2102109	BolC1t00391H	0	-	41	218	279	0.7813620
C1	2104017	2104335	BolC1t00392H	0	-	49	318	318	1.0000000
C1	2120481	2120796	BolC1t00393H	0	-	31	249	315	0.7904762
C1	2132569	2132869	BolC1t00394H	0	+	0	0	300	0.0000000
C1	2157958	2158282	BolC1t00395H	0	+	23	192	324	0.5925926
C1	2165124	2165553	BolC1t00396H	0	-	174	429	429	1.0000000
C1	2167177	2171865	BolC1t00397H	0	+	2999	4604	4688	0.9820819
C1	2180102	2181321	BolC1t00398H	0	-	213	833	1219	0.6833470
C1	2190048	2201705	BolC1t00399H	0	+	2334	9357	11657	0.8026937
C1	2202350	2203178	BolC1t00400H	0	-	431	828	828	1.0000000
C1	2204398	2205300	BolC1t00401H	0	-	48	621	902	0.6884701
C1	2210784	2211978	BolC1t00402H	0	-	680	1194	1194	1.0000000
C1	2212579	2215149	BolC1t00403H	0	+	1607	2535	2570	0.9863814
C1	2215779	2222813	BolC1t00404H	0	-	5209	7034	7034	1.0000000
C1	2223769	2224399	BolC1t00405H	0	+	262	629	630	0.9984127
C1	2225443	2226270	BolC1t00406H	0	+	752	827	827	1.0000000
C1	2228486	2229024	BolC1t00407H	0	-	63	461	538	0.8568773
C1	2237085	2237550	BolC1t00408H	0	-	2	71	465	0.1526882
C1	2252817	2255997	BolC1t00409H	0	-	868	2704	3180	0.8503144
C1	2261172	2264036	BolC1t00410H	0	+	2878	2864	2864	1.0000000
C1	2266781	2267423	BolC1t00411H	0	-	215	642	642	1.0000000
C1	2271787	2273060	BolC1t00412H	0	-	706	1260	1273	0.9897879
C1	2274892	2275859	BolC1t00413H	0	-	1	41	967	0.0423992
C1	2275968	2276181	BolC1t00414H	0	+	0	0	213	0.0000000
C1	2277462	2278915	BolC1t00415H	0	-	385	1247	1453	0.8582244
C1	2283245	2286027	BolC1t00416H	0	+	1006	2655	2782	0.9543494
C1	2286652	2289489	BolC1t00417H	0	+	1341	2662	2837	0.9383151
C1	2291477	2294559	BolC1t00418H	0	+	911	2934	3082	0.9519792
C1	2299128	2301093	BolC1t00419H	0	+	1068	1965	1965	1.0000000
C1	2301891	2306486	BolC1t00420H	0	-	1981	3914	4595	0.8517954
C1	2307232	2318280	BolC1t00421H	0	-	3951	10136	11048	0.9174511
C1	2320542	2321340	BolC1t00422H	0	+	251	790	798	0.9899749
C1	2329701	2331136	BolC1t00423H	0	+	831	1264	1435	0.8808362
C1	2331470	2332298	BolC1t00424H	0	-	344	828	828	1.0000000
C1	2336452	2336944	BolC1t00425H	0	-	124	492	492	1.0000000
C1	2345795	2349129	BolC1t00426H	0	-	1843	3021	3334	0.9061188
C1	2350823	2352245	BolC1t00427H	0	-	475	1358	1422	0.9549929
C1	2354237	2357338	BolC1t00428H	0	-	2265	3029	3101	0.9767817
C1	2358415	2360247	BolC1t00429H	0	-	1529	1800	1832	0.9825327
C1	2361405	2361648	BolC1t00430H	0	+	212	240	243	0.9876543
C1	2362167	2364162	BolC1t00431H	0	+	1180	1995	1995	1.0000000
C1	2369138	2370209	BolC1t00432H	0	+	319	973	1071	0.9084967
C1	2370637	2375543	BolC1t00433H	0	-	1956	3713	4906	0.7568284
C1	2376066	2376876	BolC1t00434H	0	-	693	810	810	1.0000000
C1	2377431	2381364	BolC1t00435H	0	-	1689	3925	3933	0.9979659
C1	2381665	2382876	BolC1t00436H	0	+	661	1211	1211	1.0000000
C1	2383535	2385217	BolC1t00437H	0	+	1193	1682	1682	1.0000000
C1	2386407	2386954	BolC1t00438H	0	-	460	547	547	1.0000000
C1	2389870	2393800	BolC1t00439H	0	-	1888	3919	3930	0.9972010
C1	2397532	2398963	BolC1t00440H	0	-	383	1308	1431	0.9140461
C1	2404232	2407173	BolC1t00441H	0	-	1190	2855	2941	0.9707583
C1	2408912	2411071	BolC1t00442H	0	+	692	2050	2159	0.9495137
C1	2412658	2415413	BolC1t00443H	0	+	340	2063	2755	0.7488203
C1	2417865	2420249	BolC1t00444H	0	+	228	2163	2384	0.9072987
C1	2422002	2423835	BolC1t00445H	0	+	270	1538	1833	0.8390616
C1	2428620	2431206	BolC1t00446H	0	+	985	2536	2586	0.9806651
C1	2432845	2433609	BolC1t00447H	0	+	162	760	764	0.9947644
C1	2434183	2437611	BolC1t00448H	0	-	1369	2833	3428	0.8264294
C1	2439060	2440570	BolC1t00449H	0	+	69	727	1510	0.4814570
C1	2444572	2445151	BolC1t00450H	0	-	8	324	579	0.5595855
C1	2445383	2446154	BolC1t00451H	0	-	0	0	771	0.0000000
C1	2463136	2464508	BolC1t00452H	0	-	333	845	1372	0.6158892
C1	2465377	2470194	BolC1t00453H	0	-	4404	4782	4817	0.9927341
C1	2471005	2472642	BolC1t00454H	0	+	229	1528	1637	0.9334148
C1	2475299	2476751	BolC1t00455H	0	+	122	1145	1452	0.7885675
C1	2479375	2481102	BolC1t00456H	0	+	820	1722	1727	0.9971048
C1	2481353	2482874	BolC1t00457H	0	-	1793	1521	1521	1.0000000
C1	2483678	2491681	BolC1t00458H	0	-	2361	4404	8003	0.5502936
C1	2493292	2497381	BolC1t00459H	0	-	744	3535	4089	0.8645145
C1	2498428	2505272	BolC1t00460H	0	-	2360	6404	6844	0.9357101
C1	2505811	2507806	BolC1t00461H	0	+	938	1932	1995	0.9684210
C1	2508799	2512092	BolC1t00462H	0	+	2244	3237	3293	0.9829943
C1	2512583	2514474	BolC1t00463H	0	-	810	1859	1891	0.9830778
C1	2518640	2520038	BolC1t00464H	0	+	1019	1398	1398	1.0000000
C1	2521047	2523180	BolC1t00465H	0	+	2967	2077	2133	0.9737459
C1	2528810	2529008	BolC1t00466H	0	-	4	121	198	0.6111111
C1	2534603	2536725	BolC1t00467H	0	-	753	2073	2122	0.9769086
C1	2538303	2540716	BolC1t00468H	0	-	1933	2413	2413	1.0000000
C1	2541394	2542649	BolC1t00469H	0	-	1037	1255	1255	1.0000000
C1	2543175	2545261	BolC1t00470H	0	-	1549	2086	2086	1.0000000
C1	2553033	2554612	BolC1t00471H	0	+	595	1472	1579	0.9322356
C1	2571241	2572250	BolC1t00472H	0	-	467	1009	1009	1.0000000
C1	2575228	2577301	BolC1t00473H	0	+	1317	2073	2073	1.0000000
C1	2579347	2580131	BolC1t00474H	0	+	393	784	784	1.0000000
C1	2595523	2601463	BolC1t00475H	0	+	1566	5097	5940	0.8580808
C1	2603138	2605605	BolC1t00476H	0	+	1622	2446	2467	0.9914876
C1	2615868	2618315	BolC1t00477H	0	+	721	2384	2447	0.9742542
C1	2618966	2622350	BolC1t00478H	0	+	1309	3365	3384	0.9943854
C1	2623157	2624486	BolC1t00479H	0	-	1148	1329	1329	1.0000000
C1	2626565	2627084	BolC1t00480H	0	-	76	296	519	0.5703276
C1	2634720	2635245	BolC1t00481H	0	-	52	326	525	0.6209524
C1	2636959	2637565	BolC1t00482H	0	-	70	365	606	0.6023102
C1	2639442	2642035	BolC1t00483H	0	+	885	2297	2593	0.8858465
C1	2642392	2643660	BolC1t00484H	0	-	1187	1268	1268	1.0000000
C1	2644295	2646220	BolC1t00485H	0	+	1632	1925	1925	1.0000000
C1	2647711	2647963	BolC1t00486H	0	-	108	252	252	1.0000000
C1	2649220	2649633	BolC1t00487H	0	+	110	378	413	0.9152542
C1	2650646	2655663	BolC1t00488H	0	-	3243	5017	5017	1.0000000
C1	2656222	2656682	BolC1t00489H	0	+	472	460	460	1.0000000
C1	2657339	2658610	BolC1t00490H	0	+	618	1199	1271	0.9433517
C1	2658912	2664244	BolC1t00491H	0	-	4033	5332	5332	1.0000000
C1	2668207	2672580	BolC1t00492H	0	+	3300	4373	4373	1.0000000
C1	2675682	2678361	BolC1t00493H	0	-	1558	2679	2679	1.0000000
C1	2683506	2687065	BolC1t00494H	0	+	883	3021	3559	0.8488339
C1	2687696	2692591	BolC1t00495H	0	-	2909	4840	4895	0.9887640
C1	2693444	2695978	BolC1t00496H	0	-	1200	2519	2534	0.9940805
C1	2697721	2701234	BolC1t00497H	0	+	1865	3398	3513	0.9672645
C1	2701988	2703227	BolC1t00498H	0	+	624	1239	1239	1.0000000
C1	2703661	2705512	BolC1t00499H	0	+	830	1821	1851	0.9837925
C1	2707084	2712348	BolC1t00500H	0	+	1894	5214	5264	0.9905015
C1	2717994	2718379	BolC1t00501H	0	+	413	385	385	1.0000000
C1	2719093	2720739	BolC1t00502H	0	+	814	1646	1646	1.0000000
C1	2723843	2724697	BolC1t00503H	0	+	190	839	854	0.9824356
C1	2729420	2732228	BolC1t00504H	0	-	886	2725	2808	0.9704416
C1	2733882	2736888	BolC1t00505H	0	+	1173	2980	3006	0.9913507
C1	2737452	2739111	BolC1t00506H	0	-	284	1497	1659	0.9023508
C1	2740967	2742273	BolC1t00507H	0	-	839	1306	1306	1.0000000
C1	2746046	2748393	BolC1t00508H	0	+	588	1856	2347	0.7907968
C1	2748725	2751697	BolC1t00509H	0	-	992	2776	2972	0.9340512
C1	2752283	2754016	BolC1t00510H	0	-	1137	1704	1733	0.9832660
C1	2754566	2756963	BolC1t00511H	0	+	1974	2397	2397	1.0000000
C1	2758868	2762489	BolC1t00512H	0	+	1399	3596	3621	0.9930958
C1	2767634	2770840	BolC1t00513H	0	+	1697	3090	3206	0.9638178
C1	2772816	2774472	BolC1t00514H	0	-	851	1518	1656	0.9166667
C1	2774519	2774729	BolC1t00515H	0	+	173	210	210	1.0000000
C1	2775611	2776891	BolC1t00516H	0	+	927	1280	1280	1.0000000
C1	2781348	2781758	BolC1t00517H	0	+	179	410	410	1.0000000
C1	2783445	2783634	BolC1t00518H	0	+	368	189	189	1.0000000
C1	2784504	2788801	BolC1t00519H	0	+	2097	4249	4297	0.9888294
C1	2790586	2797230	BolC1t00520H	0	+	2672	6497	6644	0.9778748
C1	2797638	2801368	BolC1t00521H	0	-	1156	3386	3730	0.9077748
C1	2804863	2809694	BolC1t00522H	0	+	2375	4820	4831	0.9977230
C1	2812742	2823701	BolC1t00523H	0	+	1019	5647	10959	0.5152842
C1	2830157	2831991	BolC1t00524H	0	-	1165	1734	1834	0.9454744
C1	2832488	2835452	BolC1t00525H	0	+	953	2950	2964	0.9952766
C1	2835580	2836816	BolC1t00526H	0	-	753	1236	1236	1.0000000
C1	2841685	2847356	BolC1t00527H	0	+	4706	5581	5671	0.9841298
C1	2847831	2848017	BolC1t00528H	0	+	240	186	186	1.0000000
C1	2849386	2849572	BolC1t00529H	0	+	247	186	186	1.0000000
C1	2852721	2852862	BolC1t00530H	0	+	78	141	141	1.0000000
C1	2855710	2855896	BolC1t00531H	0	+	21	89	186	0.4784946
C1	2857036	2857222	BolC1t00532H	0	+	24	186	186	1.0000000
C1	2863719	2863905	BolC1t00533H	0	+	14	117	186	0.6290323
C1	2864557	2866684	BolC1t00534H	0	-	2035	2127	2127	1.0000000
C1	2867636	2868956	BolC1t00535H	0	+	942	1320	1320	1.0000000
C1	2870454	2872449	BolC1t00536H	0	+	726	1766	1995	0.8852130
C1	2876835	2879436	BolC1t00537H	0	+	2016	2601	2601	1.0000000
C1	2879649	2880081	BolC1t00538H	0	-	322	432	432	1.0000000
C1	2880852	2885125	BolC1t00539H	0	+	2501	4273	4273	1.0000000
C1	2885845	2890246	BolC1t00540H	0	-	1186	3917	4401	0.8900250
C1	2892367	2895359	BolC1t00541H	0	-	938	2818	2992	0.9418449
C1	2896350	2898164	BolC1t00542H	0	+	435	1636	1814	0.9018743
C1	2902025	2902460	BolC1t00543H	0	+	15	145	435	0.3333333
C1	2905811	2908396	BolC1t00544H	0	-	1613	2578	2585	0.9972920
C1	2909222	2911592	BolC1t00545H	0	+	1388	2255	2370	0.9514768
C1	2921227	2925513	BolC1t00546H	0	+	470	3814	4286	0.8898740
C1	2927391	2928996	BolC1t00547H	0	-	960	1605	1605	1.0000000
C1	2935055	2935229	BolC1t00548H	0	+	74	174	174	1.0000000
C1	2941844	2943506	BolC1t00549H	0	+	826	1630	1662	0.9807461
C1	2945019	2946390	BolC1t00550H	0	-	242	1168	1371	0.8519329
C1	2946720	2952773	BolC1t00551H	0	+	4599	5371	6053	0.8873286
C1	2954356	2955500	BolC1t00552H	0	+	825	1144	1144	1.0000000
C1	2957505	2958223	BolC1t00553H	0	-	348	697	718	0.9707521
C1	2962451	2964726	BolC1t00554H	0	-	275	833	2275	0.3661538
C1	2965762	2966119	BolC1t00555H	0	+	54	324	357	0.9075630
C1	2986247	2988616	BolC1t00556H	0	+	532	2171	2369	0.9164205
C1	2988959	2990032	BolC1t00557H	0	-	446	1021	1073	0.9515377
C1	2993890	3000858	BolC1t00558H	0	+	1621	6256	6968	0.8978186
C1	3001681	3005360	BolC1t00559H	0	-	310	2487	3679	0.6759989
C1	3005798	3007592	BolC1t00560H	0	+	1007	1794	1794	1.0000000
C1	3009242	3009913	BolC1t00561H	0	-	200	646	671	0.9627421
C1	3016871	3017320	BolC1t00562H	0	+	0	0	449	0.0000000
C1	3033090	3033539	BolC1t00563H	0	+	0	0	449	0.0000000
C1	3036290	3036743	BolC1t00564H	0	+	0	0	453	0.0000000
C1	3041183	3041631	BolC1t00565H	0	+	0	0	448	0.0000000
C1	3046698	3047385	BolC1t00566H	0	+	130	361	687	0.5254731
C1	3052974	3053752	BolC1t00567H	0	-	0	0	778	0.0000000
C1	3062187	3062762	BolC1t00568H	0	+	3	42	575	0.0730435
C1	3065004	3065951	BolC1t00569H	0	-	208	449	947	0.4741288
C1	3067123	3067831	BolC1t00570H	0	+	643	704	708	0.9943503
C1	3085758	3087212	BolC1t00571H	0	+	67	1083	1454	0.7448418
C1	3089787	3103097	BolC1t00572H	0	-	1709	4773	13310	0.3586026
C1	3092568	3093167	BolC1t00573H	0	+	171	515	599	0.8597663
C1	3093271	3149378	BolC1t00574H	0	-	2827	10260	56107	0.1828649
C1	3093523	3094303	BolC1t00575H	0	-	0	0	780	0.0000000
C1	3095849	3096065	BolC1t00576H	0	+	0	0	216	0.0000000
C1	3100298	3113464	BolC1t00577H	0	+	1697	2325	13166	0.1765912
C1	3104569	3105291	BolC1t00578H	0	-	0	0	722	0.0000000
C1	3108407	3110802	BolC1t00579H	0	-	0	0	2395	0.0000000
C1	3111338	3112372	BolC1t00580H	0	+	0	0	1034	0.0000000
C1	3132931	3133166	BolC1t00581H	0	+	0	0	235	0.0000000
C1	3150839	3151510	BolC1t00582H	0	+	2	215	671	0.3204173
C1	3152228	3152776	BolC1t00583H	0	+	0	0	548	0.0000000
C1	3155328	3169390	BolC1t00584H	0	+	95	1417	14062	0.1007680
C1	3157571	3158123	BolC1t00585H	0	-	2	21	552	0.0380435
C1	3160052	3160312	BolC1t00586H	0	-	0	0	260	0.0000000
C1	3163422	3163836	BolC1t00587H	0	-	0	0	414	0.0000000
C1	3175095	3175675	BolC1t00588H	0	+	0	0	580	0.0000000
C1	3183743	3183875	BolC1t00589H	0	+	0	0	132	0.0000000
C1	3187852	3188111	BolC1t00590H	0	+	1	150	259	0.5791506
C1	3191892	3192301	BolC1t00591H	0	-	83	409	409	1.0000000
C1	3203844	3208241	BolC1t00592H	0	+	510	2495	4397	0.5674323
C1	3209954	3210446	BolC1t00593H	0	-	120	492	492	1.0000000
C1	3216507	3217089	BolC1t00594H	0	+	362	582	582	1.0000000
C1	3218338	3218657	BolC1t00595H	0	-	228	319	319	1.0000000
C1	3219692	3221308	BolC1t00596H	0	+	146	1297	1616	0.8025990
C1	3224290	3228539	BolC1t00597H	0	-	2675	4144	4249	0.9752883
C1	3234456	3237432	BolC1t00598H	0	+	1090	2936	2976	0.9865592
C1	3237981	3239780	BolC1t00599H	0	-	1298	1769	1799	0.9833241
C1	3241645	3251023	BolC1t00600H	0	+	2523	7275	9378	0.7757518
C1	3251490	3254760	BolC1t00601H	0	-	831	2637	3270	0.8064220
C1	3259791	3260343	BolC1t00602H	0	-	124	552	552	1.0000000
C1	3263006	3263888	BolC1t00603H	0	-	0	0	882	0.0000000
C1	3282812	3282971	BolC1t00604H	0	+	186	159	159	1.0000000
C1	3283474	3284437	BolC1t00605H	0	-	930	963	963	1.0000000
C1	3292412	3293893	BolC1t00606H	0	-	9	395	1481	0.2667117
C1	3295368	3295512	BolC1t00607H	0	+	169	144	144	1.0000000
C1	3299759	3300452	BolC1t00608H	0	-	61	529	693	0.7633477
C1	3306056	3311664	BolC1t00609H	0	-	1015	4233	5608	0.7548146
C1	3313983	3314486	BolC1t00610H	0	-	511	503	503	1.0000000
C1	3314660	3315871	BolC1t00611H	0	-	1355	1211	1211	1.0000000
C1	3319844	3323996	BolC1t00612H	0	-	1946	4148	4152	0.9990366
C1	3327883	3328612	BolC1t00613H	0	-	609	729	729	1.0000000
C1	3333035	3337281	BolC1t00614H	0	-	2001	3758	4246	0.8850683
C1	3338836	3341091	BolC1t00615H	0	-	353	2212	2255	0.9809313
C1	3344897	3345370	BolC1t00616H	0	-	64	473	473	1.0000000
C1	3368810	3369277	BolC1t00617H	0	-	226	455	467	0.9743041
C1	3378405	3378843	BolC1t00618H	0	-	208	381	438	0.8698630
C1	3379408	3382465	BolC1t00619H	0	-	1031	2968	3057	0.9708865
C1	3394126	3396262	BolC1t00620H	0	-	1535	2136	2136	1.0000000
C1	3396776	3398726	BolC1t00621H	0	+	1541	1950	1950	1.0000000
C1	3399442	3401223	BolC1t00622H	0	+	1295	1781	1781	1.0000000
C1	3403160	3403558	BolC1t00623H	0	+	260	398	398	1.0000000
C1	3403811	3412142	BolC1t00624H	0	+	5133	7718	8331	0.9264194
C1	3412605	3415144	BolC1t00625H	0	-	1719	2457	2539	0.9677038
C1	3418345	3422055	BolC1t00626H	0	+	1002	2411	3710	0.6498652
C1	3422967	3430429	BolC1t00627H	0	-	5212	7414	7462	0.9935674
C1	3431584	3434696	BolC1t00628H	0	-	1196	2600	3112	0.8354756
C1	3435654	3440611	BolC1t00629H	0	-	191	2271	4957	0.4581400
C1	3445118	3446447	BolC1t00630H	0	+	652	1316	1329	0.9902182
C1	3447180	3448561	BolC1t00631H	0	+	1027	1136	1381	0.8225923
C1	3449164	3450673	BolC1t00632H	0	-	758	1509	1509	1.0000000
C1	3451922	3452982	BolC1t00633H	0	-	641	1060	1060	1.0000000
C1	3454467	3456397	BolC1t00634H	0	+	1374	1930	1930	1.0000000
C1	3456920	3457623	BolC1t00635H	0	+	470	703	703	1.0000000
C1	3458355	3460391	BolC1t00636H	0	-	1102	2036	2036	1.0000000
C1	3463611	3468680	BolC1t00637H	0	-	1778	4902	5069	0.9670547
C1	3472045	3473294	BolC1t00638H	0	-	54	550	1249	0.4403523
C1	3484030	3485962	BolC1t00639H	0	-	260	1285	1932	0.6651139
C1	3494303	3497717	BolC1t00640H	0	+	2089	3414	3414	1.0000000
C1	3498074	3498503	BolC1t00641H	0	-	247	429	429	1.0000000
C1	3499495	3501058	BolC1t00642H	0	-	800	1356	1563	0.8675624
C1	3501694	3503356	BolC1t00643H	0	+	1029	1637	1662	0.9849579
C1	3504338	3510581	BolC1t00644H	0	+	3100	6236	6243	0.9988787
C1	3511123	3514127	BolC1t00645H	0	-	1184	2691	3004	0.8958056
C1	3516160	3517154	BolC1t00646H	0	+	888	994	994	1.0000000
C1	3522560	3524882	BolC1t00647H	0	+	274	1679	2322	0.7230836
C1	3525966	3527289	BolC1t00648H	0	-	995	1323	1323	1.0000000
C1	3528468	3530285	BolC1t00649H	0	-	239	1378	1817	0.7583929
C1	3534122	3536441	BolC1t00650H	0	-	979	2319	2319	1.0000000
C1	3537078	3541442	BolC1t00651H	0	+	3475	4304	4364	0.9862512
C1	3547747	3548200	BolC1t00652H	0	-	476	453	453	1.0000000
C1	3550823	3551440	BolC1t00653H	0	+	274	617	617	1.0000000
C1	3552175	3553659	BolC1t00654H	0	-	570	1484	1484	1.0000000
C1	3555368	3556424	BolC1t00655H	0	-	153	843	1056	0.7982954
C1	3558665	3560919	BolC1t00656H	0	-	302	1868	2254	0.8287489
C1	3561942	3564541	BolC1t00657H	0	-	960	2356	2599	0.9065025
C1	3566605	3568005	BolC1t00658H	0	+	951	1400	1400	1.0000000
C1	3568861	3570849	BolC1t00659H	0	-	1999	1988	1988	1.0000000
C1	3574992	3575514	BolC1t00660H	0	-	773	522	522	1.0000000
C1	3576592	3580466	BolC1t00661H	0	-	1371	3649	3874	0.9419205
C1	3587367	3588621	BolC1t00662H	0	-	495	1254	1254	1.0000000
C1	3601268	3601976	BolC1t00663H	0	+	201	708	708	1.0000000
C1	3603486	3605370	BolC1t00664H	0	-	387	1792	1884	0.9511677
C1	3607692	3608737	BolC1t00665H	0	-	1355	1045	1045	1.0000000
C1	3613942	3615229	BolC1t00666H	0	-	670	1225	1287	0.9518260
C1	3616063	3616859	BolC1t00667H	0	+	493	748	796	0.9396985
C1	3619440	3620510	BolC1t00668H	0	+	732	991	1070	0.9261682
C1	3620767	3622828	BolC1t00669H	0	-	942	1985	2061	0.9631247
C1	3623360	3623622	BolC1t00670H	0	-	26	100	262	0.3816794
C1	3624326	3625207	BolC1t00671H	0	-	652	881	881	1.0000000
C1	3625919	3628432	BolC1t00672H	0	-	2277	2513	2513	1.0000000
C1	3629638	3633505	BolC1t00673H	0	+	2799	3867	3867	1.0000000
C1	3635077	3638752	BolC1t00674H	0	-	1469	3363	3675	0.9151021
C1	3639505	3639883	BolC1t00675H	0	+	128	378	378	1.0000000
C1	3640723	3641633	BolC1t00676H	0	+	177	867	910	0.9527472
C1	3641857	3642578	BolC1t00677H	0	+	468	721	721	1.0000000
C1	3643132	3645069	BolC1t00678H	0	+	2324	1937	1937	1.0000000
C1	3646043	3648338	BolC1t00679H	0	+	876	2087	2295	0.9093682
C1	3651226	3651846	BolC1t00680H	0	+	219	217	620	0.3500000
C1	3652970	3656580	BolC1t00681H	0	+	886	2588	3610	0.7168975
C1	3657470	3658091	BolC1t00682H	0	-	117	125	621	0.2012882
C1	3660791	3663042	BolC1t00683H	0	+	216	1665	2251	0.7396712
C1	3670695	3672947	BolC1t00684H	0	-	458	1802	2252	0.8001776
C1	3673432	3677731	BolC1t00685H	0	-	1768	4284	4299	0.9965108
C1	3679044	3680746	BolC1t00686H	0	-	376	1696	1702	0.9964747
C1	3681680	3683756	BolC1t00687H	0	-	371	2011	2076	0.9686898
C1	3687286	3687895	BolC1t00688H	0	-	51	390	609	0.6403941
C1	3696915	3697389	BolC1t00689H	0	-	143	474	474	1.0000000
C1	3700548	3706662	BolC1t00690H	0	+	2816	5666	6114	0.9267256
C1	3707132	3711871	BolC1t00691H	0	-	4544	4739	4739	1.0000000
C1	3718962	3719398	BolC1t00692H	0	+	421	436	436	1.0000000
C1	3722970	3725750	BolC1t00693H	0	+	1970	2780	2780	1.0000000
C1	3727856	3734929	BolC1t00694H	0	-	1041	4395	7073	0.6213771
C1	3740488	3745853	BolC1t00695H	0	-	934	3393	5365	0.6324325
C1	3766957	3768874	BolC1t00696H	0	+	1120	1882	1917	0.9817423
C1	3772472	3777464	BolC1t00697H	0	+	959	3597	4992	0.7205529
C1	3784528	3784918	BolC1t00698H	0	+	266	388	390	0.9948718
C1	3787267	3790594	BolC1t00699H	0	-	1728	3327	3327	1.0000000
C1	3791265	3791967	BolC1t00700H	0	-	367	702	702	1.0000000
C1	3792636	3792939	BolC1t00701H	0	+	20	188	303	0.6204621
C1	3812862	3814071	BolC1t00702H	0	-	99	875	1209	0.7237386
C1	3818146	3821486	BolC1t00703H	0	+	1930	3340	3340	1.0000000
C1	3821933	3824066	BolC1t00704H	0	+	1583	2130	2133	0.9985935
C1	3827515	3827719	BolC1t00705H	0	+	0	0	204	0.0000000
C1	3830969	3832322	BolC1t00706H	0	-	1324	1353	1353	1.0000000
C1	3835300	3835573	BolC1t00707H	0	+	70	273	273	1.0000000
C1	3842882	3844065	BolC1t00708H	0	-	566	1183	1183	1.0000000
C1	3846908	3849180	BolC1t00709H	0	-	1321	2272	2272	1.0000000
C1	3854653	3856604	BolC1t00710H	0	+	2246	1951	1951	1.0000000
C1	3857075	3858793	BolC1t00711H	0	-	1089	1718	1718	1.0000000
C1	3860340	3860841	BolC1t00712H	0	-	45	234	501	0.4670659
C1	3872555	3874673	BolC1t00713H	0	+	2801	2118	2118	1.0000000
C1	3875028	3876513	BolC1t00714H	0	-	467	1308	1485	0.8808081
C1	3880232	3880370	BolC1t00715H	0	+	174	138	138	1.0000000
C1	3883667	3884939	BolC1t00716H	0	+	621	1205	1272	0.9473270
C1	3890284	3894977	BolC1t00717H	0	-	2670	4693	4693	1.0000000
C1	3895457	3897386	BolC1t00718H	0	+	752	1710	1929	0.8864697
C1	3899306	3901312	BolC1t00719H	0	-	672	2005	2006	0.9995015
C1	3911575	3932133	BolC1t00720H	0	-	9617	15770	20558	0.7670979
C1	3920844	3923639	BolC1t00721H	0	+	2404	2795	2795	1.0000000
C1	3925094	3925753	BolC1t00722H	0	-	489	656	659	0.9954476
C1	3937013	3938901	BolC1t00723H	0	-	1829	1888	1888	1.0000000
C1	3939635	3945576	BolC1t00724H	0	+	2604	5570	5941	0.9375526
C1	3947264	3956103	BolC1t00725H	0	-	3296	8549	8839	0.9671909
C1	3957067	3957667	BolC1t00726H	0	-	547	600	600	1.0000000
C1	3970862	3971108	BolC1t00727H	0	-	476	246	246	1.0000000
C1	3983916	3985297	BolC1t00728H	0	+	190	1350	1381	0.9775525
C1	3988470	3990507	BolC1t00729H	0	+	490	1972	2037	0.9680904
C1	3993493	3994447	BolC1t00730H	0	-	151	931	954	0.9758910
C1	3994972	3995666	BolC1t00731H	0	-	154	614	694	0.8847262
C1	3999499	4000252	BolC1t00732H	0	-	9	335	753	0.4448871
C1	4002113	4003067	BolC1t00733H	0	-	19	397	954	0.4161426
C1	4004180	4007464	BolC1t00734H	0	-	172	1946	3284	0.5925700
C1	4009517	4010348	BolC1t00735H	0	-	26	527	831	0.6341757
C1	4011555	4012854	BolC1t00736H	0	+	114	639	1299	0.4919169
C1	4024450	4025344	BolC1t00737H	0	+	1206	894	894	1.0000000
C1	4025511	4026331	BolC1t00738H	0	+	1097	820	820	1.0000000
C1	4026680	4027735	BolC1t00739H	0	-	757	1055	1055	1.0000000
C1	4028392	4028864	BolC1t00740H	0	-	161	425	472	0.9004237
C1	4028955	4031064	BolC1t00741H	0	-	833	2093	2109	0.9924135
C1	4032577	4035777	BolC1t00742H	0	-	1853	3200	3200	1.0000000
C1	4037914	4039570	BolC1t00743H	0	+	894	1656	1656	1.0000000
C1	4041103	4042141	BolC1t00744H	0	-	502	1013	1038	0.9759152
C1	4043554	4046960	BolC1t00745H	0	-	1659	3293	3406	0.9668233
C1	4057000	4057375	BolC1t00746H	0	-	21	331	375	0.8826666
C1	4069183	4070538	BolC1t00747H	0	-	1544	1355	1355	1.0000000
C1	4071267	4073255	BolC1t00748H	0	-	1969	1988	1988	1.0000000
C1	4074443	4074924	BolC1t00749H	0	+	404	481	481	1.0000000
C1	4074991	4075648	BolC1t00750H	0	+	124	630	657	0.9589041
C1	4076749	4079862	BolC1t00751H	0	-	1505	3058	3113	0.9823322
C1	4084020	4084197	BolC1t00752H	0	+	0	0	177	0.0000000
C1	4086823	4087787	BolC1t00753H	0	-	436	964	964	1.0000000
C1	4089605	4089815	BolC1t00754H	0	+	31	78	210	0.3714286
C1	4095067	4095634	BolC1t00755H	0	+	138	512	567	0.9029982
C1	4097584	4099695	BolC1t00756H	0	-	1804	2084	2111	0.9872099
C1	4101613	4103018	BolC1t00757H	0	-	1774	1405	1405	1.0000000
C1	4109729	4110317	BolC1t00758H	0	+	285	588	588	1.0000000
C1	4111520	4111763	BolC1t00759H	0	-	296	243	243	1.0000000
C1	4111761	4113556	BolC1t00760H	0	+	1230	1783	1795	0.9933147
C1	4114979	4115354	BolC1t00761H	0	+	78	367	375	0.9786667
C1	4115374	4120757	BolC1t00762H	0	+	2773	4880	5383	0.9065577
C1	4120821	4122300	BolC1t00763H	0	+	720	1479	1479	1.0000000
C1	4122596	4129102	BolC1t00764H	0	-	4584	6504	6506	0.9996926
C1	4129705	4131822	BolC1t00765H	0	+	977	1999	2117	0.9442608
C1	4132427	4134980	BolC1t00766H	0	-	560	1915	2553	0.7500979
C1	4136073	4137392	BolC1t00767H	0	+	413	1319	1319	1.0000000
C1	4139154	4141089	BolC1t00768H	0	-	565	1917	1935	0.9906977
C1	4144294	4145393	BolC1t00769H	0	+	548	1099	1099	1.0000000
C1	4145879	4146207	BolC1t00770H	0	+	144	267	328	0.8140244
C1	4146863	4149019	BolC1t00771H	0	+	670	1886	2156	0.8747681
C1	4151768	4151961	BolC1t00772H	0	-	223	193	193	1.0000000
C1	4168116	4170212	BolC1t00773H	0	+	1701	2096	2096	1.0000000
C1	4180963	4192919	BolC1t00774H	0	+	2430	7244	11956	0.6058882
C1	4193362	4196218	BolC1t00775H	0	-	1614	2724	2856	0.9537815
C1	4196618	4198527	BolC1t00776H	0	+	855	1896	1909	0.9931902
C1	4200865	4202102	BolC1t00777H	0	+	530	1213	1237	0.9805982
C1	4204213	4204780	BolC1t00778H	0	-	80	496	567	0.8747795
C1	4205685	4206751	BolC1t00779H	0	-	200	1022	1066	0.9587242
C1	4207268	4209607	BolC1t00780H	0	-	1178	2325	2339	0.9940146
C1	4215295	4215568	BolC1t00781H	0	+	261	273	273	1.0000000
C1	4215889	4217709	BolC1t00782H	0	-	941	1744	1820	0.9582418
C1	4223097	4225280	BolC1t00783H	0	+	843	2130	2183	0.9757215
C1	4260605	4260923	BolC1t00784H	0	-	168	318	318	1.0000000
C1	4261127	4261700	BolC1t00785H	0	-	52	440	573	0.7678883
C1	4268039	4269601	BolC1t00786H	0	-	12	369	1562	0.2362356
C1	4273626	4274952	BolC1t00787H	0	-	135	1158	1326	0.8733032
C1	4277726	4278002	BolC1t00788H	0	-	0	0	276	0.0000000
C1	4296457	4298198	BolC1t00789H	0	+	1561	1741	1741	1.0000000
C1	4299393	4299765	BolC1t00790H	0	-	65	372	372	1.0000000
C1	4301153	4302550	BolC1t00791H	0	+	1295	1397	1397	1.0000000
C1	4303148	4305673	BolC1t00792H	0	+	763	2152	2525	0.8522772
C1	4306020	4307866	BolC1t00793H	0	-	301	1384	1846	0.7497292
C1	4309878	4312186	BolC1t00794H	0	+	1421	2308	2308	1.0000000
C1	4312770	4313085	BolC1t00795H	0	-	305	315	315	1.0000000
C1	4323486	4325204	BolC1t00796H	0	+	525	1634	1718	0.9511060
C1	4327546	4328517	BolC1t00797H	0	+	776	971	971	1.0000000
C1	4328908	4331548	BolC1t00798H	0	-	927	2337	2640	0.8852273
C1	4332214	4341411	BolC1t00799H	0	-	2241	7223	9197	0.7853648
C1	4346804	4349407	BolC1t00800H	0	-	488	2178	2603	0.8367268
C1	4356978	4360961	BolC1t00801H	0	+	1254	3962	3983	0.9947276
C1	4361484	4363666	BolC1t00802H	0	-	520	2052	2182	0.9404216
C1	4365124	4365586	BolC1t00803H	0	+	63	342	462	0.7402598
C1	4370551	4375802	BolC1t00804H	0	+	1937	5029	5251	0.9577224
C1	4376669	4377063	BolC1t00805H	0	-	371	394	394	1.0000000
C1	4377376	4380594	BolC1t00806H	0	+	2036	3174	3218	0.9863269
C1	4381170	4382079	BolC1t00807H	0	-	729	909	909	1.0000000
C1	4382307	4382500	BolC1t00808H	0	-	344	193	193	1.0000000
C1	4383956	4384283	BolC1t00809H	0	+	45	236	327	0.7217125
C1	4385220	4387459	BolC1t00810H	0	+	859	2126	2239	0.9495310
C1	4388114	4388818	BolC1t00811H	0	-	643	704	704	1.0000000
C1	4389334	4389638	BolC1t00812H	0	-	96	277	304	0.9111842
C1	4390164	4391324	BolC1t00813H	0	-	236	1056	1160	0.9103448
C1	4395069	4396869	BolC1t00814H	0	+	1032	1800	1800	1.0000000
C1	4406672	4407369	BolC1t00815H	0	-	394	697	697	1.0000000
C1	4421657	4422845	BolC1t00816H	0	+	186	809	1188	0.6809765
C1	4423379	4425635	BolC1t00817H	0	-	1175	2256	2256	1.0000000
C1	4426860	4427828	BolC1t00818H	0	-	764	968	968	1.0000000
C1	4430376	4432794	BolC1t00819H	0	+	1093	2404	2418	0.9942101
C1	4435225	4436398	BolC1t00820H	0	-	91	510	1173	0.4347826
C1	4469488	4472215	BolC1t00821H	0	+	1803	2727	2727	1.0000000
C1	4475549	4475870	BolC1t00822H	0	+	2	156	321	0.4859813
C1	4478626	4479715	BolC1t00823H	0	+	60	560	1089	0.5142332
C1	4480384	4480846	BolC1t00824H	0	-	2	233	462	0.5043290
C1	4489672	4491583	BolC1t00825H	0	-	2354	1911	1911	1.0000000
C1	4503844	4505935	BolC1t00826H	0	+	1711	1652	2091	0.7900526
C1	4508725	4523372	BolC1t00827H	0	+	1719	4438	14647	0.3029972
C1	4510300	4510939	BolC1t00828H	0	-	10	338	639	0.5289515
C1	4511216	4511516	BolC1t00829H	0	-	2	4	300	0.0133333
C1	4520758	4521133	BolC1t00830H	0	+	0	0	375	0.0000000
C1	4524529	4526317	BolC1t00831H	0	-	0	0	1788	0.0000000
C1	4541375	4541717	BolC1t00832H	0	+	0	0	342	0.0000000
C1	4543768	4544412	BolC1t00833H	0	+	0	0	644	0.0000000
C1	4545164	4546912	BolC1t00834H	0	-	132	817	1748	0.4673913
C1	4561954	4562329	BolC1t00835H	0	+	0	0	375	0.0000000
C1	4564207	4565302	BolC1t00836H	0	+	152	658	1095	0.6009132
C1	4565722	4567511	BolC1t00837H	0	-	166	311	1789	0.1738401
C1	4568000	4568204	BolC1t00838H	0	+	26	204	204	1.0000000
C1	4573059	4574021	BolC1t00839H	0	-	96	621	962	0.6455302
C1	4574135	4574630	BolC1t00840H	0	+	26	158	495	0.3191919
C1	4576837	4577164	BolC1t00841H	0	+	38	288	327	0.8807340
C1	4580312	4581602	BolC1t00842H	0	+	33	690	1290	0.5348837
C1	4584733	4585045	BolC1t00843H	0	+	336	312	312	1.0000000
C1	4592630	4595095	BolC1t00844H	0	+	1486	2309	2465	0.9367140
C1	4595184	4596848	BolC1t00845H	0	-	108	915	1664	0.5498798
C1	4606161	4606790	BolC1t00846H	0	-	70	351	629	0.5580286
C1	4607698	4608241	BolC1t00847H	0	+	40	198	543	0.3646409
C1	4611050	4612472	BolC1t00848H	0	-	165	821	1422	0.5773559
C1	4623629	4624205	BolC1t00849H	0	-	215	463	576	0.8038194
C1	4634536	4634965	BolC1t00850H	0	-	580	429	429	1.0000000
C1	4637644	4643362	BolC1t00851H	0	-	1054	4522	5718	0.7908360
C1	4645722	4646211	BolC1t00852H	0	+	107	378	489	0.7730061
C1	4647456	4651190	BolC1t00853H	0	+	1678	3676	3734	0.9844671
C1	4658534	4658684	BolC1t00854H	0	+	0	0	150	0.0000000
C1	4661229	4661422	BolC1t00855H	0	+	30	184	193	0.9533679
C1	4661790	4662935	BolC1t00856H	0	+	0	0	1145	0.0000000
C1	4674800	4677697	BolC1t00857H	0	-	983	2449	2897	0.8453572
C1	4703250	4703828	BolC1t00858H	0	-	2	235	578	0.4065744
C1	4705859	4708503	BolC1t00859H	0	+	1001	2644	2644	1.0000000
C1	4713117	4713480	BolC1t00860H	0	-	313	363	363	1.0000000
C1	4714333	4714840	BolC1t00861H	0	-	418	507	507	1.0000000
C1	4716888	4718076	BolC1t00862H	0	+	99	1037	1188	0.8728956
C1	4724822	4725869	BolC1t00863H	0	+	63	551	1047	0.5262655
C1	4737900	4739256	BolC1t00864H	0	+	1250	1356	1356	1.0000000
C1	4739831	4740514	BolC1t00865H	0	+	866	683	683	1.0000000
C1	4742000	4743130	BolC1t00866H	0	+	171	868	1130	0.7681416
C1	4746845	4746962	BolC1t00867H	0	-	78	117	117	1.0000000
C1	4757565	4758621	BolC1t00868H	0	+	172	905	1056	0.8570076
C1	4759365	4760862	BolC1t00869H	0	+	1037	1497	1497	1.0000000
C1	4764521	4766072	BolC1t00870H	0	+	423	1340	1551	0.8639587
C1	4768252	4770409	BolC1t00871H	0	+	2135	2157	2157	1.0000000
C1	4775473	4776729	BolC1t00872H	0	+	1017	1256	1256	1.0000000
C1	4778426	4779194	BolC1t00873H	0	-	750	768	768	1.0000000
C1	4780981	4781905	BolC1t00874H	0	-	125	924	924	1.0000000
C1	4783952	4787478	BolC1t00875H	0	-	3811	3526	3526	1.0000000
C1	4808872	4811145	BolC1t00876H	0	+	996	2272	2273	0.9995601
C1	4850771	4855191	BolC1t00877H	0	+	1294	3979	4420	0.9002262
C1	4857721	4858210	BolC1t00878H	0	-	5	203	489	0.4151329
C1	4877552	4879997	BolC1t00879H	0	-	1757	2298	2445	0.9398773
C1	4884347	4885481	BolC1t00880H	0	-	126	832	1134	0.7336861
C1	4890524	4891670	BolC1t00881H	0	-	106	450	1146	0.3926702
C1	4898802	4903684	BolC1t00882H	0	-	2517	4795	4882	0.9821795
C1	4911071	4911534	BolC1t00883H	0	+	265	463	463	1.0000000
C1	4912742	4914260	BolC1t00884H	0	-	667	1518	1518	1.0000000
C1	4918601	4925318	BolC1t00885H	0	-	2601	6291	6717	0.9365788
C1	4925900	4928168	BolC1t00886H	0	+	1118	2242	2268	0.9885362
C1	4937096	4939454	BolC1t00887H	0	-	810	2258	2358	0.9575912
C1	4944335	4947379	BolC1t00888H	0	+	1839	3001	3044	0.9858739
C1	4952127	4952421	BolC1t00889H	0	-	0	0	294	0.0000000
C1	4957926	4973306	BolC1t00890H	0	+	7339	14267	15380	0.9276333
C1	4962906	4966261	BolC1t00891H	0	+	2659	3355	3355	1.0000000
C1	4974830	4975807	BolC1t00892H	0	+	369	973	977	0.9959058
C1	4981271	4983700	BolC1t00893H	0	+	271	1966	2429	0.8093866
C1	4988258	4990661	BolC1t00894H	0	+	1131	2403	2403	1.0000000
C1	5003735	5005306	BolC1t00895H	0	-	886	1571	1571	1.0000000
C1	5009703	5011005	BolC1t00896H	0	+	678	1302	1302	1.0000000
C1	5011255	5014893	BolC1t00897H	0	-	1981	3638	3638	1.0000000
C1	5019420	5020791	BolC1t00898H	0	-	829	1371	1371	1.0000000
C1	5025977	5026342	BolC1t00899H	0	-	465	365	365	1.0000000
C1	5028632	5030775	BolC1t00900H	0	+	1546	2143	2143	1.0000000
C1	5033298	5036886	BolC1t00901H	0	+	1001	2984	3588	0.8316611
C1	5038587	5039911	BolC1t00902H	0	+	792	1324	1324	1.0000000
C1	5045064	5048142	BolC1t00903H	0	-	840	3050	3078	0.9909032
C1	5054352	5057713	BolC1t00904H	0	+	1438	3299	3361	0.9815531
C1	5058705	5058897	BolC1t00905H	0	+	24	134	192	0.6979167
C1	5059656	5062155	BolC1t00906H	0	-	152	1732	2499	0.6930772
C1	5086020	5098046	BolC1t00907H	0	+	4638	9805	12026	0.8153168
C1	5099012	5108562	BolC1t00908H	0	-	3435	8851	9550	0.9268063
C1	5100908	5103723	BolC1t00909H	0	+	784	2311	2815	0.8209592
C1	5104401	5104767	BolC1t00910H	0	+	299	366	366	1.0000000
C1	5105022	5106431	BolC1t00911H	0	-	992	1409	1409	1.0000000
C1	5108830	5110228	BolC1t00912H	0	+	479	1344	1398	0.9613734
C1	5111277	5111943	BolC1t00913H	0	+	12	383	666	0.5750751
C1	5112894	5113843	BolC1t00914H	0	-	312	949	949	1.0000000
C1	5116167	5116896	BolC1t00915H	0	-	179	729	729	1.0000000
C1	5117287	5120917	BolC1t00916H	0	+	709	3349	3630	0.9225895
C1	5128752	5129342	BolC1t00917H	0	+	351	590	590	1.0000000
C1	5130536	5130740	BolC1t00918H	0	+	289	204	204	1.0000000
C1	5134523	5135189	BolC1t00919H	0	-	8	516	666	0.7747748
C1	5139093	5146523	BolC1t00920H	0	+	3932	7327	7430	0.9861373
C1	5147584	5148106	BolC1t00921H	0	-	205	522	522	1.0000000
C1	5148417	5150826	BolC1t00922H	0	+	978	2409	2409	1.0000000
C1	5151239	5152065	BolC1t00923H	0	+	744	826	826	1.0000000
C1	5153965	5155543	BolC1t00924H	0	+	567	1553	1578	0.9841571
C1	5155739	5156904	BolC1t00925H	0	-	229	1018	1165	0.8738198
C1	5157107	5158548	BolC1t00926H	0	+	759	1364	1441	0.9465649
C1	5159220	5161108	BolC1t00927H	0	+	1040	1865	1888	0.9878178
C1	5162554	5164232	BolC1t00928H	0	+	241	1577	1678	0.9398093
C1	5164878	5170252	BolC1t00929H	0	-	2907	5309	5374	0.9879047
C1	5173229	5174813	BolC1t00930H	0	-	484	1520	1584	0.9595960
C1	5178384	5179443	BolC1t00931H	0	+	838	1059	1059	1.0000000
C1	5182200	5182794	BolC1t00932H	0	+	343	576	594	0.9696970
C1	5194960	5196880	BolC1t00933H	0	+	2629	1920	1920	1.0000000
C1	5198728	5201723	BolC1t00934H	0	+	1491	2860	2995	0.9549249
C1	5206992	5208615	BolC1t00935H	0	+	121	1522	1623	0.9377696
C1	5235375	5235876	BolC1t00936H	0	+	1	35	501	0.0698603
C1	5235937	5236848	BolC1t00937H	0	+	12	275	911	0.3018661
C1	5243271	5244621	BolC1t00938H	0	+	164	468	1350	0.3466667
C1	5247966	5249346	BolC1t00939H	0	+	639	1318	1380	0.9550725
C1	5260658	5261701	BolC1t00940H	0	+	964	1043	1043	1.0000000
C1	5263039	5268969	BolC1t00941H	0	-	3364	5930	5930	1.0000000
C1	5273213	5274671	BolC1t00942H	0	+	306	1341	1458	0.9197531
C1	5277646	5277898	BolC1t00943H	0	+	226	252	252	1.0000000
C1	5285787	5286372	BolC1t00944H	0	-	192	585	585	1.0000000
C1	5286818	5287425	BolC1t00945H	0	-	213	607	607	1.0000000
C1	5287965	5291444	BolC1t00946H	0	-	2587	3479	3479	1.0000000
C1	5299442	5301041	BolC1t00947H	0	-	516	1559	1599	0.9749843
C1	5304839	5306488	BolC1t00948H	0	-	780	1594	1649	0.9666464
C1	5310393	5310937	BolC1t00949H	0	+	109	422	544	0.7757353
C1	5311150	5312414	BolC1t00950H	0	+	333	1229	1264	0.9723101
C1	5318866	5321054	BolC1t00951H	0	+	356	1877	2188	0.8578610
C1	5321619	5322843	BolC1t00952H	0	-	987	1224	1224	1.0000000
C1	5324054	5324484	BolC1t00953H	0	-	287	430	430	1.0000000
C1	5326117	5327819	BolC1t00954H	0	-	845	1702	1702	1.0000000
C1	5331368	5331647	BolC1t00955H	0	+	0	0	279	0.0000000
C1	5342119	5345660	BolC1t00956H	0	-	2864	3541	3541	1.0000000
C1	5346183	5347807	BolC1t00957H	0	+	1755	1624	1624	1.0000000
C1	5348046	5349998	BolC1t00958H	0	-	1225	1952	1952	1.0000000
C1	5350425	5354195	BolC1t00959H	0	-	2333	3709	3770	0.9838196
C1	5354955	5355694	BolC1t00960H	0	+	493	739	739	1.0000000
C1	5357859	5359387	BolC1t00961H	0	+	349	1017	1528	0.6655759
C1	5359474	5363182	BolC1t00962H	0	+	1410	3447	3708	0.9296116
C1	5365660	5365822	BolC1t00963H	0	+	17	162	162	1.0000000
C1	5369209	5372543	BolC1t00964H	0	+	1241	3015	3334	0.9043191
C1	5373163	5374029	BolC1t00965H	0	-	225	834	866	0.9630485
C1	5374255	5376185	BolC1t00966H	0	+	590	1805	1930	0.9352332
C1	5376273	5378332	BolC1t00967H	0	+	860	1915	2059	0.9300631
C1	5378683	5380171	BolC1t00968H	0	-	657	1488	1488	1.0000000
C1	5380438	5381335	BolC1t00969H	0	+	319	897	897	1.0000000
C1	5381791	5387959	BolC1t00970H	0	-	1393	4790	6168	0.7765889
C1	5402797	5406580	BolC1t00971H	0	-	4181	3783	3783	1.0000000
C1	5416954	5418140	BolC1t00972H	0	-	404	894	1186	0.7537943
C1	5420056	5420230	BolC1t00973H	0	-	147	174	174	1.0000000
C1	5426045	5427197	BolC1t00974H	0	-	117	834	1152	0.7239583
C1	5437052	5439015	BolC1t00975H	0	+	686	1954	1963	0.9954152
C1	5439483	5440232	BolC1t00976H	0	-	239	718	749	0.9586115
C1	5445848	5446796	BolC1t00977H	0	+	640	948	948	1.0000000
C1	5447775	5448741	BolC1t00978H	0	-	138	650	966	0.6728778
C1	5449369	5451288	BolC1t00979H	0	-	1002	1919	1919	1.0000000
C1	5451964	5452150	BolC1t00980H	0	+	32	186	186	1.0000000
C1	5460623	5462627	BolC1t00981H	0	+	942	1845	2004	0.9206587
C1	5466516	5466795	BolC1t00982H	0	+	1	79	279	0.2831541
C1	5475321	5475546	BolC1t00983H	0	-	245	225	225	1.0000000
C1	5479708	5481508	BolC1t00984H	0	+	781	1800	1800	1.0000000
C1	5489112	5492496	BolC1t00985H	0	+	1021	1602	3384	0.4734043
C1	5490656	5491118	BolC1t00986H	0	-	0	0	462	0.0000000
C1	5495753	5500347	BolC1t00987H	0	-	673	3363	4594	0.7320418
C1	5510327	5512561	BolC1t00988H	0	+	104	1493	2234	0.6683080
C1	5512874	5515682	BolC1t00989H	0	-	916	2439	2808	0.8685898
C1	5548327	5548968	BolC1t00990H	0	-	0	0	641	0.0000000
C1	5551617	5553422	BolC1t00991H	0	-	751	1559	1805	0.8637119
C1	5555314	5556439	BolC1t00992H	0	-	811	1123	1125	0.9982222
C1	5569800	5571417	BolC1t00993H	0	-	20	215	1617	0.1329623
C1	5590061	5590657	BolC1t00994H	0	-	253	596	596	1.0000000
C1	5624350	5624548	BolC1t00995H	0	-	3	99	198	0.5000000
C1	5625441	5625633	BolC1t00996H	0	+	19	192	192	1.0000000
C1	5630479	5634736	BolC1t00997H	0	-	465	3027	4257	0.7110641
C1	5646020	5646588	BolC1t00998H	0	+	717	568	568	1.0000000
C1	5660626	5661378	BolC1t00999H	0	+	179	663	752	0.8816490
C1	5671979	5672141	BolC1t01000H	0	-	80	162	162	1.0000000
C1	5685057	5693475	BolC1t01001H	0	+	1002	5097	8418	0.6054882
C1	5715168	5716568	BolC1t01002H	0	+	72	803	1400	0.5735714
C1	5717135	5718530	BolC1t01003H	0	-	888	1395	1395	1.0000000
C1	5718585	5719190	BolC1t01004H	0	+	372	605	605	1.0000000
C1	5727831	5728586	BolC1t01005H	0	+	560	755	755	1.0000000
C1	5728887	5732306	BolC1t01006H	0	-	1302	3171	3419	0.9274642
C1	5733184	5735478	BolC1t01007H	0	-	264	1884	2294	0.8212729
C1	5738408	5740409	BolC1t01008H	0	+	1598	1928	2001	0.9635183
C1	5743218	5747368	BolC1t01009H	0	-	1208	3645	4150	0.8783132
C1	5748453	5748909	BolC1t01010H	0	-	14	193	456	0.4232456
C1	5752654	5752996	BolC1t01011H	0	-	12	215	342	0.6286550
C1	5759607	5760063	BolC1t01012H	0	-	216	456	456	1.0000000
C1	5762013	5762163	BolC1t01013H	0	-	326	150	150	1.0000000
C1	5763090	5763487	BolC1t01014H	0	+	152	397	397	1.0000000
C1	5773825	5778082	BolC1t01015H	0	+	1766	4147	4257	0.9741602
C1	5778633	5785935	BolC1t01016H	0	-	3997	6900	7302	0.9449466
C1	5786736	5788154	BolC1t01017H	0	-	1027	1418	1418	1.0000000
C1	5789331	5795066	BolC1t01018H	0	-	1027	3742	5735	0.6524847
C1	5800465	5802908	BolC1t01019H	0	-	494	2056	2443	0.8415882
C1	5806887	5808207	BolC1t01020H	0	+	999	1320	1320	1.0000000
C1	5810537	5811797	BolC1t01021H	0	+	135	1102	1260	0.8746032
C1	5814169	5816622	BolC1t01022H	0	-	1434	2453	2453	1.0000000
C1	5817290	5818738	BolC1t01023H	0	-	618	1264	1448	0.8729282
C1	5827060	5828723	BolC1t01024H	0	-	239	1461	1663	0.8785328
C1	5844400	5845736	BolC1t01025H	0	-	566	1297	1336	0.9708084
C1	5845958	5847299	BolC1t01026H	0	+	1017	1292	1341	0.9634601
C1	5847580	5863609	BolC1t01027H	0	-	3455	10122	16029	0.6314805
C1	5859798	5860105	BolC1t01028H	0	+	321	307	307	1.0000000
C1	5869420	5869597	BolC1t01029H	0	-	0	0	177	0.0000000
C1	5870571	5871498	BolC1t01030H	0	+	95	244	927	0.2632147
C1	5882320	5884670	BolC1t01031H	0	-	360	2069	2350	0.8804255
C1	5889200	5890620	BolC1t01032H	0	+	856	1420	1420	1.0000000
C1	5890934	5893830	BolC1t01033H	0	-	1080	2824	2896	0.9751381
C1	5901795	5902627	BolC1t01034H	0	+	828	832	832	1.0000000
C1	5903022	5904304	BolC1t01035H	0	-	1313	1282	1282	1.0000000
C1	5908352	5909205	BolC1t01036H	0	-	554	853	853	1.0000000
C1	5910128	5910263	BolC1t01037H	0	-	195	135	135	1.0000000
C1	5916874	5918390	BolC1t01038H	0	-	605	1462	1516	0.9643800
C1	5942093	5942492	BolC1t01039H	0	-	24	336	399	0.8421053
C1	5942787	5943105	BolC1t01040H	0	-	63	318	318	1.0000000
C1	5943675	5944873	BolC1t01041H	0	-	202	1006	1198	0.8397329
C1	5948692	5961931	BolC1t01042H	0	-	4719	12193	13239	0.9209910
C1	5966034	5966494	BolC1t01043H	0	-	160	460	460	1.0000000
C1	5978899	5979151	BolC1t01044H	0	+	1	38	252	0.1507937
C1	5986758	5988264	BolC1t01045H	0	-	388	1222	1506	0.8114210
C1	5988961	5990173	BolC1t01046H	0	-	134	1112	1212	0.9174917
C1	6004214	6005430	BolC1t01047H	0	-	121	856	1216	0.7039474
C1	6010350	6010798	BolC1t01048H	0	-	33	303	448	0.6763393
C1	6033885	6037977	BolC1t01049H	0	-	3045	4041	4092	0.9875367
C1	6049992	6053555	BolC1t01050H	0	-	1199	3326	3563	0.9334830
C1	6055760	6058878	BolC1t01051H	0	+	180	2198	3118	0.7049391
C1	6059304	6060593	BolC1t01052H	0	-	300	1268	1289	0.9837083
C1	6062071	6064669	BolC1t01053H	0	+	1429	2522	2598	0.9707468
C1	6065772	6067536	BolC1t01054H	0	+	1073	1764	1764	1.0000000
C1	6067987	6070417	BolC1t01055H	0	-	589	2318	2430	0.9539095
C1	6077021	6078356	BolC1t01056H	0	+	587	1335	1335	1.0000000
C1	6083761	6086619	BolC1t01057H	0	-	909	2743	2858	0.9597621
C1	6111006	6114284	BolC1t01058H	0	+	1396	2927	3278	0.8929225
C1	6117060	6119076	BolC1t01059H	0	-	900	1945	2016	0.9647818
C1	6124919	6126364	BolC1t01060H	0	+	793	1297	1445	0.8975779
C1	6126844	6128417	BolC1t01061H	0	-	674	1040	1573	0.6611570
C1	6130852	6133949	BolC1t01062H	0	-	783	2887	3097	0.9321924
C1	6138450	6139134	BolC1t01063H	0	+	200	684	684	1.0000000
C1	6139282	6140920	BolC1t01064H	0	-	993	1570	1638	0.9584860
C1	6141409	6146634	BolC1t01065H	0	+	550	3832	5225	0.7333971
C1	6147314	6147536	BolC1t01066H	0	-	205	222	222	1.0000000
C1	6164474	6165279	BolC1t01067H	0	-	585	803	805	0.9975155
C1	6165540	6167459	BolC1t01068H	0	-	1480	1919	1919	1.0000000
C1	6167893	6169726	BolC1t01069H	0	-	335	1456	1833	0.7943262
C1	6170290	6170977	BolC1t01070H	0	+	1	35	687	0.0509461
C1	6171400	6171736	BolC1t01071H	0	+	35	278	336	0.8273810
C1	6172729	6172951	BolC1t01072H	0	-	234	222	222	1.0000000
C1	6174212	6175167	BolC1t01073H	0	-	431	810	955	0.8481675
C1	6176821	6177325	BolC1t01074H	0	+	213	504	504	1.0000000
C1	6179175	6179541	BolC1t01075H	0	+	63	341	366	0.9316940
C1	6185203	6185344	BolC1t01076H	0	-	83	141	141	1.0000000
C1	6189291	6189675	BolC1t01077H	0	+	83	384	384	1.0000000
C1	6190002	6191466	BolC1t01078H	0	-	147	1081	1464	0.7383880
C1	6195372	6196152	BolC1t01079H	0	-	103	685	780	0.8782051
C1	6205089	6205785	BolC1t01080H	0	+	73	639	696	0.9181035
C1	6209174	6210613	BolC1t01081H	0	-	254	788	1439	0.5476025
C1	6211167	6212834	BolC1t01082H	0	+	738	1667	1667	1.0000000
C1	6213251	6214645	BolC1t01083H	0	-	1214	1394	1394	1.0000000
C1	6214695	6215060	BolC1t01084H	0	-	161	365	365	1.0000000
C1	6217235	6218878	BolC1t01085H	0	+	802	1643	1643	1.0000000
C1	6219026	6225564	BolC1t01086H	0	-	440	2737	6538	0.4186296
C1	6226512	6227689	BolC1t01087H	0	-	141	1022	1177	0.8683093
C1	6229930	6230374	BolC1t01088H	0	-	370	444	444	1.0000000
C1	6233322	6235809	BolC1t01089H	0	-	785	2387	2487	0.9597909
C1	6238761	6239025	BolC1t01090H	0	-	53	251	264	0.9507576
C1	6239972	6240320	BolC1t01091H	0	-	345	348	348	1.0000000
C1	6242579	6245574	BolC1t01092H	0	-	733	2550	2995	0.8514190
C1	6246635	6255711	BolC1t01093H	0	-	2949	8346	9076	0.9195681
C1	6288561	6291052	BolC1t01094H	0	+	588	2254	2491	0.9048575
C1	6292600	6293325	BolC1t01095H	0	+	570	725	725	1.0000000
C1	6294200	6295453	BolC1t01096H	0	+	1072	1253	1253	1.0000000
C1	6295989	6299219	BolC1t01097H	0	+	2357	3230	3230	1.0000000
C1	6302502	6303203	BolC1t01098H	0	-	695	701	701	1.0000000
C1	6315814	6315946	BolC1t01099H	0	+	208	132	132	1.0000000
C1	6319560	6327539	BolC1t01100H	0	+	1083	4828	7979	0.6050884
C1	6321217	6323212	BolC1t01101H	0	-	141	1040	1995	0.5213032
C1	6327632	6328097	BolC1t01102H	0	+	337	465	465	1.0000000
C1	6328329	6328965	BolC1t01103H	0	+	268	630	636	0.9905660
C1	6332436	6333409	BolC1t01104H	0	+	518	973	973	1.0000000
C1	6340909	6341615	BolC1t01105H	0	-	615	706	706	1.0000000
C1	6356976	6358007	BolC1t01106H	0	-	848	1031	1031	1.0000000
C1	6371532	6372576	BolC1t01107H	0	+	111	170	1044	0.1628353
C1	6373427	6373610	BolC1t01108H	0	-	0	0	183	0.0000000
C1	6375011	6377593	BolC1t01109H	0	-	168	1227	2582	0.4752130
C1	6405863	6406055	BolC1t01110H	0	-	110	192	192	1.0000000
C1	6409150	6410192	BolC1t01111H	0	-	192	1042	1042	1.0000000
C1	6411658	6413005	BolC1t01112H	0	+	440	1332	1347	0.9888641
C1	6413540	6414979	BolC1t01113H	0	-	241	1167	1439	0.8109798
C1	6419464	6421372	BolC1t01114H	0	-	202	950	1908	0.4979036
C1	6439784	6441150	BolC1t01115H	0	+	533	1214	1366	0.8887262
C1	6441815	6443388	BolC1t01116H	0	-	45	674	1573	0.4284806
C1	6448255	6448648	BolC1t01117H	0	-	260	393	393	1.0000000
C1	6448724	6449729	BolC1t01118H	0	+	712	1005	1005	1.0000000
C1	6460268	6460409	BolC1t01119H	0	-	168	141	141	1.0000000
C1	6468022	6468631	BolC1t01120H	0	-	1	57	609	0.0935961
C1	6471116	6473301	BolC1t01121H	0	+	2605	2185	2185	1.0000000
C1	6473993	6475202	BolC1t01122H	0	-	1751	1209	1209	1.0000000
C1	6485208	6485598	BolC1t01123H	0	-	301	390	390	1.0000000
C1	6509493	6509999	BolC1t01124H	0	+	869	506	506	1.0000000
C1	6524110	6524992	BolC1t01125H	0	+	5	39	882	0.0442177
C1	6530988	6532866	BolC1t01126H	0	+	854	1821	1878	0.9696485
C1	6533041	6534677	BolC1t01127H	0	-	238	1427	1636	0.8722494
C1	6538818	6539796	BolC1t01128H	0	+	127	936	978	0.9570552
C1	6547202	6548046	BolC1t01129H	0	+	94	508	844	0.6018957
C1	6551256	6552868	BolC1t01130H	0	+	209	969	1612	0.6011166
C1	6565159	6565357	BolC1t01131H	0	-	91	198	198	1.0000000
C1	6570156	6570732	BolC1t01132H	0	+	32	521	576	0.9045139
C1	6571414	6571714	BolC1t01133H	0	+	97	300	300	1.0000000
C1	6577789	6579547	BolC1t01134H	0	-	50	1045	1758	0.5944255
C1	6586230	6588331	BolC1t01135H	0	+	811	2101	2101	1.0000000
C1	6602327	6603923	BolC1t01136H	0	+	662	1591	1596	0.9968672
C1	6605558	6606479	BolC1t01137H	0	-	23	314	921	0.3409338
C1	6614193	6614881	BolC1t01138H	0	-	211	688	688	1.0000000
C1	6616018	6616903	BolC1t01139H	0	-	33	476	885	0.5378531
C1	6619279	6620168	BolC1t01140H	0	+	472	889	889	1.0000000
C1	6620707	6622293	BolC1t01141H	0	-	738	1584	1586	0.9987389
C1	6624691	6625821	BolC1t01142H	0	+	827	1130	1130	1.0000000
C1	6666135	6666666	BolC1t01143H	0	-	0	0	531	0.0000000
C1	6677994	6679059	BolC1t01144H	0	-	25	389	1065	0.3652582
C1	6690956	6691145	BolC1t01145H	0	+	12	133	189	0.7037037
C1	6691629	6692268	BolC1t01146H	0	-	87	600	639	0.9389671
C1	6703852	6706338	BolC1t01147H	0	-	28	857	2486	0.3447305
C1	6734138	6734756	BolC1t01148H	0	+	3	237	618	0.3834952
C1	6736307	6737346	BolC1t01149H	0	+	102	628	1039	0.6044273
C1	6741341	6741548	BolC1t01150H	0	-	11	136	207	0.6570048
C1	6750954	6751227	BolC1t01151H	0	+	0	0	273	0.0000000
C1	6752071	6754991	BolC1t01152H	0	+	1065	1043	2920	0.3571918
C1	6755757	6757164	BolC1t01153H	0	-	186	1052	1407	0.7476901
C1	6761203	6762531	BolC1t01154H	0	+	15	455	1328	0.3426205
C1	6765999	6768155	BolC1t01155H	0	-	157	712	2156	0.3302412
C1	6771279	6772448	BolC1t01156H	0	-	16	359	1169	0.3071001
C1	6790034	6792722	BolC1t01157H	0	-	861	2566	2688	0.9546131
C1	6796532	6799333	BolC1t01158H	0	-	989	2743	2801	0.9792931
C1	6800258	6801904	BolC1t01159H	0	+	47	671	1646	0.4076549
C1	6813388	6813970	BolC1t01160H	0	-	425	582	582	1.0000000
C1	6818317	6818521	BolC1t01161H	0	-	33	204	204	1.0000000
C1	6855783	6858478	BolC1t01162H	0	-	607	2218	2695	0.8230056
C1	6883323	6886513	BolC1t01163H	0	-	1274	2978	3190	0.9335423
C1	6887968	6889230	BolC1t01164H	0	-	766	1262	1262	1.0000000
C1	6890272	6890924	BolC1t01165H	0	-	180	597	652	0.9156442
C1	6895890	6896148	BolC1t01166H	0	+	277	258	258	1.0000000
C1	6899445	6902171	BolC1t01167H	0	+	926	2635	2726	0.9666178
C1	6902471	6905982	BolC1t01168H	0	-	1010	3201	3511	0.9117061
C1	6906722	6906962	BolC1t01169H	0	+	384	240	240	1.0000000
C1	6911243	6911396	BolC1t01170H	0	+	191	153	153	1.0000000
C1	6917124	6918529	BolC1t01171H	0	+	67	1300	1405	0.9252669
C1	6927841	6929258	BolC1t01172H	0	+	390	1287	1417	0.9082569
C1	6949785	6950939	BolC1t01173H	0	+	72	884	1154	0.7660312
C1	6955812	6960527	BolC1t01174H	0	+	1343	3402	4715	0.7215270
C1	6962508	6963600	BolC1t01175H	0	-	868	1092	1092	1.0000000
C1	6978516	6988695	BolC1t01176H	0	+	846	3046	10179	0.2992435
C1	6990087	6990315	BolC1t01177H	0	-	266	228	228	1.0000000
C1	7001781	7003447	BolC1t01178H	0	-	1382	1666	1666	1.0000000
C1	7009766	7010617	BolC1t01179H	0	-	1001	851	851	1.0000000
C1	7016567	7019564	BolC1t01180H	0	-	2731	2997	2997	1.0000000
C1	7023924	7025015	BolC1t01181H	0	-	682	1082	1091	0.9917507
C1	7030024	7030180	BolC1t01182H	0	-	156	156	156	1.0000000
C1	7035944	7037505	BolC1t01183H	0	+	12	521	1561	0.3337604
C1	7052354	7052721	BolC1t01184H	0	+	10	92	367	0.2506812
C1	7058102	7058510	BolC1t01185H	0	+	602	408	408	1.0000000
C1	7058834	7060175	BolC1t01186H	0	+	1613	1341	1341	1.0000000
C1	7072115	7072397	BolC1t01187H	0	+	80	256	282	0.9078014
C1	7077851	7078109	BolC1t01188H	0	+	0	0	258	0.0000000
C1	7139705	7142720	BolC1t01189H	0	+	1295	2975	3015	0.9867330
C1	7143160	7143640	BolC1t01190H	0	+	254	480	480	1.0000000
C1	7146000	7146231	BolC1t01191H	0	+	390	231	231	1.0000000
C1	7151343	7151904	BolC1t01192H	0	+	266	561	561	1.0000000
C1	7156091	7157099	BolC1t01193H	0	-	311	1008	1008	1.0000000
C1	7157465	7157621	BolC1t01194H	0	-	101	156	156	1.0000000
C1	7160328	7162077	BolC1t01195H	0	-	262	776	1749	0.4436821
C1	7173484	7174008	BolC1t01196H	0	+	538	524	524	1.0000000
C1	7179639	7181385	BolC1t01197H	0	+	111	602	1746	0.3447881
C1	7189464	7191674	BolC1t01198H	0	-	1921	2210	2210	1.0000000
C1	7199609	7201082	BolC1t01199H	0	+	1270	1473	1473	1.0000000
C1	7201264	7201609	BolC1t01200H	0	-	135	320	345	0.9275362
C1	7202804	7205176	BolC1t01201H	0	+	1339	2372	2372	1.0000000
C1	7208085	7209213	BolC1t01202H	0	+	121	948	1128	0.8404256
C1	7222440	7223517	BolC1t01203H	0	-	127	1070	1077	0.9935005
C1	7235440	7235695	BolC1t01204H	0	+	326	255	255	1.0000000
C1	7235852	7236714	BolC1t01205H	0	-	623	862	862	1.0000000
C1	7237270	7237507	BolC1t01206H	0	+	50	218	237	0.9198312
C1	7237820	7238066	BolC1t01207H	0	-	1	50	246	0.2032520
C1	7240598	7241273	BolC1t01208H	0	-	64	420	675	0.6222222
C1	7244383	7245618	BolC1t01209H	0	-	60	724	1235	0.5862348
C1	7247187	7250888	BolC1t01210H	0	-	1705	3532	3701	0.9543366
C1	7266719	7267051	BolC1t01211H	0	-	301	332	332	1.0000000
C1	7272975	7274225	BolC1t01212H	0	-	284	1247	1250	0.9976000
C1	7278799	7279300	BolC1t01213H	0	-	430	501	501	1.0000000
C1	7289994	7292406	BolC1t01214H	0	+	960	2041	2412	0.8461857
C1	7292680	7293784	BolC1t01215H	0	-	119	949	1104	0.8596014
C1	7294054	7298469	BolC1t01216H	0	+	3339	4248	4415	0.9621744
C1	7298783	7300249	BolC1t01217H	0	-	302	1249	1466	0.8519782
C1	7305539	7311134	BolC1t01218H	0	+	1952	5298	5595	0.9469169
C1	7312320	7314736	BolC1t01219H	0	+	374	2069	2416	0.8563741
C1	7322620	7322857	BolC1t01220H	0	+	9	114	237	0.4810127
C1	7330659	7330998	BolC1t01221H	0	-	184	339	339	1.0000000
C1	7332406	7334962	BolC1t01222H	0	+	896	2510	2556	0.9820032
C1	7337760	7339672	BolC1t01223H	0	-	312	1817	1912	0.9503138
C1	7352129	7354638	BolC1t01224H	0	-	858	1854	2509	0.7389398
C1	7356883	7357867	BolC1t01225H	0	+	65	914	984	0.9288618
C1	7368490	7371297	BolC1t01226H	0	+	581	2653	2807	0.9451371
C1	7371568	7372369	BolC1t01227H	0	-	618	765	801	0.9550562
C1	7373381	7375257	BolC1t01228H	0	+	1154	1801	1876	0.9600213
C1	7375664	7376261	BolC1t01229H	0	+	28	487	597	0.8157454
C1	7376663	7384469	BolC1t01230H	0	-	567	4330	7806	0.5547015
C1	7389904	7390486	BolC1t01231H	0	+	31	266	582	0.4570447
C1	7391402	7392205	BolC1t01232H	0	-	787	803	803	1.0000000
C1	7394615	7394906	BolC1t01233H	0	+	206	291	291	1.0000000
C1	7396668	7396920	BolC1t01234H	0	-	3	105	252	0.4166667
C1	7398160	7398661	BolC1t01235H	0	+	47	243	501	0.4850299
C1	7402566	7404069	BolC1t01236H	0	+	147	1074	1503	0.7145709
C1	7405699	7408675	BolC1t01237H	0	+	166	1731	2976	0.5816532
C1	7409635	7410608	BolC1t01238H	0	+	727	973	973	1.0000000
C1	7413266	7414268	BolC1t01239H	0	-	41	586	1002	0.5848303
C1	7422896	7423402	BolC1t01240H	0	+	181	303	506	0.5988142
C1	7424351	7424757	BolC1t01241H	0	+	124	406	406	1.0000000
C1	7424678	7426001	BolC1t01242H	0	+	516	1216	1323	0.9191232
C1	7430346	7432500	BolC1t01243H	0	-	1313	1141	2154	0.5297121
C1	7434819	7435994	BolC1t01244H	0	+	892	1175	1175	1.0000000
C1	7439575	7441000	BolC1t01245H	0	-	109	921	1425	0.6463158
C1	7443267	7444749	BolC1t01246H	0	-	220	1393	1482	0.9399460
C1	7458493	7460104	BolC1t01247H	0	+	965	1611	1611	1.0000000
C1	7461460	7462321	BolC1t01248H	0	+	546	861	861	1.0000000
C1	7462558	7463482	BolC1t01249H	0	-	1110	924	924	1.0000000
C1	7463789	7466402	BolC1t01250H	0	+	626	2558	2613	0.9789514
C1	7466975	7468271	BolC1t01251H	0	-	1472	1296	1296	1.0000000
C1	7475298	7477072	BolC1t01252H	0	+	1240	1774	1774	1.0000000
C1	7483649	7484501	BolC1t01253H	0	-	33	446	852	0.5234742
C1	7485135	7486386	BolC1t01254H	0	-	116	695	1251	0.5555556
C1	7493538	7494717	BolC1t01255H	0	-	934	1179	1179	1.0000000
C1	7507185	7508055	BolC1t01256H	0	-	234	870	870	1.0000000
C1	7509236	7512786	BolC1t01257H	0	-	4034	3519	3550	0.9912676
C1	7517842	7518236	BolC1t01258H	0	+	40	314	394	0.7969543
C1	7526577	7526844	BolC1t01259H	0	-	0	0	267	0.0000000
C1	7526934	7529009	BolC1t01260H	0	+	43	635	2075	0.3060241
C1	7535649	7539049	BolC1t01261H	0	-	1121	3354	3400	0.9864706
C1	7552332	7556199	BolC1t01262H	0	+	2904	3741	3867	0.9674166
C1	7560246	7561230	BolC1t01263H	0	+	548	984	984	1.0000000
C1	7561383	7562994	BolC1t01264H	0	-	474	1510	1611	0.9373060
C1	7564145	7565318	BolC1t01265H	0	-	655	1173	1173	1.0000000
C1	7572354	7573084	BolC1t01266H	0	-	246	730	730	1.0000000
C1	7574766	7576021	BolC1t01267H	0	-	897	1234	1255	0.9832669
C1	7590184	7592488	BolC1t01268H	0	+	822	2149	2304	0.9327257
C1	7594038	7596723	BolC1t01269H	0	+	665	2252	2685	0.8387337
C1	7615748	7616980	BolC1t01270H	0	+	439	1232	1232	1.0000000
C1	7618495	7627261	BolC1t01271H	0	+	4064	8264	8766	0.9427333
C1	7636800	7639131	BolC1t01272H	0	+	806	2128	2331	0.9129129
C1	7654824	7659531	BolC1t01273H	0	+	2934	4707	4707	1.0000000
C1	7661761	7663887	BolC1t01274H	0	+	18	290	2126	0.1364064
C1	7666223	7666868	BolC1t01275H	0	-	119	240	645	0.3720930
C1	7667933	7669256	BolC1t01276H	0	-	791	1323	1323	1.0000000
C1	7673874	7674210	BolC1t01277H	0	+	31	263	336	0.7827381
C1	7676277	7678505	BolC1t01278H	0	-	219	1841	2228	0.8263016
C1	7685058	7689337	BolC1t01279H	0	-	2149	4245	4279	0.9920542
C1	7697313	7703242	BolC1t01280H	0	+	641	3686	5929	0.6216900
C1	7704069	7709541	BolC1t01281H	0	-	1686	5058	5472	0.9243421
C1	7713471	7716906	BolC1t01282H	0	-	665	3148	3435	0.9164484
C1	7719091	7720240	BolC1t01283H	0	-	275	1113	1149	0.9686684
C1	7725447	7728682	BolC1t01284H	0	-	1291	3176	3235	0.9817620
C1	7747295	7749282	BolC1t01285H	0	-	584	1803	1987	0.9073981
C1	7749861	7751186	BolC1t01286H	0	+	620	1325	1325	1.0000000
C1	7751398	7752603	BolC1t01287H	0	-	774	1205	1205	1.0000000
C1	7756339	7758837	BolC1t01288H	0	-	7067	2498	2498	1.0000000
C1	7772661	7774727	BolC1t01289H	0	+	854	1953	2066	0.9453049
C1	7788679	7790461	BolC1t01290H	0	+	278	1672	1782	0.9382716
C1	7805565	7805792	BolC1t01291H	0	-	306	227	227	1.0000000
C1	7805843	7813183	BolC1t01292H	0	-	3891	2554	7340	0.3479564
C1	7806136	7816423	BolC1t01293H	0	-	5021	5083	10287	0.4941188
C1	7816965	7819509	BolC1t01294H	0	+	875	2239	2544	0.8801101
C1	7821797	7822860	BolC1t01295H	0	+	618	1032	1063	0.9708372
C1	7823402	7829894	BolC1t01296H	0	-	2436	4882	6492	0.7520025
C1	7830985	7832126	BolC1t01297H	0	+	490	1048	1141	0.9184926
C1	7834238	7836980	BolC1t01298H	0	+	972	2367	2742	0.8632385
C1	7851405	7852115	BolC1t01299H	0	-	69	384	710	0.5408451
C1	7852183	7852570	BolC1t01300H	0	-	0	0	387	0.0000000
C1	7893191	7895355	BolC1t01301H	0	+	445	2009	2164	0.9283734
C1	7915408	7916905	BolC1t01302H	0	-	826	1497	1497	1.0000000
C1	7917813	7919707	BolC1t01303H	0	+	108	487	1894	0.2571278
C1	7918230	7918794	BolC1t01304H	0	+	0	0	564	0.0000000
C1	7922827	7923357	BolC1t01305H	0	+	254	530	530	1.0000000
C1	7926868	7928302	BolC1t01306H	0	+	184	1061	1434	0.7398884
C1	7930678	7931146	BolC1t01307H	0	+	231	468	468	1.0000000
C1	7953827	7955058	BolC1t01308H	0	-	10	145	1231	0.1177904
C1	7956368	7966483	BolC1t01309H	0	-	2491	5297	10115	0.5236777
C1	7986522	7988024	BolC1t01310H	0	-	744	1460	1502	0.9720373
C1	8009840	8015414	BolC1t01311H	0	-	2340	5278	5574	0.9468963
C1	8018978	8024839	BolC1t01312H	0	-	2735	5148	5861	0.8783484
C1	8057983	8058577	BolC1t01313H	0	-	67	213	594	0.3585859
C1	8060430	8060682	BolC1t01314H	0	+	48	252	252	1.0000000
C1	8066917	8067883	BolC1t01315H	0	-	683	966	966	1.0000000
C1	8069558	8069669	BolC1t01316H	0	-	0	0	111	0.0000000
C1	8096587	8097967	BolC1t01317H	0	-	112	518	1380	0.3753623
C1	8098661	8101932	BolC1t01318H	0	+	252	2165	3271	0.6618771
C1	8102472	8104002	BolC1t01319H	0	-	144	1094	1530	0.7150327
C1	8112515	8141857	BolC1t01320H	0	+	14798	26484	29342	0.9025970
C1	8121949	8128568	BolC1t01321H	0	+	3703	6263	6619	0.9462155
C1	8130991	8133390	BolC1t01322H	0	-	1083	2325	2399	0.9691538
C1	8146269	8147820	BolC1t01323H	0	+	1248	1551	1551	1.0000000
C1	8154267	8156292	BolC1t01324H	0	+	1585	2025	2025	1.0000000
C1	8157752	8159693	BolC1t01325H	0	+	1920	1941	1941	1.0000000
C1	8164827	8165268	BolC1t01326H	0	+	354	441	441	1.0000000
C1	8168507	8169824	BolC1t01327H	0	+	1116	1317	1317	1.0000000
C1	8170805	8178463	BolC1t01328H	0	+	2629	7354	7658	0.9603029
C1	8180307	8180876	BolC1t01329H	0	-	387	569	569	1.0000000
C1	8182805	8183579	BolC1t01330H	0	+	46	418	774	0.5400517
C1	8192731	8193433	BolC1t01331H	0	+	4	263	702	0.3746439
C1	8195036	8196753	BolC1t01332H	0	-	398	1404	1717	0.8177053
C1	8204878	8206248	BolC1t01333H	0	-	546	1234	1370	0.9007300
C1	8209379	8209649	BolC1t01334H	0	+	232	270	270	1.0000000
C1	8212760	8213288	BolC1t01335H	0	+	103	485	528	0.9185606
C1	8214062	8216829	BolC1t01336H	0	+	204	1476	2767	0.5334297
C1	8221855	8222761	BolC1t01337H	0	-	731	810	906	0.8940398
C1	8225167	8226934	BolC1t01338H	0	+	444	1679	1767	0.9501981
C1	8227430	8230921	BolC1t01339H	0	-	1518	3463	3491	0.9919794
C1	8231656	8231980	BolC1t01340H	0	+	10	248	324	0.7654321
C1	8248741	8250752	BolC1t01341H	0	-	582	1856	2011	0.9229239
C1	8252382	8254644	BolC1t01342H	0	-	742	2073	2262	0.9164456
C1	8264799	8266108	BolC1t01343H	0	+	43	378	1309	0.2887700
C1	8277682	8277865	BolC1t01344H	0	+	0	0	183	0.0000000
C1	8278830	8280051	BolC1t01345H	0	+	102	965	1221	0.7903358
C1	8290895	8292097	BolC1t01346H	0	+	433	1115	1202	0.9276206
C1	8309257	8309598	BolC1t01347H	0	+	234	341	341	1.0000000
C1	8313038	8314305	BolC1t01348H	0	+	85	282	1267	0.2225730
C1	8324125	8325127	BolC1t01349H	0	-	33	421	1002	0.4201597
C1	8343687	8343849	BolC1t01350H	0	-	171	162	162	1.0000000
C1	8360264	8364860	BolC1t01351H	0	+	790	3843	4596	0.8361619
C1	8369742	8370063	BolC1t01352H	0	-	48	321	321	1.0000000
C1	8370747	8372574	BolC1t01353H	0	-	582	1581	1827	0.8653530
C1	8373319	8374385	BolC1t01354H	0	+	29	381	1066	0.3574109
C1	8376880	8378673	BolC1t01355H	0	-	363	1459	1793	0.8137200
C1	8398108	8399702	BolC1t01356H	0	+	1904	1594	1594	1.0000000
C1	8400790	8401698	BolC1t01357H	0	+	110	771	908	0.8491189
C1	8430245	8430972	BolC1t01358H	0	+	67	589	727	0.8101788
C1	8440639	8443124	BolC1t01359H	0	-	1461	2485	2485	1.0000000
C1	8444809	8454244	BolC1t01360H	0	-	804	4420	9435	0.4684685
C1	8457561	8459661	BolC1t01361H	0	-	480	1979	2100	0.9423810
C1	8460526	8461423	BolC1t01362H	0	+	717	897	897	1.0000000
C1	8466930	8470204	BolC1t01363H	0	+	446	2784	3274	0.8503360
C1	8481986	8484266	BolC1t01364H	0	+	838	1892	2280	0.8298246
C1	8497059	8497440	BolC1t01365H	0	-	337	381	381	1.0000000
C1	8503174	8504589	BolC1t01366H	0	-	1480	1415	1415	1.0000000
C1	8505700	8508373	BolC1t01367H	0	+	1323	2672	2673	0.9996259
C1	8523542	8524175	BolC1t01368H	0	+	417	633	633	1.0000000
C1	8535786	8537411	BolC1t01369H	0	-	394	1447	1625	0.8904616
C1	8537717	8538601	BolC1t01370H	0	+	932	884	884	1.0000000
C1	8538681	8540306	BolC1t01371H	0	-	569	1480	1625	0.9107692
C1	8547931	8550053	BolC1t01372H	0	-	804	1886	2122	0.8887842
C1	8554299	8558886	BolC1t01373H	0	-	3828	4587	4587	1.0000000
C1	8559924	8561862	BolC1t01374H	0	-	373	1489	1938	0.7683179
C1	8564825	8567815	BolC1t01375H	0	+	1424	2582	2990	0.8635452
C1	8569325	8572182	BolC1t01376H	0	-	81	1252	2857	0.4382219
C1	8575106	8579112	BolC1t01377H	0	+	1065	3926	4006	0.9800299
C1	8583846	8587049	BolC1t01378H	0	+	1024	2826	3203	0.8822979
C1	8591225	8595292	BolC1t01379H	0	+	1377	3418	4067	0.8404229
C1	8597703	8599757	BolC1t01380H	0	+	507	1926	2054	0.9376826
C1	8603028	8604192	BolC1t01381H	0	-	376	1141	1164	0.9802405
C1	8604661	8605254	BolC1t01382H	0	-	262	593	593	1.0000000
C1	8609783	8610152	BolC1t01383H	0	-	157	369	369	1.0000000
C1	8611198	8619795	BolC1t01384H	0	-	1734	5598	8597	0.6511574
C1	8621006	8622163	BolC1t01385H	0	-	357	1157	1157	1.0000000
C1	8637676	8638563	BolC1t01386H	0	+	641	887	887	1.0000000
C1	8638665	8639062	BolC1t01387H	0	+	516	397	397	1.0000000
C1	8641269	8644498	BolC1t01388H	0	+	608	2977	3229	0.9219573
C1	8654964	8658221	BolC1t01389H	0	+	458	2137	3257	0.6561252
C1	8668342	8673228	BolC1t01390H	0	+	1793	4764	4886	0.9750307
C1	8673911	8675920	BolC1t01391H	0	+	877	1955	2009	0.9731209
C1	8722909	8726652	BolC1t01392H	0	+	2021	3672	3743	0.9810312
C1	8727663	8738239	BolC1t01393H	0	+	3143	7839	10576	0.7412065
C1	8739092	8741091	BolC1t01394H	0	-	1867	1965	1999	0.9829915
C1	8743413	8744597	BolC1t01395H	0	+	1201	1184	1184	1.0000000
C1	8745595	8745781	BolC1t01396H	0	-	111	186	186	1.0000000
C1	8746310	8750734	BolC1t01397H	0	+	919	3867	4424	0.8740959
C1	8751280	8753681	BolC1t01398H	0	-	1326	2301	2401	0.9583507
C1	8754243	8754648	BolC1t01399H	0	+	558	405	405	1.0000000
C1	8754791	8758358	BolC1t01400H	0	-	660	2530	3567	0.7092795
C1	8760533	8761328	BolC1t01401H	0	-	93	520	795	0.6540881
C1	8770066	8771951	BolC1t01402H	0	-	539	1873	1885	0.9936339
C1	8779120	8782001	BolC1t01403H	0	+	642	2100	2881	0.7289135
C1	8782075	8783499	BolC1t01404H	0	+	735	1424	1424	1.0000000
C1	8783730	8786031	BolC1t01405H	0	-	1288	2129	2301	0.9252499
C1	8786927	8791958	BolC1t01406H	0	+	3238	5031	5031	1.0000000
C1	8797267	8797843	BolC1t01407H	0	-	393	576	576	1.0000000
C1	8798789	8800411	BolC1t01408H	0	-	406	1526	1622	0.9408138
C1	8803973	8805557	BolC1t01409H	0	+	14	544	1584	0.3434343
C1	8806970	8808551	BolC1t01410H	0	+	82	868	1581	0.5490196
C1	8809931	8811539	BolC1t01411H	0	+	146	1179	1608	0.7332090
C1	8813689	8814163	BolC1t01412H	0	+	316	474	474	1.0000000
C1	8821362	8824870	BolC1t01413H	0	-	22	348	3508	0.0992018
C1	8845472	8846229	BolC1t01414H	0	+	209	716	757	0.9458388
C1	8858707	8858833	BolC1t01415H	0	-	127	126	126	1.0000000
C1	8861932	8862815	BolC1t01416H	0	+	364	883	883	1.0000000
C1	8880572	8882677	BolC1t01417H	0	+	881	2096	2105	0.9957244
C1	8888503	8890201	BolC1t01418H	0	+	124	876	1698	0.5159011
C1	8893445	8902212	BolC1t01419H	0	-	4292	8388	8767	0.9567697
C1	8907307	8907835	BolC1t01420H	0	-	0	0	528	0.0000000
C1	8914143	8915712	BolC1t01421H	0	+	75	1017	1569	0.6481836
C1	8919634	8920808	BolC1t01422H	0	-	399	1084	1174	0.9233390
C1	8928299	8929550	BolC1t01423H	0	-	513	1251	1251	1.0000000
C1	8932134	8932542	BolC1t01424H	0	-	622	408	408	1.0000000
C1	8942185	8943830	BolC1t01425H	0	+	480	1549	1645	0.9416413
C1	8944437	8947984	BolC1t01426H	0	-	2421	3525	3547	0.9937976
C1	8950236	8951597	BolC1t01427H	0	-	486	1158	1361	0.8508450
C1	8952256	8955843	BolC1t01428H	0	-	957	3515	3587	0.9799275
C1	8963224	8967098	BolC1t01429H	0	+	670	3407	3874	0.8794528
C1	8971501	8973617	BolC1t01430H	0	+	316	2006	2116	0.9480151
C1	8991615	8991921	BolC1t01431H	0	+	102	306	306	1.0000000
C1	8996932	8997586	BolC1t01432H	0	-	0	0	654	0.0000000
C1	9024767	9025025	BolC1t01433H	0	-	57	202	258	0.7829458
C1	9027416	9028380	BolC1t01434H	0	+	1237	964	964	1.0000000
C1	9030149	9042133	BolC1t01435H	0	+	6836	11086	11984	0.9250668
C1	9043350	9044621	BolC1t01436H	0	+	290	1219	1271	0.9590873
C1	9046522	9047260	BolC1t01437H	0	+	254	563	738	0.7628726
C1	9051090	9051264	BolC1t01438H	0	+	0	0	174	0.0000000
C1	9052441	9052591	BolC1t01439H	0	-	34	96	150	0.6400000
C1	9063712	9064444	BolC1t01440H	0	+	40	390	732	0.5327869
C1	9068870	9069281	BolC1t01441H	0	+	68	411	411	1.0000000
C1	9084801	9085536	BolC1t01442H	0	+	397	633	735	0.8612245
C1	9088197	9088836	BolC1t01443H	0	+	254	629	639	0.9843506
C1	9097334	9097550	BolC1t01444H	0	+	0	0	216	0.0000000
C1	9097334	9098607	BolC1t01445H	0	+	0	0	1273	0.0000000
C1	9102055	9102241	BolC1t01446H	0	-	19	186	186	1.0000000
C1	9104396	9116371	BolC1t01447H	0	+	3167	7726	11975	0.6451774
C1	9111734	9112043	BolC1t01448H	0	+	389	309	309	1.0000000
C1	9117369	9119241	BolC1t01449H	0	+	642	1621	1872	0.8659188
C1	9121245	9125486	BolC1t01450H	0	+	3898	4210	4241	0.9926904
C1	9125875	9127240	BolC1t01451H	0	-	1257	1365	1365	1.0000000
C1	9129737	9130210	BolC1t01452H	0	+	256	473	473	1.0000000
C1	9130830	9132396	BolC1t01453H	0	-	489	1385	1566	0.8844189
C1	9136224	9137059	BolC1t01454H	0	+	451	828	835	0.9916168
C1	9137858	9139007	BolC1t01455H	0	-	785	1149	1149	1.0000000
C1	9141314	9142037	BolC1t01456H	0	-	406	723	723	1.0000000
C1	9148289	9153872	BolC1t01457H	0	-	968	4266	5583	0.7641053
C1	9161448	9166225	BolC1t01458H	0	+	1860	4187	4777	0.8764915
C1	9167048	9168755	BolC1t01459H	0	+	749	1696	1707	0.9935560
C1	9168847	9170566	BolC1t01460H	0	-	373	1512	1719	0.8795812
C1	9171363	9174001	BolC1t01461H	0	+	776	2440	2638	0.9249431
C1	9174288	9175567	BolC1t01462H	0	-	273	819	1279	0.6403440
C1	9195870	9200624	BolC1t01463H	0	+	1339	3997	4754	0.8407657
C1	9201323	9202902	BolC1t01464H	0	+	146	1168	1579	0.7397087
C1	9206207	9209056	BolC1t01465H	0	-	555	2175	2849	0.7634258
C1	9216895	9217998	BolC1t01466H	0	-	648	1103	1103	1.0000000
C1	9218106	9219348	BolC1t01467H	0	-	1064	1242	1242	1.0000000
C1	9220968	9222548	BolC1t01468H	0	+	87	720	1580	0.4556962
C1	9224354	9224486	BolC1t01469H	0	+	0	0	132	0.0000000
C1	9225844	9226154	BolC1t01470H	0	+	5	47	310	0.1516129
C1	9229620	9230112	BolC1t01471H	0	+	308	492	492	1.0000000
C1	9230268	9230443	BolC1t01472H	0	+	62	175	175	1.0000000
C1	9237604	9238475	BolC1t01473H	0	+	348	806	871	0.9253731
C1	9239139	9241692	BolC1t01474H	0	+	1097	2502	2553	0.9800235
C1	9241766	9242438	BolC1t01475H	0	-	133	534	672	0.7946429
C1	9243170	9244175	BolC1t01476H	0	+	414	989	1005	0.9840796
C1	9246246	9247067	BolC1t01477H	0	+	248	724	821	0.8818514
C1	9267900	9269557	BolC1t01478H	0	+	968	1657	1657	1.0000000
C1	9270241	9270678	BolC1t01479H	0	-	955	437	437	1.0000000
C1	9275242	9276042	BolC1t01480H	0	-	1196	800	800	1.0000000
C1	9283203	9284307	BolC1t01481H	0	-	374	1092	1104	0.9891304
C1	9285540	9307347	BolC1t01482H	0	-	4613	12023	21807	0.5513367
C1	9288021	9289218	BolC1t01483H	0	-	6	274	1197	0.2289056
C1	9313255	9314434	BolC1t01484H	0	+	103	355	1179	0.3011026
C1	9318383	9318779	BolC1t01485H	0	-	44	324	396	0.8181818
C1	9326800	9327403	BolC1t01486H	0	+	206	586	603	0.9718076
C1	9327804	9331973	BolC1t01487H	0	-	2573	3814	4169	0.9148477
C1	9336291	9337106	BolC1t01488H	0	+	511	815	815	1.0000000
C1	9337208	9337619	BolC1t01489H	0	+	329	411	411	1.0000000
C1	9350710	9351969	BolC1t01490H	0	-	58	747	1259	0.5933281
C1	9370222	9371059	BolC1t01491H	0	+	241	837	837	1.0000000
C1	9372423	9374218	BolC1t01492H	0	+	493	1734	1795	0.9660167
C1	9374583	9376628	BolC1t01493H	0	+	1629	2045	2045	1.0000000
C1	9376955	9379561	BolC1t01494H	0	-	895	2212	2606	0.8488104
C1	9380986	9381337	BolC1t01495H	0	-	385	351	351	1.0000000
C1	9396955	9398464	BolC1t01496H	0	+	72	935	1509	0.6196156
C1	9399084	9399816	BolC1t01497H	0	-	588	732	732	1.0000000
C1	9407385	9408172	BolC1t01498H	0	-	56	209	787	0.2655654
C1	9408733	9411476	BolC1t01499H	0	-	2277	2743	2743	1.0000000
C1	9411941	9416912	BolC1t01500H	0	+	3345	4944	4971	0.9945685
C1	9417737	9422844	BolC1t01501H	0	+	3264	5100	5107	0.9986293
C1	9423417	9424047	BolC1t01502H	0	-	427	630	630	1.0000000
C1	9425655	9426781	BolC1t01503H	0	-	644	1126	1126	1.0000000
C1	9437429	9438647	BolC1t01504H	0	+	386	1181	1218	0.9696223
C1	9439565	9441462	BolC1t01505H	0	-	907	1897	1897	1.0000000
C1	9449407	9450914	BolC1t01506H	0	+	667	1463	1507	0.9708029
C1	9453192	9454914	BolC1t01507H	0	+	1126	1722	1722	1.0000000
C1	9462333	9464014	BolC1t01508H	0	+	1709	1681	1681	1.0000000
C1	9465652	9471006	BolC1t01509H	0	+	1239	3774	5354	0.7048935
C1	9479557	9482672	BolC1t01510H	0	-	1131	3021	3115	0.9698234
C1	9483258	9488440	BolC1t01511H	0	-	909	3976	5182	0.7672713
C1	9489831	9490862	BolC1t01512H	0	+	308	789	1031	0.7652764
C1	9493197	9497924	BolC1t01513H	0	+	1304	3950	4727	0.8356251
C1	9498431	9499387	BolC1t01514H	0	-	254	772	956	0.8075314
C1	9505267	9505726	BolC1t01515H	0	-	666	459	459	1.0000000
C1	9506423	9506921	BolC1t01516H	0	-	333	498	498	1.0000000
C1	9508083	9510109	BolC1t01517H	0	-	74	1137	2026	0.5612043
C1	9527740	9529795	BolC1t01518H	0	+	646	1216	2055	0.5917275
C1	9537239	9544631	BolC1t01519H	0	-	2355	6777	7392	0.9168019
C1	9546558	9546717	BolC1t01520H	0	-	73	159	159	1.0000000
C1	9547688	9548610	BolC1t01521H	0	-	219	877	922	0.9511930
C1	9550343	9554337	BolC1t01522H	0	+	1935	3597	3994	0.9006009
C1	9556949	9563135	BolC1t01523H	0	-	970	4161	6186	0.6726479
C1	9563404	9564919	BolC1t01524H	0	+	1316	1515	1515	1.0000000
C1	9568321	9568747	BolC1t01525H	0	+	201	426	426	1.0000000
C1	9582264	9582936	BolC1t01526H	0	-	36	398	672	0.5922619
C1	9594201	9594775	BolC1t01527H	0	+	206	474	574	0.8257840
C1	9605129	9606142	BolC1t01528H	0	+	159	893	1013	0.8815400
C1	9617928	9620178	BolC1t01529H	0	+	1537	2250	2250	1.0000000
C1	9661943	9665028	BolC1t01530H	0	+	1049	2942	3085	0.9536467
C1	9667937	9677512	BolC1t01531H	0	+	4009	9312	9575	0.9725326
C1	9679150	9681451	BolC1t01532H	0	-	479	2301	2301	1.0000000
C1	9697139	9697490	BolC1t01533H	0	+	12	212	351	0.6039886
C1	9698912	9704122	BolC1t01534H	0	+	2131	4737	5210	0.9092131
C1	9709225	9711472	BolC1t01535H	0	+	1288	2211	2247	0.9839786
C1	9712291	9715573	BolC1t01536H	0	+	1602	3033	3282	0.9241316
C1	9715926	9717541	BolC1t01537H	0	-	668	1581	1615	0.9789473
C1	9718875	9725450	BolC1t01538H	0	+	1117	4598	6575	0.6993156
C1	9745566	9749075	BolC1t01539H	0	+	758	2465	3509	0.7024794
C1	9751997	9753494	BolC1t01540H	0	-	854	1373	1497	0.9171677
C1	9754417	9754945	BolC1t01541H	0	-	123	528	528	1.0000000
C1	9755934	9760409	BolC1t01542H	0	+	1428	3804	4475	0.8500559
C1	9760516	9762412	BolC1t01543H	0	-	121	1340	1896	0.7067510
C1	9763196	9764006	BolC1t01544H	0	-	337	810	810	1.0000000
C1	9781276	9781891	BolC1t01545H	0	-	58	615	615	1.0000000
C1	9785003	9785198	BolC1t01546H	0	-	34	195	195	1.0000000
C1	9785761	9786562	BolC1t01547H	0	-	280	688	801	0.8589264
C1	9811923	9812184	BolC1t01548H	0	-	4	261	261	1.0000000
C1	9886929	9887730	BolC1t01549H	0	-	54	473	801	0.5905119
C1	9891853	9892660	BolC1t01550H	0	-	0	0	807	0.0000000
C1	9911121	9944199	BolC1t01551H	0	-	3343	19231	33078	0.5813834
C1	9923735	9924077	BolC1t01552H	0	-	16	326	342	0.9532164
C1	9948078	9948885	BolC1t01553H	0	-	22	430	807	0.5328377
C1	9960020	9960257	BolC1t01554H	0	-	11	136	237	0.5738397
C1	9960885	9963448	BolC1t01555H	0	-	215	1130	2563	0.4408896
C1	9970403	9970840	BolC1t01556H	0	+	82	257	437	0.5881007
C1	9974523	9974877	BolC1t01557H	0	+	38	233	354	0.6581921
C1	9981614	9985185	BolC1t01558H	0	-	1576	2982	3571	0.8350602
C1	10008415	10008733	BolC1t01559H	0	-	210	318	318	1.0000000
C1	10017603	10019867	BolC1t01560H	0	+	100	1483	2264	0.6550353
C1	10023381	10023858	BolC1t01561H	0	-	49	440	477	0.9224319
C1	10029025	10029223	BolC1t01562H	0	+	195	198	198	1.0000000
C1	10037420	10037942	BolC1t01563H	0	+	137	522	522	1.0000000
C1	10038214	10040644	BolC1t01564H	0	+	1053	1961	2430	0.8069959
C1	10050249	10051991	BolC1t01565H	0	-	3	211	1742	0.1211251
C1	10059234	10059493	BolC1t01566H	0	+	23	259	259	1.0000000
C1	10059555	10060017	BolC1t01567H	0	+	1	105	462	0.2272727
C1	10061731	10062575	BolC1t01568H	0	+	135	768	844	0.9099526
C1	10063999	10064515	BolC1t01569H	0	-	326	516	516	1.0000000
C1	10065655	10066048	BolC1t01570H	0	-	84	388	393	0.9872773
C1	10091411	10094387	BolC1t01571H	0	+	185	2578	2976	0.8662634
C1	10107249	10110718	BolC1t01572H	0	+	789	2583	3469	0.7445950
C1	10123320	10124540	BolC1t01573H	0	+	6847	1220	1220	1.0000000
C1	10127656	10130627	BolC1t01574H	0	-	575	2335	2971	0.7859306
C1	10138889	10144949	BolC1t01575H	0	-	1341	5446	6060	0.8986799
C1	10146904	10147357	BolC1t01576H	0	-	357	453	453	1.0000000
C1	10148227	10152295	BolC1t01577H	0	-	2275	4047	4068	0.9948378
C1	10163921	10164539	BolC1t01578H	0	-	87	594	618	0.9611651
C1	10165947	10166461	BolC1t01579H	0	-	2	19	514	0.0369650
C1	10172813	10173254	BolC1t01580H	0	-	4	38	441	0.0861678
C1	10183750	10186546	BolC1t01581H	0	-	369	2245	2796	0.8029327
C1	10199235	10203041	BolC1t01582H	0	+	1358	3465	3806	0.9104046
C1	10203662	10205718	BolC1t01583H	0	-	960	2056	2056	1.0000000
C1	10214328	10215566	BolC1t01584H	0	-	418	1070	1238	0.8642973
C1	10216325	10216899	BolC1t01585H	0	+	26	154	574	0.2682927
C1	10217205	10218880	BolC1t01586H	0	-	343	1490	1675	0.8895522
C1	10231981	10235038	BolC1t01587H	0	-	1264	2992	3057	0.9787373
C1	10235594	10236689	BolC1t01588H	0	+	1438	1067	1095	0.9744292
C1	10237660	10242790	BolC1t01589H	0	+	2030	3750	5130	0.7309942
C1	10240336	10241597	BolC1t01590H	0	-	26	174	1261	0.1379857
C1	10249421	10249668	BolC1t01591H	0	+	118	247	247	1.0000000
C1	10249724	10250875	BolC1t01592H	0	+	761	1151	1151	1.0000000
C1	10253982	10254990	BolC1t01593H	0	-	931	1008	1008	1.0000000
C1	10261426	10266990	BolC1t01594H	0	-	1535	4183	5564	0.7517973
C1	10277725	10277854	BolC1t01595H	0	+	109	129	129	1.0000000
C1	10285335	10285485	BolC1t01596H	0	+	3	115	150	0.7666667
C1	10299096	10300402	BolC1t01597H	0	+	464	777	1306	0.5949464
C1	10309611	10310417	BolC1t01598H	0	-	679	752	806	0.9330025
C1	10316652	10317684	BolC1t01599H	0	-	151	888	1032	0.8604651
C1	10318739	10319363	BolC1t01600H	0	-	92	624	624	1.0000000
C1	10320135	10322107	BolC1t01601H	0	-	983	1961	1972	0.9944219
C1	10323434	10325579	BolC1t01602H	0	+	625	2081	2145	0.9701632
C1	10326568	10328380	BolC1t01603H	0	-	303	1362	1812	0.7516556
C1	10345128	10345759	BolC1t01604H	0	+	744	631	631	1.0000000
C1	10366747	10367856	BolC1t01605H	0	+	364	1109	1109	1.0000000
C1	10368499	10369640	BolC1t01606H	0	-	1030	1141	1141	1.0000000
C1	10388663	10389508	BolC1t01607H	0	+	541	843	845	0.9976332
C1	10389898	10392084	BolC1t01608H	0	-	762	2089	2186	0.9556267
C1	10404261	10407061	BolC1t01609H	0	-	1578	2546	2800	0.9092857
C1	10407833	10409379	BolC1t01610H	0	+	620	1546	1546	1.0000000
C1	10410024	10411295	BolC1t01611H	0	-	953	1271	1271	1.0000000
C1	10411695	10412308	BolC1t01612H	0	-	531	613	613	1.0000000
C1	10412585	10414300	BolC1t01613H	0	+	1237	1715	1715	1.0000000
C1	10414358	10414565	BolC1t01614H	0	+	174	207	207	1.0000000
C1	10423708	10425276	BolC1t01615H	0	-	640	1494	1568	0.9528061
C1	10426763	10427037	BolC1t01616H	0	-	0	0	274	0.0000000
C1	10435543	10435957	BolC1t01617H	0	-	1	46	414	0.1111111
C1	10439532	10440518	BolC1t01618H	0	-	1400	880	986	0.8924949
C1	10442865	10443237	BolC1t01619H	0	-	119	372	372	1.0000000
C1	10465412	10466643	BolC1t01620H	0	+	2553	1231	1231	1.0000000
C1	10472012	10472198	BolC1t01621H	0	+	1	48	186	0.2580645
C1	10475629	10476096	BolC1t01622H	0	+	55	392	467	0.8394004
C1	10478200	10478527	BolC1t01623H	0	+	2	191	327	0.5840979
C1	10511902	10512247	BolC1t01624H	0	+	11	48	345	0.1391304
C1	10512866	10513930	BolC1t01625H	0	-	367	980	1064	0.9210526
C1	10514692	10519029	BolC1t01626H	0	-	700	3527	4337	0.8132349
C1	10543378	10544014	BolC1t01627H	0	-	653	636	636	1.0000000
C1	10553633	10554947	BolC1t01628H	0	-	207	915	1314	0.6963471
C1	10555906	10557548	BolC1t01629H	0	-	469	1400	1642	0.8526188
C1	10565190	10565480	BolC1t01630H	0	+	3	197	290	0.6793103
C1	10586154	10586970	BolC1t01631H	0	-	206	632	816	0.7745098
C1	10594723	10595203	BolC1t01632H	0	+	114	480	480	1.0000000
C1	10603625	10604456	BolC1t01633H	0	+	22	396	831	0.4765343
C1	10606876	10607326	BolC1t01634H	0	+	24	293	450	0.6511111
C1	10613576	10615635	BolC1t01635H	0	+	2063	2059	2059	1.0000000
C1	10617679	10618982	BolC1t01636H	0	-	1335	1303	1303	1.0000000
C1	10634223	10635798	BolC1t01637H	0	+	140	922	1575	0.5853968
C1	10640482	10641688	BolC1t01638H	0	+	430	1206	1206	1.0000000
C1	10644420	10646853	BolC1t01639H	0	+	784	2364	2433	0.9716399
C1	10648165	10648635	BolC1t01640H	0	-	132	399	470	0.8489361
C1	10662005	10663706	BolC1t01641H	0	+	414	1255	1701	0.7378013
C1	10665713	10666090	BolC1t01642H	0	+	69	307	377	0.8143236
C1	10669895	10670549	BolC1t01643H	0	+	150	644	654	0.9847095
C1	10683211	10717746	BolC1t01644H	0	-	3364	13454	34535	0.3895758
C1	10684448	10685308	BolC1t01645H	0	-	0	0	860	0.0000000
C1	10691687	10692068	BolC1t01646H	0	+	0	0	381	0.0000000
C1	10700433	10701292	BolC1t01647H	0	-	24	242	859	0.2817229
C1	10724685	10725069	BolC1t01648H	0	+	2	104	384	0.2708333
C1	10727664	10782120	BolC1t01649H	0	-	9357	40050	54456	0.7354562
C1	10729346	10729833	BolC1t01650H	0	-	13	480	487	0.9856263
C1	10754211	10754595	BolC1t01651H	0	+	13	209	384	0.5442708
C1	10769695	10770115	BolC1t01652H	0	+	66	420	420	1.0000000
C1	10789691	10795384	BolC1t01653H	0	-	698	3507	5693	0.6160197
C1	10792159	10793101	BolC1t01654H	0	+	0	0	942	0.0000000
C1	10816002	10818617	BolC1t01655H	0	-	933	2174	2615	0.8313575
C1	10823433	10824544	BolC1t01656H	0	+	679	1109	1111	0.9981998
C1	10826885	10828634	BolC1t01657H	0	+	537	1741	1749	0.9954259
C1	10828798	10830200	BolC1t01658H	0	-	352	1313	1402	0.9365193
C1	10837510	10837879	BolC1t01659H	0	-	35	284	369	0.7696477
C1	10852581	10853151	BolC1t01660H	0	-	10	241	570	0.4228070
C1	10855412	10859040	BolC1t01661H	0	-	1654	3460	3628	0.9536935
C1	10861849	10862957	BolC1t01662H	0	+	1356	1108	1108	1.0000000
C1	10887459	10888974	BolC1t01663H	0	-	68	892	1515	0.5887789
C1	10890484	10891330	BolC1t01664H	0	-	2	19	846	0.0224586
C1	10891610	10892503	BolC1t01665H	0	-	1	53	893	0.0593505
C1	10915037	10915856	BolC1t01666H	0	-	0	0	819	0.0000000
C1	10924261	10928264	BolC1t01667H	0	+	995	3064	4003	0.7654259
C1	10929475	10930453	BolC1t01668H	0	+	33	679	978	0.6942740
C1	10941126	10942073	BolC1t01669H	0	-	436	947	947	1.0000000
C1	10949051	10950435	BolC1t01670H	0	+	493	1334	1384	0.9638728
C1	10958241	10961387	BolC1t01671H	0	+	1300	2872	3146	0.9129053
C1	10961862	10963230	BolC1t01672H	0	-	565	1368	1368	1.0000000
C1	10964357	10978330	BolC1t01673H	0	+	2276	4324	13973	0.3094539
C1	10973245	10973950	BolC1t01674H	0	+	0	0	705	0.0000000
C1	10979738	10981369	BolC1t01675H	0	+	653	1611	1631	0.9877376
C1	10984563	10986632	BolC1t01676H	0	+	688	1746	2069	0.8438860
C1	10987396	10992558	BolC1t01677H	0	-	2592	4776	5162	0.9252228
C1	10994892	10995177	BolC1t01678H	0	+	32	285	285	1.0000000
C1	11000745	11002474	BolC1t01679H	0	+	553	1597	1729	0.9236553
C1	11005387	11006800	BolC1t01680H	0	+	536	1413	1413	1.0000000
C1	11015638	11015788	BolC1t01681H	0	+	11	6	150	0.0400000
C1	11020501	11023188	BolC1t01682H	0	+	269	2105	2687	0.7834015
C1	11026125	11032501	BolC1t01683H	0	+	1552	5237	6376	0.8213614
C1	11034430	11035458	BolC1t01684H	0	+	313	934	1028	0.9085603
C1	11035625	11037599	BolC1t01685H	0	-	378	1874	1974	0.9493414
C1	11038431	11039113	BolC1t01686H	0	+	291	682	682	1.0000000
C1	11039818	11040442	BolC1t01687H	0	-	579	624	624	1.0000000
C1	11040999	11044159	BolC1t01688H	0	-	460	2236	3160	0.7075949
C1	11060095	11060847	BolC1t01689H	0	-	191	681	752	0.9055851
C1	11062031	11065778	BolC1t01690H	0	+	2362	3375	3747	0.9007206
C1	11066539	11076738	BolC1t01691H	0	-	1150	7519	10199	0.7372292
C1	11081084	11082296	BolC1t01692H	0	-	0	0	1212	0.0000000
C1	11090339	11096076	BolC1t01693H	0	-	2767	5283	5737	0.9208646
C1	11125927	11127808	BolC1t01694H	0	-	117	1705	1881	0.9064327
C1	11129505	11130091	BolC1t01695H	0	-	0	0	586	0.0000000
C1	11133773	11133905	BolC1t01696H	0	-	220	132	132	1.0000000
C1	11138056	11138179	BolC1t01697H	0	-	3	74	123	0.6016260
C1	11140935	11142705	BolC1t01698H	0	-	460	1629	1770	0.9203390
C1	11147617	11150803	BolC1t01699H	0	-	1604	3144	3186	0.9868173
C1	11161360	11163694	BolC1t01700H	0	-	1065	2283	2334	0.9781491
C1	11171943	11172645	BolC1t01701H	0	+	172	580	702	0.8262108
C1	11172832	11173354	BolC1t01702H	0	+	21	502	522	0.9616858
C1	11180112	11183138	BolC1t01703H	0	+	1213	2972	3026	0.9821547
C1	11183406	11184756	BolC1t01704H	0	-	693	1350	1350	1.0000000
C1	11195474	11196633	BolC1t01705H	0	+	1011	1159	1159	1.0000000
C1	11206282	11207232	BolC1t01706H	0	+	561	950	950	1.0000000
C1	11209282	11212153	BolC1t01707H	0	-	1125	2564	2871	0.8930686
C1	11215934	11225686	BolC1t01708H	0	-	4350	9096	9752	0.9327317
C1	11226182	11226470	BolC1t01709H	0	-	208	288	288	1.0000000
C1	11233590	11236146	BolC1t01710H	0	+	1985	2468	2556	0.9655712
C1	11242853	11246276	BolC1t01711H	0	-	500	3151	3423	0.9205375
C1	11246398	11247236	BolC1t01712H	0	-	622	838	838	1.0000000
C1	11259252	11259920	BolC1t01713H	0	+	217	668	668	1.0000000
C1	11260176	11261910	BolC1t01714H	0	-	344	1718	1734	0.9907728
C1	11275159	11278162	BolC1t01715H	0	+	2032	3003	3003	1.0000000
C1	11283307	11294634	BolC1t01716H	0	-	8406	11327	11327	1.0000000
C1	11285914	11288849	BolC1t01717H	0	+	3233	2935	2935	1.0000000
C1	11288853	11289760	BolC1t01718H	0	+	1563	907	907	1.0000000
C1	11295662	11295944	BolC1t01719H	0	-	0	0	282	0.0000000
C1	11300008	11300371	BolC1t01720H	0	-	42	184	363	0.5068871
C1	11300958	11302685	BolC1t01721H	0	-	21	717	1727	0.4151708
C1	11303549	11303831	BolC1t01722H	0	-	0	0	282	0.0000000
C1	11304893	11306279	BolC1t01723H	0	+	1166	1386	1386	1.0000000
C1	11309686	11314887	BolC1t01724H	0	-	1718	2875	5201	0.5527783
C1	11342488	11342752	BolC1t01725H	0	+	176	264	264	1.0000000
C1	11360748	11361583	BolC1t01726H	0	-	164	600	835	0.7185629
C1	11361637	11412568	BolC1t01727H	0	-	19192	43000	50931	0.8442795
C1	11379982	11382065	BolC1t01728H	0	+	1521	2076	2083	0.9966395
C1	11391880	11392258	BolC1t01729H	0	+	332	378	378	1.0000000
C1	11396669	11399800	BolC1t01730H	0	+	3702	3131	3131	1.0000000
C1	11400978	11403432	BolC1t01731H	0	+	1844	2454	2454	1.0000000
C1	11421453	11423977	BolC1t01732H	0	-	1070	2352	2524	0.9318542
C1	11432732	11433754	BolC1t01733H	0	+	658	1022	1022	1.0000000
C1	11435798	11446466	BolC1t01734H	0	-	3527	8066	10668	0.7560930
C1	11447312	11447860	BolC1t01735H	0	-	307	548	548	1.0000000
C1	11453348	11470946	BolC1t01736H	0	-	7848	16545	17598	0.9401637
C1	11466273	11467600	BolC1t01737H	0	-	1033	1327	1327	1.0000000
C1	11481633	11482795	BolC1t01738H	0	+	877	1162	1162	1.0000000
C1	11493855	11495082	BolC1t01739H	0	+	134	942	1227	0.7677262
C1	11497089	11499339	BolC1t01740H	0	+	1302	2250	2250	1.0000000
C1	11506586	11509406	BolC1t01741H	0	+	480	2750	2820	0.9751773
C1	11509989	11510649	BolC1t01742H	0	-	377	660	660	1.0000000
C1	11523156	11525578	BolC1t01743H	0	+	294	854	2422	0.3526012
C1	11534947	11545669	BolC1t01744H	0	+	1091	7376	10722	0.6879314
C1	11537501	11538752	BolC1t01745H	0	+	0	0	1251	0.0000000
C1	11547125	11548696	BolC1t01746H	0	+	607	1571	1571	1.0000000
C1	11549243	11551424	BolC1t01747H	0	-	145	1498	2181	0.6868409
C1	11561401	11561753	BolC1t01748H	0	-	63	123	352	0.3494318
C1	11563444	11563816	BolC1t01749H	0	-	13	226	372	0.6075269
C1	11585728	11585950	BolC1t01750H	0	+	167	222	222	1.0000000
C1	11613152	11616414	BolC1t01751H	0	+	925	2642	3262	0.8099325
C1	11616527	11616751	BolC1t01752H	0	+	1	30	224	0.1339286
C1	11616835	11617126	BolC1t01753H	0	+	2	70	291	0.2405498
C1	11617671	11663836	BolC1t01754H	0	-	15968	36967	46165	0.8007581
C1	11649443	11652261	BolC1t01755H	0	+	168	1351	2818	0.4794180
C1	11652624	11684462	BolC1t01756H	0	-	6521	17708	31838	0.5561907
C1	11665583	11666681	BolC1t01757H	0	-	202	851	1098	0.7750455
C1	11674853	11675474	BolC1t01758H	0	-	397	621	621	1.0000000
C1	11694398	11695004	BolC1t01759H	0	-	52	566	606	0.9339934
C1	11695089	11699748	BolC1t01760H	0	-	2874	4598	4659	0.9869071
C1	11700932	11702471	BolC1t01761H	0	-	900	1539	1539	1.0000000
C1	11703658	11705060	BolC1t01762H	0	-	829	1402	1402	1.0000000
C1	11720353	11722275	BolC1t01763H	0	-	1032	1922	1922	1.0000000
C1	11724390	11725105	BolC1t01764H	0	+	427	715	715	1.0000000
C1	11732589	11734446	BolC1t01765H	0	-	1143	1857	1857	1.0000000
C1	11740235	11741300	BolC1t01766H	0	-	84	749	1065	0.7032864
C1	11753136	11756886	BolC1t01767H	0	+	572	2870	3750	0.7653334
C1	11757603	11758446	BolC1t01768H	0	+	188	842	843	0.9988137
C1	11766671	11767231	BolC1t01769H	0	-	133	502	560	0.8964286
C1	11767481	11770987	BolC1t01770H	0	-	1433	3049	3506	0.8696520
C1	11792456	11794116	BolC1t01771H	0	-	28	540	1660	0.3253012
C1	11802238	11802382	BolC1t01772H	0	+	445	144	144	1.0000000
C1	11805510	11806671	BolC1t01773H	0	+	119	1087	1161	0.9362618
C1	11806831	11812250	BolC1t01774H	0	-	4838	5419	5419	1.0000000
C1	11814376	11814682	BolC1t01775H	0	-	602	306	306	1.0000000
C1	11829391	11829661	BolC1t01776H	0	+	47	270	270	1.0000000
C1	11839655	11841037	BolC1t01777H	0	+	1683	1382	1382	1.0000000
C1	11856683	11857046	BolC1t01778H	0	+	176	363	363	1.0000000
C1	11873758	11876243	BolC1t01779H	0	-	1085	2435	2485	0.9798793
C1	11879316	11881178	BolC1t01780H	0	+	1597	1862	1862	1.0000000
C1	11890810	11892984	BolC1t01781H	0	-	562	1971	2174	0.9066237
C1	11901206	11901489	BolC1t01782H	0	-	111	283	283	1.0000000
C1	11901704	11901860	BolC1t01783H	0	-	72	156	156	1.0000000
C1	11906515	11907838	BolC1t01784H	0	+	273	1323	1323	1.0000000
C1	11915558	11917656	BolC1t01785H	0	+	670	1875	2098	0.8937083
C1	11920874	11921216	BolC1t01786H	0	+	541	342	342	1.0000000
C1	11925006	11925726	BolC1t01787H	0	+	430	720	720	1.0000000
C1	11925829	11929391	BolC1t01788H	0	-	1685	3562	3562	1.0000000
C1	11948998	11950624	BolC1t01789H	0	-	909	1587	1626	0.9760147
C1	11972109	11973442	BolC1t01790H	0	-	493	1333	1333	1.0000000
C1	11975178	11976419	BolC1t01791H	0	+	1038	1241	1241	1.0000000
C1	11977319	11980520	BolC1t01792H	0	-	1436	3044	3201	0.9509528
C1	11985912	11986442	BolC1t01793H	0	+	170	530	530	1.0000000
C1	11986925	11987596	BolC1t01794H	0	+	98	671	671	1.0000000
C1	11989326	11990238	BolC1t01795H	0	-	875	912	912	1.0000000
C1	11992339	11992957	BolC1t01796H	0	-	100	586	618	0.9482201
C1	11997271	11997448	BolC1t01797H	0	+	249	177	177	1.0000000
C1	11998658	12004187	BolC1t01798H	0	-	1506	3787	5529	0.6849340
C1	12006718	12007416	BolC1t01799H	0	-	136	680	698	0.9742121
C1	12008368	12008470	BolC1t01800H	0	-	1	11	102	0.1078431
C1	12008512	12008863	BolC1t01801H	0	+	2	19	351	0.0541311
C1	12028900	12029065	BolC1t01802H	0	-	38	165	165	1.0000000
C1	12031278	12033723	BolC1t01803H	0	-	1134	2445	2445	1.0000000
C1	12034728	12034866	BolC1t01804H	0	+	134	138	138	1.0000000
C1	12036751	12038904	BolC1t01805H	0	-	2073	2153	2153	1.0000000
C1	12042182	12043210	BolC1t01806H	0	-	3	39	1028	0.0379377
C1	12054452	12055624	BolC1t01807H	0	-	637	1156	1172	0.9863482
C1	12067131	12067860	BolC1t01808H	0	-	651	546	729	0.7489712
C1	12068000	12069014	BolC1t01809H	0	-	664	1014	1014	1.0000000
C1	12078933	12079714	BolC1t01810H	0	-	746	781	781	1.0000000
C1	12080988	12081860	BolC1t01811H	0	-	600	850	872	0.9747707
C1	12090551	12091416	BolC1t01812H	0	+	161	393	865	0.4543353
C1	12091472	12091652	BolC1t01813H	0	+	1	52	180	0.2888889
C1	12098719	12099280	BolC1t01814H	0	-	146	449	561	0.8003565
C1	12101685	12101862	BolC1t01815H	0	-	2	39	177	0.2203390
C1	12115022	12118348	BolC1t01816H	0	-	959	2866	3326	0.8616957
C1	12138032	12138602	BolC1t01817H	0	+	372	570	570	1.0000000
C1	12165297	12167185	BolC1t01818H	0	+	1051	1888	1888	1.0000000
C1	12168876	12171227	BolC1t01819H	0	+	480	2153	2351	0.9157805
C1	12172555	12173090	BolC1t01820H	0	+	0	0	535	0.0000000
C1	12173356	12175142	BolC1t01821H	0	-	172	1201	1786	0.6724524
C1	12184661	12185924	BolC1t01822H	0	-	917	1263	1263	1.0000000
C1	12194826	12195018	BolC1t01823H	0	-	144	192	192	1.0000000
C1	12201598	12202567	BolC1t01824H	0	+	344	969	969	1.0000000
C1	12227186	12227727	BolC1t01825H	0	-	229	541	541	1.0000000
C1	12228217	12228487	BolC1t01826H	0	-	514	270	270	1.0000000
C1	12230679	12232782	BolC1t01827H	0	+	445	1809	2103	0.8601997
C1	12232924	12234045	BolC1t01828H	0	-	46	917	1121	0.8180196
C1	12241601	12242186	BolC1t01829H	0	-	61	570	585	0.9743590
C1	12243719	12246636	BolC1t01830H	0	-	486	2120	2917	0.7267741
C1	12247631	12251872	BolC1t01831H	0	-	765	3473	4241	0.8189107
C1	12253923	12255736	BolC1t01832H	0	+	381	1756	1813	0.9685604
C1	12256808	12257458	BolC1t01833H	0	+	0	0	650	0.0000000
C1	12258158	12259032	BolC1t01834H	0	+	0	0	874	0.0000000
C1	12267195	12267522	BolC1t01835H	0	+	23	196	327	0.5993884
C1	12279122	12279476	BolC1t01836H	0	+	3	27	354	0.0762712
C1	12280852	12281424	BolC1t01837H	0	-	58	132	572	0.2307692
C1	12283688	12284372	BolC1t01838H	0	+	528	684	684	1.0000000
C1	12284804	12285533	BolC1t01839H	0	-	429	729	729	1.0000000
C1	12287101	12289769	BolC1t01840H	0	+	1637	2668	2668	1.0000000
C1	12290296	12292525	BolC1t01841H	0	+	675	2229	2229	1.0000000
C1	12297789	12300119	BolC1t01842H	0	+	1834	2330	2330	1.0000000
C1	12300554	12301166	BolC1t01843H	0	-	243	593	612	0.9689543
C1	12301422	12308522	BolC1t01844H	0	+	4681	7053	7100	0.9933803
C1	12337389	12340391	BolC1t01845H	0	+	1326	2901	3002	0.9663557
C1	12342745	12347860	BolC1t01846H	0	+	675	3162	5115	0.6181818
C1	12353884	12357814	BolC1t01847H	0	+	2713	3114	3930	0.7923664
C1	12358015	12359185	BolC1t01848H	0	-	31	456	1170	0.3897436
C1	12398352	12402135	BolC1t01849H	0	+	679	2194	3783	0.5799630
C1	12408299	12408536	BolC1t01850H	0	+	22	110	237	0.4641350
C1	12410263	12413164	BolC1t01851H	0	+	285	1686	2901	0.5811789
C1	12424577	12428734	BolC1t01852H	0	+	991	3618	4157	0.8703392
C1	12426269	12426917	BolC1t01853H	0	-	147	556	648	0.8580247
C1	12446208	12447773	BolC1t01854H	0	+	129	449	1565	0.2869010
C1	12459144	12460858	BolC1t01855H	0	-	649	1538	1714	0.8973162
C1	12464099	12465242	BolC1t01856H	0	+	403	1143	1143	1.0000000
C1	12466957	12473758	BolC1t01857H	0	+	2017	6254	6801	0.9195706
C1	12474302	12475058	BolC1t01858H	0	-	339	756	756	1.0000000
C1	12494519	12497022	BolC1t01859H	0	+	119	1414	2503	0.5649221
C1	12500174	12500567	BolC1t01860H	0	+	248	393	393	1.0000000
C1	12500570	12506621	BolC1t01861H	0	+	416	4195	6051	0.6932738
C1	12504091	12504610	BolC1t01862H	0	-	28	458	519	0.8824663
C1	12510220	12510779	BolC1t01863H	0	+	59	451	559	0.8067979
C1	12513449	12517276	BolC1t01864H	0	-	2086	2328	3827	0.6083094
C1	12523494	12524907	BolC1t01865H	0	+	580	1350	1413	0.9554140
C1	12526236	12528259	BolC1t01866H	0	+	815	1895	2023	0.9367276
C1	12533579	12538043	BolC1t01867H	0	+	1793	4211	4464	0.9433244
C1	12542778	12544046	BolC1t01868H	0	-	12	261	1268	0.2058360
C1	12556005	12556137	BolC1t01869H	0	+	92	132	132	1.0000000
C1	12560495	12560819	BolC1t01870H	0	+	84	324	324	1.0000000
C1	12583478	12585026	BolC1t01871H	0	+	513	1512	1548	0.9767442
C1	12585522	12586931	BolC1t01872H	0	-	449	1398	1409	0.9921930
C1	12587655	12591338	BolC1t01873H	0	-	1962	3683	3683	1.0000000
C1	12613043	12613613	BolC1t01874H	0	-	4	106	570	0.1859649
C1	12615079	12615520	BolC1t01875H	0	+	84	236	441	0.5351474
C1	12617371	12617479	BolC1t01876H	0	+	120	108	108	1.0000000
C1	12618620	12619913	BolC1t01877H	0	+	246	1293	1293	1.0000000
C1	12620868	12622427	BolC1t01878H	0	-	1757	1559	1559	1.0000000
C1	12623318	12624734	BolC1t01879H	0	+	200	1366	1416	0.9646893
C1	12628174	12630810	BolC1t01880H	0	-	865	2430	2636	0.9218513
C1	12634243	12634618	BolC1t01881H	0	-	226	375	375	1.0000000
C1	12639497	12639962	BolC1t01882H	0	-	33	416	465	0.8946236
C1	12641236	12687348	BolC1t01883H	0	-	7564	18635	46112	0.4041247
C1	12648590	12675796	BolC1t01884H	0	-	3567	8538	27206	0.3138278
C1	12654755	12655302	BolC1t01885H	0	-	390	364	547	0.6654479
C1	12688349	12688679	BolC1t01886H	0	+	70	329	330	0.9969697
C1	12692104	12695002	BolC1t01887H	0	+	1464	2829	2898	0.9761904
C1	12699453	12702342	BolC1t01888H	0	+	1851	2889	2889	1.0000000
C1	12703382	12704060	BolC1t01889H	0	+	188	580	678	0.8554572
C1	12706887	12707716	BolC1t01890H	0	+	5	127	829	0.1531966
C1	12716444	12719094	BolC1t01891H	0	+	496	2379	2650	0.8977358
C1	12721715	12722366	BolC1t01892H	0	+	123	651	651	1.0000000
C1	12722851	12724003	BolC1t01893H	0	-	243	999	1152	0.8671875
C1	12726798	12728861	BolC1t01894H	0	-	478	1679	2063	0.8138633
C1	12749713	12752446	BolC1t01895H	0	+	1627	2733	2733	1.0000000
C1	12753267	12756321	BolC1t01896H	0	+	1236	2981	3054	0.9760969
C1	12756640	12757153	BolC1t01897H	0	-	120	513	513	1.0000000
C1	12757618	12758688	BolC1t01898H	0	+	454	958	1070	0.8953271
C1	12758929	12761394	BolC1t01899H	0	-	661	1953	2465	0.7922921
C1	12763455	12764591	BolC1t01900H	0	+	985	1118	1136	0.9841549
C1	12764801	12766309	BolC1t01901H	0	+	303	1343	1508	0.8905836
C1	12780448	12780574	BolC1t01902H	0	-	29	126	126	1.0000000
C1	12794292	12797606	BolC1t01903H	0	+	755	2699	3314	0.8144237
C1	12798440	12807608	BolC1t01904H	0	+	2525	8019	9168	0.8746728
C1	12808459	12810897	BolC1t01905H	0	+	2859	2438	2438	1.0000000
C1	12811838	12813742	BolC1t01906H	0	+	1170	1904	1904	1.0000000
C1	12835664	12839913	BolC1t01907H	0	+	1836	3809	4249	0.8964462
C1	12841072	12845010	BolC1t01908H	0	-	636	3193	3938	0.8108177
C1	12845187	12849854	BolC1t01909H	0	+	775	3590	4667	0.7692308
C1	12856293	12860159	BolC1t01910H	0	+	1552	3798	3866	0.9824108
C1	12861673	12865576	BolC1t01911H	0	-	1707	3806	3903	0.9751473
C1	12866708	12870028	BolC1t01912H	0	-	958	3276	3320	0.9867470
C1	12870640	12873198	BolC1t01913H	0	-	164	1656	2558	0.6473808
C1	12874769	12875093	BolC1t01914H	0	+	4	206	324	0.6358024
C1	12878886	12879195	BolC1t01915H	0	+	26	239	309	0.7734628
C1	12886193	12889176	BolC1t01916H	0	+	1567	2983	2983	1.0000000
C1	12889707	12894099	BolC1t01917H	0	-	2115	4203	4392	0.9569672
C1	12899928	12900876	BolC1t01918H	0	+	248	696	948	0.7341772
C1	12901236	12907174	BolC1t01919H	0	-	936	4769	5938	0.8031324
C1	12910393	12911188	BolC1t01920H	0	+	347	795	795	1.0000000
C1	12916343	12917530	BolC1t01921H	0	+	1071	1187	1187	1.0000000
C1	12918196	12924945	BolC1t01922H	0	-	882	4392	6749	0.6507631
C1	12925891	12929207	BolC1t01923H	0	-	2342	3316	3316	1.0000000
C1	12933656	12935824	BolC1t01924H	0	+	606	1504	2168	0.6937270
C1	12942475	12943404	BolC1t01925H	0	+	43	554	929	0.5963402
C1	12946446	12947121	BolC1t01926H	0	-	281	626	675	0.9274074
C1	12950072	12952974	BolC1t01927H	0	-	234	2156	2902	0.7429359
C1	12958093	12963594	BolC1t01928H	0	+	113	2662	5501	0.4839120
C1	12980537	12984196	BolC1t01929H	0	+	937	3240	3659	0.8854879
C1	12984655	12988507	BolC1t01930H	0	-	2150	3597	3852	0.9338006
C1	12989319	12990337	BolC1t01931H	0	-	305	889	1018	0.8732809
C1	12991176	12998988	BolC1t01932H	0	-	4917	7631	7812	0.9768305
C1	13001433	13003438	BolC1t01933H	0	-	748	1788	2005	0.8917706
C1	13005421	13005862	BolC1t01934H	0	+	382	441	441	1.0000000
C1	13016410	13017917	BolC1t01935H	0	-	946	1346	1507	0.8931652
C1	13025017	13026544	BolC1t01936H	0	-	239	1191	1527	0.7799607
C1	13030493	13031046	BolC1t01937H	0	+	10	151	553	0.2730561
C1	13047588	13050488	BolC1t01938H	0	+	1388	2900	2900	1.0000000
C1	13051541	13053836	BolC1t01939H	0	+	628	2099	2295	0.9145970
C1	13054148	13054877	BolC1t01940H	0	+	28	221	729	0.3031550
C1	13055793	13057998	BolC1t01941H	0	-	1154	2151	2205	0.9755102
C1	13064662	13067033	BolC1t01942H	0	-	986	2260	2371	0.9531843
C1	13074356	13078397	BolC1t01943H	0	-	824	3025	4041	0.7485771
C1	13086924	13087555	BolC1t01944H	0	-	388	631	631	1.0000000
C1	13089144	13095837	BolC1t01945H	0	+	1633	5689	6693	0.8499925
C1	13096682	13099475	BolC1t01946H	0	-	722	1909	2793	0.6834944
C1	13101593	13103318	BolC1t01947H	0	+	1483	1725	1725	1.0000000
C1	13103780	13104716	BolC1t01948H	0	-	438	936	936	1.0000000
C1	13105888	13106322	BolC1t01949H	0	-	322	434	434	1.0000000
C1	13110114	13111059	BolC1t01950H	0	-	958	945	945	1.0000000
C1	13112277	13114609	BolC1t01951H	0	+	1097	2319	2332	0.9944254
C1	13114916	13117495	BolC1t01952H	0	+	1482	2504	2579	0.9709190
C1	13117831	13117975	BolC1t01953H	0	+	173	144	144	1.0000000
C1	13118220	13124792	BolC1t01954H	0	+	1677	5452	6572	0.8295800
C1	13128976	13129594	BolC1t01955H	0	-	12	316	618	0.5113268
C1	13133211	13137141	BolC1t01956H	0	+	1604	3345	3930	0.8511450
C1	13138617	13140840	BolC1t01957H	0	+	930	2065	2223	0.9289249
C1	13145973	13146942	BolC1t01958H	0	-	340	964	969	0.9948400
C1	13147155	13147296	BolC1t01959H	0	-	128	141	141	1.0000000
C1	13148532	13150166	BolC1t01960H	0	-	30	780	1634	0.4773562
C1	13163513	13163862	BolC1t01961H	0	-	219	349	349	1.0000000
C1	13164221	13166228	BolC1t01962H	0	+	588	1868	2007	0.9307424
C1	13169861	13172029	BolC1t01963H	0	-	3	77	2168	0.0355166
C1	13174187	13184644	BolC1t01964H	0	+	1331	3627	10457	0.3468490
C1	13187080	13187644	BolC1t01965H	0	+	16	541	564	0.9592199
C1	13192644	13192939	BolC1t01966H	0	+	13	123	295	0.4169492
C1	13194353	13194503	BolC1t01967H	0	+	0	0	150	0.0000000
C1	13196844	13197268	BolC1t01968H	0	+	0	0	424	0.0000000
C1	13200065	13200360	BolC1t01969H	0	+	95	282	295	0.9559322
C1	13208446	13209106	BolC1t01970H	0	-	69	436	660	0.6606061
C1	13211293	13211698	BolC1t01971H	0	-	159	405	405	1.0000000
C1	13215144	13215439	BolC1t01972H	0	+	42	248	295	0.8406780
C1	13219303	13219727	BolC1t01973H	0	+	0	0	424	0.0000000
C1	13224284	13225716	BolC1t01974H	0	+	1197	981	1432	0.6850559
C1	13233180	13233589	BolC1t01975H	0	-	347	409	409	1.0000000
C1	13254743	13255836	BolC1t01976H	0	+	333	1034	1093	0.9460201
C1	13256652	13257371	BolC1t01977H	0	+	179	719	719	1.0000000
C1	13258220	13261828	BolC1t01978H	0	+	1442	3056	3608	0.8470067
C1	13262230	13263259	BolC1t01979H	0	+	133	720	1029	0.6997085
C1	13263642	13265301	BolC1t01980H	0	-	522	1424	1659	0.8583484
C1	13272866	13274239	BolC1t01981H	0	-	333	1363	1373	0.9927167
C1	13280802	13282317	BolC1t01982H	0	-	288	1299	1515	0.8574257
C1	13283463	13286935	BolC1t01983H	0	-	1107	3246	3472	0.9349079
C1	13287604	13288744	BolC1t01984H	0	-	45	587	1140	0.5149123
C1	13289135	13290029	BolC1t01985H	0	+	287	894	894	1.0000000
C1	13290655	13291796	BolC1t01986H	0	-	169	892	1141	0.7817703
C1	13292319	13295828	BolC1t01987H	0	-	355	2630	3509	0.7495013
C1	13324087	13326156	BolC1t01988H	0	+	612	2032	2069	0.9821169
C1	13330364	13331162	BolC1t01989H	0	+	18	207	798	0.2593985
C1	13332549	13333641	BolC1t01990H	0	-	17	713	1092	0.6529304
C1	13336229	13338332	BolC1t01991H	0	-	919	2103	2103	1.0000000
C1	13338911	13340580	BolC1t01992H	0	-	1216	1669	1669	1.0000000
C1	13357069	13357796	BolC1t01993H	0	+	535	727	727	1.0000000
C1	13362757	13364958	BolC1t01994H	0	-	649	2180	2201	0.9904589
C1	13368400	13369492	BolC1t01995H	0	+	546	1092	1092	1.0000000
C1	13371426	13373435	BolC1t01996H	0	+	232	1459	2009	0.7262319
C1	13373718	13373889	BolC1t01997H	0	-	121	171	171	1.0000000
C1	13374982	13377828	BolC1t01998H	0	+	10913	2846	2846	1.0000000
C1	13379074	13382263	BolC1t01999H	0	+	2489	3189	3189	1.0000000
C1	13386954	13389538	BolC1t02000H	0	+	498	2515	2584	0.9732972
C1	13391713	13392313	BolC1t02001H	0	+	448	581	600	0.9683333
C1	13395858	13396125	BolC1t02002H	0	+	35	158	267	0.5917603
C1	13398819	13399517	BolC1t02003H	0	+	2	52	698	0.0744986
C1	13401357	13401963	BolC1t02004H	0	-	45	291	606	0.4801980
C1	13402623	13404204	BolC1t02005H	0	-	145	1401	1581	0.8861480
C1	13404402	13405967	BolC1t02006H	0	-	494	1489	1565	0.9514377
C1	13415211	13421338	BolC1t02007H	0	+	2743	4745	6127	0.7744410
C1	13421661	13421862	BolC1t02008H	0	+	571	201	201	1.0000000
C1	13421963	13423298	BolC1t02009H	0	+	273	1140	1335	0.8539326
C1	13425587	13427055	BolC1t02010H	0	+	244	773	1468	0.5265667
C1	13427688	13429053	BolC1t02011H	0	-	801	1365	1365	1.0000000
C1	13430453	13432069	BolC1t02012H	0	+	718	1517	1616	0.9387376
C1	13435316	13435659	BolC1t02013H	0	-	244	343	343	1.0000000
C1	13450444	13452571	BolC1t02014H	0	+	1029	2023	2127	0.9511048
C1	13452932	13453843	BolC1t02015H	0	+	527	911	911	1.0000000
C1	13503500	13504372	BolC1t02016H	0	+	59	426	872	0.4885321
C1	13510690	13511211	BolC1t02017H	0	-	727	521	521	1.0000000
C1	13524044	13524680	BolC1t02018H	0	+	1297	471	636	0.7405660
C1	13524926	13526478	BolC1t02019H	0	-	4	303	1552	0.1952320
C1	13528606	13530407	BolC1t02020H	0	-	727	1782	1801	0.9894503
C1	13530815	13530968	BolC1t02021H	0	-	37	153	153	1.0000000
C1	13535044	13536488	BolC1t02022H	0	-	247	1303	1444	0.9023546
C1	13552295	13552538	BolC1t02023H	0	+	2	39	243	0.1604938
C1	13556401	13556746	BolC1t02024H	0	+	241	345	345	1.0000000
C1	13567019	13570941	BolC1t02025H	0	-	1405	3245	3922	0.8273840
C1	13585170	13585323	BolC1t02026H	0	-	75	153	153	1.0000000
C1	13591087	13591537	BolC1t02027H	0	-	42	338	450	0.7511111
C1	13597281	13599203	BolC1t02028H	0	-	90	938	1922	0.4880333
C1	13600041	13602310	BolC1t02029H	0	-	449	1892	2269	0.8338475
C1	13615224	13617205	BolC1t02030H	0	+	665	1845	1981	0.9313478
C1	13618182	13618710	BolC1t02031H	0	+	861	528	528	1.0000000
C1	13641870	13644570	BolC1t02032H	0	+	250	1244	2700	0.4607407
C1	13647847	13648190	BolC1t02033H	0	-	34	319	343	0.9300292
C1	13648621	13651879	BolC1t02034H	0	+	959	3012	3258	0.9244936
C1	13653327	13654309	BolC1t02035H	0	+	1526	982	982	1.0000000
C1	13656984	13657522	BolC1t02036H	0	-	539	538	538	1.0000000
C1	13670878	13671741	BolC1t02037H	0	-	66	569	863	0.6593279
C1	13672593	13675807	BolC1t02038H	0	+	2198	2558	3214	0.7958930
C1	13684286	13686640	BolC1t02039H	0	+	386	1731	2354	0.7353441
C1	13685773	13687264	BolC1t02040H	0	-	523	1465	1491	0.9825621
C1	13692458	13694697	BolC1t02041H	0	+	1582	2239	2239	1.0000000
C1	13695436	13704955	BolC1t02042H	0	-	1535	7374	9519	0.7746612
C1	13706002	13706455	BolC1t02043H	0	-	30	341	453	0.7527594
C1	13708963	13711731	BolC1t02044H	0	-	1615	2493	2768	0.9006503
C1	13712477	13713666	BolC1t02045H	0	+	895	1189	1189	1.0000000
C1	13714079	13714646	BolC1t02046H	0	-	580	566	567	0.9982364
C1	13714731	13714884	BolC1t02047H	0	-	82	107	153	0.6993464
C1	13716291	13717662	BolC1t02048H	0	+	1070	1356	1371	0.9890591
C1	13717984	13718563	BolC1t02049H	0	-	316	561	579	0.9689119
C1	13718645	13718804	BolC1t02050H	0	-	85	159	159	1.0000000
C1	13723849	13730539	BolC1t02051H	0	-	970	2721	6690	0.4067264
C1	13733854	13736629	BolC1t02052H	0	-	1685	2615	2775	0.9423423
C1	13738953	13740390	BolC1t02053H	0	-	513	1426	1437	0.9923452
C1	13742633	13744355	BolC1t02054H	0	-	449	1553	1722	0.9018583
C1	13766419	13766836	BolC1t02055H	0	+	115	292	417	0.7002398
C1	13775485	13777493	BolC1t02056H	0	-	1108	1919	2008	0.9556773
C1	13789168	13789777	BolC1t02057H	0	+	23	247	609	0.4055829
C1	13795230	13796434	BolC1t02058H	0	-	34	717	1204	0.5955150
C1	13799258	13801608	BolC1t02059H	0	+	482	2068	2350	0.8800000
C1	13803127	13804362	BolC1t02060H	0	+	192	965	1235	0.7813765
C1	13807885	13809155	BolC1t02061H	0	+	115	698	1270	0.5496063
C1	13816371	13816709	BolC1t02062H	0	+	55	338	338	1.0000000
C1	13828546	13830079	BolC1t02063H	0	+	477	1529	1533	0.9973907
C1	13849758	13871235	BolC1t02064H	0	+	5282	13911	21477	0.6477162
C1	13871494	13873441	BolC1t02065H	0	-	1105	1937	1947	0.9948639
C1	13877802	13877934	BolC1t02066H	0	-	83	132	132	1.0000000
C1	13882538	13885820	BolC1t02067H	0	+	1602	3228	3282	0.9835466
C1	13886429	13893685	BolC1t02068H	0	-	3607	6383	7256	0.8796858
C1	13904311	13906352	BolC1t02069H	0	+	857	1958	2041	0.9593337
C1	13907245	13909400	BolC1t02070H	0	+	1338	2150	2155	0.9976798
C1	13936335	13937300	BolC1t02071H	0	+	778	965	965	1.0000000
C1	13937695	13940602	BolC1t02072H	0	-	904	2391	2907	0.8224974
C1	13943433	13944439	BolC1t02073H	0	+	60	738	1006	0.7335984
C1	13958540	13959038	BolC1t02074H	0	-	148	498	498	1.0000000
C1	13961534	13963999	BolC1t02075H	0	+	2	19	2465	0.0077079
C1	13991314	13991629	BolC1t02076H	0	+	2346	315	315	1.0000000
C1	13993466	13993604	BolC1t02077H	0	+	2	73	138	0.5289855
C1	14005655	14010466	BolC1t02078H	0	+	729	3798	4811	0.7894409
C1	14010790	14012666	BolC1t02079H	0	+	950	1864	1876	0.9936034
C1	14013237	14014896	BolC1t02080H	0	-	1402	1659	1659	1.0000000
C1	14035300	14036354	BolC1t02081H	0	-	383	1054	1054	1.0000000
C1	14042429	14042762	BolC1t02082H	0	+	1	150	333	0.4504505
C1	14048615	14049234	BolC1t02083H	0	-	3	143	619	0.2310178
C1	14048872	14049247	BolC1t02084H	0	+	3	156	375	0.4160000
C1	14052643	14054730	BolC1t02085H	0	+	1245	2066	2087	0.9899377
C1	14062046	14069256	BolC1t02086H	0	+	1993	5950	7210	0.8252427
C1	14077366	14077818	BolC1t02087H	0	-	10	165	452	0.3650442
C1	14080530	14080686	BolC1t02088H	0	-	120	156	156	1.0000000
C1	14081597	14082407	BolC1t02089H	0	-	0	0	810	0.0000000
C1	14083547	14084357	BolC1t02090H	0	-	0	0	810	0.0000000
C1	14085497	14086307	BolC1t02091H	0	-	0	0	810	0.0000000
C1	14087454	14087682	BolC1t02092H	0	-	438	205	228	0.8991228
C1	14089069	14089687	BolC1t02093H	0	+	59	618	618	1.0000000
C1	14100073	14100493	BolC1t02094H	0	-	149	420	420	1.0000000
C1	14119387	14124721	BolC1t02095H	0	+	697	1839	5334	0.3447694
C1	14120203	14124459	BolC1t02096H	0	+	157	761	4256	0.1788064
C1	14131596	14131734	BolC1t02097H	0	+	177	138	138	1.0000000
C1	14154937	14155645	BolC1t02098H	0	+	0	0	708	0.0000000
C1	14158203	14158911	BolC1t02099H	0	+	0	0	708	0.0000000
C1	14170098	14172526	BolC1t02100H	0	-	1026	2315	2428	0.9534596
C1	14173001	14180188	BolC1t02101H	0	+	5623	7187	7187	1.0000000
C1	14182098	14182893	BolC1t02102H	0	-	4	358	795	0.4503145
C1	14185705	14185922	BolC1t02103H	0	-	0	0	217	0.0000000
C1	14187676	14188290	BolC1t02104H	0	+	28	494	614	0.8045602
C1	14244002	14244140	BolC1t02105H	0	+	0	0	138	0.0000000
C1	14244435	14244642	BolC1t02106H	0	+	68	207	207	1.0000000
C1	14265286	14268986	BolC1t02107H	0	+	1296	3446	3700	0.9313514
C1	14269729	14271268	BolC1t02108H	0	-	678	1495	1539	0.9714100
C1	14282266	14282797	BolC1t02109H	0	+	118	531	531	1.0000000
C1	14283311	14286035	BolC1t02110H	0	+	280	1081	2724	0.3968429
C1	14286516	14291137	BolC1t02111H	0	-	1383	4370	4621	0.9456828
C1	14291771	14294246	BolC1t02112H	0	+	296	2041	2475	0.8246465
C1	14297205	14298181	BolC1t02113H	0	+	10	248	976	0.2540984
C1	14299616	14300237	BolC1t02114H	0	-	482	621	621	1.0000000
C1	14302314	14302821	BolC1t02115H	0	-	479	507	507	1.0000000
C1	14304546	14304735	BolC1t02116H	0	+	120	189	189	1.0000000
C1	14315444	14317744	BolC1t02117H	0	+	1367	2288	2300	0.9947826
C1	14324419	14326845	BolC1t02118H	0	+	853	2402	2426	0.9901072
C1	14328576	14329440	BolC1t02119H	0	-	330	792	864	0.9166667
C1	14339208	14339403	BolC1t02120H	0	-	35	195	195	1.0000000
C1	14340877	14341391	BolC1t02121H	0	-	9	37	514	0.0719844
C1	14342327	14346616	BolC1t02122H	0	-	1466	3527	4289	0.8223362
C1	14347563	14353438	BolC1t02123H	0	-	3280	5875	5875	1.0000000
C1	14355647	14357419	BolC1t02124H	0	+	611	1633	1772	0.9215575
C1	14358489	14359577	BolC1t02125H	0	+	853	1052	1088	0.9669118
C1	14359849	14361401	BolC1t02126H	0	-	527	1352	1552	0.8711340
C1	14363280	14365368	BolC1t02127H	0	+	1404	2088	2088	1.0000000
C1	14370138	14371543	BolC1t02128H	0	-	703	1258	1405	0.8953736
C1	14391722	14393618	BolC1t02129H	0	-	979	1365	1896	0.7199367
C1	14401729	14403441	BolC1t02130H	0	+	155	904	1712	0.5280374
C1	14425544	14425808	BolC1t02131H	0	-	137	264	264	1.0000000
C1	14430485	14431327	BolC1t02132H	0	+	389	842	842	1.0000000
C1	14435124	14435844	BolC1t02133H	0	+	782	720	720	1.0000000
C1	14436255	14436833	BolC1t02134H	0	-	476	577	578	0.9982699
C1	14437507	14446814	BolC1t02135H	0	-	2935	7671	9307	0.8242183
C1	14448794	14449844	BolC1t02136H	0	-	319	964	1050	0.9180952
C1	14450641	14451517	BolC1t02137H	0	-	192	825	876	0.9417808
C1	14459721	14459955	BolC1t02138H	0	+	0	0	234	0.0000000
C1	14463314	14464199	BolC1t02139H	0	+	104	838	885	0.9468927
C1	14467428	14470207	BolC1t02140H	0	-	1324	2696	2779	0.9701331
C1	14471600	14472590	BolC1t02141H	0	-	442	720	990	0.7272727
C1	14490547	14490926	BolC1t02142H	0	+	16	296	379	0.7810026
C1	14491977	14492699	BolC1t02143H	0	+	207	700	722	0.9695291
C1	14492888	14497200	BolC1t02144H	0	-	2531	4145	4312	0.9612709
C1	14497321	14499087	BolC1t02145H	0	-	1203	1766	1766	1.0000000
C1	14499499	14500617	BolC1t02146H	0	-	1474	1118	1118	1.0000000
C1	14502271	14502451	BolC1t02147H	0	-	45	180	180	1.0000000
C1	14504114	14504432	BolC1t02148H	0	-	8	222	318	0.6981132
C1	14505682	14507129	BolC1t02149H	0	+	568	1447	1447	1.0000000
C1	14508688	14510461	BolC1t02150H	0	-	919	1675	1773	0.9447265
C1	14511004	14512717	BolC1t02151H	0	-	191	1137	1713	0.6637478
C1	14512869	14514681	BolC1t02152H	0	+	1059	1808	1812	0.9977925
C1	14514977	14515316	BolC1t02153H	0	-	270	339	339	1.0000000
C1	14522462	14522968	BolC1t02154H	0	+	4	238	506	0.4703557
C1	14530983	14531652	BolC1t02155H	0	+	328	669	669	1.0000000
C1	14533244	14534054	BolC1t02156H	0	+	793	810	810	1.0000000
C1	14574041	14575290	BolC1t02157H	0	-	47	331	1249	0.2650120
C1	14577634	14579222	BolC1t02158H	0	-	368	1528	1588	0.9622166
C1	14595874	14596171	BolC1t02159H	0	-	308	297	297	1.0000000
C1	14597055	14599058	BolC1t02160H	0	-	160	1269	2003	0.6335497
C1	14610403	14612403	BolC1t02161H	0	+	159	1262	2000	0.6310000
C1	14614142	14616208	BolC1t02162H	0	+	1461	2052	2066	0.9932236
C1	14616528	14618347	BolC1t02163H	0	-	698	1588	1819	0.8730071
C1	14621408	14622213	BolC1t02164H	0	-	296	751	805	0.9329193
C1	14623338	14624493	BolC1t02165H	0	+	50	807	1155	0.6987013
C1	14627092	14629600	BolC1t02166H	0	+	864	1980	2508	0.7894737
C1	14641988	14644223	BolC1t02167H	0	+	559	2065	2235	0.9239374
C1	14645150	14646761	BolC1t02168H	0	+	810	1611	1611	1.0000000
C1	14655832	14656033	BolC1t02169H	0	-	3	49	201	0.2437811
C1	14657409	14658878	BolC1t02170H	0	+	817	1348	1469	0.9176310
C1	14659372	14662155	BolC1t02171H	0	-	1668	2746	2783	0.9867050
C1	14664092	14664929	BolC1t02172H	0	-	828	837	837	1.0000000
C1	14665671	14667737	BolC1t02173H	0	+	81	1500	2066	0.7260407
C1	14673275	14674490	BolC1t02174H	0	-	63	712	1215	0.5860083
C1	14674589	14674898	BolC1t02175H	0	-	3	45	309	0.1456311
C1	14686695	14687062	BolC1t02176H	0	-	349	367	367	1.0000000
C1	14695379	14696735	BolC1t02177H	0	+	21	586	1356	0.4321534
C1	14697574	14698721	BolC1t02178H	0	-	10	478	1147	0.4167393
C1	14703879	14704680	BolC1t02179H	0	+	125	757	801	0.9450687
C1	14705890	14706943	BolC1t02180H	0	-	487	1053	1053	1.0000000
C1	14707961	14713262	BolC1t02181H	0	+	1507	5064	5301	0.9552915
C1	14715490	14718848	BolC1t02182H	0	-	819	2949	3358	0.8782013
C1	14730334	14733119	BolC1t02183H	0	-	1087	2012	2785	0.7224417
C1	14733701	14734202	BolC1t02184H	0	-	5	170	501	0.3393213
C1	14735559	14737157	BolC1t02185H	0	-	982	1547	1598	0.9680851
C1	14738389	14744771	BolC1t02186H	0	-	6406	5741	6382	0.8995613
C1	14745491	14746896	BolC1t02187H	0	-	935	1311	1405	0.9330961
C1	14753727	14754127	BolC1t02188H	0	+	2	163	400	0.4075000
C1	14754749	14755217	BolC1t02189H	0	+	5	242	468	0.5170940
C1	14755403	14755586	BolC1t02190H	0	+	38	156	183	0.8524590
C1	14761202	14763378	BolC1t02191H	0	+	87	717	2176	0.3295037
C1	14777553	14778582	BolC1t02192H	0	-	194	882	1029	0.8571429
C1	14784893	14787765	BolC1t02193H	0	-	213	1477	2872	0.5142758
C1	14796895	14800511	BolC1t02194H	0	+	1453	2914	3616	0.8058628
C1	14803575	14805192	BolC1t02195H	0	+	426	1528	1617	0.9449598
C1	14805978	14807592	BolC1t02196H	0	-	567	1601	1614	0.9919455
C1	14808046	14808202	BolC1t02197H	0	+	224	156	156	1.0000000
C1	14810039	14813563	BolC1t02198H	0	-	1415	3322	3524	0.9426787
C1	14824151	14826957	BolC1t02199H	0	-	1526	2806	2806	1.0000000
C1	14839401	14840999	BolC1t02200H	0	+	702	1598	1598	1.0000000
C1	14842104	14843220	BolC1t02201H	0	+	696	1116	1116	1.0000000
C1	14843467	14843653	BolC1t02202H	0	-	45	186	186	1.0000000
C1	14844365	14856806	BolC1t02203H	0	+	5123	10124	12441	0.8137609
C1	14857432	14858308	BolC1t02204H	0	-	437	876	876	1.0000000
C1	14867052	14867304	BolC1t02205H	0	+	198	252	252	1.0000000
C1	14867603	14870501	BolC1t02206H	0	-	733	2700	2898	0.9316770
C1	14884247	14887930	BolC1t02207H	0	+	1830	3493	3683	0.9484116
C1	14889182	14892739	BolC1t02208H	0	+	1370	3248	3557	0.9131290
C1	14893348	14894982	BolC1t02209H	0	+	348	1428	1634	0.8739290
C1	14895710	14896345	BolC1t02210H	0	-	216	592	635	0.9322835
C1	14897699	14899119	BolC1t02211H	0	-	149	1206	1420	0.8492958
C1	14899651	14902254	BolC1t02212H	0	-	1725	2288	2603	0.8789858
C1	14902713	14905847	BolC1t02213H	0	-	1472	3134	3134	1.0000000
C1	14906112	14908077	BolC1t02214H	0	+	183	1492	1965	0.7592875
C1	14908803	14909587	BolC1t02215H	0	-	510	784	784	1.0000000
C1	14923386	14923725	BolC1t02216H	0	-	388	339	339	1.0000000
C1	14953218	14954581	BolC1t02217H	0	+	425	906	1363	0.6647102
C1	14961054	14961288	BolC1t02218H	0	+	1	12	234	0.0512821
C1	14965531	14966489	BolC1t02219H	0	+	3	113	958	0.1179541
C1	14986816	14987002	BolC1t02220H	0	-	0	0	186	0.0000000
C1	14988068	14988664	BolC1t02221H	0	+	29	410	596	0.6879194
C1	14989086	14989281	BolC1t02222H	0	+	0	0	195	0.0000000
C1	15006395	15008354	BolC1t02223H	0	-	10	202	1959	0.1031138
C1	15023741	15023900	BolC1t02224H	0	-	74	159	159	1.0000000
C1	15024876	15025578	BolC1t02225H	0	-	2	59	702	0.0840456
C1	15026096	15027273	BolC1t02226H	0	-	4	130	1177	0.1104503
C1	15029276	15029393	BolC1t02227H	0	-	7	117	117	1.0000000
C1	15033508	15034363	BolC1t02228H	0	+	12	108	855	0.1263158
C1	15035466	15035658	BolC1t02229H	0	-	161	192	192	1.0000000
C1	15051899	15052202	BolC1t02230H	0	-	215	290	303	0.9570957
C1	15066718	15066907	BolC1t02231H	0	-	90	189	189	1.0000000
C1	15067541	15067775	BolC1t02232H	0	-	21	117	234	0.5000000
C1	15085205	15086663	BolC1t02233H	0	+	61	739	1458	0.5068587
C1	15087645	15089522	BolC1t02234H	0	+	131	1031	1877	0.5492808
C1	15090032	15090434	BolC1t02235H	0	-	41	318	402	0.7910448
C1	15092316	15093279	BolC1t02236H	0	+	650	963	963	1.0000000
C1	15097470	15099367	BolC1t02237H	0	-	621	1665	1897	0.8777016
C1	15102380	15103950	BolC1t02238H	0	-	534	1570	1570	1.0000000
C1	15105915	15106365	BolC1t02239H	0	-	287	450	450	1.0000000
C1	15112514	15113861	BolC1t02240H	0	+	312	1204	1347	0.8938382
C1	15126830	15127130	BolC1t02241H	0	-	216	300	300	1.0000000
C1	15134525	15138127	BolC1t02242H	0	+	1103	3526	3602	0.9789006
C1	15139369	15142631	BolC1t02243H	0	-	480	2859	3262	0.8764561
C1	15143933	15146091	BolC1t02244H	0	+	516	2023	2158	0.9374421
C1	15146460	15149253	BolC1t02245H	0	-	602	2209	2793	0.7909058
C1	15150698	15153316	BolC1t02246H	0	-	1187	2554	2618	0.9755539
C1	15153689	15163412	BolC1t02247H	0	+	4323	9083	9723	0.9341767
C1	15163762	15166195	BolC1t02248H	0	-	765	2292	2433	0.9420469
C1	15169086	15169239	BolC1t02249H	0	-	10	93	153	0.6078432
C1	15172727	15173624	BolC1t02250H	0	+	103	816	897	0.9096990
C1	15173795	15175077	BolC1t02251H	0	-	23	550	1282	0.4290172
C1	15180056	15180495	BolC1t02252H	0	-	359	439	439	1.0000000
C1	15182603	15187867	BolC1t02253H	0	-	2280	4919	5264	0.9344605
C1	15188017	15191475	BolC1t02254H	0	-	736	2751	3458	0.7955465
C1	15191835	15192204	BolC1t02255H	0	+	344	369	369	1.0000000
C1	15196309	15197517	BolC1t02256H	0	-	519	1208	1208	1.0000000
C1	15197902	15200478	BolC1t02257H	0	+	1185	2576	2576	1.0000000
C1	15201340	15204168	BolC1t02258H	0	-	572	2458	2828	0.8691655
C1	15205543	15212964	BolC1t02259H	0	-	3747	7408	7421	0.9982482
C1	15213556	15214270	BolC1t02260H	0	-	403	714	714	1.0000000
C1	15217215	15217758	BolC1t02261H	0	+	19	431	543	0.7937385
C1	15230497	15231040	BolC1t02262H	0	+	363	543	543	1.0000000
C1	15236153	15236273	BolC1t02263H	0	-	49	120	120	1.0000000
C1	15243677	15244229	BolC1t02264H	0	+	129	469	552	0.8496377
C1	15250499	15250793	BolC1t02265H	0	-	110	294	294	1.0000000
C1	15262135	15262687	BolC1t02266H	0	+	16	369	552	0.6684783
C1	15263786	15263903	BolC1t02267H	0	+	0	0	117	0.0000000
C1	15268960	15272534	BolC1t02268H	0	-	1153	3458	3574	0.9675434
C1	15279481	15280370	BolC1t02269H	0	+	139	797	889	0.8965129
C1	15281672	15282716	BolC1t02270H	0	+	0	0	1044	0.0000000
C1	15282824	15283667	BolC1t02271H	0	+	12	22	843	0.0260973
C1	15285210	15285582	BolC1t02272H	0	-	0	0	372	0.0000000
C1	15287102	15287530	BolC1t02273H	0	-	3	25	428	0.0584112
C1	15292862	15293176	BolC1t02274H	0	-	56	274	314	0.8726115
C1	15296252	15296856	BolC1t02275H	0	-	62	419	604	0.6937086
C1	15319333	15322237	BolC1t02276H	0	+	337	2056	2904	0.7079890
C1	15322624	15323214	BolC1t02277H	0	-	141	590	590	1.0000000
C1	15325306	15325408	BolC1t02278H	0	+	3	102	102	1.0000000
C1	15327216	15328556	BolC1t02279H	0	+	358	1321	1340	0.9858209
C1	15349828	15350460	BolC1t02280H	0	-	441	632	632	1.0000000
C1	15355121	15355691	BolC1t02281H	0	-	293	570	570	1.0000000
C1	15367800	15370517	BolC1t02282H	0	-	1717	2703	2717	0.9948472
C1	15377092	15377476	BolC1t02283H	0	-	0	0	384	0.0000000
C1	15385440	15387145	BolC1t02284H	0	+	1000	1705	1705	1.0000000
C1	15399691	15402257	BolC1t02285H	0	+	222	1927	2566	0.7509743
C1	15429295	15431448	BolC1t02286H	0	-	713	1388	2153	0.6446818
C1	15434979	15438036	BolC1t02287H	0	+	612	2096	3057	0.6856395
C1	15438166	15441515	BolC1t02288H	0	-	262	1577	3349	0.4708868
C1	15444565	15445003	BolC1t02289H	0	-	247	438	438	1.0000000
C1	15447117	15447901	BolC1t02290H	0	+	183	703	784	0.8966837
C1	15450825	15451590	BolC1t02291H	0	-	171	709	765	0.9267974
C1	15452902	15454071	BolC1t02292H	0	-	238	1016	1169	0.8691189
C1	15467462	15470236	BolC1t02293H	0	-	1069	2680	2774	0.9661139
C1	15470873	15472474	BolC1t02294H	0	-	206	1189	1601	0.7426608
C1	15480537	15481128	BolC1t02295H	0	+	70	471	591	0.7969543
C1	15487939	15488550	BolC1t02296H	0	+	211	554	611	0.9067103
C1	15489306	15490406	BolC1t02297H	0	-	281	1091	1100	0.9918182
C1	15500670	15503095	BolC1t02298H	0	-	281	1564	2425	0.6449485
C1	15510178	15510361	BolC1t02299H	0	+	14	132	183	0.7213115
C1	15533571	15533993	BolC1t02300H	0	-	284	422	422	1.0000000
C1	15534568	15534948	BolC1t02301H	0	-	493	380	380	1.0000000
C1	15550184	15551314	BolC1t02302H	0	-	694	1130	1130	1.0000000
C1	15563824	15564316	BolC1t02303H	0	+	247	471	492	0.9573171
C1	15608818	15611927	BolC1t02304H	0	+	904	2850	3109	0.9166934
C1	15614751	15620118	BolC1t02305H	0	+	482	2847	5367	0.5304639
C1	15621178	15622735	BolC1t02306H	0	+	686	1557	1557	1.0000000
C1	15623419	15624633	BolC1t02307H	0	-	49	854	1214	0.7034596
C1	15654298	15654812	BolC1t02308H	0	-	342	514	514	1.0000000
C1	15655213	15655642	BolC1t02309H	0	-	489	429	429	1.0000000
C1	15655707	15656417	BolC1t02310H	0	-	514	688	710	0.9690141
C1	15658307	15659631	BolC1t02311H	0	+	165	1165	1324	0.8799093
C1	15661698	15662430	BolC1t02312H	0	+	177	657	732	0.8975410
C1	15662796	15664324	BolC1t02313H	0	-	1241	1528	1528	1.0000000
C1	15668528	15670278	BolC1t02314H	0	+	1585	1750	1750	1.0000000
C1	15671573	15671771	BolC1t02315H	0	+	188	198	198	1.0000000
C1	15673775	15675363	BolC1t02316H	0	+	1460	1588	1588	1.0000000
C1	15675741	15676035	BolC1t02317H	0	+	135	294	294	1.0000000
C1	15679498	15679765	BolC1t02318H	0	+	144	203	267	0.7602996
C1	15683494	15685111	BolC1t02319H	0	+	85	734	1617	0.4539270
C1	15685805	15689310	BolC1t02320H	0	+	1339	2976	3505	0.8490728
C1	15689741	15692358	BolC1t02321H	0	-	1022	2535	2617	0.9686664
C1	15695566	15696650	BolC1t02322H	0	-	147	828	1084	0.7638376
C1	15697928	15699201	BolC1t02323H	0	-	386	1216	1273	0.9552239
C1	15700236	15700674	BolC1t02324H	0	-	268	438	438	1.0000000
C1	15701244	15703664	BolC1t02325H	0	-	859	1792	2420	0.7404959
C1	15714182	15715755	BolC1t02326H	0	-	452	763	1573	0.4850604
C1	15722854	15723555	BolC1t02327H	0	+	19	404	701	0.5763195
C1	15724237	15733003	BolC1t02328H	0	-	4565	8766	8766	1.0000000
C1	15733823	15735455	BolC1t02329H	0	-	893	1556	1632	0.9534314
C1	15748783	15750115	BolC1t02330H	0	+	75	665	1332	0.4992492
C1	15750644	15751940	BolC1t02331H	0	-	602	1248	1296	0.9629630
C1	15753512	15757371	BolC1t02332H	0	-	2679	3749	3859	0.9714952
C1	15758063	15763154	BolC1t02333H	0	-	2026	4937	5091	0.9697505
C1	15763781	15766140	BolC1t02334H	0	+	43	1056	2359	0.4476473
C1	15766397	15766763	BolC1t02335H	0	+	17	270	366	0.7377049
C1	15767402	15767543	BolC1t02336H	0	+	0	0	141	0.0000000
C1	15771848	15773919	BolC1t02337H	0	-	2138	2071	2071	1.0000000
C1	15774709	15775513	BolC1t02338H	0	-	671	804	804	1.0000000
C1	15777255	15778932	BolC1t02339H	0	+	746	1587	1677	0.9463328
C1	15788183	15788372	BolC1t02340H	0	+	125	189	189	1.0000000
C1	15793985	15794499	BolC1t02341H	0	-	372	468	514	0.9105058
C1	15805500	15807335	BolC1t02342H	0	+	1204	1835	1835	1.0000000
C1	15813519	15813737	BolC1t02343H	0	-	61	218	218	1.0000000
C1	15857288	15857468	BolC1t02344H	0	+	25	141	180	0.7833334
C1	15861179	15861368	BolC1t02345H	0	+	28	119	189	0.6296296
C1	15866049	15866388	BolC1t02346H	0	+	1	31	339	0.0914454
C1	15867914	15868103	BolC1t02347H	0	+	112	189	189	1.0000000
C1	15868467	15870858	BolC1t02348H	0	-	1012	2209	2391	0.9238812
C1	15873718	15874297	BolC1t02349H	0	+	13	388	579	0.6701209
C1	15874780	15875350	BolC1t02350H	0	+	18	336	570	0.5894737
C1	15876751	15877588	BolC1t02351H	0	+	304	837	837	1.0000000
C1	15878874	15879548	BolC1t02352H	0	+	182	674	674	1.0000000
C1	15879726	15879888	BolC1t02353H	0	+	175	162	162	1.0000000
C1	15906331	15908430	BolC1t02354H	0	-	383	2026	2099	0.9652215
C1	15942594	15944041	BolC1t02355H	0	+	1028	1447	1447	1.0000000
C1	15944446	15944626	BolC1t02356H	0	+	18	180	180	1.0000000
C1	15954774	15955152	BolC1t02357H	0	+	63	378	378	1.0000000
C1	15973281	15975145	BolC1t02358H	0	+	672	1669	1864	0.8953863
C1	15982014	15982781	BolC1t02359H	0	-	28	459	767	0.5984355
C1	15983377	15985818	BolC1t02360H	0	+	539	2327	2441	0.9532979
C1	15987975	15989099	BolC1t02361H	0	-	437	1124	1124	1.0000000
C1	15991709	15991856	BolC1t02362H	0	-	177	147	147	1.0000000
C1	15998302	16000575	BolC1t02363H	0	+	601	1957	2273	0.8609767
C1	16010877	16013112	BolC1t02364H	0	+	688	2104	2235	0.9413870
C1	16013585	16016267	BolC1t02365H	0	-	816	2442	2682	0.9105145
C1	16019450	16019856	BolC1t02366H	0	+	37	304	406	0.7487684
C1	16020987	16021811	BolC1t02367H	0	+	237	728	824	0.8834952
C1	16022218	16023921	BolC1t02368H	0	+	305	1503	1703	0.8825602
C1	16025012	16025971	BolC1t02369H	0	+	11	486	959	0.5067779
C1	16030323	16030476	BolC1t02370H	0	-	169	153	153	1.0000000
C1	16030743	16030902	BolC1t02371H	0	-	126	159	159	1.0000000
C1	16037426	16039946	BolC1t02372H	0	+	1018	2136	2520	0.8476191
C1	16041077	16042842	BolC1t02373H	0	+	524	1750	1765	0.9915014
C1	16043279	16044669	BolC1t02374H	0	+	12	283	1390	0.2035971
C1	16052809	16053171	BolC1t02375H	0	-	39	362	362	1.0000000
C1	16056114	16056840	BolC1t02376H	0	-	12	331	726	0.4559229
C1	16066880	16067988	BolC1t02377H	0	-	113	820	1108	0.7400722
C1	16075515	16078844	BolC1t02378H	0	+	2793	2640	3329	0.7930309
C1	16079250	16081530	BolC1t02379H	0	+	550	2108	2280	0.9245614
C1	16084929	16088649	BolC1t02380H	0	+	1466	3552	3720	0.9548387
C1	16089558	16090829	BolC1t02381H	0	+	178	754	1271	0.5932336
C1	16092206	16093236	BolC1t02382H	0	+	149	997	1030	0.9679612
C1	16095738	16095900	BolC1t02383H	0	+	299	162	162	1.0000000
C1	16102610	16103376	BolC1t02384H	0	+	294	761	766	0.9934726
C1	16107278	16109540	BolC1t02385H	0	+	3966	2243	2262	0.9916003
C1	16115385	16116514	BolC1t02386H	0	-	83	1007	1129	0.8919398
C1	16158204	16159218	BolC1t02387H	0	-	138	867	1014	0.8550296
C1	16164790	16164925	BolC1t02388H	0	-	63	135	135	1.0000000
C1	16165420	16165828	BolC1t02389H	0	-	220	408	408	1.0000000
C1	16172654	16176699	BolC1t02390H	0	-	2062	3547	4045	0.8768851
C1	16177999	16178526	BolC1t02391H	0	+	0	0	527	0.0000000
C1	16191701	16192286	BolC1t02392H	0	+	0	0	585	0.0000000
C1	16202629	16206695	BolC1t02393H	0	+	2452	3947	4066	0.9707329
C1	16206936	16207599	BolC1t02394H	0	-	759	663	663	1.0000000
C1	16209426	16210193	BolC1t02395H	0	-	505	767	767	1.0000000
C1	16212593	16214034	BolC1t02396H	0	+	429	1420	1441	0.9854268
C1	16214361	16215418	BolC1t02397H	0	-	79	645	1057	0.6102176
C1	16215829	16216287	BolC1t02398H	0	-	475	458	458	1.0000000
C1	16217304	16219709	BolC1t02399H	0	+	523	2249	2405	0.9351351
C1	16220306	16220543	BolC1t02400H	0	+	30	237	237	1.0000000
C1	16222618	16222861	BolC1t02401H	0	+	1	88	243	0.3621399
C1	16223507	16223837	BolC1t02402H	0	-	137	330	330	1.0000000
C1	16228644	16233059	BolC1t02403H	0	-	1238	3870	4415	0.8765572
C1	16240637	16241519	BolC1t02404H	0	-	135	588	882	0.6666667
C1	16243390	16243678	BolC1t02405H	0	-	53	275	288	0.9548611
C1	16244077	16260322	BolC1t02406H	0	-	4819	13754	16245	0.8466605
C1	16249073	16249832	BolC1t02407H	0	+	20	391	759	0.5151515
C1	16261331	16261535	BolC1t02408H	0	+	0	0	204	0.0000000
C1	16262658	16262937	BolC1t02409H	0	+	682	279	279	1.0000000
C1	16263256	16263418	BolC1t02410H	0	-	340	162	162	1.0000000
C1	16263661	16264505	BolC1t02411H	0	+	218	834	844	0.9881517
C1	16264854	16265622	BolC1t02412H	0	-	164	682	768	0.8880208
C1	16271815	16272103	BolC1t02413H	0	-	13	21	288	0.0729167
C1	16272943	16274358	BolC1t02414H	0	+	492	1412	1415	0.9978799
C1	16276021	16277260	BolC1t02415H	0	+	585	1239	1239	1.0000000
C1	16279098	16280271	BolC1t02416H	0	-	209	995	1173	0.8482524
C1	16280973	16281234	BolC1t02417H	0	-	94	174	261	0.6666667
C1	16283803	16326344	BolC1t02418H	0	-	19416	32749	42541	0.7698221
C1	16300421	16301833	BolC1t02419H	0	-	88	661	1412	0.4681303
C1	16316876	16317308	BolC1t02420H	0	-	401	432	432	1.0000000
C1	16318461	16319131	BolC1t02421H	0	-	18	503	670	0.7507463
C1	16328247	16328835	BolC1t02422H	0	-	161	193	588	0.3282313
C1	16333880	16334615	BolC1t02423H	0	+	44	300	735	0.4081633
C1	16335132	16335587	BolC1t02424H	0	-	111	435	455	0.9560440
C1	16337610	16339247	BolC1t02425H	0	+	1134	1637	1637	1.0000000
C1	16339917	16340472	BolC1t02426H	0	+	221	555	555	1.0000000
C1	16340698	16342345	BolC1t02427H	0	-	231	1269	1647	0.7704918
C1	16347976	16348312	BolC1t02428H	0	-	56	318	336	0.9464286
C1	16369968	16370452	BolC1t02429H	0	-	351	484	484	1.0000000
C1	16386089	16387265	BolC1t02430H	0	+	34	320	1176	0.2721089
C1	16387676	16388036	BolC1t02431H	0	+	60	360	360	1.0000000
C1	16391226	16391887	BolC1t02432H	0	-	62	367	661	0.5552194
C1	16405357	16406106	BolC1t02433H	0	-	31	442	749	0.5901201
C1	16407349	16408522	BolC1t02434H	0	-	66	952	1173	0.8115942
C1	16410140	16410577	BolC1t02435H	0	+	3	83	437	0.1899313
C1	16410683	16437868	BolC1t02436H	0	+	10368	27021	27185	0.9939672
C1	16438288	16439923	BolC1t02437H	0	+	974	1454	1635	0.8892967
C1	16441227	16442735	BolC1t02438H	0	+	591	1497	1508	0.9927056
C1	16451404	16452493	BolC1t02439H	0	-	36	390	1089	0.3581267
C1	16477831	16478487	BolC1t02440H	0	-	893	656	656	1.0000000
C1	16496450	16497877	BolC1t02441H	0	+	136	1312	1427	0.9194114
C1	16498685	16502707	BolC1t02442H	0	+	1690	3894	4022	0.9681751
C1	16502474	16502798	BolC1t02443H	0	+	250	324	324	1.0000000
C1	16533550	16534235	BolC1t02444H	0	-	839	685	685	1.0000000
C1	16546998	16549292	BolC1t02445H	0	+	2110	2294	2294	1.0000000
C1	16553558	16555127	BolC1t02446H	0	+	342	1294	1569	0.8247291
C1	16555703	16559874	BolC1t02447H	0	+	1020	3317	4171	0.7952529
C1	16561322	16573445	BolC1t02448H	0	-	25445	10215	12123	0.8426132
C1	16577341	16577488	BolC1t02449H	0	-	191	147	147	1.0000000
C1	16581028	16581689	BolC1t02450H	0	+	207	637	661	0.9636914
C1	16581779	16582580	BolC1t02451H	0	+	167	644	801	0.8039950
C1	16582958	16583471	BolC1t02452H	0	+	77	459	513	0.8947368
C1	16583935	16585412	BolC1t02453H	0	+	234	1293	1477	0.8754231
C1	16585493	16586094	BolC1t02454H	0	+	54	528	601	0.8785357
C1	16587402	16588226	BolC1t02455H	0	-	27	225	824	0.2730583
C1	16642113	16643151	BolC1t02456H	0	-	4530	1038	1038	1.0000000
C1	16643494	16643842	BolC1t02457H	0	+	183	348	348	1.0000000
C1	16647074	16648166	BolC1t02458H	0	-	1909	1092	1092	1.0000000
C1	16648509	16648650	BolC1t02459H	0	+	20	141	141	1.0000000
C1	16683669	16687254	BolC1t02460H	0	-	1372	3406	3585	0.9500697
C1	16691433	16691977	BolC1t02461H	0	+	221	544	544	1.0000000
C1	16692149	16692493	BolC1t02462H	0	+	293	344	344	1.0000000
C1	16693795	16695467	BolC1t02463H	0	+	1247	1672	1672	1.0000000
C1	16695828	16697601	BolC1t02464H	0	-	839	1773	1773	1.0000000
C1	16699569	16700448	BolC1t02465H	0	-	266	840	879	0.9556314
C1	16705984	16706499	BolC1t02466H	0	+	236	450	515	0.8737864
C1	16709660	16710099	BolC1t02467H	0	-	162	439	439	1.0000000
C1	16725676	16726213	BolC1t02468H	0	+	285	537	537	1.0000000
C1	16735862	16738647	BolC1t02469H	0	-	1181	2741	2785	0.9842011
C1	16739965	16741340	BolC1t02470H	0	+	163	1168	1375	0.8494545
C1	16741593	16759358	BolC1t02471H	0	-	1738	8445	17765	0.4753729
C1	16746251	16746908	BolC1t02472H	0	-	74	657	657	1.0000000
C1	16756741	16756950	BolC1t02473H	0	-	4	94	209	0.4497608
C1	16759964	16761013	BolC1t02474H	0	-	734	1049	1049	1.0000000
C1	16761071	16762697	BolC1t02475H	0	-	367	1302	1626	0.8007380
C1	16773467	16775842	BolC1t02476H	0	+	1453	2375	2375	1.0000000
C1	16781252	16783122	BolC1t02477H	0	+	855	1743	1870	0.9320856
C1	16793327	16794923	BolC1t02478H	0	+	447	1596	1596	1.0000000
C1	16796540	16798913	BolC1t02479H	0	+	323	1920	2373	0.8091024
C1	16799380	16799934	BolC1t02480H	0	-	29	332	554	0.5992780
C1	16801445	16803803	BolC1t02481H	0	+	16	691	2358	0.2930450
C1	16815028	16818677	BolC1t02482H	0	+	1454	3224	3649	0.8835297
C1	16818919	16820472	BolC1t02483H	0	-	294	1355	1553	0.8725048
C1	16824495	16828501	BolC1t02484H	0	-	537	3362	4006	0.8392411
C1	16826032	16827054	BolC1t02485H	0	-	76	902	1022	0.8825831
C1	16831439	16832797	BolC1t02486H	0	+	296	1328	1358	0.9779087
C1	16836984	16838879	BolC1t02487H	0	+	390	1727	1895	0.9113457
C1	16840238	16841363	BolC1t02488H	0	+	264	1125	1125	1.0000000
C1	16842326	16844359	BolC1t02489H	0	-	377	1897	2033	0.9331038
C1	16855932	16858057	BolC1t02490H	0	+	567	1960	2125	0.9223530
C1	16858498	16859743	BolC1t02491H	0	+	108	614	1245	0.4931727
C1	16860080	16861535	BolC1t02492H	0	-	907	1455	1455	1.0000000
C1	16862439	16864729	BolC1t02493H	0	-	1907	2290	2290	1.0000000
C1	16865103	16867188	BolC1t02494H	0	+	1224	2085	2085	1.0000000
C1	16872661	16874083	BolC1t02495H	0	+	299	1219	1422	0.8572433
C1	16876284	16878915	BolC1t02496H	0	+	907	2134	2631	0.8110985
C1	16885041	16886237	BolC1t02497H	0	-	159	728	1196	0.6086956
C1	16891470	16894185	BolC1t02498H	0	+	434	2052	2715	0.7558011
C1	16906830	16907286	BolC1t02499H	0	-	195	456	456	1.0000000
C1	16911165	16911860	BolC1t02500H	0	+	141	695	695	1.0000000
C1	16925450	16929877	BolC1t02501H	0	+	2969	4224	4427	0.9541450
C1	16930503	16934983	BolC1t02502H	0	-	1150	4242	4480	0.9468750
C1	16935515	16937108	BolC1t02503H	0	-	1608	1593	1593	1.0000000
C1	16937698	16944621	BolC1t02504H	0	+	214	1903	6923	0.2748808
C1	16952594	16954127	BolC1t02505H	0	-	98	997	1533	0.6503588
C1	16966112	16967993	BolC1t02506H	0	-	2705	1830	1881	0.9728867
C1	16968719	16969109	BolC1t02507H	0	-	313	390	390	1.0000000
C1	16969139	16971908	BolC1t02508H	0	-	1570	2769	2769	1.0000000
C1	16975500	16975985	BolC1t02509H	0	-	445	485	485	1.0000000
C1	16977887	16979025	BolC1t02510H	0	-	566	1138	1138	1.0000000
C1	16992238	16992562	BolC1t02511H	0	+	47	324	324	1.0000000
C1	16997546	16999676	BolC1t02512H	0	+	549	2081	2130	0.9769953
C1	16999943	17001397	BolC1t02513H	0	-	881	1454	1454	1.0000000
C1	17002104	17004933	BolC1t02514H	0	-	741	2797	2829	0.9886886
C1	17009698	17011154	BolC1t02515H	0	+	260	1456	1456	1.0000000
C1	17014254	17016108	BolC1t02516H	0	-	1376	1854	1854	1.0000000
C1	17017164	17017743	BolC1t02517H	0	-	296	487	579	0.8411053
C1	17022934	17025760	BolC1t02518H	0	+	464	2294	2826	0.8117480
C1	17045201	17052103	BolC1t02519H	0	-	1348	5093	6902	0.7379020
C1	17060455	17061865	BolC1t02520H	0	+	500	1363	1410	0.9666666
C1	17063288	17064449	BolC1t02521H	0	-	101	780	1161	0.6718346
C1	17098724	17099446	BolC1t02522H	0	-	496	695	722	0.9626039
C1	17100768	17102369	BolC1t02523H	0	+	2481	1601	1601	1.0000000
C1	17113684	17117287	BolC1t02524H	0	+	917	3170	3603	0.8798224
C1	17121975	17124533	BolC1t02525H	0	-	559	2558	2558	1.0000000
C1	17153968	17156639	BolC1t02526H	0	+	634	2411	2671	0.9026582
C1	17162955	17164659	BolC1t02527H	0	-	566	1657	1704	0.9724178
C1	17168544	17169090	BolC1t02528H	0	+	57	236	546	0.4322344
C1	17203523	17205600	BolC1t02529H	0	-	642	1787	2077	0.8603755
C1	17218508	17219425	BolC1t02530H	0	-	278	658	917	0.7175573
C1	17229442	17230708	BolC1t02531H	0	+	518	1226	1266	0.9684044
C1	17232096	17232793	BolC1t02532H	0	-	372	693	697	0.9942611
C1	17233326	17235635	BolC1t02533H	0	+	706	2240	2309	0.9701169
C1	17236623	17236764	BolC1t02534H	0	-	324	141	141	1.0000000
C1	17238849	17239167	BolC1t02535H	0	+	186	318	318	1.0000000
C1	17265154	17265479	BolC1t02536H	0	-	81	325	325	1.0000000
C1	17265700	17308640	BolC1t02537H	0	+	7110	37493	42940	0.8731486
C1	17268031	17269235	BolC1t02538H	0	-	94	995	1204	0.8264120
C1	17309746	17310759	BolC1t02539H	0	+	647	972	1013	0.9595262
C1	17312498	17314805	BolC1t02540H	0	-	1011	2283	2307	0.9895969
C1	17317401	17320083	BolC1t02541H	0	+	983	2201	2682	0.8206562
C1	17320440	17323142	BolC1t02542H	0	-	1322	2429	2702	0.8989637
C1	17337827	17341767	BolC1t02543H	0	-	2339	3627	3940	0.9205584
C1	17343750	17346285	BolC1t02544H	0	-	922	2511	2535	0.9905325
C1	17356657	17357734	BolC1t02545H	0	+	115	424	1077	0.3936862
C1	17365480	17369384	BolC1t02546H	0	+	2804	3904	3904	1.0000000
C1	17376329	17379154	BolC1t02547H	0	+	218	2351	2825	0.8322124
C1	17381479	17382400	BolC1t02548H	0	+	120	890	921	0.9663410
C1	17392268	17392884	BolC1t02549H	0	-	462	616	616	1.0000000
C1	17395910	17397418	BolC1t02550H	0	+	209	1072	1508	0.7108753
C1	17397682	17398217	BolC1t02551H	0	-	12	253	535	0.4728972
C1	17413616	17414766	BolC1t02552H	0	+	428	1094	1150	0.9513044
C1	17415865	17416450	BolC1t02553H	0	-	269	537	585	0.9179487
C1	17419278	17424192	BolC1t02554H	0	-	2160	3988	4914	0.8115588
C1	17445706	17446061	BolC1t02555H	0	+	357	355	355	1.0000000
C1	17464909	17466307	BolC1t02556H	0	+	259	1188	1398	0.8497854
C1	17466947	17470783	BolC1t02557H	0	-	1850	3496	3836	0.9113660
C1	17472316	17472508	BolC1t02558H	0	+	32	192	192	1.0000000
C1	17475949	17477463	BolC1t02559H	0	+	884	1374	1514	0.9075297
C1	17480292	17481771	BolC1t02560H	0	+	156	1382	1479	0.9344152
C1	17490616	17491486	BolC1t02561H	0	+	218	870	870	1.0000000
C1	17497216	17498429	BolC1t02562H	0	+	577	1149	1213	0.9472383
C1	17500504	17501041	BolC1t02563H	0	-	32	462	537	0.8603352
C1	17502709	17502880	BolC1t02564H	0	-	13	171	171	1.0000000
C1	17504853	17505024	BolC1t02565H	0	-	0	0	171	0.0000000
C1	17505880	17507054	BolC1t02566H	0	+	969	1161	1174	0.9889268
C1	17508229	17509545	BolC1t02567H	0	+	539	796	1316	0.6048632
C1	17509791	17511583	BolC1t02568H	0	-	221	1569	1792	0.8755580
C1	17518452	17519280	BolC1t02569H	0	+	1	41	828	0.0495169
C1	17520050	17520776	BolC1t02570H	0	-	4	97	726	0.1336088
C1	17531082	17531298	BolC1t02571H	0	+	402	216	216	1.0000000
C1	17554215	17560507	BolC1t02572H	0	+	830	4297	6292	0.6829307
C1	17573421	17574003	BolC1t02573H	0	-	226	582	582	1.0000000
C1	17582274	17582613	BolC1t02574H	0	+	24	191	339	0.5634218
C1	17593136	17593445	BolC1t02575H	0	-	388	309	309	1.0000000
C1	17603094	17604597	BolC1t02576H	0	+	199	940	1503	0.6254159
C1	17605388	17607198	BolC1t02577H	0	-	138	1200	1810	0.6629834
C1	17613498	17615181	BolC1t02578H	0	+	625	1532	1683	0.9102793
C1	17615561	17617943	BolC1t02579H	0	-	103	1381	2382	0.5797649
C1	17673892	17674054	BolC1t02580H	0	-	2	124	162	0.7654321
C1	17711357	17713315	BolC1t02581H	0	-	537	1590	1958	0.8120531
C1	17725630	17726025	BolC1t02582H	0	-	48	359	395	0.9088607
C1	17740138	17740535	BolC1t02583H	0	+	258	397	397	1.0000000
C1	17751952	17752333	BolC1t02584H	0	-	2	112	381	0.2939633
C1	17774621	17776450	BolC1t02585H	0	-	46	775	1829	0.4237288
C1	17809934	17810377	BolC1t02586H	0	+	652	443	443	1.0000000
C1	17810536	17812311	BolC1t02587H	0	+	1385	1775	1775	1.0000000
C1	17813797	17815499	BolC1t02588H	0	+	1095	1699	1702	0.9982374
C1	17818232	17819222	BolC1t02589H	0	+	995	990	990	1.0000000
C1	17825360	17827563	BolC1t02590H	0	+	695	1880	2203	0.8533818
C1	17827851	17829207	BolC1t02591H	0	-	96	808	1356	0.5958702
C1	17842811	17844272	BolC1t02592H	0	+	967	1461	1461	1.0000000
C1	17844877	17845288	BolC1t02593H	0	+	351	411	411	1.0000000
C1	17846457	17855973	BolC1t02594H	0	-	2601	6167	9516	0.6480664
C1	17856426	17858529	BolC1t02595H	0	-	231	1416	2103	0.6733238
C1	17859306	17860629	BolC1t02596H	0	-	580	1323	1323	1.0000000
C1	17886821	17922348	BolC1t02597H	0	-	7225	25229	35527	0.7101359
C1	17919755	17920067	BolC1t02598H	0	+	20	282	312	0.9038461
C1	17927777	17929021	BolC1t02599H	0	+	308	1244	1244	1.0000000
C1	17929293	17941474	BolC1t02600H	0	+	5311	10408	12181	0.8544455
C1	17942758	17944042	BolC1t02601H	0	+	267	1176	1284	0.9158878
C1	17950100	17950424	BolC1t02602H	0	+	261	324	324	1.0000000
C1	17955706	17962545	BolC1t02603H	0	+	374	2893	6839	0.4230151
C1	17965292	17966684	BolC1t02604H	0	-	232	814	1392	0.5847701
C1	17973087	17974133	BolC1t02605H	0	+	436	1046	1046	1.0000000
C1	17975584	17977256	BolC1t02606H	0	+	286	1300	1672	0.7775120
C1	17984695	17984905	BolC1t02607H	0	-	217	210	210	1.0000000
C1	17992804	17995459	BolC1t02608H	0	-	665	2518	2655	0.9483992
C1	18001332	18002164	BolC1t02609H	0	+	88	832	832	1.0000000
C1	18005197	18007019	BolC1t02610H	0	+	829	1755	1822	0.9632272
C1	18010690	18011599	BolC1t02611H	0	+	12175	909	909	1.0000000
C1	18016613	18018564	BolC1t02612H	0	-	333	1266	1951	0.6488980
C1	18018895	18023824	BolC1t02613H	0	+	836	2971	4929	0.6027592
C1	18025571	18026258	BolC1t02614H	0	-	99	579	687	0.8427948
C1	18031923	18034054	BolC1t02615H	0	-	650	1946	2131	0.9131863
C1	18034438	18037616	BolC1t02616H	0	+	2288	3178	3178	1.0000000
C1	18044489	18048815	BolC1t02617H	0	+	1453	4105	4326	0.9489136
C1	18049590	18050067	BolC1t02618H	0	+	238	477	477	1.0000000
C1	18050369	18050822	BolC1t02619H	0	+	71	416	453	0.9183223
C1	18062562	18064207	BolC1t02620H	0	+	517	1645	1645	1.0000000
C1	18064740	18066214	BolC1t02621H	0	-	6	255	1474	0.1729986
C1	18090874	18093774	BolC1t02622H	0	+	590	2272	2900	0.7834483
C1	18092140	18093501	BolC1t02623H	0	-	111	816	1361	0.5995591
C1	18094143	18097426	BolC1t02624H	0	+	1971	3179	3283	0.9683217
C1	18098159	18100957	BolC1t02625H	0	+	704	2436	2798	0.8706219
C1	18102563	18103412	BolC1t02626H	0	+	493	849	849	1.0000000
C1	18106222	18106798	BolC1t02627H	0	-	23	379	576	0.6579861
C1	18117360	18124095	BolC1t02628H	0	-	821	4481	6735	0.6653304
C1	18141072	18141435	BolC1t02629H	0	+	63	363	363	1.0000000
C1	18142521	18143105	BolC1t02630H	0	-	58	349	584	0.5976027
C1	18143713	18144651	BolC1t02631H	0	-	157	819	938	0.8731343
C1	18148412	18149821	BolC1t02632H	0	-	251	1277	1409	0.9063165
C1	18160852	18163557	BolC1t02633H	0	+	658	1907	2705	0.7049907
C1	18164322	18166882	BolC1t02634H	0	-	284	1804	2560	0.7046875
C1	18168058	18168840	BolC1t02635H	0	+	24	208	782	0.2659847
C1	18195441	18197243	BolC1t02636H	0	-	10	487	1802	0.2702553
C1	18202450	18202887	BolC1t02637H	0	+	65	303	437	0.6933638
C1	18220953	18222395	BolC1t02638H	0	-	155	787	1442	0.5457698
C1	18225391	18229685	BolC1t02639H	0	+	2422	4294	4294	1.0000000
C1	18240776	18241043	BolC1t02640H	0	-	630	267	267	1.0000000
C1	18244421	18244838	BolC1t02641H	0	+	785	417	417	1.0000000
C1	18271798	18273754	BolC1t02642H	0	-	208	1586	1956	0.8108385
C1	18279813	18279984	BolC1t02643H	0	-	60	171	171	1.0000000
C1	18284888	18285258	BolC1t02644H	0	-	178	370	370	1.0000000
C1	18287166	18290002	BolC1t02645H	0	-	1318	2836	2836	1.0000000
C1	18292573	18293235	BolC1t02646H	0	-	727	662	662	1.0000000
C1	18295699	18295876	BolC1t02647H	0	+	215	177	177	1.0000000
C1	18321393	18322325	BolC1t02648H	0	-	1193	932	932	1.0000000
C1	18324971	18326024	BolC1t02649H	0	+	11	395	1053	0.3751187
C1	18332226	18334998	BolC1t02650H	0	-	1059	2748	2772	0.9913420
C1	18339928	18343523	BolC1t02651H	0	+	1865	3406	3595	0.9474270
C1	18343756	18344602	BolC1t02652H	0	+	404	846	846	1.0000000
C1	18346204	18349426	BolC1t02653H	0	+	2729	3168	3222	0.9832402
C1	18353101	18355288	BolC1t02654H	0	-	1362	2168	2187	0.9913123
C1	18356220	18361258	BolC1t02655H	0	-	2791	4972	5038	0.9868996
C1	18362685	18377715	BolC1t02656H	0	+	4156	11041	15030	0.7345974
C1	18378768	18380641	BolC1t02657H	0	+	1961	1873	1873	1.0000000
C1	18381841	18382405	BolC1t02658H	0	-	167	564	564	1.0000000
C1	18398952	18401023	BolC1t02659H	0	-	316	1263	2071	0.6098503
C1	18416055	18416676	BolC1t02660H	0	+	75	466	621	0.7504026
C1	18423139	18424465	BolC1t02661H	0	+	70	641	1326	0.4834087
C1	18428726	18430292	BolC1t02662H	0	+	349	1421	1566	0.9074074
C1	18451525	18451810	BolC1t02663H	0	+	323	285	285	1.0000000
C1	18451903	18452671	BolC1t02664H	0	+	458	768	768	1.0000000
C1	18461215	18461473	BolC1t02665H	0	+	326	258	258	1.0000000
C1	18464315	18464648	BolC1t02666H	0	+	409	333	333	1.0000000
C1	18469530	18470724	BolC1t02667H	0	+	270	975	1194	0.8165829
C1	18470906	18472836	BolC1t02668H	0	+	834	1866	1930	0.9668394
C1	18479732	18484097	BolC1t02669H	0	+	1286	3684	4365	0.8439863
C1	18486794	18487103	BolC1t02670H	0	-	60	180	309	0.5825243
C1	18493193	18493502	BolC1t02671H	0	-	260	309	309	1.0000000
C1	18501566	18501875	BolC1t02672H	0	-	270	309	309	1.0000000
C1	18511696	18513471	BolC1t02673H	0	+	642	1695	1775	0.9549296
C1	18516912	18519369	BolC1t02674H	0	+	1057	2209	2457	0.8990639
C1	18530648	18535282	BolC1t02675H	0	-	1010	4276	4634	0.9227449
C1	18537862	18538971	BolC1t02676H	0	-	173	882	1109	0.7953111
C1	18549058	18552094	BolC1t02677H	0	-	600	2563	3036	0.8442029
C1	18568908	18600624	BolC1t02678H	0	+	17753	27390	31716	0.8636020
C1	18570861	18572608	BolC1t02679H	0	-	559	1702	1747	0.9742416
C1	18585965	18586183	BolC1t02680H	0	+	239	218	218	1.0000000
C1	18588551	18589130	BolC1t02681H	0	+	1732	579	579	1.0000000
C1	18603710	18610573	BolC1t02682H	0	+	1224	6179	6863	0.9003351
C1	18611100	18612439	BolC1t02683H	0	-	128	1177	1339	0.8790142
C1	18614072	18614785	BolC1t02684H	0	+	21	16	713	0.0224404
C1	18615256	18616706	BolC1t02685H	0	-	222	1290	1450	0.8896552
C1	18617112	18622014	BolC1t02686H	0	-	791	3956	4902	0.8070176
C1	18626354	18627773	BolC1t02687H	0	+	12	445	1419	0.3136011
C1	18637569	18643639	BolC1t02688H	0	+	164	2369	6070	0.3902801
C1	18667868	18669317	BolC1t02689H	0	+	162	1175	1449	0.8109041
C1	18676530	18684570	BolC1t02690H	0	+	633	3172	8040	0.3945274
C1	18689548	18691442	BolC1t02691H	0	-	312	1300	1894	0.6863781
C1	18701441	18702125	BolC1t02692H	0	+	27	564	684	0.8245614
C1	18702349	18703831	BolC1t02693H	0	+	12	320	1482	0.2159244
C1	18703968	18707209	BolC1t02694H	0	-	228	1709	3241	0.5273064
C1	18715805	18716750	BolC1t02695H	0	-	132	645	945	0.6825397
C1	18717982	18718462	BolC1t02696H	0	+	53	257	480	0.5354167
C1	18723675	18724652	BolC1t02697H	0	-	1102	977	977	1.0000000
C1	18726915	18727400	BolC1t02698H	0	+	0	0	485	0.0000000
C1	18728542	18728962	BolC1t02699H	0	+	28	233	420	0.5547619
C1	18750116	18750581	BolC1t02700H	0	-	68	241	465	0.5182796
C1	18750628	18751034	BolC1t02701H	0	-	0	0	406	0.0000000
C1	18751292	18751712	BolC1t02702H	0	-	27	336	420	0.8000000
C1	18752224	18753103	BolC1t02703H	0	+	247	729	879	0.8293515
C1	18754674	18756412	BolC1t02704H	0	-	45	719	1738	0.4136939
C1	18759990	18761104	BolC1t02705H	0	-	222	1064	1114	0.9551167
C1	18763433	18765000	BolC1t02706H	0	-	346	1471	1567	0.9387364
C1	18780761	18781619	BolC1t02707H	0	-	394	823	858	0.9592075
C1	18788229	18793261	BolC1t02708H	0	-	1526	3155	5032	0.6269873
C1	18797512	18797671	BolC1t02709H	0	+	58	152	159	0.9559748
C1	18814845	18815289	BolC1t02710H	0	-	4	306	444	0.6891892
C1	18821357	18822674	BolC1t02711H	0	+	179	1159	1317	0.8800304
C1	18851717	18853828	BolC1t02712H	0	-	1508	2111	2111	1.0000000
C1	18864437	18865781	BolC1t02713H	0	+	10	125	1344	0.0930060
C1	18871806	18874580	BolC1t02714H	0	-	34	560	2774	0.2018746
C1	18878108	18879452	BolC1t02715H	0	+	9	214	1344	0.1592262
C1	18886276	18887734	BolC1t02716H	0	-	230	1208	1458	0.8285322
C1	18890993	18891287	BolC1t02717H	0	-	13	160	294	0.5442177
C1	18906574	18908541	BolC1t02718H	0	+	560	1827	1967	0.9288256
C1	18910367	18910559	BolC1t02719H	0	+	1	14	192	0.0729167
C1	18918754	18920101	BolC1t02720H	0	+	295	1282	1347	0.9517446
C1	18921529	18924519	BolC1t02721H	0	+	474	2723	2990	0.9107023
C1	18924986	18935560	BolC1t02722H	0	-	942	3930	10574	0.3716663
C1	18969461	18970102	BolC1t02723H	0	+	107	618	641	0.9641185
C1	18979160	18980471	BolC1t02724H	0	-	80	540	1311	0.4118993
C1	18981369	18982467	BolC1t02725H	0	-	1330	1098	1098	1.0000000
C1	19031772	19033314	BolC1t02726H	0	-	130	1246	1542	0.8080415
C1	19035986	19036538	BolC1t02727H	0	-	30	250	552	0.4528986
C1	19053521	19057609	BolC1t02728H	0	-	1712	4088	4088	1.0000000
C1	19061643	19064513	BolC1t02729H	0	+	1227	2447	2870	0.8526132
C1	19069728	19071229	BolC1t02730H	0	-	1097	1501	1501	1.0000000
C1	19083956	19084357	BolC1t02731H	0	+	166	401	401	1.0000000
C1	19089475	19091939	BolC1t02732H	0	-	536	2464	2464	1.0000000
C1	19092072	19099098	BolC1t02733H	0	-	2391	6597	7026	0.9389411
C1	19116490	19116926	BolC1t02734H	0	-	521	436	436	1.0000000
C1	19127861	19129803	BolC1t02735H	0	+	57	569	1942	0.2929969
C1	19150742	19152646	BolC1t02736H	0	+	13	528	1904	0.2773109
C1	19161726	19164882	BolC1t02737H	0	+	987	2706	3156	0.8574144
C1	19164981	19167072	BolC1t02738H	0	-	775	2069	2091	0.9894787
C1	19184145	19186727	BolC1t02739H	0	-	214	2225	2582	0.8617351
C1	19187666	19189601	BolC1t02740H	0	+	440	1614	1935	0.8341085
C1	19190374	19190782	BolC1t02741H	0	-	148	408	408	1.0000000
C1	19194981	19197904	BolC1t02742H	0	+	1166	2714	2923	0.9284981
C1	19202095	19203277	BolC1t02743H	0	+	604	984	1182	0.8324873
C1	19206629	19206967	BolC1t02744H	0	+	2	30	338	0.0887574
C1	19208152	19210191	BolC1t02745H	0	-	1026	2039	2039	1.0000000
C1	19237736	19241633	BolC1t02746H	0	-	574	3607	3897	0.9255838
C1	19245933	19248092	BolC1t02747H	0	-	1319	2135	2159	0.9888837
C1	19252141	19255602	BolC1t02748H	0	+	476	1976	3461	0.5709333
C1	19262782	19263019	BolC1t02749H	0	-	101	237	237	1.0000000
C1	19264285	19265293	BolC1t02750H	0	+	7	112	1008	0.1111111
C1	19284176	19284338	BolC1t02751H	0	+	167	162	162	1.0000000
C1	19297450	19298716	BolC1t02752H	0	+	567	1090	1266	0.8609794
C1	19300041	19300497	BolC1t02753H	0	-	113	456	456	1.0000000
C1	19301101	19303093	BolC1t02754H	0	+	1127	1957	1992	0.9824297
C1	19303471	19303999	BolC1t02755H	0	-	183	528	528	1.0000000
C1	19304215	19304797	BolC1t02756H	0	-	767	582	582	1.0000000
C1	19316341	19318378	BolC1t02757H	0	+	801	1945	2037	0.9548355
C1	19320481	19320802	BolC1t02758H	0	-	24	195	321	0.6074767
C1	19324918	19326736	BolC1t02759H	0	-	700	1540	1818	0.8470847
C1	19327084	19328438	BolC1t02760H	0	-	683	1354	1354	1.0000000
C1	19328749	19332276	BolC1t02761H	0	+	1189	3121	3527	0.8848880
C1	19332696	19334591	BolC1t02762H	0	-	1110	1895	1895	1.0000000
C1	19334874	19336024	BolC1t02763H	0	-	333	1087	1150	0.9452174
C1	19337850	19338558	BolC1t02764H	0	-	364	708	708	1.0000000
C1	19364328	19365845	BolC1t02765H	0	-	262	1503	1517	0.9907712
C1	19372128	19375457	BolC1t02766H	0	+	1210	3089	3329	0.9279063
C1	19375789	19380872	BolC1t02767H	0	-	1125	4604	5083	0.9057643
C1	19404879	19405617	BolC1t02768H	0	+	419	738	738	1.0000000
C1	19418102	19419461	BolC1t02769H	0	-	648	1325	1359	0.9749816
C1	19455124	19456997	BolC1t02770H	0	-	213	694	1873	0.3705285
C1	19480366	19482367	BolC1t02771H	0	+	1228	1953	2001	0.9760120
C1	19556388	19556763	BolC1t02772H	0	-	153	375	375	1.0000000
C1	19615854	19616832	BolC1t02773H	0	-	0	0	978	0.0000000
C1	19631866	19635292	BolC1t02774H	0	+	508	2590	3426	0.7559837
C1	19638135	19639368	BolC1t02775H	0	-	791	1066	1233	0.8645580
C1	19651684	19654394	BolC1t02776H	0	+	1234	2701	2710	0.9966789
C1	19689051	19690367	BolC1t02777H	0	+	297	822	1316	0.6246201
C1	19705663	19706237	BolC1t02778H	0	-	385	574	574	1.0000000
C1	19706852	19707224	BolC1t02779H	0	+	308	372	372	1.0000000
C1	19709760	19712935	BolC1t02780H	0	+	5	240	3175	0.0755906
C1	19722869	19723025	BolC1t02781H	0	-	26	156	156	1.0000000
C1	19723365	19724702	BolC1t02782H	0	+	330	1136	1337	0.8496634
C1	19756566	19758908	BolC1t02783H	0	+	1229	2342	2342	1.0000000
C1	19760461	19761672	BolC1t02784H	0	+	227	891	1211	0.7357556
C1	19766849	19767793	BolC1t02785H	0	-	15	333	944	0.3527542
C1	19779520	19781443	BolC1t02786H	0	+	305	1523	1923	0.7919917
C1	19783637	19785498	BolC1t02787H	0	-	1208	1861	1861	1.0000000
C1	19790380	19794743	BolC1t02788H	0	+	737	3164	4363	0.7251891
C1	19800283	19801813	BolC1t02789H	0	-	1847	1530	1530	1.0000000
C1	19814447	19814633	BolC1t02790H	0	+	262	186	186	1.0000000
C1	19823864	19823981	BolC1t02791H	0	+	15	117	117	1.0000000
C1	19824348	19824898	BolC1t02792H	0	+	86	379	550	0.6890909
C1	19829045	19830144	BolC1t02793H	0	-	371	897	1099	0.8161966
C1	19839151	19840370	BolC1t02794H	0	+	281	1214	1219	0.9958983
C1	19849876	19851568	BolC1t02795H	0	-	673	1537	1692	0.9083924
C1	19856936	19858451	BolC1t02796H	0	-	527	1429	1515	0.9432343
C1	19878002	19879009	BolC1t02797H	0	-	577	1007	1007	1.0000000
C1	19886249	19886739	BolC1t02798H	0	-	480	490	490	1.0000000
C1	19887596	19920417	BolC1t02799H	0	-	9544	30316	32821	0.9236769
C1	19893002	19893323	BolC1t02800H	0	-	54	211	321	0.6573209
C1	19930933	19931479	BolC1t02801H	0	+	85	480	546	0.8791209
C1	19931978	19934498	BolC1t02802H	0	-	1205	2414	2520	0.9579365
C1	19954638	19956060	BolC1t02803H	0	+	173	1270	1422	0.8931083
C1	19963841	19965644	BolC1t02804H	0	+	1808	1803	1803	1.0000000
C1	19969705	19970813	BolC1t02805H	0	+	144	303	1108	0.2734657
C1	19971558	19972170	BolC1t02806H	0	+	259	600	612	0.9803922
C1	19974983	19975109	BolC1t02807H	0	-	91	126	126	1.0000000
C1	19976022	19982296	BolC1t02808H	0	+	3469	5560	6274	0.8861970
C1	19989310	19990802	BolC1t02809H	0	+	868	1473	1492	0.9872654
C1	19994757	19995072	BolC1t02810H	0	-	150	225	315	0.7142857
C1	20003181	20006978	BolC1t02811H	0	-	785	3584	3797	0.9439031
C1	20026637	20027768	BolC1t02812H	0	+	81	697	1131	0.6162688
C1	20033778	20034054	BolC1t02813H	0	-	312	276	276	1.0000000
C1	20037584	20040902	BolC1t02814H	0	+	1024	2508	3318	0.7558770
C1	20041290	20043238	BolC1t02815H	0	-	556	1817	1948	0.9327515
C1	20050015	20050192	BolC1t02816H	0	+	82	174	177	0.9830508
C1	20051446	20052768	BolC1t02817H	0	+	84	952	1322	0.7201210
C1	20054253	20054409	BolC1t02818H	0	-	8	47	156	0.3012820
C1	20058953	20059055	BolC1t02819H	0	-	5	102	102	1.0000000
C1	20060377	20064402	BolC1t02820H	0	-	866	3253	4025	0.8081988
C1	20075000	20077333	BolC1t02821H	0	+	636	2279	2333	0.9768538
C1	20078017	20078782	BolC1t02822H	0	-	4	156	765	0.2039216
C1	20081072	20083208	BolC1t02823H	0	+	90	1459	2136	0.6830524
C1	20087704	20088546	BolC1t02824H	0	+	238	811	842	0.9631829
C1	20099830	20102337	BolC1t02825H	0	-	266	1621	2507	0.6465896
C1	20116470	20120054	BolC1t02826H	0	-	421	1872	3584	0.5223214
C1	20126373	20128111	BolC1t02827H	0	+	1235	1738	1738	1.0000000
C1	20130924	20132214	BolC1t02828H	0	+	916	1290	1290	1.0000000
C1	20132586	20132931	BolC1t02829H	0	+	84	278	345	0.8057971
C1	20161655	20161964	BolC1t02830H	0	-	226	309	309	1.0000000
C1	20163171	20163527	BolC1t02831H	0	+	445	356	356	1.0000000
C1	20164987	20166167	BolC1t02832H	0	-	299	1057	1180	0.8957627
C1	20166635	20170205	BolC1t02833H	0	+	812	3246	3570	0.9092437
C1	20171085	20172794	BolC1t02834H	0	-	814	1693	1709	0.9906378
C1	20173550	20174252	BolC1t02835H	0	-	407	702	702	1.0000000
C1	20174759	20175086	BolC1t02836H	0	-	88	273	327	0.8348624
C1	20176434	20179061	BolC1t02837H	0	+	391	2283	2627	0.8690522
C1	20179855	20181074	BolC1t02838H	0	+	679	1198	1219	0.9827728
C1	20181918	20185886	BolC1t02839H	0	-	1927	3459	3968	0.8717238
C1	20191307	20192698	BolC1t02840H	0	-	154	1121	1391	0.8058950
C1	20193921	20195569	BolC1t02841H	0	-	102	1022	1648	0.6201456
C1	20231440	20232912	BolC1t02842H	0	+	637	1448	1472	0.9836956
C1	20235731	20236568	BolC1t02843H	0	+	27	344	837	0.4109916
C1	20236698	20238239	BolC1t02844H	0	-	1340	1541	1541	1.0000000
C1	20242943	20243153	BolC1t02845H	0	+	229	210	210	1.0000000
C1	20245353	20246743	BolC1t02846H	0	-	413	1286	1390	0.9251798
C1	20253370	20254254	BolC1t02847H	0	+	991	884	884	1.0000000
C1	20264607	20265644	BolC1t02848H	0	-	98	840	1037	0.8100289
C1	20266738	20268267	BolC1t02849H	0	-	1134	1529	1529	1.0000000
C1	20268661	20271347	BolC1t02850H	0	-	1600	2532	2686	0.9426657
C1	20274271	20274475	BolC1t02851H	0	+	106	204	204	1.0000000
C1	20277741	20279550	BolC1t02852H	0	+	139	1294	1809	0.7153123
C1	20281137	20281422	BolC1t02853H	0	-	3	150	285	0.5263158
C1	20289394	20290477	BolC1t02854H	0	+	224	1081	1083	0.9981533
C1	20291603	20292190	BolC1t02855H	0	-	349	587	587	1.0000000
C1	20304599	20305553	BolC1t02856H	0	+	695	954	954	1.0000000
C1	20305567	20309897	BolC1t02857H	0	+	2477	4330	4330	1.0000000
C1	20323560	20324606	BolC1t02858H	0	-	0	0	1046	0.0000000
C1	20325775	20326445	BolC1t02859H	0	-	0	0	670	0.0000000
C1	20326681	20327339	BolC1t02860H	0	-	0	0	658	0.0000000
C1	20330695	20331679	BolC1t02861H	0	+	0	0	984	0.0000000
C1	20333382	20333920	BolC1t02862H	0	+	0	0	538	0.0000000
C1	20341162	20351758	BolC1t02863H	0	-	2374	5312	10596	0.5013213
C1	20342831	20343173	BolC1t02864H	0	-	1	78	342	0.2280702
C1	20346144	20346738	BolC1t02865H	0	-	0	0	594	0.0000000
C1	20374648	20375232	BolC1t02866H	0	-	8	152	584	0.2602740
C1	20380196	20385126	BolC1t02867H	0	-	1709	4761	4930	0.9657201
C1	20386490	20387986	BolC1t02868H	0	+	862	1496	1496	1.0000000
C1	20409084	20409668	BolC1t02869H	0	+	2	21	584	0.0359589
C1	20423093	20423690	BolC1t02870H	0	+	0	0	597	0.0000000
C1	20427241	20427837	BolC1t02871H	0	+	0	0	596	0.0000000
C1	20431037	20436874	BolC1t02872H	0	+	8	107	5837	0.0183313
C1	20440094	20440634	BolC1t02873H	0	-	0	0	540	0.0000000
C1	20442441	20442924	BolC1t02874H	0	-	0	0	483	0.0000000
C1	20442974	20443293	BolC1t02875H	0	-	0	0	319	0.0000000
C1	20446357	20450488	BolC1t02876H	0	+	1369	3123	4131	0.7559913
C1	20473907	20475071	BolC1t02877H	0	+	647	1164	1164	1.0000000
C1	20487606	20488400	BolC1t02878H	0	-	509	794	794	1.0000000
C1	20489433	20490391	BolC1t02879H	0	+	223	872	958	0.9102296
C1	20505591	20507361	BolC1t02880H	0	+	478	1722	1770	0.9728814
C1	20510291	20511217	BolC1t02881H	0	-	184	926	926	1.0000000
C1	20524052	20528578	BolC1t02882H	0	-	751	2355	4526	0.5203270
C1	20538503	20538743	BolC1t02883H	0	-	243	240	240	1.0000000
C1	20540018	20541125	BolC1t02884H	0	-	246	1082	1107	0.9774165
C1	20542279	20544359	BolC1t02885H	0	-	227	1801	2080	0.8658654
C1	20545611	20547153	BolC1t02886H	0	-	158	1416	1542	0.9182879
C1	20635967	20636722	BolC1t02887H	0	+	90	572	755	0.7576159
C1	20638413	20639640	BolC1t02888H	0	+	70	664	1227	0.5411573
C1	20656263	20657694	BolC1t02889H	0	+	642	1431	1431	1.0000000
C1	20658043	20659606	BolC1t02890H	0	-	48	657	1563	0.4203455
C1	20666493	20669311	BolC1t02891H	0	-	579	2631	2818	0.9336409
C1	20682326	20683154	BolC1t02892H	0	-	1462	828	828	1.0000000
C1	20696603	20696840	BolC1t02893H	0	-	230	237	237	1.0000000
C1	20717063	20717837	BolC1t02894H	0	-	35	593	774	0.7661499
C1	20733665	20735024	BolC1t02895H	0	+	1271	1359	1359	1.0000000
C1	20737969	20738587	BolC1t02896H	0	+	750	618	618	1.0000000
C1	20756681	20758027	BolC1t02897H	0	-	1267	1346	1346	1.0000000
C1	20786291	20786594	BolC1t02898H	0	-	1	11	303	0.0363036
C1	20787542	20787939	BolC1t02899H	0	-	46	394	397	0.9924433
C1	20798459	20798864	BolC1t02900H	0	-	2	147	405	0.3629630
C1	20828266	20830065	BolC1t02901H	0	+	68	618	1799	0.3435242
C1	20881339	20882788	BolC1t02902H	0	+	27	490	1449	0.3381642
C1	20883942	20884288	BolC1t02903H	0	-	81	346	346	1.0000000
C1	20903985	20906184	BolC1t02904H	0	-	208	1669	2199	0.7589813
C1	20955685	20959661	BolC1t02905H	0	+	596	2443	3976	0.6144366
C1	21080422	21080758	BolC1t02906H	0	-	5	133	336	0.3958333
C1	21082860	21083436	BolC1t02907H	0	+	14	136	576	0.2361111
C1	21097318	21098561	BolC1t02908H	0	-	687	1243	1243	1.0000000
C1	21122205	21123657	BolC1t02909H	0	-	700	1373	1452	0.9455923
C1	21136778	21143454	BolC1t02910H	0	+	3771	6676	6676	1.0000000
C1	21146598	21147648	BolC1t02911H	0	+	427	1050	1050	1.0000000
C1	21150781	21151108	BolC1t02912H	0	+	528	327	327	1.0000000
C1	21175265	21177942	BolC1t02913H	0	+	816	2334	2677	0.8718715
C1	21179356	21179725	BolC1t02914H	0	-	64	263	369	0.7127371
C1	21181151	21183700	BolC1t02915H	0	-	1138	2196	2549	0.8615143
C1	21194229	21195599	BolC1t02916H	0	-	778	1370	1370	1.0000000
C1	21199628	21200171	BolC1t02917H	0	+	624	543	543	1.0000000
C1	21210915	21211077	BolC1t02918H	0	-	0	0	162	0.0000000
C1	21215496	21216070	BolC1t02919H	0	-	243	547	574	0.9529617
C1	21216096	21218730	BolC1t02920H	0	-	349	2129	2634	0.8082764
C1	21218804	21223526	BolC1t02921H	0	-	2547	4553	4722	0.9642101
C1	21224213	21227287	BolC1t02922H	0	-	1286	2474	3074	0.8048146
C1	21228568	21229285	BolC1t02923H	0	-	106	438	717	0.6108786
C1	21231373	21231868	BolC1t02924H	0	+	104	495	495	1.0000000
C1	21232950	21233202	BolC1t02925H	0	-	174	252	252	1.0000000
C1	21241132	21243766	BolC1t02926H	0	-	753	2176	2634	0.8261200
C1	21248976	21265930	BolC1t02927H	0	+	1008	6653	16954	0.3924148
C1	21266483	21266708	BolC1t02928H	0	-	85	225	225	1.0000000
C1	21274258	21274612	BolC1t02929H	0	+	346	354	354	1.0000000
C1	21276556	21276790	BolC1t02930H	0	+	354	234	234	1.0000000
C1	21279352	21280817	BolC1t02931H	0	-	1372	1465	1465	1.0000000
C1	21317747	21318950	BolC1t02932H	0	+	68	549	1203	0.4563591
C1	21362951	21363143	BolC1t02933H	0	+	77	192	192	1.0000000
C1	21420861	21421630	BolC1t02934H	0	-	783	769	769	1.0000000
C1	21449202	21449886	BolC1t02935H	0	+	378	640	684	0.9356725
C1	21489455	21489821	BolC1t02936H	0	-	187	366	366	1.0000000
C1	21492136	21494683	BolC1t02937H	0	-	802	2219	2547	0.8712211
C1	21506150	21506360	BolC1t02938H	0	+	86	210	210	1.0000000
C1	21518157	21520071	BolC1t02939H	0	-	534	1321	1914	0.6901776
C1	21534060	21534664	BolC1t02940H	0	-	59	523	604	0.8658940
C1	21548876	21549326	BolC1t02941H	0	-	124	432	450	0.9600000
C1	21559744	21560169	BolC1t02942H	0	-	581	425	425	1.0000000
C1	21562803	21566450	BolC1t02943H	0	+	2111	3647	3647	1.0000000
C1	21568360	21572443	BolC1t02944H	0	-	2961	4083	4083	1.0000000
C1	21576148	21578194	BolC1t02945H	0	+	448	1651	2046	0.8069404
C1	21583893	21584166	BolC1t02946H	0	+	102	273	273	1.0000000
C1	21584310	21584656	BolC1t02947H	0	+	134	302	346	0.8728324
C1	21589359	21590197	BolC1t02948H	0	+	721	838	838	1.0000000
C1	21592734	21595075	BolC1t02949H	0	-	1643	2341	2341	1.0000000
C1	21619207	21623801	BolC1t02950H	0	-	1096	4493	4594	0.9780148
C1	21625289	21625805	BolC1t02951H	0	-	310	516	516	1.0000000
C1	21661794	21663075	BolC1t02952H	0	+	446	1197	1281	0.9344262
C1	21666093	21668024	BolC1t02953H	0	-	2228	1931	1931	1.0000000
C1	21669282	21670818	BolC1t02954H	0	-	599	1536	1536	1.0000000
C1	21683801	21683993	BolC1t02955H	0	-	86	192	192	1.0000000
C1	21696724	21697438	BolC1t02956H	0	-	935	714	714	1.0000000
C1	21720038	21721362	BolC1t02957H	0	+	235	1245	1324	0.9403324
C1	21725349	21725541	BolC1t02958H	0	+	43	129	192	0.6718750
C1	21726376	21726487	BolC1t02959H	0	+	206	111	111	1.0000000
C1	21739167	21739350	BolC1t02960H	0	-	168	183	183	1.0000000
C1	21744660	21745376	BolC1t02961H	0	-	628	716	716	1.0000000
C1	21756598	21757057	BolC1t02962H	0	-	268	459	459	1.0000000
C1	21760461	21765532	BolC1t02963H	0	-	2075	3981	5071	0.7850522
C1	21765791	21767002	BolC1t02964H	0	-	1013	1211	1211	1.0000000
C1	21767144	21768119	BolC1t02965H	0	+	639	975	975	1.0000000
C1	21768684	21768822	BolC1t02966H	0	+	160	138	138	1.0000000
C1	21774809	21775633	BolC1t02967H	0	+	327	824	824	1.0000000
C1	21784804	21785791	BolC1t02968H	0	+	628	987	987	1.0000000
C1	21788662	21789391	BolC1t02969H	0	+	559	729	729	1.0000000
C1	21794433	21797284	BolC1t02970H	0	+	740	2801	2851	0.9824623
C1	21799544	21800945	BolC1t02971H	0	+	685	1399	1401	0.9985725
C1	21803189	21804830	BolC1t02972H	0	+	78	447	1641	0.2723949
C1	21814039	21815167	BolC1t02973H	0	-	34	590	1128	0.5230497
C1	21816035	21816837	BolC1t02974H	0	+	1333	802	802	1.0000000
C1	21817553	21817700	BolC1t02975H	0	+	28	147	147	1.0000000
C1	21846512	21848541	BolC1t02976H	0	-	1695	2029	2029	1.0000000
C1	21855921	21857561	BolC1t02977H	0	+	1106	1640	1640	1.0000000
C1	21868079	21869604	BolC1t02978H	0	+	403	1269	1525	0.8321311
C1	21882356	21883056	BolC1t02979H	0	-	357	700	700	1.0000000
C1	21884631	21885543	BolC1t02980H	0	-	900	912	912	1.0000000
C1	21890942	21891722	BolC1t02981H	0	-	697	780	780	1.0000000
C1	21907289	21907958	BolC1t02982H	0	-	105	499	669	0.7458894
C1	21920968	21921409	BolC1t02983H	0	-	60	417	441	0.9455782
C1	21922884	21925068	BolC1t02984H	0	+	395	1980	2184	0.9065934
C1	21927388	21928951	BolC1t02985H	0	-	250	984	1563	0.6295586
C1	21934830	21935585	BolC1t02986H	0	+	573	755	755	1.0000000
C1	21936248	21937514	BolC1t02987H	0	-	646	1181	1266	0.9328594
C1	21950289	21950960	BolC1t02988H	0	-	112	487	671	0.7257824
C1	21960318	21960720	BolC1t02989H	0	-	163	402	402	1.0000000
C1	21962641	21963745	BolC1t02990H	0	+	679	1104	1104	1.0000000
C1	21980121	21981465	BolC1t02991H	0	+	216	1017	1344	0.7566964
C1	21989542	21991229	BolC1t02992H	0	+	1084	1687	1687	1.0000000
C1	22000576	22001623	BolC1t02993H	0	+	190	783	1047	0.7478510
C1	22016548	22017936	BolC1t02994H	0	+	2394	1041	1388	0.7500000
C1	22058493	22059222	BolC1t02995H	0	-	22	377	729	0.5171468
C1	22067653	22069181	BolC1t02996H	0	-	684	1528	1528	1.0000000
C1	22077414	22077579	BolC1t02997H	0	-	91	158	165	0.9575757
C1	22080474	22081616	BolC1t02998H	0	+	84	1103	1142	0.9658494
C1	22093121	22093729	BolC1t02999H	0	+	259	608	608	1.0000000
C1	22113648	22114137	BolC1t03000H	0	+	415	488	489	0.9979550
C1	22133310	22134150	BolC1t03001H	0	+	15	171	840	0.2035714
C1	22140834	22142079	BolC1t03002H	0	+	640	1139	1245	0.9148594
C1	22143750	22146561	BolC1t03003H	0	-	931	2647	2811	0.9416578
C1	22163519	22163687	BolC1t03004H	0	-	122	168	168	1.0000000
C1	22198356	22198813	BolC1t03005H	0	+	296	457	457	1.0000000
C1	22211278	22212424	BolC1t03006H	0	+	450	1135	1146	0.9904014
C1	22217084	22217513	BolC1t03007H	0	-	46	220	429	0.5128205
C1	22262543	22263879	BolC1t03008H	0	+	1749	1336	1336	1.0000000
C1	22278780	22281367	BolC1t03009H	0	+	1372	2587	2587	1.0000000
C1	22281683	22282862	BolC1t03010H	0	-	1584	1179	1179	1.0000000
C1	22306180	22311998	BolC1t03011H	0	-	591	1587	5818	0.2727742
C1	22325830	22332271	BolC1t03012H	0	-	9041	5612	6441	0.8712933
C1	22337036	22337391	BolC1t03013H	0	-	281	355	355	1.0000000
C1	22346202	22346643	BolC1t03014H	0	-	172	441	441	1.0000000
C1	22347795	22351473	BolC1t03015H	0	+	57	533	3678	0.1449157
C1	22356238	22359766	BolC1t03016H	0	+	1605	2926	3528	0.8293651
C1	22371071	22386314	BolC1t03017H	0	-	5534	13190	15243	0.8653152
C1	22376435	22376717	BolC1t03018H	0	-	64	282	282	1.0000000
C1	22378992	22379325	BolC1t03019H	0	-	2	73	333	0.2192192
C1	22386998	22391922	BolC1t03020H	0	+	1016	3470	4924	0.7047116
C1	22408920	22409103	BolC1t03021H	0	-	0	0	183	0.0000000
C1	22413249	22413357	BolC1t03022H	0	-	0	0	108	0.0000000
C1	22417224	22417461	BolC1t03023H	0	-	372	237	237	1.0000000
C1	22422316	22424944	BolC1t03024H	0	-	1703	2628	2628	1.0000000
C1	22442884	22443715	BolC1t03025H	0	+	28	727	831	0.8748496
C1	22445033	22447371	BolC1t03026H	0	+	741	2184	2338	0.9341317
C1	22481174	22483269	BolC1t03027H	0	+	548	1952	2095	0.9317423
C1	22517856	22518018	BolC1t03028H	0	+	1	52	162	0.3209876
C1	22518083	22518611	BolC1t03029H	0	+	0	0	528	0.0000000
C1	22522474	22522928	BolC1t03030H	0	-	1528	454	454	1.0000000
C1	22553459	22553720	BolC1t03031H	0	-	1	102	261	0.3908046
C1	22556477	22556729	BolC1t03032H	0	+	293	252	252	1.0000000
C1	22579928	22580702	BolC1t03033H	0	-	326	770	774	0.9948320
C1	22582537	22584479	BolC1t03034H	0	+	298	1001	1942	0.5154480
C1	22585514	22586794	BolC1t03035H	0	+	294	968	1280	0.7562500
C1	22606570	22606947	BolC1t03036H	0	+	0	0	377	0.0000000
C1	22616076	22645179	BolC1t03037H	0	+	13993	21442	29103	0.7367625
C1	22645931	22646484	BolC1t03038H	0	+	489	553	553	1.0000000
C1	22660220	22661135	BolC1t03039H	0	+	606	915	915	1.0000000
C1	22688189	22690130	BolC1t03040H	0	-	141	1601	1941	0.8248326
C1	22691104	22691467	BolC1t03041H	0	+	378	363	363	1.0000000
C1	22699084	22703916	BolC1t03042H	0	-	2003	4146	4832	0.8580298
C1	22743498	22743669	BolC1t03043H	0	+	264	171	171	1.0000000
C1	22745188	22746073	BolC1t03044H	0	+	1212	885	885	1.0000000
C1	22754279	22754711	BolC1t03045H	0	-	0	0	432	0.0000000
C1	22761913	22770289	BolC1t03046H	0	-	379	2744	8376	0.3276027
C1	22805406	22808409	BolC1t03047H	0	+	779	2337	3003	0.7782218
C1	22820318	22827176	BolC1t03048H	0	+	2144	5977	6858	0.8715369
C1	22848810	22850757	BolC1t03049H	0	-	227	976	1947	0.5012840
C1	22855694	22861617	BolC1t03050H	0	+	2419	5012	5923	0.8461928
C1	22862321	22864385	BolC1t03051H	0	+	335	1460	2064	0.7073643
C1	22871594	22873364	BolC1t03052H	0	+	969	1770	1770	1.0000000
C1	22877172	22877340	BolC1t03053H	0	+	0	0	168	0.0000000
C1	22883317	22883485	BolC1t03054H	0	+	0	0	168	0.0000000
C1	22889095	22889377	BolC1t03055H	0	+	13	145	282	0.5141844
C1	22901551	22901758	BolC1t03056H	0	+	1	55	207	0.2657005
C1	22908563	22910270	BolC1t03057H	0	+	1041	1707	1707	1.0000000
C1	22927610	22933074	BolC1t03058H	0	+	1279	4371	5464	0.7999634
C1	22939010	22939163	BolC1t03059H	0	+	289	153	153	1.0000000
C1	22940024	22942583	BolC1t03060H	0	-	122	1428	2559	0.5580305
C1	22969477	22969636	BolC1t03061H	0	-	0	0	159	0.0000000
C1	22982721	22988736	BolC1t03062H	0	+	2620	5518	6015	0.9173732
C1	22989063	22996581	BolC1t03063H	0	-	968	3710	7518	0.4934823
C1	22997947	22998855	BolC1t03064H	0	+	265	908	908	1.0000000
C1	22999253	23000652	BolC1t03065H	0	-	290	1335	1399	0.9542530
C1	23000908	23002324	BolC1t03066H	0	-	253	897	1416	0.6334746
C1	23018242	23019282	BolC1t03067H	0	+	489	1023	1040	0.9836538
C1	23020941	23021977	BolC1t03068H	0	+	2802	1036	1036	1.0000000
C1	23029822	23029957	BolC1t03069H	0	+	164	135	135	1.0000000
C1	23046960	23048166	BolC1t03070H	0	+	153	496	1206	0.4112769
C1	23055675	23056128	BolC1t03071H	0	+	23	401	453	0.8852097
C1	23070406	23070607	BolC1t03072H	0	-	286	201	201	1.0000000
C1	23072801	23077129	BolC1t03073H	0	-	4478	4278	4328	0.9884473
C1	23082852	23083845	BolC1t03074H	0	-	179	891	993	0.8972810
C1	23085619	23089080	BolC1t03075H	0	+	322	2368	3461	0.6841953
C1	23089315	23089640	BolC1t03076H	0	-	195	325	325	1.0000000
C1	23094260	23095246	BolC1t03077H	0	-	657	986	986	1.0000000
C1	23100320	23117060	BolC1t03078H	0	+	5559	14827	16740	0.8857228
C1	23119409	23121374	BolC1t03079H	0	-	110	932	1965	0.4743003
C1	23122195	23122650	BolC1t03080H	0	-	489	455	455	1.0000000
C1	23125684	23125852	BolC1t03081H	0	-	33	168	168	1.0000000
C1	23129755	23130580	BolC1t03082H	0	+	401	825	825	1.0000000
C1	23131358	23133898	BolC1t03083H	0	-	1177	2540	2540	1.0000000
C1	23138842	23140749	BolC1t03084H	0	-	455	1866	1907	0.9785002
C1	23140806	23141237	BolC1t03085H	0	-	331	431	431	1.0000000
C1	23157000	23160577	BolC1t03086H	0	+	2314	3577	3577	1.0000000
C1	23160654	23161773	BolC1t03087H	0	+	131	1119	1119	1.0000000
C1	23212060	23214146	BolC1t03088H	0	+	217	1687	2086	0.8087248
C1	23219406	23219867	BolC1t03089H	0	+	34	368	461	0.7982646
C1	23234565	23267269	BolC1t03090H	0	-	21112	29330	32704	0.8968322
C1	23283797	23284060	BolC1t03091H	0	+	157	263	263	1.0000000
C1	23285336	23287915	BolC1t03092H	0	+	1112	2579	2579	1.0000000
C1	23289096	23291378	BolC1t03093H	0	-	566	2282	2282	1.0000000
C1	23330595	23331567	BolC1t03094H	0	+	122	548	972	0.5637860
C1	23349186	23350158	BolC1t03095H	0	+	70	431	972	0.4434156
C1	23351339	23351549	BolC1t03096H	0	-	52	139	210	0.6619048
C1	23354814	23358797	BolC1t03097H	0	+	796	2978	3983	0.7476776
C1	23364305	23364422	BolC1t03098H	0	-	1	97	117	0.8290598
C1	23366857	23367231	BolC1t03099H	0	+	177	374	374	1.0000000
C1	23369420	23369537	BolC1t03100H	0	-	0	0	117	0.0000000
C1	23384816	23407322	BolC1t03101H	0	+	4962	18432	22506	0.8189816
C1	23402211	23413238	BolC1t03102H	0	+	2766	9308	11027	0.8441099
C1	23416861	23416975	BolC1t03103H	0	+	83	114	114	1.0000000
C1	23425326	23425575	BolC1t03104H	0	+	242	249	249	1.0000000
C1	23452845	23453525	BolC1t03105H	0	-	220	606	680	0.8911765
C1	23469645	23477798	BolC1t03106H	0	+	958	5667	8153	0.6950816
C1	23470786	23471303	BolC1t03107H	0	+	29	315	517	0.6092843
C1	23501548	23503203	BolC1t03108H	0	-	350	1441	1655	0.8706949
C1	23515157	23516069	BolC1t03109H	0	-	263	877	912	0.9616228
C1	23597887	23598166	BolC1t03110H	0	+	0	0	279	0.0000000
C1	23621466	23621649	BolC1t03111H	0	+	36	183	183	1.0000000
C1	23635558	23636133	BolC1t03112H	0	+	187	575	575	1.0000000
C1	23641282	23641879	BolC1t03113H	0	-	136	597	597	1.0000000
C1	23642682	23644650	BolC1t03114H	0	+	77	954	1968	0.4847561
C1	23653554	23653683	BolC1t03115H	0	+	104	129	129	1.0000000
C1	23656638	23657238	BolC1t03116H	0	-	1139	600	600	1.0000000
C1	23657506	23657890	BolC1t03117H	0	+	508	384	384	1.0000000
C1	23658359	23658485	BolC1t03118H	0	+	46	126	126	1.0000000
C1	23660310	23660679	BolC1t03119H	0	-	232	369	369	1.0000000
C1	23661449	23661746	BolC1t03120H	0	-	288	297	297	1.0000000
C1	23661806	23662064	BolC1t03121H	0	-	306	258	258	1.0000000
C1	23677006	23677578	BolC1t03122H	0	+	5	240	572	0.4195804
C1	23681631	23681832	BolC1t03123H	0	+	105	201	201	1.0000000
C1	23694633	23694987	BolC1t03124H	0	+	42	354	354	1.0000000
C1	23719027	23719378	BolC1t03125H	0	-	213	351	351	1.0000000
C1	23722601	23723196	BolC1t03126H	0	-	523	595	595	1.0000000
C1	23727524	23728304	BolC1t03127H	0	+	676	780	780	1.0000000
C1	23779190	23779751	BolC1t03128H	0	-	11	275	561	0.4901961
C1	23791899	23794050	BolC1t03129H	0	+	1149	2151	2151	1.0000000
C1	23794234	23796430	BolC1t03130H	0	-	646	2181	2196	0.9931694
C1	23815474	23815948	BolC1t03131H	0	+	615	474	474	1.0000000
C1	23823355	23823598	BolC1t03132H	0	-	60	243	243	1.0000000
C1	23826076	23826976	BolC1t03133H	0	+	65	827	900	0.9188889
C1	23863144	23863453	BolC1t03134H	0	+	750	309	309	1.0000000
C1	23879849	23889053	BolC1t03135H	0	+	3231	8517	9204	0.9253585
C1	23897124	23897652	BolC1t03136H	0	+	430	528	528	1.0000000
C1	23909482	23912463	BolC1t03137H	0	-	984	2825	2981	0.9476686
C1	23946365	23946656	BolC1t03138H	0	-	206	291	291	1.0000000
C1	23987298	23987635	BolC1t03139H	0	+	1	62	337	0.1839763
C1	24003028	24003390	BolC1t03140H	0	+	192	362	362	1.0000000
C1	24038326	24038500	BolC1t03141H	0	+	177	174	174	1.0000000
C1	24062843	24064416	BolC1t03142H	0	-	33	718	1573	0.4564526
C1	24072513	24072648	BolC1t03143H	0	-	198	135	135	1.0000000
C1	24078693	24079169	BolC1t03144H	0	-	408	476	476	1.0000000
C1	24095062	24096611	BolC1t03145H	0	-	77	859	1549	0.5545513
C1	24098731	24098932	BolC1t03146H	0	-	230	201	201	1.0000000
C1	24157572	24157800	BolC1t03147H	0	-	22	178	228	0.7807018
C1	24169941	24172121	BolC1t03148H	0	+	33	811	2180	0.3720183
C1	24174556	24174709	BolC1t03149H	0	+	45	153	153	1.0000000
C1	24177358	24178726	BolC1t03150H	0	+	64	631	1368	0.4612573
C1	24179092	24179890	BolC1t03151H	0	+	52	468	798	0.5864662
C1	24192938	24193596	BolC1t03152H	0	-	160	658	658	1.0000000
C1	24216253	24216643	BolC1t03153H	0	+	116	390	390	1.0000000
C1	24244632	24245288	BolC1t03154H	0	-	278	656	656	1.0000000
C1	24381265	24385219	BolC1t03155H	0	+	798	2352	3954	0.5948406
C1	24388132	24388330	BolC1t03156H	0	+	0	0	198	0.0000000
C1	24392369	24392678	BolC1t03157H	0	+	2	28	309	0.0906149
C1	24395931	24396435	BolC1t03158H	0	+	242	504	504	1.0000000
C1	24408944	24411563	BolC1t03159H	0	+	0	0	2619	0.0000000
C1	24417019	24417388	BolC1t03160H	0	+	0	0	369	0.0000000
C1	24419478	24420600	BolC1t03161H	0	+	0	0	1122	0.0000000
C1	24422689	24423010	BolC1t03162H	0	+	1	14	321	0.0436137
C1	24424600	24426933	BolC1t03163H	0	-	746	1449	2333	0.6210887
C1	24435282	24438896	BolC1t03164H	0	+	1286	3497	3614	0.9676259
C1	24440440	24440680	BolC1t03165H	0	-	14	59	240	0.2458333
C1	24452509	24454357	BolC1t03166H	0	-	460	1848	1848	1.0000000
C1	24472575	24472842	BolC1t03167H	0	-	465	267	267	1.0000000
C1	24487621	24488841	BolC1t03168H	0	-	600	1194	1220	0.9786885
C1	24512429	24514169	BolC1t03169H	0	+	505	1683	1740	0.9672414
C1	24558520	24560576	BolC1t03170H	0	+	19	628	2056	0.3054475
C1	24602732	24603722	BolC1t03171H	0	+	79	912	990	0.9212121
C1	24612158	24613462	BolC1t03172H	0	-	362	1161	1304	0.8903374
C1	24627974	24629943	BolC1t03173H	0	+	879	1969	1969	1.0000000
C1	24630695	24631046	BolC1t03174H	0	+	213	351	351	1.0000000
C1	24635714	24636098	BolC1t03175H	0	+	33	384	384	1.0000000
C1	24637393	24638043	BolC1t03176H	0	+	283	650	650	1.0000000
C1	24642100	24642619	BolC1t03177H	0	+	260	519	519	1.0000000
C1	24677306	24677540	BolC1t03178H	0	+	166	234	234	1.0000000
C1	24687527	24689764	BolC1t03179H	0	+	532	1987	2237	0.8882432
C1	24693280	24695807	BolC1t03180H	0	-	578	1835	2527	0.7261575
C1	24697922	24699243	BolC1t03181H	0	+	1867	1321	1321	1.0000000
C1	24705021	24705718	BolC1t03182H	0	-	404	696	697	0.9985653
C1	24707420	24708827	BolC1t03183H	0	-	538	1407	1407	1.0000000
C1	24730857	24733298	BolC1t03184H	0	+	45	863	2441	0.3535436
C1	24745989	24746091	BolC1t03185H	0	+	27	77	102	0.7549019
C1	24758649	24759639	BolC1t03186H	0	+	27	411	990	0.4151515
C1	24760375	24771963	BolC1t03187H	0	+	96	1329	11588	0.1146876
C1	24768696	24769956	BolC1t03188H	0	+	2	158	1260	0.1253968
C1	24772021	24772399	BolC1t03189H	0	+	4	250	378	0.6613756
C1	24809745	24811897	BolC1t03190H	0	-	293	1680	2152	0.7806692
C1	24813536	24814685	BolC1t03191H	0	+	875	1149	1149	1.0000000
C1	24834058	24835512	BolC1t03192H	0	-	1050	1454	1454	1.0000000
C1	24849937	24851530	BolC1t03193H	0	+	1307	1593	1593	1.0000000
C1	24881155	24882485	BolC1t03194H	0	-	484	1224	1330	0.9203007
C1	24894925	24900236	BolC1t03195H	0	-	4188	4817	5311	0.9069855
C1	24908921	24909386	BolC1t03196H	0	-	65	317	465	0.6817204
C1	24909688	24918695	BolC1t03197H	0	-	4184	8538	9007	0.9479294
C1	24929335	24937818	BolC1t03198H	0	+	4093	8483	8483	1.0000000
C1	24933267	24934332	BolC1t03199H	0	-	305	1065	1065	1.0000000
C1	24953481	24954707	BolC1t03200H	0	-	762	1226	1226	1.0000000
C1	24960192	24960686	BolC1t03201H	0	-	539	494	494	1.0000000
C1	24964957	24967376	BolC1t03202H	0	-	704	2419	2419	1.0000000
C1	24968110	24968392	BolC1t03203H	0	-	256	282	282	1.0000000
C1	24968700	24969094	BolC1t03204H	0	-	475	394	394	1.0000000
C1	24970851	24971214	BolC1t03205H	0	-	28	360	363	0.9917355
C1	24986934	24987165	BolC1t03206H	0	+	137	231	231	1.0000000
C1	24990035	24990704	BolC1t03207H	0	-	112	657	669	0.9820628
C1	24998669	25000773	BolC1t03208H	0	-	1304	2104	2104	1.0000000
C1	25003009	25004217	BolC1t03209H	0	-	287	1013	1208	0.8385761
C1	25018998	25019317	BolC1t03210H	0	-	113	304	319	0.9529781
C1	25031750	25032585	BolC1t03211H	0	-	11	513	835	0.6143712
C1	25050433	25050568	BolC1t03212H	0	+	201	135	135	1.0000000
C1	25161555	25166710	BolC1t03213H	0	+	508	3555	5155	0.6896217
C1	25169212	25169669	BolC1t03214H	0	+	35	375	457	0.8205689
C1	25170999	25171527	BolC1t03215H	0	-	51	234	528	0.4431818
C1	25199983	25200433	BolC1t03216H	0	-	21	401	450	0.8911111
C1	25201531	25201998	BolC1t03217H	0	-	85	436	467	0.9336188
C1	25210295	25210526	BolC1t03218H	0	+	0	0	231	0.0000000
C1	25212409	25213693	BolC1t03219H	0	-	506	1176	1284	0.9158878
C1	25226152	25226293	BolC1t03220H	0	-	314	141	141	1.0000000
C1	25229094	25229769	BolC1t03221H	0	-	314	675	675	1.0000000
C1	25348707	25372869	BolC1t03222H	0	-	4022	21060	24162	0.8716166
C1	25373292	25374405	BolC1t03223H	0	+	766	1113	1113	1.0000000
C1	25387712	25388302	BolC1t03224H	0	-	23	503	590	0.8525424
C1	25390899	25391700	BolC1t03225H	0	-	453	801	801	1.0000000
C1	25415263	25415900	BolC1t03226H	0	+	412	637	637	1.0000000
C1	25420678	25423351	BolC1t03227H	0	+	233	1729	2673	0.6468388
C1	25450416	25450760	BolC1t03228H	0	-	184	313	344	0.9098837
C1	25451681	25453030	BolC1t03229H	0	+	886	1349	1349	1.0000000
C1	25459596	25462154	BolC1t03230H	0	-	1520	2558	2558	1.0000000
C1	25484253	25484637	BolC1t03231H	0	+	146	384	384	1.0000000
C1	25485625	25485943	BolC1t03232H	0	-	5	214	318	0.6729560
C1	25488264	25488667	BolC1t03233H	0	+	237	403	403	1.0000000
C1	25518712	25519171	BolC1t03234H	0	-	344	459	459	1.0000000
C1	25524825	25526554	BolC1t03235H	0	-	572	1729	1729	1.0000000
C1	25529860	25530890	BolC1t03236H	0	-	1558	1030	1030	1.0000000
C1	25537109	25537565	BolC1t03237H	0	-	324	456	456	1.0000000
C1	25562340	25562848	BolC1t03238H	0	+	231	508	508	1.0000000
C1	25570305	25571293	BolC1t03239H	0	-	537	988	988	1.0000000
C1	25577053	25579875	BolC1t03240H	0	+	739	2545	2822	0.9018427
C1	25596844	25599864	BolC1t03241H	0	+	1770	3020	3020	1.0000000
C1	25599270	25604622	BolC1t03242H	0	+	2472	5352	5352	1.0000000
C1	25607152	25607479	BolC1t03243H	0	+	231	327	327	1.0000000
C1	25607602	25607977	BolC1t03244H	0	+	234	375	375	1.0000000
C1	25620193	25620310	BolC1t03245H	0	+	14	117	117	1.0000000
C1	25638252	25638991	BolC1t03246H	0	+	875	739	739	1.0000000
C1	25641172	25643149	BolC1t03247H	0	+	86	819	1977	0.4142640
C1	25658740	25660829	BolC1t03248H	0	-	247	1190	2089	0.5696505
C1	25668871	25669573	BolC1t03249H	0	-	394	702	702	1.0000000
C1	25673200	25673377	BolC1t03250H	0	+	19	170	177	0.9604520
C1	25678446	25681672	BolC1t03251H	0	-	61	1037	3226	0.3214507
C1	25719656	25730064	BolC1t03252H	0	+	1444	6423	10408	0.6171215
C1	25740234	25740694	BolC1t03253H	0	+	194	460	460	1.0000000
C1	25747824	25749737	BolC1t03254H	0	+	243	1450	1913	0.7579718
C1	25753710	25754075	BolC1t03255H	0	+	79	309	365	0.8465753
C1	25823976	25824973	BolC1t03256H	0	+	44	734	997	0.7362086
C1	25848239	25849668	BolC1t03257H	0	+	154	866	1429	0.6060182
C1	25850151	25851601	BolC1t03258H	0	+	7	119	1450	0.0820690
C1	25852973	25853891	BolC1t03259H	0	-	731	918	918	1.0000000
C1	25861550	25863792	BolC1t03260H	0	+	1294	2167	2242	0.9665477
C1	25882341	25884141	BolC1t03261H	0	-	146	912	1800	0.5066667
C1	25893362	25894688	BolC1t03262H	0	+	1271	1326	1326	1.0000000
C1	25914431	25915453	BolC1t03263H	0	-	133	794	1022	0.7769080
C1	25934454	25936101	BolC1t03264H	0	+	746	1647	1647	1.0000000
C1	25942706	25944328	BolC1t03265H	0	-	94	444	1622	0.2737361
C1	25951057	25952154	BolC1t03266H	0	+	192	1097	1097	1.0000000
C1	25998211	26000663	BolC1t03267H	0	+	207	1391	2452	0.5672920
C1	26004919	26005381	BolC1t03268H	0	-	132	462	462	1.0000000
C1	26005851	26006262	BolC1t03269H	0	+	159	343	411	0.8345499
C1	26014395	26015439	BolC1t03270H	0	+	601	1039	1044	0.9952107
C1	26024000	26025099	BolC1t03271H	0	+	171	1099	1099	1.0000000
C1	26034640	26035441	BolC1t03272H	0	-	977	801	801	1.0000000
C1	26039128	26040054	BolC1t03273H	0	-	916	926	926	1.0000000
C1	26075469	26075699	BolC1t03274H	0	+	7	172	230	0.7478261
C1	26082667	26082841	BolC1t03275H	0	-	0	0	174	0.0000000
C1	26084821	26085028	BolC1t03276H	0	-	0	0	207	0.0000000
C1	26106213	26133148	BolC1t03277H	0	-	1145	4817	26935	0.1788379
C1	26339531	26340329	BolC1t03278H	0	+	539	798	798	1.0000000
C1	26372622	26372868	BolC1t03279H	0	+	173	246	246	1.0000000
C1	26422024	26424017	BolC1t03280H	0	+	1250	1993	1993	1.0000000
C1	26429928	26430177	BolC1t03281H	0	+	28	249	249	1.0000000
C1	26447362	26448692	BolC1t03282H	0	-	1066	1330	1330	1.0000000
C1	26454788	26454938	BolC1t03283H	0	-	98	150	150	1.0000000
C1	26508824	26511326	BolC1t03284H	0	-	104	952	2502	0.3804956
C1	26512285	26512649	BolC1t03285H	0	-	122	364	364	1.0000000
C1	26514632	26516062	BolC1t03286H	0	+	46	774	1430	0.5412588
C1	26540663	26541674	BolC1t03287H	0	+	343	998	1011	0.9871414
C1	26550407	26552232	BolC1t03288H	0	-	2198	1825	1825	1.0000000
C1	26570816	26571749	BolC1t03289H	0	+	538	933	933	1.0000000
C1	26584326	26584572	BolC1t03290H	0	-	116	190	246	0.7723577
C1	26590486	26590867	BolC1t03291H	0	+	182	381	381	1.0000000
C1	26594927	26595233	BolC1t03292H	0	-	48	289	306	0.9444444
C1	26640317	26640440	BolC1t03293H	0	-	0	0	123	0.0000000
C1	26641872	26641974	BolC1t03294H	0	-	0	0	102	0.0000000
C1	26643407	26643581	BolC1t03295H	0	-	0	0	174	0.0000000
C1	26655064	26656252	BolC1t03296H	0	-	730	1188	1188	1.0000000
C1	26657070	26657172	BolC1t03297H	0	+	165	102	102	1.0000000
C1	26678365	26678896	BolC1t03298H	0	+	540	531	531	1.0000000
C1	26692861	26694541	BolC1t03299H	0	+	1227	1274	1680	0.7583333
C1	26698192	26700611	BolC1t03300H	0	-	2159	2419	2419	1.0000000
C1	26701279	26701657	BolC1t03301H	0	+	517	378	378	1.0000000
C1	26702221	26702590	BolC1t03302H	0	+	585	369	369	1.0000000
C1	26704481	26707061	BolC1t03303H	0	-	1594	2580	2580	1.0000000
C1	26712331	26713998	BolC1t03304H	0	-	1098	1667	1667	1.0000000
C1	26714535	26714914	BolC1t03305H	0	+	436	379	379	1.0000000
C1	26725292	26728096	BolC1t03306H	0	+	644	2062	2804	0.7353780
C1	26726203	26726458	BolC1t03307H	0	+	148	255	255	1.0000000
C1	26736804	26737440	BolC1t03308H	0	-	118	636	636	1.0000000
C1	26770583	26771296	BolC1t03309H	0	-	119	636	713	0.8920056
C1	26837394	26842401	BolC1t03310H	0	+	2129	3310	5007	0.6610745
C1	26844956	26845543	BolC1t03311H	0	-	481	587	587	1.0000000
C1	26845675	26846032	BolC1t03312H	0	-	342	357	357	1.0000000
C1	26864829	26865506	BolC1t03313H	0	+	435	677	677	1.0000000
C1	26874727	26875776	BolC1t03314H	0	-	712	1049	1049	1.0000000
C1	26875630	26878516	BolC1t03315H	0	+	560	2677	2886	0.9275814
C1	26919197	26931024	BolC1t03316H	0	-	4650	11384	11827	0.9625433
C1	26944446	26944572	BolC1t03317H	0	+	103	126	126	1.0000000
C1	26945303	26945477	BolC1t03318H	0	+	160	174	174	1.0000000
C1	26950607	26963346	BolC1t03319H	0	-	1532	5695	12739	0.4470524
C1	26959455	26964438	BolC1t03320H	0	-	855	2224	4983	0.4463175
C1	27009447	27011143	BolC1t03321H	0	-	638	1304	1696	0.7688679
C1	27022427	27024549	BolC1t03322H	0	+	393	1058	2122	0.4985862
C1	27029330	27029594	BolC1t03323H	0	-	298	264	264	1.0000000
C1	27050455	27052173	BolC1t03324H	0	+	63	986	1718	0.5739232
C1	27058848	27061283	BolC1t03325H	0	+	1225	2435	2435	1.0000000
C1	27064502	27065007	BolC1t03326H	0	+	325	505	505	1.0000000
C1	27065185	27080587	BolC1t03327H	0	+	6360	15233	15402	0.9890274
C1	27082431	27083078	BolC1t03328H	0	+	604	647	647	1.0000000
C1	27088700	27088967	BolC1t03329H	0	+	2	151	267	0.5655431
C1	27091570	27091906	BolC1t03330H	0	-	248	336	336	1.0000000
C1	27095666	27097548	BolC1t03331H	0	+	769	1882	1882	1.0000000
C1	27106195	27106537	BolC1t03332H	0	-	190	342	342	1.0000000
C1	27106903	27107080	BolC1t03333H	0	-	101	177	177	1.0000000
C1	27113345	27114398	BolC1t03334H	0	+	185	893	1053	0.8480532
C1	27129442	27129820	BolC1t03335H	0	-	194	378	378	1.0000000
C1	27129897	27130093	BolC1t03336H	0	-	113	196	196	1.0000000
C1	27151066	27152014	BolC1t03337H	0	-	405	948	948	1.0000000
C1	27154039	27154357	BolC1t03338H	0	-	11	286	318	0.8993711
C1	27182295	27184913	BolC1t03339H	0	+	164	1493	2618	0.5702826
C1	27212015	27212378	BolC1t03340H	0	+	225	363	363	1.0000000
C1	27215640	27217361	BolC1t03341H	0	+	2	121	1721	0.0703080
C1	27217880	27218633	BolC1t03342H	0	-	74	356	753	0.4727756
C1	27225636	27226212	BolC1t03343H	0	+	163	576	576	1.0000000
C1	27227524	27227823	BolC1t03344H	0	-	38	299	299	1.0000000
C1	27229185	27230733	BolC1t03345H	0	-	325	1548	1548	1.0000000
C1	27233820	27235014	BolC1t03346H	0	-	253	1194	1194	1.0000000
C1	27255594	27258305	BolC1t03347H	0	+	361	1538	2711	0.5673183
C1	27259874	27261110	BolC1t03348H	0	+	154	666	1236	0.5388349
C1	27267570	27269343	BolC1t03349H	0	+	878	1773	1773	1.0000000
C1	27271375	27271495	BolC1t03350H	0	+	2	4	120	0.0333333
C1	27281027	27281536	BolC1t03351H	0	+	333	509	509	1.0000000
C1	27309878	27310112	BolC1t03352H	0	+	0	0	234	0.0000000
C1	27310679	27310826	BolC1t03353H	0	+	36	147	147	1.0000000
C1	27331767	27333719	BolC1t03354H	0	+	2	126	1952	0.0645492
C1	27339913	27340339	BolC1t03355H	0	-	47	236	426	0.5539906
C1	27341090	27341706	BolC1t03356H	0	-	5	358	616	0.5811688
C1	27342946	27343132	BolC1t03357H	0	+	0	0	186	0.0000000
C1	27345348	27346397	BolC1t03358H	0	+	8	192	1049	0.1830315
C1	27347057	27347165	BolC1t03359H	0	+	0	0	108	0.0000000
C1	27369052	27370031	BolC1t03360H	0	-	6	26	979	0.0265577
C1	27385034	27385636	BolC1t03361H	0	+	576	602	602	1.0000000
C1	27386947	27388307	BolC1t03362H	0	+	391	854	1360	0.6279412
C1	27389457	27389857	BolC1t03363H	0	-	9	221	400	0.5525000
C1	27397406	27398693	BolC1t03364H	0	-	767	1287	1287	1.0000000
C1	27403450	27404869	BolC1t03365H	0	+	2184	1419	1419	1.0000000
C1	27407640	27408598	BolC1t03366H	0	-	1434	958	958	1.0000000
C1	27423951	27429788	BolC1t03367H	0	+	3094	5837	5837	1.0000000
C1	27432791	27433182	BolC1t03368H	0	-	383	391	391	1.0000000
C1	27434121	27438449	BolC1t03369H	0	-	2676	4328	4328	1.0000000
C1	27450885	27451624	BolC1t03370H	0	-	445	739	739	1.0000000
C1	27452732	27454019	BolC1t03371H	0	-	1725	1287	1287	1.0000000
C1	27454917	27455325	BolC1t03372H	0	+	53	398	408	0.9754902
C1	27462454	27462679	BolC1t03373H	0	-	43	225	225	1.0000000
C1	27664544	27666546	BolC1t03374H	0	-	253	1437	2002	0.7177822
C1	27702127	27703224	BolC1t03375H	0	+	152	897	1097	0.8176846
C1	27761460	27762373	BolC1t03376H	0	+	542	913	913	1.0000000
C1	27845224	27845441	BolC1t03377H	0	-	0	0	217	0.0000000
C1	27849600	27850407	BolC1t03378H	0	+	609	807	807	1.0000000
C1	27852014	27852164	BolC1t03379H	0	-	223	150	150	1.0000000
C1	27872167	27874795	BolC1t03380H	0	-	26	905	2628	0.3443683
C1	27875510	27876678	BolC1t03381H	0	-	577	1149	1168	0.9837329
C1	27886383	27888854	BolC1t03382H	0	-	474	1707	2471	0.6908134
C1	27890059	27890590	BolC1t03383H	0	-	153	512	531	0.9642184
C1	27893247	27896214	BolC1t03384H	0	-	452	2179	2967	0.7344118
C1	27899877	27902690	BolC1t03385H	0	+	1912	2813	2813	1.0000000
C1	27905873	27916823	BolC1t03386H	0	+	3341	10357	10950	0.9458448
C1	27940625	27948230	BolC1t03387H	0	+	902	4225	7605	0.5555556
C1	27949231	27949416	BolC1t03388H	0	+	164	185	185	1.0000000
C1	27959264	27965357	BolC1t03389H	0	-	175	1951	6093	0.3202035
C1	27969803	27971322	BolC1t03390H	0	-	21	589	1519	0.3877551
C1	27985501	27985666	BolC1t03391H	0	+	291	165	165	1.0000000
C1	28012111	28012348	BolC1t03392H	0	-	270	237	237	1.0000000
C1	28017323	28021029	BolC1t03393H	0	-	2378	3685	3706	0.9943335
C1	28024314	28024896	BolC1t03394H	0	-	289	582	582	1.0000000
C1	28095205	28096852	BolC1t03395H	0	+	777	1647	1647	1.0000000
C1	28097293	28103972	BolC1t03396H	0	-	1185	4691	6679	0.7023507
C1	28125430	28126699	BolC1t03397H	0	-	1774	1269	1269	1.0000000
C1	28445735	28448021	BolC1t03398H	0	-	11	218	2286	0.0953631
C1	28610674	28611354	BolC1t03399H	0	-	498	680	680	1.0000000
C1	28615608	28617210	BolC1t03400H	0	+	396	973	1602	0.6073658
C1	28671145	28671537	BolC1t03401H	0	+	724	392	392	1.0000000
C1	28718130	28718569	BolC1t03402H	0	-	0	0	439	0.0000000
C1	28912645	28917700	BolC1t03403H	0	+	4122	5055	5055	1.0000000
C1	28919538	28919907	BolC1t03404H	0	+	215	369	369	1.0000000
C1	28920507	28920787	BolC1t03405H	0	-	336	280	280	1.0000000
C1	28922061	28923030	BolC1t03406H	0	-	781	969	969	1.0000000
C1	28923992	28925953	BolC1t03407H	0	+	1083	1961	1961	1.0000000
C1	28941961	28944667	BolC1t03408H	0	+	176	1328	2706	0.4907613
C1	28951529	28955715	BolC1t03409H	0	-	245	2623	4186	0.6266125
C1	28975742	28978744	BolC1t03410H	0	-	1119	3002	3002	1.0000000
C1	28980929	28981553	BolC1t03411H	0	+	473	624	624	1.0000000
C1	28986197	28987856	BolC1t03412H	0	+	146	631	1659	0.3803496
C1	29037600	29037897	BolC1t03413H	0	-	373	297	297	1.0000000
C1	29039458	29041194	BolC1t03414H	0	-	307	1122	1736	0.6463134
C1	29044847	29045186	BolC1t03415H	0	+	27	265	339	0.7817109
C1	29049048	29049461	BolC1t03416H	0	-	75	258	413	0.6246973
C1	29052931	29053759	BolC1t03417H	0	+	2	80	828	0.0966184
C1	29060803	29061655	BolC1t03418H	0	+	356	852	852	1.0000000
C1	29066884	29069895	BolC1t03419H	0	+	1423	2239	3011	0.7436067
C1	29070004	29070537	BolC1t03420H	0	+	8	125	533	0.2345216
C1	29073693	29075304	BolC1t03421H	0	+	48	794	1611	0.4928616
C1	29080140	29081049	BolC1t03422H	0	+	132	909	909	1.0000000
C1	29090546	29093930	BolC1t03423H	0	-	280	2043	3384	0.6037234
C1	29095130	29095431	BolC1t03424H	0	+	379	301	301	1.0000000
C1	29096613	29096811	BolC1t03425H	0	-	135	198	198	1.0000000
C1	29100210	29109863	BolC1t03426H	0	+	11463	9653	9653	1.0000000
C1	29124288	29125411	BolC1t03427H	0	+	33	522	1123	0.4648263
C1	29134316	29135399	BolC1t03428H	0	-	120	770	1083	0.7109880
C1	29150272	29151455	BolC1t03429H	0	+	168	814	1183	0.6880811
C1	29154757	29156038	BolC1t03430H	0	+	167	748	1281	0.5839188
C1	29190879	29191107	BolC1t03431H	0	-	373	228	228	1.0000000
C1	29207234	29209117	BolC1t03432H	0	+	771	1823	1883	0.9681360
C1	29210849	29211794	BolC1t03433H	0	-	962	945	945	1.0000000
C1	29215938	29216133	BolC1t03434H	0	+	3	60	195	0.3076923
C1	29230454	29234012	BolC1t03435H	0	-	31080	3558	3558	1.0000000
C1	29236926	29237493	BolC1t03436H	0	-	6211	567	567	1.0000000
C1	29237996	29238473	BolC1t03437H	0	-	5321	477	477	1.0000000
C1	29264858	29266602	BolC1t03438H	0	-	6036	1709	1744	0.9799312
C1	29268406	29269785	BolC1t03439H	0	+	8094	1379	1379	1.0000000
C1	29269806	29270152	BolC1t03440H	0	+	4390	346	346	1.0000000
C1	29270382	29270523	BolC1t03441H	0	-	2928	141	141	1.0000000
C1	29283458	29284021	BolC1t03442H	0	-	2048	563	563	1.0000000
C1	29287429	29287705	BolC1t03443H	0	+	0	0	276	0.0000000
C1	29290407	29290755	BolC1t03444H	0	-	19	93	348	0.2672414
C1	29291194	29292208	BolC1t03445H	0	-	21	375	1014	0.3698225
C1	29293529	29293841	BolC1t03446H	0	+	63	246	312	0.7884616
C1	29294771	29295119	BolC1t03447H	0	-	2675	348	348	1.0000000
C1	29295378	29295681	BolC1t03448H	0	-	4439	303	303	1.0000000
C1	29297899	29298286	BolC1t03449H	0	-	62	366	387	0.9457364
C1	29300144	29301081	BolC1t03450H	0	+	19	195	937	0.2081110
C1	29301274	29326844	BolC1t03451H	0	+	14927	14997	25570	0.5865076
C1	29311956	29312439	BolC1t03452H	0	+	81	457	483	0.9461698
C1	29313341	29317538	BolC1t03453H	0	-	10883	3565	4197	0.8494163
C1	29318162	29318680	BolC1t03454H	0	-	0	0	518	0.0000000
C1	29319968	29320409	BolC1t03455H	0	+	138	417	441	0.9455782
C1	29322012	29322500	BolC1t03456H	0	-	2	42	488	0.0860656
C1	29322654	29323641	BolC1t03457H	0	-	67	431	987	0.4366768
C1	29328146	29328524	BolC1t03458H	0	+	2905	378	378	1.0000000
C1	29329173	29329629	BolC1t03459H	0	-	2653	456	456	1.0000000
C1	29331486	29331756	BolC1t03460H	0	+	4665	270	270	1.0000000
C1	29344642	29346465	BolC1t03461H	0	+	17413	1823	1823	1.0000000
C1	29345605	29345938	BolC1t03462H	0	+	5324	333	333	1.0000000
C1	29346543	29347225	BolC1t03463H	0	+	8613	682	682	1.0000000
C1	29348609	29349105	BolC1t03464H	0	+	7757	496	496	1.0000000
C1	29357533	29357737	BolC1t03465H	0	-	151	204	204	1.0000000
C1	29398726	29399044	BolC1t03466H	0	-	2	146	318	0.4591195
C1	29403681	29409185	BolC1t03467H	0	+	2246	3843	5504	0.6982195
C1	29442868	29444786	BolC1t03468H	0	+	139	732	1918	0.3816476
C1	29453322	29456301	BolC1t03469H	0	-	290	2000	2979	0.6713662
C1	29460174	29461505	BolC1t03470H	0	-	660	1331	1331	1.0000000
C1	29482459	29483495	BolC1t03471H	0	-	19	213	1036	0.2055985
C1	29495639	29496621	BolC1t03472H	0	+	682	982	982	1.0000000
C1	29520264	29520662	BolC1t03473H	0	-	336	398	398	1.0000000
C1	29520952	29521205	BolC1t03474H	0	-	62	253	253	1.0000000
C1	29528377	29529314	BolC1t03475H	0	-	128	550	937	0.5869797
C1	29530652	29530880	BolC1t03476H	0	+	407	228	228	1.0000000
C1	29532486	29533159	BolC1t03477H	0	-	390	673	673	1.0000000
C1	29542261	29543460	BolC1t03478H	0	-	573	1199	1199	1.0000000
C1	29567356	29569283	BolC1t03479H	0	+	105	991	1927	0.5142709
C1	29609608	29610060	BolC1t03480H	0	-	331	452	452	1.0000000
C1	29618173	29618876	BolC1t03481H	0	+	412	703	703	1.0000000
C1	29622430	29622940	BolC1t03482H	0	+	611	510	510	1.0000000
C1	29626858	29627647	BolC1t03483H	0	-	294	789	789	1.0000000
C1	29641330	29643066	BolC1t03484H	0	+	43	725	1736	0.4176267
C1	29645067	29645235	BolC1t03485H	0	+	48	168	168	1.0000000
C1	29646453	29648869	BolC1t03486H	0	-	692	2008	2416	0.8311259
C1	29653957	29654943	BolC1t03487H	0	-	178	702	986	0.7119675
C1	29709960	29710929	BolC1t03488H	0	+	40	449	969	0.4633643
C1	29722457	29724927	BolC1t03489H	0	-	808	1847	2470	0.7477733
C1	29725275	29727018	BolC1t03490H	0	+	283	1467	1743	0.8416523
C1	29730197	29732094	BolC1t03491H	0	+	486	1758	1897	0.9267264
C1	29739162	29742943	BolC1t03492H	0	-	1305	3477	3781	0.9195980
C1	29855738	29856038	BolC1t03493H	0	+	0	0	300	0.0000000
C1	29890361	29890964	BolC1t03494H	0	-	23	347	603	0.5754561
C1	29891706	29891829	BolC1t03495H	0	-	2	6	123	0.0487805
C1	29891911	29892244	BolC1t03496H	0	-	0	0	333	0.0000000
C1	29959736	29960171	BolC1t03497H	0	+	70	398	435	0.9149425
C1	29965741	29966001	BolC1t03498H	0	+	214	260	260	1.0000000
C1	30060895	30061965	BolC1t03499H	0	-	181	1050	1070	0.9813084
C1	30063160	30064176	BolC1t03500H	0	+	60	560	1016	0.5511811
C1	30064506	30075066	BolC1t03501H	0	-	735	6288	10560	0.5954546
C1	30076737	30077461	BolC1t03502H	0	+	0	0	724	0.0000000
C1	30077575	30078224	BolC1t03503H	0	+	43	448	649	0.6902928
C1	30089167	30089886	BolC1t03504H	0	+	227	499	719	0.6940195
C1	30090740	30090962	BolC1t03505H	0	+	40	197	222	0.8873874
C1	30094161	30095748	BolC1t03506H	0	-	150	1283	1587	0.8084436
C1	30108439	30117300	BolC1t03507H	0	-	1396	5544	8861	0.6256630
C1	30122755	30123574	BolC1t03508H	0	-	688	819	819	1.0000000
C1	30130450	30131406	BolC1t03509H	0	-	507	941	956	0.9843096
C1	30160417	30162171	BolC1t03510H	0	+	349	1288	1754	0.7343215
C1	30170596	30170821	BolC1t03511H	0	-	234	225	225	1.0000000
C1	30177107	30179705	BolC1t03512H	0	+	1216	2598	2598	1.0000000
C1	30179899	30180659	BolC1t03513H	0	+	717	760	760	1.0000000
C1	30190336	30191071	BolC1t03514H	0	-	476	735	735	1.0000000
C1	30195318	30208242	BolC1t03515H	0	-	2594	11011	12924	0.8519808
C1	30231783	30233185	BolC1t03516H	0	+	284	1114	1402	0.7945791
C1	30233589	30235072	BolC1t03517H	0	-	18	426	1483	0.2872556
C1	30245303	30245645	BolC1t03518H	0	-	142	342	342	1.0000000
C1	30246644	30247004	BolC1t03519H	0	-	374	360	360	1.0000000
C1	30253379	30254535	BolC1t03520H	0	+	742	1156	1156	1.0000000
C1	30258874	30258994	BolC1t03521H	0	+	73	120	120	1.0000000
C1	30263060	30263285	BolC1t03522H	0	+	392	225	225	1.0000000
C1	30264578	30267230	BolC1t03523H	0	-	579	2258	2652	0.8514329
C1	30279370	30280444	BolC1t03524H	0	-	112	740	1074	0.6890131
C1	30288822	30289137	BolC1t03525H	0	-	219	315	315	1.0000000
C1	30298444	30300799	BolC1t03526H	0	-	566	2025	2355	0.8598726
C1	30306614	30308040	BolC1t03527H	0	-	223	1198	1426	0.8401122
C1	30322952	30323054	BolC1t03528H	0	-	343	102	102	1.0000000
C1	30326746	30329877	BolC1t03529H	0	-	1554	2762	3131	0.8821463
C1	30356249	30356971	BolC1t03530H	0	+	509	722	722	1.0000000
C1	30372800	30373940	BolC1t03531H	0	+	541	1140	1140	1.0000000
C1	30387080	30389827	BolC1t03532H	0	-	837	2674	2747	0.9734256
C1	30403301	30404707	BolC1t03533H	0	-	74	962	1406	0.6842105
C1	30408568	30411239	BolC1t03534H	0	+	8	237	2671	0.0887308
C1	30439102	30439420	BolC1t03535H	0	-	203	318	318	1.0000000
C1	30439358	30439605	BolC1t03536H	0	-	168	247	247	1.0000000
C1	30442062	30443617	BolC1t03537H	0	+	180	1101	1555	0.7080386
C1	30463887	30464164	BolC1t03538H	0	-	229	277	277	1.0000000
C1	30465135	30467633	BolC1t03539H	0	-	1348	2489	2498	0.9963971
C1	30476019	30477635	BolC1t03540H	0	-	150	1135	1616	0.7023515
C1	30483107	30485859	BolC1t03541H	0	+	1000	2750	2752	0.9992732
C1	30488239	30488629	BolC1t03542H	0	+	299	390	390	1.0000000
C1	30492536	30496659	BolC1t03543H	0	-	1252	2972	4123	0.7208343
C1	30539936	30540752	BolC1t03544H	0	+	525	816	816	1.0000000
C1	30541038	30543931	BolC1t03545H	0	+	206	791	2893	0.2734186
C1	30544203	30547589	BolC1t03546H	0	-	799	1319	3386	0.3895452
C1	30549682	30549943	BolC1t03547H	0	+	0	0	261	0.0000000
C1	30583687	30596673	BolC1t03548H	0	+	543	4234	12986	0.3260434
C1	30602275	30613781	BolC1t03549H	0	-	660	5415	11506	0.4706240
C1	30617171	30624909	BolC1t03550H	0	+	2936	7491	7738	0.9680796
C1	30621850	30622729	BolC1t03551H	0	-	88	779	879	0.8862343
C1	30625188	30626458	BolC1t03552H	0	+	946	1270	1270	1.0000000
C1	30640855	30642750	BolC1t03553H	0	-	1923	1895	1895	1.0000000
C1	30676648	30678282	BolC1t03554H	0	-	43	790	1634	0.4834761
C1	30678416	30678758	BolC1t03555H	0	-	2	134	342	0.3918129
C1	30681486	30682734	BolC1t03556H	0	-	514	1248	1248	1.0000000
C1	30695240	30696885	BolC1t03557H	0	-	366	1588	1645	0.9653496
C1	30705783	30706701	BolC1t03558H	0	-	528	918	918	1.0000000
C1	30710681	30711671	BolC1t03559H	0	+	23	554	990	0.5595959
C1	30714095	30715408	BolC1t03560H	0	-	130	1131	1313	0.8613861
C1	30727234	30728324	BolC1t03561H	0	-	5	192	1090	0.1761468
C1	30730943	30732720	BolC1t03562H	0	-	207	839	1777	0.4721441
C1	30734403	30734730	BolC1t03563H	0	-	24	308	327	0.9418960
C1	30740964	30741215	BolC1t03564H	0	-	0	0	251	0.0000000
C1	30743019	30744841	BolC1t03565H	0	-	0	0	1822	0.0000000
C1	30769365	30770762	BolC1t03566H	0	-	909	1397	1397	1.0000000
C1	30777553	30777712	BolC1t03567H	0	+	15	159	159	1.0000000
C1	30802881	30803184	BolC1t03568H	0	+	488	303	303	1.0000000
C1	30826998	30827676	BolC1t03569H	0	+	51	105	678	0.1548673
C1	30839746	30840803	BolC1t03570H	0	+	0	0	1057	0.0000000
C1	30859618	30861390	BolC1t03571H	0	+	0	0	1772	0.0000000
C1	30867806	30868646	BolC1t03572H	0	+	4	45	840	0.0535714
C1	30873847	30874523	BolC1t03573H	0	+	9	475	676	0.7026627
C1	30894131	30894515	BolC1t03574H	0	-	0	0	384	0.0000000
C1	30895134	30895515	BolC1t03575H	0	-	1	94	381	0.2467192
C1	30908842	30910096	BolC1t03576H	0	+	2	56	1254	0.0446571
C1	30917128	30917888	BolC1t03577H	0	+	5	50	760	0.0657895
C1	30923092	30923771	BolC1t03578H	0	+	0	0	679	0.0000000
C1	31048129	31049727	BolC1t03579H	0	+	1612	1598	1598	1.0000000
C1	31051619	31051982	BolC1t03580H	0	+	531	363	363	1.0000000
C1	31066222	31067727	BolC1t03581H	0	+	339	918	1505	0.6099668
C1	31069362	31069599	BolC1t03582H	0	-	178	237	237	1.0000000
C1	31081502	31082604	BolC1t03583H	0	+	7	538	1102	0.4882033
C1	31105154	31106301	BolC1t03584H	0	+	3	140	1147	0.1220575
C1	31119573	31120798	BolC1t03585H	0	+	192	1156	1225	0.9436735
C1	31127725	31131470	BolC1t03586H	0	+	269	2175	3745	0.5807744
C1	31132163	31133405	BolC1t03587H	0	-	395	1185	1242	0.9541063
C1	31144739	31148672	BolC1t03588H	0	+	570	2695	3933	0.6852276
C1	31153904	31163161	BolC1t03589H	0	+	7867	9257	9257	1.0000000
C1	31163944	31165271	BolC1t03590H	0	+	240	796	1327	0.5998493
C1	31179023	31179662	BolC1t03591H	0	+	15	164	639	0.2566510
C1	31183940	31185506	BolC1t03592H	0	-	217	1291	1566	0.8243933
C1	31188919	31191007	BolC1t03593H	0	-	989	2061	2088	0.9870690
C1	31213745	31220743	BolC1t03594H	0	+	1116	6257	6998	0.8941126
C1	31225385	31228892	BolC1t03595H	0	+	2872	3389	3507	0.9663530
C1	31229661	31238830	BolC1t03596H	0	+	3239	8957	9169	0.9768786
C1	31239513	31239803	BolC1t03597H	0	+	53	290	290	1.0000000
C1	31241576	31241863	BolC1t03598H	0	+	20	287	287	1.0000000
C1	31245681	31245966	BolC1t03599H	0	+	8	285	285	1.0000000
C1	31247717	31248002	BolC1t03600H	0	+	621	285	285	1.0000000
C1	31256496	31257331	BolC1t03601H	0	-	281	835	835	1.0000000
C1	31312030	31312501	BolC1t03602H	0	+	423	471	471	1.0000000
C1	31336531	31336913	BolC1t03603H	0	+	47	278	382	0.7277487
C1	31345738	31346068	BolC1t03604H	0	-	658	330	330	1.0000000
C1	31346638	31348373	BolC1t03605H	0	-	327	1689	1735	0.9734870
C1	31350569	31360557	BolC1t03606H	0	+	1733	3637	9988	0.3641370
C1	31361346	31362078	BolC1t03607H	0	-	289	732	732	1.0000000
C1	31398388	31398493	BolC1t03608H	0	+	154	105	105	1.0000000
C1	31406131	31409918	BolC1t03609H	0	+	959	2982	3787	0.7874307
C1	31410253	31411757	BolC1t03610H	0	-	652	1311	1504	0.8716756
C1	31430489	31433525	BolC1t03611H	0	-	12065	3036	3036	1.0000000
C1	31449108	31449393	BolC1t03612H	0	+	705	285	285	1.0000000
C1	31455453	31464477	BolC1t03613H	0	+	2824	7796	9024	0.8639184
C1	31466118	31466310	BolC1t03614H	0	-	256	192	192	1.0000000
C1	31476030	31477567	BolC1t03615H	0	+	1829	1537	1537	1.0000000
C1	31477774	31479181	BolC1t03616H	0	-	998	1390	1407	0.9879175
C1	31491723	31492384	BolC1t03617H	0	-	454	661	661	1.0000000
C1	31500071	31500347	BolC1t03618H	0	-	378	276	276	1.0000000
C1	31556123	31561856	BolC1t03619H	0	+	4587	5589	5733	0.9748822
C1	31585103	31587587	BolC1t03620H	0	+	2821	2475	2484	0.9963768
C1	31588095	31590503	BolC1t03621H	0	-	4879	2391	2408	0.9929402
C1	31599293	31599996	BolC1t03622H	0	-	77	550	703	0.7823613
C1	31611131	31612814	BolC1t03623H	0	+	983	1683	1683	1.0000000
C1	31631636	31633222	BolC1t03624H	0	-	620	1560	1586	0.9836066
C1	31669718	31669916	BolC1t03625H	0	-	0	0	198	0.0000000
C1	31670476	31670656	BolC1t03626H	0	+	15	180	180	1.0000000
C1	31676596	31677800	BolC1t03627H	0	+	611	1204	1204	1.0000000
C1	31681951	31683650	BolC1t03628H	0	-	1245	1699	1699	1.0000000
C1	31690497	31691197	BolC1t03629H	0	-	583	700	700	1.0000000
C1	31695101	31697652	BolC1t03630H	0	-	1487	1956	2551	0.7667581
C1	31699977	31700958	BolC1t03631H	0	+	314	723	981	0.7370030
C1	31718250	31719085	BolC1t03632H	0	-	2192	835	835	1.0000000
C1	31725375	31727179	BolC1t03633H	0	-	2601	1804	1804	1.0000000
C1	31741226	31743862	BolC1t03634H	0	-	269	1249	2636	0.4738240
C1	31833125	31836386	BolC1t03635H	0	+	2866	3012	3261	0.9236431
C1	31849371	31853179	BolC1t03636H	0	-	3871	3774	3808	0.9910714
C1	31863321	31865734	BolC1t03637H	0	+	1066	2413	2413	1.0000000
C1	31879537	31880705	BolC1t03638H	0	-	508	1168	1168	1.0000000
C1	31882100	31882418	BolC1t03639H	0	+	33	318	318	1.0000000
C1	31901746	31901860	BolC1t03640H	0	-	103	114	114	1.0000000
C1	31918487	31918625	BolC1t03641H	0	-	58	138	138	1.0000000
C1	31934693	31937489	BolC1t03642H	0	-	596	2583	2796	0.9238197
C1	31982691	31985034	BolC1t03643H	0	+	1343	2343	2343	1.0000000
C1	32009442	32013271	BolC1t03644H	0	-	1234	3251	3829	0.8490468
C1	32019015	32020167	BolC1t03645H	0	-	27	230	1152	0.1996528
C1	32020644	32020854	BolC1t03646H	0	+	133	210	210	1.0000000
C1	32026955	32027129	BolC1t03647H	0	+	46	174	174	1.0000000
C1	32027527	32046993	BolC1t03648H	0	+	7086	15167	19466	0.7791534
C1	32051791	32053263	BolC1t03649H	0	+	473	1472	1472	1.0000000
C1	32061593	32063633	BolC1t03650H	0	+	257	1751	2040	0.8583333
C1	32064696	32068791	BolC1t03651H	0	-	1244	2851	4095	0.6962149
C1	32075190	32075754	BolC1t03652H	0	-	961	564	564	1.0000000
C1	32076955	32077936	BolC1t03653H	0	-	73	310	981	0.3160041
C1	32084657	32091745	BolC1t03654H	0	+	2551	6699	7088	0.9451185
C1	32095586	32096988	BolC1t03655H	0	+	723	1402	1402	1.0000000
C1	32107232	32109285	BolC1t03656H	0	+	225	1717	2053	0.8363371
C1	32117559	32123256	BolC1t03657H	0	+	6316	5688	5697	0.9984202
C1	32143235	32147742	BolC1t03658H	0	-	1724	4198	4507	0.9314400
C1	32147934	32150271	BolC1t03659H	0	-	469	1812	2337	0.7753530
C1	32193934	32194120	BolC1t03660H	0	-	125	186	186	1.0000000
C1	32205474	32206050	BolC1t03661H	0	-	108	576	576	1.0000000
C1	32220413	32220626	BolC1t03662H	0	-	8	141	213	0.6619718
C1	32223969	32224923	BolC1t03663H	0	-	4	553	954	0.5796646
C1	32228863	32229208	BolC1t03664H	0	-	4	175	345	0.5072464
C1	32266760	32267073	BolC1t03665H	0	+	300	313	313	1.0000000
C1	32280004	32282693	BolC1t03666H	0	+	1454	2428	2689	0.9029379
C1	32292193	32293780	BolC1t03667H	0	+	192	1343	1587	0.8462508
C1	32319558	32319786	BolC1t03668H	0	-	128	210	228	0.9210526
C1	32324190	32324805	BolC1t03669H	0	+	2	22	615	0.0357724
C1	32356367	32358641	BolC1t03670H	0	-	1636	2274	2274	1.0000000
C1	32402593	32402737	BolC1t03671H	0	+	19	144	144	1.0000000
C1	32405049	32405250	BolC1t03672H	0	-	170	201	201	1.0000000
C1	32407380	32409421	BolC1t03673H	0	-	696	2041	2041	1.0000000
C1	32417755	32418708	BolC1t03674H	0	-	29	468	953	0.4910808
C1	32438651	32438897	BolC1t03675H	0	+	104	246	246	1.0000000
C1	32448790	32449731	BolC1t03676H	0	-	4	85	941	0.0903294
C1	32452070	32454507	BolC1t03677H	0	-	200	1796	2437	0.7369717
C1	32455025	32455409	BolC1t03678H	0	-	450	384	384	1.0000000
C1	32467966	32469625	BolC1t03679H	0	+	845	1659	1659	1.0000000
C1	32475511	32476039	BolC1t03680H	0	+	115	376	528	0.7121212
C1	32476482	32478444	BolC1t03681H	0	-	1467	1962	1962	1.0000000
C1	32479348	32480501	BolC1t03682H	0	-	157	1032	1153	0.8950564
C1	32489672	32489882	BolC1t03683H	0	+	210	210	210	1.0000000
C1	32493883	32494294	BolC1t03684H	0	+	279	411	411	1.0000000
C1	32543716	32543954	BolC1t03685H	0	-	50	238	238	1.0000000
C1	32544648	32546543	BolC1t03686H	0	+	292	1755	1895	0.9261214
C1	32552618	32554640	BolC1t03687H	0	-	285	1561	2022	0.7720079
C1	32555860	32557106	BolC1t03688H	0	-	759	1246	1246	1.0000000
C1	32558855	32559237	BolC1t03689H	0	+	596	382	382	1.0000000
C1	32561147	32561279	BolC1t03690H	0	+	34	132	132	1.0000000
C1	32567921	32570501	BolC1t03691H	0	+	1469	2395	2580	0.9282946
C1	32578547	32579340	BolC1t03692H	0	-	645	793	793	1.0000000
C1	32579151	32617429	BolC1t03693H	0	-	9306	28517	38278	0.7449971
C1	32601823	32602828	BolC1t03694H	0	+	216	1005	1005	1.0000000
C1	32604337	32610458	BolC1t03695H	0	-	234	2712	6121	0.4430649
C1	32614925	32615365	BolC1t03696H	0	+	360	440	440	1.0000000
C1	32615929	32651593	BolC1t03697H	0	-	7070	18034	35664	0.5056640
C1	32641763	32642677	BolC1t03698H	0	+	42	359	914	0.3927790
C1	32673530	32674740	BolC1t03699H	0	-	840	1182	1210	0.9768595
C1	32685707	32687336	BolC1t03700H	0	-	463	1335	1629	0.8195212
C1	32701937	32703287	BolC1t03701H	0	+	626	1350	1350	1.0000000
C1	32704363	32707042	BolC1t03702H	0	+	349	1143	2679	0.4266517
C1	32707440	32709717	BolC1t03703H	0	-	767	1578	2277	0.6930171
C1	32718093	32719625	BolC1t03704H	0	+	1030	1532	1532	1.0000000
C1	32730900	32731720	BolC1t03705H	0	+	0	0	820	0.0000000
C1	32739058	32739385	BolC1t03706H	0	-	316	310	327	0.9480122
C1	32739519	32739696	BolC1t03707H	0	-	78	111	177	0.6271186
C1	32751259	32751802	BolC1t03708H	0	-	91	543	543	1.0000000
C1	32757181	32760703	BolC1t03709H	0	-	1841	3503	3522	0.9946054
C1	32767435	32768292	BolC1t03710H	0	+	1099	857	857	1.0000000
C1	32801177	32804132	BolC1t03711H	0	-	218	1933	2955	0.6541455
C1	32804634	32808376	BolC1t03712H	0	-	1079	2632	3742	0.7033672
C1	32806052	32806934	BolC1t03713H	0	+	528	882	882	1.0000000
C1	32816294	32819803	BolC1t03714H	0	+	1328	3265	3509	0.9304645
C1	32820744	32821224	BolC1t03715H	0	-	7	299	480	0.6229166
C1	32821225	32824675	BolC1t03716H	0	-	1594	3172	3450	0.9194203
C1	32831175	32831643	BolC1t03717H	0	+	62	430	468	0.9188034
C1	32831664	32833503	BolC1t03718H	0	+	371	1839	1839	1.0000000
C1	32892029	32893062	BolC1t03719H	0	-	139	1006	1033	0.9738625
C1	32895746	32899514	BolC1t03720H	0	+	880	3160	3768	0.8386412
C1	32900329	32900776	BolC1t03721H	0	+	57	207	447	0.4630873
C1	32912430	32913998	BolC1t03722H	0	-	291	1493	1568	0.9521683
C1	32924871	32927821	BolC1t03723H	0	-	359	1538	2950	0.5213559
C1	32944141	32945134	BolC1t03724H	0	+	22	405	993	0.4078550
C1	32953949	32954338	BolC1t03725H	0	+	28	168	389	0.4318766
C1	32982863	32984649	BolC1t03726H	0	-	1256	1702	1786	0.9529675
C1	32988437	32989884	BolC1t03727H	0	+	1175	1447	1447	1.0000000
C1	33001916	33004954	BolC1t03728H	0	-	272	2239	3038	0.7369980
C1	33022895	33024617	BolC1t03729H	0	-	279	1242	1722	0.7212543
C1	33031400	33032032	BolC1t03730H	0	+	10	170	632	0.2689873
C1	33035010	33039401	BolC1t03731H	0	-	1028	4070	4391	0.9268959
C1	33057496	33058072	BolC1t03732H	0	+	235	576	576	1.0000000
C1	33079343	33082058	BolC1t03733H	0	-	877	2145	2715	0.7900553
C1	33083134	33084322	BolC1t03734H	0	+	1319	1188	1188	1.0000000
C1	33086521	33086819	BolC1t03735H	0	-	113	295	298	0.9899329
C1	33090144	33091681	BolC1t03736H	0	+	770	1537	1537	1.0000000
C1	33105939	33106297	BolC1t03737H	0	-	7	235	358	0.6564246
C1	33115489	33118910	BolC1t03738H	0	-	1110	2476	3421	0.7237650
C1	33128589	33131788	BolC1t03739H	0	-	1053	2651	3199	0.8286965
C1	33137688	33138344	BolC1t03740H	0	-	345	646	656	0.9847561
C1	33157451	33159263	BolC1t03741H	0	-	921	1198	1812	0.6611479
C1	33180064	33183590	BolC1t03742H	0	-	188	2221	3526	0.6298922
C1	33190481	33195394	BolC1t03743H	0	-	811	3084	4913	0.6277224
C1	33236304	33236610	BolC1t03744H	0	+	360	306	306	1.0000000
C1	33238589	33239315	BolC1t03745H	0	-	515	726	726	1.0000000
C1	33242366	33242795	BolC1t03746H	0	+	32	186	429	0.4335664
C1	33243767	33245118	BolC1t03747H	0	+	1004	1351	1351	1.0000000
C1	33257572	33259059	BolC1t03748H	0	+	69	1114	1487	0.7491594
C1	33260941	33261685	BolC1t03749H	0	+	38	281	744	0.3776882
C1	33277327	33278995	BolC1t03750H	0	-	5377	1668	1668	1.0000000
C1	33279091	33279760	BolC1t03751H	0	-	709	669	669	1.0000000
C1	33283552	33286938	BolC1t03752H	0	+	1155	3320	3386	0.9805080
C1	33295917	33296025	BolC1t03753H	0	+	195	108	108	1.0000000
C1	33333906	33334014	BolC1t03754H	0	+	31	108	108	1.0000000
C1	33336860	33336968	BolC1t03755H	0	+	11	108	108	1.0000000
C1	33357892	33358000	BolC1t03756H	0	+	471	108	108	1.0000000
C1	33360335	33360649	BolC1t03757H	0	+	126	314	314	1.0000000
C1	33383125	33383233	BolC1t03758H	0	+	50	108	108	1.0000000
C1	33396903	33397225	BolC1t03759H	0	+	80	322	322	1.0000000
C1	33400535	33400703	BolC1t03760H	0	+	149	168	168	1.0000000
C1	33406366	33408902	BolC1t03761H	0	-	735	2536	2536	1.0000000
C1	33414377	33414485	BolC1t03762H	0	+	18	108	108	1.0000000
C1	33417737	33418928	BolC1t03763H	0	+	283	1191	1191	1.0000000
C1	33422263	33422632	BolC1t03764H	0	+	139	369	369	1.0000000
C1	33427343	33427451	BolC1t03765H	0	+	139	108	108	1.0000000
C1	33471518	33471834	BolC1t03766H	0	+	175	316	316	1.0000000
C1	33475420	33475528	BolC1t03767H	0	+	160	108	108	1.0000000
C1	33504820	33505140	BolC1t03768H	0	+	110	320	320	1.0000000
C1	33524309	33524631	BolC1t03769H	0	+	70	322	322	1.0000000
C1	33527397	33527505	BolC1t03770H	0	+	32	108	108	1.0000000
C1	33544065	33544704	BolC1t03771H	0	+	446	639	639	1.0000000
C1	33574444	33575078	BolC1t03772H	0	+	283	622	634	0.9810725
C1	33577449	33578573	BolC1t03773H	0	+	46	628	1124	0.5587189
C1	33597996	33599581	BolC1t03774H	0	-	1262	1585	1585	1.0000000
C1	33613792	33614056	BolC1t03775H	0	-	276	264	264	1.0000000
C1	33615017	33621337	BolC1t03776H	0	+	1884	5385	6320	0.8520570
C1	33622972	33624956	BolC1t03777H	0	+	192	1527	1984	0.7696573
C1	33630601	33631898	BolC1t03778H	0	+	237	1297	1297	1.0000000
C1	33632108	33633239	BolC1t03779H	0	+	761	1131	1131	1.0000000
C1	33634393	33636579	BolC1t03780H	0	+	908	2085	2186	0.9537969
C1	33642652	33643168	BolC1t03781H	0	-	36	394	516	0.7635659
C1	33649461	33651077	BolC1t03782H	0	-	133	1258	1616	0.7784653
C1	33653134	33654413	BolC1t03783H	0	-	55	712	1279	0.5566849
C1	33656881	33658110	BolC1t03784H	0	-	809	1229	1229	1.0000000
C1	33666392	33666878	BolC1t03785H	0	+	499	486	486	1.0000000
C1	33669675	33669927	BolC1t03786H	0	-	60	252	252	1.0000000
C1	33717862	33719658	BolC1t03787H	0	+	17	622	1796	0.3463252
C1	33723356	33724225	BolC1t03788H	0	-	487	869	869	1.0000000
C1	33727182	33727923	BolC1t03789H	0	+	1326	741	741	1.0000000
C1	33730622	33731039	BolC1t03790H	0	-	258	417	417	1.0000000
C1	33733040	33733445	BolC1t03791H	0	-	423	405	405	1.0000000
C1	33736592	33738394	BolC1t03792H	0	+	53	696	1802	0.3862375
C1	33746841	33748150	BolC1t03793H	0	+	420	1261	1309	0.9633308
C1	33758227	33758329	BolC1t03794H	0	+	181	102	102	1.0000000
C1	33759060	33759299	BolC1t03795H	0	+	328	239	239	1.0000000
C1	33774528	33799699	BolC1t03796H	0	-	6451	18283	25171	0.7263517
C1	33787632	33787849	BolC1t03797H	0	+	0	0	217	0.0000000
C1	33802523	33805492	BolC1t03798H	0	-	1131	2639	2969	0.8888515
C1	33809447	33810338	BolC1t03799H	0	-	226	858	891	0.9629630
C1	33813146	33813977	BolC1t03800H	0	-	35	576	831	0.6931408
C1	33815037	33815683	BolC1t03801H	0	+	67	608	646	0.9411765
C1	33816094	33825493	BolC1t03802H	0	+	968	4913	9399	0.5227152
C1	33826185	33826821	BolC1t03803H	0	+	36	435	636	0.6839623
C1	33842629	33843607	BolC1t03804H	0	+	274	752	978	0.7689161
C1	33851650	33852648	BolC1t03805H	0	+	61	594	998	0.5951904
C1	33853237	33856500	BolC1t03806H	0	-	1596	3203	3263	0.9816120
C1	33897287	33897515	BolC1t03807H	0	+	33	203	228	0.8903509
C1	33922210	33922438	BolC1t03808H	0	+	5	78	228	0.3421053
C1	33940300	33941794	BolC1t03809H	0	-	680	1262	1494	0.8447122
C1	33944736	33945227	BolC1t03810H	0	+	449	491	491	1.0000000
C1	33957588	33960562	BolC1t03811H	0	-	328	1782	2974	0.5991930
C1	33964469	33965326	BolC1t03812H	0	+	262	728	857	0.8494749
C1	33970241	33974244	BolC1t03813H	0	+	515	1789	4003	0.4469148
C1	33974291	33974483	BolC1t03814H	0	+	95	192	192	1.0000000
C1	33979168	33979937	BolC1t03815H	0	-	480	769	769	1.0000000
C1	33988190	33988940	BolC1t03816H	0	+	0	0	750	0.0000000
C1	33991292	33994354	BolC1t03817H	0	+	483	2403	3062	0.7847812
C1	34005887	34008971	BolC1t03818H	0	+	1497	3084	3084	1.0000000
C1	34010089	34010745	BolC1t03819H	0	-	257	613	656	0.9344512
C1	34014018	34015550	BolC1t03820H	0	-	359	1411	1532	0.9210183
C1	34029770	34030621	BolC1t03821H	0	+	533	808	851	0.9494712
C1	34031894	34035041	BolC1t03822H	0	+	1245	2626	3147	0.8344455
C1	34036660	34038778	BolC1t03823H	0	+	806	2024	2118	0.9556185
C1	34040800	34041347	BolC1t03824H	0	-	490	547	547	1.0000000
C1	34052329	34054348	BolC1t03825H	0	+	266	1235	2019	0.6116890
C1	34057422	34059510	BolC1t03826H	0	-	631	1784	2088	0.8544061
C1	34066448	34066925	BolC1t03827H	0	+	268	477	477	1.0000000
C1	34081195	34081573	BolC1t03828H	0	-	4	20	378	0.0529101
C1	34139132	34140912	BolC1t03829H	0	-	257	1240	1780	0.6966292
C1	34160571	34162419	BolC1t03830H	0	+	24	638	1848	0.3452381
C1	34163551	34163993	BolC1t03831H	0	-	0	0	442	0.0000000
C1	34164509	34165177	BolC1t03832H	0	+	0	0	668	0.0000000
C1	34165332	34166004	BolC1t03833H	0	+	8	356	672	0.5297619
C1	34167156	34169381	BolC1t03834H	0	+	130	1781	2225	0.8004494
C1	34170613	34171291	BolC1t03835H	0	-	3	108	678	0.1592920
C1	34172256	34175767	BolC1t03836H	0	-	496	3124	3511	0.8897750
C1	34175976	34176347	BolC1t03837H	0	-	25	167	371	0.4501348
C1	34179245	34179888	BolC1t03838H	0	-	135	592	643	0.9206843
C1	34184953	34185567	BolC1t03839H	0	+	246	614	614	1.0000000
C1	34252912	34253152	BolC1t03840H	0	-	11	108	240	0.4500000
C1	34276563	34278425	BolC1t03841H	0	+	200	1342	1862	0.7207304
C1	34292931	34295409	BolC1t03842H	0	-	126	1038	2478	0.4188862
C1	34298469	34299013	BolC1t03843H	0	+	464	544	544	1.0000000
C1	34306463	34307908	BolC1t03844H	0	+	1372	1374	1445	0.9508650
C1	34311641	34315344	BolC1t03845H	0	-	1033	2984	3703	0.8058331
C1	34315678	34316400	BolC1t03846H	0	+	696	722	722	1.0000000
C1	34316945	34318451	BolC1t03847H	0	-	326	1389	1506	0.9223108
C1	34319252	34328892	BolC1t03848H	0	-	4694	9210	9640	0.9553942
C1	34337236	34342516	BolC1t03849H	0	-	2167	4194	5280	0.7943182
C1	34344273	34344711	BolC1t03850H	0	+	714	438	438	1.0000000
C1	34357963	34358200	BolC1t03851H	0	-	255	237	237	1.0000000
C1	34361009	34376943	BolC1t03852H	0	-	4282	11548	15934	0.7247396
C1	34377145	34377841	BolC1t03853H	0	-	638	696	696	1.0000000
C1	34441372	34442044	BolC1t03854H	0	-	68	473	672	0.7038690
C1	34453194	34455284	BolC1t03855H	0	+	467	1544	2090	0.7387560
C1	34458419	34459460	BolC1t03856H	0	+	136	783	1041	0.7521614
C1	34468042	34468733	BolC1t03857H	0	-	132	691	691	1.0000000
C1	34482634	34482999	BolC1t03858H	0	+	311	365	365	1.0000000
C1	34496205	34497648	BolC1t03859H	0	+	379	1347	1443	0.9334719
C1	34514019	34518052	BolC1t03860H	0	+	2290	3625	4033	0.8988346
C1	34551923	34552791	BolC1t03861H	0	+	171	785	868	0.9043779
C1	34563279	34564818	BolC1t03862H	0	-	353	1349	1539	0.8765432
C1	34565602	34566829	BolC1t03863H	0	-	120	1100	1227	0.8964955
C1	34571383	34574426	BolC1t03864H	0	-	1013	2522	3043	0.8287874
C1	34577815	34578925	BolC1t03865H	0	+	233	466	1110	0.4198198
C1	34625333	34627389	BolC1t03866H	0	-	756	1960	2056	0.9533074
C1	34631905	34632403	BolC1t03867H	0	-	20	287	498	0.5763052
C1	34642937	34643813	BolC1t03868H	0	+	23	556	876	0.6347032
C1	34649336	34653251	BolC1t03869H	0	+	1616	3826	3915	0.9772669
C1	34650905	34651716	BolC1t03870H	0	+	789	811	811	1.0000000
C1	34653726	34654405	BolC1t03871H	0	+	82	590	679	0.8689249
C1	34655063	34660610	BolC1t03872H	0	+	978	4313	5547	0.7775374
C1	34686165	34696853	BolC1t03873H	0	-	1050	5289	10688	0.4948540
C1	34741101	34741716	BolC1t03874H	0	-	167	615	615	1.0000000
C1	34745540	34746788	BolC1t03875H	0	-	911	1248	1248	1.0000000
C1	34749946	34752443	BolC1t03876H	0	+	1111	2373	2497	0.9503404
C1	34759290	34759599	BolC1t03877H	0	+	206	309	309	1.0000000
C1	34761149	34761816	BolC1t03878H	0	+	43	404	667	0.6056972
C1	34778020	34778272	BolC1t03879H	0	-	154	252	252	1.0000000
C1	34782780	34784509	BolC1t03880H	0	-	395	1483	1729	0.8577212
C1	34805018	34805410	BolC1t03881H	0	-	264	392	392	1.0000000
C1	34814502	34815476	BolC1t03882H	0	+	24	320	974	0.3285421
C1	34826714	34828173	BolC1t03883H	0	+	2970	1335	1459	0.9150103
C1	34834085	34835117	BolC1t03884H	0	+	127	1032	1032	1.0000000
C1	34840065	34840305	BolC1t03885H	0	-	199	240	240	1.0000000
C1	34854567	34855466	BolC1t03886H	0	+	792	899	899	1.0000000
C1	34874504	34875980	BolC1t03887H	0	+	625	1351	1476	0.9153116
C1	34886843	34892904	BolC1t03888H	0	+	1471	5541	6061	0.9142056
C1	34893845	34894343	BolC1t03889H	0	-	781	498	498	1.0000000
C1	34905930	34908856	BolC1t03890H	0	+	1382	2515	2926	0.8595352
C1	34909608	34910016	BolC1t03891H	0	-	343	408	408	1.0000000
C1	34913141	34913243	BolC1t03892H	0	+	139	102	102	1.0000000
C1	34913261	34913462	BolC1t03893H	0	-	226	201	201	1.0000000
C1	34920476	34921214	BolC1t03894H	0	+	59	645	738	0.8739837
C1	34922280	34924579	BolC1t03895H	0	-	1011	2203	2299	0.9582427
C1	34939580	34940429	BolC1t03896H	0	-	108	698	849	0.8221437
C1	34942127	34943447	BolC1t03897H	0	-	635	1320	1320	1.0000000
C1	34946812	34948961	BolC1t03898H	0	-	373	1376	2149	0.6402978
C1	34960746	34961234	BolC1t03899H	0	+	553	488	488	1.0000000
C1	34961431	34962038	BolC1t03900H	0	+	922	607	607	1.0000000
C1	34964371	34964943	BolC1t03901H	0	-	139	301	572	0.5262238
C1	34968330	34970444	BolC1t03902H	0	+	843	2060	2114	0.9744560
C1	34978578	34979325	BolC1t03903H	0	+	618	710	747	0.9504685
C1	34990720	34993863	BolC1t03904H	0	-	2242	3143	3143	1.0000000
C1	34998917	35003892	BolC1t03905H	0	+	6925	4500	4975	0.9045226
C1	35010478	35011198	BolC1t03906H	0	+	34	480	720	0.6666667
C1	35011702	35016658	BolC1t03907H	0	-	1377	4010	4956	0.8091202
C1	35028928	35030300	BolC1t03908H	0	-	13	410	1372	0.2988338
C1	35063205	35064055	BolC1t03909H	0	+	117	750	850	0.8823529
C1	35078495	35079141	BolC1t03910H	0	-	83	634	646	0.9814242
C1	35107693	35119306	BolC1t03911H	0	+	69	1182	11613	0.1017825
C1	35111983	35114271	BolC1t03912H	0	-	0	0	2288	0.0000000
C1	35115626	35116775	BolC1t03913H	0	-	0	0	1149	0.0000000
C1	35117143	35117336	BolC1t03914H	0	-	0	0	193	0.0000000
C1	35132572	35133070	BolC1t03915H	0	-	102	446	498	0.8955823
C1	35133993	35139601	BolC1t03916H	0	-	639	1667	5608	0.2972539
C1	35145281	35147764	BolC1t03917H	0	+	681	2462	2483	0.9915425
C1	35150057	35150939	BolC1t03918H	0	+	463	868	882	0.9841270
C1	35153576	35157476	BolC1t03919H	0	+	806	3258	3900	0.8353846
C1	35159943	35161272	BolC1t03920H	0	-	682	1329	1329	1.0000000
C1	35161841	35163749	BolC1t03921H	0	-	1246	1908	1908	1.0000000
C1	35213657	35229948	BolC1t03922H	0	+	1346	3748	16291	0.2300657
C1	35232468	35245747	BolC1t03923H	0	+	1410	6559	13279	0.4939378
C1	35232619	35232919	BolC1t03924H	0	-	6	255	300	0.8500000
C1	35271040	35271887	BolC1t03925H	0	+	110	847	847	1.0000000
C1	35287665	35287788	BolC1t03926H	0	+	2	39	123	0.3170732
C1	35300647	35301357	BolC1t03927H	0	+	290	634	710	0.8929577
C1	35302704	35303967	BolC1t03928H	0	-	709	1263	1263	1.0000000
C1	35304866	35306164	BolC1t03929H	0	+	903	1298	1298	1.0000000
C1	35308011	35309394	BolC1t03930H	0	-	61	726	1383	0.5249458
C1	35337290	35337590	BolC1t03931H	0	-	206	300	300	1.0000000
C1	35364654	35381594	BolC1t03932H	0	+	5426	14597	16940	0.8616883
C1	35376021	35376483	BolC1t03933H	0	+	82	414	462	0.8961039
C1	35385045	35386886	BolC1t03934H	0	+	236	1067	1841	0.5795763
C1	35387750	35388206	BolC1t03935H	0	-	14	287	456	0.6293859
C1	35402812	35403103	BolC1t03936H	0	-	265	291	291	1.0000000
C1	35404332	35405850	BolC1t03937H	0	-	1159	1518	1518	1.0000000
C1	35408578	35409383	BolC1t03938H	0	+	552	805	805	1.0000000
C1	35412117	35413739	BolC1t03939H	0	-	53	451	1622	0.2780518
C1	35422298	35425250	BolC1t03940H	0	-	362	2147	2952	0.7273035
C1	35443073	35443685	BolC1t03941H	0	+	1109	612	612	1.0000000
C1	35444759	35446339	BolC1t03942H	0	-	141	940	1580	0.5949367
C1	35458771	35465009	BolC1t03943H	0	+	2040	4224	6238	0.6771401
C1	35459778	35460306	BolC1t03944H	0	-	4	258	528	0.4886364
C1	35462605	35463574	BolC1t03945H	0	-	692	969	969	1.0000000
C1	35466528	35467347	BolC1t03946H	0	+	340	731	819	0.8925519
C1	35468547	35470591	BolC1t03947H	0	-	384	2021	2044	0.9887475
C1	35479962	35488218	BolC1t03948H	0	-	2242	7560	8256	0.9156977
C1	35491463	35492654	BolC1t03949H	0	+	1086	1191	1191	1.0000000
C1	35518191	35519929	BolC1t03950H	0	+	473	1635	1738	0.9407365
C1	35520534	35526459	BolC1t03951H	0	-	1945	5432	5925	0.9167932
C1	35530538	35533254	BolC1t03952H	0	-	567	2678	2716	0.9860088
C1	35533800	35534088	BolC1t03953H	0	+	38	241	288	0.8368056
C1	35536429	35537848	BolC1t03954H	0	+	978	1419	1419	1.0000000
C1	35551338	35551811	BolC1t03955H	0	-	14	357	473	0.7547569
C1	35565753	35566827	BolC1t03956H	0	-	187	1074	1074	1.0000000
C1	35575382	35583855	BolC1t03957H	0	-	1909	6955	8473	0.8208427
C1	35604160	35605098	BolC1t03958H	0	-	94	663	938	0.7068231
C1	35610202	35610820	BolC1t03959H	0	-	42	516	618	0.8349515
C1	35611236	35611431	BolC1t03960H	0	+	81	195	195	1.0000000
C1	35638441	35638573	BolC1t03961H	0	+	1	7	132	0.0530303
C1	35666150	35667110	BolC1t03962H	0	-	31	464	960	0.4833333
C1	35744083	35745786	BolC1t03963H	0	-	862	1631	1703	0.9577217
C1	35747684	35750163	BolC1t03964H	0	-	1145	2479	2479	1.0000000
C1	35750856	35752064	BolC1t03965H	0	-	1300	1208	1208	1.0000000
C1	35762354	35762786	BolC1t03966H	0	-	45	346	432	0.8009259
C1	35772801	35774327	BolC1t03967H	0	-	212	1371	1526	0.8984272
C1	35783596	35789989	BolC1t03968H	0	-	195	1378	6393	0.2155483
C1	35791121	35797371	BolC1t03969H	0	-	916	5135	6250	0.8216000
C1	35800832	35823590	BolC1t03970H	0	+	3921	9501	22758	0.4174796
C1	35823230	35824142	BolC1t03971H	0	+	369	912	912	1.0000000
C1	35832874	35833210	BolC1t03972H	0	-	336	336	336	1.0000000
C1	35833243	35833807	BolC1t03973H	0	-	366	564	564	1.0000000
C1	35843269	35844181	BolC1t03974H	0	-	504	912	912	1.0000000
C1	35844738	35845445	BolC1t03975H	0	-	431	707	707	1.0000000
C1	35856076	35857666	BolC1t03976H	0	-	1326	1590	1590	1.0000000
C1	35868845	35871310	BolC1t03977H	0	+	237	1696	2465	0.6880324
C1	35876132	35880527	BolC1t03978H	0	+	273	2612	4395	0.5943117
C1	35880527	35881686	BolC1t03979H	0	-	110	1159	1159	1.0000000
C1	35906429	35909768	BolC1t03980H	0	+	927	3025	3339	0.9059598
C1	35909815	35909923	BolC1t03981H	0	+	14	69	108	0.6388889
C1	35911677	35925063	BolC1t03982H	0	+	1427	5323	13386	0.3976543
C1	35934600	35937071	BolC1t03983H	0	-	161	1272	2471	0.5147713
C1	35945139	35948780	BolC1t03984H	0	-	2309	3641	3641	1.0000000
C1	35952151	35952337	BolC1t03985H	0	+	131	186	186	1.0000000
C1	35975315	35986209	BolC1t03986H	0	-	556	6236	10894	0.5724252
C1	35998388	36003371	BolC1t03987H	0	-	2017	4711	4983	0.9454144
C1	36010386	36014444	BolC1t03988H	0	+	301	2921	4058	0.7198127
C1	36011507	36012022	BolC1t03989H	0	+	12	226	515	0.4388350
C1	36031026	36032390	BolC1t03990H	0	+	1040	1364	1364	1.0000000
C1	36032658	36032976	BolC1t03991H	0	+	290	318	318	1.0000000
C1	36033121	36033421	BolC1t03992H	0	-	251	300	300	1.0000000
C1	36036653	36036827	BolC1t03993H	0	-	44	174	174	1.0000000
C1	36038739	36040005	BolC1t03994H	0	-	9934	1266	1266	1.0000000
C1	36049047	36049341	BolC1t03995H	0	-	72	294	294	1.0000000
C1	36074269	36074554	BolC1t03996H	0	-	45	285	285	1.0000000
C1	36113287	36113422	BolC1t03997H	0	-	0	0	135	0.0000000
C1	36122414	36127930	BolC1t03998H	0	+	267	2490	5516	0.4514141
C1	36128944	36129683	BolC1t03999H	0	-	124	648	739	0.8768606
C1	36142107	36142849	BolC1t04000H	0	-	25	217	742	0.2924528
C1	36162459	36163962	BolC1t04001H	0	+	46	928	1503	0.6174318
C1	36183042	36186197	BolC1t04002H	0	-	479	2299	3155	0.7286846
C1	36210825	36211965	BolC1t04003H	0	-	30	515	1140	0.4517544
C1	36212205	36214870	BolC1t04004H	0	+	4	173	2665	0.0649156
C1	36222279	36223098	BolC1t04005H	0	+	402	819	819	1.0000000
C1	36225084	36226242	BolC1t04006H	0	+	606	935	1158	0.8074266
C1	36226505	36231135	BolC1t04007H	0	-	2964	4577	4630	0.9885529
C1	36240719	36241223	BolC1t04008H	0	-	87	471	504	0.9345238
C1	36246027	36247090	BolC1t04009H	0	-	5	245	1063	0.2304798
C1	36281448	36283205	BolC1t04010H	0	-	818	1757	1757	1.0000000
C1	36283824	36284370	BolC1t04011H	0	-	127	517	546	0.9468864
C1	36298091	36300210	BolC1t04012H	0	-	1050	2000	2119	0.9438415
C1	36306585	36307170	BolC1t04013H	0	-	283	560	585	0.9572650
C1	36315034	36316076	BolC1t04014H	0	+	126	891	1042	0.8550864
C1	36339048	36339297	BolC1t04015H	0	+	6	123	249	0.4939759
C1	36341891	36342152	BolC1t04016H	0	+	0	0	261	0.0000000
C1	36359467	36359989	BolC1t04017H	0	+	56	506	522	0.9693487
C1	36361013	36362218	BolC1t04018H	0	+	516	1205	1205	1.0000000
C1	36362509	36366513	BolC1t04019H	0	-	118	1219	4004	0.3044456
C1	36370919	36373245	BolC1t04020H	0	-	72	1425	2326	0.6126397
C1	36377074	36377463	BolC1t04021H	0	-	105	389	389	1.0000000
C1	36382507	36383703	BolC1t04022H	0	-	41	601	1196	0.5025083
C1	36389155	36391052	BolC1t04023H	0	-	375	1242	1897	0.6547180
C1	36400226	36400831	BolC1t04024H	0	+	51	325	605	0.5371901
C1	36421155	36421788	BolC1t04025H	0	-	93	522	633	0.8246446
C1	36451016	36451244	BolC1t04026H	0	+	449	228	228	1.0000000
C1	36457781	36459026	BolC1t04027H	0	-	1300	1245	1245	1.0000000
C1	36469836	36470013	BolC1t04028H	0	-	161	177	177	1.0000000
C1	36499124	36499329	BolC1t04029H	0	+	84	131	205	0.6390244
C1	36506310	36508025	BolC1t04030H	0	-	1165	1632	1715	0.9516035
C1	36508072	36508741	BolC1t04031H	0	-	421	669	669	1.0000000
C1	36530795	36531296	BolC1t04032H	0	-	36	433	501	0.8642715
C1	36554804	36556149	BolC1t04033H	0	+	476	1345	1345	1.0000000
C1	36556999	36557974	BolC1t04034H	0	-	203	769	975	0.7887179
C1	36576957	36577588	BolC1t04035H	0	-	48	524	631	0.8304279
C1	36592675	36593672	BolC1t04036H	0	-	21	665	997	0.6670010
C1	36603318	36603827	BolC1t04037H	0	+	140	509	509	1.0000000
C1	36610538	36612990	BolC1t04038H	0	-	56	1229	2452	0.5012235
C1	36630939	36632516	BolC1t04039H	0	-	16	439	1577	0.2783767
C1	36667185	36668351	BolC1t04040H	0	+	52	906	1166	0.7770154
C1	36672295	36673151	BolC1t04041H	0	-	85	560	856	0.6542056
C1	36685471	36686077	BolC1t04042H	0	-	4	139	606	0.2293729
C1	36703194	36703712	BolC1t04043H	0	+	43	461	518	0.8899614
C1	36710738	36711373	BolC1t04044H	0	-	400	635	635	1.0000000
C1	36723751	36725272	BolC1t04045H	0	+	1229	1521	1521	1.0000000
C1	36728924	36730046	BolC1t04046H	0	+	35	678	1122	0.6042781
C1	36734757	36753590	BolC1t04047H	0	-	7287	16374	18833	0.8694313
C1	36757070	36757968	BolC1t04048H	0	-	569	898	898	1.0000000
C1	36770040	36774886	BolC1t04049H	0	+	1920	3454	4846	0.7127528
C1	36770198	36770417	BolC1t04050H	0	+	286	219	219	1.0000000
C1	36782672	36783711	BolC1t04051H	0	+	782	1003	1039	0.9653513
C1	36803235	36803484	BolC1t04052H	0	-	219	249	249	1.0000000
C1	36809348	36842063	BolC1t04053H	0	+	18672	25742	32715	0.7868562
C1	36832489	36834314	BolC1t04054H	0	-	1244	1825	1825	1.0000000
C1	36834879	36838005	BolC1t04055H	0	-	69	1416	3126	0.4529750
C1	36835162	36841854	BolC1t04056H	0	+	304	2196	6692	0.3281530
C1	36842616	36842859	BolC1t04057H	0	-	0	0	243	0.0000000
C1	36848149	36848524	BolC1t04058H	0	-	289	375	375	1.0000000
C1	36856797	36856938	BolC1t04059H	0	-	287	141	141	1.0000000
C1	36859524	36859958	BolC1t04060H	0	-	493	434	434	1.0000000
C1	36860060	36860346	BolC1t04061H	0	-	187	286	286	1.0000000
C1	36864488	36867593	BolC1t04062H	0	+	1726	2874	3105	0.9256039
C1	36877884	36878484	BolC1t04063H	0	+	17	301	600	0.5016667
C1	36886375	36886573	BolC1t04064H	0	+	369	198	198	1.0000000
C1	36906561	36907966	BolC1t04065H	0	+	57	623	1405	0.4434164
C1	36909819	36911064	BolC1t04066H	0	-	63	977	1245	0.7847390
C1	36916809	36918819	BolC1t04067H	0	+	48	1078	2010	0.5363184
C1	36918878	36919161	BolC1t04068H	0	+	29	262	283	0.9257951
C1	36919894	36920667	BolC1t04069H	0	+	90	707	773	0.9146184
C1	36946828	36948709	BolC1t04070H	0	-	1196	1881	1881	1.0000000
C1	36996054	36996858	BolC1t04071H	0	-	169	804	804	1.0000000
C1	36997423	36999737	BolC1t04072H	0	-	633	1839	2314	0.7947277
C1	37011834	37012256	BolC1t04073H	0	+	98	422	422	1.0000000
C1	37012899	37013368	BolC1t04074H	0	-	115	469	469	1.0000000
C1	37014974	37016033	BolC1t04075H	0	-	931	1059	1059	1.0000000
C1	37022519	37024482	BolC1t04076H	0	+	424	1694	1963	0.8629649
C1	37046929	37047433	BolC1t04077H	0	+	796	504	504	1.0000000
C1	37065837	37067477	BolC1t04078H	0	+	157	1249	1640	0.7615854
C1	37072256	37072606	BolC1t04079H	0	+	413	350	350	1.0000000
C1	37073140	37081056	BolC1t04080H	0	+	799	3308	7916	0.4178878
C1	37085742	37086439	BolC1t04081H	0	-	896	697	697	1.0000000
C1	37093790	37094673	BolC1t04082H	0	-	831	883	883	1.0000000
C1	37096386	37096756	BolC1t04083H	0	-	147	370	370	1.0000000
C1	37099602	37102653	BolC1t04084H	0	+	215	2095	3051	0.6866601
C1	37103006	37103853	BolC1t04085H	0	-	4	214	847	0.2526564
C1	37107870	37108026	BolC1t04086H	0	-	1	79	156	0.5064102
C1	37114842	37115909	BolC1t04087H	0	-	46	598	1067	0.5604498
C1	37138335	37139653	BolC1t04088H	0	-	802	1272	1318	0.9650986
C1	37156768	37157216	BolC1t04089H	0	+	5	276	448	0.6160714
C1	37157736	37158000	BolC1t04090H	0	-	73	252	264	0.9545454
C1	37171703	37172204	BolC1t04091H	0	-	76	376	501	0.7504990
C1	37173034	37175535	BolC1t04092H	0	+	731	1884	2501	0.7532987
C1	37176342	37177403	BolC1t04093H	0	-	342	1025	1061	0.9660698
C1	37183051	37183501	BolC1t04094H	0	+	44	446	450	0.9911111
C1	37184837	37185830	BolC1t04095H	0	+	286	748	993	0.7532729
C1	37202620	37204490	BolC1t04096H	0	-	518	1590	1870	0.8502674
C1	37230030	37231018	BolC1t04097H	0	-	26	230	988	0.2327935
C1	37231826	37233170	BolC1t04098H	0	-	1465	1344	1344	1.0000000
C1	37235038	37241154	BolC1t04099H	0	+	2310	5930	6116	0.9695880
C1	37277830	37278409	BolC1t04100H	0	+	32	547	579	0.9447323
C1	37288842	37290695	BolC1t04101H	0	+	211	1669	1853	0.9007016
C1	37301828	37304919	BolC1t04102H	0	-	401	1521	3091	0.4920738
C1	37311232	37316570	BolC1t04103H	0	+	1401	2350	5338	0.4402398
C1	37324553	37324928	BolC1t04104H	0	-	162	375	375	1.0000000
C1	37328199	37332038	BolC1t04105H	0	+	5075	3839	3839	1.0000000
C1	37354488	37355760	BolC1t04106H	0	+	139	722	1272	0.5676101
C1	37380837	37380939	BolC1t04107H	0	+	36	102	102	1.0000000
C1	37381722	37382196	BolC1t04108H	0	-	104	318	474	0.6708861
C1	37384663	37384975	BolC1t04109H	0	-	25	293	312	0.9391026
C1	37395318	37400611	BolC1t04110H	0	+	960	4937	5293	0.9327413
C1	37400856	37422907	BolC1t04111H	0	-	9420	21163	22051	0.9597297
C1	37409557	37409968	BolC1t04112H	0	-	390	411	411	1.0000000
C1	37410579	37410953	BolC1t04113H	0	-	188	374	374	1.0000000
C1	37411109	37411493	BolC1t04114H	0	+	43	271	384	0.7057292
C1	37435794	37436106	BolC1t04115H	0	+	487	312	312	1.0000000
C1	37440061	37440641	BolC1t04116H	0	-	542	580	580	1.0000000
C1	37463411	37465096	BolC1t04117H	0	+	429	1370	1685	0.8130564
C1	37469743	37471670	BolC1t04118H	0	-	1614	1927	1927	1.0000000
C1	37471911	37473105	BolC1t04119H	0	-	988	1194	1194	1.0000000
C1	37476160	37476736	BolC1t04120H	0	-	301	576	576	1.0000000
C1	37477712	37478603	BolC1t04121H	0	+	121	781	891	0.8765432
C1	37483602	37484121	BolC1t04122H	0	-	35	360	519	0.6936416
C1	37484480	37485765	BolC1t04123H	0	+	656	1285	1285	1.0000000
C1	37485944	37486758	BolC1t04124H	0	-	535	712	814	0.8746929
C1	37487591	37488266	BolC1t04125H	0	+	74	609	675	0.9022222
C1	37488966	37489293	BolC1t04126H	0	+	13	137	327	0.4189602
C1	37491138	37493976	BolC1t04127H	0	+	457	2802	2838	0.9873150
C1	37498990	37499254	BolC1t04128H	0	+	413	264	264	1.0000000
C1	37499272	37499473	BolC1t04129H	0	+	312	201	201	1.0000000
C1	37505352	37506267	BolC1t04130H	0	+	55	804	915	0.8786885
C1	37513926	37514412	BolC1t04131H	0	+	272	432	486	0.8888889
C1	37515160	37517357	BolC1t04132H	0	-	1054	2153	2197	0.9799727
C1	37526076	37526877	BolC1t04133H	0	-	294	635	801	0.7927591
C1	37557118	37557683	BolC1t04134H	0	-	398	565	565	1.0000000
C1	37563101	37563221	BolC1t04135H	0	-	138	120	120	1.0000000
C1	37574420	37575362	BolC1t04136H	0	-	75	404	942	0.4288747
C1	37575941	37577778	BolC1t04137H	0	-	278	1705	1837	0.9281437
C1	37583336	37584734	BolC1t04138H	0	-	1010	1398	1398	1.0000000
C1	37609675	37610092	BolC1t04139H	0	-	63	139	417	0.3333333
C1	37613871	37614441	BolC1t04140H	0	-	24	208	570	0.3649123
C1	37627605	37630078	BolC1t04141H	0	+	799	2230	2473	0.9017388
C1	37633136	37647548	BolC1t04142H	0	-	365	3302	14412	0.2291146
C1	37646376	37647944	BolC1t04143H	0	-	32	376	1568	0.2397959
C1	37655083	37658523	BolC1t04144H	0	-	44	220	3440	0.0639535
C1	37658594	37658920	BolC1t04145H	0	-	0	0	326	0.0000000
C1	37672946	37677309	BolC1t04146H	0	-	997	3346	4363	0.7669035
C1	37711248	37717061	BolC1t04147H	0	-	1522	3840	5813	0.6605883
C1	37732973	37733195	BolC1t04148H	0	-	192	222	222	1.0000000
C1	37735624	37737265	BolC1t04149H	0	-	346	1310	1641	0.7982937
C1	37737704	37740158	BolC1t04150H	0	-	322	2283	2454	0.9303178
C1	37746588	37747102	BolC1t04151H	0	+	362	514	514	1.0000000
C1	37751169	37752559	BolC1t04152H	0	-	223	456	1390	0.3280576
C1	37754801	37774713	BolC1t04153H	0	+	2617	10368	19912	0.5206910
C1	37778041	37781101	BolC1t04154H	0	-	1484	2561	3060	0.8369281
C1	37782422	37784010	BolC1t04155H	0	-	1232	1588	1588	1.0000000
C1	37793427	37799454	BolC1t04156H	0	-	2797	5189	6027	0.8609590
C1	37810590	37810814	BolC1t04157H	0	+	0	0	224	0.0000000
C1	37812562	37812786	BolC1t04158H	0	+	0	0	224	0.0000000
C1	37815575	37820262	BolC1t04159H	0	+	2249	3922	4687	0.8367826
C1	37823734	37823839	BolC1t04160H	0	+	0	0	105	0.0000000
C1	37826230	37826638	BolC1t04161H	0	+	166	408	408	1.0000000
C1	37828791	37832410	BolC1t04162H	0	-	1543	3407	3619	0.9414203
C1	37833551	37835635	BolC1t04163H	0	+	1068	2059	2084	0.9880038
C1	37835949	37838625	BolC1t04164H	0	-	1043	2587	2676	0.9667414
C1	37841150	37849649	BolC1t04165H	0	+	667	3327	8499	0.3914578
C1	37852031	37854298	BolC1t04166H	0	+	535	1292	2267	0.5699162
C1	37863802	37864995	BolC1t04167H	0	+	426	1193	1193	1.0000000
C1	37890536	37891906	BolC1t04168H	0	-	28	375	1370	0.2737226
C1	37895066	37898088	BolC1t04169H	0	+	275	2544	3022	0.8418266
C1	37901150	37902260	BolC1t04170H	0	-	54	1009	1110	0.9090090
C1	37904538	37904858	BolC1t04171H	0	-	3509	320	320	1.0000000
C1	37919888	37933195	BolC1t04172H	0	+	886	4897	13307	0.3680018
C1	37943189	37943780	BolC1t04173H	0	+	0	0	591	0.0000000
C1	37945774	37946014	BolC1t04174H	0	-	0	0	240	0.0000000
C1	37955864	37957775	BolC1t04175H	0	+	14	577	1911	0.3019361
C1	37965650	37966655	BolC1t04176H	0	+	99	703	1005	0.6995025
C1	37970243	37970996	BolC1t04177H	0	+	295	753	753	1.0000000
C1	37971230	37972699	BolC1t04178H	0	-	1139	1469	1469	1.0000000
C1	37987581	37989929	BolC1t04179H	0	+	774	2192	2348	0.9335605
C1	38011757	38012291	BolC1t04180H	0	+	144	533	534	0.9981273
C1	38026864	38027777	BolC1t04181H	0	-	73	851	913	0.9320920
C1	38040779	38041994	BolC1t04182H	0	+	2	8	1215	0.0065844
C1	38060610	38061663	BolC1t04183H	0	-	74	121	1053	0.1149098
C1	38063615	38065489	BolC1t04184H	0	-	1188	1874	1874	1.0000000
C1	38074156	38074441	BolC1t04185H	0	+	20	243	285	0.8526316
C1	38082511	38082795	BolC1t04186H	0	-	257	284	284	1.0000000
C1	38091301	38091640	BolC1t04187H	0	+	11	112	339	0.3303835
C1	38098688	38100108	BolC1t04188H	0	-	91	672	1420	0.4732394
C1	38101369	38101977	BolC1t04189H	0	+	323	608	608	1.0000000
C1	38102781	38104827	BolC1t04190H	0	+	665	1727	2046	0.8440861
C1	38105276	38105524	BolC1t04191H	0	+	165	248	248	1.0000000
C1	38105946	38109372	BolC1t04192H	0	-	1106	2980	3426	0.8698190
C1	38145909	38146062	BolC1t04193H	0	+	29	153	153	1.0000000
C1	38154810	38156289	BolC1t04194H	0	+	39	578	1479	0.3908046
C1	38157445	38159185	BolC1t04195H	0	-	332	1166	1740	0.6701149
C1	38159822	38160154	BolC1t04196H	0	-	0	0	332	0.0000000
C1	38169440	38169791	BolC1t04197H	0	+	447	351	351	1.0000000
C1	38173091	38174341	BolC1t04198H	0	-	1751	1083	1250	0.8664000
C1	38175277	38177223	BolC1t04199H	0	+	1392	1101	1946	0.5657759
C1	38190876	38192328	BolC1t04200H	0	-	31	587	1452	0.4042700
C1	38219533	38222435	BolC1t04201H	0	-	238	1552	2902	0.5348036
C1	38226949	38227186	BolC1t04202H	0	-	0	0	237	0.0000000
C1	38230834	38231258	BolC1t04203H	0	+	0	0	424	0.0000000
C1	38254314	38255465	BolC1t04204H	0	-	104	889	1151	0.7723718
C1	38257595	38258470	BolC1t04205H	0	-	16	405	875	0.4628572
C1	38291339	38306711	BolC1t04206H	0	-	9442	14873	15372	0.9675384
C1	38327012	38330294	BolC1t04207H	0	-	280	1935	3282	0.5895795
C1	38335544	38343770	BolC1t04208H	0	-	2135	7587	8226	0.9223195
C1	38381001	38381355	BolC1t04209H	0	+	3	26	354	0.0734463
C1	38382430	38383286	BolC1t04210H	0	+	2	141	856	0.1647196
C1	38387850	38388334	BolC1t04211H	0	+	108	465	484	0.9607438
C1	38391495	38391747	BolC1t04212H	0	+	29	208	252	0.8253968
C1	38392802	38398002	BolC1t04213H	0	-	2323	4252	5200	0.8176923
C1	38398128	38398595	BolC1t04214H	0	-	17	231	467	0.4946467
C1	38413685	38416061	BolC1t04215H	0	+	175	1473	2376	0.6199495
C1	38418350	38418767	BolC1t04216H	0	+	3	61	417	0.1462830
C1	38433205	38434699	BolC1t04217H	0	-	1	34	1494	0.0227577
C1	38450461	38450994	BolC1t04218H	0	+	308	533	533	1.0000000
C1	38458742	38459534	BolC1t04219H	0	-	7	145	792	0.1830808
C1	38470031	38470589	BolC1t04220H	0	+	5	205	558	0.3673835
C1	38475555	38476164	BolC1t04221H	0	-	1	142	609	0.2331691
C1	38480450	38481640	BolC1t04222H	0	+	5	198	1190	0.1663866
C1	38488884	38489284	BolC1t04223H	0	+	0	0	400	0.0000000
C1	38499180	38501196	BolC1t04224H	0	-	4	19	2016	0.0094246
C1	38501658	38502948	BolC1t04225H	0	+	478	1283	1290	0.9945737
C1	38503666	38504306	BolC1t04226H	0	+	16	370	640	0.5781250
C1	38506486	38506999	BolC1t04227H	0	-	360	513	513	1.0000000
C1	38535910	38536300	BolC1t04228H	0	+	264	390	390	1.0000000
C1	38559876	38562203	BolC1t04229H	0	+	314	1062	2327	0.4563816
C1	38569393	38571578	BolC1t04230H	0	+	106	588	2185	0.2691076
C1	38584213	38587315	BolC1t04231H	0	-	2176	3102	3102	1.0000000
C1	38592882	38595215	BolC1t04232H	0	+	1225	2333	2333	1.0000000
C1	38640612	38640921	BolC1t04233H	0	+	27	253	309	0.8187702
C1	38657054	38657216	BolC1t04234H	0	-	219	162	162	1.0000000
C1	38659445	38660466	BolC1t04235H	0	+	856	1021	1021	1.0000000
C1	38667659	38669427	BolC1t04236H	0	-	82	913	1768	0.5164027
C1	38709624	38711508	BolC1t04237H	0	+	103	1442	1884	0.7653928
C1	38725678	38725935	BolC1t04238H	0	-	187	257	257	1.0000000
C1	38745261	38745696	BolC1t04239H	0	-	162	418	435	0.9609196
C1	38770445	38772173	BolC1t04240H	0	-	188	264	1728	0.1527778
C1	38812205	38812421	BolC1t04241H	0	+	0	0	216	0.0000000
C1	38815310	38815907	BolC1t04242H	0	-	258	553	597	0.9262981
C1	38823629	38823951	BolC1t04243H	0	-	478	322	322	1.0000000
C1	38824545	38825344	BolC1t04244H	0	-	417	799	799	1.0000000
C1	38852463	38852841	BolC1t04245H	0	+	170	378	378	1.0000000
C1	38852720	38853032	BolC1t04246H	0	-	53	312	312	1.0000000
C1	38853037	38853220	BolC1t04247H	0	+	30	178	183	0.9726776
C1	38857145	38858788	BolC1t04248H	0	+	71	769	1643	0.4680462
C1	38870670	38871795	BolC1t04249H	0	-	67	628	1125	0.5582222
C1	38879763	38882047	BolC1t04250H	0	+	1156	2160	2284	0.9457093
C1	38883234	38883651	BolC1t04251H	0	-	260	417	417	1.0000000
C1	38885950	38886499	BolC1t04252H	0	-	199	439	549	0.7996357
C1	38887803	38889216	BolC1t04253H	0	-	580	1413	1413	1.0000000
C1	38891870	38893772	BolC1t04254H	0	+	149	1307	1902	0.6871714
C1	38894438	38900264	BolC1t04255H	0	-	2210	5367	5826	0.9212152
C1	38901234	38915885	BolC1t04256H	0	-	1688	4707	14651	0.3212750
C1	38918085	38920387	BolC1t04257H	0	+	2516	2281	2302	0.9908775
C1	38920830	38922583	BolC1t04258H	0	-	1240	1753	1753	1.0000000
C1	38923032	38925124	BolC1t04259H	0	+	1196	2092	2092	1.0000000
C1	38925961	38928359	BolC1t04260H	0	-	1054	2254	2398	0.9399499
C1	38936892	38937123	BolC1t04261H	0	+	358	231	231	1.0000000
C1	38939352	38939795	BolC1t04262H	0	-	312	443	443	1.0000000
C1	38945336	38945714	BolC1t04263H	0	+	0	0	378	0.0000000
C1	38946849	38950133	BolC1t04264H	0	-	40	1836	3284	0.5590743
C1	38952255	38953770	BolC1t04265H	0	+	1034	1515	1515	1.0000000
C1	38962307	38965400	BolC1t04266H	0	+	1952	3016	3093	0.9751050
C1	38965820	38968221	BolC1t04267H	0	-	940	2370	2401	0.9870887
C1	38968612	38968978	BolC1t04268H	0	+	194	365	366	0.9972678
C1	38981384	38982587	BolC1t04269H	0	-	0	0	1203	0.0000000
C1	38988020	38988437	BolC1t04270H	0	+	89	417	417	1.0000000
C1	38992298	38992427	BolC1t04271H	0	-	45	129	129	1.0000000
C1	39005667	39052242	BolC1t04272H	0	-	5162	22111	46575	0.4747397
C1	39022276	39023112	BolC1t04273H	0	-	0	0	836	0.0000000
C1	39036439	39038046	BolC1t04274H	0	-	605	1443	1607	0.8979465
C1	39038811	39041169	BolC1t04275H	0	-	773	2323	2358	0.9851569
C1	39053781	39053979	BolC1t04276H	0	-	23	198	198	1.0000000
C1	39054126	39054751	BolC1t04277H	0	-	48	538	625	0.8608000
C1	39062334	39062846	BolC1t04278H	0	-	68	473	512	0.9238281
C1	39063364	39063676	BolC1t04279H	0	+	15	312	312	1.0000000
C1	39066492	39066963	BolC1t04280H	0	-	0	0	471	0.0000000
C1	39067028	39067349	BolC1t04281H	0	-	12	268	321	0.8348910
C1	39071747	39072972	BolC1t04282H	0	-	50	796	1225	0.6497959
C1	39103314	39104081	BolC1t04283H	0	-	24	449	767	0.5853977
C1	39110985	39112169	BolC1t04284H	0	+	211	1048	1184	0.8851351
C1	39123712	39124536	BolC1t04285H	0	+	1165	824	824	1.0000000
C1	39149937	39150621	BolC1t04286H	0	+	31	531	684	0.7763158
C1	39155268	39156025	BolC1t04287H	0	-	125	757	757	1.0000000
C1	39156813	39157858	BolC1t04288H	0	-	1298	1045	1045	1.0000000
C1	39267246	39268471	BolC1t04289H	0	-	169	727	1225	0.5934694
C1	39268998	39269166	BolC1t04290H	0	+	5	34	168	0.2023810
C1	39274391	39275530	BolC1t04291H	0	+	35	459	1139	0.4029851
C1	39284244	39286387	BolC1t04292H	0	+	19	771	2143	0.3597760
C1	39286521	39287154	BolC1t04293H	0	+	0	0	633	0.0000000
C1	39306660	39308754	BolC1t04294H	0	+	300	1961	2094	0.9364852
C1	39323201	39323396	BolC1t04295H	0	+	17	185	195	0.9487180
C1	39330030	39330619	BolC1t04296H	0	-	762	589	589	1.0000000
C1	39346633	39349316	BolC1t04297H	0	-	71	1350	2683	0.5031681
C1	39364593	39364812	BolC1t04298H	0	-	8	33	219	0.1506849
C1	39380546	39385597	BolC1t04299H	0	+	4891	4408	5051	0.8726985
C1	39414060	39415158	BolC1t04300H	0	-	71	701	1098	0.6384335
C1	39420436	39420559	BolC1t04301H	0	+	65	123	123	1.0000000
C1	39422640	39424108	BolC1t04302H	0	-	1068	1468	1468	1.0000000
C1	39426402	39428220	BolC1t04303H	0	+	995	1818	1818	1.0000000
C1	39444704	39444815	BolC1t04304H	0	+	216	111	111	1.0000000
C1	39445352	39445544	BolC1t04305H	0	+	42	192	192	1.0000000
C1	39451371	39451635	BolC1t04306H	0	-	39	264	264	1.0000000
C1	39452697	39452945	BolC1t04307H	0	+	94	248	248	1.0000000
C1	39457140	39458468	BolC1t04308H	0	-	817	1328	1328	1.0000000
C1	39461393	39461615	BolC1t04309H	0	+	4	53	222	0.2387387
C1	39482705	39485168	BolC1t04310H	0	+	2309	2463	2463	1.0000000
C1	39485374	39487164	BolC1t04311H	0	-	429	1510	1790	0.8435754
C1	39487468	39494658	BolC1t04312H	0	-	3493	6922	7190	0.9627260
C1	39508470	39508662	BolC1t04313H	0	+	163	192	192	1.0000000
C1	39509528	39515026	BolC1t04314H	0	+	3689	5498	5498	1.0000000
C1	39525888	39526887	BolC1t04315H	0	+	616	999	999	1.0000000
C1	39527736	39528219	BolC1t04316H	0	-	278	483	483	1.0000000
C1	39533357	39535719	BolC1t04317H	0	+	1979	2362	2362	1.0000000
C1	39538795	39548352	BolC1t04318H	0	-	4572	8772	9557	0.9178613
C1	39558967	39561572	BolC1t04319H	0	-	2353	2605	2605	1.0000000
C1	39580318	39582695	BolC1t04320H	0	+	478	1930	2377	0.8119478
C1	39629560	39630199	BolC1t04321H	0	-	101	448	639	0.7010955
C1	39631570	39635412	BolC1t04322H	0	+	1156	3762	3842	0.9791775
C1	39636121	39636739	BolC1t04323H	0	-	197	580	618	0.9385113
C1	39649820	39651274	BolC1t04324H	0	-	142	914	1454	0.6286107
C1	39653219	39653666	BolC1t04325H	0	-	478	447	447	1.0000000
C1	39675437	39675699	BolC1t04326H	0	+	264	262	262	1.0000000
C1	39676851	39682876	BolC1t04327H	0	-	3593	6025	6025	1.0000000
C1	39687635	39688166	BolC1t04328H	0	-	140	531	531	1.0000000
C1	39693184	39693418	BolC1t04329H	0	-	235	234	234	1.0000000
C1	39718519	39719239	BolC1t04330H	0	+	328	720	720	1.0000000
C1	39720267	39720519	BolC1t04331H	0	-	75	252	252	1.0000000
C1	39730181	39731427	BolC1t04332H	0	+	343	1133	1246	0.9093098
C1	39732297	39736661	BolC1t04333H	0	-	1093	3331	4364	0.7632906
C1	39764243	39764570	BolC1t04334H	0	+	38	266	327	0.8134556
C1	39765304	39769072	BolC1t04335H	0	+	1580	3426	3768	0.9092357
C1	39769889	39770561	BolC1t04336H	0	+	11	312	672	0.4642857
C1	39775792	39775909	BolC1t04337H	0	-	0	0	117	0.0000000
C1	39797248	39799269	BolC1t04338H	0	+	566	1408	2021	0.6966848
C1	39825719	39829071	BolC1t04339H	0	+	885	2091	3352	0.6238067
C1	39835133	39837044	BolC1t04340H	0	-	144	1055	1911	0.5520670
C1	39837043	39837505	BolC1t04341H	0	-	141	462	462	1.0000000
C1	39838267	39838727	BolC1t04342H	0	+	8	147	460	0.3195652
C1	39839707	39839866	BolC1t04343H	0	-	105	159	159	1.0000000
C1	39866255	39867010	BolC1t04344H	0	-	453	755	755	1.0000000
C1	39868450	39869250	BolC1t04345H	0	-	2582	800	800	1.0000000
C1	39869277	39869992	BolC1t04346H	0	-	1785	702	715	0.9818182
C1	39869574	39873592	BolC1t04347H	0	+	6088	3290	4018	0.8188154
C1	39872281	39872974	BolC1t04348H	0	-	17	335	693	0.4834055
C1	39873193	39873754	BolC1t04349H	0	-	2470	561	561	1.0000000
C1	39875640	39881788	BolC1t04350H	0	-	868	4011	6148	0.6524073
C1	39883227	39883984	BolC1t04351H	0	-	352	735	757	0.9709379
C1	39885425	39890465	BolC1t04352H	0	-	4881	4129	5040	0.8192461
C1	39894630	39895577	BolC1t04353H	0	-	0	0	947	0.0000000
C1	39897330	39898125	BolC1t04354H	0	-	639	795	795	1.0000000
C1	39905814	39906356	BolC1t04355H	0	+	9	403	542	0.7435424
C1	39917276	39917863	BolC1t04356H	0	+	0	0	587	0.0000000
C1	39924432	39926818	BolC1t04357H	0	-	658	2386	2386	1.0000000
C1	39929368	39932105	BolC1t04358H	0	+	1551	1615	2737	0.5900621
C1	39932925	39933495	BolC1t04359H	0	-	260	570	570	1.0000000
C1	39944449	39947699	BolC1t04360H	0	-	1416	2735	3250	0.8415385
C1	39950126	39950879	BolC1t04361H	0	-	106	388	753	0.5152723
C1	39956788	39957058	BolC1t04362H	0	+	64	270	270	1.0000000
C1	39965465	39966521	BolC1t04363H	0	+	115	846	1056	0.8011364
C1	39972615	39974226	BolC1t04364H	0	-	137	967	1611	0.6002483
C1	39986554	39987834	BolC1t04365H	0	+	685	1273	1280	0.9945313
C1	39988307	39992373	BolC1t04366H	0	+	1528	4005	4066	0.9849975
C1	39992172	40009293	BolC1t04367H	0	+	2311	10649	17121	0.6219847
C1	39992433	40007465	BolC1t04368H	0	+	1672	8606	15032	0.5725120
C1	40015862	40019023	BolC1t04369H	0	+	826	2378	3161	0.7522936
C1	40019227	40028547	BolC1t04370H	0	-	4241	5830	9320	0.6255365
C1	40028600	40031347	BolC1t04371H	0	-	3177	2747	2747	1.0000000
C1	40032761	40034951	BolC1t04372H	0	-	1558	1929	2190	0.8808219
C1	40045072	40046994	BolC1t04373H	0	-	1031	1871	1922	0.9734651
C1	40055728	40058333	BolC1t04374H	0	-	1604	2605	2605	1.0000000
C1	40060653	40061619	BolC1t04375H	0	-	179	933	966	0.9658385
C1	40065655	40066123	BolC1t04376H	0	-	477	468	468	1.0000000
C1	40066074	40067539	BolC1t04377H	0	-	589	1117	1465	0.7624573
C1	40067952	40068273	BolC1t04378H	0	-	50	321	321	1.0000000
C1	40072817	40074086	BolC1t04379H	0	+	1020	1167	1269	0.9196218
C1	40117977	40118944	BolC1t04380H	0	+	621	967	967	1.0000000
C1	40143091	40145208	BolC1t04381H	0	+	2170	2078	2117	0.9815777
C1	40146691	40148513	BolC1t04382H	0	-	52	587	1822	0.3221734
C1	40152907	40153840	BolC1t04383H	0	-	514	933	933	1.0000000
C1	40154043	40156705	BolC1t04384H	0	-	1435	2486	2662	0.9338843
C1	40159944	40161529	BolC1t04385H	0	+	1268	1585	1585	1.0000000
C1	40162822	40165817	BolC1t04386H	0	+	1325	2337	2995	0.7803005
C1	40167866	40168942	BolC1t04387H	0	+	864	1076	1076	1.0000000
C1	40179938	40180644	BolC1t04388H	0	-	717	706	706	1.0000000
C1	40182681	40183395	BolC1t04389H	0	-	22	682	714	0.9551821
C1	40206733	40206910	BolC1t04390H	0	-	59	177	177	1.0000000
C1	40227791	40227977	BolC1t04391H	0	-	196	186	186	1.0000000
C1	40232764	40234039	BolC1t04392H	0	+	825	1275	1275	1.0000000
C1	40234710	40238496	BolC1t04393H	0	-	1114	3356	3786	0.8864236
C1	40239465	40251043	BolC1t04394H	0	-	3761	10427	11578	0.9005873
C1	40275073	40277906	BolC1t04395H	0	+	970	2336	2833	0.8245676
C1	40297664	40298209	BolC1t04396H	0	+	515	545	545	1.0000000
C1	40298263	40298766	BolC1t04397H	0	+	485	503	503	1.0000000
C1	40298828	40300731	BolC1t04398H	0	+	1210	1903	1903	1.0000000
C1	40306913	40308948	BolC1t04399H	0	+	154	1215	2035	0.5970516
C1	40309816	40311066	BolC1t04400H	0	-	265	822	1250	0.6576000
C1	40311897	40314149	BolC1t04401H	0	-	1327	2241	2252	0.9951155
C1	40314753	40321088	BolC1t04402H	0	+	2188	5718	6335	0.9026046
C1	40322128	40326649	BolC1t04403H	0	+	429	1941	4521	0.4293298
C1	40336885	40338171	BolC1t04404H	0	-	743	1286	1286	1.0000000
C1	40348583	40348892	BolC1t04405H	0	-	27	254	309	0.8220065
C1	40363807	40370178	BolC1t04406H	0	+	4614	6366	6371	0.9992152
C1	40370733	40373737	BolC1t04407H	0	-	819	1728	3004	0.5752330
C1	40375033	40376437	BolC1t04408H	0	-	172	1164	1404	0.8290598
C1	40379513	40379986	BolC1t04409H	0	-	443	473	473	1.0000000
C1	40381308	40382583	BolC1t04410H	0	-	266	1079	1275	0.8462745
C1	40389129	40389450	BolC1t04411H	0	+	162	321	321	1.0000000
C1	40399389	40399533	BolC1t04412H	0	+	334	144	144	1.0000000
C1	40400828	40402883	BolC1t04413H	0	-	983	2035	2055	0.9902676
C1	40403669	40407166	BolC1t04414H	0	-	2349	3497	3497	1.0000000
C1	40408321	40408624	BolC1t04415H	0	+	180	284	303	0.9372937
C1	40417559	40417718	BolC1t04416H	0	-	4	12	159	0.0754717
C1	40424027	40424918	BolC1t04417H	0	+	1358	891	891	1.0000000
C1	40425294	40427752	BolC1t04418H	0	-	2158	2391	2458	0.9727421
C1	40433730	40434516	BolC1t04419H	0	+	73	737	786	0.9376590
C1	40436936	40439899	BolC1t04420H	0	-	905	2518	2963	0.8498144
C1	40445223	40447092	BolC1t04421H	0	+	390	1601	1869	0.8566078
C1	40452491	40453151	BolC1t04422H	0	+	452	660	660	1.0000000
C1	40464034	40465030	BolC1t04423H	0	-	853	996	996	1.0000000
C1	40506903	40507303	BolC1t04424H	0	-	502	400	400	1.0000000
C1	40507866	40508067	BolC1t04425H	0	-	134	201	201	1.0000000
C1	40517409	40519029	BolC1t04426H	0	-	219	1197	1620	0.7388889
C1	40521066	40522155	BolC1t04427H	0	-	432	1089	1089	1.0000000
C1	40523312	40523543	BolC1t04428H	0	-	73	231	231	1.0000000
C1	40527450	40528329	BolC1t04429H	0	-	913	879	879	1.0000000
C1	40530471	40533166	BolC1t04430H	0	+	997	2571	2695	0.9539889
C1	40533673	40533994	BolC1t04431H	0	+	319	321	321	1.0000000
C1	40535598	40537261	BolC1t04432H	0	+	248	1429	1663	0.8592904
C1	40540203	40543997	BolC1t04433H	0	+	3301	3794	3794	1.0000000
C1	40548067	40548178	BolC1t04434H	0	+	0	0	111	0.0000000
C1	40548074	40548212	BolC1t04435H	0	-	0	0	138	0.0000000
C1	40552760	40555010	BolC1t04436H	0	+	540	1836	2250	0.8160000
C1	40557785	40560931	BolC1t04437H	0	-	1179	3085	3146	0.9806103
C1	40562155	40562937	BolC1t04438H	0	-	17	461	782	0.5895141
C1	40574846	40576616	BolC1t04439H	0	-	254	1580	1770	0.8926554
C1	40578911	40580336	BolC1t04440H	0	+	1693	1425	1425	1.0000000
C1	40611821	40613233	BolC1t04441H	0	-	1345	1294	1412	0.9164306
C1	40632231	40634103	BolC1t04442H	0	-	330	1848	1872	0.9871795
C1	40661987	40663241	BolC1t04443H	0	+	144	1138	1254	0.9074960
C1	40664487	40665674	BolC1t04444H	0	-	785	1121	1187	0.9443976
C1	40676659	40677082	BolC1t04445H	0	-	1011	423	423	1.0000000
C1	40677873	40679668	BolC1t04446H	0	-	3269	1795	1795	1.0000000
C1	40681216	40681636	BolC1t04447H	0	-	1174	420	420	1.0000000
C1	40681945	40686593	BolC1t04448H	0	-	618	2287	4648	0.4920396
C1	40700412	40700681	BolC1t04449H	0	-	42	168	269	0.6245353
C1	40700807	40701235	BolC1t04450H	0	-	60	354	428	0.8271028
C1	40711219	40712728	BolC1t04451H	0	-	528	1490	1509	0.9874089
C1	40719475	40720986	BolC1t04452H	0	+	1789	1511	1511	1.0000000
C1	40721407	40722451	BolC1t04453H	0	-	495	1044	1044	1.0000000
C1	40723918	40726971	BolC1t04454H	0	+	1337	3029	3053	0.9921389
C1	40738504	40744769	BolC1t04455H	0	+	2679	6076	6265	0.9698324
C1	40761111	40762613	BolC1t04456H	0	+	595	1233	1502	0.8209054
C1	40763634	40771711	BolC1t04457H	0	+	3041	7367	8077	0.9120961
C1	40772228	40775199	BolC1t04458H	0	-	998	2575	2971	0.8667116
C1	40799846	40800572	BolC1t04459H	0	-	490	726	726	1.0000000
C1	40801554	40802055	BolC1t04460H	0	+	224	501	501	1.0000000
C1	40822103	40822381	BolC1t04461H	0	+	191	278	278	1.0000000
C1	40825284	40825626	BolC1t04462H	0	-	382	342	342	1.0000000
C1	40825801	40826526	BolC1t04463H	0	-	327	650	725	0.8965517
C1	40845168	40845582	BolC1t04464H	0	+	240	414	414	1.0000000
C1	40846048	40846808	BolC1t04465H	0	-	265	760	760	1.0000000
C1	40854262	40855178	BolC1t04466H	0	-	1294	916	916	1.0000000
C1	40866035	40873862	BolC1t04467H	0	+	1217	5154	7827	0.6584898
C1	40888062	40888245	BolC1t04468H	0	+	150	183	183	1.0000000
C1	40910079	40912620	BolC1t04469H	0	+	441	2090	2541	0.8225108
C1	40920001	40920151	BolC1t04470H	0	+	237	150	150	1.0000000
C1	40924716	40927381	BolC1t04471H	0	+	606	2484	2665	0.9320825
C1	40934403	40935792	BolC1t04472H	0	-	183	642	1389	0.4622030
C1	40954860	40955892	BolC1t04473H	0	-	463	985	1032	0.9544573
C1	40967302	40967566	BolC1t04474H	0	-	26	209	264	0.7916667
C1	40968761	40969076	BolC1t04475H	0	+	36	315	315	1.0000000
C1	40972281	40973373	BolC1t04476H	0	-	4	19	1092	0.0173993
C1	41038649	41038883	BolC1t04477H	0	-	0	0	234	0.0000000
C1	41042394	41044679	BolC1t04478H	0	-	1	47	2285	0.0205689
C1	41044802	41045570	BolC1t04479H	0	-	79	234	768	0.3046875
C1	41057438	41058992	BolC1t04480H	0	-	167	1222	1554	0.7863578
C1	41074187	41074697	BolC1t04481H	0	-	375	510	510	1.0000000
C1	41080471	41082382	BolC1t04482H	0	-	347	1672	1911	0.8749346
C1	41097466	41099048	BolC1t04483H	0	-	969	1582	1582	1.0000000
C1	41100808	41101339	BolC1t04484H	0	-	163	531	531	1.0000000
C1	41104066	41104885	BolC1t04485H	0	+	1042	819	819	1.0000000
C1	41108205	41108547	BolC1t04486H	0	+	147	342	342	1.0000000
C1	41117220	41117481	BolC1t04487H	0	-	244	261	261	1.0000000
C1	41119328	41120036	BolC1t04488H	0	-	531	708	708	1.0000000
C1	41127799	41128137	BolC1t04489H	0	+	12	200	338	0.5917160
C1	41133643	41134845	BolC1t04490H	0	+	208	1146	1202	0.9534110
C1	41136279	41137739	BolC1t04491H	0	-	999	1460	1460	1.0000000
C1	41138017	41138563	BolC1t04492H	0	-	530	546	546	1.0000000
C1	41153166	41153971	BolC1t04493H	0	-	146	488	805	0.6062112
C1	41157137	41160044	BolC1t04494H	0	+	828	2044	2907	0.7031304
C1	41170715	41172280	BolC1t04495H	0	+	64	1281	1565	0.8185304
C1	41174919	41175138	BolC1t04496H	0	-	27	219	219	1.0000000
C1	41179231	41179666	BolC1t04497H	0	-	0	0	435	0.0000000
C1	41184607	41186230	BolC1t04498H	0	-	570	1392	1623	0.8576710
C1	41186913	41190108	BolC1t04499H	0	+	1783	2857	3195	0.8942097
C1	41191255	41191561	BolC1t04500H	0	-	446	306	306	1.0000000
C1	41192419	41192768	BolC1t04501H	0	+	233	349	349	1.0000000
C1	41199094	41200468	BolC1t04502H	0	-	164	1136	1374	0.8267831
C1	41215507	41216182	BolC1t04503H	0	-	131	669	675	0.9911111
C1	41220109	41220739	BolC1t04504H	0	-	171	594	630	0.9428571
C1	41235862	41236045	BolC1t04505H	0	-	0	0	183	0.0000000
C1	41236326	41237891	BolC1t04506H	0	-	18	507	1565	0.3239617
C1	41255733	41256192	BolC1t04507H	0	-	188	459	459	1.0000000
C1	41258050	41258364	BolC1t04508H	0	-	126	314	314	1.0000000
C1	41258684	41258972	BolC1t04509H	0	-	63	288	288	1.0000000
C1	41259340	41259837	BolC1t04510H	0	-	444	497	497	1.0000000
C1	41264189	41266134	BolC1t04511H	0	+	299	1809	1945	0.9300771
C1	41267612	41269923	BolC1t04512H	0	+	507	1716	2311	0.7425357
C1	41270422	41270988	BolC1t04513H	0	-	274	566	566	1.0000000
C1	41281535	41281817	BolC1t04514H	0	-	205	282	282	1.0000000
C1	41300547	41301822	BolC1t04515H	0	-	1387	1275	1275	1.0000000
C1	41303559	41303781	BolC1t04516H	0	+	144	222	222	1.0000000
C1	41305348	41310465	BolC1t04517H	0	+	2012	5043	5117	0.9855384
C1	41323010	41323664	BolC1t04518H	0	+	114	598	654	0.9143731
C1	41345807	41348950	BolC1t04519H	0	+	754	2646	3143	0.8418708
C1	41362771	41363806	BolC1t04520H	0	+	246	936	1035	0.9043478
C1	41365132	41367297	BolC1t04521H	0	+	2311	2140	2165	0.9884527
C1	41367821	41369358	BolC1t04522H	0	+	862	1494	1537	0.9720234
C1	41370588	41373817	BolC1t04523H	0	+	954	2691	3229	0.8333849
C1	41374196	41374666	BolC1t04524H	0	-	264	470	470	1.0000000
C1	41391401	41393810	BolC1t04525H	0	-	1740	1614	2409	0.6699876
C1	41394075	41395049	BolC1t04526H	0	+	635	971	974	0.9969199
C1	41395362	41395857	BolC1t04527H	0	+	330	495	495	1.0000000
C1	41407150	41407735	BolC1t04528H	0	-	18	142	585	0.2427350
C1	41421352	41421598	BolC1t04529H	0	-	142	246	246	1.0000000
C1	41431339	41433058	BolC1t04530H	0	-	81	570	1719	0.3315881
C1	41455349	41456545	BolC1t04531H	0	-	1542	1196	1196	1.0000000
C1	41458386	41458545	BolC1t04532H	0	-	36	157	159	0.9874214
C1	41465557	41467290	BolC1t04533H	0	-	15	80	1733	0.0461627
C1	41467424	41467719	BolC1t04534H	0	-	184	295	295	1.0000000
C1	41475579	41475795	BolC1t04535H	0	+	0	0	216	0.0000000
C1	41477420	41478926	BolC1t04536H	0	+	220	868	1506	0.5763612
C1	41501084	41508445	BolC1t04537H	0	-	3618	6575	7361	0.8932210
C1	41509136	41509367	BolC1t04538H	0	-	60	220	231	0.9523810
C1	41509644	41509884	BolC1t04539H	0	+	82	240	240	1.0000000
C1	41510929	41511321	BolC1t04540H	0	-	163	323	392	0.8239796
C1	41545822	41547722	BolC1t04541H	0	+	362	1766	1900	0.9294737
C1	41560937	41563026	BolC1t04542H	0	+	129	1105	2089	0.5289612
C1	41563590	41565473	BolC1t04543H	0	-	378	1475	1883	0.7833245
C1	41565523	41566044	BolC1t04544H	0	-	14	325	521	0.6238004
C1	41569688	41571059	BolC1t04545H	0	-	552	1337	1371	0.9752006
C1	41571409	41573505	BolC1t04546H	0	+	1196	1947	2096	0.9289122
C1	41574699	41575542	BolC1t04547H	0	+	274	798	843	0.9466192
C1	41578973	41581991	BolC1t04548H	0	-	1507	3018	3018	1.0000000
C1	41584229	41584454	BolC1t04549H	0	-	184	225	225	1.0000000
C1	41586999	41592428	BolC1t04550H	0	-	2148	3473	5429	0.6397126
C1	41596009	41596279	BolC1t04551H	0	-	371	270	270	1.0000000
C1	41604270	41605283	BolC1t04552H	0	-	154	966	1013	0.9536031
C1	41621277	41622119	BolC1t04553H	0	-	75	652	842	0.7743468
C1	41622537	41623907	BolC1t04554H	0	+	197	685	1370	0.5000000
C1	41624573	41626098	BolC1t04555H	0	-	892	1262	1525	0.8275410
C1	41639212	41640348	BolC1t04556H	0	+	2	52	1136	0.0457746
C1	41648652	41649189	BolC1t04557H	0	+	151	512	537	0.9534451
C1	41649967	41651005	BolC1t04558H	0	+	241	953	1038	0.9181117
C1	41651640	41651757	BolC1t04559H	0	+	42	117	117	1.0000000
C1	41653980	41654205	BolC1t04560H	0	+	4	103	225	0.4577778
C1	41655517	41657942	BolC1t04561H	0	-	790	1946	2425	0.8024742
C1	41677399	41678114	BolC1t04562H	0	+	338	715	715	1.0000000
C1	41706710	41708168	BolC1t04563H	0	-	657	1458	1458	1.0000000
C1	41710143	41711762	BolC1t04564H	0	+	499	1599	1619	0.9876467
C1	41712338	41713943	BolC1t04565H	0	-	274	1518	1605	0.9457944
C1	41719656	41721452	BolC1t04566H	0	-	608	1787	1796	0.9949889
C1	41739464	41739780	BolC1t04567H	0	-	21	91	316	0.2879747
C1	41740420	41744670	BolC1t04568H	0	-	1253	3877	4250	0.9122353
C1	41745441	41747749	BolC1t04569H	0	-	395	1076	2308	0.4662045
C1	41768112	41772564	BolC1t04570H	0	-	1232	2480	4452	0.5570530
C1	41777401	41778577	BolC1t04571H	0	+	150	1166	1176	0.9914966
C1	41778910	41779698	BolC1t04572H	0	-	218	788	788	1.0000000
C1	41781247	41781807	BolC1t04573H	0	+	1	3	560	0.0053571
C1	41787535	41790161	BolC1t04574H	0	-	373	1859	2626	0.7079208
C1	41812452	41814945	BolC1t04575H	0	-	541	2354	2493	0.9442439
C1	41815464	41815665	BolC1t04576H	0	+	415	201	201	1.0000000
C1	41816602	41817220	BolC1t04577H	0	-	10	154	618	0.2491909
C1	41820693	41822799	BolC1t04578H	0	+	857	2074	2106	0.9848053
C1	41830016	41837009	BolC1t04579H	0	+	1076	3331	6993	0.4763335
C1	41831281	41831940	BolC1t04580H	0	-	280	659	659	1.0000000
C1	41837047	41837832	BolC1t04581H	0	+	455	734	785	0.9350318
C1	41838293	41839193	BolC1t04582H	0	-	175	680	900	0.7555556
C1	41896895	41898564	BolC1t04583H	0	+	454	1590	1669	0.9526663
C1	41899741	41900872	BolC1t04584H	0	+	396	1131	1131	1.0000000
C1	41902058	41904002	BolC1t04585H	0	-	1077	1938	1944	0.9969136
C1	41906507	41910113	BolC1t04586H	0	-	1217	3568	3606	0.9894620
C1	41912128	41915400	BolC1t04587H	0	-	324	2194	3272	0.6705379
C1	41917350	41917548	BolC1t04588H	0	+	133	198	198	1.0000000
C1	41917928	41918624	BolC1t04589H	0	+	491	696	696	1.0000000
C1	41924008	41924381	BolC1t04590H	0	-	56	373	373	1.0000000
C1	41930873	41931416	BolC1t04591H	0	+	76	501	543	0.9226519
C1	41937222	41937792	BolC1t04592H	0	-	0	0	570	0.0000000
C1	41951361	41951815	BolC1t04593H	0	-	0	0	454	0.0000000
C1	41971742	41972196	BolC1t04594H	0	+	0	0	454	0.0000000
C1	41985724	41986294	BolC1t04595H	0	+	0	0	570	0.0000000
C1	42022734	42025058	BolC1t04596H	0	+	84	443	2324	0.1906196
C1	42029650	42035274	BolC1t04597H	0	+	876	3505	5624	0.6232219
C1	42037546	42039742	BolC1t04598H	0	-	312	1845	2196	0.8401639
C1	42055195	42057230	BolC1t04599H	0	-	700	2004	2035	0.9847666
C1	42063104	42064858	BolC1t04600H	0	-	380	1682	1754	0.9589510
C1	42065959	42067212	BolC1t04601H	0	-	193	1229	1253	0.9808460
C1	42082200	42083355	BolC1t04602H	0	-	757	1155	1155	1.0000000
C1	42085923	42087874	BolC1t04603H	0	+	296	1547	1951	0.7929267
C1	42099329	42099814	BolC1t04604H	0	-	532	485	485	1.0000000
C1	42101498	42101989	BolC1t04605H	0	+	496	491	491	1.0000000
C1	42138798	42139770	BolC1t04606H	0	+	563	972	972	1.0000000
C1	42148551	42148824	BolC1t04607H	0	-	236	273	273	1.0000000
C1	42149415	42149529	BolC1t04608H	0	+	108	114	114	1.0000000
C1	42178283	42179420	BolC1t04609H	0	+	81	271	1137	0.2383465
C1	42183067	42183421	BolC1t04610H	0	+	10	109	354	0.3079096
C1	42188476	42189010	BolC1t04611H	0	+	136	482	534	0.9026217
C1	42195143	42195335	BolC1t04612H	0	+	0	0	192	0.0000000
C1	42211052	42212543	BolC1t04613H	0	+	434	1247	1491	0.8363515
C1	42223675	42224327	BolC1t04614H	0	-	391	652	652	1.0000000
C1	42231576	42234922	BolC1t04615H	0	+	2130	2040	3346	0.6096832
C1	42245855	42246570	BolC1t04616H	0	+	424	715	715	1.0000000
C1	42247456	42250654	BolC1t04617H	0	-	626	2659	3198	0.8314571
C1	42253439	42260980	BolC1t04618H	0	+	2942	7541	7541	1.0000000
C1	42261679	42266959	BolC1t04619H	0	-	4106	5280	5280	1.0000000
C1	42285534	42286503	BolC1t04620H	0	+	544	969	969	1.0000000
C1	42307179	42312324	BolC1t04621H	0	-	1878	4590	5145	0.8921283
C1	42335758	42339135	BolC1t04622H	0	-	1265	2674	3377	0.7918271
C1	42344431	42345789	BolC1t04623H	0	-	265	523	1358	0.3851252
C1	42349011	42356920	BolC1t04624H	0	-	2143	7355	7909	0.9299532
C1	42362896	42363130	BolC1t04625H	0	-	123	234	234	1.0000000
C1	42363190	42363412	BolC1t04626H	0	-	65	222	222	1.0000000
C1	42363924	42364818	BolC1t04627H	0	+	630	894	894	1.0000000
C1	42368636	42372852	BolC1t04628H	0	-	1392	4109	4216	0.9746205
C1	42373926	42374127	BolC1t04629H	0	+	122	201	201	1.0000000
C1	42374695	42375504	BolC1t04630H	0	-	1411	809	809	1.0000000
C1	42382029	42384714	BolC1t04631H	0	-	1339	2529	2685	0.9418994
C1	42385393	42386058	BolC1t04632H	0	-	49	376	665	0.5654135
C1	42396599	42397036	BolC1t04633H	0	-	171	437	437	1.0000000
C1	42399972	42403205	BolC1t04634H	0	+	744	3024	3233	0.9353542
C1	42403852	42404465	BolC1t04635H	0	+	305	613	613	1.0000000
C1	42406963	42407355	BolC1t04636H	0	+	0	0	392	0.0000000
C1	42461100	42462050	BolC1t04637H	0	-	1084	950	950	1.0000000
C1	42466388	42468467	BolC1t04638H	0	-	0	0	2079	0.0000000
C1	42470445	42471765	BolC1t04639H	0	+	526	1320	1320	1.0000000
C1	42472116	42472632	BolC1t04640H	0	+	6	219	516	0.4244186
C1	42473479	42474520	BolC1t04641H	0	-	233	1033	1041	0.9923151
C1	42492557	42535771	BolC1t04642H	0	+	2615	7349	43214	0.1700606
C1	42537655	42538287	BolC1t04643H	0	-	58	547	632	0.8655064
C1	42552126	42553983	BolC1t04644H	0	+	308	1134	1857	0.6106623
C1	42554834	42555862	BolC1t04645H	0	-	173	1028	1028	1.0000000
C1	42567613	42568713	BolC1t04646H	0	-	341	1072	1100	0.9745455
C1	42571983	42574634	BolC1t04647H	0	+	72	870	2651	0.3281780
C1	42578412	42578866	BolC1t04648H	0	-	11	183	454	0.4030837
C1	42589026	42589739	BolC1t04649H	0	+	8	190	713	0.2664797
C1	42589918	42590050	BolC1t04650H	0	+	3	30	132	0.2272727
C1	42592115	42592652	BolC1t04651H	0	+	492	537	537	1.0000000
C1	42593435	42596563	BolC1t04652H	0	+	599	2115	3128	0.6761509
C1	42597788	42599714	BolC1t04653H	0	+	1024	1769	1926	0.9184839
C1	42600688	42603078	BolC1t04654H	0	-	919	2249	2390	0.9410042
C1	42614338	42616648	BolC1t04655H	0	+	284	1924	2310	0.8329004
C1	42617197	42634717	BolC1t04656H	0	-	8920	12736	17520	0.7269406
C1	42626617	42627158	BolC1t04657H	0	+	196	541	541	1.0000000
C1	42638366	42638892	BolC1t04658H	0	+	374	526	526	1.0000000
C1	42639849	42641031	BolC1t04659H	0	+	85	527	1182	0.4458545
C1	42648197	42649638	BolC1t04660H	0	+	790	1441	1441	1.0000000
C1	42691802	42692684	BolC1t04661H	0	-	492	882	882	1.0000000
C1	42693577	42697759	BolC1t04662H	0	+	1010	3033	4182	0.7252511
C1	42711162	42712465	BolC1t04663H	0	+	481	1303	1303	1.0000000
C1	42714806	42715257	BolC1t04664H	0	-	280	451	451	1.0000000
C1	42725548	42727238	BolC1t04665H	0	+	306	1574	1690	0.9313610
C1	42728168	42728693	BolC1t04666H	0	+	1	105	525	0.2000000
C1	42728987	42729550	BolC1t04667H	0	-	571	558	563	0.9911190
C1	42734329	42734782	BolC1t04668H	0	+	151	437	453	0.9646799
C1	42740409	42741027	BolC1t04669H	0	-	35	285	618	0.4611650
C1	42741852	42748462	BolC1t04670H	0	-	1550	4349	6610	0.6579425
C1	42758782	42759300	BolC1t04671H	0	-	73	518	518	1.0000000
C1	42823014	42831932	BolC1t04672H	0	+	2129	5471	8918	0.6134784
C1	42842914	42844181	BolC1t04673H	0	+	414	1196	1267	0.9439621
C1	42845408	42846118	BolC1t04674H	0	-	156	665	710	0.9366197
C1	42848886	42849746	BolC1t04675H	0	-	596	860	860	1.0000000
C1	42851340	42852032	BolC1t04676H	0	+	199	692	692	1.0000000
C1	42859080	42859690	BolC1t04677H	0	+	941	610	610	1.0000000
C1	42860012	42861020	BolC1t04678H	0	+	257	517	1008	0.5128968
C1	42863624	42864176	BolC1t04679H	0	+	51	407	552	0.7373188
C1	42865343	42866191	BolC1t04680H	0	-	70	820	848	0.9669811
C1	42867713	42868043	BolC1t04681H	0	+	184	330	330	1.0000000
C1	42871051	42871480	BolC1t04682H	0	-	90	429	429	1.0000000
C1	42894373	42897210	BolC1t04683H	0	-	839	2837	2837	1.0000000
C1	42902473	42903425	BolC1t04684H	0	+	271	888	952	0.9327731
C1	42923491	42924136	BolC1t04685H	0	-	183	602	645	0.9333333
C1	42929584	42929796	BolC1t04686H	0	-	76	212	212	1.0000000
C1	42938268	42939987	BolC1t04687H	0	-	290	1599	1719	0.9301920
C1	42942825	42943005	BolC1t04688H	0	+	180	180	180	1.0000000
C1	42943188	42943455	BolC1t04689H	0	+	280	267	267	1.0000000
C1	42943933	42944347	BolC1t04690H	0	-	3	100	414	0.2415459
C1	42962209	42962614	BolC1t04691H	0	-	40	338	405	0.8345679
C1	42982712	42998418	BolC1t04692H	0	+	4244	12551	15706	0.7991214
C1	42998440	43002336	BolC1t04693H	0	+	1271	3493	3896	0.8965605
C1	43027880	43031271	BolC1t04694H	0	+	1619	3044	3391	0.8976703
C1	43031904	43032932	BolC1t04695H	0	+	531	1028	1028	1.0000000
C1	43033695	43035491	BolC1t04696H	0	-	788	1796	1796	1.0000000
C1	43043820	43044952	BolC1t04697H	0	+	758	1132	1132	1.0000000
C1	43049826	43050267	BolC1t04698H	0	+	509	441	441	1.0000000
C1	43055030	43055784	BolC1t04699H	0	-	28	478	754	0.6339523
C1	43056530	43058489	BolC1t04700H	0	+	978	1959	1959	1.0000000
C1	43060395	43061034	BolC1t04701H	0	+	57	639	639	1.0000000
C1	43062940	43065374	BolC1t04702H	0	+	1077	2411	2434	0.9905505
C1	43065802	43066827	BolC1t04703H	0	-	215	937	1025	0.9141464
C1	43071723	43072568	BolC1t04704H	0	-	598	845	845	1.0000000
C1	43081647	43086053	BolC1t04705H	0	+	3676	4273	4406	0.9698139
C1	43093631	43099549	BolC1t04706H	0	-	2103	5629	5918	0.9511659
C1	43104908	43105160	BolC1t04707H	0	+	1	1	252	0.0039683
C1	43107587	43108860	BolC1t04708H	0	+	593	1259	1273	0.9890023
C1	43112448	43113619	BolC1t04709H	0	+	348	518	1171	0.4423570
C1	43114897	43115413	BolC1t04710H	0	+	152	498	516	0.9651163
C1	43126216	43127299	BolC1t04711H	0	+	42	206	1083	0.1902124
C1	43130747	43131851	BolC1t04712H	0	+	0	0	1104	0.0000000
C1	43142461	43143241	BolC1t04713H	0	+	0	0	780	0.0000000
C1	43159092	43159494	BolC1t04714H	0	+	0	0	402	0.0000000
C1	43166780	43167863	BolC1t04715H	0	+	4	187	1083	0.1726685
C1	43183580	43184528	BolC1t04716H	0	-	550	948	948	1.0000000
C1	43184674	43184876	BolC1t04717H	0	+	32	139	202	0.6881188
C1	43193440	43198068	BolC1t04718H	0	-	793	2647	4628	0.5719534
C1	43201075	43202816	BolC1t04719H	0	-	69	859	1741	0.4933946
C1	43212827	43213253	BolC1t04720H	0	-	379	426	426	1.0000000
C1	43213985	43214210	BolC1t04721H	0	+	152	225	225	1.0000000
C1	43238379	43238675	BolC1t04722H	0	-	123	296	296	1.0000000
C1	43245315	43246279	BolC1t04723H	0	-	78	841	964	0.8724067
C1	43247206	43249048	BolC1t04724H	0	-	800	1695	1842	0.9201955
C1	43251494	43255442	BolC1t04725H	0	-	1735	3941	3948	0.9982269
C1	43257647	43259108	BolC1t04726H	0	-	626	1461	1461	1.0000000
C1	43260523	43261808	BolC1t04727H	0	-	34	713	1285	0.5548638
C1	43266503	43267815	BolC1t04728H	0	-	859	1312	1312	1.0000000
C1	43267838	43268174	BolC1t04729H	0	-	293	336	336	1.0000000
C1	43279197	43285990	BolC1t04730H	0	+	3629	6793	6793	1.0000000
C1	43287316	43290274	BolC1t04731H	0	+	677	2471	2958	0.8353617
C1	43292389	43293097	BolC1t04732H	0	-	343	708	708	1.0000000
C1	43297688	43297916	BolC1t04733H	0	-	164	228	228	1.0000000
C1	43300438	43301107	BolC1t04734H	0	-	290	611	669	0.9133034
C1	43312302	43313124	BolC1t04735H	0	-	290	822	822	1.0000000
C1	43313968	43330331	BolC1t04736H	0	-	1571	7491	16363	0.4578011
C1	43331592	43332950	BolC1t04737H	0	-	871	1332	1358	0.9808542
C1	43334360	43336437	BolC1t04738H	0	+	470	1926	2077	0.9272990
C1	43337735	43338797	BolC1t04739H	0	-	225	882	1062	0.8305085
C1	43341135	43344517	BolC1t04740H	0	-	1504	2740	3382	0.8101715
C1	43345435	43346589	BolC1t04741H	0	+	992	1154	1154	1.0000000
C1	43355371	43365364	BolC1t04742H	0	+	4662	9440	9993	0.9446613
C1	43362943	43364655	BolC1t04743H	0	+	712	1295	1712	0.7564253
C1	43365437	43367036	BolC1t04744H	0	+	587	1588	1599	0.9931207
C1	43367232	43367538	BolC1t04745H	0	-	308	306	306	1.0000000
C1	43374446	43377035	BolC1t04746H	0	+	654	2447	2589	0.9451526
C1	43397273	43398524	BolC1t04747H	0	+	203	1061	1251	0.8481215
C1	43412473	43413983	BolC1t04748H	0	+	452	1494	1510	0.9894040
C1	43417183	43417656	BolC1t04749H	0	-	134	369	473	0.7801269
C1	43421830	43423914	BolC1t04750H	0	+	586	1942	2084	0.9318618
C1	43425357	43426051	BolC1t04751H	0	-	624	694	694	1.0000000
C1	43430869	43430995	BolC1t04752H	0	-	263	126	126	1.0000000
C1	43440826	43441036	BolC1t04753H	0	+	1751	210	210	1.0000000
C1	43442086	43443551	BolC1t04754H	0	-	3646	1465	1465	1.0000000
C1	43449748	43451069	BolC1t04755H	0	-	287	1135	1321	0.8591976
C1	43453818	43465242	BolC1t04756H	0	-	5425	9835	11424	0.8609068
C1	43478425	43480219	BolC1t04757H	0	-	875	1794	1794	1.0000000
C1	43486543	43487287	BolC1t04758H	0	+	97	547	744	0.7352151
C1	43487457	43489418	BolC1t04759H	0	+	202	1410	1961	0.7190209
C1	43487990	43488832	BolC1t04760H	0	+	114	407	842	0.4833729
C1	43489895	43493702	BolC1t04761H	0	+	883	2564	3807	0.6734962
C1	43491976	43492372	BolC1t04762H	0	-	24	359	396	0.9065657
C1	43494670	43495183	BolC1t04763H	0	+	564	513	513	1.0000000
C1	43495441	43496143	BolC1t04764H	0	-	214	686	702	0.9772080
C1	43497814	43498135	BolC1t04765H	0	-	9	294	321	0.9158878
C1	43525420	43526164	BolC1t04766H	0	-	29	362	744	0.4865592
C1	43541034	43541151	BolC1t04767H	0	-	43	117	117	1.0000000
C1	43541604	43541730	BolC1t04768H	0	-	270	126	126	1.0000000
C1	43563297	43563770	BolC1t04769H	0	-	4	176	473	0.3720930
C1	43565550	43566168	BolC1t04770H	0	-	382	618	618	1.0000000
C1	43571935	43574163	BolC1t04771H	0	+	412	2015	2228	0.9043986
C1	43574409	43575804	BolC1t04772H	0	-	57	708	1395	0.5075269
C1	43590345	43592185	BolC1t04773H	0	+	24	987	1840	0.5364130
C1	43606259	43608109	BolC1t04774H	0	-	432	1607	1850	0.8686486
C1	43608570	43609593	BolC1t04775H	0	+	7	212	1023	0.2072336
C1	43627111	43629364	BolC1t04776H	0	+	839	1721	2253	0.7638704
C1	43640662	43644113	BolC1t04777H	0	+	332	2137	3451	0.6192408
C1	43644355	43645234	BolC1t04778H	0	-	73	680	879	0.7736064
C1	43645619	43649040	BolC1t04779H	0	-	790	3204	3421	0.9365683
C1	43651596	43653315	BolC1t04780H	0	+	640	1719	1719	1.0000000
C1	43653443	43654723	BolC1t04781H	0	-	74	1031	1280	0.8054687
C1	43657645	43657822	BolC1t04782H	0	+	25	177	177	1.0000000
C1	43658627	43659326	BolC1t04783H	0	+	311	578	699	0.8268956
C1	43659470	43661770	BolC1t04784H	0	-	94	1175	2300	0.5108696
C1	43668916	43670972	BolC1t04785H	0	-	485	1392	2056	0.6770428
C1	43672169	43672439	BolC1t04786H	0	-	7	108	270	0.4000000
C1	43690907	43691239	BolC1t04787H	0	+	159	332	332	1.0000000
C1	43691806	43694922	BolC1t04788H	0	-	1144	3033	3116	0.9733633
C1	43696392	43698164	BolC1t04789H	0	+	663	1772	1772	1.0000000
C1	43699192	43700314	BolC1t04790H	0	-	289	1112	1122	0.9910873
C1	43705456	43706250	BolC1t04791H	0	+	269	794	794	1.0000000
C1	43706487	43708980	BolC1t04792H	0	-	402	1783	2493	0.7152026
C1	43709828	43711287	BolC1t04793H	0	-	20	293	1459	0.2008225
C1	43715924	43722340	BolC1t04794H	0	+	2251	4257	6416	0.6634975
C1	43720646	43721987	BolC1t04795H	0	+	680	1341	1341	1.0000000
C1	43722424	43723305	BolC1t04796H	0	+	648	881	881	1.0000000
C1	43757105	43760897	BolC1t04797H	0	-	675	2732	3792	0.7204641
C1	43763063	43763237	BolC1t04798H	0	+	3	151	174	0.8678161
C1	43788725	43794929	BolC1t04799H	0	+	698	3751	6204	0.6046099
C1	43804859	43808644	BolC1t04800H	0	+	461	2356	3785	0.6224571
C1	43810656	43836840	BolC1t04801H	0	+	6091	20626	26184	0.7877330
C1	43822937	43823596	BolC1t04802H	0	-	617	659	659	1.0000000
C1	43841359	43841833	BolC1t04803H	0	+	29	301	474	0.6350211
C1	43842902	43843975	BolC1t04804H	0	-	589	1073	1073	1.0000000
C1	43845891	43847817	BolC1t04805H	0	-	871	1826	1926	0.9480789
C1	43848207	43851458	BolC1t04806H	0	+	2802	3226	3251	0.9923100
C1	43851738	43852341	BolC1t04807H	0	+	473	603	603	1.0000000
C1	43852576	43854128	BolC1t04808H	0	-	1099	1545	1552	0.9954897
C1	43867414	43873330	BolC1t04809H	0	+	1512	5230	5916	0.8840433
C1	43873957	43874458	BolC1t04810H	0	+	96	421	501	0.8403193
C1	43874676	43874964	BolC1t04811H	0	-	540	288	288	1.0000000
C1	43885065	43885341	BolC1t04812H	0	-	527	276	276	1.0000000
C1	43893967	43895227	BolC1t04813H	0	+	283	1065	1260	0.8452381
C1	43916800	43917362	BolC1t04814H	0	-	51	527	562	0.9377224
C1	43917460	43918699	BolC1t04815H	0	+	86	668	1239	0.5391445
C1	43920415	43922584	BolC1t04816H	0	-	984	2169	2169	1.0000000
C1	43922961	43923492	BolC1t04817H	0	+	374	531	531	1.0000000
C1	43927080	43928696	BolC1t04818H	0	-	231	1166	1616	0.7215347
C1	43930496	43932633	BolC1t04819H	0	-	36	700	2137	0.3275620
C1	43933316	43936149	BolC1t04820H	0	-	1601	2650	2833	0.9354042
C1	43936823	43937342	BolC1t04821H	0	-	254	519	519	1.0000000
C1	43938454	43941582	BolC1t04822H	0	-	656	2119	3128	0.6774297
C1	43948053	43949230	BolC1t04823H	0	+	1148	1177	1177	1.0000000
C1	43957333	43958959	BolC1t04824H	0	+	458	1327	1626	0.8161132
C1	43959836	43960031	BolC1t04825H	0	+	73	195	195	1.0000000
C1	43960449	43961903	BolC1t04826H	0	-	1166	1433	1454	0.9855571
C1	43965399	43966036	BolC1t04827H	0	-	67	565	637	0.8869702
C1	43979605	43980365	BolC1t04828H	0	+	168	603	760	0.7934210
C1	43983576	43984750	BolC1t04829H	0	+	795	1174	1174	1.0000000
C1	43985073	43986724	BolC1t04830H	0	-	1042	1651	1651	1.0000000
C1	43991615	43991954	BolC1t04831H	0	+	133	339	339	1.0000000
C1	43992509	43993235	BolC1t04832H	0	+	191	726	726	1.0000000
C1	44000349	44005518	BolC1t04833H	0	-	3548	5169	5169	1.0000000
C1	44006384	44009183	BolC1t04834H	0	+	773	2751	2799	0.9828510
C1	44009660	44010339	BolC1t04835H	0	+	127	679	679	1.0000000
C1	44010913	44013668	BolC1t04836H	0	-	883	2679	2755	0.9724138
C1	44016822	44017271	BolC1t04837H	0	-	268	449	449	1.0000000
C1	44018151	44019886	BolC1t04838H	0	+	137	1148	1735	0.6616715
C1	44024955	44025699	BolC1t04839H	0	-	84	738	744	0.9919355
C1	44026728	44026932	BolC1t04840H	0	-	25	204	204	1.0000000
C1	44026896	44027253	BolC1t04841H	0	-	20	242	357	0.6778712
C1	44031973	44032691	BolC1t04842H	0	+	17	461	718	0.6420613
C1	44034367	44036241	BolC1t04843H	0	+	8	181	1874	0.0965848
C1	44037974	44039376	BolC1t04844H	0	+	18	407	1402	0.2902996
C1	44040221	44040809	BolC1t04845H	0	+	58	458	588	0.7789116
C1	44041283	44042150	BolC1t04846H	0	+	270	867	867	1.0000000
C1	44043098	44045034	BolC1t04847H	0	-	356	1264	1936	0.6528926
C1	44061731	44062362	BolC1t04848H	0	+	8	410	631	0.6497623
C1	44065795	44066921	BolC1t04849H	0	-	64	573	1126	0.5088810
C1	44084002	44084632	BolC1t04850H	0	+	0	0	630	0.0000000
C1	44090315	44092188	BolC1t04851H	0	+	2	115	1873	0.0613988
C1	44094000	44095126	BolC1t04852H	0	-	48	629	1126	0.5586146
C1	44104290	44104608	BolC1t04853H	0	-	78	287	318	0.9025157
C1	44108379	44108586	BolC1t04854H	0	-	32	144	207	0.6956522
C1	44127029	44128030	BolC1t04855H	0	+	178	956	1001	0.9550450
C1	44129809	44130103	BolC1t04856H	0	-	101	294	294	1.0000000
C1	44132787	44135043	BolC1t04857H	0	-	112	1094	2256	0.4849291
C1	44141637	44143002	BolC1t04858H	0	-	343	1042	1365	0.7633700
C1	44192145	44193270	BolC1t04859H	0	-	35	443	1125	0.3937778
C1	44194231	44194779	BolC1t04860H	0	+	1045	486	548	0.8868613
C1	44194852	44195999	BolC1t04861H	0	+	27	204	1147	0.1778553
C1	44201384	44201621	BolC1t04862H	0	-	13	178	237	0.7510548
C1	44218994	44220195	BolC1t04863H	0	-	390	1158	1201	0.9641965
C1	44242938	44268488	BolC1t04864H	0	+	1514	3957	25550	0.1548728
C1	44268833	44269551	BolC1t04865H	0	-	453	657	718	0.9150418
C1	44270167	44270434	BolC1t04866H	0	-	52	267	267	1.0000000
C1	44275724	44282021	BolC1t04867H	0	-	1320	5141	6297	0.8164205
C1	44278692	44279171	BolC1t04868H	0	+	10	180	479	0.3757829
C1	44283244	44285873	BolC1t04869H	0	+	1415	2576	2629	0.9798402
C1	44288135	44290534	BolC1t04870H	0	-	2466	2399	2399	1.0000000
C1	44290825	44291101	BolC1t04871H	0	+	344	276	276	1.0000000
C1	44292080	44292275	BolC1t04872H	0	+	214	195	195	1.0000000
C1	44293584	44296286	BolC1t04873H	0	-	1419	2702	2702	1.0000000
C1	44298364	44299614	BolC1t04874H	0	+	0	0	1250	0.0000000
C1	44304545	44306632	BolC1t04875H	0	-	1454	2087	2087	1.0000000
C1	44307338	44308032	BolC1t04876H	0	-	299	694	694	1.0000000
C1	44309045	44309876	BolC1t04877H	0	+	171	645	831	0.7761733
C1	44312969	44316420	BolC1t04878H	0	+	494	2882	3451	0.8351203
C1	44316818	44319319	BolC1t04879H	0	-	680	2278	2501	0.9108357
C1	44320782	44328375	BolC1t04880H	0	+	586	3042	7593	0.4006322
C1	44339325	44339769	BolC1t04881H	0	-	222	364	444	0.8198198
C1	44353321	44353771	BolC1t04882H	0	+	542	450	450	1.0000000
C1	44354381	44355026	BolC1t04883H	0	+	483	645	645	1.0000000
C1	44356843	44358078	BolC1t04884H	0	-	103	818	1235	0.6623482
C1	44360725	44362210	BolC1t04885H	0	+	234	1086	1485	0.7313131
C1	44363822	44364704	BolC1t04886H	0	-	258	816	882	0.9251701
C1	44368876	44369170	BolC1t04887H	0	-	110	294	294	1.0000000
C1	44420585	44421254	BolC1t04888H	0	+	286	514	669	0.7683109
C1	44422641	44422984	BolC1t04889H	0	+	210	343	343	1.0000000
C1	44423631	44424142	BolC1t04890H	0	+	656	511	511	1.0000000
C1	44428003	44428629	BolC1t04891H	0	+	54	626	626	1.0000000
C1	44428893	44432837	BolC1t04892H	0	-	1979	3826	3944	0.9700812
C1	44442399	44442807	BolC1t04893H	0	-	49	254	408	0.6225490
C1	44469286	44469943	BolC1t04894H	0	-	915	657	657	1.0000000
C1	44473960	44474753	BolC1t04895H	0	-	497	793	793	1.0000000
C1	44475365	44476705	BolC1t04896H	0	-	409	1164	1340	0.8686567
C1	44479059	44480188	BolC1t04897H	0	+	545	1126	1129	0.9973428
C1	44481176	44481992	BolC1t04898H	0	+	703	816	816	1.0000000
C1	44484406	44485915	BolC1t04899H	0	-	1111	1509	1509	1.0000000
C1	44500186	44500696	BolC1t04900H	0	+	61	407	510	0.7980392
C1	44506995	44520616	BolC1t04901H	0	+	6973	10248	13621	0.7523677
C1	44513534	44514493	BolC1t04902H	0	+	0	0	959	0.0000000
C1	44521405	44522147	BolC1t04903H	0	-	83	683	742	0.9204852
C1	44522976	44523935	BolC1t04904H	0	+	441	959	959	1.0000000
C1	44524654	44525332	BolC1t04905H	0	+	90	678	678	1.0000000
C1	44527216	44528305	BolC1t04906H	0	-	266	1028	1089	0.9439853
C1	44539139	44543563	BolC1t04907H	0	-	1963	4376	4424	0.9891501
C1	44570584	44573312	BolC1t04908H	0	+	959	2520	2728	0.9237537
C1	44574571	44577501	BolC1t04909H	0	-	2212	2930	2930	1.0000000
C1	44578117	44578667	BolC1t04910H	0	+	335	550	550	1.0000000
C1	44587549	44589304	BolC1t04911H	0	-	479	1600	1755	0.9116809
C1	44590761	44591090	BolC1t04912H	0	-	108	315	329	0.9574468
C1	44595289	44596000	BolC1t04913H	0	+	343	665	711	0.9353024
C1	44596883	44597279	BolC1t04914H	0	+	88	179	396	0.4520202
C1	44598032	44600059	BolC1t04915H	0	-	127	1483	2027	0.7316231
C1	44601475	44601655	BolC1t04916H	0	-	150	180	180	1.0000000
C1	44609348	44609673	BolC1t04917H	0	-	141	325	325	1.0000000
C1	44609760	44610550	BolC1t04918H	0	-	108	676	790	0.8556962
C1	44616366	44622662	BolC1t04919H	0	-	4006	6154	6296	0.9774460
C1	44634570	44636079	BolC1t04920H	0	-	753	1509	1509	1.0000000
C1	44638634	44640757	BolC1t04921H	0	+	601	2028	2123	0.9552520
C1	44641362	44643351	BolC1t04922H	0	-	429	1591	1989	0.7998995
C1	44648975	44649182	BolC1t04923H	0	+	0	0	207	0.0000000
C1	44650751	44654445	BolC1t04924H	0	+	2010	3515	3694	0.9515430
C1	44654863	44655460	BolC1t04925H	0	-	107	480	597	0.8040201
C1	44656869	44657922	BolC1t04926H	0	+	887	1053	1053	1.0000000
C1	44659437	44661411	BolC1t04927H	0	+	1060	1974	1974	1.0000000
C1	44661777	44664268	BolC1t04928H	0	-	609	2191	2491	0.8795664
C1	44676629	44677486	BolC1t04929H	0	-	28	166	857	0.1936989
C1	44681989	44682596	BolC1t04930H	0	+	50	485	607	0.7990115
C1	44688204	44690248	BolC1t04931H	0	-	0	0	2044	0.0000000
C1	44690851	44743615	BolC1t04932H	0	-	2898	17905	52764	0.3393412
C1	44744197	44744812	BolC1t04933H	0	-	0	0	615	0.0000000
C1	44749740	44752042	BolC1t04934H	0	-	0	0	2302	0.0000000
C1	44781535	44781760	BolC1t04935H	0	-	0	0	225	0.0000000
C1	44790811	44791265	BolC1t04936H	0	-	11	220	454	0.4845815
C1	44806766	44808807	BolC1t04937H	0	-	0	0	2041	0.0000000
C1	44809387	44811229	BolC1t04938H	0	-	0	0	1842	0.0000000
C1	44814847	44815361	BolC1t04939H	0	-	449	514	514	1.0000000
C1	44823453	44826780	BolC1t04940H	0	+	1696	3327	3327	1.0000000
C1	44827250	44829248	BolC1t04941H	0	-	1351	1998	1998	1.0000000
C1	44836370	44836894	BolC1t04942H	0	+	21	515	524	0.9828244
C1	44849883	44852788	BolC1t04943H	0	+	711	2798	2905	0.9631670
C1	44853586	44854048	BolC1t04944H	0	-	164	462	462	1.0000000
C1	44855922	44856402	BolC1t04945H	0	-	26	357	480	0.7437500
C1	44858672	44862899	BolC1t04946H	0	+	5144	3963	4227	0.9375443
C1	44869532	44870778	BolC1t04947H	0	+	223	1215	1246	0.9751204
C1	44873738	44874316	BolC1t04948H	0	+	0	0	578	0.0000000
C1	44885390	44885800	BolC1t04949H	0	+	212	410	410	1.0000000
C1	44891839	44892115	BolC1t04950H	0	+	289	276	276	1.0000000
C1	44892885	44893585	BolC1t04951H	0	+	500	700	700	1.0000000
C1	44897663	44901373	BolC1t04952H	0	+	2079	3700	3710	0.9973046
C1	44921901	44922828	BolC1t04953H	0	+	234	697	927	0.7518878
C1	44922890	44923255	BolC1t04954H	0	-	221	365	365	1.0000000
C1	44923336	44925128	BolC1t04955H	0	-	1705	1792	1792	1.0000000
C1	44926774	44926930	BolC1t04956H	0	+	66	156	156	1.0000000
C1	44929270	44932064	BolC1t04957H	0	+	2110	2794	2794	1.0000000
C1	44936462	44939872	BolC1t04958H	0	-	2757	3410	3410	1.0000000
C1	44971539	44974035	BolC1t04959H	0	-	871	2255	2496	0.9034455
C1	45007880	45010216	BolC1t04960H	0	-	470	2085	2336	0.8925514
C1	45040274	45042071	BolC1t04961H	0	+	223	1576	1797	0.8770173
C1	45062467	45062775	BolC1t04962H	0	+	285	308	308	1.0000000
C1	45063261	45065230	BolC1t04963H	0	-	922	1878	1969	0.9537836
C1	45066845	45068727	BolC1t04964H	0	+	703	1882	1882	1.0000000
C1	45072131	45072605	BolC1t04965H	0	-	760	474	474	1.0000000
C1	45073875	45075622	BolC1t04966H	0	-	1014	1659	1747	0.9496279
C1	45083191	45083404	BolC1t04967H	0	-	285	213	213	1.0000000
C1	45086259	45086412	BolC1t04968H	0	-	92	153	153	1.0000000
C1	45118966	45119113	BolC1t04969H	0	+	250	147	147	1.0000000
C1	45137774	45141814	BolC1t04970H	0	+	2259	4040	4040	1.0000000
C1	45142298	45144555	BolC1t04971H	0	+	758	2202	2257	0.9756314
C1	45155774	45159221	BolC1t04972H	0	+	1841	3447	3447	1.0000000
C1	45163864	45167414	BolC1t04973H	0	+	1877	3548	3550	0.9994366
C1	45167666	45169270	BolC1t04974H	0	+	1423	1604	1604	1.0000000
C1	45187618	45188254	BolC1t04975H	0	+	187	590	636	0.9276730
C1	45204478	45210037	BolC1t04976H	0	+	1984	5494	5559	0.9883072
C1	45227539	45233683	BolC1t04977H	0	-	3577	4730	6144	0.7698568
C1	45240237	45242422	BolC1t04978H	0	+	527	2101	2185	0.9615561
C1	45242818	45243551	BolC1t04979H	0	-	826	733	733	1.0000000
C1	45247840	45249638	BolC1t04980H	0	+	95	528	1798	0.2936596
C1	45269232	45269820	BolC1t04981H	0	+	347	588	588	1.0000000
C1	45270256	45276400	BolC1t04982H	0	-	801	5127	6144	0.8344727
C1	45286643	45287042	BolC1t04983H	0	-	444	399	399	1.0000000
C1	45296539	45297321	BolC1t04984H	0	+	15	317	782	0.4053708
C1	45305635	45305770	BolC1t04985H	0	-	527	135	135	1.0000000
C1	45307891	45308038	BolC1t04986H	0	-	89	147	147	1.0000000
C1	45330483	45345618	BolC1t04987H	0	+	7702	14628	15135	0.9665015
C1	45360972	45361966	BolC1t04988H	0	+	949	994	994	1.0000000
C1	45363511	45364964	BolC1t04989H	0	-	327	1336	1453	0.9194769
C1	45371873	45372396	BolC1t04990H	0	-	550	523	523	1.0000000
C1	45383271	45383664	BolC1t04991H	0	+	120	393	393	1.0000000
C1	45384602	45384764	BolC1t04992H	0	+	170	162	162	1.0000000
C1	45386509	45386647	BolC1t04993H	0	+	52	138	138	1.0000000
C1	45394489	45398756	BolC1t04994H	0	+	1831	4105	4267	0.9620342
C1	45400670	45401947	BolC1t04995H	0	+	635	1249	1277	0.9780736
C1	45402685	45403431	BolC1t04996H	0	-	645	746	746	1.0000000
C1	45404910	45405366	BolC1t04997H	0	+	397	456	456	1.0000000
C1	45406415	45407159	BolC1t04998H	0	+	1508	744	744	1.0000000
C1	45408141	45410250	BolC1t04999H	0	+	2084	2109	2109	1.0000000
C1	45410471	45417252	BolC1t05000H	0	-	4626	6777	6781	0.9994101
C1	45417811	45418980	BolC1t05001H	0	-	886	1169	1169	1.0000000
C1	45421436	45423638	BolC1t05002H	0	+	549	2177	2202	0.9886467
C1	45424705	45427033	BolC1t05003H	0	+	609	2307	2328	0.9909794
C1	45428326	45428683	BolC1t05004H	0	+	0	0	357	0.0000000
C1	45430799	45432116	BolC1t05005H	0	-	89	1088	1317	0.8261200
C1	45440752	45444614	BolC1t05006H	0	-	1567	3799	3862	0.9836872
C1	45444781	45444961	BolC1t05007H	0	+	48	152	180	0.8444445
C1	45465158	45467028	BolC1t05008H	0	+	385	1686	1870	0.9016043
C1	45467943	45472007	BolC1t05009H	0	+	1425	3758	4064	0.9247047
C1	45477169	45478758	BolC1t05010H	0	+	156	1127	1589	0.7092511
C1	45493577	45494636	BolC1t05011H	0	+	180	966	1059	0.9121813
C1	45535470	45536730	BolC1t05012H	0	+	1364	1260	1260	1.0000000
C1	45538709	45540274	BolC1t05013H	0	-	784	1565	1565	1.0000000
C1	45549202	45549433	BolC1t05014H	0	-	265	231	231	1.0000000
C1	45552450	45554320	BolC1t05015H	0	+	407	1595	1870	0.8529412
C1	45556937	45558832	BolC1t05016H	0	-	356	1777	1895	0.9377308
C1	45562533	45564588	BolC1t05017H	0	+	549	1955	2055	0.9513382
C1	45565336	45566680	BolC1t05018H	0	+	1040	1344	1344	1.0000000
C1	45566003	45573524	BolC1t05019H	0	-	3128	7384	7521	0.9817843
C1	45589913	45591186	BolC1t05020H	0	+	165	1212	1273	0.9520817
C1	45593729	45595964	BolC1t05021H	0	-	794	2235	2235	1.0000000
C1	45602795	45604759	BolC1t05022H	0	+	1155	1658	1964	0.8441955
C1	45617576	45618359	BolC1t05023H	0	-	9	292	783	0.3729247
C1	45619241	45620305	BolC1t05024H	0	-	1205	1064	1064	1.0000000
C1	45625003	45626191	BolC1t05025H	0	+	638	1168	1188	0.9831650
C1	45661971	45662169	BolC1t05026H	0	-	127	198	198	1.0000000
C1	45664137	45667117	BolC1t05027H	0	-	846	2491	2980	0.8359060
C1	45677065	45677251	BolC1t05028H	0	+	85	186	186	1.0000000
C1	45685027	45685387	BolC1t05029H	0	+	136	360	360	1.0000000
C1	45699018	45701925	BolC1t05030H	0	+	461	2588	2907	0.8902649
C1	45703733	45708085	BolC1t05031H	0	-	1290	4030	4352	0.9260110
C1	45738407	45741129	BolC1t05032H	0	+	615	1667	2722	0.6124173
C1	45741215	45741693	BolC1t05033H	0	+	108	229	478	0.4790795
C1	45749156	45749705	BolC1t05034H	0	+	31	271	549	0.4936248
C1	45751091	45751721	BolC1t05035H	0	+	210	600	630	0.9523810
C1	45777943	45778579	BolC1t05036H	0	+	297	636	636	1.0000000
C1	45780664	45783548	BolC1t05037H	0	-	401	2508	2884	0.8696255
C1	45791609	45793887	BolC1t05038H	0	+	708	2254	2278	0.9894645
C1	45805176	45806114	BolC1t05039H	0	-	74	852	938	0.9083155
C1	45806165	45806424	BolC1t05040H	0	-	46	205	259	0.7915058
C1	45807915	45809475	BolC1t05041H	0	+	1460	1560	1560	1.0000000
C1	45813060	45816686	BolC1t05042H	0	-	1355	3619	3626	0.9980695
C1	45818720	45819563	BolC1t05043H	0	+	46	664	843	0.7876631
C1	45832146	45832284	BolC1t05044H	0	+	33	138	138	1.0000000
C1	45839579	45865750	BolC1t05045H	0	-	7223	17649	26171	0.6743724
C1	45867067	45867325	BolC1t05046H	0	-	108	239	258	0.9263566
C1	45867717	45868050	BolC1t05047H	0	-	6	218	333	0.6546547
C1	45870074	45870638	BolC1t05048H	0	-	88	514	564	0.9113475
C1	45872462	45873213	BolC1t05049H	0	-	579	751	751	1.0000000
C1	45875690	45875966	BolC1t05050H	0	-	0	0	276	0.0000000
C1	45876557	45876764	BolC1t05051H	0	-	78	116	207	0.5603865
C1	45877077	45877603	BolC1t05052H	0	-	4	278	526	0.5285171
C1	45877725	45878001	BolC1t05053H	0	-	0	0	276	0.0000000
C1	45878589	45878796	BolC1t05054H	0	-	18	75	207	0.3623188
C1	45878969	45879446	BolC1t05055H	0	-	37	190	477	0.3983229
C1	45882828	45885301	BolC1t05056H	0	+	76	856	2473	0.3461383
C1	45894851	45896598	BolC1t05057H	0	+	392	1373	1747	0.7859187
C1	45903621	45904109	BolC1t05058H	0	-	747	488	488	1.0000000
C1	45914566	45915466	BolC1t05059H	0	-	950	900	900	1.0000000
C1	45915181	45916747	BolC1t05060H	0	+	1156	1566	1566	1.0000000
C1	45930504	45931178	BolC1t05061H	0	+	449	674	674	1.0000000
C1	45934820	45936251	BolC1t05062H	0	-	189	1173	1431	0.8197065
C1	45939474	45941661	BolC1t05063H	0	-	408	2071	2187	0.9469593
C1	45969314	45970296	BolC1t05064H	0	+	232	886	982	0.9022403
C1	45970524	45971564	BolC1t05065H	0	+	440	1040	1040	1.0000000
C1	45980307	46013114	BolC1t05066H	0	+	3645	17311	32807	0.5276618
C1	45986995	45988657	BolC1t05067H	0	-	14	390	1662	0.2346570
C1	45998957	46000139	BolC1t05068H	0	+	275	748	1182	0.6328257
C1	46005291	46005834	BolC1t05069H	0	-	0	0	543	0.0000000
C1	46029031	46029391	BolC1t05070H	0	+	0	0	360	0.0000000
C1	46032337	46032880	BolC1t05071H	0	-	0	0	543	0.0000000
C1	46035804	46036206	BolC1t05072H	0	+	108	402	402	1.0000000
C1	46055930	46056290	BolC1t05073H	0	+	0	0	360	0.0000000
C1	46057239	46057443	BolC1t05074H	0	-	0	0	204	0.0000000
C1	46060118	46060577	BolC1t05075H	0	-	0	0	459	0.0000000
C1	46065563	46065761	BolC1t05076H	0	-	75	198	198	1.0000000
C1	46098212	46098545	BolC1t05077H	0	+	332	333	333	1.0000000
C1	46117921	46119026	BolC1t05078H	0	+	235	1015	1105	0.9185520
C1	46121514	46123719	BolC1t05079H	0	+	1330	2178	2205	0.9877551
C1	46123984	46125166	BolC1t05080H	0	+	299	784	1182	0.6632826
C1	46129064	46129262	BolC1t05081H	0	-	13	154	198	0.7777778
C1	46146465	46147072	BolC1t05082H	0	+	54	431	607	0.7100495
C1	46147975	46193746	BolC1t05083H	0	+	40313	38094	45771	0.8322737
C1	46157244	46158381	BolC1t05084H	0	+	795	1137	1137	1.0000000
C1	46183602	46184154	BolC1t05085H	0	-	2	195	552	0.3532609
C1	46196399	46197941	BolC1t05086H	0	-	1	11	1542	0.0071336
C1	46204702	46205011	BolC1t05087H	0	+	31	269	309	0.8705502
C1	46205920	46262975	BolC1t05088H	0	+	26056	53241	57055	0.9331522
C1	46211179	46211452	BolC1t05089H	0	+	247	273	273	1.0000000
C1	46247342	46277428	BolC1t05090H	0	+	3907	17635	30086	0.5861530
C1	46254863	46291574	BolC1t05091H	0	-	7158	23248	36711	0.6332707
C1	46256605	46256998	BolC1t05092H	0	-	16	317	393	0.8066158
C1	46268408	46268960	BolC1t05093H	0	-	0	0	552	0.0000000
C1	46269542	46270001	BolC1t05094H	0	-	0	0	459	0.0000000
C1	46278488	46278829	BolC1t05095H	0	+	54	341	341	1.0000000
C1	46302341	46302573	BolC1t05096H	0	-	99	232	232	1.0000000
C1	46331343	46333228	BolC1t05097H	0	+	1310	1846	1885	0.9793103
C1	46336023	46337321	BolC1t05098H	0	-	195	818	1298	0.6302003
C1	46338678	46344341	BolC1t05099H	0	+	1520	4507	5663	0.7958679
C1	46345694	46345883	BolC1t05100H	0	-	32	156	189	0.8253968
C1	46353193	46353473	BolC1t05101H	0	+	140	280	280	1.0000000
C1	46357720	46358245	BolC1t05102H	0	+	585	525	525	1.0000000
C1	46359865	46362711	BolC1t05103H	0	+	655	2688	2846	0.9444835
C1	46366475	46367610	BolC1t05104H	0	-	470	1027	1135	0.9048458
C1	46367712	46368904	BolC1t05105H	0	-	572	1192	1192	1.0000000
C1	46369307	46371559	BolC1t05106H	0	+	819	2192	2252	0.9733570
C1	46381802	46382012	BolC1t05107H	0	-	110	210	210	1.0000000
C1	46394812	46395511	BolC1t05108H	0	-	302	699	699	1.0000000
C1	46405005	46405548	BolC1t05109H	0	-	399	543	543	1.0000000
C1	46406513	46407226	BolC1t05110H	0	+	158	713	713	1.0000000
C1	46413255	46413535	BolC1t05111H	0	-	155	280	280	1.0000000
C1	46435362	46437283	BolC1t05112H	0	+	807	1867	1921	0.9718896
C1	46445935	46448315	BolC1t05113H	0	-	487	1558	2380	0.6546218
C1	46459905	46462023	BolC1t05114H	0	+	269	1759	2118	0.8305005
C1	46462581	46463067	BolC1t05115H	0	-	351	486	486	1.0000000
C1	46463564	46465548	BolC1t05116H	0	-	1117	1984	1984	1.0000000
C1	46466549	46467800	BolC1t05117H	0	+	1229	1251	1251	1.0000000
C1	46467933	46472548	BolC1t05118H	0	-	1578	3789	4615	0.8210184
C1	46475118	46476684	BolC1t05119H	0	+	84	1157	1566	0.7388250
C1	46477891	46478083	BolC1t05120H	0	-	32	192	192	1.0000000
C1	46482313	46482601	BolC1t05121H	0	-	278	288	288	1.0000000
C1	46482733	46484207	BolC1t05122H	0	-	607	1070	1474	0.7259158
C1	46485506	46487613	BolC1t05123H	0	-	1573	2107	2107	1.0000000
C1	46494209	46494689	BolC1t05124H	0	+	236	480	480	1.0000000
C1	46495251	46495698	BolC1t05125H	0	-	479	447	447	1.0000000
C1	46496222	46496420	BolC1t05126H	0	+	252	198	198	1.0000000
C1	46497223	46500073	BolC1t05127H	0	+	2331	2850	2850	1.0000000
C1	46500370	46502051	BolC1t05128H	0	+	829	1315	1681	0.7822725
C1	46506154	46515159	BolC1t05129H	0	+	2666	1039	9005	0.1153803
C1	46525574	46529472	BolC1t05130H	0	+	2730	3495	3898	0.8966137
C1	46534352	46534598	BolC1t05131H	0	-	2	60	246	0.2439024
C1	46535831	46536479	BolC1t05132H	0	+	182	645	648	0.9953704
C1	46538100	46539706	BolC1t05133H	0	-	383	1307	1606	0.8138232
C1	46540161	46543055	BolC1t05134H	0	+	2940	2894	2894	1.0000000
C1	46543601	46546741	BolC1t05135H	0	+	1566	3115	3140	0.9920382
C1	46547029	46548511	BolC1t05136H	0	-	924	1480	1482	0.9986505
C1	46549706	46552824	BolC1t05137H	0	+	1564	3070	3118	0.9846055
C1	46555219	46556403	BolC1t05138H	0	+	599	1184	1184	1.0000000
C1	46564112	46566656	BolC1t05139H	0	+	1805	2533	2544	0.9956761
C1	46567395	46568580	BolC1t05140H	0	+	260	1146	1185	0.9670886
C1	46568922	46569324	BolC1t05141H	0	-	1032	402	402	1.0000000
C1	46569816	46571127	BolC1t05142H	0	+	50	239	1311	0.1823036
C1	46572110	46572859	BolC1t05143H	0	+	295	749	749	1.0000000
C1	46576378	46577049	BolC1t05144H	0	+	662	671	671	1.0000000
C1	46578297	46583860	BolC1t05145H	0	+	1069	5280	5563	0.9491282
C1	46584647	46589668	BolC1t05146H	0	+	2025	4749	5021	0.9458275
C1	46590013	46594738	BolC1t05147H	0	-	1915	4644	4725	0.9828572
C1	46594965	46597159	BolC1t05148H	0	-	1344	2105	2194	0.9594348
C1	46598435	46603883	BolC1t05149H	0	-	2064	5181	5448	0.9509912
C1	46607514	46609377	BolC1t05150H	0	+	982	1863	1863	1.0000000
C1	46610343	46611409	BolC1t05151H	0	+	410	1066	1066	1.0000000
C1	46611469	46612402	BolC1t05152H	0	+	498	933	933	1.0000000
C1	46612723	46613971	BolC1t05153H	0	-	501	1248	1248	1.0000000
C1	46615989	46617754	BolC1t05154H	0	+	491	1342	1765	0.7603399
C1	46625477	46630947	BolC1t05155H	0	+	453	3059	5470	0.5592322
C1	46631373	46631589	BolC1t05156H	0	+	36	216	216	1.0000000
C1	46632480	46640916	BolC1t05157H	0	-	2929	7811	8436	0.9259127
C1	46658926	46659193	BolC1t05158H	0	-	200	267	267	1.0000000
C1	46659580	46660009	BolC1t05159H	0	+	70	429	429	1.0000000
C1	46677388	46680034	BolC1t05160H	0	+	1258	2567	2646	0.9701436
C1	46680883	46682470	BolC1t05161H	0	-	650	1587	1587	1.0000000
C1	46693108	46694262	BolC1t05162H	0	+	118	961	1154	0.8327556
C1	46701682	46703116	BolC1t05163H	0	-	142	908	1434	0.6331939
C1	46711577	46713287	BolC1t05164H	0	-	226	1361	1710	0.7959064
C1	46717185	46718221	BolC1t05165H	0	-	398	1036	1036	1.0000000
C1	46731141	46737598	BolC1t05166H	0	-	751	2666	6457	0.4128852
C1	46747679	46747838	BolC1t05167H	0	+	422	159	159	1.0000000
C1	46748209	46748332	BolC1t05168H	0	+	446	123	123	1.0000000
C1	46750502	46750766	BolC1t05169H	0	+	354	264	264	1.0000000
C1	46750882	46751207	BolC1t05170H	0	+	352	325	325	1.0000000
C1	46754033	46759569	BolC1t05171H	0	-	816	4799	5536	0.8668714
C1	46759998	46760217	BolC1t05172H	0	+	76	202	219	0.9223744
C1	46760949	46761441	BolC1t05173H	0	+	2	39	492	0.0792683
C1	46767335	46767765	BolC1t05174H	0	+	5	190	430	0.4418605
C1	46768651	46769260	BolC1t05175H	0	+	180	609	609	1.0000000
C1	46782910	46783399	BolC1t05176H	0	+	119	489	489	1.0000000
C1	46792782	46794316	BolC1t05177H	0	+	871	1336	1534	0.8709257
C1	46794604	46794868	BolC1t05178H	0	+	105	264	264	1.0000000
C1	46795016	46802217	BolC1t05179H	0	-	5688	6803	7201	0.9447299
C1	46805155	46807409	BolC1t05180H	0	+	367	1859	2254	0.8247560
C1	46807922	46814308	BolC1t05181H	0	-	6427	6369	6386	0.9973379
C1	46816769	46818026	BolC1t05182H	0	+	6	91	1257	0.0723946
C1	46822824	46824158	BolC1t05183H	0	+	8	232	1334	0.1739130
C1	46838008	46839454	BolC1t05184H	0	+	1	29	1446	0.0200553
C1	46840562	46842705	BolC1t05185H	0	-	163	1232	2143	0.5748950
C1	46852964	46855187	BolC1t05186H	0	+	230	1284	2223	0.5775979
C1	46858526	46859461	BolC1t05187H	0	+	625	935	935	1.0000000
C1	46859588	46860398	BolC1t05188H	0	+	1135	810	810	1.0000000
C1	46866692	46870301	BolC1t05189H	0	+	1178	2969	3609	0.8226656
C1	46876023	46876812	BolC1t05190H	0	-	68	519	789	0.6577947
C1	46877414	46877660	BolC1t05191H	0	+	122	246	246	1.0000000
C1	46878031	46881006	BolC1t05192H	0	-	872	2530	2975	0.8504202
C1	46887978	46888446	BolC1t05193H	0	-	55	381	468	0.8141026
C1	46890287	46892216	BolC1t05194H	0	+	394	1813	1929	0.9398652
C1	46893459	46894578	BolC1t05195H	0	+	275	880	1119	0.7864165
C1	46895188	46896257	BolC1t05196H	0	-	560	1069	1069	1.0000000
C1	46906292	46913073	BolC1t05197H	0	+	851	3696	6781	0.5450523
C1	46914626	46914740	BolC1t05198H	0	+	4	38	114	0.3333333
C1	46915773	46918203	BolC1t05199H	0	+	1144	2372	2430	0.9761317
C1	46918875	46920426	BolC1t05200H	0	-	167	758	1551	0.4887170
C1	46925820	46925981	BolC1t05201H	0	+	0	0	161	0.0000000
C1	46926037	46926663	BolC1t05202H	0	+	45	441	626	0.7044728
C1	46928589	46931303	BolC1t05203H	0	+	2031	2714	2714	1.0000000
C1	46932236	46933178	BolC1t05204H	0	+	429	942	942	1.0000000
C1	46933973	46934450	BolC1t05205H	0	-	360	476	477	0.9979036
C1	46958779	46960147	BolC1t05206H	0	-	1405	1368	1368	1.0000000
C1	46960267	46961288	BolC1t05207H	0	+	170	923	1021	0.9040157
C1	46964507	46965468	BolC1t05208H	0	+	95	425	961	0.4422477
C1	46965611	46966371	BolC1t05209H	0	+	105	532	760	0.7000000
C1	46967309	46968327	BolC1t05210H	0	+	22	570	1018	0.5599214
C1	46969351	46971961	BolC1t05211H	0	+	1215	2560	2610	0.9808429
C1	46972081	46973133	BolC1t05212H	0	+	476	1030	1052	0.9790875
C1	46973365	46975204	BolC1t05213H	0	-	1641	1775	1839	0.9651985
C1	46980376	46981039	BolC1t05214H	0	+	135	434	663	0.6546003
C1	46982469	46983129	BolC1t05215H	0	+	105	660	660	1.0000000
C1	46984253	46984676	BolC1t05216H	0	+	200	418	423	0.9881797
C1	46985945	46987277	BolC1t05217H	0	-	655	1332	1332	1.0000000
C1	46988704	46989196	BolC1t05218H	0	-	345	492	492	1.0000000
C1	46992535	46993027	BolC1t05219H	0	-	270	492	492	1.0000000
C1	46994440	46994932	BolC1t05220H	0	-	369	492	492	1.0000000
C1	46996357	46996849	BolC1t05221H	0	-	185	492	492	1.0000000
C1	46998289	47000687	BolC1t05222H	0	-	238	2134	2398	0.8899083
C1	47002135	47002618	BolC1t05223H	0	-	271	483	483	1.0000000
C1	47008288	47009131	BolC1t05224H	0	+	406	843	843	1.0000000
C1	47009779	47010842	BolC1t05225H	0	-	405	1063	1063	1.0000000
C1	47011396	47011909	BolC1t05226H	0	+	77	410	513	0.7992203
C1	47012231	47014884	BolC1t05227H	0	-	447	2431	2653	0.9163212
C1	47016241	47017021	BolC1t05228H	0	-	509	780	780	1.0000000
C1	47022677	47023467	BolC1t05229H	0	-	56	581	790	0.7354431
C1	47026896	47027379	BolC1t05230H	0	-	39	261	483	0.5403727
C1	47028876	47029365	BolC1t05231H	0	-	2	158	489	0.3231084
C1	47030938	47031391	BolC1t05232H	0	-	22	335	453	0.7395144
C1	47032892	47033345	BolC1t05233H	0	-	3	394	453	0.8697572
C1	47034849	47035302	BolC1t05234H	0	-	17	448	453	0.9889625
C1	47036806	47037259	BolC1t05235H	0	-	7	252	453	0.5562914
C1	47038763	47039216	BolC1t05236H	0	-	2	239	453	0.5275938
C1	47040726	47041179	BolC1t05237H	0	-	2	255	453	0.5629139
C1	47042687	47045112	BolC1t05238H	0	-	1033	2425	2425	1.0000000
C1	47048833	47050436	BolC1t05239H	0	+	1676	1603	1603	1.0000000
C1	47051009	47051903	BolC1t05240H	0	+	5	148	894	0.1655481
C1	47053439	47054048	BolC1t05241H	0	+	264	466	609	0.7651888
C1	47054054	47054390	BolC1t05242H	0	+	45	212	336	0.6309524
C1	47055297	47055477	BolC1t05243H	0	-	236	180	180	1.0000000
C1	47068310	47068805	BolC1t05244H	0	-	43	382	495	0.7717172
C1	47070110	47072219	BolC1t05245H	0	+	821	1987	2109	0.9421527
C1	47077763	47077973	BolC1t05246H	0	+	99	210	210	1.0000000
C1	47078524	47079505	BolC1t05247H	0	-	784	981	981	1.0000000
C1	47080293	47084886	BolC1t05248H	0	+	1913	4377	4593	0.9529719
C1	47085651	47086711	BolC1t05249H	0	+	376	1060	1060	1.0000000
C1	47087259	47089247	BolC1t05250H	0	-	702	1988	1988	1.0000000
C1	47093291	47096348	BolC1t05251H	0	+	351	2721	3057	0.8900883
C1	47096906	47097152	BolC1t05252H	0	-	31	136	246	0.5528455
C1	47098145	47100588	BolC1t05253H	0	+	121	1664	2443	0.6811298
C1	47101804	47102404	BolC1t05254H	0	-	0	0	600	0.0000000
C1	47118273	47118619	BolC1t05255H	0	-	71	346	346	1.0000000
C1	47124176	47127482	BolC1t05256H	0	+	1903	3306	3306	1.0000000
C1	47128098	47129151	BolC1t05257H	0	-	849	1053	1053	1.0000000
C1	47129597	47131094	BolC1t05258H	0	-	1100	1486	1497	0.9926520
C1	47132011	47133350	BolC1t05259H	0	+	611	874	1339	0.6527259
C1	47145023	47146160	BolC1t05260H	0	+	81	478	1137	0.4204046
C1	47148312	47148813	BolC1t05261H	0	-	586	480	501	0.9580838
C1	47160974	47163203	BolC1t05262H	0	+	173	1614	2229	0.7240915
C1	47174283	47176204	BolC1t05263H	0	+	519	1582	1921	0.8235294
C1	47179209	47180364	BolC1t05264H	0	+	198	958	1155	0.8294373
C1	47182103	47183378	BolC1t05265H	0	+	52	1027	1275	0.8054902
C1	47184891	47186106	BolC1t05266H	0	-	411	1180	1215	0.9711934
C1	47187430	47187725	BolC1t05267H	0	-	47	257	295	0.8711864
C1	47187953	47188125	BolC1t05268H	0	+	13	109	172	0.6337209
C1	47188431	47190647	BolC1t05269H	0	-	95	897	2216	0.4047834
C1	47216776	47217364	BolC1t05270H	0	+	72	441	588	0.7500000
C1	47217670	47218227	BolC1t05271H	0	-	73	515	557	0.9245961
C1	47218999	47221673	BolC1t05272H	0	-	190	1536	2674	0.5744203
C1	47222843	47223254	BolC1t05273H	0	-	0	0	411	0.0000000
C1	47226762	47231856	BolC1t05274H	0	-	213	2055	5094	0.4034158
C1	47235193	47235747	BolC1t05275H	0	-	0	0	554	0.0000000
C1	47237927	47239519	BolC1t05276H	0	-	134	958	1592	0.6017588
C1	47240649	47253351	BolC1t05277H	0	+	1317	7213	12702	0.5678633
C1	47254799	47255856	BolC1t05278H	0	-	150	992	1057	0.9385052
C1	47256883	47257987	BolC1t05279H	0	+	650	1104	1104	1.0000000
C1	47258447	47259546	BolC1t05280H	0	-	141	998	1099	0.9080983
C1	47266736	47267919	BolC1t05281H	0	-	145	1130	1183	0.9551986
C1	47272445	47275889	BolC1t05282H	0	-	1450	2995	3444	0.8696283
C1	47277574	47285684	BolC1t05283H	0	+	3708	7801	8110	0.9618989
C1	47286370	47286945	BolC1t05284H	0	+	703	575	575	1.0000000
C1	47286985	47288585	BolC1t05285H	0	+	1116	1600	1600	1.0000000
C1	47291591	47293290	BolC1t05286H	0	+	758	1658	1699	0.9758682
C1	47293514	47296789	BolC1t05287H	0	-	2304	2927	3275	0.8937405
C1	47320942	47322074	BolC1t05288H	0	+	706	1132	1132	1.0000000
C1	47322736	47323339	BolC1t05289H	0	+	231	603	603	1.0000000
C1	47323928	47327471	BolC1t05290H	0	-	1010	3472	3543	0.9799605
C1	47332656	47333022	BolC1t05291H	0	-	0	0	366	0.0000000
C1	47334126	47336049	BolC1t05292H	0	-	323	1152	1923	0.5990639
C1	47336906	47337950	BolC1t05293H	0	+	456	980	1044	0.9386973
C1	47338138	47338986	BolC1t05294H	0	-	167	791	848	0.9327830
C1	47340496	47342177	BolC1t05295H	0	+	656	1661	1681	0.9881023
C1	47342966	47346034	BolC1t05296H	0	+	820	2762	3068	0.9002607
C1	47349077	47350930	BolC1t05297H	0	-	530	1216	1853	0.6562331
C1	47358150	47358903	BolC1t05298H	0	-	387	753	753	1.0000000
C1	47382593	47384925	BolC1t05299H	0	+	746	1422	2332	0.6097770
C1	47389716	47390355	BolC1t05300H	0	+	2	121	639	0.1893584
C1	47393416	47394145	BolC1t05301H	0	+	792	729	729	1.0000000
C1	47395002	47395485	BolC1t05302H	0	-	192	483	483	1.0000000
C1	47396173	47397870	BolC1t05303H	0	-	450	1618	1697	0.9534473
C1	47403166	47403517	BolC1t05304H	0	-	11	286	351	0.8148148
C1	47407514	47407706	BolC1t05305H	0	+	205	192	192	1.0000000
C1	47430156	47431706	BolC1t05306H	0	+	922	1487	1550	0.9593548
C1	47439806	47440971	BolC1t05307H	0	+	790	1165	1165	1.0000000
C1	47441413	47442216	BolC1t05308H	0	-	33	468	803	0.5828145
C1	47453074	47453353	BolC1t05309H	0	+	22	55	279	0.1971326
C1	47454180	47454366	BolC1t05310H	0	+	246	186	186	1.0000000
C1	47455880	47457495	BolC1t05311H	0	+	320	1537	1615	0.9517028
C1	47459731	47460309	BolC1t05312H	0	+	231	578	578	1.0000000
C1	47462184	47464231	BolC1t05313H	0	+	691	1965	2047	0.9599414
C1	47465131	47466829	BolC1t05314H	0	-	974	1625	1698	0.9570082
C1	47475267	47476964	BolC1t05315H	0	-	7	390	1697	0.2298173
C1	47479093	47481399	BolC1t05316H	0	-	157	1603	2306	0.6951431
C1	47504351	47504912	BolC1t05317H	0	-	463	561	561	1.0000000
C1	47507660	47508941	BolC1t05318H	0	+	295	1216	1281	0.9492584
C1	47516863	47517515	BolC1t05319H	0	-	46	439	652	0.6733129
C1	47518195	47518423	BolC1t05320H	0	-	26	185	228	0.8114035
C1	47519487	47520421	BolC1t05321H	0	+	423	928	934	0.9935760
C1	47521875	47523268	BolC1t05322H	0	+	282	1006	1393	0.7221823
C1	47525158	47528716	BolC1t05323H	0	+	1265	3306	3558	0.9291737
C1	47530221	47531147	BolC1t05324H	0	+	234	908	926	0.9805616
C1	47540710	47544573	BolC1t05325H	0	-	129	1812	3863	0.4690655
C1	47545629	47546521	BolC1t05326H	0	-	77	733	892	0.8217489
C1	47547652	47547878	BolC1t05327H	0	+	128	205	226	0.9070796
C1	47549082	47550845	BolC1t05328H	0	+	1399	1752	1763	0.9937606
C1	47561797	47563878	BolC1t05329H	0	+	1399	1853	2081	0.8904373
C1	47575696	47578446	BolC1t05330H	0	-	517	2160	2750	0.7854546
C1	47589615	47590618	BolC1t05331H	0	-	143	713	1003	0.7108674
C1	47591789	47592963	BolC1t05332H	0	-	170	408	1174	0.3475298
C1	47597272	47599154	BolC1t05333H	0	+	521	1817	1882	0.9654623
C1	47600838	47609085	BolC1t05334H	0	+	705	5629	8247	0.6825512
C1	47611348	47612077	BolC1t05335H	0	+	162	695	729	0.9533608
C1	47613545	47616188	BolC1t05336H	0	-	977	2599	2643	0.9833522
C1	47617391	47622689	BolC1t05337H	0	-	1266	3906	5298	0.7372593
C1	47625660	47628748	BolC1t05338H	0	-	784	2868	3088	0.9287565
C1	47629531	47633059	BolC1t05339H	0	-	812	3080	3528	0.8730159
C1	47636636	47637679	BolC1t05340H	0	+	746	1040	1043	0.9971237
C1	47639312	47646498	BolC1t05341H	0	-	1231	3976	7186	0.5532981
C1	47650414	47651408	BolC1t05342H	0	+	372	931	994	0.9366197
C1	47677212	47677503	BolC1t05343H	0	+	309	291	291	1.0000000
C1	47678135	47679450	BolC1t05344H	0	-	1167	1315	1315	1.0000000
C1	47679783	47681203	BolC1t05345H	0	+	805	1369	1420	0.9640845
C1	47683436	47683988	BolC1t05346H	0	+	27	265	552	0.4800725
C1	47685907	47686188	BolC1t05347H	0	-	496	281	281	1.0000000
C1	47688030	47689994	BolC1t05348H	0	+	439	1252	1964	0.6374745
C1	47710751	47711830	BolC1t05349H	0	+	176	786	1079	0.7284523
C1	47714616	47715100	BolC1t05350H	0	-	317	473	484	0.9772727
C1	47716166	47718498	BolC1t05351H	0	+	584	1396	2332	0.5986278
C1	47718867	47720816	BolC1t05352H	0	-	1031	1903	1949	0.9763982
C1	47721861	47722499	BolC1t05353H	0	-	5	216	638	0.3385580
C1	47727279	47728385	BolC1t05354H	0	-	756	1086	1106	0.9819168
C1	47729980	47730765	BolC1t05355H	0	+	65	668	785	0.8509554
C1	47734691	47736136	BolC1t05356H	0	+	810	1348	1445	0.9328720
C1	47737733	47738678	BolC1t05357H	0	-	420	945	945	1.0000000
C1	47739872	47740506	BolC1t05358H	0	-	159	634	634	1.0000000
C1	47744905	47745265	BolC1t05359H	0	-	337	360	360	1.0000000
C1	47751648	47755281	BolC1t05360H	0	+	3499	3633	3633	1.0000000
C1	47761362	47762336	BolC1t05361H	0	+	634	974	974	1.0000000
C1	47763664	47766314	BolC1t05362H	0	+	940	2343	2650	0.8841509
C1	47768229	47769282	BolC1t05363H	0	-	132	732	1053	0.6951567
C1	47781987	47783744	BolC1t05364H	0	-	196	574	1757	0.3266932
C1	47795753	47797325	BolC1t05365H	0	+	231	1526	1572	0.9707379
C1	47805726	47808142	BolC1t05366H	0	-	458	1868	2416	0.7731788
C1	47810926	47820635	BolC1t05367H	0	+	1742	4210	9709	0.4336183
C1	47822500	47824485	BolC1t05368H	0	-	1368	1985	1985	1.0000000
C1	47826358	47855694	BolC1t05369H	0	+	8862	22844	29336	0.7787020
C1	47839798	47842762	BolC1t05370H	0	-	158	1278	2964	0.4311741
C1	47840253	47841068	BolC1t05371H	0	-	0	0	815	0.0000000
C1	47845884	47847165	BolC1t05372H	0	-	753	1281	1281	1.0000000
C1	47855973	47857461	BolC1t05373H	0	+	266	1488	1488	1.0000000
C1	47858132	47859404	BolC1t05374H	0	-	349	1272	1272	1.0000000
C1	47861532	47861918	BolC1t05375H	0	+	305	386	386	1.0000000
C1	47878364	47879597	BolC1t05376H	0	-	390	1221	1233	0.9902676
C1	47884892	47885066	BolC1t05377H	0	-	174	174	174	1.0000000
C1	47887819	47888023	BolC1t05378H	0	-	39	204	204	1.0000000
C1	47908647	47908839	BolC1t05379H	0	-	90	192	192	1.0000000
C1	47914739	47917948	BolC1t05380H	0	-	211	1789	3209	0.5574945
C1	47921589	47922636	BolC1t05381H	0	+	1143	1047	1047	1.0000000
C1	47923085	47924059	BolC1t05382H	0	+	559	947	974	0.9722793
C1	47930743	47933743	BolC1t05383H	0	-	574	2057	3000	0.6856667
C1	47936971	47941865	BolC1t05384H	0	+	3581	4894	4894	1.0000000
C1	47942827	47945551	BolC1t05385H	0	-	1839	2614	2724	0.9596182
C1	47953785	47954019	BolC1t05386H	0	-	34	234	234	1.0000000
C1	47957254	47959509	BolC1t05387H	0	-	887	2163	2255	0.9592018
C1	47975482	47975863	BolC1t05388H	0	+	11	62	381	0.1627297
C1	47977897	47979976	BolC1t05389H	0	+	1720	2079	2079	1.0000000
C1	47980796	47983847	BolC1t05390H	0	-	1613	2974	3051	0.9747624
C1	47990793	47993105	BolC1t05391H	0	-	849	1879	2312	0.8127162
C1	47994156	47996252	BolC1t05392H	0	-	1261	2096	2096	1.0000000
C1	47997922	47999854	BolC1t05393H	0	-	558	1890	1932	0.9782609
C1	48003584	48004754	BolC1t05394H	0	-	199	760	1170	0.6495727
C1	48012756	48014571	BolC1t05395H	0	-	708	1563	1815	0.8611570
C1	48016481	48018859	BolC1t05396H	0	-	696	1454	2378	0.6114382
C1	48019355	48020567	BolC1t05397H	0	+	306	1052	1212	0.8679868
C1	48022437	48023583	BolC1t05398H	0	+	158	1126	1146	0.9825480
C1	48030666	48031851	BolC1t05399H	0	+	95	784	1185	0.6616034
C1	48032978	48033963	BolC1t05400H	0	+	1065	985	985	1.0000000
C1	48035099	48036278	BolC1t05401H	0	+	404	942	1179	0.7989822
C1	48036844	48037069	BolC1t05402H	0	-	176	225	225	1.0000000
C1	48038215	48041517	BolC1t05403H	0	+	1039	2649	3302	0.8022411
C1	48042149	48050072	BolC1t05404H	0	+	1526	6485	7923	0.8185031
C1	48050822	48053735	BolC1t05405H	0	-	1713	2775	2913	0.9526262
C1	48058525	48059590	BolC1t05406H	0	-	623	1034	1065	0.9708920
C1	48060316	48062491	BolC1t05407H	0	-	1350	2175	2175	1.0000000
C1	48068678	48070005	BolC1t05408H	0	-	672	1162	1327	0.8756594
C1	48071180	48072623	BolC1t05409H	0	+	767	1194	1443	0.8274428
C1	48072913	48074974	BolC1t05410H	0	+	304	1759	2061	0.8534692
C1	48076836	48078828	BolC1t05411H	0	+	1308	1992	1992	1.0000000
C1	48082923	48083530	BolC1t05412H	0	+	286	607	607	1.0000000
C1	48086631	48090318	BolC1t05413H	0	+	2171	3393	3687	0.9202604
C1	48097142	48098421	BolC1t05414H	0	+	473	1223	1279	0.9562158
C1	48108084	48108417	BolC1t05415H	0	+	439	333	333	1.0000000
C1	48122192	48122516	BolC1t05416H	0	+	580	324	324	1.0000000
C1	48135658	48135985	BolC1t05417H	0	+	356	327	327	1.0000000
C1	48141052	48141712	BolC1t05418H	0	-	48	581	660	0.8803030
C1	48143895	48147700	BolC1t05419H	0	+	1627	3722	3805	0.9781866
C1	48151786	48152302	BolC1t05420H	0	-	316	516	516	1.0000000
C1	48158672	48159413	BolC1t05421H	0	+	134	676	741	0.9122807
C1	48167705	48168203	BolC1t05422H	0	+	588	498	498	1.0000000
C1	48177392	48181373	BolC1t05423H	0	+	706	3342	3981	0.8394876
C1	48182963	48183200	BolC1t05424H	0	+	26	237	237	1.0000000
C1	48190354	48190534	BolC1t05425H	0	+	0	0	180	0.0000000
C1	48200876	48202790	BolC1t05426H	0	+	16	195	1914	0.1018809
C1	48203394	48203978	BolC1t05427H	0	-	0	0	584	0.0000000
C1	48205980	48207199	BolC1t05428H	0	+	0	0	1219	0.0000000
C1	48208195	48211139	BolC1t05429H	0	-	531	2787	2944	0.9466712
C1	48212111	48214571	BolC1t05430H	0	-	564	2158	2460	0.8772358
C1	48218638	48220792	BolC1t05431H	0	-	593	1958	2154	0.9090065
C1	48221394	48222502	BolC1t05432H	0	+	1008	1108	1108	1.0000000
C1	48237757	48239044	BolC1t05433H	0	+	880	1287	1287	1.0000000
C1	48239837	48241506	BolC1t05434H	0	-	910	1669	1669	1.0000000
C1	48245990	48246203	BolC1t05435H	0	+	113	213	213	1.0000000
C1	48246742	48248554	BolC1t05436H	0	-	1334	1812	1812	1.0000000
C1	48249067	48251807	BolC1t05437H	0	+	1703	2740	2740	1.0000000
C1	48254731	48255031	BolC1t05438H	0	+	397	300	300	1.0000000
C1	48255975	48256545	BolC1t05439H	0	+	439	570	570	1.0000000
C1	48261272	48265935	BolC1t05440H	0	+	1061	3806	4663	0.8162127
C1	48266585	48268935	BolC1t05441H	0	-	883	2350	2350	1.0000000
C1	48269141	48270570	BolC1t05442H	0	+	829	1429	1429	1.0000000
C1	48271091	48272861	BolC1t05443H	0	-	929	1747	1770	0.9870057
C1	48273119	48274845	BolC1t05444H	0	-	250	1536	1726	0.8899189
C1	48275896	48276101	BolC1t05445H	0	+	337	205	205	1.0000000
C1	48276919	48278767	BolC1t05446H	0	-	1092	1848	1848	1.0000000
C1	48285489	48288935	BolC1t05447H	0	+	2511	3350	3446	0.9721416
C1	48292040	48293933	BolC1t05448H	0	-	379	1863	1893	0.9841521
C1	48301324	48301968	BolC1t05449H	0	-	287	644	644	1.0000000
C1	48311881	48312429	BolC1t05450H	0	-	72	548	548	1.0000000
C1	48312918	48314726	BolC1t05451H	0	+	402	1297	1808	0.7173672
C1	48322480	48323272	BolC1t05452H	0	+	339	610	792	0.7702020
C1	48330392	48333105	BolC1t05453H	0	+	968	2611	2713	0.9624032
C1	48334994	48336626	BolC1t05454H	0	+	679	1514	1632	0.9276960
C1	48337025	48339401	BolC1t05455H	0	-	615	2210	2376	0.9301347
C1	48341256	48341814	BolC1t05456H	0	-	106	558	558	1.0000000
C1	48341865	48342267	BolC1t05457H	0	-	90	366	402	0.9104478
C1	48344205	48344730	BolC1t05458H	0	+	0	0	525	0.0000000
C1	48353558	48354116	BolC1t05459H	0	+	170	522	558	0.9354839
C1	48358595	48359600	BolC1t05460H	0	+	22	623	1005	0.6199005
C1	48360226	48362385	BolC1t05461H	0	-	532	2106	2159	0.9754516
C1	48366988	48367504	BolC1t05462H	0	-	861	516	516	1.0000000
C1	48404822	48408022	BolC1t05463H	0	-	586	2444	3200	0.7637500
C1	48411267	48411847	BolC1t05464H	0	+	52	518	580	0.8931034
C1	48420341	48427222	BolC1t05465H	0	-	1365	6296	6881	0.9149833
C1	48452872	48453939	BolC1t05466H	0	+	100	862	1067	0.8078725
C1	48463049	48466349	BolC1t05467H	0	+	1547	3059	3300	0.9269697
C1	48468456	48469724	BolC1t05468H	0	-	279	1202	1268	0.9479495
C1	48475431	48478169	BolC1t05469H	0	+	1178	2736	2738	0.9992695
C1	48478615	48480521	BolC1t05470H	0	-	1132	1886	1906	0.9895068
C1	48481467	48482722	BolC1t05471H	0	+	895	1255	1255	1.0000000
C1	48483143	48485236	BolC1t05472H	0	+	1087	2022	2093	0.9660774
C1	48490881	48495183	BolC1t05473H	0	+	944	3732	4302	0.8675035
C1	48495380	48495719	BolC1t05474H	0	-	83	293	339	0.8643068
C1	48496065	48501208	BolC1t05475H	0	+	988	4484	5143	0.8718647
C1	48516128	48518018	BolC1t05476H	0	+	1035	1876	1890	0.9925926
C1	48518454	48519486	BolC1t05477H	0	-	199	1032	1032	1.0000000
C1	48522127	48522538	BolC1t05478H	0	+	76	411	411	1.0000000
C1	48524359	48525556	BolC1t05479H	0	-	61	837	1197	0.6992481
C1	48527525	48529309	BolC1t05480H	0	-	615	1781	1784	0.9983184
C1	48531557	48532840	BolC1t05481H	0	+	765	1283	1283	1.0000000
C1	48533260	48535242	BolC1t05482H	0	-	1586	1982	1982	1.0000000
C1	48537690	48538627	BolC1t05483H	0	-	1292	937	937	1.0000000
C1	48542622	48545176	BolC1t05484H	0	-	1202	2502	2554	0.9796398
C1	48548625	48550590	BolC1t05485H	0	+	1353	1899	1965	0.9664122
C1	48552009	48552415	BolC1t05486H	0	-	143	406	406	1.0000000
C1	48555414	48557562	BolC1t05487H	0	+	148	1047	2148	0.4874302
C1	48563387	48563666	BolC1t05488H	0	+	368	279	279	1.0000000
C1	48565146	48568270	BolC1t05489H	0	-	111	1472	3124	0.4711908
C1	48570600	48572743	BolC1t05490H	0	+	1411	2143	2143	1.0000000
C1	48580892	48585834	BolC1t05491H	0	+	2497	4905	4942	0.9925132
C1	48607436	48607801	BolC1t05492H	0	+	46	363	365	0.9945205
C1	48612672	48616918	BolC1t05493H	0	-	3361	4180	4246	0.9844559
C1	48630419	48630629	BolC1t05494H	0	+	0	0	210	0.0000000
C1	48632476	48632962	BolC1t05495H	0	-	40	473	486	0.9732510
C1	48638445	48639153	BolC1t05496H	0	-	22	11	708	0.0155367
C1	48647557	48650237	BolC1t05497H	0	+	672	2570	2680	0.9589552
C1	48653333	48654359	BolC1t05498H	0	-	309	1017	1026	0.9912280
C1	48656354	48656681	BolC1t05499H	0	+	116	327	327	1.0000000
C1	48657812	48660531	BolC1t05500H	0	-	1033	2643	2719	0.9720485
C1	48662212	48662480	BolC1t05501H	0	-	206	268	268	1.0000000
C1	48662839	48665724	BolC1t05502H	0	+	783	2562	2885	0.8880416
C1	48666973	48667420	BolC1t05503H	0	+	18	256	447	0.5727069
C1	48670795	48671567	BolC1t05504H	0	+	117	162	772	0.2098446
C1	48685013	48686144	BolC1t05505H	0	+	679	1060	1131	0.9372237
C1	48690254	48693930	BolC1t05506H	0	+	1166	2887	3676	0.7853645
C1	48694694	48697349	BolC1t05507H	0	-	513	1893	2655	0.7129943
C1	48700217	48703585	BolC1t05508H	0	+	1236	3087	3368	0.9165677
C1	48706349	48707107	BolC1t05509H	0	+	126	361	758	0.4762533
C1	48707450	48708393	BolC1t05510H	0	+	0	0	943	0.0000000
C1	48726114	48727002	BolC1t05511H	0	-	2	149	888	0.1677928
C1	48728651	48729998	BolC1t05512H	0	-	190	269	1347	0.1997030
C1	48732735	48733759	BolC1t05513H	0	-	0	0	1024	0.0000000
C1	48739463	48740243	BolC1t05514H	0	-	497	780	780	1.0000000
C1	48740861	48743683	BolC1t05515H	0	-	423	1970	2822	0.6980864
C1	48761443	48763614	BolC1t05516H	0	-	946	2060	2171	0.9488715
C1	48764788	48766739	BolC1t05517H	0	-	1870	1951	1951	1.0000000
C1	48769510	48770182	BolC1t05518H	0	+	84	617	672	0.9181548
C1	48779127	48779765	BolC1t05519H	0	+	163	638	638	1.0000000
C1	48786504	48788836	BolC1t05520H	0	+	921	2137	2332	0.9163808
C1	48789496	48790820	BolC1t05521H	0	-	84	861	1324	0.6503021
C1	48792774	48794419	BolC1t05522H	0	+	48	350	1645	0.2127660
C1	48800376	48802012	BolC1t05523H	0	+	4	16	1636	0.0097800
C1	48813454	48813810	BolC1t05524H	0	+	1	2	356	0.0056180
C1	48814142	48815088	BolC1t05525H	0	+	0	0	946	0.0000000
C1	48816389	48816605	BolC1t05526H	0	+	0	0	216	0.0000000
C1	48817974	48818136	BolC1t05527H	0	+	0	0	162	0.0000000
C1	48826341	48827898	BolC1t05528H	0	+	169	1389	1557	0.8921002
C1	48832630	48834619	BolC1t05529H	0	+	247	1550	1989	0.7792861
C1	48836119	48837993	BolC1t05530H	0	-	560	1784	1874	0.9519744
C1	48839478	48840423	BolC1t05531H	0	+	307	945	945	1.0000000
C1	48841161	48842646	BolC1t05532H	0	-	433	1409	1485	0.9488215
C1	48849368	48851396	BolC1t05533H	0	-	272	1574	2028	0.7761341
C1	48856956	48857227	BolC1t05534H	0	-	171	201	271	0.7416974
C1	48858598	48859630	BolC1t05535H	0	-	312	865	1032	0.8381783
C1	48863209	48864645	BolC1t05536H	0	-	710	1436	1436	1.0000000
C1	48865456	48866881	BolC1t05537H	0	-	1111	1409	1425	0.9887719
C1	48867849	48872421	BolC1t05538H	0	-	1546	4120	4572	0.9011374
C1	48873993	48878251	BolC1t05539H	0	+	2067	3933	4258	0.9236731
C1	48879388	48880961	BolC1t05540H	0	-	444	1284	1573	0.8162746
C1	48887832	48891440	BolC1t05541H	0	+	1461	2777	3608	0.7696785
C1	48891748	48892244	BolC1t05542H	0	-	482	496	496	1.0000000
C1	48894322	48896222	BolC1t05543H	0	+	442	568	1900	0.2989474
C1	48897110	48899072	BolC1t05544H	0	+	2776	1906	1962	0.9714577
C1	48902286	48903024	BolC1t05545H	0	-	380	430	738	0.5826558
C1	48903612	48904588	BolC1t05546H	0	+	636	872	976	0.8934426
C1	48905592	48906042	BolC1t05547H	0	-	79	410	450	0.9111111
C1	48910080	48911001	BolC1t05548H	0	+	69	741	921	0.8045602
C1	48914848	48915559	BolC1t05549H	0	-	99	599	711	0.8424754
C1	48916221	48917465	BolC1t05550H	0	+	356	719	1244	0.5779743
C1	48918406	48919698	BolC1t05551H	0	+	2	21	1292	0.0162539
C1	48920452	48921151	BolC1t05552H	0	-	30	422	699	0.6037196
C1	48935814	48937398	BolC1t05553H	0	-	253	1442	1584	0.9103535
C1	48951723	48952626	BolC1t05554H	0	-	10	293	903	0.3244740
C1	48958275	48959679	BolC1t05555H	0	+	49	425	1404	0.3027065
C1	48961204	48962139	BolC1t05556H	0	-	76	398	935	0.4256684
C1	48967196	48969989	BolC1t05557H	0	-	2	19	2793	0.0068027
C1	48973193	48973608	BolC1t05558H	0	-	14	312	415	0.7518072
C1	48975747	48978385	BolC1t05559H	0	+	596	2467	2638	0.9351782
C1	48983518	48986062	BolC1t05560H	0	+	224	1997	2544	0.7849843
C1	48987291	48989247	BolC1t05561H	0	+	791	1488	1956	0.7607362
C1	48989782	48991903	BolC1t05562H	0	-	103	1153	2121	0.5436115
C1	48995626	48995839	BolC1t05563H	0	+	34	213	213	1.0000000
C1	49002121	49003483	BolC1t05564H	0	+	648	725	1362	0.5323054
C1	49005692	49006457	BolC1t05565H	0	-	117	765	765	1.0000000
C1	49009092	49020834	BolC1t05566H	0	+	2525	9090	11742	0.7741441
C1	49023615	49026150	BolC1t05567H	0	+	274	1925	2535	0.7593688
C1	49026355	49027390	BolC1t05568H	0	-	167	674	1035	0.6512077
C1	49029587	49036385	BolC1t05569H	0	+	1170	5183	6798	0.7624301
C1	49036494	49038300	BolC1t05570H	0	-	231	1635	1806	0.9053156
C1	49038922	49040913	BolC1t05571H	0	-	28	514	1991	0.2581617
C1	49043662	49046352	BolC1t05572H	0	+	771	2578	2690	0.9583643
C1	49048818	49051596	BolC1t05573H	0	+	2511	2727	2778	0.9816415
C1	49078638	49081881	BolC1t05574H	0	+	652	2563	3243	0.7903176
C1	49092710	49093027	BolC1t05575H	0	-	114	299	317	0.9432177
C1	49099025	49099235	BolC1t05576H	0	-	49	116	210	0.5523810
C1	49099647	49101503	BolC1t05577H	0	+	785	1341	1856	0.7225215
C1	49103377	49105283	BolC1t05578H	0	+	669	805	1906	0.4223505
C1	49109048	49109757	BolC1t05579H	0	+	92	485	709	0.6840621
C1	49111854	49112901	BolC1t05580H	0	-	1731	1047	1047	1.0000000
C1	49115235	49123469	BolC1t05581H	0	-	1675	5435	8234	0.6600680
C1	49123852	49124331	BolC1t05582H	0	+	71	56	479	0.1169102
C1	49127259	49127891	BolC1t05583H	0	-	771	632	632	1.0000000
C1	49130330	49133542	BolC1t05584H	0	-	2027	2827	3212	0.8801370
C1	49134259	49134525	BolC1t05585H	0	-	432	266	266	1.0000000
C1	49135342	49136481	BolC1t05586H	0	+	1022	1139	1139	1.0000000
C1	49138583	49139790	BolC1t05587H	0	+	1006	1134	1207	0.9395195
C1	49140648	49142610	BolC1t05588H	0	-	553	1733	1962	0.8832824
C1	49162465	49163077	BolC1t05589H	0	-	522	612	612	1.0000000
C1	49163738	49165166	BolC1t05590H	0	-	148	782	1428	0.5476190
C1	49165472	49165741	BolC1t05591H	0	+	96	254	269	0.9442379
C1	49167069	49173781	BolC1t05592H	0	+	5975	6484	6712	0.9660310
C1	49174823	49176715	BolC1t05593H	0	-	1455	1626	1892	0.8594080
C1	49178995	49180030	BolC1t05594H	0	-	80	884	1035	0.8541063
C1	49182843	49183104	BolC1t05595H	0	+	4	100	261	0.3831418
C1	49187123	49189122	BolC1t05596H	0	+	538	1487	1999	0.7438719
C1	49190725	49191049	BolC1t05597H	0	-	182	311	324	0.9598765
C1	49209254	49213539	BolC1t05598H	0	+	554	2590	4285	0.6044341
C1	49214263	49215112	BolC1t05599H	0	-	472	700	849	0.8244994
C1	49215419	49216237	BolC1t05600H	0	+	235	747	818	0.9132029
C1	49221983	49222685	BolC1t05601H	0	+	211	617	702	0.8789174
C1	49226907	49229670	BolC1t05602H	0	+	748	2609	2763	0.9442635
C1	49231150	49234706	BolC1t05603H	0	+	745	2922	3556	0.8217098
C1	49243273	49243773	BolC1t05604H	0	-	0	0	500	0.0000000
C1	49244334	49244739	BolC1t05605H	0	+	6	165	405	0.4074074
C1	49247506	49248406	BolC1t05606H	0	-	18	140	900	0.1555556
C1	49250380	49250911	BolC1t05607H	0	+	182	531	531	1.0000000
C1	49259122	49262445	BolC1t05608H	0	-	405	2275	3323	0.6846223
C1	49270021	49272185	BolC1t05609H	0	-	121	643	2164	0.2971349
C1	49285184	49286314	BolC1t05610H	0	-	646	1120	1130	0.9911504
C1	49287064	49287455	BolC1t05611H	0	-	8	391	391	1.0000000
C1	49291832	49292465	BolC1t05612H	0	-	78	584	633	0.9225909
C1	49297176	49297374	BolC1t05613H	0	-	18	154	198	0.7777778
C1	49305575	49306391	BolC1t05614H	0	-	6	353	816	0.4325980
C1	49311001	49311817	BolC1t05615H	0	-	28	528	816	0.6470588
C1	49314370	49314856	BolC1t05616H	0	-	299	445	486	0.9156379
C1	49320325	49320607	BolC1t05617H	0	+	37	282	282	1.0000000
C1	49331140	49332025	BolC1t05618H	0	-	12	215	885	0.2429378
C1	49334517	49335345	BolC1t05619H	0	-	145	339	828	0.4094203
C1	49340614	49342731	BolC1t05620H	0	+	262	1613	2117	0.7619272
C1	49353032	49353590	BolC1t05621H	0	+	8	19	558	0.0340502
C1	49357208	49357628	BolC1t05622H	0	-	463	420	420	1.0000000
C1	49375551	49377370	BolC1t05623H	0	+	161	1381	1819	0.7592084
C1	49377796	49383049	BolC1t05624H	0	-	1089	4252	5253	0.8094422
C1	49388185	49391803	BolC1t05625H	0	+	548	2945	3618	0.8139856
C1	49404082	49405335	BolC1t05626H	0	+	15	494	1253	0.3942538
C1	49406214	49408444	BolC1t05627H	0	+	408	1660	2230	0.7443946
C1	49410099	49410480	BolC1t05628H	0	-	4	157	381	0.4120735
C1	49411799	49415255	BolC1t05629H	0	+	1167	2858	3456	0.8269676
C1	49415866	49418386	BolC1t05630H	0	-	701	2000	2520	0.7936508
C1	49433519	49434107	BolC1t05631H	0	-	42	431	588	0.7329932
C1	49438479	49439246	BolC1t05632H	0	-	1	35	767	0.0456323
C1	49598702	49599818	BolC1t05633H	0	-	442	1096	1116	0.9820789
C1	49602088	49603144	BolC1t05634H	0	+	35	694	1056	0.6571970
C1	49608973	49610868	BolC1t05635H	0	+	492	1798	1895	0.9488127
C1	49612786	49612942	BolC1t05636H	0	-	8	103	156	0.6602564
C1	49623493	49625517	BolC1t05637H	0	-	122	972	2024	0.4802372
C1	49626609	49627940	BolC1t05638H	0	-	148	813	1331	0.6108189
C1	49638011	49638547	BolC1t05639H	0	+	200	526	536	0.9813433
C1	49641752	49641896	BolC1t05640H	0	+	38	144	144	1.0000000
C1	49642860	49643624	BolC1t05641H	0	+	0	0	764	0.0000000
C1	49647652	49653172	BolC1t05642H	0	+	1699	4107	5520	0.7440217
C1	49653550	49653934	BolC1t05643H	0	-	0	0	384	0.0000000
C1	49655727	49658466	BolC1t05644H	0	+	794	2173	2739	0.7933552
C1	49659260	49659941	BolC1t05645H	0	-	702	681	681	1.0000000
C1	49660734	49661307	BolC1t05646H	0	+	204	573	573	1.0000000
C1	49662046	49664105	BolC1t05647H	0	+	105	1372	2059	0.6663429
C1	49666947	49670385	BolC1t05648H	0	-	1478	3037	3438	0.8833624
C1	49698809	49699831	BolC1t05649H	0	+	36	596	1022	0.5831702
C1	49700759	49701093	BolC1t05650H	0	+	0	0	334	0.0000000
C1	49701163	49702043	BolC1t05651H	0	+	0	0	880	0.0000000
C1	49703056	49703921	BolC1t05652H	0	-	553	865	865	1.0000000
C1	49704865	49705328	BolC1t05653H	0	+	488	463	463	1.0000000
C1	49706008	49707530	BolC1t05654H	0	+	121	926	1522	0.6084100
C1	49709869	49710130	BolC1t05655H	0	+	83	261	261	1.0000000
C1	49711216	49711496	BolC1t05656H	0	+	147	280	280	1.0000000
C1	49712506	49712761	BolC1t05657H	0	-	55	205	255	0.8039216
C1	49714085	49715195	BolC1t05658H	0	+	282	667	1110	0.6009009
C1	49718414	49718684	BolC1t05659H	0	-	269	270	270	1.0000000
C1	49724194	49726663	BolC1t05660H	0	+	518	2163	2469	0.8760632
C1	49727058	49729329	BolC1t05661H	0	-	183	1677	2271	0.7384412
C1	49731755	49732002	BolC1t05662H	0	-	259	247	247	1.0000000
C1	49732749	49735584	BolC1t05663H	0	+	604	2308	2835	0.8141093
C1	49736502	49737695	BolC1t05664H	0	+	2	156	1193	0.1307628
C1	49738175	49738682	BolC1t05665H	0	+	3	223	507	0.4398422
C1	49746155	49746752	BolC1t05666H	0	-	29	469	597	0.7855946
C1	49751404	49758446	BolC1t05667H	0	+	2287	4774	7042	0.6779324
C1	49760884	49761484	BolC1t05668H	0	+	469	591	600	0.9850000
C1	49762061	49763328	BolC1t05669H	0	+	228	875	1267	0.6906077
C1	49764247	49765373	BolC1t05670H	0	-	287	933	1126	0.8285968
C1	49767085	49770672	BolC1t05671H	0	+	232	930	3587	0.2592696
C1	49774120	49774693	BolC1t05672H	0	+	20	344	573	0.6003491
C1	49777536	49777938	BolC1t05673H	0	-	176	328	402	0.8159204
C1	49778160	49779130	BolC1t05674H	0	+	307	927	970	0.9556701
C1	49782949	49783739	BolC1t05675H	0	-	298	434	790	0.5493671
C1	49784450	49785077	BolC1t05676H	0	-	194	575	627	0.9170654
C1	49785987	49788136	BolC1t05677H	0	-	1497	1983	2149	0.9227548
C1	49793857	49795566	BolC1t05678H	0	+	1063	1524	1709	0.8917496
C1	49796933	49797343	BolC1t05679H	0	+	75	214	410	0.5219512
C1	49810838	49814435	BolC1t05680H	0	+	879	3006	3597	0.8356964
C1	49814828	49819668	BolC1t05681H	0	-	2663	4200	4840	0.8677686
C1	49822321	49824880	BolC1t05682H	0	+	997	1968	2559	0.7690504
C1	49825359	49826262	BolC1t05683H	0	-	335	785	903	0.8693244
C1	49829070	49830660	BolC1t05684H	0	+	241	1162	1590	0.7308176
C1	49832924	49834133	BolC1t05685H	0	+	677	1178	1209	0.9743590
C1	49834468	49835712	BolC1t05686H	0	-	2396	1212	1244	0.9742765
C1	49836848	49837963	BolC1t05687H	0	-	1044	1115	1115	1.0000000
C1	49838521	49839016	BolC1t05688H	0	-	251	489	495	0.9878788
C1	49839583	49840055	BolC1t05689H	0	-	246	472	472	1.0000000
C1	49841174	49843846	BolC1t05690H	0	-	519	1907	2672	0.7136976
C1	49878190	49885719	BolC1t05691H	0	-	1762	5819	7529	0.7728782
C1	49886754	49887939	BolC1t05692H	0	-	56	947	1185	0.7991561
C1	49892705	49893047	BolC1t05693H	0	-	13	204	342	0.5964912
C1	49897477	49898032	BolC1t05694H	0	-	0	0	555	0.0000000
C1	49898877	49903179	BolC1t05695H	0	-	296	2897	4302	0.6734077
C1	49932291	49951324	BolC1t05696H	0	+	10126	8388	19033	0.4407082
C1	49942801	49943389	BolC1t05697H	0	+	13	419	588	0.7125850
C1	49952167	49957135	BolC1t05698H	0	-	747	2829	4968	0.5694444
C1	49958442	49961433	BolC1t05699H	0	+	417	1579	2991	0.5279171
C1	49963187	49965295	BolC1t05700H	0	+	511	1417	2108	0.6722012
C1	49966556	49967366	BolC1t05701H	0	+	215	785	810	0.9691358
C1	49968866	49970141	BolC1t05702H	0	+	45	790	1275	0.6196079
C1	49970421	49972469	BolC1t05703H	0	-	83	676	2048	0.3300781
C1	49973949	49975423	BolC1t05704H	0	+	374	1316	1474	0.8928087
C1	49981078	49983279	BolC1t05705H	0	-	820	2201	2201	1.0000000
C1	49992209	49993367	BolC1t05706H	0	-	67	739	1158	0.6381692
C1	49994035	49995825	BolC1t05707H	0	-	1686	1616	1790	0.9027933
C1	49995957	49997871	BolC1t05708H	0	-	360	1258	1914	0.6572623
C1	49999542	50000532	BolC1t05709H	0	-	0	0	990	0.0000000
C1	50002469	50002756	BolC1t05710H	0	+	53	287	287	1.0000000
C1	50003834	50006012	BolC1t05711H	0	+	551	1874	2178	0.8604224
C1	50006182	50007392	BolC1t05712H	0	-	303	1210	1210	1.0000000
C1	50008558	50009398	BolC1t05713H	0	-	84	730	840	0.8690476
C1	50010149	50013022	BolC1t05714H	0	-	335	2143	2873	0.7459102
C1	50016726	50016879	BolC1t05715H	0	+	0	0	153	0.0000000
C1	50019095	50019585	BolC1t05716H	0	-	0	0	490	0.0000000
C1	50034895	50035145	BolC1t05717H	0	-	83	250	250	1.0000000
C1	50140444	50143580	BolC1t05718H	0	+	1	30	3136	0.0095663
C1	50146760	50154015	BolC1t05719H	0	+	3474	4253	7255	0.5862164
C1	50156408	50157210	BolC1t05720H	0	+	317	741	802	0.9239401
C1	50158024	50159389	BolC1t05721H	0	+	196	960	1365	0.7032967
C1	50159943	50162317	BolC1t05722H	0	+	651	1634	2374	0.6882898
C1	50164275	50169354	BolC1t05723H	0	+	819	3171	5079	0.6243355
C1	50169892	50170741	BolC1t05724H	0	+	580	724	849	0.8527679
C1	50171885	50174577	BolC1t05725H	0	-	756	2530	2692	0.9398217
C1	50175745	50177263	BolC1t05726H	0	+	350	1376	1518	0.9064559
C1	50181150	50182895	BolC1t05727H	0	+	529	1395	1745	0.7994269
C1	50185895	50186441	BolC1t05728H	0	-	292	546	546	1.0000000
C1	50188927	50190091	BolC1t05729H	0	-	843	943	1164	0.8101375
C1	50191348	50192223	BolC1t05730H	0	-	189	716	875	0.8182857
C1	50193193	50194322	BolC1t05731H	0	-	825	1053	1129	0.9326838
C1	50199966	50200407	BolC1t05732H	0	+	192	441	441	1.0000000
C1	50202388	50203246	BolC1t05733H	0	+	719	827	858	0.9638695
C1	50203619	50205787	BolC1t05734H	0	+	113	303	2168	0.1397602
C1	50206018	50206609	BolC1t05735H	0	-	62	555	591	0.9390863
C1	50218278	50221499	BolC1t05736H	0	-	1476	2668	3221	0.8283142
C1	50222894	50224895	BolC1t05737H	0	+	302	1196	2001	0.5977011
C1	50225144	50227460	BolC1t05738H	0	-	345	1551	2316	0.6696891
C1	50228091	50228295	BolC1t05739H	0	+	89	204	204	1.0000000
C1	50231384	50234275	BolC1t05740H	0	+	387	1792	2891	0.6198547
C1	50242831	50243779	BolC1t05741H	0	-	34	444	948	0.4683544
C1	50247715	50247937	BolC1t05742H	0	+	446	95	222	0.4279279
C1	50253392	50254820	BolC1t05743H	0	-	258	1042	1428	0.7296919
C1	50258774	50259347	BolC1t05744H	0	+	3	95	573	0.1657941
C1	50266667	50267269	BolC1t05745H	0	-	727	602	602	1.0000000
C1	50278949	50279816	BolC1t05746H	0	+	6	23	867	0.0265283
C1	50281160	50281907	BolC1t05747H	0	-	1	62	747	0.0829987
C1	50284832	50285255	BolC1t05748H	0	-	0	0	423	0.0000000
C1	50289828	50290797	BolC1t05749H	0	+	0	0	969	0.0000000
C1	50293800	50295075	BolC1t05750H	0	-	42	499	1275	0.3913726
C1	50321457	50322639	BolC1t05751H	0	+	0	0	1182	0.0000000
C1	50326921	50327089	BolC1t05752H	0	+	36	168	168	1.0000000
C1	50328568	50331430	BolC1t05753H	0	+	583	2550	2862	0.8909853
C1	50331721	50332097	BolC1t05754H	0	-	446	376	376	1.0000000
C1	50338093	50338315	BolC1t05755H	0	+	173	222	222	1.0000000
C1	50346661	50348578	BolC1t05756H	0	+	152	1299	1917	0.6776213
C1	50357518	50363697	BolC1t05757H	0	+	2847	4883	6179	0.7902573
C1	50364503	50365256	BolC1t05758H	0	+	270	498	753	0.6613546
C1	50366865	50372421	BolC1t05759H	0	+	3413	5193	5556	0.9346652
C1	50373754	50374195	BolC1t05760H	0	+	122	441	441	1.0000000
C1	50374998	50377447	BolC1t05761H	0	-	968	2259	2449	0.9224173
C1	50378284	50381254	BolC1t05762H	0	-	717	2795	2970	0.9410775
C1	50384147	50384267	BolC1t05763H	0	-	77	120	120	1.0000000
C1	50394348	50394912	BolC1t05764H	0	-	126	390	564	0.6914893
C1	50396472	50401446	BolC1t05765H	0	+	3463	4697	4974	0.9443104
C1	50408544	50408835	BolC1t05766H	0	+	31	251	291	0.8625429
C1	50411907	50413355	BolC1t05767H	0	+	347	1135	1448	0.7838398
C1	50430339	50431704	BolC1t05768H	0	+	77	1013	1365	0.7421246
C1	50477260	50479027	BolC1t05769H	0	-	604	1629	1767	0.9219015
C1	50483491	50485162	BolC1t05770H	0	+	199	1446	1671	0.8653501
C1	50485509	50486593	BolC1t05771H	0	-	67	658	1084	0.6070111
C1	50490058	50490372	BolC1t05772H	0	-	58	293	314	0.9331210
C1	50491233	50491371	BolC1t05773H	0	+	280	138	138	1.0000000
C1	50492779	50493583	BolC1t05774H	0	-	19	131	804	0.1629353
C1	50500859	50501213	BolC1t05775H	0	+	188	354	354	1.0000000
C1	50501565	50501895	BolC1t05776H	0	+	348	330	330	1.0000000
C1	50513054	50513228	BolC1t05777H	0	-	1	9	174	0.0517241
C1	50513875	50514893	BolC1t05778H	0	+	329	926	1018	0.9096267
C1	50517055	50517895	BolC1t05779H	0	+	193	821	840	0.9773809
C1	50520569	50520768	BolC1t05780H	0	-	0	0	199	0.0000000
C1	50525091	50555159	BolC1t05781H	0	+	1984	11613	30068	0.3862246
C1	50555399	50573896	BolC1t05782H	0	-	1371	7400	18497	0.4000649
C1	50566089	50566263	BolC1t05783H	0	-	0	0	174	0.0000000
C1	50566947	50568457	BolC1t05784H	0	+	62	646	1510	0.4278146
C1	50569459	50604661	BolC1t05785H	0	+	2974	17495	35202	0.4969888
C1	50574787	50575252	BolC1t05786H	0	+	0	0	465	0.0000000
C1	50575758	50606707	BolC1t05787H	0	-	2685	14729	30949	0.4759120
C1	50610661	50629758	BolC1t05788H	0	+	3307	12981	19097	0.6797403
C1	50611660	50612128	BolC1t05789H	0	+	1	21	468	0.0448718
C1	50615464	50615929	BolC1t05790H	0	+	48	109	465	0.2344086
C1	50616702	50619555	BolC1t05791H	0	-	297	2217	2853	0.7770768
C1	50622227	50622639	BolC1t05792H	0	+	65	314	412	0.7621359
C1	50628200	50628590	BolC1t05793H	0	+	170	343	390	0.8794872
C1	50633389	50634610	BolC1t05794H	0	+	33	156	1221	0.1277641
C1	50634983	50637825	BolC1t05795H	0	-	429	1999	2842	0.7033779
C1	50639377	50641361	BolC1t05796H	0	-	574	1723	1984	0.8684476
C1	50645399	50649040	BolC1t05797H	0	+	1786	3554	3641	0.9761055
C1	50651155	50651797	BolC1t05798H	0	+	346	442	642	0.6884735
C1	50656195	50657097	BolC1t05799H	0	+	687	902	902	1.0000000
C1	50657342	50659087	BolC1t05800H	0	-	749	1692	1745	0.9696275
C1	50665735	50666771	BolC1t05801H	0	-	4	19	1036	0.0183398
C1	50669150	50670911	BolC1t05802H	0	-	914	1514	1761	0.8597388
C1	50673134	50673425	BolC1t05803H	0	-	0	0	291	0.0000000
C1	50675861	50679187	BolC1t05804H	0	+	1666	2982	3326	0.8965725
C1	50679832	50681778	BolC1t05805H	0	-	1891	1897	1946	0.9748201
C1	50682942	50686871	BolC1t05806H	0	+	1122	1634	3929	0.4158819
C1	50694730	50696255	BolC1t05807H	0	-	428	1156	1525	0.7580328
C1	50697715	50698156	BolC1t05808H	0	+	18	285	441	0.6462585
C1	50700530	50700992	BolC1t05809H	0	+	0	0	462	0.0000000
C1	50704690	50706469	BolC1t05810H	0	-	122	561	1779	0.3153457
C1	50708441	50709774	BolC1t05811H	0	-	28	375	1333	0.2813203
C1	50714286	50717407	BolC1t05812H	0	+	452	2282	3121	0.7311759
C1	50721455	50724635	BolC1t05813H	0	+	3783	2926	3180	0.9201258
C1	50727207	50728275	BolC1t05814H	0	+	895	999	1068	0.9353933
C1	50729191	50731114	BolC1t05815H	0	+	448	1182	1923	0.6146646
C1	50732116	50735182	BolC1t05816H	0	-	231	2436	3066	0.7945206
C1	50745948	50747298	BolC1t05817H	0	+	462	524	1350	0.3881482
C1	50765331	50766721	BolC1t05818H	0	+	25	529	1390	0.3805755
C1	50771272	50771683	BolC1t05819H	0	+	305	123	411	0.2992701
C1	50772351	50775741	BolC1t05820H	0	-	1558	3079	3390	0.9082596
C1	50776485	50778747	BolC1t05821H	0	+	940	1742	2262	0.7701150
C1	50784986	50787248	BolC1t05822H	0	+	862	2003	2262	0.8854995
C1	50787517	50789084	BolC1t05823H	0	-	840	1532	1567	0.9776644
C1	50919352	50920944	BolC1t05824H	0	+	183	705	1592	0.4428392
C1	50922268	50923294	BolC1t05825H	0	+	145	948	1026	0.9239766
C1	50924245	50924617	BolC1t05826H	0	+	126	372	372	1.0000000
C1	50927125	50929195	BolC1t05827H	0	+	929	1654	2070	0.7990338
C1	50930593	50932172	BolC1t05828H	0	-	745	1430	1579	0.9056365
C1	50933764	50935011	BolC1t05829H	0	+	591	1193	1247	0.9566961
C1	50935522	50938532	BolC1t05830H	0	-	504	2457	3010	0.8162791
C1	50939485	50939737	BolC1t05831H	0	-	3	110	252	0.4365079
C1	50940016	50940948	BolC1t05832H	0	-	269	784	932	0.8412017
C1	50941248	50941461	BolC1t05833H	0	+	0	0	213	0.0000000
C1	50942025	50949986	BolC1t05834H	0	-	1780	6855	7961	0.8610727
C1	50951996	50952215	BolC1t05835H	0	+	16	105	219	0.4794520
C1	50955591	50960235	BolC1t05836H	0	+	778	2468	4644	0.5314384
C1	50961317	50961995	BolC1t05837H	0	+	381	582	678	0.8584071
C1	50971710	50977270	BolC1t05838H	0	+	1054	4453	5560	0.8008993
C1	50978424	50979980	BolC1t05839H	0	+	80	963	1556	0.6188946
C1	50982070	50984619	BolC1t05840H	0	+	484	1500	2549	0.5884660
C1	50984989	50985988	BolC1t05841H	0	-	1001	999	999	1.0000000
C1	50986894	50987708	BolC1t05842H	0	-	144	748	814	0.9189189
C1	50989012	50991490	BolC1t05843H	0	-	327	1937	2478	0.7816788
C1	50992166	50993949	BolC1t05844H	0	+	670	1644	1783	0.9220415
C1	50994508	50994821	BolC1t05845H	0	-	97	263	313	0.8402556
C1	50998389	51002512	BolC1t05846H	0	-	252	3026	4123	0.7339316
C1	51003014	51005324	BolC1t05847H	0	-	442	1998	2310	0.8649350
C1	51007487	51009036	BolC1t05848H	0	+	544	1413	1549	0.9122014
C1	51009938	51013274	BolC1t05849H	0	+	1065	2506	3336	0.7511991
C1	51013879	51015001	BolC1t05850H	0	+	617	947	1122	0.8440285
C1	51015360	51018077	BolC1t05851H	0	-	1229	2673	2717	0.9838057
C1	51019277	51023497	BolC1t05852H	0	-	572	3818	4220	0.9047393
C1	51024987	51026529	BolC1t05853H	0	-	907	1542	1542	1.0000000
C1	51027447	51028709	BolC1t05854H	0	+	1121	1228	1262	0.9730586
C1	51029106	51029616	BolC1t05855H	0	-	46	481	510	0.9431372
C1	51030535	51030712	BolC1t05856H	0	+	7	173	177	0.9774011
C1	51031591	51032086	BolC1t05857H	0	+	258	432	495	0.8727273
C1	51039510	51041853	BolC1t05858H	0	-	719	1919	2343	0.8190354
C1	51043516	51044411	BolC1t05859H	0	+	313	374	895	0.4178771
C1	51046820	51047122	BolC1t05860H	0	+	169	219	302	0.7251655
C1	51050031	51051737	BolC1t05861H	0	-	751	1521	1706	0.8915592
C1	51064018	51066414	BolC1t05862H	0	-	373	1833	2396	0.7650250
C1	51073269	51076125	BolC1t05863H	0	+	413	1840	2856	0.6442577
C1	51077428	51077995	BolC1t05864H	0	-	108	542	567	0.9559083
C1	51105881	51107209	BolC1t05865H	0	-	468	1303	1328	0.9811747
C1	51119928	51124325	BolC1t05866H	0	-	3456	3940	4397	0.8960655
C1	51128455	51128566	BolC1t05867H	0	+	17	61	111	0.5495495
C1	51130327	51132293	BolC1t05868H	0	-	397	1768	1966	0.8992879
C1	51135381	51137089	BolC1t05869H	0	-	360	1707	1708	0.9994145
C1	51143920	51144889	BolC1t05870H	0	+	159	966	969	0.9969040
C1	51146305	51148179	BolC1t05871H	0	+	765	1642	1874	0.8762006
C1	51148755	51149910	BolC1t05872H	0	+	177	1078	1155	0.9333333
C1	51157410	51157904	BolC1t05873H	0	+	8	464	494	0.9392713
C1	51176545	51176836	BolC1t05874H	0	-	5	174	291	0.5979381
C1	51182350	51182754	BolC1t05875H	0	+	38	404	404	1.0000000
C1	51223993	51224284	BolC1t05876H	0	-	51	291	291	1.0000000
C1	51254780	51254915	BolC1t05877H	0	-	13	77	135	0.5703704
C1	51256730	51257177	BolC1t05878H	0	+	16	384	447	0.8590604
C1	51259312	51261246	BolC1t05879H	0	+	1080	1733	1934	0.8960703
C1	51261611	51265059	BolC1t05880H	0	-	418	1667	3448	0.4834687
C1	51265902	51266696	BolC1t05881H	0	+	270	773	794	0.9735516
C1	51267631	51270225	BolC1t05882H	0	-	382	1460	2594	0.5628373
C1	51270511	51271911	BolC1t05883H	0	+	507	1273	1400	0.9092857
C1	51272158	51273927	BolC1t05884H	0	-	433	1596	1769	0.9022046
C1	51274128	51276206	BolC1t05885H	0	+	611	2078	2078	1.0000000
C1	51277534	51279548	BolC1t05886H	0	+	73	318	2014	0.1578947
C1	51281963	51283172	BolC1t05887H	0	+	62	286	1209	0.2365591
C1	51283478	51285161	BolC1t05888H	0	-	124	1429	1683	0.8490790
C1	51286067	51287639	BolC1t05889H	0	-	400	1552	1572	0.9872773
C1	51288117	51291316	BolC1t05890H	0	-	1448	2557	3199	0.7993123
C1	51292314	51293590	BolC1t05891H	0	-	260	952	1276	0.7460815
C1	51299250	51300305	BolC1t05892H	0	-	323	901	1055	0.8540285
C1	51303764	51306370	BolC1t05893H	0	+	191	757	2606	0.2904835
C1	51308008	51309788	BolC1t05894H	0	+	518	1705	1780	0.9578652
C1	51310064	51310892	BolC1t05895H	0	-	190	665	828	0.8031401
C1	51312420	51313263	BolC1t05896H	0	+	264	843	843	1.0000000
C1	51315106	51315975	BolC1t05897H	0	+	215	869	869	1.0000000
C1	51323334	51326148	BolC1t05898H	0	-	514	2466	2814	0.8763326
C1	51332838	51335214	BolC1t05899H	0	+	679	1606	2376	0.6759259
C1	51335664	51336130	BolC1t05900H	0	-	1	23	466	0.0493562
C1	51470608	51471104	BolC1t05901H	0	-	56	477	496	0.9616935
C1	51474342	51475815	BolC1t05902H	0	-	297	1062	1473	0.7209776
C1	51478332	51478509	BolC1t05903H	0	+	5	119	177	0.6723164
C1	51478824	51480620	BolC1t05904H	0	+	544	1129	1796	0.6286191
C1	51481833	51482499	BolC1t05905H	0	-	633	666	666	1.0000000
C1	51489263	51490942	BolC1t05906H	0	+	439	1394	1679	0.8302561
C1	51492274	51493690	BolC1t05907H	0	-	204	1352	1416	0.9548023
C1	51494954	51495884	BolC1t05908H	0	+	492	833	930	0.8956989
C1	51496328	51497919	BolC1t05909H	0	-	430	1225	1591	0.7699560
C1	51499140	51501108	BolC1t05910H	0	-	880	1505	1968	0.7647358
C1	51502948	51504118	BolC1t05911H	0	-	214	984	1170	0.8410257
C1	51504471	51507174	BolC1t05912H	0	+	546	2375	2703	0.8786533
C1	51507592	51510477	BolC1t05913H	0	-	227	2287	2885	0.7927210
C1	51513522	51515383	BolC1t05914H	0	+	1025	1775	1861	0.9537883
C1	51519255	51521317	BolC1t05915H	0	+	576	2009	2062	0.9742968
C1	51521945	51523779	BolC1t05916H	0	-	306	1470	1834	0.8015267
C1	51580331	51580913	BolC1t05917H	0	+	48	35	582	0.0601375
C1	51581287	51586605	BolC1t05918H	0	-	1000	3431	5318	0.6451674
C1	51587092	51587560	BolC1t05919H	0	-	61	384	468	0.8205128
C1	51589063	51589398	BolC1t05920H	0	+	1	37	335	0.1104478
C1	51589813	51592493	BolC1t05921H	0	-	184	1552	2680	0.5791045
C1	51592910	51593967	BolC1t05922H	0	+	745	978	1057	0.9252602
C1	51596523	51598301	BolC1t05923H	0	-	357	881	1778	0.4955006
C1	51599262	51600102	BolC1t05924H	0	+	4	220	840	0.2619048
C1	51602434	51604945	BolC1t05925H	0	+	381	1877	2511	0.7475110
C1	51605589	51608003	BolC1t05926H	0	-	988	2315	2414	0.9589892
C1	51616545	51618137	BolC1t05927H	0	-	0	0	1592	0.0000000
C1	51619861	51620450	BolC1t05928H	0	+	453	513	589	0.8709677
C1	51641643	51642297	BolC1t05929H	0	-	8	66	654	0.1009174
C1	51673374	51674675	BolC1t05930H	0	-	348	1109	1301	0.8524212
C1	51680154	51681755	BolC1t05931H	0	+	0	0	1601	0.0000000
C1	51683347	51686192	BolC1t05932H	0	+	531	1738	2845	0.6108963
C1	51686444	51689472	BolC1t05933H	0	-	1510	2540	3028	0.8388375
C1	51691713	51692115	BolC1t05934H	0	-	0	0	402	0.0000000
C1	51704732	51705520	BolC1t05935H	0	-	17	295	788	0.3743655
C1	51705533	51706180	BolC1t05936H	0	-	1	42	647	0.0649150
C1	51721107	51721350	BolC1t05937H	0	-	8	141	243	0.5802469
C1	51731690	51732902	BolC1t05938H	0	-	28	679	1212	0.5602310
C1	51733838	51737565	BolC1t05939H	0	-	99	1198	3727	0.3214382
C1	51740430	51740880	BolC1t05940H	0	-	1	32	450	0.0711111
C1	51746948	51748142	BolC1t05941H	0	-	1210	1194	1194	1.0000000
C1	51869890	51871478	BolC1t05942H	0	+	115	1077	1588	0.6782116
C1	51873551	51874115	BolC1t05943H	0	-	8	243	564	0.4308511
C1	51882744	51883131	BolC1t05944H	0	-	0	0	387	0.0000000
C1	51883598	51884072	BolC1t05945H	0	+	2	175	474	0.3691983
C1	51884324	51886522	BolC1t05946H	0	-	336	963	2198	0.4381256
C1	51888773	51890470	BolC1t05947H	0	-	17	376	1697	0.2215675
C1	51891958	51898016	BolC1t05948H	0	+	1906	5399	6058	0.8912182
C1	51898637	51901000	BolC1t05949H	0	-	425	1921	2363	0.8129497
C1	51902082	51909329	BolC1t05950H	0	-	2746	6655	7247	0.9183110
C1	51914855	51921158	BolC1t05951H	0	+	771	4906	6303	0.7783595
C1	51925608	51925911	BolC1t05952H	0	-	173	303	303	1.0000000
C1	51940848	51941871	BolC1t05953H	0	+	222	985	1023	0.9628543
C1	51942571	51944150	BolC1t05954H	0	-	894	1579	1579	1.0000000
C1	51944583	51945132	BolC1t05955H	0	-	192	549	549	1.0000000
C1	51945674	51946412	BolC1t05956H	0	-	396	738	738	1.0000000
C1	51946861	51947793	BolC1t05957H	0	+	196	788	932	0.8454936
C1	51949817	51958308	BolC1t05958H	0	+	158	2444	8491	0.2878342
C1	51958997	51960304	BolC1t05959H	0	-	631	1302	1307	0.9961745
C1	51973164	51983430	BolC1t05960H	0	-	724	3940	10266	0.3837911
C2	5223	5439	BolC2t05961H	0	+	0	0	216	0.0000000
C2	6939	7041	BolC2t05962H	0	-	0	0	102	0.0000000
C2	13494	14684	BolC2t05963H	0	+	1	34	1190	0.0285714
C2	15304	15574	BolC2t05964H	0	-	0	0	270	0.0000000
C2	16798	16993	BolC2t05965H	0	-	0	0	195	0.0000000
C2	19139	19488	BolC2t05966H	0	-	0	0	349	0.0000000
C2	31738	32078	BolC2t05967H	0	+	7	109	340	0.3205882
C2	38150	39302	BolC2t05968H	0	-	0	0	1152	0.0000000
C2	44969	46161	BolC2t05969H	0	+	0	0	1192	0.0000000
C2	46782	47052	BolC2t05970H	0	-	0	0	270	0.0000000
C2	48255	48471	BolC2t05971H	0	-	2	9	216	0.0416667
C2	50598	50947	BolC2t05972H	0	-	0	0	349	0.0000000
C2	54079	54349	BolC2t05973H	0	-	0	0	270	0.0000000
C2	55578	55764	BolC2t05974H	0	-	0	0	186	0.0000000
C2	57918	58267	BolC2t05975H	0	-	0	0	349	0.0000000
C2	61394	61664	BolC2t05976H	0	-	0	0	270	0.0000000
C2	62893	63097	BolC2t05977H	0	-	0	0	204	0.0000000
C2	69053	69402	BolC2t05978H	0	-	0	0	349	0.0000000
C2	73446	74082	BolC2t05979H	0	-	46	536	636	0.8427673
C2	74280	74988	BolC2t05980H	0	-	47	387	708	0.5466102
C2	79931	80381	BolC2t05981H	0	-	37	286	450	0.6355556
C2	98898	99699	BolC2t05982H	0	+	158	543	801	0.6779026
C2	113684	113921	BolC2t05983H	0	-	71	75	237	0.3164557
C2	117212	117970	BolC2t05984H	0	-	83	281	758	0.3707124
C2	140146	141529	BolC2t05985H	0	+	60	1058	1383	0.7650036
C2	149121	149464	BolC2t05986H	0	+	0	0	343	0.0000000
C2	158292	158511	BolC2t05987H	0	+	0	0	219	0.0000000
C2	175551	175895	BolC2t05988H	0	+	0	0	344	0.0000000
C2	183618	184326	BolC2t05989H	0	+	49	151	708	0.2132768
C2	192846	193305	BolC2t05990H	0	+	67	428	459	0.9324619
C2	201170	204115	BolC2t05991H	0	-	688	2091	2945	0.7100170
C2	205660	211231	BolC2t05992H	0	-	363	2919	5571	0.5239634
C2	218754	219096	BolC2t05993H	0	-	340	342	342	1.0000000
C2	228955	229597	BolC2t05994H	0	-	360	642	642	1.0000000
C2	235977	236707	BolC2t05995H	0	+	7	482	730	0.6602740
C2	241846	245986	BolC2t05996H	0	-	1143	3648	4140	0.8811594
C2	266577	267349	BolC2t05997H	0	-	17	105	772	0.1360104
C2	275284	275410	BolC2t05998H	0	-	0	0	126	0.0000000
C2	289754	290227	BolC2t05999H	0	-	0	0	473	0.0000000
C2	291844	292561	BolC2t06000H	0	-	71	299	717	0.4170153
C2	301773	302667	BolC2t06001H	0	+	367	894	894	1.0000000
C2	303706	304131	BolC2t06002H	0	+	3	115	425	0.2705882
C2	307032	308337	BolC2t06003H	0	+	42	888	1305	0.6804598
C2	310380	311652	BolC2t06004H	0	-	25	380	1272	0.2987421
C2	313428	314166	BolC2t06005H	0	-	255	677	738	0.9173442
C2	321899	322325	BolC2t06006H	0	+	0	0	426	0.0000000
C2	333090	333573	BolC2t06007H	0	-	14	139	483	0.2877847
C2	346262	348027	BolC2t06008H	0	+	730	1756	1765	0.9949008
C2	352338	354414	BolC2t06009H	0	+	772	2072	2076	0.9980732
C2	356330	357375	BolC2t06010H	0	-	236	987	1045	0.9444976
C2	358262	362141	BolC2t06011H	0	-	1046	3368	3879	0.8682650
C2	362708	364004	BolC2t06012H	0	-	450	1136	1296	0.8765432
C2	364105	364332	BolC2t06013H	0	-	366	151	227	0.6651983
C2	364718	367291	BolC2t06014H	0	+	1204	2445	2573	0.9502527
C2	368701	369631	BolC2t06015H	0	+	139	848	930	0.9118280
C2	370632	378704	BolC2t06016H	0	+	1261	5248	8072	0.6501487
C2	380828	382528	BolC2t06017H	0	+	342	1205	1700	0.7088235
C2	384227	385947	BolC2t06018H	0	-	205	1314	1720	0.7639535
C2	390557	392442	BolC2t06019H	0	+	328	1645	1885	0.8726791
C2	397229	399313	BolC2t06020H	0	+	131	1413	2084	0.6780230
C2	401645	402179	BolC2t06021H	0	-	3	10	534	0.0187266
C2	439575	441913	BolC2t06022H	0	+	49	605	2338	0.2587682
C2	442881	444441	BolC2t06023H	0	-	43	795	1560	0.5096154
C2	457633	458819	BolC2t06024H	0	-	748	1169	1186	0.9856661
C2	462015	464385	BolC2t06025H	0	-	605	2031	2370	0.8569620
C2	470089	475478	BolC2t06026H	0	-	1454	2459	5389	0.4562999
C2	479947	481436	BolC2t06027H	0	+	121	1234	1489	0.8287441
C2	481622	481778	BolC2t06028H	0	+	69	156	156	1.0000000
C2	491270	493771	BolC2t06029H	0	+	736	2254	2501	0.9012395
C2	494819	495884	BolC2t06030H	0	-	181	854	1065	0.8018779
C2	503840	504155	BolC2t06031H	0	+	4	181	315	0.5746032
C2	505104	506300	BolC2t06032H	0	-	285	1007	1196	0.8419732
C2	510585	512670	BolC2t06033H	0	+	49	591	2085	0.2834532
C2	514925	516134	BolC2t06034H	0	-	254	565	1209	0.4673284
C2	521077	524376	BolC2t06035H	0	+	787	2586	3299	0.7838739
C2	530985	532456	BolC2t06036H	0	-	317	522	1471	0.3548606
C2	533578	534697	BolC2t06037H	0	+	328	913	1119	0.8159071
C2	536913	538236	BolC2t06038H	0	+	4	21	1323	0.0158730
C2	540069	540300	BolC2t06039H	0	-	112	231	231	1.0000000
C2	560576	561959	BolC2t06040H	0	+	126	1046	1383	0.7563269
C2	567792	569100	BolC2t06041H	0	+	225	917	1308	0.7010703
C2	571762	573636	BolC2t06042H	0	-	410	1211	1874	0.6462113
C2	575550	583690	BolC2t06043H	0	+	739	4776	8140	0.5867322
C2	584298	584701	BolC2t06044H	0	-	218	403	403	1.0000000
C2	586942	590102	BolC2t06045H	0	+	453	2229	3160	0.7053797
C2	591453	592771	BolC2t06046H	0	+	121	1025	1318	0.7776935
C2	594044	637883	BolC2t06047H	0	+	2024	16416	43839	0.3744611
C2	648395	649821	BolC2t06048H	0	-	540	1348	1426	0.9453015
C2	652279	654263	BolC2t06049H	0	+	1369	1836	1984	0.9254032
C2	660020	665706	BolC2t06050H	0	+	654	2514	5686	0.4421386
C2	662683	663283	BolC2t06051H	0	+	321	600	600	1.0000000
C2	668573	668927	BolC2t06052H	0	-	1	39	354	0.1101695
C2	673753	674357	BolC2t06053H	0	+	218	557	604	0.9221854
C2	675450	680319	BolC2t06054H	0	+	1914	2744	4869	0.5635654
C2	680455	680752	BolC2t06055H	0	-	398	297	297	1.0000000
C2	683806	684938	BolC2t06056H	0	-	174	786	1132	0.6943463
C2	685549	686327	BolC2t06057H	0	+	373	703	778	0.9035990
C2	693528	694863	BolC2t06058H	0	+	236	1226	1335	0.9183521
C2	696003	696994	BolC2t06059H	0	-	843	918	991	0.9263370
C2	699072	700255	BolC2t06060H	0	+	3	152	1183	0.1284869
C2	702383	704689	BolC2t06061H	0	+	67	1006	2306	0.4362532
C2	705800	706506	BolC2t06062H	0	+	0	0	706	0.0000000
C2	708504	724896	BolC2t06063H	0	+	106	2216	16392	0.1351879
C2	718044	718624	BolC2t06064H	0	+	0	0	580	0.0000000
C2	723451	724291	BolC2t06065H	0	+	0	0	840	0.0000000
C2	737402	739225	BolC2t06066H	0	-	593	1605	1823	0.8804169
C2	739982	742701	BolC2t06067H	0	-	657	2194	2719	0.8069143
C2	744776	750929	BolC2t06068H	0	+	2702	5511	6153	0.8956606
C2	752873	754249	BolC2t06069H	0	-	1710	1349	1376	0.9803779
C2	761005	762232	BolC2t06070H	0	+	539	1224	1227	0.9975550
C2	762527	763095	BolC2t06071H	0	-	151	568	568	1.0000000
C2	763885	764438	BolC2t06072H	0	-	83	553	553	1.0000000
C2	765215	765449	BolC2t06073H	0	-	27	156	234	0.6666667
C2	769439	770144	BolC2t06074H	0	-	283	603	705	0.8553191
C2	770786	773425	BolC2t06075H	0	-	675	2514	2639	0.9526336
C2	773830	774502	BolC2t06076H	0	+	71	524	672	0.7797619
C2	843718	844588	BolC2t06077H	0	+	118	736	870	0.8459770
C2	847460	853537	BolC2t06078H	0	+	282	2043	6077	0.3361856
C2	853994	854327	BolC2t06079H	0	-	15	156	333	0.4684685
C2	854595	855536	BolC2t06080H	0	+	3	49	941	0.0520723
C2	862228	864821	BolC2t06081H	0	+	25	129	2593	0.0497493
C2	867352	868084	BolC2t06082H	0	-	99	547	732	0.7472678
C2	869033	870810	BolC2t06083H	0	-	433	1261	1777	0.7096230
C2	873917	874028	BolC2t06084H	0	+	40	111	111	1.0000000
C2	875481	875719	BolC2t06085H	0	+	33	238	238	1.0000000
C2	879701	880692	BolC2t06086H	0	-	247	912	991	0.9202825
C2	881491	881599	BolC2t06087H	0	-	143	108	108	1.0000000
C2	882413	883245	BolC2t06088H	0	-	1035	832	832	1.0000000
C2	883489	884983	BolC2t06089H	0	-	717	1149	1494	0.7690763
C2	885194	887325	BolC2t06090H	0	-	774	1890	2131	0.8869076
C2	890846	893978	BolC2t06091H	0	+	581	2070	3132	0.6609195
C2	894548	896117	BolC2t06092H	0	+	278	1421	1569	0.9056724
C2	904382	905633	BolC2t06093H	0	+	812	1126	1251	0.9000800
C2	911450	913201	BolC2t06094H	0	-	89	1316	1751	0.7515705
C2	916758	918703	BolC2t06095H	0	+	76	258	1945	0.1326478
C2	918907	919357	BolC2t06096H	0	-	0	0	450	0.0000000
C2	920240	923362	BolC2t06097H	0	-	3399	3015	3122	0.9657271
C2	924647	927693	BolC2t06098H	0	-	1078	2626	3046	0.8621143
C2	928660	929417	BolC2t06099H	0	+	754	682	757	0.9009247
C2	930444	932081	BolC2t06100H	0	+	269	1498	1637	0.9150886
C2	940547	941354	BolC2t06101H	0	+	412	807	807	1.0000000
C2	944598	945812	BolC2t06102H	0	-	2	163	1214	0.1342669
C2	946277	946478	BolC2t06103H	0	+	0	0	201	0.0000000
C2	950853	951015	BolC2t06104H	0	+	81	162	162	1.0000000
C2	951609	952212	BolC2t06105H	0	-	0	0	603	0.0000000
C2	953086	953886	BolC2t06106H	0	-	0	0	800	0.0000000
C2	958080	958463	BolC2t06107H	0	-	39	234	383	0.6109661
C2	961594	980828	BolC2t06108H	0	+	929	7926	19234	0.4120828
C2	996568	999410	BolC2t06109H	0	+	52	1556	2842	0.5475017
C2	1025859	1051806	BolC2t06110H	0	+	3225	11902	25947	0.4587043
C2	1026165	1027865	BolC2t06111H	0	+	36	353	1700	0.2076471
C2	1032193	1032605	BolC2t06112H	0	-	3	170	412	0.4126213
C2	1040210	1041070	BolC2t06113H	0	-	180	194	860	0.2255814
C2	1045258	1045521	BolC2t06114H	0	+	189	153	263	0.5817490
C2	1055067	1055217	BolC2t06115H	0	+	0	0	150	0.0000000
C2	1064807	1066292	BolC2t06116H	0	+	488	1135	1485	0.7643098
C2	1066951	1069579	BolC2t06117H	0	-	414	2177	2628	0.8283866
C2	1070069	1080920	BolC2t06118H	0	-	1805	3650	10851	0.3363745
C2	1082912	1083497	BolC2t06119H	0	-	2	250	585	0.4273504
C2	1090534	1090669	BolC2t06120H	0	-	185	135	135	1.0000000
C2	1095596	1096711	BolC2t06121H	0	-	288	873	1115	0.7829596
C2	1099702	1099897	BolC2t06122H	0	-	11	195	195	1.0000000
C2	1101147	1103616	BolC2t06123H	0	-	1029	1802	2469	0.7298501
C2	1104454	1105513	BolC2t06124H	0	-	259	979	1059	0.9244570
C2	1107636	1110249	BolC2t06125H	0	+	1515	2485	2613	0.9510142
C2	1111061	1111939	BolC2t06126H	0	+	761	724	878	0.8246014
C2	1112331	1115269	BolC2t06127H	0	-	1078	2692	2938	0.9162696
C2	1115826	1118432	BolC2t06128H	0	+	323	1653	2606	0.6343055
C2	1122396	1124009	BolC2t06129H	0	-	60	502	1613	0.3112213
C2	1136523	1139735	BolC2t06130H	0	+	316	1175	3212	0.3658157
C2	1140629	1141058	BolC2t06131H	0	+	420	385	429	0.8974359
C2	1144934	1146318	BolC2t06132H	0	+	928	1319	1384	0.9530347
C2	1148767	1150432	BolC2t06133H	0	+	2	99	1665	0.0594595
C2	1151666	1165479	BolC2t06134H	0	+	1256	6387	13813	0.4623905
C2	1166027	1167664	BolC2t06135H	0	+	55	190	1637	0.1160660
C2	1169892	1170208	BolC2t06136H	0	+	107	316	316	1.0000000
C2	1174266	1174586	BolC2t06137H	0	+	328	320	320	1.0000000
C2	1176360	1181465	BolC2t06138H	0	-	5172	4381	5105	0.8581783
C2	1184738	1185786	BolC2t06139H	0	-	982	771	1048	0.7356870
C2	1186869	1188021	BolC2t06140H	0	+	871	1108	1152	0.9618056
C2	1188930	1189902	BolC2t06141H	0	+	121	768	972	0.7901235
C2	1193119	1193695	BolC2t06142H	0	+	195	440	576	0.7638889
C2	1203176	1203765	BolC2t06143H	0	+	82	367	589	0.6230900
C2	1253727	1254461	BolC2t06144H	0	+	0	0	734	0.0000000
C2	1254921	1255492	BolC2t06145H	0	+	233	571	571	1.0000000
C2	1257531	1257924	BolC2t06146H	0	+	2	60	393	0.1526718
C2	1259739	1260789	BolC2t06147H	0	+	485	778	1050	0.7409524
C2	1261859	1262249	BolC2t06148H	0	+	30	321	390	0.8230769
C2	1262985	1264934	BolC2t06149H	0	+	310	1330	1949	0.6824012
C2	1265361	1267769	BolC2t06150H	0	-	618	2120	2408	0.8803987
C2	1273262	1273652	BolC2t06151H	0	-	5	231	390	0.5923077
C2	1278744	1283410	BolC2t06152H	0	-	3	57	4666	0.0122160
C2	1286250	1289083	BolC2t06153H	0	+	1002	2531	2833	0.8933992
C2	1290750	1292139	BolC2t06154H	0	-	225	1169	1389	0.8416127
C2	1296680	1301621	BolC2t06155H	0	-	1820	4060	4941	0.8216960
C2	1302666	1304436	BolC2t06156H	0	-	378	1730	1770	0.9774011
C2	1307044	1308424	BolC2t06157H	0	+	750	1253	1380	0.9079710
C2	1314509	1316555	BolC2t06158H	0	-	283	1874	2046	0.9159335
C2	1321038	1322054	BolC2t06159H	0	-	738	544	1016	0.5354331
C2	1324140	1324797	BolC2t06160H	0	+	0	0	657	0.0000000
C2	1325195	1327149	BolC2t06161H	0	-	651	1469	1954	0.7517912
C2	1328961	1329734	BolC2t06162H	0	-	316	773	773	1.0000000
C2	1333542	1333977	BolC2t06163H	0	+	174	435	435	1.0000000
C2	1335175	1336764	BolC2t06164H	0	-	0	0	1589	0.0000000
C2	1337804	1338650	BolC2t06165H	0	+	1	19	846	0.0224586
C2	1342317	1344493	BolC2t06166H	0	-	70	1230	2176	0.5652574
C2	1353811	1375238	BolC2t06167H	0	+	1210	5074	21427	0.2368040
C2	1361402	1362869	BolC2t06168H	0	+	283	996	1467	0.6789366
C2	1365566	1366589	BolC2t06169H	0	-	9	144	1023	0.1407625
C2	1366752	1368534	BolC2t06170H	0	-	10	483	1782	0.2710438
C2	1395134	1395776	BolC2t06171H	0	-	0	0	642	0.0000000
C2	1415994	1416141	BolC2t06172H	0	+	49	147	147	1.0000000
C2	1416864	1417704	BolC2t06173H	0	+	567	840	840	1.0000000
C2	1422630	1423538	BolC2t06174H	0	+	315	370	908	0.4074890
C2	1424190	1424523	BolC2t06175H	0	-	80	305	333	0.9159159
C2	1424705	1424897	BolC2t06176H	0	+	76	185	192	0.9635417
C2	1426284	1427633	BolC2t06177H	0	+	45	694	1349	0.5144551
C2	1427851	1428152	BolC2t06178H	0	-	130	301	301	1.0000000
C2	1428794	1431249	BolC2t06179H	0	-	478	1526	2455	0.6215886
C2	1431817	1434026	BolC2t06180H	0	-	595	1871	2209	0.8469896
C2	1435608	1438463	BolC2t06181H	0	+	1301	2663	2855	0.9327496
C2	1439261	1439951	BolC2t06182H	0	+	127	638	690	0.9246377
C2	1444268	1445892	BolC2t06183H	0	+	0	0	1624	0.0000000
C2	1447674	1448327	BolC2t06184H	0	-	403	541	653	0.8284839
C2	1449400	1450073	BolC2t06185H	0	+	708	612	673	0.9093611
C2	1450930	1451545	BolC2t06186H	0	+	429	482	615	0.7837399
C2	1463498	1465321	BolC2t06187H	0	+	299	1625	1823	0.8913878
C2	1470093	1470473	BolC2t06188H	0	+	0	0	380	0.0000000
C2	1504753	1509275	BolC2t06189H	0	-	277	3239	4522	0.7162760
C2	1510397	1511423	BolC2t06190H	0	+	63	900	1026	0.8771930
C2	1511883	1512078	BolC2t06191H	0	+	448	195	195	1.0000000
C2	1512499	1514608	BolC2t06192H	0	-	729	1280	2109	0.6069227
C2	1516232	1516613	BolC2t06193H	0	-	20	67	381	0.1758530
C2	1517072	1518747	BolC2t06194H	0	+	668	1309	1675	0.7814925
C2	1519570	1520843	BolC2t06195H	0	-	418	1124	1273	0.8829536
C2	1521328	1523182	BolC2t06196H	0	-	64	811	1854	0.4374326
C2	1529932	1531539	BolC2t06197H	0	-	350	570	1607	0.3546982
C2	1539745	1541992	BolC2t06198H	0	+	56	1232	2247	0.5482866
C2	1543280	1543607	BolC2t06199H	0	-	0	0	327	0.0000000
C2	1544842	1545811	BolC2t06200H	0	+	314	894	969	0.9226006
C2	1550195	1553329	BolC2t06201H	0	+	2073	2959	3134	0.9441608
C2	1553981	1554536	BolC2t06202H	0	+	544	555	555	1.0000000
C2	1554972	1556604	BolC2t06203H	0	-	410	1328	1632	0.8137255
C2	1557242	1569599	BolC2t06204H	0	+	4181	10223	12357	0.8273044
C2	1572296	1578753	BolC2t06205H	0	+	1740	5269	6457	0.8160136
C2	1579447	1581355	BolC2t06206H	0	+	154	1500	1908	0.7861635
C2	1581715	1582912	BolC2t06207H	0	-	88	839	1197	0.7009190
C2	1592820	1593072	BolC2t06208H	0	-	1052	252	252	1.0000000
C2	1598202	1601439	BolC2t06209H	0	+	775	2305	3237	0.7120791
C2	1603792	1606935	BolC2t06210H	0	-	1137	2600	3143	0.8272351
C2	1613271	1613424	BolC2t06211H	0	+	43	131	153	0.8562092
C2	1619535	1619862	BolC2t06212H	0	+	47	316	327	0.9663609
C2	1619937	1620358	BolC2t06213H	0	+	222	382	421	0.9073634
C2	1625290	1625958	BolC2t06214H	0	+	94	454	668	0.6796407
C2	1627219	1629268	BolC2t06215H	0	+	168	1120	2049	0.5466081
C2	1629805	1630243	BolC2t06216H	0	-	103	203	438	0.4634703
C2	1631014	1631428	BolC2t06217H	0	+	50	380	414	0.9178744
C2	1633057	1633309	BolC2t06218H	0	+	22	226	252	0.8968254
C2	1634195	1644155	BolC2t06219H	0	-	395	3279	9960	0.3292169
C2	1645079	1646174	BolC2t06220H	0	-	54	693	1095	0.6328767
C2	1649156	1653070	BolC2t06221H	0	-	639	2803	3914	0.7161472
C2	1653935	1655408	BolC2t06222H	0	+	714	1363	1473	0.9253225
C2	1655829	1657420	BolC2t06223H	0	-	964	1490	1591	0.9365179
C2	1663840	1671361	BolC2t06224H	0	+	2637	6095	7521	0.8103976
C2	1672036	1673479	BolC2t06225H	0	-	1024	1398	1443	0.9688150
C2	1676637	1680372	BolC2t06226H	0	-	1290	2986	3735	0.7994645
C2	1681195	1684457	BolC2t06227H	0	-	1481	3012	3262	0.9233599
C2	1685348	1686060	BolC2t06228H	0	+	592	528	712	0.7415730
C2	1686453	1688533	BolC2t06229H	0	-	835	2025	2080	0.9735577
C2	1722457	1723552	BolC2t06230H	0	+	556	894	1095	0.8164384
C2	1726255	1726468	BolC2t06231H	0	-	464	213	213	1.0000000
C2	1733709	1736945	BolC2t06232H	0	-	768	2835	3236	0.8760816
C2	1740092	1742049	BolC2t06233H	0	+	1450	1769	1957	0.9039346
C2	1755386	1755866	BolC2t06234H	0	+	179	480	480	1.0000000
C2	1759569	1760464	BolC2t06235H	0	-	910	882	895	0.9854749
C2	1761103	1761697	BolC2t06236H	0	-	79	512	594	0.8619528
C2	1763020	1763532	BolC2t06237H	0	-	84	512	512	1.0000000
C2	1765984	1766743	BolC2t06238H	0	+	14	457	759	0.6021081
C2	1768040	1774842	BolC2t06239H	0	-	2270	5679	6802	0.8349015
C2	1781439	1782764	BolC2t06240H	0	-	889	1325	1325	1.0000000
C2	1783823	1792012	BolC2t06241H	0	-	2351	6860	8189	0.8377091
C2	1793240	1795209	BolC2t06242H	0	+	706	1854	1969	0.9415947
C2	1795917	1796532	BolC2t06243H	0	-	47	403	615	0.6552845
C2	1801820	1802372	BolC2t06244H	0	+	148	481	552	0.8713768
C2	1804615	1811131	BolC2t06245H	0	-	1026	4463	6516	0.6849294
C2	1814731	1817316	BolC2t06246H	0	+	500	2327	2585	0.9001935
C2	1818983	1821212	BolC2t06247H	0	+	635	2111	2229	0.9470615
C2	1821532	1823424	BolC2t06248H	0	-	804	1751	1892	0.9254757
C2	1825517	1828421	BolC2t06249H	0	-	120	685	2904	0.2358815
C2	1841726	1844163	BolC2t06250H	0	+	1013	2213	2437	0.9080837
C2	1846182	1847862	BolC2t06251H	0	+	702	1680	1680	1.0000000
C2	1848319	1849573	BolC2t06252H	0	-	593	1037	1254	0.8269538
C2	1850092	1851879	BolC2t06253H	0	-	355	1049	1787	0.5870174
C2	1853648	1855876	BolC2t06254H	0	-	950	2061	2228	0.9250449
C2	1857382	1859278	BolC2t06255H	0	+	534	1678	1896	0.8850211
C2	1860315	1861071	BolC2t06256H	0	+	143	546	756	0.7222222
C2	1861803	1862910	BolC2t06257H	0	-	400	1107	1107	1.0000000
C2	1866172	1867203	BolC2t06258H	0	-	598	826	1031	0.8011639
C2	1867845	1869162	BolC2t06259H	0	-	108	924	1317	0.7015945
C2	1869436	1872245	BolC2t06260H	0	+	918	2132	2809	0.7589890
C2	1872338	1873628	BolC2t06261H	0	+	492	1205	1290	0.9341086
C2	1874569	1876096	BolC2t06262H	0	+	198	1298	1527	0.8500327
C2	1880370	1881851	BolC2t06263H	0	-	885	1440	1481	0.9723160
C2	1894823	1899368	BolC2t06264H	0	+	1685	3529	4545	0.7764577
C2	1900416	1901727	BolC2t06265H	0	-	168	1077	1311	0.8215103
C2	1903397	1906487	BolC2t06266H	0	+	17	189	3090	0.0611650
C2	1919599	1920488	BolC2t06267H	0	+	446	678	889	0.7626547
C2	1925113	1927200	BolC2t06268H	0	+	1939	1865	2087	0.8936272
C2	1928479	1928677	BolC2t06269H	0	-	214	198	198	1.0000000
C2	1932013	1937580	BolC2t06270H	0	-	2810	4985	5567	0.8954554
C2	1940696	1944953	BolC2t06271H	0	+	1191	3722	4257	0.8743246
C2	1945137	1946391	BolC2t06272H	0	-	67	740	1254	0.5901116
C2	1946903	1948654	BolC2t06273H	0	+	246	1380	1751	0.7881210
C2	1950337	1951806	BolC2t06274H	0	+	61	1094	1469	0.7447243
C2	1953971	1956440	BolC2t06275H	0	+	569	2241	2469	0.9076549
C2	1961969	1963938	BolC2t06276H	0	+	285	1520	1969	0.7719654
C2	1965295	1966254	BolC2t06277H	0	-	76	676	959	0.7049009
C2	1968268	1968778	BolC2t06278H	0	+	8	122	510	0.2392157
C2	1969222	1969438	BolC2t06279H	0	+	6	101	216	0.4675926
C2	1972404	1979131	BolC2t06280H	0	-	2073	5083	6727	0.7556117
C2	1982155	1983097	BolC2t06281H	0	-	1034	882	942	0.9363058
C2	1984557	1985673	BolC2t06282H	0	-	756	935	1116	0.8378136
C2	1987201	1988092	BolC2t06283H	0	-	122	642	891	0.7205387
C2	1988459	1989029	BolC2t06284H	0	+	358	570	570	1.0000000
C2	1989939	1991555	BolC2t06285H	0	+	935	1562	1616	0.9665841
C2	1992547	1996410	BolC2t06286H	0	+	2529	3761	3863	0.9735957
C2	1998490	2000254	BolC2t06287H	0	+	1974	1557	1764	0.8826531
C2	2002586	2004116	BolC2t06288H	0	+	987	1327	1530	0.8673202
C2	2009070	2010915	BolC2t06289H	0	+	780	1702	1845	0.9224932
C2	2014620	2015845	BolC2t06290H	0	+	434	1175	1225	0.9591837
C2	2020568	2027725	BolC2t06291H	0	-	3782	6699	7157	0.9360067
C2	2029404	2031980	BolC2t06292H	0	-	244	1764	2576	0.6847826
C2	2036946	2038491	BolC2t06293H	0	+	175	1299	1545	0.8407767
C2	2038651	2039501	BolC2t06294H	0	+	1104	850	850	1.0000000
C2	2040567	2042563	BolC2t06295H	0	-	400	1816	1996	0.9098197
C2	2043215	2046242	BolC2t06296H	0	-	748	2445	3027	0.8077304
C2	2050697	2052278	BolC2t06297H	0	+	1109	1581	1581	1.0000000
C2	2056251	2061126	BolC2t06298H	0	+	195	2328	4875	0.4775385
C2	2061570	2063082	BolC2t06299H	0	-	510	1413	1512	0.9345238
C2	2064000	2064961	BolC2t06300H	0	+	797	929	961	0.9667013
C2	2065598	2066159	BolC2t06301H	0	-	381	499	561	0.8894831
C2	2071366	2095112	BolC2t06302H	0	-	3677	14460	23746	0.6089447
C2	2090588	2093095	BolC2t06303H	0	-	1084	2039	2507	0.8133227
C2	2100918	2102984	BolC2t06304H	0	-	1077	1951	2066	0.9443369
C2	2103507	2105190	BolC2t06305H	0	-	1958	1631	1683	0.9691028
C2	2106980	2107954	BolC2t06306H	0	+	516	733	974	0.7525668
C2	2109862	2111842	BolC2t06307H	0	+	1007	1629	1980	0.8227273
C2	2112419	2114747	BolC2t06308H	0	-	111	1696	2328	0.7285224
C2	2117899	2119738	BolC2t06309H	0	+	768	1703	1839	0.9260468
C2	2123163	2123565	BolC2t06310H	0	-	73	383	402	0.9527363
C2	2124486	2124882	BolC2t06311H	0	-	221	396	396	1.0000000
C2	2126257	2127407	BolC2t06312H	0	+	371	790	1150	0.6869565
C2	2128871	2129549	BolC2t06313H	0	+	100	658	678	0.9705015
C2	2129693	2130473	BolC2t06314H	0	+	540	780	780	1.0000000
C2	2134183	2136538	BolC2t06315H	0	-	844	2066	2355	0.8772824
C2	2137956	2138166	BolC2t06316H	0	+	2	94	210	0.4476191
C2	2139202	2139666	BolC2t06317H	0	-	81	387	464	0.8340517
C2	2140614	2142648	BolC2t06318H	0	-	666	1849	2034	0.9090462
C2	2143175	2143406	BolC2t06319H	0	+	16	61	231	0.2640693
C2	2143999	2146346	BolC2t06320H	0	+	2025	2234	2347	0.9518535
C2	2148572	2150076	BolC2t06321H	0	+	334	1234	1504	0.8204787
C2	2153062	2153975	BolC2t06322H	0	-	223	746	913	0.8170865
C2	2162185	2164935	BolC2t06323H	0	-	221	1464	2750	0.5323637
C2	2166464	2166983	BolC2t06324H	0	-	110	334	519	0.6435453
C2	2167042	2167195	BolC2t06325H	0	-	0	0	153	0.0000000
C2	2175672	2178835	BolC2t06326H	0	+	556	2541	3163	0.8033512
C2	2179077	2183460	BolC2t06327H	0	-	3330	4051	4383	0.9242528
C2	2185373	2188650	BolC2t06328H	0	+	1951	2756	3277	0.8410131
C2	2189079	2191485	BolC2t06329H	0	-	515	2216	2406	0.9210308
C2	2195011	2196425	BolC2t06330H	0	+	117	1057	1414	0.7475247
C2	2196911	2197416	BolC2t06331H	0	+	271	505	505	1.0000000
C2	2198329	2201267	BolC2t06332H	0	-	2532	2720	2938	0.9257998
C2	2202184	2203642	BolC2t06333H	0	-	337	1342	1458	0.9204389
C2	2214307	2215198	BolC2t06334H	0	+	168	665	891	0.7463524
C2	2217448	2218258	BolC2t06335H	0	+	147	631	810	0.7790123
C2	2219577	2220737	BolC2t06336H	0	-	279	1160	1160	1.0000000
C2	2223480	2224143	BolC2t06337H	0	-	322	577	663	0.8702866
C2	2224959	2226648	BolC2t06338H	0	+	295	1662	1689	0.9840142
C2	2226952	2227915	BolC2t06339H	0	-	411	686	963	0.7123572
C2	2228756	2229104	BolC2t06340H	0	+	122	348	348	1.0000000
C2	2230409	2231708	BolC2t06341H	0	-	452	1299	1299	1.0000000
C2	2233328	2234383	BolC2t06342H	0	-	433	931	1055	0.8824645
C2	2236323	2237328	BolC2t06343H	0	-	214	406	1005	0.4039801
C2	2243100	2243755	BolC2t06344H	0	+	3	49	655	0.0748092
C2	2250664	2251831	BolC2t06345H	0	+	2	19	1167	0.0162811
C2	2259992	2261170	BolC2t06346H	0	+	579	1151	1178	0.9770798
C2	2264963	2265836	BolC2t06347H	0	+	539	873	873	1.0000000
C2	2272516	2273428	BolC2t06348H	0	+	295	912	912	1.0000000
C2	2274538	2274886	BolC2t06349H	0	+	285	348	348	1.0000000
C2	2275269	2276960	BolC2t06350H	0	+	285	1448	1691	0.8562980
C2	2277400	2278456	BolC2t06351H	0	-	849	930	1056	0.8806818
C2	2279209	2280040	BolC2t06352H	0	-	449	831	831	1.0000000
C2	2280758	2282225	BolC2t06353H	0	-	478	1467	1467	1.0000000
C2	2283080	2285387	BolC2t06354H	0	+	547	1879	2307	0.8144777
C2	2287481	2288504	BolC2t06355H	0	+	358	808	1023	0.7898338
C2	2288811	2290762	BolC2t06356H	0	+	1476	1736	1951	0.8898001
C2	2291462	2296211	BolC2t06357H	0	+	3034	4355	4749	0.9170352
C2	2296649	2296950	BolC2t06358H	0	+	156	264	301	0.8770764
C2	2297813	2300688	BolC2t06359H	0	+	2404	2837	2875	0.9867826
C2	2300892	2301841	BolC2t06360H	0	-	244	878	949	0.9251844
C2	2302546	2304473	BolC2t06361H	0	-	1012	1708	1927	0.8863518
C2	2305083	2308483	BolC2t06362H	0	-	2564	2994	3400	0.8805882
C2	2309739	2311964	BolC2t06363H	0	-	1181	2107	2225	0.9469663
C2	2312351	2314566	BolC2t06364H	0	-	158	718	2215	0.3241535
C2	2314948	2315230	BolC2t06365H	0	+	0	0	282	0.0000000
C2	2318708	2319356	BolC2t06366H	0	-	30	576	648	0.8888889
C2	2333334	2335520	BolC2t06367H	0	+	471	1768	2186	0.8087832
C2	2337888	2339895	BolC2t06368H	0	-	770	1948	2007	0.9706029
C2	2342015	2342243	BolC2t06369H	0	+	37	190	228	0.8333333
C2	2344442	2345198	BolC2t06370H	0	-	13	366	756	0.4841270
C2	2346789	2349649	BolC2t06371H	0	-	632	1916	2860	0.6699300
C2	2355961	2357338	BolC2t06372H	0	+	236	1231	1377	0.8939724
C2	2359329	2367104	BolC2t06373H	0	-	223	2369	7775	0.3046945
C2	2372558	2376446	BolC2t06374H	0	+	2125	3628	3888	0.9331276
C2	2377216	2380471	BolC2t06375H	0	-	1315	3093	3255	0.9502304
C2	2380990	2383579	BolC2t06376H	0	-	1423	2547	2589	0.9837775
C2	2385525	2385993	BolC2t06377H	0	+	453	468	468	1.0000000
C2	2386523	2387618	BolC2t06378H	0	+	1264	1017	1095	0.9287671
C2	2388713	2389328	BolC2t06379H	0	+	75	529	615	0.8601626
C2	2392053	2392779	BolC2t06380H	0	+	373	549	726	0.7561983
C2	2394711	2395315	BolC2t06381H	0	+	122	431	604	0.7135761
C2	2401697	2404476	BolC2t06382H	0	+	1929	2612	2779	0.9399064
C2	2406266	2406713	BolC2t06383H	0	-	18	99	447	0.2214765
C2	2407002	2408907	BolC2t06384H	0	-	647	1618	1905	0.8493438
C2	2413632	2415210	BolC2t06385H	0	+	1562	1156	1578	0.7325729
C2	2417167	2417551	BolC2t06386H	0	-	501	384	384	1.0000000
C2	2419213	2421552	BolC2t06387H	0	-	922	2210	2339	0.9448482
C2	2423174	2424539	BolC2t06388H	0	+	290	1195	1365	0.8754579
C2	2425058	2425968	BolC2t06389H	0	-	223	846	910	0.9296703
C2	2427276	2427471	BolC2t06390H	0	+	1	54	195	0.2769231
C2	2427626	2428042	BolC2t06391H	0	+	1	21	416	0.0504808
C2	2430313	2431913	BolC2t06392H	0	-	1583	1600	1600	1.0000000
C2	2434628	2436346	BolC2t06393H	0	-	472	1582	1718	0.9208382
C2	2439145	2440635	BolC2t06394H	0	+	502	1479	1490	0.9926174
C2	2441561	2444758	BolC2t06395H	0	-	467	2593	3197	0.8110729
C2	2447093	2447880	BolC2t06396H	0	+	7	185	787	0.2350699
C2	2464194	2467859	BolC2t06397H	0	+	917	3335	3665	0.9099591
C2	2470423	2472963	BolC2t06398H	0	+	853	1692	2540	0.6661417
C2	2481479	2482650	BolC2t06399H	0	+	449	1092	1171	0.9325363
C2	2486096	2489246	BolC2t06400H	0	-	638	2687	3150	0.8530159
C2	2492012	2492456	BolC2t06401H	0	-	247	444	444	1.0000000
C2	2493531	2494095	BolC2t06402H	0	-	65	448	564	0.7943262
C2	2495623	2496034	BolC2t06403H	0	-	93	411	411	1.0000000
C2	2503881	2511789	BolC2t06404H	0	-	6766	6540	7908	0.8270106
C2	2516650	2517070	BolC2t06405H	0	-	81	360	420	0.8571429
C2	2518215	2518449	BolC2t06406H	0	-	122	234	234	1.0000000
C2	2518822	2519964	BolC2t06407H	0	-	1466	992	1142	0.8686515
C2	2520657	2522757	BolC2t06408H	0	+	709	1790	2100	0.8523809
C2	2526001	2526510	BolC2t06409H	0	-	24	141	509	0.2770137
C2	2533209	2536921	BolC2t06410H	0	+	663	3595	3712	0.9684806
C2	2537305	2539302	BolC2t06411H	0	-	849	1685	1997	0.8437657
C2	2541267	2543235	BolC2t06412H	0	-	370	1581	1968	0.8033537
C2	2544432	2548078	BolC2t06413H	0	+	2732	3498	3646	0.9594076
C2	2549855	2550879	BolC2t06414H	0	+	11	287	1024	0.2802734
C2	2561835	2563110	BolC2t06415H	0	+	566	1088	1275	0.8533334
C2	2566246	2570390	BolC2t06416H	0	+	2791	3798	4144	0.9165058
C2	2570778	2571783	BolC2t06417H	0	-	639	858	1005	0.8537313
C2	2574555	2578383	BolC2t06418H	0	+	2063	2810	3828	0.7340648
C2	2578601	2581511	BolC2t06419H	0	-	1396	2414	2910	0.8295532
C2	2587849	2591538	BolC2t06420H	0	+	1142	2976	3689	0.8067227
C2	2591773	2593811	BolC2t06421H	0	-	1110	1879	2038	0.9219823
C2	2594582	2595971	BolC2t06422H	0	+	99	972	1389	0.6997840
C2	2597172	2599148	BolC2t06423H	0	-	467	1315	1976	0.6654859
C2	2601778	2603673	BolC2t06424H	0	-	874	1667	1895	0.8796834
C2	2606887	2611009	BolC2t06425H	0	+	2799	3862	4122	0.9369238
C2	2611270	2618699	BolC2t06426H	0	-	2688	4988	7429	0.6714228
C2	2614255	2614565	BolC2t06427H	0	-	111	310	310	1.0000000
C2	2614951	2615807	BolC2t06428H	0	+	169	842	856	0.9836448
C2	2619719	2620358	BolC2t06429H	0	-	198	480	639	0.7511737
C2	2620935	2621866	BolC2t06430H	0	-	406	887	931	0.9527390
C2	2622929	2624440	BolC2t06431H	0	-	644	1315	1511	0.8702846
C2	2629430	2630697	BolC2t06432H	0	-	789	1152	1267	0.9092344
C2	2631511	2634801	BolC2t06433H	0	-	2413	3159	3290	0.9601824
C2	2635583	2638412	BolC2t06434H	0	+	621	1157	2829	0.4089784
C2	2643190	2643583	BolC2t06435H	0	+	240	393	393	1.0000000
C2	2645655	2646669	BolC2t06436H	0	-	131	619	1014	0.6104537
C2	2648481	2649523	BolC2t06437H	0	-	57	565	1042	0.5422265
C2	2649618	2649908	BolC2t06438H	0	-	128	290	290	1.0000000
C2	2657264	2657661	BolC2t06439H	0	+	8	270	397	0.6801007
C2	2665228	2667651	BolC2t06440H	0	+	334	1287	2423	0.5311597
C2	2702181	2702343	BolC2t06441H	0	-	25	58	162	0.3580247
C2	2702998	2703364	BolC2t06442H	0	-	527	366	366	1.0000000
C2	2708587	2709650	BolC2t06443H	0	+	776	1036	1063	0.9746002
C2	2714627	2717771	BolC2t06444H	0	+	1514	2910	3144	0.9255725
C2	2719126	2721627	BolC2t06445H	0	+	1408	2347	2501	0.9384246
C2	2722540	2723652	BolC2t06446H	0	-	203	933	1112	0.8390288
C2	2730296	2733007	BolC2t06447H	0	-	1225	2354	2711	0.8683143
C2	2733496	2736597	BolC2t06448H	0	+	1324	2501	3101	0.8065140
C2	2736948	2740877	BolC2t06449H	0	-	1755	3492	3929	0.8887758
C2	2741624	2743057	BolC2t06450H	0	-	734	1354	1433	0.9448709
C2	2743680	2744966	BolC2t06451H	0	+	1030	1152	1286	0.8958009
C2	2745264	2746471	BolC2t06452H	0	-	346	886	1207	0.7340513
C2	2749958	2753418	BolC2t06453H	0	-	1190	2639	3460	0.7627168
C2	2761963	2763594	BolC2t06454H	0	-	146	1076	1631	0.6597180
C2	2774818	2775900	BolC2t06455H	0	+	411	1082	1082	1.0000000
C2	2787550	2788252	BolC2t06456H	0	+	116	312	702	0.4444444
C2	2791825	2792711	BolC2t06457H	0	-	884	886	886	1.0000000
C2	2802006	2804599	BolC2t06458H	0	+	2181	2330	2593	0.8985731
C2	2807058	2807313	BolC2t06459H	0	-	739	255	255	1.0000000
C2	2809114	2812761	BolC2t06460H	0	+	2614	3647	3647	1.0000000
C2	2816066	2817617	BolC2t06461H	0	+	1337	1551	1551	1.0000000
C2	2818841	2822355	BolC2t06462H	0	-	1748	3510	3514	0.9988617
C2	2833175	2836485	BolC2t06463H	0	+	3404	3310	3310	1.0000000
C2	2841089	2842371	BolC2t06464H	0	-	1491	1279	1282	0.9976599
C2	2843545	2845912	BolC2t06465H	0	-	119	1587	2367	0.6704689
C2	2850200	2851379	BolC2t06466H	0	-	294	689	1179	0.5843936
C2	2855397	2856190	BolC2t06467H	0	-	691	793	793	1.0000000
C2	2857897	2858098	BolC2t06468H	0	-	67	201	201	1.0000000
C2	2858372	2859485	BolC2t06469H	0	-	3	35	1113	0.0314465
C2	2866862	2867795	BolC2t06470H	0	-	322	933	933	1.0000000
C2	2870707	2874908	BolC2t06471H	0	-	2780	4130	4201	0.9830993
C2	2875548	2878344	BolC2t06472H	0	-	1703	2796	2796	1.0000000
C2	2880310	2881395	BolC2t06473H	0	+	957	1085	1085	1.0000000
C2	2881452	2882896	BolC2t06474H	0	+	696	1209	1444	0.8372576
C2	2898612	2899299	BolC2t06475H	0	-	416	687	687	1.0000000
C2	2904144	2905317	BolC2t06476H	0	-	159	1032	1173	0.8797954
C2	2906646	2907493	BolC2t06477H	0	-	457	847	847	1.0000000
C2	2908056	2908474	BolC2t06478H	0	+	127	418	418	1.0000000
C2	2909999	2912443	BolC2t06479H	0	+	1448	2444	2444	1.0000000
C2	2914156	2917784	BolC2t06480H	0	+	1130	3337	3628	0.9197905
C2	2918192	2919269	BolC2t06481H	0	+	186	447	1077	0.4150418
C2	2920383	2923512	BolC2t06482H	0	+	1422	3129	3129	1.0000000
C2	2924016	2925669	BolC2t06483H	0	-	896	1647	1653	0.9963703
C2	2930981	2931179	BolC2t06484H	0	+	206	198	198	1.0000000
C2	2932147	2932342	BolC2t06485H	0	-	43	173	195	0.8871795
C2	2936420	2939411	BolC2t06486H	0	+	359	2343	2991	0.7833501
C2	2940138	2945283	BolC2t06487H	0	-	2173	4326	5145	0.8408163
C2	2953069	2954184	BolC2t06488H	0	-	171	947	1115	0.8493273
C2	2955727	2956234	BolC2t06489H	0	-	34	199	507	0.3925049
C2	2957100	2961628	BolC2t06490H	0	-	562	3896	4528	0.8604240
C2	2970717	2974712	BolC2t06491H	0	+	1744	3749	3995	0.9384230
C2	2979934	2980633	BolC2t06492H	0	+	20	374	699	0.5350501
C2	2985775	2988844	BolC2t06493H	0	+	229	2227	3069	0.7256435
C2	2989483	2992234	BolC2t06494H	0	-	640	2442	2751	0.8876772
C2	2995558	2996999	BolC2t06495H	0	+	759	1429	1441	0.9916725
C2	2998929	3002557	BolC2t06496H	0	-	2254	3477	3628	0.9583793
C2	3004012	3004629	BolC2t06497H	0	+	96	510	617	0.8265802
C2	3010984	3014319	BolC2t06498H	0	-	2540	3335	3335	1.0000000
C2	3018256	3021945	BolC2t06499H	0	-	633	3104	3689	0.8414204
C2	3023141	3024506	BolC2t06500H	0	-	773	1365	1365	1.0000000
C2	3032220	3032876	BolC2t06501H	0	-	496	656	656	1.0000000
C2	3036041	3036912	BolC2t06502H	0	+	767	871	871	1.0000000
C2	3039242	3044986	BolC2t06503H	0	+	561	2428	5744	0.4227020
C2	3050724	3054473	BolC2t06504H	0	-	959	3634	3749	0.9693251
C2	3057718	3058286	BolC2t06505H	0	-	44	568	568	1.0000000
C2	3060264	3061836	BolC2t06506H	0	-	934	1572	1572	1.0000000
C2	3063812	3066296	BolC2t06507H	0	+	525	2292	2484	0.9227053
C2	3067148	3067957	BolC2t06508H	0	-	261	677	809	0.8368356
C2	3069920	3074278	BolC2t06509H	0	+	1102	3182	4358	0.7301515
C2	3075052	3079263	BolC2t06510H	0	+	2951	3886	4211	0.9228212
C2	3082422	3084248	BolC2t06511H	0	-	1900	1826	1826	1.0000000
C2	3085452	3089074	BolC2t06512H	0	-	1652	3622	3622	1.0000000
C2	3095169	3095496	BolC2t06513H	0	-	8	152	327	0.4648318
C2	3103934	3104609	BolC2t06514H	0	-	14	284	675	0.4207408
C2	3108618	3109293	BolC2t06515H	0	-	24	293	675	0.4340741
C2	3112267	3112765	BolC2t06516H	0	-	0	0	498	0.0000000
C2	3115620	3120021	BolC2t06517H	0	+	861	3637	4401	0.8264031
C2	3120640	3121560	BolC2t06518H	0	-	483	920	920	1.0000000
C2	3122543	3128968	BolC2t06519H	0	+	1577	5578	6425	0.8681712
C2	3132332	3135148	BolC2t06520H	0	-	775	2459	2816	0.8732244
C2	3137764	3138836	BolC2t06521H	0	-	1090	1072	1072	1.0000000
C2	3141797	3145298	BolC2t06522H	0	+	1170	3419	3501	0.9765781
C2	3169196	3171488	BolC2t06523H	0	-	1794	2224	2292	0.9703316
C2	3177267	3179224	BolC2t06524H	0	-	883	1931	1957	0.9867144
C2	3181345	3183029	BolC2t06525H	0	-	1029	1626	1684	0.9655582
C2	3186237	3187353	BolC2t06526H	0	+	478	1019	1116	0.9130824
C2	3197907	3202002	BolC2t06527H	0	+	2233	4094	4095	0.9997558
C2	3202518	3203001	BolC2t06528H	0	-	288	483	483	1.0000000
C2	3209408	3219914	BolC2t06529H	0	-	3852	10250	10506	0.9756330
C2	3221568	3227376	BolC2t06530H	0	+	1147	4550	5808	0.7834022
C2	3229763	3232787	BolC2t06531H	0	-	2835	3024	3024	1.0000000
C2	3233646	3237524	BolC2t06532H	0	+	1070	3116	3878	0.8035070
C2	3238638	3239393	BolC2t06533H	0	+	248	725	755	0.9602649
C2	3243819	3245926	BolC2t06534H	0	+	1563	2107	2107	1.0000000
C2	3246239	3247425	BolC2t06535H	0	-	525	1186	1186	1.0000000
C2	3249590	3251992	BolC2t06536H	0	+	1136	2365	2402	0.9845962
C2	3253717	3255466	BolC2t06537H	0	-	330	1271	1749	0.7267010
C2	3267210	3267765	BolC2t06538H	0	+	158	555	555	1.0000000
C2	3281119	3282032	BolC2t06539H	0	+	70	607	913	0.6648412
C2	3304950	3305956	BolC2t06540H	0	-	760	1006	1006	1.0000000
C2	3306480	3307840	BolC2t06541H	0	+	355	1119	1360	0.8227941
C2	3313370	3315188	BolC2t06542H	0	+	441	1576	1818	0.8668867
C2	3319566	3321218	BolC2t06543H	0	-	965	1555	1652	0.9412833
C2	3328437	3335039	BolC2t06544H	0	+	3711	6489	6602	0.9828840
C2	3337890	3341080	BolC2t06545H	0	+	1171	3089	3190	0.9683385
C2	3341319	3343100	BolC2t06546H	0	-	469	1558	1781	0.8747894
C2	3352433	3354612	BolC2t06547H	0	+	526	1985	2179	0.9109684
C2	3356339	3358302	BolC2t06548H	0	+	1081	1930	1963	0.9831890
C2	3367445	3370547	BolC2t06549H	0	+	1497	3033	3102	0.9777563
C2	3378835	3379297	BolC2t06550H	0	+	460	462	462	1.0000000
C2	3380256	3384276	BolC2t06551H	0	+	624	2798	4020	0.6960199
C2	3384474	3386669	BolC2t06552H	0	-	783	2109	2195	0.9608200
C2	3387434	3389257	BolC2t06553H	0	-	2356	1823	1823	1.0000000
C2	3390846	3392981	BolC2t06554H	0	-	1194	2135	2135	1.0000000
C2	3393444	3395176	BolC2t06555H	0	-	1626	1732	1732	1.0000000
C2	3397633	3399156	BolC2t06556H	0	-	1239	1523	1523	1.0000000
C2	3399535	3400784	BolC2t06557H	0	-	527	1101	1249	0.8815052
C2	3402129	3403783	BolC2t06558H	0	+	1008	1630	1654	0.9854897
C2	3409357	3410354	BolC2t06559H	0	+	821	997	997	1.0000000
C2	3410696	3414870	BolC2t06560H	0	-	1355	3987	4174	0.9551988
C2	3415908	3419567	BolC2t06561H	0	+	2732	3634	3659	0.9931675
C2	3420097	3420763	BolC2t06562H	0	+	230	666	666	1.0000000
C2	3420908	3422261	BolC2t06563H	0	-	700	1299	1353	0.9600887
C2	3424200	3424755	BolC2t06564H	0	-	3	55	555	0.0990991
C2	3426223	3426682	BolC2t06565H	0	-	0	0	459	0.0000000
C2	3427082	3429305	BolC2t06566H	0	-	1101	2198	2223	0.9887539
C2	3430187	3434338	BolC2t06567H	0	+	1541	4111	4151	0.9903638
C2	3436997	3437832	BolC2t06568H	0	-	0	0	835	0.0000000
C2	3438045	3440385	BolC2t06569H	0	-	17	184	2340	0.0786325
C2	3441418	3443013	BolC2t06570H	0	-	0	0	1595	0.0000000
C2	3444932	3448322	BolC2t06571H	0	-	478	2817	3390	0.8309734
C2	3450479	3452635	BolC2t06572H	0	+	1177	1934	2156	0.8970315
C2	3453102	3454131	BolC2t06573H	0	-	157	810	1029	0.7871720
C2	3459149	3460191	BolC2t06574H	0	-	472	915	1042	0.8781190
C2	3465092	3468533	BolC2t06575H	0	+	2191	3260	3441	0.9473990
C2	3469602	3475346	BolC2t06576H	0	+	2162	5209	5744	0.9068593
C2	3475600	3477301	BolC2t06577H	0	-	181	1259	1701	0.7401528
C2	3479253	3481126	BolC2t06578H	0	+	93	900	1873	0.4805126
C2	3484737	3487168	BolC2t06579H	0	+	1032	2198	2431	0.9041547
C2	3490250	3491630	BolC2t06580H	0	-	812	1348	1380	0.9768116
C2	3493630	3493834	BolC2t06581H	0	-	239	204	204	1.0000000
C2	3494574	3495838	BolC2t06582H	0	+	731	1124	1264	0.8892405
C2	3495943	3497732	BolC2t06583H	0	-	1041	1480	1789	0.8272778
C2	3499735	3505623	BolC2t06584H	0	+	3968	5563	5888	0.9448030
C2	3507561	3516461	BolC2t06585H	0	+	2121	5029	8900	0.5650562
C2	3508768	3509557	BolC2t06586H	0	-	0	0	789	0.0000000
C2	3517274	3519644	BolC2t06587H	0	+	524	1175	2370	0.4957806
C2	3520729	3522571	BolC2t06588H	0	+	611	1470	1842	0.7980456
C2	3522819	3523844	BolC2t06589H	0	-	490	905	1025	0.8829268
C2	3525055	3527907	BolC2t06590H	0	-	1760	2679	2852	0.9393408
C2	3532415	3533945	BolC2t06591H	0	+	1512	1530	1530	1.0000000
C2	3535928	3536700	BolC2t06592H	0	-	277	705	772	0.9132124
C2	3538811	3539999	BolC2t06593H	0	-	429	1083	1188	0.9116161
C2	3541855	3543597	BolC2t06594H	0	-	805	1742	1742	1.0000000
C2	3547950	3548292	BolC2t06595H	0	+	6	10	342	0.0292398
C2	3569879	3571337	BolC2t06596H	0	+	239	1250	1458	0.8573388
C2	3571540	3574202	BolC2t06597H	0	-	202	1751	2662	0.6577761
C2	3576783	3579806	BolC2t06598H	0	-	1365	2437	3023	0.8061528
C2	3582723	3583227	BolC2t06599H	0	+	333	504	504	1.0000000
C2	3585158	3586423	BolC2t06600H	0	+	889	1259	1265	0.9952569
C2	3587510	3589196	BolC2t06601H	0	-	845	1686	1686	1.0000000
C2	3594445	3594859	BolC2t06602H	0	+	75	361	414	0.8719807
C2	3597024	3597646	BolC2t06603H	0	-	580	577	622	0.9276527
C2	3598290	3600627	BolC2t06604H	0	-	725	2165	2337	0.9264014
C2	3610482	3612409	BolC2t06605H	0	+	1293	1857	1927	0.9636741
C2	3623255	3623477	BolC2t06606H	0	+	108	222	222	1.0000000
C2	3627201	3632560	BolC2t06607H	0	+	4260	5276	5359	0.9845120
C2	3634236	3635045	BolC2t06608H	0	+	2	20	809	0.0247219
C2	3635539	3635907	BolC2t06609H	0	-	362	368	368	1.0000000
C2	3637435	3637675	BolC2t06610H	0	-	78	240	240	1.0000000
C2	3647510	3648909	BolC2t06611H	0	+	0	0	1399	0.0000000
C2	3650754	3650916	BolC2t06612H	0	+	18	162	162	1.0000000
C2	3653981	3654240	BolC2t06613H	0	-	8	20	259	0.0772201
C2	3656576	3657387	BolC2t06614H	0	-	372	776	811	0.9568434
C2	3659345	3660096	BolC2t06615H	0	+	0	0	751	0.0000000
C2	3660647	3662280	BolC2t06616H	0	-	742	1551	1633	0.9497856
C2	3663805	3666147	BolC2t06617H	0	-	559	1427	2342	0.6093083
C2	3669347	3672250	BolC2t06618H	0	+	450	2095	2903	0.7216672
C2	3673062	3675553	BolC2t06619H	0	-	291	1795	2491	0.7205942
C2	3677354	3677720	BolC2t06620H	0	-	0	0	366	0.0000000
C2	3679950	3681696	BolC2t06621H	0	-	271	1450	1746	0.8304697
C2	3683739	3683970	BolC2t06622H	0	-	81	177	231	0.7662337
C2	3685505	3686989	BolC2t06623H	0	+	398	1091	1484	0.7351752
C2	3688240	3689166	BolC2t06624H	0	-	105	829	926	0.8952484
C2	3708543	3708684	BolC2t06625H	0	+	38	110	141	0.7801418
C2	3708698	3708971	BolC2t06626H	0	-	105	207	273	0.7582418
C2	3709636	3711221	BolC2t06627H	0	+	1085	1452	1585	0.9160883
C2	3712946	3713078	BolC2t06628H	0	+	1	62	132	0.4696970
C2	3714482	3714886	BolC2t06629H	0	+	127	376	404	0.9306931
C2	3720383	3720683	BolC2t06630H	0	+	34	246	300	0.8200000
C2	3724491	3725801	BolC2t06631H	0	-	142	1137	1310	0.8679389
C2	3736728	3744726	BolC2t06632H	0	+	246	2687	7998	0.3359590
C2	3745911	3763006	BolC2t06633H	0	-	1602	9435	17095	0.5519158
C2	3763934	3764209	BolC2t06634H	0	-	0	0	275	0.0000000
C2	3774223	3781536	BolC2t06635H	0	+	481	4581	7313	0.6264187
C2	3788128	3789343	BolC2t06636H	0	-	18	834	1215	0.6864197
C2	3790272	3790547	BolC2t06637H	0	-	0	0	275	0.0000000
C2	3807407	3808217	BolC2t06638H	0	+	19	427	810	0.5271605
C2	3812972	3821603	BolC2t06639H	0	-	1066	3175	8631	0.3678600
C2	3816383	3816976	BolC2t06640H	0	-	195	488	593	0.8229342
C2	3832720	3834704	BolC2t06641H	0	-	1143	1900	1984	0.9576613
C2	3838687	3840603	BolC2t06642H	0	-	1683	1873	1916	0.9775574
C2	3842429	3844008	BolC2t06643H	0	-	522	1387	1579	0.8784041
C2	3845196	3845893	BolC2t06644H	0	+	167	284	697	0.4074605
C2	3846862	3847096	BolC2t06645H	0	+	40	234	234	1.0000000
C2	3848605	3849489	BolC2t06646H	0	+	146	182	884	0.2058824
C2	3854227	3857385	BolC2t06647H	0	+	1000	2177	3158	0.6893604
C2	3858407	3861175	BolC2t06648H	0	-	2937	2632	2768	0.9508671
C2	3862598	3862928	BolC2t06649H	0	+	0	0	330	0.0000000
C2	3869670	3869961	BolC2t06650H	0	-	94	291	291	1.0000000
C2	3870857	3873096	BolC2t06651H	0	-	299	1342	2239	0.5993747
C2	3882544	3884129	BolC2t06652H	0	-	0	0	1585	0.0000000
C2	3888958	3891221	BolC2t06653H	0	-	257	199	2263	0.0879364
C2	3898536	3898995	BolC2t06654H	0	-	26	221	459	0.4814815
C2	3907789	3911384	BolC2t06655H	0	-	1125	2463	3595	0.6851182
C2	3914022	3914250	BolC2t06656H	0	-	14	87	228	0.3815790
C2	3917244	3918225	BolC2t06657H	0	+	1032	961	981	0.9796126
C2	3918645	3922903	BolC2t06658H	0	-	1804	3504	4258	0.8229216
C2	3925189	3925855	BolC2t06659H	0	+	619	624	666	0.9369369
C2	3930048	3932519	BolC2t06660H	0	+	934	2282	2471	0.9235128
C2	3933838	3935027	BolC2t06661H	0	-	580	1052	1189	0.8847771
C2	3938840	3939026	BolC2t06662H	0	-	249	180	186	0.9677419
C2	3939898	3956373	BolC2t06663H	0	+	334	3666	16475	0.2225190
C2	3962817	3963003	BolC2t06664H	0	-	10	153	186	0.8225806
C2	3964132	3966439	BolC2t06665H	0	+	432	2115	2307	0.9167750
C2	3970032	3971402	BolC2t06666H	0	+	220	1069	1370	0.7802920
C2	3972230	3974725	BolC2t06667H	0	-	1641	2156	2495	0.8641282
C2	3978500	3985970	BolC2t06668H	0	+	665	4781	7470	0.6400267
C2	3987504	3988528	BolC2t06669H	0	+	786	994	1024	0.9707031
C2	3988642	3989782	BolC2t06670H	0	-	270	876	1140	0.7684211
C2	3990005	3996119	BolC2t06671H	0	-	2068	5201	6114	0.8506706
C2	3999203	4003276	BolC2t06672H	0	-	1702	3527	4073	0.8659465
C2	4004377	4006497	BolC2t06673H	0	+	333	1837	2120	0.8665094
C2	4007325	4009480	BolC2t06674H	0	+	304	1802	2155	0.8361949
C2	4010427	4014874	BolC2t06675H	0	+	1703	4066	4447	0.9143243
C2	4015825	4017631	BolC2t06676H	0	+	1095	1806	1806	1.0000000
C2	4018045	4024175	BolC2t06677H	0	-	4288	5454	6130	0.8897227
C2	4037695	4039449	BolC2t06678H	0	-	561	1498	1754	0.8540479
C2	4040995	4042554	BolC2t06679H	0	-	1220	1491	1559	0.9563823
C2	4043197	4045458	BolC2t06680H	0	-	197	1437	2261	0.6355595
C2	4047577	4048704	BolC2t06681H	0	+	327	190	1127	0.1685892
C2	4052802	4054725	BolC2t06682H	0	+	662	1726	1923	0.8975559
C2	4061695	4063872	BolC2t06683H	0	+	1768	2177	2177	1.0000000
C2	4065449	4065764	BolC2t06684H	0	+	226	315	315	1.0000000
C2	4091870	4095727	BolC2t06685H	0	-	576	3345	3857	0.8672543
C2	4102367	4103110	BolC2t06686H	0	-	0	0	743	0.0000000
C2	4105055	4105265	BolC2t06687H	0	-	353	210	210	1.0000000
C2	4109539	4110490	BolC2t06688H	0	-	173	893	951	0.9390116
C2	4112034	4112739	BolC2t06689H	0	+	57	446	705	0.6326241
C2	4116893	4118425	BolC2t06690H	0	+	863	1192	1532	0.7780679
C2	4119253	4119616	BolC2t06691H	0	-	33	248	363	0.6831956
C2	4121043	4121970	BolC2t06692H	0	-	236	879	927	0.9482201
C2	4123459	4124094	BolC2t06693H	0	-	599	635	635	1.0000000
C2	4132659	4134075	BolC2t06694H	0	+	312	1104	1416	0.7796610
C2	4141374	4143941	BolC2t06695H	0	+	843	2192	2567	0.8539151
C2	4144507	4147975	BolC2t06696H	0	+	2141	3326	3468	0.9590542
C2	4154141	4155872	BolC2t06697H	0	+	804	1629	1731	0.9410746
C2	4162015	4165138	BolC2t06698H	0	+	26	152	3123	0.0486711
C2	4165390	4170323	BolC2t06699H	0	-	1219	3406	4933	0.6904520
C2	4173981	4174330	BolC2t06700H	0	-	318	349	349	1.0000000
C2	4178789	4180244	BolC2t06701H	0	+	532	1326	1455	0.9113402
C2	4182276	4182996	BolC2t06702H	0	+	234	338	720	0.4694445
C2	4183264	4187423	BolC2t06703H	0	-	2067	3739	4159	0.8990142
C2	4188976	4193210	BolC2t06704H	0	-	1832	3950	4234	0.9329240
C2	4194278	4197639	BolC2t06705H	0	-	747	2598	3361	0.7729842
C2	4202178	4204550	BolC2t06706H	0	+	1235	2292	2372	0.9662732
C2	4205484	4214723	BolC2t06707H	0	-	1847	5194	9239	0.5621821
C2	4218890	4220142	BolC2t06708H	0	+	843	1210	1252	0.9664537
C2	4227218	4230272	BolC2t06709H	0	-	1067	2651	3054	0.8680419
C2	4244208	4244693	BolC2t06710H	0	+	150	485	485	1.0000000
C2	4245635	4247680	BolC2t06711H	0	+	560	1685	2045	0.8239609
C2	4250007	4251988	BolC2t06712H	0	+	625	1734	1981	0.8753155
C2	4258251	4260095	BolC2t06713H	0	+	445	1504	1844	0.8156182
C2	4261161	4272088	BolC2t06714H	0	+	626	4239	10927	0.3879381
C2	4275090	4282849	BolC2t06715H	0	-	722	5206	7759	0.6709628
C2	4285773	4290930	BolC2t06716H	0	-	1528	4577	5157	0.8875315
C2	4291707	4293165	BolC2t06717H	0	-	830	1458	1458	1.0000000
C2	4295542	4296723	BolC2t06718H	0	+	502	915	1181	0.7747672
C2	4296820	4297300	BolC2t06719H	0	-	185	457	480	0.9520833
C2	4297745	4298867	BolC2t06720H	0	-	647	1069	1122	0.9527629
C2	4300808	4301891	BolC2t06721H	0	+	1038	1053	1083	0.9722992
C2	4314140	4314335	BolC2t06722H	0	-	66	179	195	0.9179487
C2	4318350	4318935	BolC2t06723H	0	+	119	517	585	0.8837607
C2	4321552	4322494	BolC2t06724H	0	-	340	916	942	0.9723992
C2	4323992	4326626	BolC2t06725H	0	-	1341	2272	2634	0.8625664
C2	4327861	4329786	BolC2t06726H	0	-	716	1158	1925	0.6015584
C2	4331342	4333943	BolC2t06727H	0	-	869	2286	2601	0.8788927
C2	4346894	4348817	BolC2t06728H	0	+	521	1353	1923	0.7035881
C2	4350800	4361616	BolC2t06729H	0	+	2017	7504	10816	0.6937870
C2	4354280	4356658	BolC2t06730H	0	-	7	383	2378	0.1610597
C2	4369690	4370145	BolC2t06731H	0	+	374	443	455	0.9736264
C2	4371285	4373449	BolC2t06732H	0	+	512	423	2164	0.1954713
C2	4373587	4374503	BolC2t06733H	0	+	750	916	916	1.0000000
C2	4375410	4375563	BolC2t06734H	0	-	300	153	153	1.0000000
C2	4382638	4387448	BolC2t06735H	0	+	3883	4491	4810	0.9336798
C2	4384791	4385439	BolC2t06736H	0	+	996	648	648	1.0000000
C2	4390485	4392152	BolC2t06737H	0	-	1005	1612	1667	0.9670066
C2	4393150	4393859	BolC2t06738H	0	-	562	705	709	0.9943582
C2	4406234	4409716	BolC2t06739H	0	+	1487	3138	3482	0.9012062
C2	4410068	4410721	BolC2t06740H	0	-	286	653	653	1.0000000
C2	4413458	4414074	BolC2t06741H	0	-	68	423	616	0.6866883
C2	4415488	4421406	BolC2t06742H	0	+	1602	5099	5918	0.8616086
C2	4421789	4427715	BolC2t06743H	0	-	1789	4950	5926	0.8353021
C2	4431846	4434375	BolC2t06744H	0	+	398	647	2529	0.2558323
C2	4443134	4443406	BolC2t06745H	0	+	305	272	272	1.0000000
C2	4445089	4449875	BolC2t06746H	0	+	2330	4506	4786	0.9414960
C2	4452809	4456333	BolC2t06747H	0	+	1908	3396	3524	0.9636776
C2	4457361	4460245	BolC2t06748H	0	-	1805	2271	2884	0.7874480
C2	4461053	4462736	BolC2t06749H	0	-	590	1645	1683	0.9774213
C2	4465719	4468350	BolC2t06750H	0	-	1486	1898	2631	0.7213987
C2	4469436	4470470	BolC2t06751H	0	-	753	1006	1034	0.9729207
C2	4471413	4473321	BolC2t06752H	0	-	1198	1685	1908	0.8831237
C2	4480831	4482830	BolC2t06753H	0	-	583	1767	1999	0.8839419
C2	4487917	4488229	BolC2t06754H	0	+	394	312	312	1.0000000
C2	4489193	4489844	BolC2t06755H	0	+	80	490	651	0.7526882
C2	4490165	4491310	BolC2t06756H	0	-	470	1027	1145	0.8969432
C2	4494931	4495881	BolC2t06757H	0	-	772	660	950	0.6947368
C2	4497480	4498125	BolC2t06758H	0	+	490	383	645	0.5937985
C2	4500105	4501131	BolC2t06759H	0	+	402	996	1026	0.9707602
C2	4503137	4509436	BolC2t06760H	0	-	2031	5643	6299	0.8958565
C2	4519090	4521503	BolC2t06761H	0	-	1016	2340	2413	0.9697472
C2	4536763	4538305	BolC2t06762H	0	-	77	448	1542	0.2905318
C2	4544332	4546481	BolC2t06763H	0	+	178	1797	2149	0.8362029
C2	4552229	4554420	BolC2t06764H	0	-	176	1734	2191	0.7914194
C2	4555681	4556507	BolC2t06765H	0	+	294	787	826	0.9527845
C2	4572514	4575626	BolC2t06766H	0	+	2210	3062	3112	0.9839332
C2	4576581	4583883	BolC2t06767H	0	+	3361	6735	7302	0.9223500
C2	4585255	4586062	BolC2t06768H	0	+	7	147	807	0.1821561
C2	4588382	4590601	BolC2t06769H	0	+	1791	2093	2219	0.9432177
C2	4594379	4596273	BolC2t06770H	0	-	154	1145	1894	0.6045406
C2	4599272	4599509	BolC2t06771H	0	+	7	47	237	0.1983122
C2	4602878	4607697	BolC2t06772H	0	-	877	4001	4819	0.8302552
C2	4608440	4609067	BolC2t06773H	0	+	695	627	627	1.0000000
C2	4611823	4612254	BolC2t06774H	0	+	333	431	431	1.0000000
C2	4612485	4615327	BolC2t06775H	0	-	1072	2451	2842	0.8624209
C2	4615784	4617259	BolC2t06776H	0	+	1021	1392	1475	0.9437288
C2	4619835	4621141	BolC2t06777H	0	-	649	1280	1306	0.9800919
C2	4621206	4624565	BolC2t06778H	0	+	1493	2505	3359	0.7457576
C2	4625390	4628233	BolC2t06779H	0	+	984	2613	2843	0.9190996
C2	4628826	4632923	BolC2t06780H	0	+	637	1685	4097	0.4112765
C2	4634753	4634994	BolC2t06781H	0	+	0	0	241	0.0000000
C2	4637629	4642316	BolC2t06782H	0	+	892	3637	4687	0.7759761
C2	4645092	4645905	BolC2t06783H	0	+	101	474	813	0.5830258
C2	4646707	4649492	BolC2t06784H	0	+	408	2294	2785	0.8236984
C2	4649910	4651210	BolC2t06785H	0	-	378	1237	1300	0.9515384
C2	4652169	4654379	BolC2t06786H	0	-	803	1592	2210	0.7203620
C2	4666031	4673561	BolC2t06787H	0	+	2188	5352	7530	0.7107570
C2	4673882	4675475	BolC2t06788H	0	-	329	1406	1593	0.8826115
C2	4679140	4680510	BolC2t06789H	0	+	485	832	1370	0.6072993
C2	4681104	4683798	BolC2t06790H	0	-	874	2590	2694	0.9613957
C2	4690264	4692560	BolC2t06791H	0	-	425	2018	2296	0.8789198
C2	4693319	4694729	BolC2t06792H	0	+	373	1410	1410	1.0000000
C2	4697048	4698800	BolC2t06793H	0	-	496	1336	1752	0.7625571
C2	4712498	4714400	BolC2t06794H	0	-	976	1879	1902	0.9879075
C2	4716698	4719478	BolC2t06795H	0	+	1516	2509	2780	0.9025180
C2	4720113	4722123	BolC2t06796H	0	-	180	1296	2010	0.6447761
C2	4723228	4723590	BolC2t06797H	0	+	15	250	362	0.6906077
C2	4729357	4729531	BolC2t06798H	0	+	1	57	174	0.3275862
C2	4731884	4732663	BolC2t06799H	0	+	36	287	779	0.3684210
C2	4733707	4735591	BolC2t06800H	0	+	274	1771	1884	0.9400212
C2	4735967	4737808	BolC2t06801H	0	+	189	1556	1841	0.8451928
C2	4738098	4738342	BolC2t06802H	0	-	36	240	244	0.9836066
C2	4745982	4746417	BolC2t06803H	0	+	51	411	435	0.9448276
C2	4746687	4748885	BolC2t06804H	0	-	773	2198	2198	1.0000000
C2	4749612	4751470	BolC2t06805H	0	-	600	1654	1858	0.8902045
C2	4753604	4759238	BolC2t06806H	0	-	739	2477	5634	0.4396521
C2	4772708	4794329	BolC2t06807H	0	+	2447	12798	21621	0.5919245
C2	4794922	4795420	BolC2t06808H	0	-	20	219	498	0.4397590
C2	4797909	4798461	BolC2t06809H	0	+	56	521	552	0.9438406
C2	4799516	4802196	BolC2t06810H	0	-	952	2550	2680	0.9514925
C2	4802892	4804298	BolC2t06811H	0	-	265	1031	1406	0.7332859
C2	4808836	4816433	BolC2t06812H	0	-	268	2645	7597	0.3481638
C2	4824994	4827529	BolC2t06813H	0	-	349	1274	2535	0.5025641
C2	4827428	4827757	BolC2t06814H	0	-	207	329	329	1.0000000
C2	4829348	4833650	BolC2t06815H	0	-	1367	3268	4302	0.7596467
C2	4836390	4837138	BolC2t06816H	0	-	0	0	748	0.0000000
C2	4843174	4846043	BolC2t06817H	0	-	340	1287	2869	0.4485884
C2	4847676	4850838	BolC2t06818H	0	+	2406	2973	3162	0.9402277
C2	4852533	4856723	BolC2t06819H	0	+	1921	2941	4190	0.7019093
C2	4853950	4854810	BolC2t06820H	0	-	9	263	860	0.3058140
C2	4858116	4859762	BolC2t06821H	0	-	977	1106	1646	0.6719320
C2	4863712	4863952	BolC2t06822H	0	+	110	220	240	0.9166667
C2	4864547	4864991	BolC2t06823H	0	-	4	151	444	0.3400901
C2	4865235	4867787	BolC2t06824H	0	-	2306	2455	2552	0.9619906
C2	4868430	4871960	BolC2t06825H	0	+	1705	2930	3530	0.8300284
C2	4883838	4884606	BolC2t06826H	0	+	284	706	768	0.9192708
C2	4886215	4887328	BolC2t06827H	0	+	61	562	1113	0.5049416
C2	4889448	4889919	BolC2t06828H	0	-	196	471	471	1.0000000
C2	4891147	4891958	BolC2t06829H	0	+	998	685	811	0.8446363
C2	4892300	4894769	BolC2t06830H	0	-	1060	2032	2469	0.8230053
C2	4895003	4895409	BolC2t06831H	0	+	63	224	406	0.5517241
C2	4901681	4902813	BolC2t06832H	0	+	832	1044	1132	0.9222615
C2	4908125	4909768	BolC2t06833H	0	-	1922	1545	1643	0.9403530
C2	4911301	4913895	BolC2t06834H	0	-	565	1691	2594	0.6518890
C2	4927159	4928436	BolC2t06835H	0	-	255	1195	1277	0.9357870
C2	4931919	4933040	BolC2t06836H	0	+	8	150	1121	0.1338091
C2	4937191	4937341	BolC2t06837H	0	-	3	90	150	0.6000000
C2	4941982	4942247	BolC2t06838H	0	-	1	21	265	0.0792453
C2	4949878	4950810	BolC2t06839H	0	+	0	0	932	0.0000000
C2	4970547	4972512	BolC2t06840H	0	-	61	657	1965	0.3343512
C2	4975168	4977154	BolC2t06841H	0	-	195	1334	1986	0.6717019
C2	4985999	4987744	BolC2t06842H	0	+	60	554	1745	0.3174785
C2	4992422	5001640	BolC2t06843H	0	-	3944	6064	9218	0.6578434
C2	5021303	5022956	BolC2t06844H	0	-	14	319	1653	0.1929825
C2	5028776	5029284	BolC2t06845H	0	-	13	174	508	0.3425197
C2	5036154	5037825	BolC2t06846H	0	+	310	1104	1671	0.6606822
C2	5040732	5042469	BolC2t06847H	0	-	57	844	1737	0.4858952
C2	5048726	5049047	BolC2t06848H	0	+	77	321	321	1.0000000
C2	5054508	5054832	BolC2t06849H	0	-	51	166	324	0.5123457
C2	5055848	5056933	BolC2t06850H	0	+	47	328	1085	0.3023041
C2	5057045	5057291	BolC2t06851H	0	+	0	0	246	0.0000000
C2	5072768	5072915	BolC2t06852H	0	-	13	139	147	0.9455782
C2	5073856	5075671	BolC2t06853H	0	-	29	731	1815	0.4027548
C2	5076016	5077075	BolC2t06854H	0	-	24	714	1059	0.6742210
C2	5080549	5083964	BolC2t06855H	0	+	588	2806	3415	0.8216691
C2	5084747	5088184	BolC2t06856H	0	-	1066	3196	3437	0.9298807
C2	5089613	5100070	BolC2t06857H	0	-	1117	2263	10457	0.2164101
C2	5095036	5095833	BolC2t06858H	0	+	2	47	797	0.0589711
C2	5110559	5112389	BolC2t06859H	0	-	2	82	1830	0.0448087
C2	5113925	5114915	BolC2t06860H	0	-	77	764	990	0.7717172
C2	5119140	5126046	BolC2t06861H	0	-	5363	6387	6906	0.9248480
C2	5128048	5128264	BolC2t06862H	0	-	33	216	216	1.0000000
C2	5136518	5138946	BolC2t06863H	0	+	177	1650	2428	0.6795717
C2	5139201	5140686	BolC2t06864H	0	-	163	862	1485	0.5804714
C2	5142886	5143186	BolC2t06865H	0	-	94	300	300	1.0000000
C2	5144437	5144716	BolC2t06866H	0	-	7	279	279	1.0000000
C2	5145524	5145815	BolC2t06867H	0	+	305	291	291	1.0000000
C2	5146808	5147105	BolC2t06868H	0	-	164	297	297	1.0000000
C2	5161013	5163600	BolC2t06869H	0	-	50	814	2587	0.3146502
C2	5161965	5162262	BolC2t06870H	0	+	39	297	297	1.0000000
C2	5165949	5166249	BolC2t06871H	0	+	2	79	300	0.2633333
C2	5167713	5168005	BolC2t06872H	0	-	9	78	292	0.2671233
C2	5175572	5176086	BolC2t06873H	0	-	527	514	514	1.0000000
C2	5177020	5177320	BolC2t06874H	0	+	32	300	300	1.0000000
C2	5178772	5179063	BolC2t06875H	0	-	0	0	291	0.0000000
C2	5180520	5180807	BolC2t06876H	0	-	23	210	287	0.7317073
C2	5181885	5182164	BolC2t06877H	0	-	294	279	279	1.0000000
C2	5183149	5183440	BolC2t06878H	0	+	77	291	291	1.0000000
C2	5184395	5185834	BolC2t06879H	0	-	778	1399	1439	0.9722029
C2	5190836	5192331	BolC2t06880H	0	+	690	1495	1495	1.0000000
C2	5192778	5193109	BolC2t06881H	0	-	113	253	331	0.7643505
C2	5193868	5194839	BolC2t06882H	0	-	528	971	971	1.0000000
C2	5196381	5199573	BolC2t06883H	0	-	966	3192	3192	1.0000000
C2	5201122	5204968	BolC2t06884H	0	-	1661	3769	3846	0.9799792
C2	5205506	5206408	BolC2t06885H	0	-	363	902	902	1.0000000
C2	5206808	5207651	BolC2t06886H	0	+	162	715	843	0.8481613
C2	5214274	5215694	BolC2t06887H	0	-	19	405	1420	0.2852113
C2	5248019	5248875	BolC2t06888H	0	+	111	769	856	0.8983645
C2	5250214	5256225	BolC2t06889H	0	-	3685	5900	6011	0.9815338
C2	5258069	5259080	BolC2t06890H	0	-	534	969	1011	0.9584570
C2	5262258	5262482	BolC2t06891H	0	-	259	224	224	1.0000000
C2	5265122	5265524	BolC2t06892H	0	+	14	44	402	0.1094527
C2	5266232	5267729	BolC2t06893H	0	-	268	1439	1497	0.9612558
C2	5274158	5275290	BolC2t06894H	0	+	1146	1098	1132	0.9699647
C2	5275929	5276793	BolC2t06895H	0	-	98	864	864	1.0000000
C2	5282325	5285728	BolC2t06896H	0	+	156	1285	3403	0.3776080
C2	5286398	5287964	BolC2t06897H	0	+	39	1006	1566	0.6424010
C2	5288015	5289533	BolC2t06898H	0	-	296	1439	1518	0.9479578
C2	5296750	5299151	BolC2t06899H	0	-	894	2401	2401	1.0000000
C2	5300583	5302419	BolC2t06900H	0	+	177	1491	1836	0.8120915
C2	5302932	5304255	BolC2t06901H	0	+	92	1192	1323	0.9009826
C2	5305122	5307027	BolC2t06902H	0	+	684	1810	1905	0.9501312
C2	5313615	5315533	BolC2t06903H	0	+	1223	1895	1918	0.9880083
C2	5317603	5318602	BolC2t06904H	0	-	166	561	999	0.5615616
C2	5328803	5331969	BolC2t06905H	0	-	1125	3056	3166	0.9652559
C2	5332215	5334963	BolC2t06906H	0	+	962	2672	2748	0.9723435
C2	5335102	5336321	BolC2t06907H	0	-	749	962	1219	0.7891715
C2	5340236	5341344	BolC2t06908H	0	-	525	1104	1108	0.9963899
C2	5362040	5362322	BolC2t06909H	0	-	178	282	282	1.0000000
C2	5363009	5365488	BolC2t06910H	0	+	298	2112	2479	0.8519564
C2	5365816	5368222	BolC2t06911H	0	+	1200	2406	2406	1.0000000
C2	5369035	5370882	BolC2t06912H	0	+	909	1801	1847	0.9750947
C2	5371344	5372163	BolC2t06913H	0	-	602	791	819	0.9658120
C2	5377983	5379862	BolC2t06914H	0	-	890	1879	1879	1.0000000
C2	5380750	5380927	BolC2t06915H	0	-	21	177	177	1.0000000
C2	5381547	5382527	BolC2t06916H	0	+	58	659	980	0.6724490
C2	5382922	5385459	BolC2t06917H	0	+	1230	2509	2537	0.9889634
C2	5400238	5404383	BolC2t06918H	0	+	1332	3510	4145	0.8468034
C2	5406078	5410548	BolC2t06919H	0	+	3903	4470	4470	1.0000000
C2	5411062	5415627	BolC2t06920H	0	-	1309	4303	4565	0.9426068
C2	5417974	5418082	BolC2t06921H	0	-	194	108	108	1.0000000
C2	5418786	5418933	BolC2t06922H	0	-	191	147	147	1.0000000
C2	5426066	5426468	BolC2t06923H	0	-	217	402	402	1.0000000
C2	5426551	5427401	BolC2t06924H	0	-	624	850	850	1.0000000
C2	5429634	5430699	BolC2t06925H	0	-	74	656	1065	0.6159624
C2	5438584	5442751	BolC2t06926H	0	+	1902	3311	4167	0.7945764
C2	5445519	5445868	BolC2t06927H	0	+	2	89	349	0.2550143
C2	5460183	5462512	BolC2t06928H	0	+	299	1949	2329	0.8368399
C2	5465214	5465465	BolC2t06929H	0	+	5	61	251	0.2430279
C2	5469370	5470378	BolC2t06930H	0	-	265	946	1008	0.9384921
C2	5509801	5511842	BolC2t06931H	0	-	0	0	2041	0.0000000
C2	5513568	5513791	BolC2t06932H	0	-	0	0	223	0.0000000
C2	5539677	5585455	BolC2t06933H	0	-	9948	35017	45778	0.7649307
C2	5545378	5547456	BolC2t06934H	0	+	240	1730	2078	0.8325313
C2	5584427	5585202	BolC2t06935H	0	-	19	589	775	0.7600000
C2	5603637	5604105	BolC2t06936H	0	-	151	468	468	1.0000000
C2	5613385	5613580	BolC2t06937H	0	-	90	195	195	1.0000000
C2	5617632	5620023	BolC2t06938H	0	-	2218	2388	2391	0.9987453
C2	5625937	5628325	BolC2t06939H	0	+	682	2307	2388	0.9660804
C2	5628761	5630647	BolC2t06940H	0	-	262	1501	1886	0.7958643
C2	5630879	5631571	BolC2t06941H	0	+	131	667	692	0.9638728
C2	5632059	5634562	BolC2t06942H	0	+	702	2244	2503	0.8965242
C2	5634783	5635495	BolC2t06943H	0	+	499	682	712	0.9578652
C2	5636629	5637294	BolC2t06944H	0	+	506	665	665	1.0000000
C2	5639696	5641771	BolC2t06945H	0	+	1062	2075	2075	1.0000000
C2	5641955	5644808	BolC2t06946H	0	-	1054	2802	2853	0.9821241
C2	5646610	5647350	BolC2t06947H	0	+	478	740	740	1.0000000
C2	5648137	5648974	BolC2t06948H	0	+	275	791	837	0.9450418
C2	5654131	5654431	BolC2t06949H	0	-	0	0	300	0.0000000
C2	5658899	5659751	BolC2t06950H	0	-	73	517	852	0.6068075
C2	5670809	5671456	BolC2t06951H	0	+	554	647	647	1.0000000
C2	5671621	5675048	BolC2t06952H	0	+	879	2732	3427	0.7971987
C2	5698475	5699483	BolC2t06953H	0	+	178	666	1008	0.6607143
C2	5830046	5830241	BolC2t06954H	0	-	147	195	195	1.0000000
C2	5831417	5831525	BolC2t06955H	0	-	235	108	108	1.0000000
C2	5835310	5838029	BolC2t06956H	0	-	1147	2706	2719	0.9952188
C2	5839448	5843985	BolC2t06957H	0	-	3023	4343	4537	0.9572405
C2	5845034	5847984	BolC2t06958H	0	+	2272	2950	2950	1.0000000
C2	5848147	5849428	BolC2t06959H	0	-	987	1281	1281	1.0000000
C2	5851295	5855328	BolC2t06960H	0	+	2330	3794	4033	0.9407389
C2	5858465	5858582	BolC2t06961H	0	+	120	117	117	1.0000000
C2	5859446	5866010	BolC2t06962H	0	+	3743	6343	6564	0.9663315
C2	5866760	5868531	BolC2t06963H	0	-	1251	1771	1771	1.0000000
C2	5875233	5877427	BolC2t06964H	0	+	1062	2194	2194	1.0000000
C2	5878480	5881648	BolC2t06965H	0	+	1255	2760	3168	0.8712121
C2	5883441	5886299	BolC2t06966H	0	+	407	2203	2858	0.7708188
C2	5889788	5890167	BolC2t06967H	0	+	108	379	379	1.0000000
C2	5892578	5893911	BolC2t06968H	0	-	908	1071	1333	0.8034509
C2	5895011	5896428	BolC2t06969H	0	-	399	1294	1417	0.9131969
C2	5896574	5897071	BolC2t06970H	0	-	1326	497	497	1.0000000
C2	5898187	5898708	BolC2t06971H	0	+	112	469	521	0.9001920
C2	5899448	5901441	BolC2t06972H	0	-	113	1288	1993	0.6462619
C2	5902654	5903104	BolC2t06973H	0	-	98	450	450	1.0000000
C2	5904318	5908652	BolC2t06974H	0	-	1169	3069	4334	0.7081218
C2	5909963	5911441	BolC2t06975H	0	-	982	1478	1478	1.0000000
C2	5925091	5925491	BolC2t06976H	0	+	321	400	400	1.0000000
C2	5938485	5946812	BolC2t06977H	0	+	4254	7331	8327	0.8803891
C2	5947365	5949482	BolC2t06978H	0	-	1217	2041	2117	0.9641001
C2	5950600	5952270	BolC2t06979H	0	-	53	1122	1670	0.6718563
C2	5955276	5956946	BolC2t06980H	0	+	42	695	1670	0.4161677
C2	5957261	5958023	BolC2t06981H	0	-	108	553	762	0.7257218
C2	5958478	5958802	BolC2t06982H	0	+	121	324	324	1.0000000
C2	5960187	5965775	BolC2t06983H	0	-	1499	5453	5588	0.9758411
C2	5974782	5978598	BolC2t06984H	0	-	804	3617	3816	0.9478512
C2	5981664	5982033	BolC2t06985H	0	+	440	369	369	1.0000000
C2	5982477	5985922	BolC2t06986H	0	-	2664	3351	3445	0.9727141
C2	5997741	5998404	BolC2t06987H	0	+	119	469	663	0.7073907
C2	6001435	6007538	BolC2t06988H	0	+	1550	4365	6103	0.7152220
C2	6008193	6009102	BolC2t06989H	0	-	85	366	909	0.4026403
C2	6009686	6010745	BolC2t06990H	0	-	1968	1059	1059	1.0000000
C2	6027199	6029214	BolC2t06991H	0	-	868	1857	2015	0.9215881
C2	6031093	6032719	BolC2t06992H	0	-	364	1417	1626	0.8714637
C2	6037676	6038783	BolC2t06993H	0	-	1477	1107	1107	1.0000000
C2	6042809	6044087	BolC2t06994H	0	-	1142	1278	1278	1.0000000
C2	6045992	6047086	BolC2t06995H	0	-	777	1094	1094	1.0000000
C2	6048157	6051243	BolC2t06996H	0	-	2688	3086	3086	1.0000000
C2	6059153	6061263	BolC2t06997H	0	+	1966	2110	2110	1.0000000
C2	6068786	6069989	BolC2t06998H	0	+	94	886	1203	0.7364921
C2	6071839	6072829	BolC2t06999H	0	-	482	990	990	1.0000000
C2	6073736	6073931	BolC2t07000H	0	+	58	195	195	1.0000000
C2	6074099	6074384	BolC2t07001H	0	-	46	285	285	1.0000000
C2	6086895	6091375	BolC2t07002H	0	+	2512	4060	4480	0.9062500
C2	6091972	6092987	BolC2t07003H	0	-	965	1015	1015	1.0000000
C2	6095741	6098564	BolC2t07004H	0	-	3212	2672	2823	0.9465108
C2	6103896	6104139	BolC2t07005H	0	-	321	243	243	1.0000000
C2	6114428	6114818	BolC2t07006H	0	+	3	50	390	0.1282051
C2	6119908	6120606	BolC2t07007H	0	+	122	622	698	0.8911175
C2	6121872	6122521	BolC2t07008H	0	-	2	86	649	0.1325116
C2	6125581	6125725	BolC2t07009H	0	-	0	0	144	0.0000000
C2	6173646	6174300	BolC2t07010H	0	+	31	315	654	0.4816514
C2	6176853	6177427	BolC2t07011H	0	+	405	574	574	1.0000000
C2	6179123	6179288	BolC2t07012H	0	+	4	5	165	0.0303030
C2	6181087	6181733	BolC2t07013H	0	-	365	519	646	0.8034056
C2	6183226	6185113	BolC2t07014H	0	-	383	1325	1887	0.7021728
C2	6193216	6194005	BolC2t07015H	0	+	0	0	789	0.0000000
C2	6204640	6205963	BolC2t07016H	0	+	1214	1040	1323	0.7860922
C2	6206545	6208074	BolC2t07017H	0	+	1345	1392	1529	0.9103990
C2	6210030	6211002	BolC2t07018H	0	+	66	676	972	0.6954733
C2	6212810	6213829	BolC2t07019H	0	-	148	319	1019	0.3130520
C2	6230844	6233044	BolC2t07020H	0	+	2	21	2200	0.0095455
C2	6233967	6236442	BolC2t07021H	0	-	51	772	2475	0.3119192
C2	6237661	6238168	BolC2t07022H	0	-	20	448	507	0.8836292
C2	6272866	6274212	BolC2t07023H	0	+	413	1086	1346	0.8068351
C2	6276443	6277220	BolC2t07024H	0	+	1619	777	777	1.0000000
C2	6277238	6277397	BolC2t07025H	0	+	565	159	159	1.0000000
C2	6279007	6280035	BolC2t07026H	0	+	36	495	1028	0.4815175
C2	6309524	6310392	BolC2t07027H	0	+	42	565	868	0.6509216
C2	6312067	6315079	BolC2t07028H	0	+	41	848	3012	0.2815405
C2	6317630	6317834	BolC2t07029H	0	+	134	199	204	0.9754902
C2	6320204	6323151	BolC2t07030H	0	+	194	1676	2947	0.5687140
C2	6323278	6324545	BolC2t07031H	0	-	133	737	1267	0.5816890
C2	6335829	6341104	BolC2t07032H	0	-	2009	4533	5275	0.8593365
C2	6347813	6349042	BolC2t07033H	0	-	833	1147	1229	0.9332791
C2	6350493	6351585	BolC2t07034H	0	-	51	523	1092	0.4789377
C2	6352716	6353784	BolC2t07035H	0	+	13	403	1068	0.3773408
C2	6359014	6360037	BolC2t07036H	0	+	450	767	1023	0.7497556
C2	6365163	6369683	BolC2t07037H	0	+	1998	3304	4520	0.7309734
C2	6370822	6371302	BolC2t07038H	0	-	289	480	480	1.0000000
C2	6372080	6376218	BolC2t07039H	0	-	4152	3731	4138	0.9016433
C2	6391946	6394057	BolC2t07040H	0	+	1275	1948	2111	0.9227854
C2	6399213	6399996	BolC2t07041H	0	+	20	389	783	0.4968072
C2	6401672	6402781	BolC2t07042H	0	+	330	1066	1109	0.9612263
C2	6403352	6413316	BolC2t07043H	0	-	3926	9300	9964	0.9333601
C2	6416869	6418012	BolC2t07044H	0	+	865	912	1143	0.7979003
C2	6418305	6421711	BolC2t07045H	0	-	1397	2133	3406	0.6262478
C2	6422899	6425200	BolC2t07046H	0	-	1961	1953	2301	0.8487614
C2	6426621	6431306	BolC2t07047H	0	+	2176	4378	4685	0.9344717
C2	6434346	6435369	BolC2t07048H	0	+	373	799	1023	0.7810361
C2	6436495	6437560	BolC2t07049H	0	-	389	817	1065	0.7671362
C2	6439847	6443197	BolC2t07050H	0	+	1048	2870	3350	0.8567164
C2	6443535	6444171	BolC2t07051H	0	-	19	270	636	0.4245283
C2	6447227	6447884	BolC2t07052H	0	-	43	403	657	0.6133942
C2	6467509	6468148	BolC2t07053H	0	-	55	221	639	0.3458529
C2	6477752	6478391	BolC2t07054H	0	-	1	16	639	0.0250391
C2	6482708	6485318	BolC2t07055H	0	-	646	2498	2610	0.9570881
C2	6503384	6505177	BolC2t07056H	0	+	563	1712	1793	0.9548243
C2	6517465	6517924	BolC2t07057H	0	-	160	459	459	1.0000000
C2	6522291	6522714	BolC2t07058H	0	-	9	140	423	0.3309693
C2	6526216	6526540	BolC2t07059H	0	+	264	324	324	1.0000000
C2	6534134	6536633	BolC2t07060H	0	+	628	1848	2499	0.7394958
C2	6537671	6539999	BolC2t07061H	0	+	857	2234	2328	0.9596220
C2	6542909	6543749	BolC2t07062H	0	-	244	449	840	0.5345238
C2	6576907	6577257	BolC2t07063H	0	-	4	187	350	0.5342857
C2	6580445	6580802	BolC2t07064H	0	-	32	330	357	0.9243698
C2	6584313	6584670	BolC2t07065H	0	-	8	174	357	0.4873950
C2	6588162	6588522	BolC2t07066H	0	-	21	177	360	0.4916667
C2	6591541	6591891	BolC2t07067H	0	-	16	266	350	0.7600000
C2	6596690	6597903	BolC2t07068H	0	+	205	1148	1213	0.9464139
C2	6598475	6603513	BolC2t07069H	0	-	2607	4211	5038	0.8358476
C2	6618535	6618778	BolC2t07070H	0	-	0	0	243	0.0000000
C2	6634481	6635042	BolC2t07071H	0	-	0	0	561	0.0000000
C2	6637114	6637432	BolC2t07072H	0	+	2	42	318	0.1320755
C2	6642589	6643353	BolC2t07073H	0	+	58	255	764	0.3337696
C2	6650240	6650624	BolC2t07074H	0	-	6	120	384	0.3125000
C2	6659116	6664362	BolC2t07075H	0	-	5037	4724	5246	0.9004956
C2	6667745	6668204	BolC2t07076H	0	+	325	459	459	1.0000000
C2	6678958	6681312	BolC2t07077H	0	-	1969	2265	2354	0.9621920
C2	6682325	6683930	BolC2t07078H	0	-	410	1527	1605	0.9514019
C2	6685135	6685648	BolC2t07079H	0	-	201	513	513	1.0000000
C2	6700363	6703065	BolC2t07080H	0	-	1518	2654	2702	0.9822354
C2	6703577	6705054	BolC2t07081H	0	+	1511	1199	1477	0.8117806
C2	6705746	6707710	BolC2t07082H	0	-	1523	1964	1964	1.0000000
C2	6711039	6715548	BolC2t07083H	0	+	1811	3900	4509	0.8649368
C2	6716021	6716525	BolC2t07084H	0	+	480	394	504	0.7817460
C2	6716768	6720715	BolC2t07085H	0	-	2360	3562	3947	0.9024575
C2	6726209	6726569	BolC2t07086H	0	+	320	360	360	1.0000000
C2	6734954	6763070	BolC2t07087H	0	+	2057	9416	28116	0.3348983
C2	6744592	6744882	BolC2t07088H	0	+	93	290	290	1.0000000
C2	6746406	6748013	BolC2t07089H	0	+	594	996	1607	0.6197884
C2	6763565	6764310	BolC2t07090H	0	+	159	734	745	0.9852349
C2	6766507	6768835	BolC2t07091H	0	+	1244	1908	2328	0.8195876
C2	6774255	6775710	BolC2t07092H	0	+	894	1455	1455	1.0000000
C2	6776131	6781332	BolC2t07093H	0	-	761	3418	5201	0.6571813
C2	6792973	6795151	BolC2t07094H	0	+	1809	1921	2178	0.8820018
C2	6809466	6811752	BolC2t07095H	0	+	449	1856	2286	0.8118985
C2	6817225	6822797	BolC2t07096H	0	+	1320	4076	5572	0.7315147
C2	6829738	6831265	BolC2t07097H	0	+	105	1057	1527	0.6922069
C2	6832050	6832965	BolC2t07098H	0	+	63	512	915	0.5595629
C2	6835188	6836073	BolC2t07099H	0	+	157	453	885	0.5118644
C2	6839304	6841113	BolC2t07100H	0	-	296	1422	1809	0.7860696
C2	6842159	6843665	BolC2t07101H	0	-	1264	1506	1506	1.0000000
C2	6845950	6850570	BolC2t07102H	0	+	377	3752	4620	0.8121212
C2	6853322	6857137	BolC2t07103H	0	-	4813	3714	3815	0.9735256
C2	6865259	6866202	BolC2t07104H	0	-	64	545	943	0.5779427
C2	6869765	6870155	BolC2t07105H	0	+	44	390	390	1.0000000
C2	6885070	6886537	BolC2t07106H	0	+	1717	1467	1467	1.0000000
C2	6891940	6892123	BolC2t07107H	0	+	4	63	183	0.3442623
C2	6907140	6908093	BolC2t07108H	0	+	959	953	953	1.0000000
C2	6909707	6911646	BolC2t07109H	0	+	2667	1939	1939	1.0000000
C2	6912935	6916801	BolC2t07110H	0	-	1262	3363	3866	0.8698913
C2	6925565	6927689	BolC2t07111H	0	+	646	1095	2124	0.5155367
C2	6928256	6929154	BolC2t07112H	0	-	246	771	898	0.8585746
C2	6932537	6935803	BolC2t07113H	0	+	948	3077	3266	0.9421310
C2	6947432	6947682	BolC2t07114H	0	+	538	250	250	1.0000000
C2	6949073	6949286	BolC2t07115H	0	-	9	190	213	0.8920188
C2	6958808	6959371	BolC2t07116H	0	+	0	0	563	0.0000000
C2	6961857	6962043	BolC2t07117H	0	+	2	2	186	0.0107527
C2	6968155	6972241	BolC2t07118H	0	+	1142	2659	4086	0.6507587
C2	6989525	6990351	BolC2t07119H	0	-	490	826	826	1.0000000
C2	6993702	6994411	BolC2t07120H	0	+	7	130	709	0.1833568
C2	6996809	6997421	BolC2t07121H	0	-	645	594	612	0.9705882
C2	6998421	7001266	BolC2t07122H	0	-	2087	2427	2845	0.8530756
C2	7020102	7020756	BolC2t07123H	0	-	22	228	654	0.3486238
C2	7026108	7026471	BolC2t07124H	0	+	162	363	363	1.0000000
C2	7026767	7027127	BolC2t07125H	0	+	106	360	360	1.0000000
C2	7027886	7028024	BolC2t07126H	0	+	9	133	138	0.9637681
C2	7038794	7040370	BolC2t07127H	0	-	595	1447	1576	0.9181472
C2	7062427	7062697	BolC2t07128H	0	+	0	0	270	0.0000000
C2	7063171	7063749	BolC2t07129H	0	+	0	0	578	0.0000000
C2	7064703	7064966	BolC2t07130H	0	+	55	255	263	0.9695817
C2	7067670	7067835	BolC2t07131H	0	+	0	0	165	0.0000000
C2	7073260	7075117	BolC2t07132H	0	+	848	1781	1857	0.9590738
C2	7075883	7082537	BolC2t07133H	0	-	1494	5679	6654	0.8534716
C2	7087620	7089568	BolC2t07134H	0	-	754	1834	1948	0.9414784
C2	7094304	7096660	BolC2t07135H	0	-	1202	1935	2356	0.8213073
C2	7098061	7099414	BolC2t07136H	0	-	72	1029	1353	0.7605321
C2	7106236	7107229	BolC2t07137H	0	+	0	0	993	0.0000000
C2	7119847	7123355	BolC2t07138H	0	-	1071	2682	3508	0.7645382
C2	7124810	7125616	BolC2t07139H	0	+	877	789	806	0.9789082
C2	7128749	7130456	BolC2t07140H	0	-	96	1079	1707	0.6321031
C2	7156872	7157223	BolC2t07141H	0	-	120	351	351	1.0000000
C2	7159049	7160399	BolC2t07142H	0	-	400	1350	1350	1.0000000
C2	7161828	7162674	BolC2t07143H	0	+	378	782	846	0.9243499
C2	7167187	7168000	BolC2t07144H	0	-	157	813	813	1.0000000
C2	7173297	7173564	BolC2t07145H	0	-	32	196	267	0.7340824
C2	7179652	7180359	BolC2t07146H	0	-	710	707	707	1.0000000
C2	7182348	7183993	BolC2t07147H	0	-	1877	1628	1645	0.9896656
C2	7184437	7185226	BolC2t07148H	0	-	73	600	789	0.7604563
C2	7195288	7197028	BolC2t07149H	0	+	271	1407	1740	0.8086207
C2	7197614	7200293	BolC2t07150H	0	-	865	2555	2679	0.9537141
C2	7203092	7205460	BolC2t07151H	0	-	1221	2320	2368	0.9797297
C2	7206958	7208090	BolC2t07152H	0	-	721	1132	1132	1.0000000
C2	7218444	7218609	BolC2t07153H	0	-	37	165	165	1.0000000
C2	7226924	7227542	BolC2t07154H	0	-	30	305	618	0.4935275
C2	7233794	7235969	BolC2t07155H	0	-	1226	2088	2175	0.9600000
C2	7238229	7239505	BolC2t07156H	0	+	1834	1276	1276	1.0000000
C2	7253222	7254678	BolC2t07157H	0	+	69	382	1456	0.2623626
C2	7255409	7260300	BolC2t07158H	0	-	2924	4864	4891	0.9944797
C2	7264972	7265534	BolC2t07159H	0	-	287	550	562	0.9786477
C2	7274075	7277283	BolC2t07160H	0	+	1974	3194	3208	0.9956359
C2	7290108	7291408	BolC2t07161H	0	-	876	1300	1300	1.0000000
C2	7293737	7293890	BolC2t07162H	0	-	2	74	153	0.4836601
C2	7299207	7299511	BolC2t07163H	0	+	21	159	304	0.5230263
C2	7300965	7302247	BolC2t07164H	0	-	395	932	1282	0.7269891
C2	7310914	7311205	BolC2t07165H	0	+	278	291	291	1.0000000
C2	7314561	7316081	BolC2t07166H	0	-	482	1144	1520	0.7526316
C2	7322938	7323564	BolC2t07167H	0	+	117	626	626	1.0000000
C2	7327001	7327331	BolC2t07168H	0	+	50	312	330	0.9454545
C2	7330833	7332069	BolC2t07169H	0	-	133	815	1236	0.6593851
C2	7335626	7335875	BolC2t07170H	0	-	16	199	249	0.7991968
C2	7354639	7356641	BolC2t07171H	0	-	705	1603	2002	0.8006993
C2	7373605	7374391	BolC2t07172H	0	-	441	786	786	1.0000000
C2	7375840	7376005	BolC2t07173H	0	+	205	165	165	1.0000000
C2	7383901	7384333	BolC2t07174H	0	+	18	185	432	0.4282407
C2	7392814	7395645	BolC2t07175H	0	+	1119	2831	2831	1.0000000
C2	7395831	7398277	BolC2t07176H	0	-	1465	2444	2446	0.9991823
C2	7402891	7403841	BolC2t07177H	0	-	272	823	950	0.8663158
C2	7413205	7414504	BolC2t07178H	0	+	448	1242	1299	0.9561201
C2	7423009	7424044	BolC2t07179H	0	+	299	981	1035	0.9478261
C2	7425792	7436378	BolC2t07180H	0	-	2163	7095	10586	0.6702248
C2	7431574	7432459	BolC2t07181H	0	+	19	627	885	0.7084746
C2	7443451	7446584	BolC2t07182H	0	+	740	3021	3133	0.9642515
C2	7451307	7453104	BolC2t07183H	0	+	213	1749	1797	0.9732888
C2	7459311	7461079	BolC2t07184H	0	+	457	1768	1768	1.0000000
C2	7465339	7466347	BolC2t07185H	0	+	931	1008	1008	1.0000000
C2	7469645	7471188	BolC2t07186H	0	+	1414	1543	1543	1.0000000
C2	7472101	7473658	BolC2t07187H	0	-	1187	1557	1557	1.0000000
C2	7476983	7480615	BolC2t07188H	0	-	1127	3568	3632	0.9823788
C2	7482917	7487773	BolC2t07189H	0	-	1181	4201	4856	0.8651153
C2	7501368	7501955	BolC2t07190H	0	-	30	332	587	0.5655878
C2	7503689	7509461	BolC2t07191H	0	+	1806	5279	5772	0.9145877
C2	7511151	7512345	BolC2t07192H	0	-	236	1115	1194	0.9338359
C2	7515806	7516412	BolC2t07193H	0	-	49	383	606	0.6320132
C2	7533521	7535140	BolC2t07194H	0	-	14	217	1619	0.1340334
C2	7536504	7537147	BolC2t07195H	0	+	32	407	643	0.6329705
C2	7545369	7549199	BolC2t07196H	0	-	1126	3748	3830	0.9785901
C2	7564543	7566660	BolC2t07197H	0	+	1442	2117	2117	1.0000000
C2	7567272	7569854	BolC2t07198H	0	-	1130	2582	2582	1.0000000
C2	7570827	7572937	BolC2t07199H	0	-	1698	2110	2110	1.0000000
C2	7576998	7579221	BolC2t07200H	0	-	752	2129	2223	0.9577148
C2	7596088	7597720	BolC2t07201H	0	+	32	527	1632	0.3229167
C2	7603274	7607467	BolC2t07202H	0	-	432	2760	4193	0.6582399
C2	7613338	7614227	BolC2t07203H	0	-	0	0	889	0.0000000
C2	7623614	7624064	BolC2t07204H	0	-	0	0	450	0.0000000
C2	7630611	7631717	BolC2t07205H	0	+	636	1106	1106	1.0000000
C2	7633743	7635744	BolC2t07206H	0	-	335	1865	2001	0.9320340
C2	7650425	7652600	BolC2t07207H	0	-	502	1966	2175	0.9039081
C2	7655923	7657459	BolC2t07208H	0	+	2106	1536	1536	1.0000000
C2	7667571	7668171	BolC2t07209H	0	-	74	379	600	0.6316667
C2	7669355	7669567	BolC2t07210H	0	+	369	212	212	1.0000000
C2	7672808	7673015	BolC2t07211H	0	-	9	135	207	0.6521739
C2	7679485	7680589	BolC2t07212H	0	-	21	349	1104	0.3161232
C2	7685213	7685927	BolC2t07213H	0	-	301	653	714	0.9145658
C2	7696124	7698899	BolC2t07214H	0	+	235	2034	2775	0.7329730
C2	7699975	7702228	BolC2t07215H	0	+	1019	2074	2253	0.9205504
C2	7702399	7704833	BolC2t07216H	0	+	251	1389	2434	0.5706656
C2	7705515	7706414	BolC2t07217H	0	+	16	536	899	0.5962180
C2	7708303	7709320	BolC2t07218H	0	+	10	116	1017	0.1140610
C2	7717828	7719149	BolC2t07219H	0	+	36	747	1321	0.5654807
C2	7721771	7722894	BolC2t07220H	0	+	268	1024	1123	0.9118433
C2	7735158	7737263	BolC2t07221H	0	-	111	1140	2105	0.5415677
C2	7748692	7752378	BolC2t07222H	0	-	1760	3346	3686	0.9077591
C2	7759169	7760968	BolC2t07223H	0	-	1183	1799	1799	1.0000000
C2	7762214	7764510	BolC2t07224H	0	-	1018	2296	2296	1.0000000
C2	7776753	7780389	BolC2t07225H	0	+	1412	3636	3636	1.0000000
C2	7787474	7787636	BolC2t07226H	0	-	0	0	162	0.0000000
C2	7792103	7796074	BolC2t07227H	0	+	1102	3547	3971	0.8932259
C2	7796251	7804661	BolC2t07228H	0	-	5562	8303	8410	0.9872770
C2	7800896	7801362	BolC2t07229H	0	-	446	466	466	1.0000000
C2	7802792	7803506	BolC2t07230H	0	-	729	714	714	1.0000000
C2	7803468	7803934	BolC2t07231H	0	-	526	466	466	1.0000000
C2	7808561	7809016	BolC2t07232H	0	+	601	455	455	1.0000000
C2	7814189	7815307	BolC2t07233H	0	+	647	1118	1118	1.0000000
C2	7819628	7820759	BolC2t07234H	0	-	707	1131	1131	1.0000000
C2	7821260	7822850	BolC2t07235H	0	-	792	1590	1590	1.0000000
C2	7828206	7829550	BolC2t07236H	0	+	537	1300	1344	0.9672619
C2	7829650	7830802	BolC2t07237H	0	+	427	947	1152	0.8220486
C2	7834767	7834869	BolC2t07238H	0	-	62	102	102	1.0000000
C2	7849275	7851990	BolC2t07239H	0	-	357	1787	2715	0.6581952
C2	7853420	7854551	BolC2t07240H	0	+	61	203	1131	0.1794872
C2	7862551	7863052	BolC2t07241H	0	-	182	501	501	1.0000000
C2	7900790	7902219	BolC2t07242H	0	+	212	1098	1429	0.7683695
C2	7905462	7908847	BolC2t07243H	0	+	1876	3385	3385	1.0000000
C2	7909181	7911414	BolC2t07244H	0	-	1107	2211	2233	0.9901478
C2	7935007	7935920	BolC2t07245H	0	-	66	681	913	0.7458926
C2	7939509	7942678	BolC2t07246H	0	-	1818	3135	3169	0.9892710
C2	7942738	7944084	BolC2t07247H	0	+	396	1268	1346	0.9420505
C2	7949115	7949799	BolC2t07248H	0	+	437	684	684	1.0000000
C2	7965403	7965706	BolC2t07249H	0	+	435	303	303	1.0000000
C2	7967891	7968296	BolC2t07250H	0	-	17	283	405	0.6987655
C2	7972576	7973185	BolC2t07251H	0	+	142	524	609	0.8604269
C2	7973489	7975529	BolC2t07252H	0	+	334	1474	2040	0.7225490
C2	7977555	7978241	BolC2t07253H	0	-	53	522	686	0.7609329
C2	7979637	7980006	BolC2t07254H	0	-	66	365	369	0.9891599
C2	7990297	7990629	BolC2t07255H	0	-	37	60	332	0.1807229
C2	7995656	7996007	BolC2t07256H	0	+	82	252	351	0.7179487
C2	8015615	8015747	BolC2t07257H	0	+	14	132	132	1.0000000
C2	8019684	8022133	BolC2t07258H	0	-	862	1772	2449	0.7235606
C2	8028054	8028369	BolC2t07259H	0	+	15	276	315	0.8761905
C2	8028932	8030995	BolC2t07260H	0	-	663	1533	2063	0.7430926
C2	8057415	8057757	BolC2t07261H	0	-	293	342	342	1.0000000
C2	8067223	8068099	BolC2t07262H	0	-	224	671	876	0.7659817
C2	8074817	8075498	BolC2t07263H	0	+	185	681	681	1.0000000
C2	8078430	8079540	BolC2t07264H	0	-	41	642	1110	0.5783784
C2	8088113	8088290	BolC2t07265H	0	+	149	177	177	1.0000000
C2	8090597	8090913	BolC2t07266H	0	-	1	72	316	0.2278481
C2	8096478	8097136	BolC2t07267H	0	-	94	590	658	0.8966565
C2	8099614	8104274	BolC2t07268H	0	-	1457	4578	4660	0.9824035
C2	8112186	8112576	BolC2t07269H	0	+	40	290	390	0.7435898
C2	8113129	8114570	BolC2t07270H	0	-	177	1192	1441	0.8272033
C2	8129879	8130275	BolC2t07271H	0	+	260	396	396	1.0000000
C2	8130735	8132176	BolC2t07272H	0	-	202	1220	1441	0.8466343
C2	8133563	8135500	BolC2t07273H	0	-	781	1831	1937	0.9452762
C2	8137200	8139384	BolC2t07274H	0	-	1120	2080	2184	0.9523810
C2	8149469	8149922	BolC2t07275H	0	+	234	439	453	0.9690949
C2	8150897	8153000	BolC2t07276H	0	-	214	1942	2103	0.9234427
C2	8155166	8157161	BolC2t07277H	0	+	388	1758	1995	0.8812030
C2	8167297	8169112	BolC2t07278H	0	+	396	1530	1815	0.8429752
C2	8170475	8170649	BolC2t07279H	0	-	6	87	174	0.5000000
C2	8183806	8184196	BolC2t07280H	0	-	1241	390	390	1.0000000
C2	8209076	8210129	BolC2t07281H	0	+	614	1053	1053	1.0000000
C2	8217017	8217416	BolC2t07282H	0	-	0	0	399	0.0000000
C2	8231872	8233041	BolC2t07283H	0	+	589	1169	1169	1.0000000
C2	8233397	8235467	BolC2t07284H	0	-	902	2070	2070	1.0000000
C2	8249800	8251621	BolC2t07285H	0	-	1145	1821	1821	1.0000000
C2	8253160	8254042	BolC2t07286H	0	+	416	882	882	1.0000000
C2	8255653	8260997	BolC2t07287H	0	+	2760	5159	5344	0.9653817
C2	8268588	8270064	BolC2t07288H	0	+	337	1338	1476	0.9065041
C2	8270262	8278455	BolC2t07289H	0	-	1273	6806	8193	0.8307092
C2	8279179	8279674	BolC2t07290H	0	+	335	495	495	1.0000000
C2	8287117	8291290	BolC2t07291H	0	-	1582	4102	4173	0.9829859
C2	8302468	8304587	BolC2t07292H	0	-	363	1990	2119	0.9391222
C2	8320701	8325786	BolC2t07293H	0	-	1201	4097	5085	0.8057030
C2	8330503	8335522	BolC2t07294H	0	+	230	1850	5019	0.3685993
C2	8358579	8360464	BolC2t07295H	0	+	354	1523	1885	0.8079575
C2	8361076	8361250	BolC2t07296H	0	+	24	174	174	1.0000000
C2	8364449	8367080	BolC2t07297H	0	-	895	2354	2631	0.8947169
C2	8367921	8382935	BolC2t07298H	0	-	832	2474	15014	0.1647795
C2	8395784	8397384	BolC2t07299H	0	-	20	273	1600	0.1706250
C2	8399189	8399618	BolC2t07300H	0	-	74	429	429	1.0000000
C2	8400511	8401103	BolC2t07301H	0	-	261	592	592	1.0000000
C2	8402372	8402864	BolC2t07302H	0	-	120	492	492	1.0000000
C2	8422901	8423432	BolC2t07303H	0	+	175	514	531	0.9679849
C2	8424176	8425343	BolC2t07304H	0	-	900	1135	1167	0.9725792
C2	8425526	8426121	BolC2t07305H	0	+	301	483	595	0.8117647
C2	8426666	8426801	BolC2t07306H	0	-	48	114	135	0.8444445
C2	8428792	8430424	BolC2t07307H	0	+	943	1632	1632	1.0000000
C2	8430715	8432193	BolC2t07308H	0	-	595	1478	1478	1.0000000
C2	8432296	8432609	BolC2t07309H	0	-	244	313	313	1.0000000
C2	8434266	8434740	BolC2t07310H	0	-	32	328	474	0.6919831
C2	8454950	8455424	BolC2t07311H	0	-	9	92	474	0.1940928
C2	8466658	8467153	BolC2t07312H	0	-	81	446	495	0.9010101
C2	8483529	8484129	BolC2t07313H	0	+	25	305	600	0.5083333
C2	8485697	8488759	BolC2t07314H	0	+	324	2584	3062	0.8438929
C2	8498896	8500888	BolC2t07315H	0	-	606	1904	1992	0.9558233
C2	8521267	8523483	BolC2t07316H	0	-	50	1176	2216	0.5306859
C2	8551693	8551949	BolC2t07317H	0	-	286	256	256	1.0000000
C2	8556250	8557182	BolC2t07318H	0	+	153	564	932	0.6051502
C2	8579160	8580894	BolC2t07319H	0	+	1003	1580	1734	0.9111880
C2	8581370	8581782	BolC2t07320H	0	+	306	412	412	1.0000000
C2	8587382	8588158	BolC2t07321H	0	+	172	766	776	0.9871134
C2	8588901	8591655	BolC2t07322H	0	-	728	2539	2754	0.9219317
C2	8592344	8594414	BolC2t07323H	0	+	1097	1996	2070	0.9642512
C2	8599888	8601736	BolC2t07324H	0	+	421	1788	1848	0.9675325
C2	8605191	8605503	BolC2t07325H	0	-	0	0	312	0.0000000
C2	8608051	8608510	BolC2t07326H	0	-	126	402	459	0.8758170
C2	8609675	8612864	BolC2t07327H	0	-	1487	3189	3189	1.0000000
C2	8615711	8616023	BolC2t07328H	0	-	145	312	312	1.0000000
C2	8628731	8635503	BolC2t07329H	0	-	1001	3855	6772	0.5692558
C2	8637457	8641515	BolC2t07330H	0	-	2958	3875	4058	0.9549039
C2	8645028	8649100	BolC2t07331H	0	-	1540	3567	4072	0.8759823
C2	8649962	8653719	BolC2t07332H	0	-	2779	3601	3757	0.9584775
C2	8656913	8657724	BolC2t07333H	0	+	104	746	811	0.9198520
C2	8678708	8683751	BolC2t07334H	0	-	3041	4618	5043	0.9157248
C2	8686773	8687101	BolC2t07335H	0	+	235	328	328	1.0000000
C2	8687836	8688886	BolC2t07336H	0	-	97	495	1050	0.4714286
C2	8689880	8696558	BolC2t07337H	0	-	2209	4023	6678	0.6024259
C2	8697509	8699079	BolC2t07338H	0	-	16	474	1570	0.3019108
C2	8702590	8704234	BolC2t07339H	0	-	1405	1644	1644	1.0000000
C2	8705118	8707018	BolC2t07340H	0	+	482	1767	1900	0.9300000
C2	8708960	8709782	BolC2t07341H	0	+	71	640	822	0.7785888
C2	8710857	8712024	BolC2t07342H	0	+	122	988	1167	0.8466153
C2	8732366	8734050	BolC2t07343H	0	+	566	1515	1684	0.8996437
C2	8740485	8740908	BolC2t07344H	0	-	205	423	423	1.0000000
C2	8749289	8749400	BolC2t07345H	0	-	1	63	111	0.5675676
C2	8750441	8751927	BolC2t07346H	0	+	813	1464	1486	0.9851952
C2	8757962	8758771	BolC2t07347H	0	-	265	809	809	1.0000000
C2	8759480	8760660	BolC2t07348H	0	+	859	1180	1180	1.0000000
C2	8773287	8774321	BolC2t07349H	0	-	409	991	1034	0.9584139
C2	8777262	8777619	BolC2t07350H	0	-	126	357	357	1.0000000
C2	8778707	8780381	BolC2t07351H	0	-	380	1429	1674	0.8536440
C2	8787545	8788373	BolC2t07352H	0	-	52	445	828	0.5374396
C2	8790819	8791524	BolC2t07353H	0	-	25	479	705	0.6794326
C2	8818481	8818901	BolC2t07354H	0	+	0	0	420	0.0000000
C2	8835253	8836003	BolC2t07355H	0	+	75	519	750	0.6920000
C2	8840921	8841965	BolC2t07356H	0	+	123	687	1044	0.6580459
C2	8852739	8853072	BolC2t07357H	0	-	7	165	333	0.4954955
C2	8878994	8879330	BolC2t07358H	0	+	38	149	336	0.4434524
C2	8883812	8884840	BolC2t07359H	0	+	211	909	1028	0.8842412
C2	8887828	8889774	BolC2t07360H	0	+	1197	1946	1946	1.0000000
C2	8892039	8892651	BolC2t07361H	0	+	89	612	612	1.0000000
C2	8899384	8899834	BolC2t07362H	0	+	138	450	450	1.0000000
C2	8901309	8902597	BolC2t07363H	0	-	24	440	1288	0.3416149
C2	8903698	8904040	BolC2t07364H	0	+	199	342	342	1.0000000
C2	8905570	8906065	BolC2t07365H	0	+	3	98	495	0.1979798
C2	8909917	8910379	BolC2t07366H	0	+	0	0	462	0.0000000
C2	8913250	8916384	BolC2t07367H	0	+	146	989	3134	0.3155712
C2	8920587	8924376	BolC2t07368H	0	-	767	3668	3789	0.9680654
C2	8943029	8946313	BolC2t07369H	0	+	511	2468	3284	0.7515225
C2	8946735	8947428	BolC2t07370H	0	-	601	693	693	1.0000000
C2	8952266	8952557	BolC2t07371H	0	+	393	291	291	1.0000000
C2	8959179	8962388	BolC2t07372H	0	-	741	2689	3209	0.8379558
C2	8966373	8967428	BolC2t07373H	0	+	96	1055	1055	1.0000000
C2	8973834	8975379	BolC2t07374H	0	+	617	1336	1545	0.8647249
C2	8976865	8981723	BolC2t07375H	0	+	2516	4556	4858	0.9378345
C2	8982184	8993644	BolC2t07376H	0	-	2699	6164	11460	0.5378709
C2	8998653	8999026	BolC2t07377H	0	+	342	328	373	0.8793566
C2	8999211	9004863	BolC2t07378H	0	+	726	1586	5652	0.2806086
C2	9010410	9010770	BolC2t07379H	0	-	10	341	360	0.9472222
C2	9010864	9011568	BolC2t07380H	0	-	59	704	704	1.0000000
C2	9028253	9030314	BolC2t07381H	0	-	447	1137	2061	0.5516739
C2	9032054	9032855	BolC2t07382H	0	-	428	801	801	1.0000000
C2	9047655	9048738	BolC2t07383H	0	-	114	868	1083	0.8014774
C2	9053275	9090494	BolC2t07384H	0	-	3294	18249	37219	0.4903141
C2	9056722	9065069	BolC2t07385H	0	-	1524	7044	8347	0.8438960
C2	9066937	9067741	BolC2t07386H	0	-	111	464	804	0.5771144
C2	9086619	9087641	BolC2t07387H	0	+	12	347	1022	0.3395303
C2	9094277	9104527	BolC2t07388H	0	-	702	4284	10250	0.4179512
C2	9098490	9099114	BolC2t07389H	0	+	0	0	624	0.0000000
C2	9100441	9101673	BolC2t07390H	0	+	209	1215	1232	0.9862013
C2	9110140	9110548	BolC2t07391H	0	+	81	337	408	0.8259804
C2	9114087	9116135	BolC2t07392H	0	-	29	607	2048	0.2963867
C2	9116915	9117266	BolC2t07393H	0	-	0	0	351	0.0000000
C2	9126034	9127840	BolC2t07394H	0	-	14	208	1806	0.1151716
C2	9131786	9132590	BolC2t07395H	0	-	581	804	804	1.0000000
C2	9135752	9136669	BolC2t07396H	0	-	51	758	917	0.8266085
C2	9135841	9136480	BolC2t07397H	0	-	41	531	639	0.8309859
C2	9141648	9141975	BolC2t07398H	0	-	6	226	327	0.6911315
C2	9149187	9150368	BolC2t07399H	0	-	3	223	1181	0.1888230
C2	9149711	9150355	BolC2t07400H	0	-	1	65	644	0.1009317
C2	9174582	9176978	BolC2t07401H	0	+	79	204	2396	0.0851419
C2	9185568	9185817	BolC2t07402H	0	-	556	249	249	1.0000000
C2	9190052	9191385	BolC2t07403H	0	+	342	1110	1333	0.8327082
C2	9195754	9199465	BolC2t07404H	0	-	1524	1554	3711	0.4187551
C2	9203901	9205540	BolC2t07405H	0	+	852	1606	1639	0.9798658
C2	9213645	9213750	BolC2t07406H	0	+	0	0	105	0.0000000
C2	9216171	9216564	BolC2t07407H	0	-	2	224	393	0.5699745
C2	9218463	9218724	BolC2t07408H	0	+	34	260	261	0.9961686
C2	9220880	9223148	BolC2t07409H	0	+	524	2044	2268	0.9012346
C2	9223805	9224568	BolC2t07410H	0	-	330	763	763	1.0000000
C2	9225546	9227484	BolC2t07411H	0	+	1096	1826	1938	0.9422085
C2	9228339	9230024	BolC2t07412H	0	+	241	1555	1685	0.9228486
C2	9232124	9232840	BolC2t07413H	0	-	203	716	716	1.0000000
C2	9238210	9238456	BolC2t07414H	0	+	0	0	246	0.0000000
C2	9240602	9242874	BolC2t07415H	0	+	394	2068	2272	0.9102113
C2	9246254	9247797	BolC2t07416H	0	-	181	1001	1543	0.6487362
C2	9249338	9252820	BolC2t07417H	0	-	673	3321	3482	0.9537622
C2	9271968	9272127	BolC2t07418H	0	-	42	159	159	1.0000000
C2	9290326	9293195	BolC2t07419H	0	-	439	2601	2869	0.9065877
C2	9294416	9294593	BolC2t07420H	0	+	1	105	177	0.5932204
C2	9297561	9307076	BolC2t07421H	0	-	612	3638	9515	0.3823437
C2	9314127	9316922	BolC2t07422H	0	-	184	1025	2795	0.3667263
C2	9314212	9314658	BolC2t07423H	0	-	34	83	446	0.1860987
C2	9321302	9324133	BolC2t07424H	0	-	748	2781	2831	0.9823384
C2	9332002	9333267	BolC2t07425H	0	+	168	753	1265	0.5952569
C2	9335223	9339175	BolC2t07426H	0	+	859	3330	3952	0.8426113
C2	9339559	9341486	BolC2t07427H	0	-	650	1820	1927	0.9444733
C2	9346508	9350743	BolC2t07428H	0	+	2192	4235	4235	1.0000000
C2	9358682	9360479	BolC2t07429H	0	-	301	1660	1797	0.9237618
C2	9380354	9380660	BolC2t07430H	0	+	71	306	306	1.0000000
C2	9385358	9388302	BolC2t07431H	0	+	575	2461	2944	0.8359375
C2	9388744	9390203	BolC2t07432H	0	-	997	1459	1459	1.0000000
C2	9392988	9393363	BolC2t07433H	0	+	0	0	375	0.0000000
C2	9396382	9396655	BolC2t07434H	0	+	3	58	273	0.2124542
C2	9397465	9400494	BolC2t07435H	0	+	857	2744	3029	0.9059095
C2	9400995	9401833	BolC2t07436H	0	-	331	838	838	1.0000000
C2	9402659	9403718	BolC2t07437H	0	+	502	962	1059	0.9084042
C2	9406194	9408692	BolC2t07438H	0	+	728	1959	2498	0.7842274
C2	9411079	9413577	BolC2t07439H	0	-	1339	2313	2498	0.9259408
C2	9416491	9416773	BolC2t07440H	0	-	176	282	282	1.0000000
C2	9437981	9440728	BolC2t07441H	0	-	2114	2747	2747	1.0000000
C2	9443736	9445304	BolC2t07442H	0	+	2962	1568	1568	1.0000000
C2	9446215	9446974	BolC2t07443H	0	-	64	665	759	0.8761528
C2	9475809	9476355	BolC2t07444H	0	+	0	0	546	0.0000000
C2	9487488	9489266	BolC2t07445H	0	+	2096	1778	1778	1.0000000
C2	9500110	9502955	BolC2t07446H	0	+	63	758	2845	0.2664323
C2	9514955	9516803	BolC2t07447H	0	+	411	1814	1848	0.9816017
C2	9517569	9518865	BolC2t07448H	0	-	461	1296	1296	1.0000000
C2	9523415	9524819	BolC2t07449H	0	+	202	1342	1404	0.9558405
C2	9524906	9525874	BolC2t07450H	0	+	645	968	968	1.0000000
C2	9532234	9535213	BolC2t07451H	0	-	3398	2979	2979	1.0000000
C2	9549681	9551960	BolC2t07452H	0	+	901	2089	2279	0.9166301
C2	9561596	9562928	BolC2t07453H	0	+	748	1332	1332	1.0000000
C2	9564092	9564838	BolC2t07454H	0	+	418	746	746	1.0000000
C2	9565198	9569641	BolC2t07455H	0	-	1809	3748	4443	0.8435742
C2	9570296	9572561	BolC2t07456H	0	+	1518	2265	2265	1.0000000
C2	9572913	9574748	BolC2t07457H	0	-	588	1511	1835	0.8234332
C2	9576422	9577435	BolC2t07458H	0	+	239	908	1013	0.8963475
C2	9577656	9579979	BolC2t07459H	0	-	298	1805	2323	0.7770125
C2	9581525	9583566	BolC2t07460H	0	-	383	1897	2041	0.9294463
C2	9586224	9588216	BolC2t07461H	0	-	1203	1992	1992	1.0000000
C2	9595824	9597328	BolC2t07462H	0	+	458	1435	1504	0.9541224
C2	9598977	9601221	BolC2t07463H	0	-	1618	2244	2244	1.0000000
C2	9603355	9606143	BolC2t07464H	0	-	916	1702	2788	0.6104735
C2	9612907	9614078	BolC2t07465H	0	-	529	1062	1171	0.9069172
C2	9614990	9617820	BolC2t07466H	0	+	438	1690	2830	0.5971732
C2	9618461	9624428	BolC2t07467H	0	-	1620	5392	5967	0.9036367
C2	9630082	9632380	BolC2t07468H	0	-	1277	1708	2298	0.7432550
C2	9645357	9646467	BolC2t07469H	0	-	253	796	1110	0.7171171
C2	9655271	9659858	BolC2t07470H	0	-	1828	4406	4587	0.9605407
C2	9660830	9661678	BolC2t07471H	0	+	504	848	848	1.0000000
C2	9663719	9666110	BolC2t07472H	0	+	1302	2352	2391	0.9836888
C2	9667692	9670274	BolC2t07473H	0	+	348	1386	2582	0.5367932
C2	9681314	9685851	BolC2t07474H	0	+	506	3259	4537	0.7183161
C2	9686781	9692376	BolC2t07475H	0	+	4627	5166	5595	0.9233244
C2	9689930	9690885	BolC2t07476H	0	+	1107	955	955	1.0000000
C2	9699040	9699689	BolC2t07477H	0	+	60	388	649	0.5978428
C2	9700053	9701647	BolC2t07478H	0	-	1282	1594	1594	1.0000000
C2	9703376	9706238	BolC2t07479H	0	+	171	1950	2862	0.6813417
C2	9706392	9709496	BolC2t07480H	0	-	279	957	3104	0.3083118
C2	9712294	9713050	BolC2t07481H	0	+	73	680	756	0.8994709
C2	9718447	9719746	BolC2t07482H	0	+	594	1299	1299	1.0000000
C2	9720261	9721314	BolC2t07483H	0	-	136	955	1053	0.9069326
C2	9721843	9722668	BolC2t07484H	0	+	825	825	825	1.0000000
C2	9724333	9724522	BolC2t07485H	0	+	3	131	189	0.6931217
C2	9725041	9725512	BolC2t07486H	0	-	114	439	471	0.9320595
C2	9726480	9727414	BolC2t07487H	0	-	159	881	934	0.9432548
C2	9731142	9732560	BolC2t07488H	0	+	161	979	1418	0.6904090
C2	9733184	9735535	BolC2t07489H	0	-	1888	2351	2351	1.0000000
C2	9740758	9744239	BolC2t07490H	0	+	1904	3329	3481	0.9563344
C2	9744691	9747805	BolC2t07491H	0	+	1997	3058	3114	0.9820167
C2	9748316	9750971	BolC2t07492H	0	-	715	2613	2655	0.9841808
C2	9752041	9753745	BolC2t07493H	0	-	444	1393	1704	0.8174883
C2	9756276	9757341	BolC2t07494H	0	+	605	1011	1065	0.9492958
C2	9758453	9758728	BolC2t07495H	0	+	321	275	275	1.0000000
C2	9758923	9759181	BolC2t07496H	0	-	383	258	258	1.0000000
C2	9759579	9761892	BolC2t07497H	0	-	1321	2313	2313	1.0000000
C2	9765208	9768703	BolC2t07498H	0	-	798	3050	3495	0.8726752
C2	9769405	9770212	BolC2t07499H	0	-	567	807	807	1.0000000
C2	9771039	9772354	BolC2t07500H	0	+	1203	1315	1315	1.0000000
C2	9772557	9773055	BolC2t07501H	0	-	546	498	498	1.0000000
C2	9775060	9776581	BolC2t07502H	0	+	507	1241	1521	0.8159106
C2	9777522	9780863	BolC2t07503H	0	-	1246	3278	3341	0.9811434
C2	9799640	9799960	BolC2t07504H	0	+	10	163	320	0.5093750
C2	9807082	9809384	BolC2t07505H	0	-	264	1599	2302	0.6946134
C2	9813384	9815511	BolC2t07506H	0	+	347	1568	2127	0.7371885
C2	9816270	9817419	BolC2t07507H	0	-	1447	1149	1149	1.0000000
C2	9837587	9837982	BolC2t07508H	0	+	494	395	395	1.0000000
C2	9840298	9841338	BolC2t07509H	0	+	65	746	1040	0.7173077
C2	9847298	9848945	BolC2t07510H	0	-	1131	1647	1647	1.0000000
C2	9855367	9857662	BolC2t07511H	0	+	736	2126	2295	0.9263617
C2	9870738	9872717	BolC2t07512H	0	+	601	1662	1979	0.8398181
C2	9881181	9881793	BolC2t07513H	0	+	15	563	612	0.9199346
C2	9886776	9888294	BolC2t07514H	0	+	67	985	1518	0.6488801
C2	9889487	9892547	BolC2t07515H	0	-	1001	2959	3060	0.9669935
C2	9896678	9897059	BolC2t07516H	0	-	188	381	381	1.0000000
C2	9911971	9912197	BolC2t07517H	0	+	404	226	226	1.0000000
C2	9912260	9915166	BolC2t07518H	0	+	2612	2906	2906	1.0000000
C2	9917319	9917535	BolC2t07519H	0	-	0	0	216	0.0000000
C2	9926756	9927223	BolC2t07520H	0	-	23	247	467	0.5289079
C2	9942084	9942900	BolC2t07521H	0	-	213	616	816	0.7549019
C2	9945645	9945822	BolC2t07522H	0	-	306	177	177	1.0000000
C2	9949889	9950336	BolC2t07523H	0	+	104	356	447	0.7964206
C2	9952339	9969319	BolC2t07524H	0	-	3780	12956	16980	0.7630153
C2	10004908	10006009	BolC2t07525H	0	-	269	1059	1101	0.9618528
C2	10017754	10017962	BolC2t07526H	0	+	2	67	208	0.3221154
C2	10021125	10023297	BolC2t07527H	0	-	2190	2172	2172	1.0000000
C2	10026061	10027243	BolC2t07528H	0	-	664	1133	1182	0.9585449
C2	10029294	10030939	BolC2t07529H	0	-	22	662	1645	0.4024316
C2	10040788	10041055	BolC2t07530H	0	+	95	267	267	1.0000000
C2	10045985	10048384	BolC2t07531H	0	+	537	2352	2399	0.9804085
C2	10052309	10054984	BolC2t07532H	0	+	1756	2360	2675	0.8822430
C2	10058220	10058520	BolC2t07533H	0	+	294	300	300	1.0000000
C2	10076708	10076864	BolC2t07534H	0	+	51	156	156	1.0000000
C2	10078625	10078808	BolC2t07535H	0	-	55	183	183	1.0000000
C2	10080760	10081333	BolC2t07536H	0	-	66	76	573	0.1326353
C2	10081657	10081984	BolC2t07537H	0	-	280	327	327	1.0000000
C2	10095333	10096952	BolC2t07538H	0	+	385	1052	1619	0.6497838
C2	10096151	10096817	BolC2t07539H	0	+	64	389	666	0.5840841
C2	10097011	10098039	BolC2t07540H	0	-	0	0	1028	0.0000000
C2	10100761	10105998	BolC2t07541H	0	+	624	2288	5237	0.4368913
C2	10106233	10107562	BolC2t07542H	0	+	422	1286	1329	0.9676449
C2	10109495	10110601	BolC2t07543H	0	+	162	745	1106	0.6735985
C2	10140574	10141027	BolC2t07544H	0	-	37	388	453	0.8565121
C2	10154857	10154959	BolC2t07545H	0	-	12	102	102	1.0000000
C2	10174313	10174815	BolC2t07546H	0	-	477	502	502	1.0000000
C2	10185970	10186363	BolC2t07547H	0	+	35	127	393	0.3231552
C2	10227023	10228023	BolC2t07548H	0	-	710	1000	1000	1.0000000
C2	10231975	10232576	BolC2t07549H	0	+	937	601	601	1.0000000
C2	10237275	10238367	BolC2t07550H	0	+	377	990	1092	0.9065934
C2	10240512	10240737	BolC2t07551H	0	+	264	225	225	1.0000000
C2	10266088	10266331	BolC2t07552H	0	-	152	243	243	1.0000000
C2	10266603	10266762	BolC2t07553H	0	+	183	159	159	1.0000000
C2	10286833	10289305	BolC2t07554H	0	+	1489	2271	2472	0.9186893
C2	10289818	10290442	BolC2t07555H	0	-	481	624	624	1.0000000
C2	10291561	10291901	BolC2t07556H	0	-	47	316	340	0.9294118
C2	10301037	10305875	BolC2t07557H	0	+	1065	4297	4838	0.8881769
C2	10307100	10307350	BolC2t07558H	0	+	83	250	250	1.0000000
C2	10324225	10325305	BolC2t07559H	0	-	294	844	1080	0.7814815
C2	10340295	10342241	BolC2t07560H	0	-	1373	1946	1946	1.0000000
C2	10351656	10356265	BolC2t07561H	0	-	1217	3728	4609	0.8088523
C2	10356705	10359528	BolC2t07562H	0	+	2046	2823	2823	1.0000000
C2	10360239	10360890	BolC2t07563H	0	+	895	651	651	1.0000000
C2	10361340	10362214	BolC2t07564H	0	-	1115	874	874	1.0000000
C2	10363088	10364425	BolC2t07565H	0	+	143	1052	1337	0.7868362
C2	10365137	10366227	BolC2t07566H	0	-	1113	1090	1090	1.0000000
C2	10369823	10371143	BolC2t07567H	0	+	1032	1320	1320	1.0000000
C2	10379025	10381509	BolC2t07568H	0	-	1307	2484	2484	1.0000000
C2	10381592	10381787	BolC2t07569H	0	-	122	195	195	1.0000000
C2	10384827	10385357	BolC2t07570H	0	-	534	530	530	1.0000000
C2	10387850	10389553	BolC2t07571H	0	-	651	1703	1703	1.0000000
C2	10418173	10418614	BolC2t07572H	0	+	237	441	441	1.0000000
C2	10424058	10425824	BolC2t07573H	0	-	172	796	1766	0.4507361
C2	10461218	10472452	BolC2t07574H	0	-	6589	10847	11234	0.9655510
C2	10473120	10475391	BolC2t07575H	0	-	1307	2216	2271	0.9757816
C2	10487524	10494004	BolC2t07576H	0	-	7483	5913	6480	0.9125000
C2	10494908	10496904	BolC2t07577H	0	-	1401	1996	1996	1.0000000
C2	10497944	10502128	BolC2t07578H	0	-	1806	3753	4184	0.8969885
C2	10505827	10506001	BolC2t07579H	0	+	5	158	174	0.9080459
C2	10515280	10515586	BolC2t07580H	0	-	429	306	306	1.0000000
C2	10550003	10551866	BolC2t07581H	0	+	1019	1863	1863	1.0000000
C2	10574650	10575813	BolC2t07582H	0	+	247	987	1163	0.8486673
C2	10577024	10577450	BolC2t07583H	0	+	353	426	426	1.0000000
C2	10578091	10578301	BolC2t07584H	0	+	254	210	210	1.0000000
C2	10590397	10590613	BolC2t07585H	0	+	4	144	216	0.6666667
C2	10595015	10596601	BolC2t07586H	0	+	854	1586	1586	1.0000000
C2	10601262	10601636	BolC2t07587H	0	-	718	374	374	1.0000000
C2	10610066	10617696	BolC2t07588H	0	+	2763	6891	7630	0.9031455
C2	10621025	10625754	BolC2t07589H	0	-	1587	3857	4729	0.8156058
C2	10627907	10629210	BolC2t07590H	0	+	155	876	1303	0.6722947
C2	10629626	10631156	BolC2t07591H	0	+	346	1500	1530	0.9803922
C2	10632045	10633112	BolC2t07592H	0	-	0	0	1067	0.0000000
C2	10633963	10635538	BolC2t07593H	0	-	590	1491	1575	0.9466667
C2	10648199	10651203	BolC2t07594H	0	-	1711	2976	3004	0.9906791
C2	10664910	10665879	BolC2t07595H	0	+	433	969	969	1.0000000
C2	10700745	10701879	BolC2t07596H	0	+	137	1021	1134	0.9003527
C2	10706297	10706723	BolC2t07597H	0	-	261	426	426	1.0000000
C2	10708917	10709315	BolC2t07598H	0	-	251	398	398	1.0000000
C2	10710108	10710630	BolC2t07599H	0	-	277	522	522	1.0000000
C2	10720985	10724353	BolC2t07600H	0	-	942	3368	3368	1.0000000
C2	10763317	10764156	BolC2t07601H	0	-	522	839	839	1.0000000
C2	10787933	10790885	BolC2t07602H	0	+	528	2148	2952	0.7276423
C2	10818417	10818825	BolC2t07603H	0	+	248	408	408	1.0000000
C2	10819923	10820121	BolC2t07604H	0	+	144	198	198	1.0000000
C2	10856254	10859312	BolC2t07605H	0	+	175	1493	3058	0.4882276
C2	10871673	10873090	BolC2t07606H	0	-	964	1352	1417	0.9541284
C2	10873312	10875980	BolC2t07607H	0	+	1789	2651	2668	0.9936282
C2	10878476	10879118	BolC2t07608H	0	-	116	427	642	0.6651090
C2	10879166	10879355	BolC2t07609H	0	-	59	189	189	1.0000000
C2	10881487	10881637	BolC2t07610H	0	-	215	150	150	1.0000000
C2	10881909	10882281	BolC2t07611H	0	-	441	372	372	1.0000000
C2	10889496	10893751	BolC2t07612H	0	+	2769	4255	4255	1.0000000
C2	10894497	10899002	BolC2t07613H	0	-	689	3808	4505	0.8452830
C2	10925703	10926054	BolC2t07614H	0	-	484	351	351	1.0000000
C2	10926215	10933871	BolC2t07615H	0	+	1195	4369	7656	0.5706635
C2	10958936	10960764	BolC2t07616H	0	+	431	1578	1828	0.8632385
C2	10964966	10965719	BolC2t07617H	0	-	78	701	753	0.9309429
C2	10972642	10973705	BolC2t07618H	0	-	1263	1063	1063	1.0000000
C2	10998578	11000017	BolC2t07619H	0	-	477	1425	1439	0.9902710
C2	11001081	11003867	BolC2t07620H	0	-	3164	2786	2786	1.0000000
C2	11009585	11010391	BolC2t07621H	0	+	147	806	806	1.0000000
C2	11019600	11020080	BolC2t07622H	0	+	368	480	480	1.0000000
C2	11037604	11040237	BolC2t07623H	0	+	2337	2633	2633	1.0000000
C2	11041406	11044034	BolC2t07624H	0	-	988	2628	2628	1.0000000
C2	11045044	11045164	BolC2t07625H	0	+	81	120	120	1.0000000
C2	11045244	11045547	BolC2t07626H	0	+	94	303	303	1.0000000
C2	11045805	11046268	BolC2t07627H	0	+	150	463	463	1.0000000
C2	11048625	11049213	BolC2t07628H	0	+	231	494	588	0.8401361
C2	11065162	11066713	BolC2t07629H	0	-	850	1551	1551	1.0000000
C2	11071790	11073551	BolC2t07630H	0	-	1153	1761	1761	1.0000000
C2	11076806	11077527	BolC2t07631H	0	+	355	721	721	1.0000000
C2	11080286	11080469	BolC2t07632H	0	-	72	183	183	1.0000000
C2	11082607	11083411	BolC2t07633H	0	+	978	804	804	1.0000000
C2	11104670	11106828	BolC2t07634H	0	-	1452	2158	2158	1.0000000
C2	11112932	11115750	BolC2t07635H	0	-	920	2818	2818	1.0000000
C2	11122735	11138763	BolC2t07636H	0	-	5177	12700	16028	0.7923633
C2	11160329	11162524	BolC2t07637H	0	-	739	2050	2195	0.9339408
C2	11193414	11201214	BolC2t07638H	0	+	2849	6113	7800	0.7837179
C2	11207957	11221696	BolC2t07639H	0	+	5077	11498	13739	0.8368877
C2	11212752	11223861	BolC2t07640H	0	+	3435	8658	11109	0.7793681
C2	11218761	11219241	BolC2t07641H	0	+	287	480	480	1.0000000
C2	11219392	11220031	BolC2t07642H	0	+	47	461	639	0.7214398
C2	11224995	11225346	BolC2t07643H	0	-	79	317	351	0.9031339
C2	11227487	11231073	BolC2t07644H	0	+	661	3134	3586	0.8739543
C2	11231483	11232743	BolC2t07645H	0	-	270	1074	1260	0.8523809
C2	11236587	11238924	BolC2t07646H	0	+	1416	2337	2337	1.0000000
C2	11250715	11252176	BolC2t07647H	0	+	584	1461	1461	1.0000000
C2	11260149	11261613	BolC2t07648H	0	+	369	1054	1464	0.7199454
C2	11267047	11267437	BolC2t07649H	0	+	1	27	390	0.0692308
C2	11272012	11273221	BolC2t07650H	0	+	121	869	1209	0.7187759
C2	11288527	11290141	BolC2t07651H	0	-	269	1107	1614	0.6858736
C2	11298416	11310718	BolC2t07652H	0	+	3069	6325	12302	0.5141441
C2	11322115	11325768	BolC2t07653H	0	-	3026	3653	3653	1.0000000
C2	11335600	11336101	BolC2t07654H	0	+	19	191	501	0.3812375
C2	11345179	11347701	BolC2t07655H	0	+	2764	2522	2522	1.0000000
C2	11375914	11379005	BolC2t07656H	0	+	1728	2877	3091	0.9307668
C2	11385862	11387095	BolC2t07657H	0	-	595	1233	1233	1.0000000
C2	11391499	11391766	BolC2t07658H	0	-	61	267	267	1.0000000
C2	11393284	11396607	BolC2t07659H	0	+	428	2515	3323	0.7568462
C2	11397016	11397980	BolC2t07660H	0	-	283	953	964	0.9885892
C2	11399874	11400760	BolC2t07661H	0	-	1230	886	886	1.0000000
C2	11401438	11402507	BolC2t07662H	0	-	613	1069	1069	1.0000000
C2	11405885	11406097	BolC2t07663H	0	+	28	212	212	1.0000000
C2	11410819	11411047	BolC2t07664H	0	-	1	56	228	0.2456140
C2	11412073	11413715	BolC2t07665H	0	-	313	1564	1642	0.9524969
C2	11414884	11415277	BolC2t07666H	0	-	890	393	393	1.0000000
C2	11428148	11429111	BolC2t07667H	0	+	10	172	963	0.1786085
C2	11430316	11431767	BolC2t07668H	0	+	6	99	1451	0.0682288
C2	11439808	11455618	BolC2t07669H	0	-	2935	12202	15810	0.7717900
C2	11439990	11440332	BolC2t07670H	0	-	15	187	342	0.5467836
C2	11467872	11468293	BolC2t07671H	0	+	328	421	421	1.0000000
C2	11484883	11485039	BolC2t07672H	0	-	18	156	156	1.0000000
C2	11498122	11499077	BolC2t07673H	0	+	526	871	955	0.9120419
C2	11503827	11504841	BolC2t07674H	0	-	209	1006	1014	0.9921104
C2	11508400	11516100	BolC2t07675H	0	-	2276	6530	7700	0.8480520
C2	11543351	11544998	BolC2t07676H	0	-	857	1579	1647	0.9587128
C2	11550629	11550839	BolC2t07677H	0	+	6	57	210	0.2714286
C2	11552623	11553975	BolC2t07678H	0	-	1174	1310	1352	0.9689349
C2	11556315	11557255	BolC2t07679H	0	+	352	891	940	0.9478723
C2	11557704	11560806	BolC2t07680H	0	-	395	2618	3102	0.8439716
C2	11568346	11571771	BolC2t07681H	0	+	1705	3267	3425	0.9538686
C2	11573904	11574111	BolC2t07682H	0	-	0	0	207	0.0000000
C2	11575315	11575444	BolC2t07683H	0	+	34	129	129	1.0000000
C2	11601074	11603139	BolC2t07684H	0	+	473	1486	2065	0.7196126
C2	11603342	11603680	BolC2t07685H	0	-	168	338	338	1.0000000
C2	11604532	11604956	BolC2t07686H	0	-	465	424	424	1.0000000
C2	11622913	11626465	BolC2t07687H	0	-	3310	3529	3552	0.9935248
C2	11630327	11630834	BolC2t07688H	0	+	420	507	507	1.0000000
C2	11632657	11633440	BolC2t07689H	0	-	89	675	783	0.8620690
C2	11641868	11643330	BolC2t07690H	0	+	605	1462	1462	1.0000000
C2	11645381	11646848	BolC2t07691H	0	-	249	942	1467	0.6421268
C2	11648425	11651722	BolC2t07692H	0	-	1321	3208	3297	0.9730058
C2	11654584	11654719	BolC2t07693H	0	-	59	123	135	0.9111111
C2	11658212	11658508	BolC2t07694H	0	+	0	0	296	0.0000000
C2	11662504	11662894	BolC2t07695H	0	-	59	390	390	1.0000000
C2	11664877	11665984	BolC2t07696H	0	-	416	1100	1107	0.9936766
C2	11666628	11668566	BolC2t07697H	0	+	361	1833	1938	0.9458205
C2	11670006	11673457	BolC2t07698H	0	-	393	2391	3451	0.6928427
C2	11686403	11689899	BolC2t07699H	0	-	2092	3493	3496	0.9991419
C2	11690719	11691130	BolC2t07700H	0	-	181	411	411	1.0000000
C2	11698127	11698622	BolC2t07701H	0	-	655	495	495	1.0000000
C2	11706122	11709235	BolC2t07702H	0	-	356	2251	3113	0.7230967
C2	11710383	11710687	BolC2t07703H	0	-	65	304	304	1.0000000
C2	11715546	11715864	BolC2t07704H	0	-	204	318	318	1.0000000
C2	11719435	11721083	BolC2t07705H	0	-	1343	1648	1648	1.0000000
C2	11723074	11724985	BolC2t07706H	0	-	545	1713	1911	0.8963893
C2	11729508	11733001	BolC2t07707H	0	+	352	2894	3493	0.8285142
C2	11754712	11754929	BolC2t07708H	0	-	217	217	217	1.0000000
C2	11756324	11756459	BolC2t07709H	0	-	29	135	135	1.0000000
C2	11757666	11758219	BolC2t07710H	0	-	0	0	553	0.0000000
C2	11758283	11758385	BolC2t07711H	0	-	0	0	102	0.0000000
C2	11760144	11761718	BolC2t07712H	0	+	552	1574	1574	1.0000000
C2	11762254	11763496	BolC2t07713H	0	+	363	1132	1242	0.9114332
C2	11789836	11790854	BolC2t07714H	0	+	269	1001	1018	0.9833006
C2	11792492	11795393	BolC2t07715H	0	+	950	2383	2901	0.8214409
C2	11797443	11798547	BolC2t07716H	0	+	313	1000	1104	0.9057971
C2	11798975	11799688	BolC2t07717H	0	+	471	713	713	1.0000000
C2	11817129	11817468	BolC2t07718H	0	-	14	83	339	0.2448378
C2	11822330	11822922	BolC2t07719H	0	-	283	592	592	1.0000000
C2	11824345	11824774	BolC2t07720H	0	-	48	374	429	0.8717949
C2	11826019	11833625	BolC2t07721H	0	+	1577	4766	7606	0.6266106
C2	11834709	11835741	BolC2t07722H	0	+	80	463	1032	0.4486434
C2	11838068	11839172	BolC2t07723H	0	+	114	686	1104	0.6213768
C2	11844407	11845141	BolC2t07724H	0	+	78	264	734	0.3596730
C2	11848603	11855988	BolC2t07725H	0	+	1500	5489	7385	0.7432634
C2	11857825	11858845	BolC2t07726H	0	+	145	979	1020	0.9598039
C2	11869295	11871467	BolC2t07727H	0	+	403	1807	2172	0.8319521
C2	11878008	11880428	BolC2t07728H	0	+	1383	2247	2420	0.9285124
C2	11882806	11887135	BolC2t07729H	0	+	1217	3899	4329	0.9006699
C2	11887802	11888754	BolC2t07730H	0	+	828	820	952	0.8613445
C2	11889303	11890989	BolC2t07731H	0	+	1050	1686	1686	1.0000000
C2	11894080	11894397	BolC2t07732H	0	-	159	317	317	1.0000000
C2	11903961	11906594	BolC2t07733H	0	-	1198	2474	2633	0.9396126
C2	11912836	11913317	BolC2t07734H	0	-	87	347	481	0.7214137
C2	11913401	11919255	BolC2t07735H	0	+	3734	5332	5854	0.9108302
C2	11926047	11926532	BolC2t07736H	0	-	366	485	485	1.0000000
C2	11938326	11939343	BolC2t07737H	0	+	562	1017	1017	1.0000000
C2	11939636	11940752	BolC2t07738H	0	+	356	1059	1116	0.9489247
C2	11941150	11941601	BolC2t07739H	0	-	466	451	451	1.0000000
C2	11943400	11943803	BolC2t07740H	0	-	114	399	403	0.9900745
C2	11944582	11947202	BolC2t07741H	0	+	1278	2352	2620	0.8977099
C2	11947604	11947838	BolC2t07742H	0	-	181	234	234	1.0000000
C2	11949982	11952755	BolC2t07743H	0	-	1624	2773	2773	1.0000000
C2	11956178	11960072	BolC2t07744H	0	+	1566	3361	3894	0.8631228
C2	11963171	11963438	BolC2t07745H	0	+	208	267	267	1.0000000
C2	11973200	11973632	BolC2t07746H	0	-	667	432	432	1.0000000
C2	11975096	11977943	BolC2t07747H	0	-	566	1360	2847	0.4776958
C2	11978703	11981941	BolC2t07748H	0	-	2019	3238	3238	1.0000000
C2	11982360	11982799	BolC2t07749H	0	-	361	439	439	1.0000000
C2	11997263	11997872	BolC2t07750H	0	-	232	470	609	0.7717570
C2	12008693	12011289	BolC2t07751H	0	-	262	1646	2596	0.6340524
C2	12034866	12035593	BolC2t07752H	0	-	173	465	727	0.6396149
C2	12039005	12040145	BolC2t07753H	0	+	153	1058	1140	0.9280702
C2	12053592	12056362	BolC2t07754H	0	-	621	2405	2770	0.8682311
C2	12057390	12059048	BolC2t07755H	0	-	840	1621	1658	0.9776840
C2	12059567	12063442	BolC2t07756H	0	-	943	3726	3875	0.9615484
C2	12068282	12068982	BolC2t07757H	0	-	114	665	700	0.9500000
C2	12072074	12072819	BolC2t07758H	0	-	5	306	745	0.4107383
C2	12075313	12076553	BolC2t07759H	0	-	4	152	1240	0.1225806
C2	12085348	12086829	BolC2t07760H	0	-	1210	1481	1481	1.0000000
C2	12090023	12090511	BolC2t07761H	0	-	243	488	488	1.0000000
C2	12102071	12102634	BolC2t07762H	0	+	873	563	563	1.0000000
C2	12108976	12111712	BolC2t07763H	0	-	71	996	2736	0.3640351
C2	12123040	12123586	BolC2t07764H	0	-	364	546	546	1.0000000
C2	12131393	12131640	BolC2t07765H	0	-	8	247	247	1.0000000
C2	12131512	12131793	BolC2t07766H	0	-	13	281	281	1.0000000
C2	12138475	12139198	BolC2t07767H	0	+	35	54	723	0.0746888
C2	12143009	12143426	BolC2t07768H	0	+	0	0	417	0.0000000
C2	12147909	12148427	BolC2t07769H	0	+	398	518	518	1.0000000
C2	12150321	12152436	BolC2t07770H	0	-	608	2062	2115	0.9749409
C2	12181771	12182078	BolC2t07771H	0	-	238	307	307	1.0000000
C2	12197303	12197612	BolC2t07772H	0	-	44	309	309	1.0000000
C2	12216009	12217978	BolC2t07773H	0	+	2084	1969	1969	1.0000000
C2	12221905	12222199	BolC2t07774H	0	+	258	294	294	1.0000000
C2	12251883	12254367	BolC2t07775H	0	+	1436	2484	2484	1.0000000
C2	12254857	12257091	BolC2t07776H	0	-	943	2012	2234	0.9006267
C2	12264817	12267502	BolC2t07777H	0	+	1096	2615	2685	0.9739292
C2	12276005	12276655	BolC2t07778H	0	-	221	413	650	0.6353846
C2	12277955	12279991	BolC2t07779H	0	+	691	1928	2036	0.9469548
C2	12280420	12282212	BolC2t07780H	0	-	999	1683	1792	0.9391741
C2	12307079	12307787	BolC2t07781H	0	+	605	708	708	1.0000000
C2	12307985	12308621	BolC2t07782H	0	+	179	636	636	1.0000000
C2	12308894	12313075	BolC2t07783H	0	-	1403	4149	4181	0.9923463
C2	12324886	12325862	BolC2t07784H	0	-	215	737	976	0.7551230
C2	12340479	12342061	BolC2t07785H	0	+	210	1191	1582	0.7528445
C2	12343722	12345233	BolC2t07786H	0	-	816	1511	1511	1.0000000
C2	12346415	12348493	BolC2t07787H	0	-	2400	2078	2078	1.0000000
C2	12355900	12359484	BolC2t07788H	0	+	76	854	3584	0.2382812
C2	12361063	12393491	BolC2t07789H	0	+	21307	30973	32428	0.9551314
C2	12392733	12393622	BolC2t07790H	0	+	883	889	889	1.0000000
C2	12396080	12396443	BolC2t07791H	0	-	275	363	363	1.0000000
C2	12398004	12398597	BolC2t07792H	0	-	205	579	593	0.9763913
C2	12437238	12439454	BolC2t07793H	0	+	102	1165	2216	0.5257220
C2	12478811	12479489	BolC2t07794H	0	+	21	448	678	0.6607670
C2	12491961	12492141	BolC2t07795H	0	-	273	180	180	1.0000000
C2	12494707	12495572	BolC2t07796H	0	+	831	865	865	1.0000000
C2	12511967	12513507	BolC2t07797H	0	-	682	1509	1540	0.9798701
C2	12520639	12521035	BolC2t07798H	0	-	55	346	396	0.8737374
C2	12538245	12538938	BolC2t07799H	0	+	101	513	693	0.7402598
C2	12545637	12553019	BolC2t07800H	0	+	2189	6229	7382	0.8438092
C2	12562331	12563547	BolC2t07801H	0	-	104	1090	1216	0.8963816
C2	12572536	12573956	BolC2t07802H	0	-	20	238	1420	0.1676056
C2	12576890	12584714	BolC2t07803H	0	-	258	3852	7824	0.4923313
C2	12599522	12600982	BolC2t07804H	0	-	456	1403	1460	0.9609589
C2	12614351	12615352	BolC2t07805H	0	+	10	99	1001	0.0989011
C2	12621585	12623377	BolC2t07806H	0	+	966	1792	1792	1.0000000
C2	12652009	12652478	BolC2t07807H	0	+	71	469	469	1.0000000
C2	12665248	12665446	BolC2t07808H	0	+	86	198	198	1.0000000
C2	12683062	12683629	BolC2t07809H	0	-	0	0	567	0.0000000
C2	12684222	12685363	BolC2t07810H	0	-	8	72	1141	0.0631025
C2	12686690	12687922	BolC2t07811H	0	-	218	963	1232	0.7816558
C2	12731205	12732570	BolC2t07812H	0	-	186	1203	1365	0.8813187
C2	12735882	12736838	BolC2t07813H	0	-	515	850	956	0.8891214
C2	12742499	12742613	BolC2t07814H	0	-	42	59	114	0.5175439
C2	12744856	12747736	BolC2t07815H	0	+	1154	2858	2880	0.9923611
C2	12756478	12757489	BolC2t07816H	0	+	584	1011	1011	1.0000000
C2	12757842	12760635	BolC2t07817H	0	-	2578	2793	2793	1.0000000
C2	12773098	12776711	BolC2t07818H	0	+	140	1439	3613	0.3982840
C2	12796885	12797068	BolC2t07819H	0	-	0	0	183	0.0000000
C2	12800804	12806436	BolC2t07820H	0	+	1446	4805	5632	0.8531605
C2	12806613	12807580	BolC2t07821H	0	-	459	967	967	1.0000000
C2	12808893	12809193	BolC2t07822H	0	+	289	300	300	1.0000000
C2	12813369	12813894	BolC2t07823H	0	+	621	525	525	1.0000000
C2	12819595	12838551	BolC2t07824H	0	+	740	8155	18956	0.4302068
C2	12844523	12844793	BolC2t07825H	0	+	0	0	270	0.0000000
C2	12846172	12848202	BolC2t07826H	0	-	102	1275	2030	0.6280788
C2	12850846	12853437	BolC2t07827H	0	+	206	1124	2591	0.4338093
C2	12873715	12873972	BolC2t07828H	0	+	0	0	257	0.0000000
C2	12883368	12883620	BolC2t07829H	0	-	0	0	252	0.0000000
C2	12886914	12887358	BolC2t07830H	0	+	0	0	444	0.0000000
C2	12887790	12906907	BolC2t07831H	0	+	921	10296	19117	0.5385782
C2	12912812	12913331	BolC2t07832H	0	+	0	0	519	0.0000000
C2	12914538	12916696	BolC2t07833H	0	-	48	971	2158	0.4499537
C2	12918560	12921717	BolC2t07834H	0	+	154	1130	3157	0.3579347
C2	12935970	12936946	BolC2t07835H	0	+	14	264	976	0.2704918
C2	12949939	12950383	BolC2t07836H	0	+	0	0	444	0.0000000
C2	12950817	12951924	BolC2t07837H	0	+	289	943	1107	0.8518519
C2	12954574	12957760	BolC2t07838H	0	+	41	584	3186	0.1833019
C2	12962174	12964148	BolC2t07839H	0	-	837	1930	1974	0.9777102
C2	12985674	12994379	BolC2t07840H	0	+	553	1990	8705	0.2286043
C2	12998117	12998430	BolC2t07841H	0	+	226	313	313	1.0000000
C2	13005114	13005807	BolC2t07842H	0	+	111	647	693	0.9336219
C2	13016903	13017817	BolC2t07843H	0	-	829	914	914	1.0000000
C2	13019715	13020398	BolC2t07844H	0	-	870	683	683	1.0000000
C2	13024503	13025067	BolC2t07845H	0	+	11	162	564	0.2872340
C2	13025436	13025835	BolC2t07846H	0	+	4	162	399	0.4060150
C2	13035859	13039194	BolC2t07847H	0	-	2245	3335	3335	1.0000000
C2	13040132	13042130	BolC2t07848H	0	+	1015	1961	1998	0.9814815
C2	13049709	13049844	BolC2t07849H	0	-	241	135	135	1.0000000
C2	13050649	13051429	BolC2t07850H	0	-	277	780	780	1.0000000
C2	13051709	13052399	BolC2t07851H	0	-	396	690	690	1.0000000
C2	13057585	13058164	BolC2t07852H	0	-	381	579	579	1.0000000
C2	13058354	13058537	BolC2t07853H	0	-	110	158	183	0.8633880
C2	13064452	13066310	BolC2t07854H	0	-	993	1858	1858	1.0000000
C2	13082120	13084236	BolC2t07855H	0	+	1599	2116	2116	1.0000000
C2	13084749	13085448	BolC2t07856H	0	-	521	699	699	1.0000000
C2	13092450	13094455	BolC2t07857H	0	+	1276	2005	2005	1.0000000
C2	13096889	13097450	BolC2t07858H	0	+	3829	557	561	0.9928699
C2	13101827	13109937	BolC2t07859H	0	-	3022	7738	8110	0.9541307
C2	13120547	13127448	BolC2t07860H	0	+	1089	3405	6901	0.4934067
C2	13143947	13144163	BolC2t07861H	0	-	68	216	216	1.0000000
C2	13144797	13146692	BolC2t07862H	0	-	1266	1895	1895	1.0000000
C2	13150230	13173672	BolC2t07863H	0	-	28288	16551	23442	0.7060404
C2	13151121	13152187	BolC2t07864H	0	+	0	0	1066	0.0000000
C2	13152852	13153419	BolC2t07865H	0	+	0	0	567	0.0000000
C2	13177219	13177591	BolC2t07866H	0	-	16	354	372	0.9516129
C2	13187819	13188629	BolC2t07867H	0	-	42	500	810	0.6172839
C2	13189269	13190620	BolC2t07868H	0	-	0	0	1351	0.0000000
C2	13193031	13194051	BolC2t07869H	0	-	7	198	1020	0.1941177
C2	13198934	13199623	BolC2t07870H	0	+	2953	689	689	1.0000000
C2	13200412	13200547	BolC2t07871H	0	+	105	135	135	1.0000000
C2	13207798	13208923	BolC2t07872H	0	-	11	290	1125	0.2577778
C2	13209220	13210179	BolC2t07873H	0	+	47	629	959	0.6558915
C2	13212954	13215644	BolC2t07874H	0	+	2	19	2690	0.0070632
C2	13218387	13226479	BolC2t07875H	0	-	34643	7386	8092	0.9127533
C2	13227759	13229114	BolC2t07876H	0	-	0	0	1355	0.0000000
C2	13231033	13231201	BolC2t07877H	0	-	0	0	168	0.0000000
C2	13233790	13235986	BolC2t07878H	0	-	88	1272	2196	0.5792350
C2	13240826	13241230	BolC2t07879H	0	+	13	50	404	0.1237624
C2	13241748	13242930	BolC2t07880H	0	+	12	307	1182	0.2597293
C2	13269802	13270407	BolC2t07881H	0	+	2	130	605	0.2148760
C2	13275608	13276072	BolC2t07882H	0	+	640	464	464	1.0000000
C2	13279198	13280929	BolC2t07883H	0	-	249	1261	1731	0.7284806
C2	13284014	13285071	BolC2t07884H	0	-	35	607	1057	0.5742668
C2	13292452	13292862	BolC2t07885H	0	+	293	410	410	1.0000000
C2	13293365	13293500	BolC2t07886H	0	+	98	135	135	1.0000000
C2	13294071	13294617	BolC2t07887H	0	-	19	229	546	0.4194139
C2	13299738	13300135	BolC2t07888H	0	-	833	397	397	1.0000000
C2	13308668	13315513	BolC2t07889H	0	-	870	3125	6845	0.4565376
C2	13319101	13319293	BolC2t07890H	0	-	17	153	192	0.7968750
C2	13333964	13334747	BolC2t07891H	0	+	942	783	783	1.0000000
C2	13336420	13338707	BolC2t07892H	0	-	1276	2049	2287	0.8959335
C2	13342811	13344184	BolC2t07893H	0	-	433	1373	1373	1.0000000
C2	13346328	13348649	BolC2t07894H	0	+	33	895	2321	0.3856097
C2	13374741	13378039	BolC2t07895H	0	+	1417	2943	3298	0.8923590
C2	13378637	13382506	BolC2t07896H	0	+	1487	3701	3869	0.9565780
C2	13382640	13384761	BolC2t07897H	0	-	1196	2121	2121	1.0000000
C2	13386666	13387287	BolC2t07898H	0	-	561	621	621	1.0000000
C2	13388068	13389143	BolC2t07899H	0	+	710	1075	1075	1.0000000
C2	13389387	13389790	BolC2t07900H	0	-	35	251	403	0.6228288
C2	13396075	13396261	BolC2t07901H	0	-	182	186	186	1.0000000
C2	13396772	13409061	BolC2t07902H	0	+	2531	10121	12289	0.8235821
C2	13410436	13411792	BolC2t07903H	0	+	204	1111	1356	0.8193215
C2	13413764	13414280	BolC2t07904H	0	-	133	439	516	0.8507752
C2	13417969	13421003	BolC2t07905H	0	-	454	2307	3034	0.7603824
C2	13429984	13430540	BolC2t07906H	0	-	505	556	556	1.0000000
C2	13433699	13433873	BolC2t07907H	0	+	103	174	174	1.0000000
C2	13451941	13452574	BolC2t07908H	0	-	978	633	633	1.0000000
C2	13462693	13464450	BolC2t07909H	0	+	256	1542	1757	0.8776323
C2	13476694	13478486	BolC2t07910H	0	+	421	1701	1792	0.9492188
C2	13478742	13480617	BolC2t07911H	0	-	797	1838	1875	0.9802667
C2	13480723	13481817	BolC2t07912H	0	+	677	1094	1094	1.0000000
C2	13484472	13486452	BolC2t07913H	0	+	721	1514	1980	0.7646465
C2	13488651	13488777	BolC2t07914H	0	-	51	126	126	1.0000000
C2	13489285	13490883	BolC2t07915H	0	-	725	1598	1598	1.0000000
C2	13492133	13494711	BolC2t07916H	0	+	496	2416	2578	0.9371606
C2	13495489	13496248	BolC2t07917H	0	+	547	759	759	1.0000000
C2	13516886	13518652	BolC2t07918H	0	+	138	979	1766	0.5543602
C2	13519566	13522392	BolC2t07919H	0	-	793	2826	2826	1.0000000
C2	13533512	13533695	BolC2t07920H	0	+	8	183	183	1.0000000
C2	13535812	13536304	BolC2t07921H	0	-	314	492	492	1.0000000
C2	13536836	13537974	BolC2t07922H	0	+	181	1047	1138	0.9200351
C2	13541634	13544448	BolC2t07923H	0	+	1954	2750	2814	0.9772566
C2	13546623	13547352	BolC2t07924H	0	-	213	729	729	1.0000000
C2	13548182	13549496	BolC2t07925H	0	+	39	886	1314	0.6742770
C2	13557865	13558263	BolC2t07926H	0	-	64	398	398	1.0000000
C2	13561451	13562262	BolC2t07927H	0	-	1157	811	811	1.0000000
C2	13567466	13567838	BolC2t07928H	0	-	69	372	372	1.0000000
C2	13570816	13571364	BolC2t07929H	0	-	380	548	548	1.0000000
C2	13581069	13582069	BolC2t07930H	0	+	993	1000	1000	1.0000000
C2	13599543	13602398	BolC2t07931H	0	-	529	2440	2855	0.8546410
C2	13612894	13614200	BolC2t07932H	0	-	163	1133	1306	0.8675345
C2	13629021	13629880	BolC2t07933H	0	+	691	859	859	1.0000000
C2	13639941	13640469	BolC2t07934H	0	+	487	528	528	1.0000000
C2	13640486	13653547	BolC2t07935H	0	+	2779	7917	13061	0.6061558
C2	13665711	13666311	BolC2t07936H	0	-	281	600	600	1.0000000
C2	13691755	13692093	BolC2t07937H	0	+	22	276	338	0.8165681
C2	13693101	13693512	BolC2t07938H	0	+	30	384	411	0.9343066
C2	13705236	13705462	BolC2t07939H	0	-	83	226	226	1.0000000
C2	13715852	13716189	BolC2t07940H	0	+	78	294	337	0.8724036
C2	13719922	13720564	BolC2t07941H	0	+	74	335	642	0.5218068
C2	13721509	13721936	BolC2t07942H	0	-	178	403	427	0.9437939
C2	13722558	13728328	BolC2t07943H	0	-	540	2145	5770	0.3717504
C2	13733949	13734410	BolC2t07944H	0	-	271	461	461	1.0000000
C2	13737308	13738924	BolC2t07945H	0	+	80	664	1616	0.4108911
C2	13763219	13763606	BolC2t07946H	0	-	14	246	387	0.6356589
C2	13765871	13766144	BolC2t07947H	0	+	0	0	273	0.0000000
C2	13772842	13773230	BolC2t07948H	0	+	128	388	388	1.0000000
C2	13773432	13773920	BolC2t07949H	0	+	210	488	488	1.0000000
C2	13774746	13774968	BolC2t07950H	0	-	185	222	222	1.0000000
C2	13782032	13783999	BolC2t07951H	0	+	882	1873	1967	0.9522115
C2	13784904	13785624	BolC2t07952H	0	-	76	310	720	0.4305556
C2	13794872	13796476	BolC2t07953H	0	-	711	748	1604	0.4663342
C2	13817704	13817916	BolC2t07954H	0	-	0	0	212	0.0000000
C2	13820304	13822667	BolC2t07955H	0	+	1703	2135	2363	0.9035125
C2	13823036	13826068	BolC2t07956H	0	-	498	2339	3032	0.7714380
C2	13832928	13833426	BolC2t07957H	0	-	411	498	498	1.0000000
C2	13836431	13836683	BolC2t07958H	0	-	8	252	252	1.0000000
C2	13841888	13844108	BolC2t07959H	0	+	842	2143	2220	0.9653153
C2	13854490	13854706	BolC2t07960H	0	+	128	216	216	1.0000000
C2	13857020	13858124	BolC2t07961H	0	-	0	0	1104	0.0000000
C2	13864236	13864952	BolC2t07962H	0	-	33	332	716	0.4636872
C2	13886054	13887879	BolC2t07963H	0	-	1057	1793	1825	0.9824657
C2	13911019	13911244	BolC2t07964H	0	-	176	225	225	1.0000000
C2	13924084	13924252	BolC2t07965H	0	+	17	51	168	0.3035714
C2	13925081	13929933	BolC2t07966H	0	+	633	2106	4852	0.4340478
C2	13947358	13947673	BolC2t07967H	0	+	228	315	315	1.0000000
C2	13947717	13948111	BolC2t07968H	0	+	211	394	394	1.0000000
C2	13956224	13957343	BolC2t07969H	0	-	0	0	1119	0.0000000
C2	13978036	13978293	BolC2t07970H	0	-	0	0	257	0.0000000
C2	13993113	13993522	BolC2t07971H	0	-	333	409	409	1.0000000
C2	14008523	14008805	BolC2t07972H	0	+	96	282	282	1.0000000
C2	14008857	14008959	BolC2t07973H	0	+	126	102	102	1.0000000
C2	14012899	14013469	BolC2t07974H	0	+	181	525	570	0.9210526
C2	14046266	14047385	BolC2t07975H	0	+	417	1082	1119	0.9669347
C2	14060363	14060504	BolC2t07976H	0	-	230	141	141	1.0000000
C2	14067301	14069085	BolC2t07977H	0	-	706	1782	1784	0.9988789
C2	14097051	14097390	BolC2t07978H	0	-	615	339	339	1.0000000
C2	14132358	14133620	BolC2t07979H	0	-	818	1262	1262	1.0000000
C2	14148076	14150470	BolC2t07980H	0	+	296	1716	2394	0.7167920
C2	14165617	14165884	BolC2t07981H	0	-	103	267	267	1.0000000
C2	14184198	14184402	BolC2t07982H	0	-	17	195	204	0.9558824
C2	14207139	14209075	BolC2t07983H	0	+	214	1776	1936	0.9173554
C2	14209428	14211366	BolC2t07984H	0	-	584	1113	1938	0.5743034
C2	14221652	14223809	BolC2t07985H	0	+	2269	2157	2157	1.0000000
C2	14224476	14224659	BolC2t07986H	0	+	409	183	183	1.0000000
C2	14224874	14225806	BolC2t07987H	0	-	550	932	932	1.0000000
C2	14226397	14227420	BolC2t07988H	0	+	444	1023	1023	1.0000000
C2	14262424	14262748	BolC2t07989H	0	-	153	324	324	1.0000000
C2	14272057	14273107	BolC2t07990H	0	+	39	897	1050	0.8542857
C2	14280121	14280259	BolC2t07991H	0	-	0	0	138	0.0000000
C2	14299980	14300868	BolC2t07992H	0	+	591	869	888	0.9786036
C2	14302685	14302976	BolC2t07993H	0	-	143	291	291	1.0000000
C2	14312562	14313190	BolC2t07994H	0	+	455	628	628	1.0000000
C2	14314395	14314831	BolC2t07995H	0	+	508	436	436	1.0000000
C2	14323087	14324270	BolC2t07996H	0	-	1207	1183	1183	1.0000000
C2	14324847	14325484	BolC2t07997H	0	-	340	637	637	1.0000000
C2	14348442	14350484	BolC2t07998H	0	+	79	1041	2042	0.5097943
C2	14355322	14355487	BolC2t07999H	0	-	97	165	165	1.0000000
C2	14374883	14376066	BolC2t08000H	0	-	40	998	1183	0.8436179
C2	14397804	14401330	BolC2t08001H	0	+	1475	3526	3526	1.0000000
C2	14432712	14433108	BolC2t08002H	0	-	349	396	396	1.0000000
C2	14434788	14435512	BolC2t08003H	0	+	153	660	724	0.9116022
C2	14459468	14459984	BolC2t08004H	0	+	369	516	516	1.0000000
C2	14460291	14464733	BolC2t08005H	0	+	2449	3744	4442	0.8428636
C2	14465575	14466620	BolC2t08006H	0	-	406	1029	1045	0.9846890
C2	14469492	14470828	BolC2t08007H	0	+	244	1026	1336	0.7679641
C2	14500273	14502898	BolC2t08008H	0	+	2942	2578	2625	0.9820952
C2	14503133	14506117	BolC2t08009H	0	-	2688	2984	2984	1.0000000
C2	14511117	14511639	BolC2t08010H	0	+	20	297	522	0.5689655
C2	14521614	14524667	BolC2t08011H	0	-	1707	2898	3053	0.9492303
C2	14527320	14527477	BolC2t08012H	0	-	257	157	157	1.0000000
C2	14527605	14530732	BolC2t08013H	0	-	2345	3014	3127	0.9638631
C2	14531490	14533799	BolC2t08014H	0	-	1160	2235	2309	0.9679515
C2	14534192	14535876	BolC2t08015H	0	-	643	1668	1684	0.9904988
C2	14536841	14537668	BolC2t08016H	0	-	47	648	827	0.7835550
C2	14548760	14553382	BolC2t08017H	0	-	2798	4548	4622	0.9839896
C2	14555299	14558265	BolC2t08018H	0	-	836	2773	2966	0.9349292
C2	14564878	14570923	BolC2t08019H	0	-	2010	5200	6045	0.8602151
C2	14584617	14585174	BolC2t08020H	0	+	363	557	557	1.0000000
C2	14590725	14591490	BolC2t08021H	0	+	38	502	765	0.6562092
C2	14623772	14624261	BolC2t08022H	0	+	372	489	489	1.0000000
C2	14628964	14629865	BolC2t08023H	0	-	520	901	901	1.0000000
C2	14631373	14634594	BolC2t08024H	0	-	1900	3101	3221	0.9627445
C2	14632000	14632407	BolC2t08025H	0	-	639	407	407	1.0000000
C2	14636002	14636498	BolC2t08026H	0	-	242	496	496	1.0000000
C2	14639527	14639719	BolC2t08027H	0	+	90	192	192	1.0000000
C2	14642795	14642972	BolC2t08028H	0	+	350	177	177	1.0000000
C2	14644463	14646227	BolC2t08029H	0	+	741	1004	1764	0.5691610
C2	14646768	14647554	BolC2t08030H	0	-	335	786	786	1.0000000
C2	14648398	14649567	BolC2t08031H	0	+	255	1069	1169	0.9144568
C2	14652550	14652914	BolC2t08032H	0	-	351	364	364	1.0000000
C2	14663313	14663679	BolC2t08033H	0	-	1282	366	366	1.0000000
C2	14666847	14667213	BolC2t08034H	0	-	772	366	366	1.0000000
C2	14679219	14679502	BolC2t08035H	0	-	1	28	283	0.0989399
C2	14721845	14722211	BolC2t08036H	0	-	154	366	366	1.0000000
C2	14723601	14723967	BolC2t08037H	0	-	208	366	366	1.0000000
C2	14732413	14732779	BolC2t08038H	0	-	1309	366	366	1.0000000
C2	14734180	14734543	BolC2t08039H	0	-	142	360	363	0.9917355
C2	14741432	14743371	BolC2t08040H	0	-	61	1203	1939	0.6204229
C2	14746554	14746920	BolC2t08041H	0	-	2	150	366	0.4098361
C2	14750092	14750457	BolC2t08042H	0	-	28	365	365	1.0000000
C2	14753623	14753989	BolC2t08043H	0	-	131	366	366	1.0000000
C2	14762450	14762816	BolC2t08044H	0	-	124	366	366	1.0000000
C2	14773435	14776459	BolC2t08045H	0	+	1200	2851	3024	0.9427910
C2	14777088	14779858	BolC2t08046H	0	-	881	2647	2770	0.9555957
C2	14806812	14807595	BolC2t08047H	0	+	46	430	783	0.5491698
C2	14816670	14816787	BolC2t08048H	0	-	46	117	117	1.0000000
C2	14816879	14817183	BolC2t08049H	0	-	75	304	304	1.0000000
C2	14819240	14819777	BolC2t08050H	0	-	3	191	537	0.3556797
C2	14833680	14835127	BolC2t08051H	0	+	117	1317	1447	0.9101589
C2	14835923	14836925	BolC2t08052H	0	+	372	963	1002	0.9610779
C2	14838628	14848547	BolC2t08053H	0	+	4145	9789	9919	0.9868938
C2	14850522	14851120	BolC2t08054H	0	+	99	598	598	1.0000000
C2	14854551	14855481	BolC2t08055H	0	+	319	930	930	1.0000000
C2	14863442	14863798	BolC2t08056H	0	+	100	237	356	0.6657304
C2	14869586	14871791	BolC2t08057H	0	-	253	1901	2205	0.8621315
C2	14875576	14878828	BolC2t08058H	0	+	142	1406	3252	0.4323493
C2	14877311	14878298	BolC2t08059H	0	+	39	581	987	0.5886525
C2	14879690	14879807	BolC2t08060H	0	-	0	0	117	0.0000000
C2	14879901	14880206	BolC2t08061H	0	-	39	305	305	1.0000000
C2	14880495	14881477	BolC2t08062H	0	-	34	837	982	0.8523422
C2	14882688	14883317	BolC2t08063H	0	-	159	292	629	0.4642289
C2	14890449	14890674	BolC2t08064H	0	-	299	225	225	1.0000000
C2	14899212	14900982	BolC2t08065H	0	+	133	1147	1770	0.6480226
C2	14903367	14904652	BolC2t08066H	0	-	1020	1285	1285	1.0000000
C2	14906565	14907996	BolC2t08067H	0	-	184	692	1431	0.4835779
C2	14928801	14929090	BolC2t08068H	0	-	96	289	289	1.0000000
C2	14929157	14929463	BolC2t08069H	0	-	56	294	306	0.9607843
C2	14958393	14960968	BolC2t08070H	0	-	796	2535	2575	0.9844660
C2	14968299	14970640	BolC2t08071H	0	-	383	1542	2341	0.6586928
C2	14971905	14976157	BolC2t08072H	0	-	2280	3978	4252	0.9355597
C2	15007106	15008120	BolC2t08073H	0	-	34	204	1014	0.2011834
C2	15008161	15008533	BolC2t08074H	0	-	10	88	372	0.2365591
C2	15016331	15016841	BolC2t08075H	0	+	13	31	510	0.0607843
C2	15026670	15027072	BolC2t08076H	0	+	8	196	402	0.4875622
C2	15034484	15052121	BolC2t08077H	0	-	13805	17637	17637	1.0000000
C2	15040587	15041165	BolC2t08078H	0	-	464	578	578	1.0000000
C2	15051657	15078560	BolC2t08079H	0	-	7946	21927	26903	0.8150392
C2	15067996	15068430	BolC2t08080H	0	-	77	434	434	1.0000000
C2	15091029	15091260	BolC2t08081H	0	+	31	184	231	0.7965368
C2	15101077	15102867	BolC2t08082H	0	-	2	107	1790	0.0597765
C2	15166134	15167879	BolC2t08083H	0	+	45	463	1745	0.2653295
C2	15187403	15189148	BolC2t08084H	0	+	5	367	1745	0.2103152
C2	15191157	15191930	BolC2t08085H	0	+	42	648	773	0.8382924
C2	15192215	15196131	BolC2t08086H	0	-	369	2845	3916	0.7265067
C2	15199656	15200052	BolC2t08087H	0	+	27	396	396	1.0000000
C2	15201095	15201813	BolC2t08088H	0	+	15	409	718	0.5696379
C2	15204548	15206280	BolC2t08089H	0	+	1103	1732	1732	1.0000000
C2	15212694	15213173	BolC2t08090H	0	+	304	479	479	1.0000000
C2	15213262	15213634	BolC2t08091H	0	+	112	372	372	1.0000000
C2	15216064	15216379	BolC2t08092H	0	+	65	216	315	0.6857143
C2	15223070	15223441	BolC2t08093H	0	+	77	334	371	0.9002696
C2	15225581	15226293	BolC2t08094H	0	-	195	674	712	0.9466292
C2	15227341	15229458	BolC2t08095H	0	+	2892	2108	2117	0.9957487
C2	15229862	15232613	BolC2t08096H	0	-	1641	2705	2751	0.9832788
C2	15233598	15234088	BolC2t08097H	0	+	274	490	490	1.0000000
C2	15240932	15242690	BolC2t08098H	0	-	333	1665	1758	0.9470990
C2	15265068	15266654	BolC2t08099H	0	-	209	1023	1586	0.6450189
C2	15273819	15277037	BolC2t08100H	0	+	641	2665	3218	0.8281541
C2	15278098	15279319	BolC2t08101H	0	-	415	1221	1221	1.0000000
C2	15282554	15284361	BolC2t08102H	0	-	1528	1807	1807	1.0000000
C2	15291130	15293053	BolC2t08103H	0	-	1245	1923	1923	1.0000000
C2	15296861	15297578	BolC2t08104H	0	+	63	437	717	0.6094840
C2	15299015	15299593	BolC2t08105H	0	-	264	578	578	1.0000000
C2	15305149	15305359	BolC2t08106H	0	+	0	0	210	0.0000000
C2	15308171	15308342	BolC2t08107H	0	-	226	171	171	1.0000000
C2	15311315	15314690	BolC2t08108H	0	-	1044	3022	3375	0.8954074
C2	15317406	15318099	BolC2t08109H	0	-	555	693	693	1.0000000
C2	15318710	15321933	BolC2t08110H	0	-	1043	3175	3223	0.9851071
C2	15323967	15324273	BolC2t08111H	0	-	258	306	306	1.0000000
C2	15326137	15328702	BolC2t08112H	0	-	135	1145	2565	0.4463938
C2	15353293	15354516	BolC2t08113H	0	-	0	0	1223	0.0000000
C2	15367023	15367417	BolC2t08114H	0	-	34	394	394	1.0000000
C2	15369752	15370334	BolC2t08115H	0	-	683	582	582	1.0000000
C2	15385964	15386165	BolC2t08116H	0	-	118	201	201	1.0000000
C2	15401478	15452546	BolC2t08117H	0	+	24540	49530	51068	0.9698833
C2	15435840	15436381	BolC2t08118H	0	+	300	541	541	1.0000000
C2	15453870	15454574	BolC2t08119H	0	+	407	704	704	1.0000000
C2	15457747	15460875	BolC2t08120H	0	-	607	2712	3128	0.8670077
C2	15463659	15465448	BolC2t08121H	0	+	906	1357	1789	0.7585243
C2	15466773	15468998	BolC2t08122H	0	-	967	2225	2225	1.0000000
C2	15489181	15491456	BolC2t08123H	0	-	742	2021	2275	0.8883516
C2	15493509	15494064	BolC2t08124H	0	-	312	555	555	1.0000000
C2	15495738	15498725	BolC2t08125H	0	-	879	2758	2987	0.9233344
C2	15539146	15539263	BolC2t08126H	0	-	61	117	117	1.0000000
C2	15539840	15540227	BolC2t08127H	0	+	214	387	387	1.0000000
C2	15541532	15542801	BolC2t08128H	0	+	542	1269	1269	1.0000000
C2	15543732	15544782	BolC2t08129H	0	+	278	943	1050	0.8980953
C2	15546747	15550962	BolC2t08130H	0	+	1403	4091	4215	0.9705812
C2	15551076	15553015	BolC2t08131H	0	+	89	1075	1939	0.5544095
C2	15557819	15559142	BolC2t08132H	0	-	484	1233	1323	0.9319728
C2	15569854	15570843	BolC2t08133H	0	-	889	989	989	1.0000000
C2	15581445	15582846	BolC2t08134H	0	+	257	1287	1401	0.9186295
C2	15608154	15609681	BolC2t08135H	0	-	69	1030	1527	0.6745252
C2	15632207	15633931	BolC2t08136H	0	-	492	1724	1724	1.0000000
C2	15634493	15634940	BolC2t08137H	0	+	122	438	447	0.9798658
C2	15649230	15649917	BolC2t08138H	0	+	64	609	687	0.8864629
C2	15656626	15657034	BolC2t08139H	0	-	92	375	408	0.9191176
C2	15660258	15662871	BolC2t08140H	0	+	505	1900	2613	0.7271336
C2	15663436	15665573	BolC2t08141H	0	-	120	977	2137	0.4571830
C2	15673444	15673639	BolC2t08142H	0	+	174	195	195	1.0000000
C2	15688485	15691388	BolC2t08143H	0	+	294	1949	2903	0.6713744
C2	15704909	15705776	BolC2t08144H	0	+	288	680	867	0.7843137
C2	15711614	15711890	BolC2t08145H	0	+	659	276	276	1.0000000
C2	15715540	15716702	BolC2t08146H	0	+	81	591	1162	0.5086058
C2	15728695	15728860	BolC2t08147H	0	-	10	165	165	1.0000000
C2	15781352	15782746	BolC2t08148H	0	+	67	769	1394	0.5516499
C2	15789229	15789748	BolC2t08149H	0	+	218	519	519	1.0000000
C2	15802352	15805986	BolC2t08150H	0	-	49	1035	3634	0.2848101
C2	15825502	15825691	BolC2t08151H	0	-	30	189	189	1.0000000
C2	15828361	15828670	BolC2t08152H	0	+	0	0	309	0.0000000
C2	15833716	15835088	BolC2t08153H	0	-	118	677	1372	0.4934402
C2	15844844	15845186	BolC2t08154H	0	-	147	342	342	1.0000000
C2	15848042	15848222	BolC2t08155H	0	-	133	180	180	1.0000000
C2	15867248	15868791	BolC2t08156H	0	+	1022	1506	1543	0.9760208
C2	15869827	15871681	BolC2t08157H	0	+	292	1355	1854	0.7308522
C2	15871924	15872917	BolC2t08158H	0	-	151	852	993	0.8580061
C2	15875203	15875308	BolC2t08159H	0	+	18	105	105	1.0000000
C2	15876479	15877979	BolC2t08160H	0	-	88	1133	1500	0.7553333
C2	15886065	15886281	BolC2t08161H	0	+	191	216	216	1.0000000
C2	15889330	15897724	BolC2t08162H	0	-	1764	5523	8394	0.6579700
C2	15903233	15905724	BolC2t08163H	0	-	30	458	2491	0.1838619
C2	15906032	15907181	BolC2t08164H	0	+	0	0	1149	0.0000000
C2	15911775	15913722	BolC2t08165H	0	+	361	1865	1947	0.9578839
C2	15917284	15919413	BolC2t08166H	0	+	1094	1867	2129	0.8769375
C2	15936417	15938478	BolC2t08167H	0	-	152	1318	2061	0.6394954
C2	15961811	15962503	BolC2t08168H	0	-	65	604	692	0.8728324
C2	15977160	15981234	BolC2t08169H	0	+	1013	2214	4074	0.5434462
C2	15982912	15983494	BolC2t08170H	0	-	10	20	582	0.0343643
C2	15995067	15995738	BolC2t08171H	0	-	108	612	671	0.9120715
C2	16025372	16026386	BolC2t08172H	0	+	0	0	1014	0.0000000
C2	16040080	16040985	BolC2t08173H	0	-	948	905	905	1.0000000
C2	16041068	16041734	BolC2t08174H	0	-	699	666	666	1.0000000
C2	16042698	16042857	BolC2t08175H	0	-	252	159	159	1.0000000
C2	16059919	16060549	BolC2t08176H	0	-	132	594	630	0.9428571
C2	16077407	16081490	BolC2t08177H	0	+	1001	3628	4083	0.8885623
C2	16081898	16084728	BolC2t08178H	0	-	347	2148	2830	0.7590106
C2	16107156	16109175	BolC2t08179H	0	-	9	497	2019	0.2461615
C2	16114142	16116168	BolC2t08180H	0	-	435	1726	2026	0.8519250
C2	16123328	16127599	BolC2t08181H	0	-	256	757	4271	0.1772419
C2	16139687	16139957	BolC2t08182H	0	+	436	270	270	1.0000000
C2	16143766	16144633	BolC2t08183H	0	+	112	729	867	0.8408304
C2	16148257	16150471	BolC2t08184H	0	+	766	1902	2214	0.8590786
C2	16164276	16166662	BolC2t08185H	0	+	1191	2369	2386	0.9928751
C2	16175629	16180156	BolC2t08186H	0	+	806	2804	4527	0.6193947
C2	16183100	16186266	BolC2t08187H	0	+	900	2956	3166	0.9336702
C2	16190164	16190764	BolC2t08188H	0	+	0	0	600	0.0000000
C2	16192962	16197581	BolC2t08189H	0	-	3712	4592	4619	0.9941546
C2	16201308	16201521	BolC2t08190H	0	+	414	213	213	1.0000000
C2	16205691	16206231	BolC2t08191H	0	+	5	99	540	0.1833333
C2	16207344	16210030	BolC2t08192H	0	+	1796	2686	2686	1.0000000
C2	16221714	16221855	BolC2t08193H	0	-	164	141	141	1.0000000
C2	16232544	16235759	BolC2t08194H	0	+	1407	3079	3215	0.9576983
C2	16236098	16238331	BolC2t08195H	0	-	1787	2233	2233	1.0000000
C2	16239140	16240716	BolC2t08196H	0	-	382	1516	1576	0.9619290
C2	16262085	16262271	BolC2t08197H	0	+	1	124	186	0.6666667
C2	16263057	16263468	BolC2t08198H	0	-	12	277	411	0.6739659
C2	16264082	16265337	BolC2t08199H	0	-	142	1159	1255	0.9235060
C2	16266152	16266454	BolC2t08200H	0	-	1	126	302	0.4172185
C2	16268045	16268345	BolC2t08201H	0	-	63	298	300	0.9933333
C2	16268907	16269219	BolC2t08202H	0	-	84	312	312	1.0000000
C2	16295615	16297355	BolC2t08203H	0	+	202	1437	1740	0.8258621
C2	16297765	16298858	BolC2t08204H	0	-	363	993	1093	0.9085087
C2	16300914	16301302	BolC2t08205H	0	-	395	388	388	1.0000000
C2	16303880	16305518	BolC2t08206H	0	+	493	1525	1638	0.9310134
C2	16306307	16307929	BolC2t08207H	0	-	382	1576	1622	0.9716399
C2	16309442	16312183	BolC2t08208H	0	-	1406	2741	2741	1.0000000
C2	16318555	16326418	BolC2t08209H	0	-	5673	7022	7863	0.8930433
C2	16328087	16330594	BolC2t08210H	0	-	1356	2507	2507	1.0000000
C2	16335390	16335492	BolC2t08211H	0	-	512	102	102	1.0000000
C2	16336269	16337544	BolC2t08212H	0	-	549	1253	1275	0.9827451
C2	16347442	16349933	BolC2t08213H	0	+	1090	2370	2491	0.9514251
C2	16354586	16355614	BolC2t08214H	0	-	283	954	1028	0.9280156
C2	16362965	16364886	BolC2t08215H	0	+	225	1736	1921	0.9036960
C2	16414419	16415559	BolC2t08216H	0	+	123	1006	1140	0.8824561
C2	16423790	16427075	BolC2t08217H	0	+	380	2867	3285	0.8727549
C2	16439119	16440994	BolC2t08218H	0	+	556	1553	1875	0.8282667
C2	16445173	16445782	BolC2t08219H	0	+	165	543	609	0.8916256
C2	16447711	16448696	BolC2t08220H	0	+	569	985	985	1.0000000
C2	16452914	16453214	BolC2t08221H	0	+	93	300	300	1.0000000
C2	16458528	16459661	BolC2t08222H	0	+	167	935	1133	0.8252427
C2	16471759	16472092	BolC2t08223H	0	-	61	313	333	0.9399399
C2	16476959	16478866	BolC2t08224H	0	+	431	1873	1907	0.9821709
C2	16480793	16481884	BolC2t08225H	0	+	259	1014	1091	0.9294226
C2	16485713	16488357	BolC2t08226H	0	+	344	1909	2644	0.7220121
C2	16493542	16495908	BolC2t08227H	0	-	315	2069	2366	0.8744717
C2	16496014	16496300	BolC2t08228H	0	-	28	223	286	0.7797203
C2	16525675	16526772	BolC2t08229H	0	-	628	1097	1097	1.0000000
C2	16537316	16539621	BolC2t08230H	0	-	922	1953	2305	0.8472885
C2	16540373	16540949	BolC2t08231H	0	-	560	576	576	1.0000000
C2	16541123	16541900	BolC2t08232H	0	-	819	777	777	1.0000000
C2	16542367	16546720	BolC2t08233H	0	+	1407	3674	4353	0.8440156
C2	16547366	16548398	BolC2t08234H	0	-	282	853	1032	0.8265504
C2	16548664	16551378	BolC2t08235H	0	+	426	1845	2714	0.6798084
C2	16549007	16549352	BolC2t08236H	0	+	87	243	345	0.7043478
C2	16551674	16552907	BolC2t08237H	0	-	3	256	1233	0.2076237
C2	16556140	16557063	BolC2t08238H	0	+	346	893	923	0.9674973
C2	16569580	16572664	BolC2t08239H	0	+	604	2745	3084	0.8900778
C2	16578689	16579334	BolC2t08240H	0	+	84	583	645	0.9038759
C2	16580222	16580660	BolC2t08241H	0	-	281	438	438	1.0000000
C2	16584316	16586962	BolC2t08242H	0	+	744	2630	2646	0.9939531
C2	16590534	16591480	BolC2t08243H	0	+	750	946	946	1.0000000
C2	16600082	16600508	BolC2t08244H	0	-	160	426	426	1.0000000
C2	16602798	16608900	BolC2t08245H	0	-	1658	4389	6102	0.7192724
C2	16614792	16616850	BolC2t08246H	0	-	243	1379	2058	0.6700680
C2	16619957	16620704	BolC2t08247H	0	-	307	747	747	1.0000000
C2	16625700	16630455	BolC2t08248H	0	-	350	2080	4755	0.4374343
C2	16635858	16640156	BolC2t08249H	0	+	889	3550	4298	0.8259656
C2	16640683	16642418	BolC2t08250H	0	-	582	1552	1735	0.8945245
C2	16657686	16660306	BolC2t08251H	0	-	785	2617	2620	0.9988549
C2	16662781	16666303	BolC2t08252H	0	-	546	2606	3522	0.7399205
C2	16670485	16673698	BolC2t08253H	0	+	779	2963	3213	0.9221911
C2	16674653	16676501	BolC2t08254H	0	-	406	1775	1848	0.9604979
C2	16682199	16683309	BolC2t08255H	0	-	171	984	1110	0.8864865
C2	16684685	16686005	BolC2t08256H	0	+	2216	1156	1320	0.8757576
C2	16686931	16688696	BolC2t08257H	0	-	588	1759	1765	0.9966006
C2	16689123	16690517	BolC2t08258H	0	+	400	1207	1394	0.8658537
C2	16691001	16699180	BolC2t08259H	0	+	496	2565	8179	0.3136080
C2	16694970	16695900	BolC2t08260H	0	-	0	0	930	0.0000000
C2	16699775	16703866	BolC2t08261H	0	-	2664	4091	4091	1.0000000
C2	16704473	16706077	BolC2t08262H	0	+	608	1515	1604	0.9445137
C2	16706682	16711129	BolC2t08263H	0	-	1150	3439	4447	0.7733303
C2	16713779	16716358	BolC2t08264H	0	+	700	2272	2579	0.8809616
C2	16716750	16718499	BolC2t08265H	0	+	258	1416	1749	0.8096055
C2	16719051	16722116	BolC2t08266H	0	+	1584	3065	3065	1.0000000
C2	16724661	16725072	BolC2t08267H	0	+	198	411	411	1.0000000
C2	16729669	16729951	BolC2t08268H	0	-	27	282	282	1.0000000
C2	16751138	16751879	BolC2t08269H	0	-	277	714	741	0.9635627
C2	16760402	16760928	BolC2t08270H	0	+	0	0	526	0.0000000
C2	16764068	16766225	BolC2t08271H	0	+	124	1470	2157	0.6815021
C2	16767744	16768837	BolC2t08272H	0	-	0	0	1093	0.0000000
C2	16768972	16770587	BolC2t08273H	0	-	8	388	1615	0.2402477
C2	16773409	16775260	BolC2t08274H	0	+	439	1738	1851	0.9389519
C2	16775888	16776053	BolC2t08275H	0	-	33	165	165	1.0000000
C2	16788470	16793032	BolC2t08276H	0	-	1393	3648	4562	0.7996493
C2	16802885	16805178	BolC2t08277H	0	-	216	1386	2293	0.6044483
C2	16814170	16814410	BolC2t08278H	0	+	60	231	240	0.9625000
C2	16852984	16854741	BolC2t08279H	0	+	271	1164	1757	0.6624929
C2	16864504	16864933	BolC2t08280H	0	+	123	374	429	0.8717949
C2	16867367	16868087	BolC2t08281H	0	-	209	720	720	1.0000000
C2	16873351	16875464	BolC2t08282H	0	-	753	1944	2113	0.9200189
C2	16878039	16884286	BolC2t08283H	0	-	1788	4460	6247	0.7139427
C2	16879257	16879835	BolC2t08284H	0	-	257	578	578	1.0000000
C2	16888015	16888207	BolC2t08285H	0	-	52	192	192	1.0000000
C2	16908995	16909604	BolC2t08286H	0	+	3	45	609	0.0738916
C2	16929721	16930108	BolC2t08287H	0	-	337	387	387	1.0000000
C2	16931772	16933092	BolC2t08288H	0	-	951	1320	1320	1.0000000
C2	16952585	16952840	BolC2t08289H	0	+	0	0	255	0.0000000
C2	16954354	16954940	BolC2t08290H	0	+	0	0	586	0.0000000
C2	16956960	16962527	BolC2t08291H	0	-	1476	4477	5567	0.8042033
C2	16996263	16996611	BolC2t08292H	0	+	369	348	348	1.0000000
C2	17004546	17005851	BolC2t08293H	0	+	849	1305	1305	1.0000000
C2	17011446	17013205	BolC2t08294H	0	+	1507	1759	1759	1.0000000
C2	17022123	17023938	BolC2t08295H	0	-	300	1746	1815	0.9619834
C2	17044721	17045703	BolC2t08296H	0	-	158	787	982	0.8014256
C2	17047230	17048681	BolC2t08297H	0	-	746	1451	1451	1.0000000
C2	17051223	17051775	BolC2t08298H	0	-	462	552	552	1.0000000
C2	17057484	17057809	BolC2t08299H	0	-	330	325	325	1.0000000
C2	17060304	17061092	BolC2t08300H	0	+	412	788	788	1.0000000
C2	17084144	17086660	BolC2t08301H	0	+	743	1726	2516	0.6860095
C2	17089350	17091380	BolC2t08302H	0	-	60	582	2030	0.2866995
C2	17095976	17096242	BolC2t08303H	0	+	0	0	266	0.0000000
C2	17101516	17104359	BolC2t08304H	0	-	692	1902	2843	0.6690116
C2	17115826	17116879	BolC2t08305H	0	+	0	0	1053	0.0000000
C2	17148786	17151728	BolC2t08306H	0	+	812	2815	2942	0.9568321
C2	17153554	17154452	BolC2t08307H	0	-	257	721	898	0.8028953
C2	17156699	17158263	BolC2t08308H	0	-	770	1564	1564	1.0000000
C2	17173447	17173558	BolC2t08309H	0	-	105	111	111	1.0000000
C2	17177882	17178686	BolC2t08310H	0	-	123	630	804	0.7835821
C2	17207963	17209375	BolC2t08311H	0	-	934	1093	1412	0.7740793
C2	17240634	17241918	BolC2t08312H	0	+	26	570	1284	0.4439252
C2	17242492	17245110	BolC2t08313H	0	-	320	1644	2618	0.6279603
C2	17251419	17256184	BolC2t08314H	0	-	1488	4039	4765	0.8476390
C2	17258509	17259003	BolC2t08315H	0	+	99	477	494	0.9655870
C2	17261541	17262315	BolC2t08316H	0	-	7	72	774	0.0930233
C2	17305074	17305329	BolC2t08317H	0	-	38	172	255	0.6745098
C2	17306324	17309272	BolC2t08318H	0	-	1854	2925	2948	0.9921981
C2	17319278	17321329	BolC2t08319H	0	-	176	1276	2051	0.6221355
C2	17356060	17358445	BolC2t08320H	0	+	317	2115	2385	0.8867925
C2	17362419	17364745	BolC2t08321H	0	-	646	2310	2326	0.9931213
C2	17368634	17369525	BolC2t08322H	0	-	322	891	891	1.0000000
C2	17371040	17371615	BolC2t08323H	0	-	235	575	575	1.0000000
C2	17379747	17383656	BolC2t08324H	0	-	1391	2413	3909	0.6172934
C2	17396813	17398025	BolC2t08325H	0	+	80	1026	1212	0.8465347
C2	17418260	17419880	BolC2t08326H	0	+	221	1263	1620	0.7796296
C2	17423611	17425112	BolC2t08327H	0	-	27	739	1501	0.4923384
C2	17448204	17449728	BolC2t08328H	0	+	3	160	1524	0.1049869
C2	17468130	17468262	BolC2t08329H	0	+	0	0	132	0.0000000
C2	17470467	17471254	BolC2t08330H	0	+	16	274	787	0.3481576
C2	17476106	17477805	BolC2t08331H	0	+	369	1139	1699	0.6703944
C2	17491394	17491910	BolC2t08332H	0	+	315	516	516	1.0000000
C2	17501533	17502867	BolC2t08333H	0	+	34	817	1334	0.6124438
C2	17536243	17537095	BolC2t08334H	0	-	343	852	852	1.0000000
C2	17543508	17544029	BolC2t08335H	0	-	0	0	521	0.0000000
C2	17547003	17548280	BolC2t08336H	0	-	0	0	1277	0.0000000
C2	17581599	17582876	BolC2t08337H	0	-	0	0	1277	0.0000000
C2	17600546	17601067	BolC2t08338H	0	-	4	181	521	0.3474088
C2	17604057	17609898	BolC2t08339H	0	-	5432	5457	5841	0.9342578
C2	17612894	17613264	BolC2t08340H	0	-	533	370	370	1.0000000
C2	17631073	17632500	BolC2t08341H	0	+	19	162	1427	0.1135249
C2	17649456	17650816	BolC2t08342H	0	+	641	1066	1360	0.7838235
C2	17660898	17662651	BolC2t08343H	0	-	58	497	1753	0.2835140
C2	17666674	17667486	BolC2t08344H	0	-	0	0	812	0.0000000
C2	17669077	17670709	BolC2t08345H	0	-	4	73	1632	0.0447304
C2	17685660	17687374	BolC2t08346H	0	-	521	1705	1714	0.9947491
C2	17693490	17693829	BolC2t08347H	0	+	50	256	339	0.7551622
C2	17694947	17696475	BolC2t08348H	0	-	1090	1528	1528	1.0000000
C2	17698556	17698853	BolC2t08349H	0	+	18	207	297	0.6969697
C2	17709228	17709655	BolC2t08350H	0	+	12	38	427	0.0889930
C2	17714102	17714609	BolC2t08351H	0	+	237	507	507	1.0000000
C2	17718534	17730116	BolC2t08352H	0	+	3873	10355	11582	0.8940598
C2	17721347	17723996	BolC2t08353H	0	+	355	2292	2649	0.8652322
C2	17723997	17725522	BolC2t08354H	0	-	871	1525	1525	1.0000000
C2	17731065	17732226	BolC2t08355H	0	+	818	1161	1161	1.0000000
C2	17738308	17739559	BolC2t08356H	0	+	480	1251	1251	1.0000000
C2	17740732	17740888	BolC2t08357H	0	+	324	156	156	1.0000000
C2	17741108	17742195	BolC2t08358H	0	-	241	804	1087	0.7396504
C2	17743524	17744510	BolC2t08359H	0	-	418	956	986	0.9695740
C2	17746114	17746309	BolC2t08360H	0	-	158	195	195	1.0000000
C2	17746387	17747158	BolC2t08361H	0	-	249	749	771	0.9714656
C2	17747521	17748078	BolC2t08362H	0	-	463	557	557	1.0000000
C2	17751737	17753469	BolC2t08363H	0	-	0	0	1732	0.0000000
C2	17762284	17765259	BolC2t08364H	0	-	1091	2000	2975	0.6722689
C2	17784911	17785866	BolC2t08365H	0	-	36	562	955	0.5884817
C2	17786219	17787352	BolC2t08366H	0	-	283	1086	1133	0.9585172
C2	17810687	17811952	BolC2t08367H	0	+	2	198	1265	0.1565217
C2	17813482	17813950	BolC2t08368H	0	-	4	194	468	0.4145299
C2	17813796	17813901	BolC2t08369H	0	+	2	44	105	0.4190476
C2	17814751	17814862	BolC2t08370H	0	-	2	46	111	0.4144144
C2	17816121	17816970	BolC2t08371H	0	-	24	243	849	0.2862191
C2	17817812	17818850	BolC2t08372H	0	+	0	0	1038	0.0000000
C2	17821392	17832742	BolC2t08373H	0	-	1803	6963	11350	0.6134802
C2	17842268	17865029	BolC2t08374H	0	+	1636	14953	22761	0.6569571
C2	17878160	17878601	BolC2t08375H	0	-	1	44	441	0.0997732
C2	17889347	17889773	BolC2t08376H	0	-	15	244	426	0.5727699
C2	17897045	17901615	BolC2t08377H	0	-	3156	4242	4570	0.9282275
C2	17899229	17899967	BolC2t08378H	0	+	215	534	738	0.7235773
C2	17925731	17928092	BolC2t08379H	0	-	42	555	2361	0.2350699
C2	17929756	17942277	BolC2t08380H	0	-	1898	8790	12521	0.7020206
C2	17943406	17945243	BolC2t08381H	0	-	844	1506	1837	0.8198149
C2	17947722	17948904	BolC2t08382H	0	+	63	762	1182	0.6446701
C2	17970546	17971071	BolC2t08383H	0	-	275	495	525	0.9428571
C2	17974475	17987963	BolC2t08384H	0	+	7219	10710	13488	0.7940391
C2	17982958	17983118	BolC2t08385H	0	-	4	122	160	0.7625000
C2	17996970	17997690	BolC2t08386H	0	+	355	720	720	1.0000000
C2	17997851	18000423	BolC2t08387H	0	-	1009	2572	2572	1.0000000
C2	18026843	18028398	BolC2t08388H	0	-	262	1468	1555	0.9440514
C2	18036427	18037323	BolC2t08389H	0	+	17	505	896	0.5636161
C2	18058953	18060780	BolC2t08390H	0	-	359	769	1827	0.4209086
C2	18067423	18067690	BolC2t08391H	0	+	192	267	267	1.0000000
C2	18082734	18083055	BolC2t08392H	0	+	270	321	321	1.0000000
C2	18088634	18090565	BolC2t08393H	0	+	641	1743	1931	0.9026411
C2	18117717	18120146	BolC2t08394H	0	+	593	1954	2429	0.8044463
C2	18121077	18122123	BolC2t08395H	0	+	125	675	1046	0.6453155
C2	18128913	18129748	BolC2t08396H	0	-	7	342	835	0.4095808
C2	18133080	18133915	BolC2t08397H	0	-	1	44	835	0.0526946
C2	18176003	18177415	BolC2t08398H	0	-	368	1412	1412	1.0000000
C2	18204942	18205775	BolC2t08399H	0	-	64	609	833	0.7310925
C2	18243353	18244454	BolC2t08400H	0	+	40	704	1101	0.6394187
C2	18257781	18261745	BolC2t08401H	0	-	1115	2803	3964	0.7071140
C2	18281151	18282629	BolC2t08402H	0	-	59	542	1478	0.3667118
C2	18286141	18303927	BolC2t08403H	0	-	1038	6174	17786	0.3471270
C2	18319342	18319477	BolC2t08404H	0	+	57	135	135	1.0000000
C2	18322774	18323791	BolC2t08405H	0	+	758	1017	1017	1.0000000
C2	18330880	18331387	BolC2t08406H	0	+	436	507	507	1.0000000
C2	18332329	18332857	BolC2t08407H	0	-	0	0	528	0.0000000
C2	18333586	18334458	BolC2t08408H	0	-	73	257	872	0.2947248
C2	18375377	18376880	BolC2t08409H	0	+	55	817	1503	0.5435795
C2	18386270	18387524	BolC2t08410H	0	-	214	937	1254	0.7472090
C2	18399001	18404204	BolC2t08411H	0	-	232	2791	5203	0.5364213
C2	18408447	18415845	BolC2t08412H	0	+	1632	6987	7398	0.9444444
C2	18416969	18417332	BolC2t08413H	0	-	30	363	363	1.0000000
C2	18420560	18421044	BolC2t08414H	0	-	18	379	484	0.7830579
C2	18428879	18429476	BolC2t08415H	0	+	334	597	597	1.0000000
C2	18430910	18433005	BolC2t08416H	0	+	957	2093	2095	0.9990454
C2	18456110	18456365	BolC2t08417H	0	-	295	255	255	1.0000000
C2	18459838	18461059	BolC2t08418H	0	+	182	1210	1221	0.9909910
C2	18463179	18463813	BolC2t08419H	0	-	545	634	634	1.0000000
C2	18464868	18466071	BolC2t08420H	0	+	168	806	1203	0.6699917
C2	18471563	18473748	BolC2t08421H	0	+	893	1775	2185	0.8123570
C2	18484436	18488337	BolC2t08422H	0	+	1162	3040	3901	0.7792873
C2	18489082	18493466	BolC2t08423H	0	-	1682	4218	4384	0.9621350
C2	18496036	18497417	BolC2t08424H	0	-	1142	1381	1381	1.0000000
C2	18502280	18503321	BolC2t08425H	0	-	61	920	1041	0.8837656
C2	18511108	18513838	BolC2t08426H	0	-	688	1666	2730	0.6102564
C2	18517318	18518181	BolC2t08427H	0	+	606	863	863	1.0000000
C2	18537882	18538212	BolC2t08428H	0	-	1	65	330	0.1969697
C2	18542719	18543049	BolC2t08429H	0	-	0	0	330	0.0000000
C2	18562394	18562724	BolC2t08430H	0	-	0	0	330	0.0000000
C2	18587379	18587547	BolC2t08431H	0	+	81	168	168	1.0000000
C2	18597971	18598781	BolC2t08432H	0	+	85	535	810	0.6604939
C2	18607318	18609468	BolC2t08433H	0	-	132	1623	2150	0.7548837
C2	18651188	18656813	BolC2t08434H	0	-	2024	4718	5625	0.8387555
C2	18657023	18660416	BolC2t08435H	0	-	2403	3178	3393	0.9366342
C2	18682119	18683007	BolC2t08436H	0	+	76	306	888	0.3445946
C2	18708447	18708847	BolC2t08437H	0	-	0	0	400	0.0000000
C2	18777148	18777879	BolC2t08438H	0	+	259	731	731	1.0000000
C2	18782122	18783705	BolC2t08439H	0	+	204	1183	1583	0.7473152
C2	18784282	18784633	BolC2t08440H	0	-	529	351	351	1.0000000
C2	18789531	18790269	BolC2t08441H	0	-	556	738	738	1.0000000
C2	18815777	18815972	BolC2t08442H	0	+	21	129	195	0.6615385
C2	18816777	18817574	BolC2t08443H	0	-	286	743	797	0.9322459
C2	18819404	18823684	BolC2t08444H	0	-	2545	3927	4280	0.9175234
C2	18824278	18825912	BolC2t08445H	0	-	607	1634	1634	1.0000000
C2	18833562	18834032	BolC2t08446H	0	-	753	470	470	1.0000000
C2	18834940	18837243	BolC2t08447H	0	+	594	1651	2303	0.7168910
C2	18891501	18892691	BolC2t08448H	0	+	43	674	1190	0.5663866
C2	18897285	18898233	BolC2t08449H	0	+	589	948	948	1.0000000
C2	18902721	18903053	BolC2t08450H	0	+	269	332	332	1.0000000
C2	18907199	18909079	BolC2t08451H	0	-	298	1623	1880	0.8632979
C2	18913521	18916874	BolC2t08452H	0	+	596	2967	3353	0.8848792
C2	18917467	18918211	BolC2t08453H	0	-	93	478	744	0.6424731
C2	18918825	18919540	BolC2t08454H	0	-	119	608	715	0.8503497
C2	18963490	18964862	BolC2t08455H	0	-	448	1372	1372	1.0000000
C2	18970969	18971378	BolC2t08456H	0	-	487	409	409	1.0000000
C2	18971757	18971874	BolC2t08457H	0	-	157	117	117	1.0000000
C2	18973411	18974426	BolC2t08458H	0	+	748	1015	1015	1.0000000
C2	18976994	18979068	BolC2t08459H	0	-	107	1755	2074	0.8461909
C2	18995926	19000515	BolC2t08460H	0	+	1095	4188	4589	0.9126171
C2	19013482	19021616	BolC2t08461H	0	+	1565	5805	8134	0.7136710
C2	19027817	19031258	BolC2t08462H	0	-	140	1446	3441	0.4202267
C2	19057423	19058739	BolC2t08463H	0	-	16	289	1316	0.2196049
C2	19075323	19076196	BolC2t08464H	0	-	81	742	873	0.8499427
C2	19077474	19077848	BolC2t08465H	0	+	304	247	374	0.6604278
C2	19083585	19087243	BolC2t08466H	0	-	711	2734	3658	0.7474030
C2	19104754	19106996	BolC2t08467H	0	-	65	902	2242	0.4023194
C2	19109860	19112300	BolC2t08468H	0	-	1894	2440	2440	1.0000000
C2	19121599	19122374	BolC2t08469H	0	-	128	646	775	0.8335484
C2	19123851	19124289	BolC2t08470H	0	-	288	438	438	1.0000000
C2	19137487	19139122	BolC2t08471H	0	+	392	1238	1635	0.7571865
C2	19140062	19140665	BolC2t08472H	0	-	32	330	603	0.5472637
C2	19153868	19156060	BolC2t08473H	0	+	62	1120	2192	0.5109489
C2	19161854	19162085	BolC2t08474H	0	+	123	231	231	1.0000000
C2	19168016	19169510	BolC2t08475H	0	+	21	763	1494	0.5107095
C2	19192239	19192796	BolC2t08476H	0	-	412	557	557	1.0000000
C2	19196791	19196956	BolC2t08477H	0	+	23	165	165	1.0000000
C2	19206016	19207566	BolC2t08478H	0	+	1415	1550	1550	1.0000000
C2	19214365	19214693	BolC2t08479H	0	+	26	206	328	0.6280488
C2	19228540	19230296	BolC2t08480H	0	+	218	1079	1756	0.6144647
C2	19234289	19234553	BolC2t08481H	0	+	275	264	264	1.0000000
C2	19234926	19235340	BolC2t08482H	0	+	633	414	414	1.0000000
C2	19236291	19237107	BolC2t08483H	0	+	27	339	816	0.4154412
C2	19241452	19242921	BolC2t08484H	0	-	5877	1469	1469	1.0000000
C2	19253305	19254803	BolC2t08485H	0	+	470	1498	1498	1.0000000
C2	19255060	19258719	BolC2t08486H	0	-	2202	3635	3659	0.9934408
C2	19287293	19289749	BolC2t08487H	0	+	1038	2072	2456	0.8436482
C2	19306600	19306782	BolC2t08488H	0	-	122	182	182	1.0000000
C2	19307611	19307758	BolC2t08489H	0	-	15	106	147	0.7210884
C2	19317064	19318099	BolC2t08490H	0	+	0	0	1035	0.0000000
C2	19325246	19326220	BolC2t08491H	0	-	45	617	974	0.6334702
C2	19336106	19336307	BolC2t08492H	0	+	195	201	201	1.0000000
C2	19338065	19338764	BolC2t08493H	0	-	300	631	699	0.9027182
C2	19342284	19342812	BolC2t08494H	0	-	481	528	528	1.0000000
C2	19345589	19346078	BolC2t08495H	0	+	0	0	489	0.0000000
C2	19347667	19349003	BolC2t08496H	0	-	509	1317	1336	0.9857785
C2	19379618	19379789	BolC2t08497H	0	-	129	171	171	1.0000000
C2	19382929	19384206	BolC2t08498H	0	+	40	447	1277	0.3500392
C2	19386311	19386980	BolC2t08499H	0	+	0	0	669	0.0000000
C2	19394499	19396387	BolC2t08500H	0	+	1266	1848	1888	0.9788136
C2	19399347	19399834	BolC2t08501H	0	-	757	487	487	1.0000000
C2	19400145	19400701	BolC2t08502H	0	+	383	556	556	1.0000000
C2	19402623	19402905	BolC2t08503H	0	-	1425	282	282	1.0000000
C2	19412885	19414520	BolC2t08504H	0	+	495	1629	1635	0.9963303
C2	19414922	19415633	BolC2t08505H	0	+	291	672	711	0.9451477
C2	19419913	19422431	BolC2t08506H	0	+	1269	2518	2518	1.0000000
C2	19423292	19423862	BolC2t08507H	0	-	860	570	570	1.0000000
C2	19427192	19428455	BolC2t08508H	0	+	784	1237	1263	0.9794141
C2	19445659	19445899	BolC2t08509H	0	+	7	188	240	0.7833334
C2	19446802	19449741	BolC2t08510H	0	-	279	2560	2939	0.8710446
C2	19448126	19448892	BolC2t08511H	0	-	39	658	766	0.8590078
C2	19450819	19453474	BolC2t08512H	0	+	279	2112	2655	0.7954803
C2	19487113	19488797	BolC2t08513H	0	-	1231	1664	1684	0.9881235
C2	19489848	19490370	BolC2t08514H	0	+	387	469	522	0.8984674
C2	19490847	19492334	BolC2t08515H	0	-	324	1398	1487	0.9401479
C2	19495068	19496055	BolC2t08516H	0	-	2	110	987	0.1114488
C2	19496119	19496832	BolC2t08517H	0	-	10	443	713	0.6213184
C2	19497834	19498175	BolC2t08518H	0	-	181	341	341	1.0000000
C2	19503896	19504103	BolC2t08519H	0	+	10	175	207	0.8454106
C2	19504278	19504623	BolC2t08520H	0	-	341	345	345	1.0000000
C2	19512539	19513646	BolC2t08521H	0	+	111	1046	1107	0.9448961
C2	19513873	19514707	BolC2t08522H	0	-	21	315	834	0.3776979
C2	19537834	19553927	BolC2t08523H	0	+	2149	11673	16093	0.7253464
C2	19561965	19562796	BolC2t08524H	0	-	612	796	831	0.9578820
C2	19582763	19582909	BolC2t08525H	0	+	174	146	146	1.0000000
C2	19586854	19590636	BolC2t08526H	0	+	2046	3747	3782	0.9907457
C2	19596365	19597008	BolC2t08527H	0	+	4	289	643	0.4494557
C2	19599650	19601368	BolC2t08528H	0	+	884	833	1718	0.4848661
C2	19613924	19624754	BolC2t08529H	0	+	7187	10591	10830	0.9779317
C2	19625737	19627565	BolC2t08530H	0	+	604	1644	1828	0.8993436
C2	19628675	19628804	BolC2t08531H	0	-	0	0	129	0.0000000
C2	19632858	19633459	BolC2t08532H	0	-	0	0	601	0.0000000
C2	19640757	19643378	BolC2t08533H	0	+	800	2367	2621	0.9030904
C2	19644582	19645335	BolC2t08534H	0	+	54	636	753	0.8446215
C2	19656453	19656906	BolC2t08535H	0	-	4	79	453	0.1743929
C2	19668320	19676443	BolC2t08536H	0	+	715	3827	8123	0.4711314
C2	19682493	19683568	BolC2t08537H	0	-	246	1075	1075	1.0000000
C2	19685379	19685676	BolC2t08538H	0	+	37	297	297	1.0000000
C2	19686367	19687330	BolC2t08539H	0	-	113	827	963	0.8587747
C2	19704535	19705491	BolC2t08540H	0	-	810	956	956	1.0000000
C2	19708449	19709280	BolC2t08541H	0	-	24	663	831	0.7978339
C2	19720893	19721547	BolC2t08542H	0	+	0	0	654	0.0000000
C2	19732112	19733196	BolC2t08543H	0	+	405	1066	1084	0.9833949
C2	19736503	19737553	BolC2t08544H	0	+	13	161	1050	0.1533333
C2	19740901	19742864	BolC2t08545H	0	+	4356	1946	1963	0.9913398
C2	19785897	19786215	BolC2t08546H	0	+	0	0	318	0.0000000
C2	19806632	19807457	BolC2t08547H	0	+	11	353	825	0.4278788
C2	19814898	19818204	BolC2t08548H	0	-	1511	2888	3306	0.8735632
C2	19825538	19825709	BolC2t08549H	0	+	37	171	171	1.0000000
C2	19858139	19858838	BolC2t08550H	0	-	0	0	699	0.0000000
C2	19876453	19876819	BolC2t08551H	0	-	36	332	366	0.9071038
C2	19882247	19884324	BolC2t08552H	0	-	658	2077	2077	1.0000000
C2	19890567	19892842	BolC2t08553H	0	+	437	1632	2275	0.7173626
C2	19894250	19897729	BolC2t08554H	0	-	940	2974	3479	0.8548433
C2	19903432	19907718	BolC2t08555H	0	+	1892	3665	4286	0.8551096
C2	19918771	19919215	BolC2t08556H	0	-	52	409	444	0.9211712
C2	19941801	19942752	BolC2t08557H	0	+	60	763	951	0.8023133
C2	19963410	19963719	BolC2t08558H	0	+	308	309	309	1.0000000
C2	19966820	19967099	BolC2t08559H	0	-	15	81	279	0.2903226
C2	19985366	19986413	BolC2t08560H	0	-	18	336	1047	0.3209169
C2	20033001	20033271	BolC2t08561H	0	-	398	270	270	1.0000000
C2	20055649	20058102	BolC2t08562H	0	+	719	2453	2453	1.0000000
C2	20062758	20063112	BolC2t08563H	0	-	373	354	354	1.0000000
C2	20068167	20068650	BolC2t08564H	0	-	388	483	483	1.0000000
C2	20069256	20069487	BolC2t08565H	0	-	1080	231	231	1.0000000
C2	20076542	20077301	BolC2t08566H	0	+	567	759	759	1.0000000
C2	20080461	20081878	BolC2t08567H	0	-	274	1056	1417	0.7452364
C2	20115092	20116041	BolC2t08568H	0	+	273	836	949	0.8809273
C2	20190311	20190563	BolC2t08569H	0	-	53	241	252	0.9563492
C2	20193051	20193429	BolC2t08570H	0	+	18	237	378	0.6269841
C2	20216915	20217206	BolC2t08571H	0	+	236	291	291	1.0000000
C2	20232767	20234184	BolC2t08572H	0	-	59	475	1417	0.3352152
C2	20237406	20238006	BolC2t08573H	0	+	74	600	600	1.0000000
C2	20238060	20238444	BolC2t08574H	0	+	74	384	384	1.0000000
C2	20256516	20261146	BolC2t08575H	0	+	1366	4630	4630	1.0000000
C2	20261826	20262231	BolC2t08576H	0	-	405	405	405	1.0000000
C2	20265050	20265589	BolC2t08577H	0	-	259	539	539	1.0000000
C2	20273823	20274402	BolC2t08578H	0	-	300	579	579	1.0000000
C2	20283749	20286986	BolC2t08579H	0	-	601	2787	3237	0.8609824
C2	20311034	20311734	BolC2t08580H	0	+	22	478	700	0.6828572
C2	20312966	20313917	BolC2t08581H	0	-	103	681	951	0.7160884
C2	20313997	20314368	BolC2t08582H	0	-	70	327	371	0.8814016
C2	20327728	20331497	BolC2t08583H	0	-	204	2451	3769	0.6503051
C2	20405745	20409453	BolC2t08584H	0	+	219	2061	3708	0.5558252
C2	20415012	20415228	BolC2t08585H	0	+	4	201	216	0.9305556
C2	20416112	20416650	BolC2t08586H	0	+	156	512	538	0.9516729
C2	20416798	20417375	BolC2t08587H	0	-	28	145	577	0.2512998
C2	20419798	20420218	BolC2t08588H	0	+	167	420	420	1.0000000
C2	20440239	20443169	BolC2t08589H	0	+	1628	2670	2930	0.9112628
C2	20444097	20452313	BolC2t08590H	0	-	2319	8175	8216	0.9950097
C2	20455498	20456913	BolC2t08591H	0	+	153	1389	1415	0.9816254
C2	20460204	20464382	BolC2t08592H	0	+	549	1961	4178	0.4693633
C2	20464943	20465751	BolC2t08593H	0	-	225	719	808	0.8898515
C2	20467814	20471437	BolC2t08594H	0	-	389	1895	3623	0.5230472
C2	20493869	20493971	BolC2t08595H	0	+	119	102	102	1.0000000
C2	20556417	20556921	BolC2t08596H	0	+	161	431	504	0.8551587
C2	20558060	20558282	BolC2t08597H	0	-	2	82	222	0.3693694
C2	20570941	20574941	BolC2t08598H	0	-	2183	3649	4000	0.9122500
C2	20580211	20581129	BolC2t08599H	0	+	43	297	918	0.3235294
C2	20588424	20589383	BolC2t08600H	0	+	46	587	959	0.6120960
C2	20619606	20619927	BolC2t08601H	0	+	414	321	321	1.0000000
C2	20635200	20636315	BolC2t08602H	0	-	175	828	1115	0.7426009
C2	20656968	20657322	BolC2t08603H	0	+	546	354	354	1.0000000
C2	20671995	20672280	BolC2t08604H	0	-	48	285	285	1.0000000
C2	20687617	20687875	BolC2t08605H	0	+	180	258	258	1.0000000
C2	20690430	20691009	BolC2t08606H	0	-	639	579	579	1.0000000
C2	20695803	20699409	BolC2t08607H	0	+	1411	3446	3606	0.9556295
C2	20700769	20701293	BolC2t08608H	0	+	476	524	524	1.0000000
C2	20702437	20702620	BolC2t08609H	0	-	1	62	183	0.3387978
C2	20703939	20706459	BolC2t08610H	0	+	1175	2460	2520	0.9761904
C2	20708741	20708994	BolC2t08611H	0	+	153	253	253	1.0000000
C2	20719346	20720378	BolC2t08612H	0	+	17	305	1032	0.2955426
C2	20723930	20725876	BolC2t08613H	0	-	86	1461	1946	0.7507708
C2	20744903	20745509	BolC2t08614H	0	+	30	384	606	0.6336634
C2	20748408	20748864	BolC2t08615H	0	+	124	211	456	0.4627193
C2	20750199	20750358	BolC2t08616H	0	-	15	119	159	0.7484277
C2	20751076	20752601	BolC2t08617H	0	-	115	1002	1525	0.6570492
C2	20779505	20779985	BolC2t08618H	0	-	149	480	480	1.0000000
C2	20780244	20780427	BolC2t08619H	0	-	23	183	183	1.0000000
C2	20782421	20783972	BolC2t08620H	0	+	2158	1551	1551	1.0000000
C2	20789332	20789695	BolC2t08621H	0	+	15	231	363	0.6363636
C2	20817265	20826330	BolC2t08622H	0	+	8644	8985	9065	0.9911749
C2	20828639	20831327	BolC2t08623H	0	-	1228	2440	2688	0.9077381
C2	20832563	20832680	BolC2t08624H	0	+	130	117	117	1.0000000
C2	20841237	20841393	BolC2t08625H	0	+	472	156	156	1.0000000
C2	20850491	20852452	BolC2t08626H	0	+	1250	1954	1961	0.9964304
C2	20855121	20857824	BolC2t08627H	0	+	3	61	2703	0.0225675
C2	20875618	20877515	BolC2t08628H	0	+	1249	1897	1897	1.0000000
C2	20878078	20878324	BolC2t08629H	0	+	188	246	246	1.0000000
C2	20879703	20880192	BolC2t08630H	0	-	62	437	489	0.8936605
C2	20880463	20881498	BolC2t08631H	0	+	19	356	1035	0.3439614
C2	20900060	20900725	BolC2t08632H	0	-	0	0	665	0.0000000
C2	20901982	20902563	BolC2t08633H	0	-	745	581	581	1.0000000
C2	20910551	20910791	BolC2t08634H	0	+	3	47	240	0.1958333
C2	20911500	20912786	BolC2t08635H	0	-	12	245	1286	0.1905132
C2	20939914	20940073	BolC2t08636H	0	-	24	159	159	1.0000000
C2	20952768	20953223	BolC2t08637H	0	-	95	440	455	0.9670330
C2	20956946	20958785	BolC2t08638H	0	+	403	1799	1839	0.9782491
C2	20965676	20967334	BolC2t08639H	0	+	545	1658	1658	1.0000000
C2	20968187	20970234	BolC2t08640H	0	-	749	1784	2047	0.8715193
C2	20992636	20992816	BolC2t08641H	0	+	57	180	180	1.0000000
C2	20993499	20993754	BolC2t08642H	0	+	214	255	255	1.0000000
C2	20998095	20998287	BolC2t08643H	0	-	386	192	192	1.0000000
C2	21003100	21004808	BolC2t08644H	0	+	335	1453	1708	0.8507026
C2	21015009	21015294	BolC2t08645H	0	+	58	235	285	0.8245614
C2	21018174	21018486	BolC2t08646H	0	-	58	312	312	1.0000000
C2	21020668	21021691	BolC2t08647H	0	-	88	782	1023	0.7644184
C2	21024419	21028150	BolC2t08648H	0	-	670	2866	3731	0.7681587
C2	21043665	21045111	BolC2t08649H	0	-	520	1340	1446	0.9266943
C2	21046142	21048324	BolC2t08650H	0	-	125	1786	2182	0.8185151
C2	21049389	21049725	BolC2t08651H	0	-	92	183	336	0.5446429
C2	21050526	21052211	BolC2t08652H	0	-	1060	1685	1685	1.0000000
C2	21053257	21055443	BolC2t08653H	0	-	3	270	2186	0.1235133
C2	21070394	21070646	BolC2t08654H	0	+	82	252	252	1.0000000
C2	21072391	21073746	BolC2t08655H	0	-	0	0	1355	0.0000000
C2	21076703	21077021	BolC2t08656H	0	-	77	141	318	0.4433962
C2	21080416	21082249	BolC2t08657H	0	-	156	268	1833	0.1462084
C2	21088647	21089157	BolC2t08658H	0	-	45	296	510	0.5803922
C2	21092176	21094070	BolC2t08659H	0	-	16	375	1894	0.1979937
C2	21099240	21099648	BolC2t08660H	0	+	3	55	408	0.1348039
C2	21100157	21101276	BolC2t08661H	0	+	72	722	1119	0.6452190
C2	21107172	21108036	BolC2t08662H	0	-	0	0	864	0.0000000
C2	21108131	21110286	BolC2t08663H	0	-	17	145	2155	0.0672854
C2	21112400	21113871	BolC2t08664H	0	-	87	1027	1471	0.6981645
C2	21124713	21125339	BolC2t08665H	0	+	0	0	626	0.0000000
C2	21131569	21133156	BolC2t08666H	0	+	2	19	1587	0.0119723
C2	21136685	21137063	BolC2t08667H	0	+	224	378	378	1.0000000
C2	21138934	21140032	BolC2t08668H	0	+	116	1031	1098	0.9389800
C2	21141118	21142430	BolC2t08669H	0	+	938	1312	1312	1.0000000
C2	21163938	21165072	BolC2t08670H	0	+	12	458	1134	0.4038801
C2	21173623	21173797	BolC2t08671H	0	+	2	28	174	0.1609195
C2	21175289	21177814	BolC2t08672H	0	-	520	1984	2525	0.7857426
C2	21179813	21180162	BolC2t08673H	0	-	2	77	349	0.2206304
C2	21183476	21184261	BolC2t08674H	0	-	41	457	785	0.5821656
C2	21195196	21195553	BolC2t08675H	0	+	209	357	357	1.0000000
C2	21215286	21216252	BolC2t08676H	0	+	377	857	966	0.8871636
C2	21232446	21233597	BolC2t08677H	0	+	269	1045	1151	0.9079062
C2	21234179	21235647	BolC2t08678H	0	-	1262	1468	1468	1.0000000
C2	21247989	21249094	BolC2t08679H	0	+	7	100	1105	0.0904977
C2	21265983	21267092	BolC2t08680H	0	+	0	0	1109	0.0000000
C2	21289842	21291841	BolC2t08681H	0	-	1711	1895	1999	0.9479740
C2	21295691	21297248	BolC2t08682H	0	-	729	1444	1557	0.9274246
C2	21297546	21302866	BolC2t08683H	0	-	451	2928	5320	0.5503759
C2	21310305	21310886	BolC2t08684H	0	-	58	552	581	0.9500861
C2	21311987	21315635	BolC2t08685H	0	-	384	1708	3648	0.4682018
C2	21324653	21326698	BolC2t08686H	0	+	642	1965	2045	0.9608802
C2	21333236	21337387	BolC2t08687H	0	+	1956	3128	4151	0.7535533
C2	21339121	21340669	BolC2t08688H	0	-	195	1493	1548	0.9644703
C2	21342726	21343396	BolC2t08689H	0	-	268	670	670	1.0000000
C2	21344660	21345876	BolC2t08690H	0	+	448	1216	1216	1.0000000
C2	21347528	21347861	BolC2t08691H	0	-	90	333	333	1.0000000
C2	21349241	21349677	BolC2t08692H	0	+	407	436	436	1.0000000
C2	21350813	21352790	BolC2t08693H	0	-	527	1718	1977	0.8689934
C2	21355987	21357313	BolC2t08694H	0	-	545	1231	1326	0.9283559
C2	21363720	21365645	BolC2t08695H	0	-	202	1502	1925	0.7802597
C2	21367284	21371316	BolC2t08696H	0	+	440	2564	4032	0.6359127
C2	21375149	21375473	BolC2t08697H	0	-	100	324	324	1.0000000
C2	21407166	21409397	BolC2t08698H	0	-	618	984	2231	0.4410578
C2	21410217	21411488	BolC2t08699H	0	-	4	23	1271	0.0180960
C2	21412654	21414555	BolC2t08700H	0	+	1181	1779	1901	0.9358233
C2	21414930	21417974	BolC2t08701H	0	+	1624	2874	3044	0.9441524
C2	21419167	21419930	BolC2t08702H	0	-	303	761	763	0.9973788
C2	21425796	21426230	BolC2t08703H	0	+	7	335	434	0.7718894
C2	21431168	21439634	BolC2t08704H	0	-	1946	5126	8466	0.6054807
C2	21440113	21441436	BolC2t08705H	0	+	278	1297	1323	0.9803477
C2	21442446	21444334	BolC2t08706H	0	+	278	1333	1888	0.7060381
C2	21466457	21466667	BolC2t08707H	0	-	86	210	210	1.0000000
C2	21506571	21509528	BolC2t08708H	0	+	1864	2877	2957	0.9729456
C2	21511683	21511842	BolC2t08709H	0	+	176	159	159	1.0000000
C2	21514913	21518546	BolC2t08710H	0	-	2123	3443	3633	0.9477016
C2	21537103	21537540	BolC2t08711H	0	-	240	437	437	1.0000000
C2	21538064	21539258	BolC2t08712H	0	+	354	910	1194	0.7621440
C2	21573217	21574228	BolC2t08713H	0	+	12	581	1011	0.5746785
C2	21576224	21578468	BolC2t08714H	0	-	1063	2009	2244	0.8952763
C2	21590445	21592158	BolC2t08715H	0	-	283	1571	1713	0.9171045
C2	21609885	21610834	BolC2t08716H	0	-	232	949	949	1.0000000
C2	21634611	21635045	BolC2t08717H	0	+	46	433	434	0.9976959
C2	21638493	21639504	BolC2t08718H	0	+	54	608	1011	0.6013848
C2	21640529	21641255	BolC2t08719H	0	+	228	610	726	0.8402204
C2	21653020	21653672	BolC2t08720H	0	-	546	652	652	1.0000000
C2	21655264	21659062	BolC2t08721H	0	+	1713	3765	3798	0.9913112
C2	21666336	21667331	BolC2t08722H	0	+	365	950	995	0.9547738
C2	21668447	21668885	BolC2t08723H	0	-	0	0	438	0.0000000
C2	21676855	21677566	BolC2t08724H	0	-	240	637	711	0.8959212
C2	21692784	21693154	BolC2t08725H	0	-	58	370	370	1.0000000
C2	21695842	21697817	BolC2t08726H	0	+	915	1975	1975	1.0000000
C2	21717033	21718553	BolC2t08727H	0	+	159	1232	1520	0.8105263
C2	21730398	21730773	BolC2t08728H	0	+	5	214	375	0.5706667
C2	21746266	21747034	BolC2t08729H	0	+	92	323	768	0.4205729
C2	21785022	21787843	BolC2t08730H	0	+	890	2758	2821	0.9776675
C2	21788814	21789827	BolC2t08731H	0	+	566	1013	1013	1.0000000
C2	21790956	21792750	BolC2t08732H	0	-	813	1620	1794	0.9030100
C2	21798740	21843938	BolC2t08733H	0	-	13536	33010	45198	0.7303420
C2	21804237	21804961	BolC2t08734H	0	+	7	136	724	0.1878453
C2	21824612	21826573	BolC2t08735H	0	+	443	1895	1961	0.9663437
C2	21846389	21847363	BolC2t08736H	0	-	723	974	974	1.0000000
C2	21848064	21850341	BolC2t08737H	0	-	907	2144	2277	0.9415898
C2	21850777	21852558	BolC2t08738H	0	+	142	1331	1781	0.7473329
C2	21853095	21862204	BolC2t08739H	0	-	2045	6811	9109	0.7477220
C2	21863146	21863923	BolC2t08740H	0	+	161	763	777	0.9819820
C2	21901007	21901550	BolC2t08741H	0	+	41	543	543	1.0000000
C2	21925769	21926714	BolC2t08742H	0	+	4	268	945	0.2835979
C2	21935503	21936833	BolC2t08743H	0	+	139	664	1330	0.4992481
C2	21938309	21942208	BolC2t08744H	0	+	228	1395	3899	0.3577840
C2	21949379	21949776	BolC2t08745H	0	-	61	397	397	1.0000000
C2	21949915	21950720	BolC2t08746H	0	+	270	736	805	0.9142857
C2	21952959	21953929	BolC2t08747H	0	+	127	970	970	1.0000000
C2	21954638	21955154	BolC2t08748H	0	+	386	516	516	1.0000000
C2	22004442	22004970	BolC2t08749H	0	-	114	436	528	0.8257576
C2	22032730	22032904	BolC2t08750H	0	+	100	174	174	1.0000000
C2	22070276	22070600	BolC2t08751H	0	-	6	57	324	0.1759259
C2	22093242	22093674	BolC2t08752H	0	-	312	432	432	1.0000000
C2	22115948	22117566	BolC2t08753H	0	+	218	1062	1618	0.6563659
C2	22160695	22162806	BolC2t08754H	0	+	1066	2111	2111	1.0000000
C2	22178719	22179868	BolC2t08755H	0	-	746	1149	1149	1.0000000
C2	22200938	22201427	BolC2t08756H	0	+	396	489	489	1.0000000
C2	22202851	22204870	BolC2t08757H	0	-	644	1895	2019	0.9385834
C2	22207595	22209664	BolC2t08758H	0	-	226	1154	2069	0.5577574
C2	22222340	22222994	BolC2t08759H	0	-	260	654	654	1.0000000
C2	22235849	22236626	BolC2t08760H	0	-	534	776	777	0.9987130
C2	22238175	22239375	BolC2t08761H	0	-	85	896	1200	0.7466667
C2	22246683	22247695	BolC2t08762H	0	-	145	917	1012	0.9061265
C2	22269664	22270801	BolC2t08763H	0	-	235	1015	1137	0.8927001
C2	22273129	22273693	BolC2t08764H	0	-	303	564	564	1.0000000
C2	22286933	22291959	BolC2t08765H	0	+	1160	4007	5026	0.7972543
C2	22293338	22294702	BolC2t08766H	0	-	10	251	1364	0.1840176
C2	22298478	22298631	BolC2t08767H	0	-	103	90	153	0.5882353
C2	22321790	22322999	BolC2t08768H	0	-	59	708	1209	0.5856079
C2	22348166	22362080	BolC2t08769H	0	-	2001	10870	13914	0.7812275
C2	22368038	22369238	BolC2t08770H	0	-	30	341	1200	0.2841667
C2	22394223	22394532	BolC2t08771H	0	+	0	0	309	0.0000000
C2	22405263	22407334	BolC2t08772H	0	-	1663	2034	2071	0.9821342
C2	22411478	22413485	BolC2t08773H	0	-	935	1821	2007	0.9073244
C2	22443890	22446235	BolC2t08774H	0	-	2	124	2345	0.0528785
C2	22448228	22449007	BolC2t08775H	0	-	21	369	779	0.4736842
C2	22456161	22456431	BolC2t08776H	0	-	315	270	270	1.0000000
C2	22463888	22467266	BolC2t08777H	0	+	874	3090	3378	0.9147425
C2	22471809	22472364	BolC2t08778H	0	-	855	555	555	1.0000000
C2	22472422	22472969	BolC2t08779H	0	-	361	547	547	1.0000000
C2	22477366	22478413	BolC2t08780H	0	+	53	768	1047	0.7335244
C2	22480823	22481171	BolC2t08781H	0	+	32	286	348	0.8218391
C2	22482795	22483869	BolC2t08782H	0	+	13	196	1074	0.1824953
C2	22493741	22494651	BolC2t08783H	0	+	100	804	910	0.8835165
C2	22504353	22506673	BolC2t08784H	0	+	1938	1793	2320	0.7728449
C2	22509339	22528993	BolC2t08785H	0	+	3283	13314	19654	0.6774194
C2	22533836	22534160	BolC2t08786H	0	+	442	324	324	1.0000000
C2	22534183	22534743	BolC2t08787H	0	+	566	560	560	1.0000000
C2	22539803	22542671	BolC2t08788H	0	+	523	2559	2868	0.8922594
C2	22543504	22544101	BolC2t08789H	0	+	35	380	597	0.6365159
C2	22547305	22550561	BolC2t08790H	0	-	564	2063	3256	0.6335995
C2	22557026	22557267	BolC2t08791H	0	+	146	241	241	1.0000000
C2	22563044	22565063	BolC2t08792H	0	+	392	1911	2019	0.9465082
C2	22570815	22573157	BolC2t08793H	0	+	1800	2321	2342	0.9910333
C2	22574293	22574560	BolC2t08794H	0	+	240	267	267	1.0000000
C2	22586386	22586796	BolC2t08795H	0	+	325	410	410	1.0000000
C2	22596673	22596856	BolC2t08796H	0	+	147	183	183	1.0000000
C2	22617946	22624680	BolC2t08797H	0	-	1226	3300	6734	0.4900505
C2	22625207	22637023	BolC2t08798H	0	+	3281	8151	11816	0.6898273
C2	22646565	22648178	BolC2t08799H	0	-	19	458	1613	0.2839430
C2	22654040	22656892	BolC2t08800H	0	+	568	2638	2852	0.9249650
C2	22669021	22670431	BolC2t08801H	0	-	1083	1410	1410	1.0000000
C2	22675624	22676557	BolC2t08802H	0	+	79	904	933	0.9689175
C2	22680627	22683805	BolC2t08803H	0	+	481	2221	3178	0.6988672
C2	22691508	22691676	BolC2t08804H	0	+	36	168	168	1.0000000
C2	22698937	22699261	BolC2t08805H	0	-	143	281	324	0.8672839
C2	22700724	22702974	BolC2t08806H	0	-	710	1920	2250	0.8533334
C2	22723351	22723684	BolC2t08807H	0	+	0	0	333	0.0000000
C2	22725755	22728572	BolC2t08808H	0	-	204	1684	2817	0.5977991
C2	22733848	22736016	BolC2t08809H	0	-	245	1278	2168	0.5894834
C2	22751198	22756838	BolC2t08810H	0	-	2817	5044	5640	0.8943263
C2	22757937	22761973	BolC2t08811H	0	-	857	3774	4036	0.9350842
C2	22809503	22810479	BolC2t08812H	0	-	6	310	976	0.3176230
C2	22820935	22822485	BolC2t08813H	0	+	576	1457	1550	0.9400000
C2	22824237	22824720	BolC2t08814H	0	-	24	385	483	0.7971014
C2	22825438	22829402	BolC2t08815H	0	-	1888	3839	3964	0.9684662
C2	22832616	22833384	BolC2t08816H	0	-	73	768	768	1.0000000
C2	22848014	22851350	BolC2t08817H	0	+	772	3109	3336	0.9319544
C2	22852767	22856067	BolC2t08818H	0	+	1456	3268	3300	0.9903030
C2	22856477	22856924	BolC2t08819H	0	-	409	447	447	1.0000000
C2	22868449	22868620	BolC2t08820H	0	+	209	171	171	1.0000000
C2	22869026	22870080	BolC2t08821H	0	-	619	1054	1054	1.0000000
C2	22880704	22882105	BolC2t08822H	0	-	892	1401	1401	1.0000000
C2	22890355	22892141	BolC2t08823H	0	+	1420	1786	1786	1.0000000
C2	22906568	22912394	BolC2t08824H	0	+	2637	5608	5826	0.9625815
C2	22921737	22924329	BolC2t08825H	0	-	545	2363	2592	0.9116513
C2	22926092	22927199	BolC2t08826H	0	+	475	1107	1107	1.0000000
C2	22927255	22927501	BolC2t08827H	0	+	302	246	246	1.0000000
C2	22930117	22930565	BolC2t08828H	0	-	100	448	448	1.0000000
C2	22930955	22934644	BolC2t08829H	0	+	2476	3590	3689	0.9731635
C2	22937357	22937462	BolC2t08830H	0	-	18	105	105	1.0000000
C2	22937549	22941693	BolC2t08831H	0	-	555	3753	4144	0.9056467
C2	22944513	22944998	BolC2t08832H	0	-	438	485	485	1.0000000
C2	22950689	22951190	BolC2t08833H	0	+	27	190	501	0.3792415
C2	22964790	22965384	BolC2t08834H	0	-	621	594	594	1.0000000
C2	22990198	22993085	BolC2t08835H	0	+	1044	2823	2887	0.9778317
C2	23011397	23013914	BolC2t08836H	0	+	384	2404	2517	0.9551053
C2	23019285	23022575	BolC2t08837H	0	+	2359	3290	3290	1.0000000
C2	23024031	23025423	BolC2t08838H	0	+	17	602	1392	0.4324713
C2	23026394	23027659	BolC2t08839H	0	+	277	1265	1265	1.0000000
C2	23033338	23033602	BolC2t08840H	0	+	181	264	264	1.0000000
C2	23037413	23039465	BolC2t08841H	0	+	679	2052	2052	1.0000000
C2	23040045	23040486	BolC2t08842H	0	-	91	392	441	0.8888889
C2	23041086	23044908	BolC2t08843H	0	+	1472	3728	3822	0.9754056
C2	23045681	23047265	BolC2t08844H	0	+	1246	1584	1584	1.0000000
C2	23057745	23064386	BolC2t08845H	0	+	3457	6122	6641	0.9218491
C2	23068277	23071613	BolC2t08846H	0	-	954	3335	3336	0.9997002
C2	23083036	23084378	BolC2t08847H	0	+	364	1271	1342	0.9470939
C2	23102252	23102450	BolC2t08848H	0	+	703	198	198	1.0000000
C2	23114544	23115778	BolC2t08849H	0	+	176	872	1234	0.7066451
C2	23127827	23129890	BolC2t08850H	0	+	390	1477	2063	0.7159476
C2	23164091	23164244	BolC2t08851H	0	-	36	150	153	0.9803922
C2	23168107	23168514	BolC2t08852H	0	-	99	280	407	0.6879607
C2	23170243	23170852	BolC2t08853H	0	+	425	609	609	1.0000000
C2	23173893	23175676	BolC2t08854H	0	-	676	1436	1783	0.8053842
C2	23181874	23194505	BolC2t08855H	0	+	8802	12592	12631	0.9969124
C2	23195996	23196359	BolC2t08856H	0	-	472	363	363	1.0000000
C2	23199597	23200081	BolC2t08857H	0	-	261	484	484	1.0000000
C2	23228910	23229471	BolC2t08858H	0	-	483	561	561	1.0000000
C2	23249888	23250351	BolC2t08859H	0	+	398	463	463	1.0000000
C2	23252250	23252502	BolC2t08860H	0	+	700	252	252	1.0000000
C2	23254114	23255024	BolC2t08861H	0	+	115	464	910	0.5098901
C2	23255288	23258234	BolC2t08862H	0	-	1242	2722	2946	0.9239647
C2	23262655	23262987	BolC2t08863H	0	+	391	332	332	1.0000000
C2	23264893	23265395	BolC2t08864H	0	-	171	445	502	0.8864542
C2	23266882	23267101	BolC2t08865H	0	-	434	219	219	1.0000000
C2	23268352	23269289	BolC2t08866H	0	-	436	937	937	1.0000000
C2	23279023	23279326	BolC2t08867H	0	+	11	277	303	0.9141914
C2	23286298	23286819	BolC2t08868H	0	+	38	164	521	0.3147793
C2	23333667	23334722	BolC2t08869H	0	-	129	747	1055	0.7080569
C2	23345658	23345877	BolC2t08870H	0	+	56	219	219	1.0000000
C2	23346991	23347825	BolC2t08871H	0	+	62	640	834	0.7673861
C2	23373780	23375327	BolC2t08872H	0	+	163	1342	1547	0.8674855
C2	23377780	23378377	BolC2t08873H	0	-	32	410	597	0.6867672
C2	23381228	23381829	BolC2t08874H	0	+	324	601	601	1.0000000
C2	23383853	23384739	BolC2t08875H	0	-	29	224	886	0.2528217
C2	23393401	23393726	BolC2t08876H	0	-	118	325	325	1.0000000
C2	23402791	23403640	BolC2t08877H	0	-	112	724	849	0.8527679
C2	23407669	23408020	BolC2t08878H	0	+	330	351	351	1.0000000
C2	23411151	23411844	BolC2t08879H	0	-	117	348	693	0.5021645
C2	23421144	23421417	BolC2t08880H	0	+	220	273	273	1.0000000
C2	23433341	23434096	BolC2t08881H	0	+	472	755	755	1.0000000
C2	23455122	23455656	BolC2t08882H	0	-	80	512	534	0.9588015
C2	23458639	23459510	BolC2t08883H	0	-	103	617	871	0.7083812
C2	23471036	23473068	BolC2t08884H	0	+	618	1534	2032	0.7549213
C2	23508765	23510113	BolC2t08885H	0	+	504	968	1348	0.7181009
C2	23510206	23512901	BolC2t08886H	0	+	77	1384	2695	0.5135436
C2	23515562	23518176	BolC2t08887H	0	-	366	2195	2614	0.8397093
C2	23532933	23535739	BolC2t08888H	0	+	1570	2806	2806	1.0000000
C2	23579430	23579937	BolC2t08889H	0	-	70	328	507	0.6469428
C2	23582401	23587621	BolC2t08890H	0	-	546	1466	5220	0.2808429
C2	23591048	23591934	BolC2t08891H	0	-	467	886	886	1.0000000
C2	23646471	23647169	BolC2t08892H	0	+	389	698	698	1.0000000
C2	23661583	23665362	BolC2t08893H	0	-	1160	3284	3779	0.8690130
C2	23673576	23673792	BolC2t08894H	0	+	266	216	216	1.0000000
C2	23685091	23690518	BolC2t08895H	0	+	1084	4389	5427	0.8087341
C2	23692144	23692639	BolC2t08896H	0	-	0	0	495	0.0000000
C2	23693160	23694443	BolC2t08897H	0	-	0	0	1283	0.0000000
C2	23695524	23696243	BolC2t08898H	0	-	43	345	719	0.4798331
C2	23700185	23700480	BolC2t08899H	0	-	57	295	295	1.0000000
C2	23709573	23710953	BolC2t08900H	0	+	27	405	1380	0.2934783
C2	23713068	23713752	BolC2t08901H	0	+	11	378	684	0.5526316
C2	23715153	23716695	BolC2t08902H	0	-	437	1377	1542	0.8929961
C2	23717633	23719159	BolC2t08903H	0	-	714	1526	1526	1.0000000
C2	23720642	23720828	BolC2t08904H	0	-	91	186	186	1.0000000
C2	23722761	23723953	BolC2t08905H	0	+	267	755	1192	0.6333892
C2	23730064	23731599	BolC2t08906H	0	-	157	877	1535	0.5713355
C2	23732286	23732781	BolC2t08907H	0	+	437	495	495	1.0000000
C2	23735983	23736484	BolC2t08908H	0	-	832	501	501	1.0000000
C2	23737815	23737950	BolC2t08909H	0	-	4	135	135	1.0000000
C2	23740829	23741235	BolC2t08910H	0	-	8	125	406	0.3078818
C2	23741610	23741997	BolC2t08911H	0	-	2	150	387	0.3875969
C2	23743012	23743213	BolC2t08912H	0	-	23	201	201	1.0000000
C2	23743630	23743771	BolC2t08913H	0	-	7	53	141	0.3758865
C2	23745733	23745838	BolC2t08914H	0	+	2	27	105	0.2571429
C2	23747655	23747841	BolC2t08915H	0	-	0	0	186	0.0000000
C2	23759505	23759718	BolC2t08916H	0	-	153	201	213	0.9436620
C2	23759822	23759954	BolC2t08917H	0	+	7	132	132	1.0000000
C2	23760729	23761152	BolC2t08918H	0	-	2	76	423	0.1796690
C2	23762346	23763075	BolC2t08919H	0	+	215	667	729	0.9149520
C2	23764004	23764420	BolC2t08920H	0	+	1561	400	416	0.9615384
C2	23765485	23765767	BolC2t08921H	0	+	7	140	282	0.4964539
C2	23766114	23766420	BolC2t08922H	0	-	3	244	306	0.7973856
C2	23769094	23769244	BolC2t08923H	0	-	1	15	150	0.1000000
C2	23772725	23772884	BolC2t08924H	0	-	18	159	159	1.0000000
C2	23777019	23777235	BolC2t08925H	0	+	13	182	216	0.8425926
C2	23779742	23780228	BolC2t08926H	0	+	6	103	486	0.2119341
C2	23780614	23781091	BolC2t08927H	0	+	10	139	477	0.2914046
C2	23782879	23783062	BolC2t08928H	0	+	1	10	183	0.0546448
C2	23783978	23784170	BolC2t08929H	0	-	2	65	192	0.3385417
C2	23789750	23806087	BolC2t08930H	0	+	6394	10665	16337	0.6528127
C2	23809319	23809985	BolC2t08931H	0	+	303	666	666	1.0000000
C2	23811198	23812548	BolC2t08932H	0	-	268	1126	1350	0.8340741
C2	23813407	23814618	BolC2t08933H	0	-	1519	1211	1211	1.0000000
C2	23818434	23827913	BolC2t08934H	0	-	4359	9110	9479	0.9610718
C2	23831054	23833945	BolC2t08935H	0	+	1217	2822	2891	0.9761328
C2	23835909	23837241	BolC2t08936H	0	-	409	1297	1332	0.9737237
C2	23837316	23839057	BolC2t08937H	0	-	460	1657	1741	0.9517519
C2	23843476	23846291	BolC2t08938H	0	-	233	2045	2815	0.7264653
C2	23896883	23900681	BolC2t08939H	0	+	2395	3798	3798	1.0000000
C2	23903418	23904359	BolC2t08940H	0	-	1036	941	941	1.0000000
C2	23906312	23906790	BolC2t08941H	0	-	464	478	478	1.0000000
C2	23915625	23924242	BolC2t08942H	0	-	1204	4122	8617	0.4783567
C2	23929335	23929800	BolC2t08943H	0	-	27	315	465	0.6774194
C2	23948790	23949278	BolC2t08944H	0	-	450	488	488	1.0000000
C2	23955896	23956445	BolC2t08945H	0	-	24	241	549	0.4389800
C2	23968228	23969706	BolC2t08946H	0	+	256	1214	1478	0.8213803
C2	23969774	23970323	BolC2t08947H	0	+	262	481	549	0.8761384
C2	23970319	23970913	BolC2t08948H	0	-	236	594	594	1.0000000
C2	23971525	23976168	BolC2t08949H	0	+	1715	4125	4643	0.8884342
C2	23977494	23977881	BolC2t08950H	0	-	441	362	387	0.9354005
C2	23978246	23983646	BolC2t08951H	0	-	1539	2095	5400	0.3879630
C2	23984947	23987353	BolC2t08952H	0	-	91	487	2406	0.2024106
C2	24002786	24003275	BolC2t08953H	0	+	217	483	489	0.9877301
C2	24008407	24008611	BolC2t08954H	0	-	0	0	204	0.0000000
C2	24023171	24023548	BolC2t08955H	0	-	2	152	377	0.4031830
C2	24040862	24042741	BolC2t08956H	0	+	743	1853	1879	0.9861628
C2	24063699	24066232	BolC2t08957H	0	-	1493	2533	2533	1.0000000
C2	24069396	24069657	BolC2t08958H	0	+	936	261	261	1.0000000
C2	24082438	24085780	BolC2t08959H	0	+	1333	3284	3342	0.9826451
C2	24086451	24087048	BolC2t08960H	0	-	458	597	597	1.0000000
C2	24091539	24091937	BolC2t08961H	0	+	668	398	398	1.0000000
C2	24095367	24095859	BolC2t08962H	0	+	225	492	492	1.0000000
C2	24101993	24106319	BolC2t08963H	0	+	1159	3918	4326	0.9056866
C2	24107118	24108918	BolC2t08964H	0	-	231	1137	1800	0.6316667
C2	24141449	24142385	BolC2t08965H	0	+	116	936	936	1.0000000
C2	24166300	24166495	BolC2t08966H	0	-	471	195	195	1.0000000
C2	24184214	24185949	BolC2t08967H	0	+	26	881	1735	0.5077810
C2	24188415	24188760	BolC2t08968H	0	-	349	345	345	1.0000000
C2	24191250	24193208	BolC2t08969H	0	+	1162	1958	1958	1.0000000
C2	24194196	24194682	BolC2t08970H	0	+	212	486	486	1.0000000
C2	24216621	24218464	BolC2t08971H	0	+	291	1728	1843	0.9376017
C2	24240650	24242156	BolC2t08972H	0	+	171	988	1506	0.6560425
C2	24252976	24254194	BolC2t08973H	0	+	664	1218	1218	1.0000000
C2	24254608	24255665	BolC2t08974H	0	-	850	1057	1057	1.0000000
C2	24271439	24277465	BolC2t08975H	0	-	3182	5224	6026	0.8669100
C2	24282403	24282616	BolC2t08976H	0	+	51	196	213	0.9201878
C2	24299261	24299882	BolC2t08977H	0	+	662	621	621	1.0000000
C2	24323480	24323804	BolC2t08978H	0	+	40	324	324	1.0000000
C2	24325340	24326675	BolC2t08979H	0	-	241	1076	1335	0.8059925
C2	24340054	24341941	BolC2t08980H	0	-	60	1178	1887	0.6242713
C2	24345554	24346670	BolC2t08981H	0	+	218	877	1116	0.7858423
C2	24347240	24347868	BolC2t08982H	0	-	302	628	628	1.0000000
C2	24348760	24350716	BolC2t08983H	0	-	797	1956	1956	1.0000000
C2	24351151	24353086	BolC2t08984H	0	+	1144	1833	1935	0.9472868
C2	24364830	24365088	BolC2t08985H	0	+	137	258	258	1.0000000
C2	24370494	24370852	BolC2t08986H	0	+	172	308	358	0.8603352
C2	24372572	24374063	BolC2t08987H	0	+	281	1275	1491	0.8551308
C2	24384034	24386001	BolC2t08988H	0	-	436	1293	1967	0.6573462
C2	24386914	24389557	BolC2t08989H	0	-	770	2408	2643	0.9110859
C2	24410230	24411263	BolC2t08990H	0	-	831	1033	1033	1.0000000
C2	24425772	24427691	BolC2t08991H	0	+	627	1681	1919	0.8759771
C2	24429008	24431233	BolC2t08992H	0	-	290	1351	2225	0.6071910
C2	24460784	24467225	BolC2t08993H	0	+	4841	6441	6441	1.0000000
C2	24474281	24476322	BolC2t08994H	0	+	224	909	2041	0.4453699
C2	24477238	24479532	BolC2t08995H	0	+	710	1669	2294	0.7275501
C2	24507178	24509144	BolC2t08996H	0	+	430	1916	1966	0.9745677
C2	24524693	24526643	BolC2t08997H	0	-	903	1795	1950	0.9205128
C2	24532534	24533599	BolC2t08998H	0	-	791	1065	1065	1.0000000
C2	24536833	24544341	BolC2t08999H	0	-	4055	7493	7508	0.9980021
C2	24544876	24545227	BolC2t09000H	0	-	26	351	351	1.0000000
C2	24559500	24559970	BolC2t09001H	0	-	26	422	470	0.8978723
C2	24580187	24581357	BolC2t09002H	0	-	972	1083	1170	0.9256410
C2	24632279	24634976	BolC2t09003H	0	+	280	1875	2697	0.6952169
C2	24687395	24689428	BolC2t09004H	0	+	740	1945	2033	0.9567142
C2	24694710	24695110	BolC2t09005H	0	+	311	400	400	1.0000000
C2	24714725	24715811	BolC2t09006H	0	-	59	814	1086	0.7495396
C2	24726944	24728126	BolC2t09007H	0	+	293	894	1182	0.7563452
C2	24767933	24768825	BolC2t09008H	0	-	70	846	892	0.9484305
C2	24771869	24772046	BolC2t09009H	0	+	55	177	177	1.0000000
C2	24777243	24777408	BolC2t09010H	0	+	66	165	165	1.0000000
C2	24778439	24778806	BolC2t09011H	0	-	67	306	367	0.8337874
C2	24783455	24784675	BolC2t09012H	0	+	506	1162	1220	0.9524590
C2	24785359	24786588	BolC2t09013H	0	-	227	1205	1229	0.9804719
C2	24791606	24791867	BolC2t09014H	0	-	237	261	261	1.0000000
C2	24798346	24798745	BolC2t09015H	0	+	77	399	399	1.0000000
C2	24806544	24811563	BolC2t09016H	0	+	1563	4084	5019	0.8137079
C2	24813332	24814004	BolC2t09017H	0	+	2345	672	672	1.0000000
C2	24817874	24819774	BolC2t09018H	0	-	134	1683	1900	0.8857895
C2	24835195	24835333	BolC2t09019H	0	+	0	0	138	0.0000000
C2	24836078	24843805	BolC2t09020H	0	+	2366	5527	7727	0.7152840
C2	24848969	24849417	BolC2t09021H	0	+	44	399	448	0.8906250
C2	24850191	24850821	BolC2t09022H	0	+	859	630	630	1.0000000
C2	24858060	24858219	BolC2t09023H	0	-	152	159	159	1.0000000
C2	24863637	24864540	BolC2t09024H	0	+	1107	903	903	1.0000000
C2	24884721	24885375	BolC2t09025H	0	+	47	575	654	0.8792049
C2	24892186	24892288	BolC2t09026H	0	-	44	102	102	1.0000000
C2	24907810	24911044	BolC2t09027H	0	-	346	2029	3234	0.6273964
C2	24915064	24915415	BolC2t09028H	0	-	82	351	351	1.0000000
C2	24938060	24939005	BolC2t09029H	0	+	454	927	945	0.9809524
C2	24939941	24940172	BolC2t09030H	0	+	117	227	231	0.9826840
C2	24940563	24940967	BolC2t09031H	0	-	95	47	404	0.1163366
C2	24940973	24941502	BolC2t09032H	0	-	198	457	529	0.8638942
C2	24943099	24945036	BolC2t09033H	0	+	495	1783	1937	0.9204956
C2	24948889	24949132	BolC2t09034H	0	-	10	125	243	0.5144033
C2	24951976	24952465	BolC2t09035H	0	+	1	36	489	0.0736196
C2	24952509	24952734	BolC2t09036H	0	+	0	0	225	0.0000000
C2	24961089	24962681	BolC2t09037H	0	-	439	1348	1592	0.8467337
C2	24963260	24969197	BolC2t09038H	0	+	1030	3498	5937	0.5891864
C2	24973347	24973701	BolC2t09039H	0	-	9	344	354	0.9717514
C2	24976273	24976486	BolC2t09040H	0	-	199	213	213	1.0000000
C2	24982379	25000575	BolC2t09041H	0	-	3135	12446	18196	0.6839965
C2	25032945	25034289	BolC2t09042H	0	-	640	1339	1344	0.9962798
C2	25044469	25046556	BolC2t09043H	0	+	242	1624	2087	0.7781504
C2	25067633	25068273	BolC2t09044H	0	+	610	639	640	0.9984375
C2	25071132	25073134	BolC2t09045H	0	-	2523	2002	2002	1.0000000
C2	25076262	25077815	BolC2t09046H	0	-	1421	1553	1553	1.0000000
C2	25077969	25079512	BolC2t09047H	0	-	434	1477	1543	0.9572262
C2	25080536	25081133	BolC2t09048H	0	+	154	597	597	1.0000000
C2	25083824	25084270	BolC2t09049H	0	-	8	282	446	0.6322870
C2	25087613	25089929	BolC2t09050H	0	-	1209	2053	2316	0.8864421
C2	25099289	25100388	BolC2t09051H	0	-	404	1099	1099	1.0000000
C2	25105620	25106010	BolC2t09052H	0	+	295	390	390	1.0000000
C2	25106367	25107011	BolC2t09053H	0	+	496	644	644	1.0000000
C2	25111609	25111720	BolC2t09054H	0	-	531	111	111	1.0000000
C2	25112852	25113236	BolC2t09055H	0	-	454	384	384	1.0000000
C2	25115190	25115592	BolC2t09056H	0	+	102	402	402	1.0000000
C2	25135346	25135847	BolC2t09057H	0	+	41	349	501	0.6966068
C2	25195448	25199103	BolC2t09058H	0	+	292	1280	3655	0.3502052
C2	25201406	25203361	BolC2t09059H	0	-	143	958	1955	0.4900256
C2	25221394	25222933	BolC2t09060H	0	-	1044	1539	1539	1.0000000
C2	25252359	25255643	BolC2t09061H	0	+	86	1612	3284	0.4908648
C2	25262350	25262977	BolC2t09062H	0	-	79	608	627	0.9696970
C2	25272117	25272477	BolC2t09063H	0	+	10	127	360	0.3527778
C2	25279200	25279840	BolC2t09064H	0	-	2	28	640	0.0437500
C2	25281217	25282322	BolC2t09065H	0	+	13	45	1105	0.0407240
C2	25283242	25283392	BolC2t09066H	0	+	28	150	150	1.0000000
C2	25289725	25289981	BolC2t09067H	0	-	230	256	256	1.0000000
C2	25317800	25322070	BolC2t09068H	0	+	836	3830	4270	0.8969555
C2	25341246	25345115	BolC2t09069H	0	+	2122	3806	3869	0.9837167
C2	25345916	25346294	BolC2t09070H	0	-	6	134	378	0.3544973
C2	25346961	25349136	BolC2t09071H	0	-	679	1730	2175	0.7954023
C2	25360031	25360256	BolC2t09072H	0	-	1	55	225	0.2444444
C2	25366281	25366596	BolC2t09073H	0	-	150	315	315	1.0000000
C2	25367254	25368186	BolC2t09074H	0	+	348	932	932	1.0000000
C2	25368688	25372422	BolC2t09075H	0	-	656	2557	3734	0.6847884
C2	25373185	25373332	BolC2t09076H	0	+	81	147	147	1.0000000
C2	25374301	25374439	BolC2t09077H	0	+	128	138	138	1.0000000
C2	25404039	25404546	BolC2t09078H	0	-	2	19	507	0.0374753
C2	25405358	25406215	BolC2t09079H	0	-	0	0	857	0.0000000
C2	25407381	25407612	BolC2t09080H	0	-	122	231	231	1.0000000
C2	25420601	25420931	BolC2t09081H	0	+	131	309	330	0.9363636
C2	25421236	25423161	BolC2t09082H	0	-	255	1716	1925	0.8914286
C2	25426675	25426804	BolC2t09083H	0	+	103	129	129	1.0000000
C2	25430625	25431911	BolC2t09084H	0	-	181	777	1286	0.6041991
C2	25436648	25441891	BolC2t09085H	0	-	2256	3961	5243	0.7554835
C2	25443430	25443667	BolC2t09086H	0	-	271	237	237	1.0000000
C2	25449351	25453263	BolC2t09087H	0	+	1520	3489	3912	0.8918712
C2	25454865	25455021	BolC2t09088H	0	-	0	0	156	0.0000000
C2	25455185	25455899	BolC2t09089H	0	+	382	714	714	1.0000000
C2	25460713	25461280	BolC2t09090H	0	+	265	564	567	0.9947090
C2	25461883	25463915	BolC2t09091H	0	-	1154	2032	2032	1.0000000
C2	25467685	25468550	BolC2t09092H	0	-	74	830	865	0.9595376
C2	25474816	25477645	BolC2t09093H	0	+	1613	2704	2829	0.9558148
C2	25478868	25481725	BolC2t09094H	0	+	982	2569	2857	0.8991950
C2	25482294	25482762	BolC2t09095H	0	-	282	468	468	1.0000000
C2	25505790	25506408	BolC2t09096H	0	+	63	308	618	0.4983819
C2	25519360	25520635	BolC2t09097H	0	-	132	908	1275	0.7121569
C2	25525228	25527246	BolC2t09098H	0	-	22	564	2018	0.2794846
C2	25542212	25542613	BolC2t09099H	0	-	72	322	401	0.8029925
C2	25548527	25549376	BolC2t09100H	0	+	459	716	849	0.8433451
C2	25549648	25550257	BolC2t09101H	0	-	185	229	609	0.3760263
C2	25552187	25552336	BolC2t09102H	0	-	167	149	149	1.0000000
C2	25554079	25560838	BolC2t09103H	0	+	4003	6498	6759	0.9613848
C2	25556982	25557312	BolC2t09104H	0	-	274	330	330	1.0000000
C2	25560941	25561412	BolC2t09105H	0	-	379	471	471	1.0000000
C2	25564793	25565513	BolC2t09106H	0	+	815	720	720	1.0000000
C2	25566169	25567486	BolC2t09107H	0	-	899	1317	1317	1.0000000
C2	25569542	25569647	BolC2t09108H	0	-	158	105	105	1.0000000
C2	25571356	25572539	BolC2t09109H	0	+	417	1183	1183	1.0000000
C2	25572739	25574577	BolC2t09110H	0	-	664	1795	1838	0.9766050
C2	25575341	25576410	BolC2t09111H	0	-	1022	1069	1069	1.0000000
C2	25576977	25577589	BolC2t09112H	0	+	464	612	612	1.0000000
C2	25578930	25579539	BolC2t09113H	0	-	602	609	609	1.0000000
C2	25579705	25579837	BolC2t09114H	0	-	372	132	132	1.0000000
C2	25602593	25603979	BolC2t09115H	0	+	28	759	1386	0.5476190
C2	25604229	25606359	BolC2t09116H	0	-	57	285	2130	0.1338028
C2	25620747	25621395	BolC2t09117H	0	-	497	648	648	1.0000000
C2	25622055	25622330	BolC2t09118H	0	-	0	0	275	0.0000000
C2	25626253	25626886	BolC2t09119H	0	-	535	633	633	1.0000000
C2	25639511	25640197	BolC2t09120H	0	+	49	522	686	0.7609329
C2	25670921	25671470	BolC2t09121H	0	+	26	371	549	0.6757742
C2	25675536	25676268	BolC2t09122H	0	-	321	650	732	0.8879781
C2	25716302	25716838	BolC2t09123H	0	-	0	0	536	0.0000000
C2	25739428	25739665	BolC2t09124H	0	-	6	146	237	0.6160337
C2	25771595	25774627	BolC2t09125H	0	-	863	2916	3032	0.9617414
C2	25775439	25776889	BolC2t09126H	0	+	1127	1450	1450	1.0000000
C2	25777259	25778208	BolC2t09127H	0	+	243	891	949	0.9388830
C2	25778446	25781371	BolC2t09128H	0	-	1095	2801	2925	0.9576069
C2	25782923	25784784	BolC2t09129H	0	-	1168	1766	1861	0.9489522
C2	25792022	25792708	BolC2t09130H	0	-	15	384	686	0.5597668
C2	25792720	25794166	BolC2t09131H	0	-	3715	1314	1446	0.9087137
C2	25843981	25845799	BolC2t09132H	0	+	278	883	1818	0.4856986
C2	25849185	25849809	BolC2t09133H	0	+	117	600	624	0.9615384
C2	25863033	25863657	BolC2t09134H	0	+	258	624	624	1.0000000
C2	25875777	25877730	BolC2t09135H	0	+	531	1588	1953	0.8131080
C2	25884707	25886627	BolC2t09136H	0	+	195	1524	1920	0.7937500
C2	25887560	25888602	BolC2t09137H	0	-	260	1042	1042	1.0000000
C2	25889313	25890910	BolC2t09138H	0	+	67	1109	1597	0.6944271
C2	25891413	25892037	BolC2t09139H	0	-	53	230	624	0.3685897
C2	25901858	25902098	BolC2t09140H	0	+	0	0	240	0.0000000
C2	25905536	25906114	BolC2t09141H	0	-	87	564	578	0.9757785
C2	25916145	25917145	BolC2t09142H	0	-	343	672	1000	0.6720000
C2	25936432	25937128	BolC2t09143H	0	-	459	696	696	1.0000000
C2	25939098	25939447	BolC2t09144H	0	+	0	0	349	0.0000000
C2	25948824	25949589	BolC2t09145H	0	-	36	310	765	0.4052288
C2	25954149	25954803	BolC2t09146H	0	-	220	654	654	1.0000000
C2	25958383	25958983	BolC2t09147H	0	-	269	600	600	1.0000000
C2	25967067	25967705	BolC2t09148H	0	-	362	638	638	1.0000000
C2	25972263	25973352	BolC2t09149H	0	-	69	625	1089	0.5739210
C2	25997512	25998888	BolC2t09150H	0	+	272	1023	1376	0.7434593
C2	26013459	26014595	BolC2t09151H	0	+	461	1136	1136	1.0000000
C2	26017212	26017740	BolC2t09152H	0	-	170	528	528	1.0000000
C2	26018651	26025904	BolC2t09153H	0	+	5855	7253	7253	1.0000000
C2	26039326	26039710	BolC2t09154H	0	+	195	384	384	1.0000000
C2	26040586	26042826	BolC2t09155H	0	+	886	2173	2240	0.9700893
C2	26044526	26044877	BolC2t09156H	0	-	342	351	351	1.0000000
C2	26054995	26055916	BolC2t09157H	0	-	239	849	921	0.9218241
C2	26060114	26060709	BolC2t09158H	0	+	470	223	595	0.3747899
C2	26071751	26072280	BolC2t09159H	0	-	137	326	529	0.6162571
C2	26073761	26074440	BolC2t09160H	0	-	64	638	679	0.9396171
C2	26075338	26075896	BolC2t09161H	0	-	101	301	558	0.5394265
C2	26077315	26077774	BolC2t09162H	0	+	351	459	459	1.0000000
C2	26078031	26079750	BolC2t09163H	0	+	1383	1666	1719	0.9691681
C2	26081097	26081898	BolC2t09164H	0	+	48	486	801	0.6067415
C2	26088954	26091811	BolC2t09165H	0	+	1064	2090	2857	0.7315366
C2	26122154	26123967	BolC2t09166H	0	-	1332	1813	1813	1.0000000
C2	26127198	26127849	BolC2t09167H	0	-	63	615	651	0.9447005
C2	26127928	26130051	BolC2t09168H	0	-	270	1638	2123	0.7715497
C2	26195485	26196611	BolC2t09169H	0	-	189	1024	1126	0.9094139
C2	26196804	26197962	BolC2t09170H	0	+	457	866	1158	0.7478411
C2	26214007	26218806	BolC2t09171H	0	-	359	1495	4799	0.3115232
C2	26234579	26237384	BolC2t09172H	0	+	1264	2607	2805	0.9294118
C2	26237734	26238844	BolC2t09173H	0	-	646	961	1110	0.8657658
C2	26246309	26247077	BolC2t09174H	0	+	575	768	768	1.0000000
C2	26247700	26247997	BolC2t09175H	0	+	41	180	297	0.6060606
C2	26265556	26266765	BolC2t09176H	0	+	173	1017	1209	0.8411911
C2	26294073	26294449	BolC2t09177H	0	-	476	376	376	1.0000000
C2	26296231	26297162	BolC2t09178H	0	+	64	631	931	0.6777658
C2	26297351	26301530	BolC2t09179H	0	-	376	2428	4179	0.5810003
C2	26302496	26304551	BolC2t09180H	0	-	353	1491	2055	0.7255474
C2	26305582	26316632	BolC2t09181H	0	-	2748	7076	11050	0.6403620
C2	26325096	26326201	BolC2t09182H	0	-	947	1105	1105	1.0000000
C2	26341775	26343132	BolC2t09183H	0	+	471	1031	1357	0.7597642
C2	26344013	26346559	BolC2t09184H	0	-	356	1735	2546	0.6814611
C2	26346846	26347038	BolC2t09185H	0	+	14	101	192	0.5260417
C2	26351974	26361736	BolC2t09186H	0	-	4597	6894	9762	0.7062078
C2	26364384	26365763	BolC2t09187H	0	-	588	1379	1379	1.0000000
C2	26372340	26373445	BolC2t09188H	0	-	428	1105	1105	1.0000000
C2	26378758	26380289	BolC2t09189H	0	+	952	1531	1531	1.0000000
C2	26393512	26394526	BolC2t09190H	0	-	102	1002	1014	0.9881657
C2	26398507	26398753	BolC2t09191H	0	-	1	85	246	0.3455285
C2	26401552	26402086	BolC2t09192H	0	+	50	492	534	0.9213483
C2	26412921	26413224	BolC2t09193H	0	-	9	175	303	0.5775577
C2	26432343	26432727	BolC2t09194H	0	-	210	384	384	1.0000000
C2	26444693	26446797	BolC2t09195H	0	+	508	1841	2104	0.8750000
C2	26448805	26450021	BolC2t09196H	0	+	660	1216	1216	1.0000000
C2	26453323	26456960	BolC2t09197H	0	+	754	3022	3637	0.8309046
C2	26458309	26513830	BolC2t09198H	0	-	33431	50206	55521	0.9042705
C2	26473115	26473469	BolC2t09199H	0	+	3337	354	354	1.0000000
C2	26501111	26501600	BolC2t09200H	0	-	284	489	489	1.0000000
C2	26513903	26515356	BolC2t09201H	0	-	939	1453	1453	1.0000000
C2	26516856	26519952	BolC2t09202H	0	-	1636	2958	3096	0.9554263
C2	26520279	26520702	BolC2t09203H	0	-	354	423	423	1.0000000
C2	26522126	26529205	BolC2t09204H	0	-	3166	6753	7079	0.9539483
C2	26530455	26531403	BolC2t09205H	0	-	356	948	948	1.0000000
C2	26532334	26533657	BolC2t09206H	0	+	867	1323	1323	1.0000000
C2	26535040	26536616	BolC2t09207H	0	+	1095	1576	1576	1.0000000
C2	26536843	26538854	BolC2t09208H	0	+	994	1914	2011	0.9517653
C2	26543568	26543992	BolC2t09209H	0	-	202	424	424	1.0000000
C2	26544582	26545461	BolC2t09210H	0	-	566	879	879	1.0000000
C2	26549694	26551278	BolC2t09211H	0	-	163	812	1584	0.5126263
C2	26556045	26556419	BolC2t09212H	0	-	64	374	374	1.0000000
C2	26556486	26558134	BolC2t09213H	0	-	152	296	1648	0.1796117
C2	26559563	26560037	BolC2t09214H	0	+	223	474	474	1.0000000
C2	26560135	26560684	BolC2t09215H	0	+	42	484	549	0.8816029
C2	26564289	26565103	BolC2t09216H	0	-	115	803	814	0.9864865
C2	26588575	26588740	BolC2t09217H	0	-	7	153	165	0.9272727
C2	26609661	26611033	BolC2t09218H	0	+	19	408	1372	0.2973761
C2	26625880	26631999	BolC2t09219H	0	+	3460	4226	6119	0.6906357
C2	26634155	26634648	BolC2t09220H	0	+	0	0	493	0.0000000
C2	26640645	26642205	BolC2t09221H	0	-	25	444	1560	0.2846154
C2	26647348	26649160	BolC2t09222H	0	+	200	1473	1812	0.8129139
C2	26649287	26650083	BolC2t09223H	0	-	140	778	796	0.9773870
C2	26663794	26664148	BolC2t09224H	0	-	158	354	354	1.0000000
C2	26671795	26674135	BolC2t09225H	0	-	19	570	2340	0.2435897
C2	26674217	26674448	BolC2t09226H	0	-	64	231	231	1.0000000
C2	26675162	26675937	BolC2t09227H	0	-	0	0	775	0.0000000
C2	26693370	26699696	BolC2t09228H	0	-	549	4121	6326	0.6514385
C2	26730530	26731571	BolC2t09229H	0	-	828	1041	1041	1.0000000
C2	26732392	26733314	BolC2t09230H	0	+	908	922	922	1.0000000
C2	26733574	26734345	BolC2t09231H	0	-	221	637	771	0.8261998
C2	26734844	26736779	BolC2t09232H	0	-	819	1904	1935	0.9839793
C2	26737968	26738079	BolC2t09233H	0	+	58	111	111	1.0000000
C2	26754944	26757515	BolC2t09234H	0	-	488	1826	2571	0.7102295
C2	26758015	26760634	BolC2t09235H	0	-	42	1397	2619	0.5334097
C2	26762274	26764949	BolC2t09236H	0	+	2320	2675	2675	1.0000000
C2	26765747	26773119	BolC2t09237H	0	+	4372	7359	7372	0.9982366
C2	26817074	26820090	BolC2t09238H	0	+	185	1835	3016	0.6084217
C2	26834558	26834805	BolC2t09239H	0	+	12	152	247	0.6153846
C2	26850160	26850680	BolC2t09240H	0	+	7	123	520	0.2365385
C2	26851493	26853721	BolC2t09241H	0	-	773	2021	2228	0.9070916
C2	26855256	26856692	BolC2t09242H	0	+	222	1187	1436	0.8266017
C2	26864760	26869003	BolC2t09243H	0	+	1806	3995	4243	0.9415508
C2	26875739	26876600	BolC2t09244H	0	+	375	533	861	0.6190476
C2	26890078	26893985	BolC2t09245H	0	+	167	1403	3907	0.3590991
C2	26899525	26901812	BolC2t09246H	0	-	273	1962	2287	0.8578925
C2	26915738	26916672	BolC2t09247H	0	-	49	869	934	0.9304069
C2	26917673	26918545	BolC2t09248H	0	-	170	872	872	1.0000000
C2	26922355	26922532	BolC2t09249H	0	+	11	177	177	1.0000000
C2	26922744	26924401	BolC2t09250H	0	+	99	751	1657	0.4532287
C2	26926072	26926882	BolC2t09251H	0	+	876	810	810	1.0000000
C2	26927591	26930365	BolC2t09252H	0	-	1956	2728	2774	0.9834175
C2	26930683	26930980	BolC2t09253H	0	-	205	297	297	1.0000000
C2	26939716	26940903	BolC2t09254H	0	-	635	1187	1187	1.0000000
C2	26962398	26965071	BolC2t09255H	0	-	552	2211	2673	0.8271605
C2	26966189	26969609	BolC2t09256H	0	-	659	2458	3420	0.7187135
C2	26971059	26973290	BolC2t09257H	0	+	421	1953	2231	0.8753922
C2	26974254	26975087	BolC2t09258H	0	+	277	810	833	0.9723890
C2	26978967	26980773	BolC2t09259H	0	-	391	1384	1806	0.7663344
C2	26996970	26997669	BolC2t09260H	0	+	775	699	699	1.0000000
C2	26998261	26998733	BolC2t09261H	0	-	591	472	472	1.0000000
C2	27000080	27002388	BolC2t09262H	0	+	5	101	2308	0.0437608
C2	27010229	27011202	BolC2t09263H	0	-	955	973	973	1.0000000
C2	27013281	27013662	BolC2t09264H	0	+	134	381	381	1.0000000
C2	27016824	27016977	BolC2t09265H	0	+	53	153	153	1.0000000
C2	27019045	27021882	BolC2t09266H	0	-	1355	2491	2837	0.8780402
C2	27028051	27028480	BolC2t09267H	0	+	228	429	429	1.0000000
C2	27051743	27052292	BolC2t09268H	0	-	314	549	549	1.0000000
C2	27069894	27070530	BolC2t09269H	0	+	288	636	636	1.0000000
C2	27076106	27076322	BolC2t09270H	0	-	0	0	216	0.0000000
C2	27077253	27077670	BolC2t09271H	0	-	6	19	417	0.0455635
C2	27079759	27082039	BolC2t09272H	0	-	335	1429	2280	0.6267544
C2	27089056	27089938	BolC2t09273H	0	+	366	814	882	0.9229025
C2	27103483	27103765	BolC2t09274H	0	-	84	282	282	1.0000000
C2	27106428	27106909	BolC2t09275H	0	+	479	481	481	1.0000000
C2	27109382	27110475	BolC2t09276H	0	+	269	1086	1093	0.9935956
C2	27112800	27114248	BolC2t09277H	0	+	322	714	1448	0.4930939
C2	27114537	27115254	BolC2t09278H	0	-	81	471	717	0.6569037
C2	27116500	27125454	BolC2t09279H	0	+	1289	3592	8954	0.4011615
C2	27125562	27127268	BolC2t09280H	0	-	855	1698	1706	0.9953107
C2	27137177	27137951	BolC2t09281H	0	+	138	589	774	0.7609819
C2	27163860	27165507	BolC2t09282H	0	-	536	1536	1647	0.9326047
C2	27172472	27175102	BolC2t09283H	0	-	0	0	2630	0.0000000
C2	27182089	27183501	BolC2t09284H	0	+	102	597	1412	0.4228045
C2	27253693	27254191	BolC2t09285H	0	+	91	498	498	1.0000000
C2	27265304	27266689	BolC2t09286H	0	+	1125	1385	1385	1.0000000
C2	27266946	27268561	BolC2t09287H	0	-	103	1494	1615	0.9250774
C2	27273688	27273898	BolC2t09288H	0	+	1	76	210	0.3619048
C2	27292082	27292519	BolC2t09289H	0	+	231	437	437	1.0000000
C2	27292552	27294555	BolC2t09290H	0	+	204	1524	2003	0.7608587
C2	27294663	27298228	BolC2t09291H	0	+	704	3010	3565	0.8443198
C2	27299449	27301530	BolC2t09292H	0	+	378	995	2081	0.4781355
C2	27302124	27302679	BolC2t09293H	0	+	25	114	555	0.2054054
C2	27302809	27303331	BolC2t09294H	0	+	17	233	522	0.4463601
C2	27303357	27303702	BolC2t09295H	0	+	25	311	345	0.9014493
C2	27320345	27320716	BolC2t09296H	0	+	9	96	371	0.2587601
C2	27321810	27329047	BolC2t09297H	0	+	99	1280	7237	0.1768689
C2	27382046	27382250	BolC2t09298H	0	+	69	204	204	1.0000000
C2	27386241	27387283	BolC2t09299H	0	-	104	544	1042	0.5220729
C2	27390352	27391726	BolC2t09300H	0	-	64	806	1374	0.5866085
C2	27398198	27398630	BolC2t09301H	0	+	11	263	432	0.6087963
C2	27419408	27419900	BolC2t09302H	0	+	548	492	492	1.0000000
C2	27449414	27450668	BolC2t09303H	0	+	597	1219	1254	0.9720893
C2	27464588	27465164	BolC2t09304H	0	-	226	559	576	0.9704861
C2	27486421	27486745	BolC2t09305H	0	-	213	324	324	1.0000000
C2	27486901	27488008	BolC2t09306H	0	-	674	1107	1107	1.0000000
C2	27488107	27488437	BolC2t09307H	0	-	253	330	330	1.0000000
C2	27488935	27489262	BolC2t09308H	0	+	1	29	327	0.0886850
C2	27501440	27503670	BolC2t09309H	0	+	867	2230	2230	1.0000000
C2	27502682	27502946	BolC2t09310H	0	+	124	264	264	1.0000000
C2	27536280	27536451	BolC2t09311H	0	+	0	0	171	0.0000000
C2	27540332	27540791	BolC2t09312H	0	-	0	0	459	0.0000000
C2	27600843	27601029	BolC2t09313H	0	+	0	0	186	0.0000000
C2	27605103	27605382	BolC2t09314H	0	-	15	153	279	0.5483871
C2	27682568	27682730	BolC2t09315H	0	+	168	162	162	1.0000000
C2	27685858	27686485	BolC2t09316H	0	-	144	627	627	1.0000000
C2	27686895	27687698	BolC2t09317H	0	+	495	803	803	1.0000000
C2	27689458	27691123	BolC2t09318H	0	-	608	1127	1665	0.6768769
C2	27727887	27729591	BolC2t09319H	0	-	878	1704	1704	1.0000000
C2	27746702	27747053	BolC2t09320H	0	-	151	351	351	1.0000000
C2	27748886	27749244	BolC2t09321H	0	-	786	358	358	1.0000000
C2	27757344	27762806	BolC2t09322H	0	+	2479	5342	5462	0.9780300
C2	27763284	27764452	BolC2t09323H	0	-	353	1140	1168	0.9760274
C2	27765358	27768399	BolC2t09324H	0	-	1118	2557	3041	0.8408418
C2	27777121	27778100	BolC2t09325H	0	+	339	979	979	1.0000000
C2	27778496	27779162	BolC2t09326H	0	-	372	666	666	1.0000000
C2	27789448	27791852	BolC2t09327H	0	-	478	1452	2404	0.6039934
C2	27793957	27795275	BolC2t09328H	0	+	1141	1318	1318	1.0000000
C2	27799757	27803045	BolC2t09329H	0	+	958	2476	3288	0.7530414
C2	27804354	27805854	BolC2t09330H	0	-	839	1480	1500	0.9866667
C2	27807322	27810107	BolC2t09331H	0	-	785	2642	2785	0.9486535
C2	27832584	27842131	BolC2t09332H	0	-	1254	6363	9547	0.6664921
C2	27852117	27853611	BolC2t09333H	0	-	46	158	1494	0.1057564
C2	27861670	27861994	BolC2t09334H	0	+	0	0	324	0.0000000
C2	27866824	27869009	BolC2t09335H	0	+	425	1918	2185	0.8778032
C2	27888279	27893846	BolC2t09336H	0	-	1060	4661	5567	0.8372552
C2	27902348	27904311	BolC2t09337H	0	+	336	1894	1963	0.9648497
C2	27905822	27906200	BolC2t09338H	0	+	48	305	378	0.8068783
C2	27908386	27908721	BolC2t09339H	0	+	82	325	335	0.9701493
C2	27911765	27912100	BolC2t09340H	0	+	101	305	335	0.9104478
C2	27924562	27924914	BolC2t09341H	0	+	221	352	352	1.0000000
C2	27926277	27927679	BolC2t09342H	0	+	911	1402	1402	1.0000000
C2	27955452	27955596	BolC2t09343H	0	+	0	0	144	0.0000000
C2	27972696	27973947	BolC2t09344H	0	+	256	1246	1251	0.9960032
C2	27974421	27980354	BolC2t09345H	0	-	904	3931	5933	0.6625653
C2	27984029	27984610	BolC2t09346H	0	+	23	222	581	0.3820998
C2	27985693	27987435	BolC2t09347H	0	+	34	335	1742	0.1923077
C2	27997241	27998846	BolC2t09348H	0	+	6	287	1605	0.1788162
C2	28007784	28010781	BolC2t09349H	0	+	22	268	2997	0.0894228
C2	28013489	28014094	BolC2t09350H	0	+	67	598	605	0.9884297
C2	28028288	28028555	BolC2t09351H	0	-	61	267	267	1.0000000
C2	28032774	28034421	BolC2t09352H	0	+	185	1592	1647	0.9666060
C2	28037296	28038231	BolC2t09353H	0	-	427	935	935	1.0000000
C2	28039274	28051177	BolC2t09354H	0	-	1735	7621	11903	0.6402587
C2	28053421	28053902	BolC2t09355H	0	-	103	462	481	0.9604990
C2	28057559	28058351	BolC2t09356H	0	+	70	564	792	0.7121212
C2	28061075	28061851	BolC2t09357H	0	-	579	776	776	1.0000000
C2	28080895	28081363	BolC2t09358H	0	-	184	468	468	1.0000000
C2	28086487	28087222	BolC2t09359H	0	+	209	735	735	1.0000000
C2	28087270	28088540	BolC2t09360H	0	+	92	1187	1270	0.9346457
C2	28105539	28109044	BolC2t09361H	0	+	1337	3295	3505	0.9400856
C2	28111282	28112893	BolC2t09362H	0	-	3	103	1611	0.0639354
C2	28115653	28120829	BolC2t09363H	0	-	2229	4963	5176	0.9588485
C2	28130532	28131257	BolC2t09364H	0	-	40	380	725	0.5241379
C2	28136797	28137175	BolC2t09365H	0	-	0	0	378	0.0000000
C2	28141367	28141781	BolC2t09366H	0	+	145	401	414	0.9685990
C2	28142677	28142998	BolC2t09367H	0	+	456	321	321	1.0000000
C2	28143676	28143781	BolC2t09368H	0	+	249	105	105	1.0000000
C2	28147444	28149392	BolC2t09369H	0	+	1351	1948	1948	1.0000000
C2	28149932	28150887	BolC2t09370H	0	-	200	462	955	0.4837696
C2	28154193	28156702	BolC2t09371H	0	-	1316	2509	2509	1.0000000
C2	28186019	28186343	BolC2t09372H	0	+	0	0	324	0.0000000
C2	28197939	28199577	BolC2t09373H	0	+	46	633	1638	0.3864469
C2	28200296	28200581	BolC2t09374H	0	-	0	0	285	0.0000000
C2	28212805	28212979	BolC2t09375H	0	+	29	174	174	1.0000000
C2	28214558	28214720	BolC2t09376H	0	+	28	162	162	1.0000000
C2	28215096	28215546	BolC2t09377H	0	+	155	450	450	1.0000000
C2	28218482	28218929	BolC2t09378H	0	-	57	315	447	0.7046980
C2	28220000	28220590	BolC2t09379H	0	-	534	590	590	1.0000000
C2	28225251	28225512	BolC2t09380H	0	+	486	261	261	1.0000000
C2	28225857	28228071	BolC2t09381H	0	-	1690	1745	2214	0.7881662
C2	28236020	28237564	BolC2t09382H	0	+	1484	1544	1544	1.0000000
C2	28238322	28238604	BolC2t09383H	0	+	0	0	282	0.0000000
C2	28241588	28248456	BolC2t09384H	0	-	454	3552	6868	0.5171812
C2	28249559	28250853	BolC2t09385H	0	+	3	53	1294	0.0409583
C2	28251362	28252966	BolC2t09386H	0	-	10	298	1604	0.1857855
C2	28254936	28255478	BolC2t09387H	0	-	2	79	542	0.1457565
C2	28262770	28263857	BolC2t09388H	0	-	64	497	1087	0.4572217
C2	28269147	28269884	BolC2t09389H	0	+	227	670	737	0.9090909
C2	28304360	28307567	BolC2t09390H	0	-	86	1113	3207	0.3470533
C2	28344237	28344804	BolC2t09391H	0	+	85	503	567	0.8871252
C2	28347886	28352720	BolC2t09392H	0	-	529	3113	4834	0.6439801
C2	28371434	28374072	BolC2t09393H	0	-	212	1759	2638	0.6667930
C2	28392520	28392646	BolC2t09394H	0	+	111	120	126	0.9523810
C2	28394793	28395039	BolC2t09395H	0	+	156	246	246	1.0000000
C2	28401802	28402302	BolC2t09396H	0	-	462	437	500	0.8740000
C2	28403819	28406642	BolC2t09397H	0	+	467	1810	2823	0.6411619
C2	28413288	28413489	BolC2t09398H	0	+	235	201	201	1.0000000
C2	28417639	28418491	BolC2t09399H	0	+	1	128	852	0.1502347
C2	28423933	28424705	BolC2t09400H	0	-	133	726	772	0.9404145
C2	28429258	28434012	BolC2t09401H	0	+	568	3679	4754	0.7738746
C2	28434624	28435268	BolC2t09402H	0	+	999	644	644	1.0000000
C2	28436270	28436633	BolC2t09403H	0	-	265	363	363	1.0000000
C2	28439840	28440327	BolC2t09404H	0	-	97	444	487	0.9117043
C2	28465236	28465599	BolC2t09405H	0	+	86	363	363	1.0000000
C2	28467936	28468581	BolC2t09406H	0	-	320	392	645	0.6077520
C2	28472171	28473448	BolC2t09407H	0	-	215	1144	1277	0.8958496
C2	28475281	28475624	BolC2t09408H	0	-	2	47	343	0.1370262
C2	28480986	28482998	BolC2t09409H	0	+	125	1180	2012	0.5864811
C2	28484097	28485786	BolC2t09410H	0	+	333	1247	1689	0.7383067
C2	28492377	28496249	BolC2t09411H	0	+	1238	3720	3872	0.9607438
C2	28509370	28510012	BolC2t09412H	0	+	79	586	642	0.9127726
C2	28519065	28519576	BolC2t09413H	0	-	63	509	511	0.9960861
C2	28521150	28521546	BolC2t09414H	0	-	248	396	396	1.0000000
C2	28561785	28563310	BolC2t09415H	0	-	491	1517	1525	0.9947541
C2	28579963	28581452	BolC2t09416H	0	+	199	1344	1489	0.9026192
C2	28583488	28583806	BolC2t09417H	0	+	207	318	318	1.0000000
C2	28584047	28585403	BolC2t09418H	0	+	125	1034	1356	0.7625369
C2	28585928	28586396	BolC2t09419H	0	+	78	427	468	0.9123932
C2	28587531	28600309	BolC2t09420H	0	+	6251	11043	12778	0.8642197
C2	28603589	28604757	BolC2t09421H	0	+	612	1168	1168	1.0000000
C2	28611640	28612225	BolC2t09422H	0	+	134	427	585	0.7299145
C2	28614485	28614793	BolC2t09423H	0	+	616	308	308	1.0000000
C2	28615617	28616485	BolC2t09424H	0	-	991	868	868	1.0000000
C2	28618468	28619207	BolC2t09425H	0	+	330	739	739	1.0000000
C2	28620811	28625648	BolC2t09426H	0	-	539	3270	4837	0.6760389
C2	28635593	28640467	BolC2t09427H	0	+	1865	4360	4874	0.8945425
C2	28640775	28641552	BolC2t09428H	0	-	231	740	777	0.9523810
C2	28680892	28681069	BolC2t09429H	0	-	87	177	177	1.0000000
C2	28681432	28681975	BolC2t09430H	0	+	91	480	543	0.8839779
C2	28694175	28695014	BolC2t09431H	0	-	182	839	839	1.0000000
C2	28695230	28696059	BolC2t09432H	0	-	38	730	829	0.8805790
C2	28698931	28699285	BolC2t09433H	0	+	25	307	354	0.8672317
C2	28706310	28707303	BolC2t09434H	0	+	17	388	993	0.3907351
C2	28711685	28713526	BolC2t09435H	0	+	418	1717	1841	0.9326453
C2	28732229	28734251	BolC2t09436H	0	-	3404	2022	2022	1.0000000
C2	28754021	28755257	BolC2t09437H	0	+	37	366	1236	0.2961165
C2	28770752	28771169	BolC2t09438H	0	-	307	417	417	1.0000000
C2	28774672	28778495	BolC2t09439H	0	+	677	3086	3823	0.8072194
C2	28790003	28790291	BolC2t09440H	0	+	28	273	288	0.9479167
C2	28795417	28797126	BolC2t09441H	0	+	271	1053	1709	0.6161498
C2	28821288	28823011	BolC2t09442H	0	-	815	1619	1723	0.9396402
C2	28853807	28853969	BolC2t09443H	0	+	183	162	162	1.0000000
C2	28900386	28901349	BolC2t09444H	0	-	553	963	963	1.0000000
C2	28903705	28903943	BolC2t09445H	0	-	189	238	238	1.0000000
C2	28905025	28905236	BolC2t09446H	0	-	251	211	211	1.0000000
C2	28905345	28905729	BolC2t09447H	0	-	324	384	384	1.0000000
C2	28923560	28923947	BolC2t09448H	0	-	166	386	387	0.9974160
C2	28948559	28950794	BolC2t09449H	0	-	1222	2084	2235	0.9324385
C2	29007398	29007772	BolC2t09450H	0	+	0	0	374	0.0000000
C2	29009826	29009985	BolC2t09451H	0	-	0	0	159	0.0000000
C2	29013288	29014779	BolC2t09452H	0	+	10	349	1491	0.2340711
C2	29016794	29018062	BolC2t09453H	0	-	139	625	1268	0.4929022
C2	29046933	29048252	BolC2t09454H	0	+	0	0	1319	0.0000000
C2	29052786	29053179	BolC2t09455H	0	+	2	90	393	0.2290076
C2	29053557	29053725	BolC2t09456H	0	+	0	0	168	0.0000000
C2	29053813	29054041	BolC2t09457H	0	+	0	0	228	0.0000000
C2	29086278	29086652	BolC2t09458H	0	+	182	374	374	1.0000000
C2	29087684	29089503	BolC2t09459H	0	-	0	0	1819	0.0000000
C2	29092942	29093101	BolC2t09460H	0	+	0	0	159	0.0000000
C2	29138063	29138456	BolC2t09461H	0	+	0	0	393	0.0000000
C2	29139092	29139320	BolC2t09462H	0	+	3	48	228	0.2105263
C2	29140529	29140983	BolC2t09463H	0	-	0	0	454	0.0000000
C2	29141209	29142279	BolC2t09464H	0	-	598	1070	1070	1.0000000
C2	29163404	29165325	BolC2t09465H	0	+	48	817	1921	0.4252993
C2	29183418	29184842	BolC2t09466H	0	-	970	1424	1424	1.0000000
C2	29186490	29186928	BolC2t09467H	0	-	60	438	438	1.0000000
C2	29187627	29188900	BolC2t09468H	0	-	932	1273	1273	1.0000000
C2	29199881	29201896	BolC2t09469H	0	+	1017	1472	2015	0.7305211
C2	29202552	29204502	BolC2t09470H	0	-	449	1321	1950	0.6774359
C2	29215173	29217145	BolC2t09471H	0	+	362	1228	1972	0.6227180
C2	29217523	29222327	BolC2t09472H	0	-	722	3932	4804	0.8184846
C2	29237087	29241520	BolC2t09473H	0	-	88	1790	4433	0.4037898
C2	29253864	29254350	BolC2t09474H	0	+	74	486	486	1.0000000
C2	29267814	29268658	BolC2t09475H	0	+	2	20	844	0.0236967
C2	29377422	29378077	BolC2t09476H	0	+	237	655	655	1.0000000
C2	29386630	29391061	BolC2t09477H	0	+	1343	3977	4431	0.8975400
C2	29407763	29408307	BolC2t09478H	0	+	350	525	544	0.9650735
C2	29408889	29410099	BolC2t09479H	0	-	145	1158	1210	0.9570248
C2	29416667	29418131	BolC2t09480H	0	-	141	986	1464	0.6734973
C2	29419369	29421920	BolC2t09481H	0	+	283	1345	2551	0.5272442
C2	29422632	29425551	BolC2t09482H	0	-	581	1191	2919	0.4080164
C2	29428326	29430302	BolC2t09483H	0	+	820	1471	1976	0.7444332
C2	29433070	29435041	BolC2t09484H	0	+	750	1845	1971	0.9360731
C2	29436309	29437240	BolC2t09485H	0	+	390	894	931	0.9602578
C2	29438968	29440859	BolC2t09486H	0	-	374	1497	1891	0.7916446
C2	29442649	29443494	BolC2t09487H	0	-	1310	845	845	1.0000000
C2	29445166	29447949	BolC2t09488H	0	+	1129	1871	2783	0.6722961
C2	29453757	29455392	BolC2t09489H	0	+	2085	1635	1635	1.0000000
C2	29490535	29491105	BolC2t09490H	0	+	59	470	570	0.8245614
C2	29492083	29492494	BolC2t09491H	0	-	58	411	411	1.0000000
C2	29492979	29493638	BolC2t09492H	0	-	96	653	659	0.9908953
C2	29493786	29495495	BolC2t09493H	0	-	361	1661	1709	0.9719134
C2	29539652	29541472	BolC2t09494H	0	+	516	1820	1820	1.0000000
C2	29542599	29543042	BolC2t09495H	0	+	313	443	443	1.0000000
C2	29548552	29553427	BolC2t09496H	0	-	179	2279	4875	0.4674872
C2	29554426	29555196	BolC2t09497H	0	+	22	124	770	0.1610390
C2	29555278	29556534	BolC2t09498H	0	+	214	1044	1256	0.8312102
C2	29566296	29567731	BolC2t09499H	0	+	22	254	1435	0.1770035
C2	29573490	29582743	BolC2t09500H	0	-	226	2256	9253	0.2438128
C2	29590675	29590969	BolC2t09501H	0	+	45	276	294	0.9387755
C2	29598795	29599110	BolC2t09502H	0	+	29	301	315	0.9555556
C2	29616622	29617332	BolC2t09503H	0	+	13	502	710	0.7070423
C2	29617371	29623179	BolC2t09504H	0	+	2018	5559	5808	0.9571281
C2	29626171	29628083	BolC2t09505H	0	-	265	785	1912	0.4105648
C2	29661359	29662834	BolC2t09506H	0	-	555	992	1475	0.6725424
C2	29664040	29666190	BolC2t09507H	0	-	108	1068	2150	0.4967442
C2	29668817	29671103	BolC2t09508H	0	+	371	2087	2286	0.9129484
C2	29671663	29674204	BolC2t09509H	0	-	975	2541	2541	1.0000000
C2	29686609	29687259	BolC2t09510H	0	+	19	145	650	0.2230769
C2	29696099	29697700	BolC2t09511H	0	-	122	1082	1601	0.6758276
C2	29735087	29735303	BolC2t09512H	0	-	155	216	216	1.0000000
C2	29765235	29767642	BolC2t09513H	0	-	105	1079	2407	0.4482759
C2	29784216	29786383	BolC2t09514H	0	+	582	1333	2167	0.6151361
C2	29787127	29789297	BolC2t09515H	0	-	372	671	2170	0.3092166
C2	29790128	29790372	BolC2t09516H	0	-	270	244	244	1.0000000
C2	29799673	29800626	BolC2t09517H	0	-	100	571	953	0.5991606
C2	29801889	29802069	BolC2t09518H	0	-	17	180	180	1.0000000
C2	29804657	29806267	BolC2t09519H	0	-	401	1491	1610	0.9260870
C2	29806003	29806700	BolC2t09520H	0	+	166	575	697	0.8249641
C2	29811415	29813021	BolC2t09521H	0	+	455	1069	1606	0.6656289
C2	29824741	29827880	BolC2t09522H	0	+	150	1208	3139	0.3848359
C2	29844063	29844772	BolC2t09523H	0	-	253	677	709	0.9548660
C2	29845813	29846558	BolC2t09524H	0	+	246	727	745	0.9758389
C2	29863563	29867312	BolC2t09525H	0	-	862	2655	3749	0.7081888
C2	29867936	29868471	BolC2t09526H	0	+	134	432	535	0.8074766
C2	29871232	29871448	BolC2t09527H	0	-	65	77	216	0.3564815
C2	29882801	29883703	BolC2t09528H	0	+	157	856	902	0.9490022
C2	29884036	29884816	BolC2t09529H	0	-	31	396	780	0.5076923
C2	29889073	29889256	BolC2t09530H	0	-	131	183	183	1.0000000
C2	29892608	29893003	BolC2t09531H	0	+	4	118	395	0.2987342
C2	29897939	29899237	BolC2t09532H	0	-	260	1093	1298	0.8420647
C2	29900866	29907131	BolC2t09533H	0	+	1002	4865	6265	0.7765363
C2	29929483	29929720	BolC2t09534H	0	+	236	237	237	1.0000000
C2	29935683	29936247	BolC2t09535H	0	-	271	564	564	1.0000000
C2	29941577	29941837	BolC2t09536H	0	-	159	260	260	1.0000000
C2	29960948	29961317	BolC2t09537H	0	-	658	369	369	1.0000000
C2	29976686	29977452	BolC2t09538H	0	-	326	766	766	1.0000000
C2	30011203	30014315	BolC2t09539H	0	+	130	1299	3112	0.4174165
C2	30013559	30016351	BolC2t09540H	0	+	1494	2666	2792	0.9548711
C2	30021193	30021763	BolC2t09541H	0	+	71	492	570	0.8631579
C2	30034985	30035168	BolC2t09542H	0	-	186	183	183	1.0000000
C2	30037642	30037819	BolC2t09543H	0	-	164	177	177	1.0000000
C2	30038872	30039070	BolC2t09544H	0	+	309	198	198	1.0000000
C2	30041152	30043065	BolC2t09545H	0	+	720	1777	1913	0.9289075
C2	30047576	30047777	BolC2t09546H	0	+	278	201	201	1.0000000
C2	30078232	30079165	BolC2t09547H	0	+	61	631	933	0.6763130
C2	30087878	30089530	BolC2t09548H	0	+	1726	1616	1652	0.9782082
C2	30124651	30126946	BolC2t09549H	0	+	55	1186	2295	0.5167756
C2	30138860	30139252	BolC2t09550H	0	+	664	392	392	1.0000000
C2	30147805	30147967	BolC2t09551H	0	-	197	162	162	1.0000000
C2	30159218	30159419	BolC2t09552H	0	+	140	201	201	1.0000000
C2	30204187	30205123	BolC2t09553H	0	+	30	485	936	0.5181624
C2	30210176	30210612	BolC2t09554H	0	+	185	343	436	0.7866973
C2	30212574	30214170	BolC2t09555H	0	+	727	1596	1596	1.0000000
C2	30214264	30215881	BolC2t09556H	0	-	982	1617	1617	1.0000000
C2	30217108	30218666	BolC2t09557H	0	+	167	1388	1558	0.8908858
C2	30220527	30224049	BolC2t09558H	0	+	397	2763	3522	0.7844974
C2	30226218	30227423	BolC2t09559H	0	+	0	0	1205	0.0000000
C2	30227700	30229427	BolC2t09560H	0	+	36	658	1727	0.3810075
C2	30230306	30230870	BolC2t09561H	0	-	17	489	564	0.8670213
C2	30240038	30241448	BolC2t09562H	0	+	768	1410	1410	1.0000000
C2	30263099	30263829	BolC2t09563H	0	+	41	416	730	0.5698630
C2	30266534	30269719	BolC2t09564H	0	-	552	2463	3185	0.7733124
C2	30284179	30286663	BolC2t09565H	0	-	622	2125	2484	0.8554751
C2	30290728	30292178	BolC2t09566H	0	-	26	440	1450	0.3034483
C2	30299889	30300916	BolC2t09567H	0	+	386	970	1027	0.9444985
C2	30304439	30307639	BolC2t09568H	0	+	2017	3200	3200	1.0000000
C2	30310995	30312453	BolC2t09569H	0	+	361	1352	1458	0.9272977
C2	30313294	30314173	BolC2t09570H	0	-	242	879	879	1.0000000
C2	30330418	30332182	BolC2t09571H	0	-	162	1537	1764	0.8713152
C2	30361890	30362814	BolC2t09572H	0	-	931	924	924	1.0000000
C2	30372333	30373605	BolC2t09573H	0	+	80	922	1272	0.7248428
C2	30381040	30383077	BolC2t09574H	0	+	937	1947	2037	0.9558174
C2	30434632	30436296	BolC2t09575H	0	-	431	1579	1664	0.9489183
C2	30492783	30496119	BolC2t09576H	0	+	547	2095	3336	0.6279976
C2	30515122	30515230	BolC2t09577H	0	-	168	108	108	1.0000000
C2	30526533	30526959	BolC2t09578H	0	-	160	426	426	1.0000000
C2	30527752	30532554	BolC2t09579H	0	-	1749	4619	4802	0.9618909
C2	30541509	30544404	BolC2t09580H	0	+	277	1875	2895	0.6476684
C2	30546533	30547641	BolC2t09581H	0	+	2	268	1108	0.2418773
C2	30555829	30556781	BolC2t09582H	0	+	100	426	952	0.4474790
C2	30560607	30561964	BolC2t09583H	0	+	0	0	1357	0.0000000
C2	30573964	30578571	BolC2t09584H	0	-	5086	4607	4607	1.0000000
C2	30595273	30595534	BolC2t09585H	0	-	27	261	261	1.0000000
C2	30597203	30606090	BolC2t09586H	0	+	1879	7589	8887	0.8539439
C2	30630085	30631961	BolC2t09587H	0	+	415	1582	1876	0.8432836
C2	30633030	30634287	BolC2t09588H	0	+	211	1228	1257	0.9769292
C2	30647472	30647790	BolC2t09589H	0	-	53	297	318	0.9339623
C2	30674392	30674599	BolC2t09590H	0	-	136	207	207	1.0000000
C2	30679973	30680465	BolC2t09591H	0	+	6	77	492	0.1565041
C2	30681808	30682159	BolC2t09592H	0	+	114	292	351	0.8319088
C2	30692358	30692604	BolC2t09593H	0	+	3	147	246	0.5975610
C2	30707362	30708590	BolC2t09594H	0	+	3	325	1228	0.2646580
C2	30716897	30717716	BolC2t09595H	0	+	5	34	819	0.0415140
C2	30718154	30718811	BolC2t09596H	0	-	21	382	657	0.5814307
C2	30739373	30739697	BolC2t09597H	0	-	219	324	324	1.0000000
C2	30748524	30749081	BolC2t09598H	0	+	83	372	557	0.6678635
C2	30755338	30757434	BolC2t09599H	0	+	1576	2096	2096	1.0000000
C2	30758337	30759744	BolC2t09600H	0	+	1039	1407	1407	1.0000000
C2	30762634	30764423	BolC2t09601H	0	+	807	1610	1789	0.8999441
C2	30764472	30765135	BolC2t09602H	0	+	897	663	663	1.0000000
C2	30767735	30769773	BolC2t09603H	0	-	554	2022	2038	0.9921492
C2	30772069	30773107	BolC2t09604H	0	-	26	496	1038	0.4778420
C2	30780532	30782270	BolC2t09605H	0	-	477	1647	1738	0.9476410
C2	30785267	30785840	BolC2t09606H	0	-	4	203	573	0.3542757
C2	30816020	30817326	BolC2t09607H	0	+	543	1270	1306	0.9724349
C2	30817789	30819437	BolC2t09608H	0	-	71	1214	1648	0.7366505
C2	30821151	30821501	BolC2t09609H	0	+	325	350	350	1.0000000
C2	30823182	30823425	BolC2t09610H	0	+	79	170	243	0.6995885
C2	30838956	30841253	BolC2t09611H	0	+	4	238	2297	0.1036134
C2	30842924	30843285	BolC2t09612H	0	+	0	0	361	0.0000000
C2	30859272	30859718	BolC2t09613H	0	+	4005	446	446	1.0000000
C2	30870756	30871151	BolC2t09614H	0	-	12	22	395	0.0556962
C2	30873971	30877175	BolC2t09615H	0	-	475	2547	3204	0.7949438
C2	30882195	30883155	BolC2t09616H	0	-	142	784	960	0.8166667
C2	30892143	30892971	BolC2t09617H	0	+	239	627	828	0.7572464
C2	30893704	30894027	BolC2t09618H	0	+	110	202	323	0.6253870
C2	30894631	30895735	BolC2t09619H	0	-	2276	1104	1104	1.0000000
C2	30896792	30897047	BolC2t09620H	0	+	584	255	255	1.0000000
C2	30897152	30897311	BolC2t09621H	0	+	466	159	159	1.0000000
C2	30901403	30905432	BolC2t09622H	0	+	813	3625	4029	0.8997270
C2	30906896	30911115	BolC2t09623H	0	+	694	3891	4219	0.9222565
C2	30911804	30915860	BolC2t09624H	0	-	736	2395	4056	0.5904832
C2	30930859	30931301	BolC2t09625H	0	-	219	442	442	1.0000000
C2	30932239	30938952	BolC2t09626H	0	-	455	3166	6713	0.4716222
C2	30948838	30950857	BolC2t09627H	0	-	633	1867	2019	0.9247152
C2	30951005	30951170	BolC2t09628H	0	-	192	165	165	1.0000000
C2	30952828	30954273	BolC2t09629H	0	+	403	1260	1445	0.8719723
C2	30954531	30957076	BolC2t09630H	0	-	1006	2224	2545	0.8738703
C2	30964914	30965889	BolC2t09631H	0	+	74	698	975	0.7158974
C2	30969098	30969356	BolC2t09632H	0	-	10	214	258	0.8294573
C2	30972670	30973087	BolC2t09633H	0	-	11	267	417	0.6402878
C2	31051013	31051460	BolC2t09634H	0	-	87	381	447	0.8523490
C2	31068644	31068764	BolC2t09635H	0	-	0	0	120	0.0000000
C2	31082157	31085657	BolC2t09636H	0	+	2164	3500	3500	1.0000000
C2	31098746	31099184	BolC2t09637H	0	-	101	305	438	0.6963471
C2	31118154	31119562	BolC2t09638H	0	-	753	1408	1408	1.0000000
C2	31148172	31149326	BolC2t09639H	0	+	105	719	1154	0.6230503
C2	31151726	31151972	BolC2t09640H	0	-	0	0	246	0.0000000
C2	31153009	31158346	BolC2t09641H	0	+	516	4477	5337	0.8388608
C2	31159031	31160845	BolC2t09642H	0	-	640	1768	1814	0.9746417
C2	31162971	31163283	BolC2t09643H	0	+	176	312	312	1.0000000
C2	31163672	31167023	BolC2t09644H	0	-	2120	3315	3351	0.9892569
C2	31171102	31173406	BolC2t09645H	0	-	174	1616	2304	0.7013889
C2	31177746	31178513	BolC2t09646H	0	+	197	720	767	0.9387223
C2	31179686	31181520	BolC2t09647H	0	+	18	485	1834	0.2644493
C2	31188591	31189194	BolC2t09648H	0	-	534	603	603	1.0000000
C2	31190343	31192478	BolC2t09649H	0	+	612	1889	2135	0.8847775
C2	31194046	31194974	BolC2t09650H	0	-	0	0	928	0.0000000
C2	31200660	31202412	BolC2t09651H	0	+	455	1470	1752	0.8390411
C2	31204563	31206339	BolC2t09652H	0	+	4	221	1776	0.1244369
C2	31209606	31210068	BolC2t09653H	0	-	360	462	462	1.0000000
C2	31210789	31212346	BolC2t09654H	0	-	39	972	1557	0.6242775
C2	31214618	31215066	BolC2t09655H	0	+	0	0	448	0.0000000
C2	31228048	31228319	BolC2t09656H	0	+	48	271	271	1.0000000
C2	31232233	31233769	BolC2t09657H	0	-	76	764	1536	0.4973958
C2	31255902	31256031	BolC2t09658H	0	-	0	0	129	0.0000000
C2	31265236	31270773	BolC2t09659H	0	-	301	3306	5537	0.5970742
C2	31286546	31287456	BolC2t09660H	0	-	12	505	910	0.5549451
C2	31287596	31287810	BolC2t09661H	0	-	49	214	214	1.0000000
C2	31291813	31292005	BolC2t09662H	0	-	2	30	192	0.1562500
C2	31302149	31304593	BolC2t09663H	0	+	1173	2349	2444	0.9611293
C2	31321593	31324255	BolC2t09664H	0	-	934	2597	2662	0.9755822
C2	31325123	31327613	BolC2t09665H	0	-	282	1641	2490	0.6590362
C2	31328875	31330869	BolC2t09666H	0	-	471	1682	1994	0.8435306
C2	31353522	31353847	BolC2t09667H	0	-	29	134	325	0.4123077
C2	31355777	31358522	BolC2t09668H	0	+	1058	2583	2745	0.9409836
C2	31363486	31364466	BolC2t09669H	0	+	42	481	980	0.4908163
C2	31364726	31366241	BolC2t09670H	0	+	190	1215	1515	0.8019802
C2	31369323	31369721	BolC2t09671H	0	-	7	99	398	0.2487437
C2	31369559	31370167	BolC2t09672H	0	-	24	339	608	0.5575658
C2	31371495	31372699	BolC2t09673H	0	+	349	1184	1204	0.9833887
C2	31373300	31373587	BolC2t09674H	0	-	34	237	287	0.8257840
C2	31377225	31377390	BolC2t09675H	0	-	1	53	165	0.3212121
C2	31384799	31386175	BolC2t09676H	0	-	798	1376	1376	1.0000000
C2	31410107	31411899	BolC2t09677H	0	-	1839	1792	1792	1.0000000
C2	31433702	31436189	BolC2t09678H	0	+	918	2229	2487	0.8962606
C2	31436546	31439015	BolC2t09679H	0	-	378	1657	2469	0.6711219
C2	31446856	31455332	BolC2t09680H	0	-	1942	6990	8476	0.8246815
C2	31459447	31461929	BolC2t09681H	0	-	127	1030	2482	0.4149879
C2	31462824	31463130	BolC2t09682H	0	-	0	0	306	0.0000000
C2	31464562	31467000	BolC2t09683H	0	-	780	2015	2438	0.8264971
C2	31468495	31471828	BolC2t09684H	0	+	711	2698	3333	0.8094810
C2	31472936	31473556	BolC2t09685H	0	+	8	125	620	0.2016129
C2	31509672	31522052	BolC2t09686H	0	-	28929	4196	12380	0.3389338
C2	31510125	31511856	BolC2t09687H	0	+	76	614	1731	0.3547083
C2	31511992	31525483	BolC2t09688H	0	+	28854	3554	13491	0.2634349
C2	31518057	31518555	BolC2t09689H	0	-	0	0	498	0.0000000
C2	31523552	31524071	BolC2t09690H	0	+	0	0	519	0.0000000
C2	31530984	31531275	BolC2t09691H	0	-	0	0	291	0.0000000
C2	31549053	31550370	BolC2t09692H	0	-	26	286	1317	0.2171602
C2	31566584	31568062	BolC2t09693H	0	+	257	1460	1478	0.9878214
C2	31568308	31568963	BolC2t09694H	0	-	396	655	655	1.0000000
C2	31569228	31571024	BolC2t09695H	0	+	471	1531	1796	0.8524499
C2	31571934	31573965	BolC2t09696H	0	-	47	917	2031	0.4515017
C2	31584643	31585943	BolC2t09697H	0	-	6	197	1300	0.1515385
C2	31588676	31590319	BolC2t09698H	0	+	42	421	1643	0.2562386
C2	31592545	31593283	BolC2t09699H	0	-	104	690	738	0.9349594
C2	31597498	31598244	BolC2t09700H	0	+	384	686	746	0.9195710
C2	31598912	31600982	BolC2t09701H	0	-	466	1331	2070	0.6429952
C2	31627370	31630221	BolC2t09702H	0	+	445	2153	2851	0.7551736
C2	31630589	31632341	BolC2t09703H	0	-	284	1477	1752	0.8430365
C2	31633580	31634476	BolC2t09704H	0	-	27	596	896	0.6651786
C2	31635862	31636687	BolC2t09705H	0	-	65	684	825	0.8290909
C2	31644207	31645111	BolC2t09706H	0	+	137	785	904	0.8683628
C2	31649655	31650356	BolC2t09707H	0	+	1169	701	701	1.0000000
C2	31664768	31665594	BolC2t09708H	0	+	42	507	826	0.6138015
C2	31668646	31669584	BolC2t09709H	0	-	30	690	938	0.7356077
C2	31669693	31669852	BolC2t09710H	0	-	5	114	159	0.7169811
C2	31680636	31681542	BolC2t09711H	0	+	12	136	906	0.1501104
C2	31695554	31697018	BolC2t09712H	0	-	110	1006	1464	0.6871585
C2	31705975	31706662	BolC2t09713H	0	+	10	196	687	0.2852984
C2	31732792	31734299	BolC2t09714H	0	-	146	1294	1507	0.8586596
C2	31737006	31737201	BolC2t09715H	0	-	5	117	195	0.6000000
C2	31740253	31742667	BolC2t09716H	0	+	1041	2372	2414	0.9826015
C2	31746686	31746956	BolC2t09717H	0	+	150	270	270	1.0000000
C2	31747318	31750734	BolC2t09718H	0	-	634	3305	3416	0.9675059
C2	31751789	31753388	BolC2t09719H	0	-	163	1442	1599	0.9018136
C2	31754730	31757161	BolC2t09720H	0	+	268	2307	2431	0.9489922
C2	31764260	31764762	BolC2t09721H	0	-	50	478	502	0.9521912
C2	31766079	31768187	BolC2t09722H	0	+	1095	2108	2108	1.0000000
C2	31775147	31775879	BolC2t09723H	0	-	696	689	732	0.9412568
C2	31786597	31787526	BolC2t09724H	0	+	1080	901	929	0.9698601
C2	31790038	31790797	BolC2t09725H	0	-	53	516	759	0.6798419
C2	31811386	31816262	BolC2t09726H	0	-	960	3173	4876	0.6507383
C2	31816592	31818750	BolC2t09727H	0	-	964	2135	2158	0.9893420
C2	31818980	31821092	BolC2t09728H	0	-	375	1803	2112	0.8536932
C2	31841825	31844043	BolC2t09729H	0	-	127	1229	2218	0.5541028
C2	31845625	31845730	BolC2t09730H	0	-	294	105	105	1.0000000
C2	31847287	31847750	BolC2t09731H	0	+	239	463	463	1.0000000
C2	31872848	31873298	BolC2t09732H	0	+	31	298	450	0.6622222
C2	31883656	31884930	BolC2t09733H	0	+	1158	1272	1274	0.9984301
C2	31891603	31894241	BolC2t09734H	0	+	462	1978	2638	0.7498105
C2	31900455	31901904	BolC2t09735H	0	-	70	1079	1449	0.7446515
C2	31904683	31904860	BolC2t09736H	0	+	186	177	177	1.0000000
C2	31923903	31924539	BolC2t09737H	0	+	21	288	636	0.4528302
C2	31938906	31941146	BolC2t09738H	0	+	118	1289	2240	0.5754464
C2	31941651	31943717	BolC2t09739H	0	+	1859	2066	2066	1.0000000
C2	31945418	31945649	BolC2t09740H	0	+	447	231	231	1.0000000
C2	31948340	31950407	BolC2t09741H	0	+	251	1195	2067	0.5781326
C2	31951147	31953587	BolC2t09742H	0	+	317	1850	2440	0.7581967
C2	31954762	31956413	BolC2t09743H	0	+	887	1621	1651	0.9818292
C2	31956857	31959807	BolC2t09744H	0	+	461	2782	2950	0.9430509
C2	31963686	31965181	BolC2t09745H	0	-	75	1444	1495	0.9658863
C2	31966139	31968692	BolC2t09746H	0	-	875	2500	2553	0.9792401
C2	31969266	31971417	BolC2t09747H	0	-	778	2151	2151	1.0000000
C2	31976169	31977532	BolC2t09748H	0	+	135	897	1363	0.6581071
C2	31988493	31990412	BolC2t09749H	0	+	245	1821	1919	0.9489318
C2	32010010	32012405	BolC2t09750H	0	+	437	2104	2395	0.8784969
C2	32020915	32021275	BolC2t09751H	0	-	238	360	360	1.0000000
C2	32037433	32039023	BolC2t09752H	0	+	193	1194	1590	0.7509434
C2	32039734	32040982	BolC2t09753H	0	+	171	1048	1248	0.8397436
C2	32043416	32044557	BolC2t09754H	0	-	275	1116	1141	0.9780894
C2	32048967	32050011	BolC2t09755H	0	-	681	1040	1044	0.9961686
C2	32066119	32068390	BolC2t09756H	0	+	457	1766	2271	0.7776310
C2	32085737	32091491	BolC2t09757H	0	-	1872	5437	5754	0.9449079
C2	32096700	32097731	BolC2t09758H	0	+	475	1031	1031	1.0000000
C2	32104893	32105106	BolC2t09759H	0	-	66	161	213	0.7558686
C2	32107861	32108937	BolC2t09760H	0	-	265	1019	1076	0.9470260
C2	32111336	32111543	BolC2t09761H	0	-	247	207	207	1.0000000
C2	32114430	32115641	BolC2t09762H	0	+	1208	1179	1211	0.9735755
C2	32116111	32116321	BolC2t09763H	0	+	94	210	210	1.0000000
C2	32116818	32117637	BolC2t09764H	0	-	183	688	819	0.8400488
C2	32120340	32121519	BolC2t09765H	0	-	179	781	1179	0.6624258
C2	32122088	32123813	BolC2t09766H	0	-	139	1372	1725	0.7953623
C2	32126420	32126807	BolC2t09767H	0	+	69	387	387	1.0000000
C2	32128451	32129176	BolC2t09768H	0	-	63	684	725	0.9434483
C2	32210788	32212055	BolC2t09769H	0	+	168	928	1267	0.7324388
C2	32213375	32214177	BolC2t09770H	0	-	50	518	802	0.6458853
C2	32215542	32215978	BolC2t09771H	0	+	27	221	436	0.5068808
C2	32216716	32217120	BolC2t09772H	0	+	2	103	404	0.2549505
C2	32217216	32218493	BolC2t09773H	0	+	29	388	1277	0.3038371
C2	32230867	32231364	BolC2t09774H	0	-	0	0	497	0.0000000
C2	32247185	32248089	BolC2t09775H	0	+	810	898	904	0.9933628
C2	32250664	32251045	BolC2t09776H	0	-	18	381	381	1.0000000
C2	32251843	32253152	BolC2t09777H	0	-	1105	893	1309	0.6822001
C2	32253829	32255093	BolC2t09778H	0	+	312	1264	1264	1.0000000
C2	32255552	32257318	BolC2t09779H	0	-	1092	1658	1766	0.9388449
C2	32264966	32267354	BolC2t09780H	0	+	2	20	2388	0.0083752
C2	32269898	32270018	BolC2t09781H	0	-	32	120	120	1.0000000
C2	32270817	32274281	BolC2t09782H	0	+	484	2821	3464	0.8143764
C2	32276176	32276598	BolC2t09783H	0	-	486	422	422	1.0000000
C2	32287757	32288654	BolC2t09784H	0	+	154	847	897	0.9442586
C2	32289457	32289940	BolC2t09785H	0	-	119	483	483	1.0000000
C2	32304211	32304394	BolC2t09786H	0	-	86	183	183	1.0000000
C2	32304831	32306892	BolC2t09787H	0	-	358	1930	2061	0.9364386
C2	32307490	32307784	BolC2t09788H	0	-	41	288	294	0.9795918
C2	32309484	32311013	BolC2t09789H	0	-	7	107	1529	0.0699804
C2	32313813	32317490	BolC2t09790H	0	-	329	2391	3677	0.6502584
C2	32329112	32345167	BolC2t09791H	0	+	1362	9494	16055	0.5913423
C2	32350310	32350745	BolC2t09792H	0	+	502	435	435	1.0000000
C2	32354637	32366229	BolC2t09793H	0	+	305	2038	11592	0.1758109
C2	32381836	32382519	BolC2t09794H	0	+	79	571	683	0.8360175
C2	32385483	32387532	BolC2t09795H	0	+	339	1681	2049	0.8204002
C2	32388851	32389309	BolC2t09796H	0	+	159	458	458	1.0000000
C2	32389769	32391510	BolC2t09797H	0	-	290	1208	1741	0.6938541
C2	32399407	32400934	BolC2t09798H	0	-	129	1203	1527	0.7878193
C2	32409755	32410067	BolC2t09799H	0	+	145	273	312	0.8750000
C2	32410569	32413367	BolC2t09800H	0	-	839	2665	2798	0.9524661
C2	32414238	32416681	BolC2t09801H	0	-	273	2150	2443	0.8800655
C2	32448725	32451424	BolC2t09802H	0	+	1138	2470	2699	0.9151537
C2	32453885	32454151	BolC2t09803H	0	-	108	247	266	0.9285714
C2	32454404	32458649	BolC2t09804H	0	-	661	3180	4245	0.7491166
C2	32461206	32463259	BolC2t09805H	0	-	657	2053	2053	1.0000000
C2	32479064	32480872	BolC2t09806H	0	+	100	955	1808	0.5282080
C2	32488115	32489229	BolC2t09807H	0	-	128	1056	1114	0.9479353
C2	32493123	32493511	BolC2t09808H	0	-	236	388	388	1.0000000
C2	32499364	32500777	BolC2t09809H	0	+	34	277	1413	0.1960368
C2	32514701	32515082	BolC2t09810H	0	+	44	291	381	0.7637795
C2	32544205	32545999	BolC2t09811H	0	+	20	738	1794	0.4113712
C2	32553694	32554179	BolC2t09812H	0	-	127	485	485	1.0000000
C2	32562520	32563528	BolC2t09813H	0	+	21	331	1008	0.3283730
C2	32564166	32565038	BolC2t09814H	0	+	138	752	872	0.8623853
C2	32571084	32572931	BolC2t09815H	0	+	1086	1847	1847	1.0000000
C2	32577700	32580919	BolC2t09816H	0	+	627	2736	3219	0.8499534
C2	32582396	32582930	BolC2t09817H	0	-	272	534	534	1.0000000
C2	32583453	32585329	BolC2t09818H	0	-	567	1746	1876	0.9307036
C2	32594796	32595209	BolC2t09819H	0	+	8	413	413	1.0000000
C2	32611513	32612905	BolC2t09820H	0	-	579	1392	1392	1.0000000
C2	32648479	32650009	BolC2t09821H	0	+	560	1486	1530	0.9712418
C2	32656836	32659997	BolC2t09822H	0	+	130	1660	3161	0.5251502
C2	32680438	32681579	BolC2t09823H	0	-	184	755	1141	0.6617002
C2	32683905	32684903	BolC2t09824H	0	+	1024	998	998	1.0000000
C2	32687921	32691312	BolC2t09825H	0	+	704	1886	3391	0.5561781
C2	32710758	32712137	BolC2t09826H	0	+	206	1088	1379	0.7889775
C2	32712745	32712889	BolC2t09827H	0	+	107	144	144	1.0000000
C2	32715768	32720396	BolC2t09828H	0	-	1451	3858	4628	0.8336214
C2	32727105	32728307	BolC2t09829H	0	-	80	291	1202	0.2420965
C2	32728378	32733677	BolC2t09830H	0	+	4188	5299	5299	1.0000000
C2	32734961	32735630	BolC2t09831H	0	+	24	162	669	0.2421525
C2	32773574	32774467	BolC2t09832H	0	-	667	893	893	1.0000000
C2	32776164	32777543	BolC2t09833H	0	-	1118	1379	1379	1.0000000
C2	32786670	32788301	BolC2t09834H	0	+	1236	1631	1631	1.0000000
C2	32790169	32796743	BolC2t09835H	0	+	1335	1888	6574	0.2871920
C2	32810670	32811904	BolC2t09836H	0	+	806	1234	1234	1.0000000
C2	32813156	32813471	BolC2t09837H	0	-	253	315	315	1.0000000
C2	32819620	32821045	BolC2t09838H	0	+	36	143	1425	0.1003509
C2	32826977	32828099	BolC2t09839H	0	+	268	1122	1122	1.0000000
C2	32828993	32829229	BolC2t09840H	0	+	40	236	236	1.0000000
C2	32829480	32830165	BolC2t09841H	0	+	472	685	685	1.0000000
C2	32831561	32832419	BolC2t09842H	0	-	33	543	858	0.6328672
C2	32840122	32840953	BolC2t09843H	0	+	59	813	831	0.9783394
C2	32841781	32842880	BolC2t09844H	0	-	444	1099	1099	1.0000000
C2	32848105	32848270	BolC2t09845H	0	-	109	165	165	1.0000000
C2	32866953	32868378	BolC2t09846H	0	+	12	36	1425	0.0252632
C2	32875837	32877789	BolC2t09847H	0	-	501	1952	1952	1.0000000
C2	32885878	32887330	BolC2t09848H	0	+	36	284	1452	0.1955923
C2	32888372	32889078	BolC2t09849H	0	-	179	477	706	0.6756374
C2	32899339	32900236	BolC2t09850H	0	-	54	597	897	0.6655518
C2	32903718	32904656	BolC2t09851H	0	-	87	539	938	0.5746269
C2	32918931	32926502	BolC2t09852H	0	-	2736	6158	7571	0.8133668
C2	32928414	32928624	BolC2t09853H	0	+	27	167	210	0.7952381
C2	32929612	32931934	BolC2t09854H	0	-	1000	2039	2322	0.8781223
C2	32935147	32935529	BolC2t09855H	0	+	45	374	382	0.9790576
C2	32936918	32938116	BolC2t09856H	0	-	107	952	1198	0.7946578
C2	32939264	32939426	BolC2t09857H	0	+	22	162	162	1.0000000
C2	32993223	32995142	BolC2t09858H	0	+	282	1667	1919	0.8686816
C2	32995455	32996007	BolC2t09859H	0	-	74	433	552	0.7844203
C2	32996449	32998879	BolC2t09860H	0	+	1557	2430	2430	1.0000000
C2	33006013	33006394	BolC2t09861H	0	-	374	381	381	1.0000000
C2	33015748	33016394	BolC2t09862H	0	-	5	308	646	0.4767802
C2	33022389	33022572	BolC2t09863H	0	+	111	183	183	1.0000000
C2	33042676	33047850	BolC2t09864H	0	+	2327	4676	5174	0.9037495
C2	33062670	33063377	BolC2t09865H	0	-	628	707	707	1.0000000
C2	33070000	33070342	BolC2t09866H	0	-	305	342	342	1.0000000
C2	33073488	33074935	BolC2t09867H	0	+	72	1056	1447	0.7297857
C2	33087604	33090957	BolC2t09868H	0	+	1374	3150	3353	0.9394572
C2	33114672	33116424	BolC2t09869H	0	+	138	1206	1752	0.6883562
C2	33155325	33155825	BolC2t09870H	0	+	5	207	500	0.4140000
C2	33169394	33170331	BolC2t09871H	0	+	748	937	937	1.0000000
C2	33238370	33238800	BolC2t09872H	0	-	214	364	430	0.8465116
C2	33239457	33240805	BolC2t09873H	0	+	215	1143	1348	0.8479229
C2	33247711	33249311	BolC2t09874H	0	-	366	1600	1600	1.0000000
C2	33257508	33260445	BolC2t09875H	0	+	993	2799	2937	0.9530133
C2	33436751	33437147	BolC2t09876H	0	+	257	396	396	1.0000000
C2	33437502	33438957	BolC2t09877H	0	+	1412	1455	1455	1.0000000
C2	33465641	33466481	BolC2t09878H	0	+	172	784	840	0.9333333
C2	33470863	33471883	BolC2t09879H	0	+	38	327	1020	0.3205882
C2	33475860	33476114	BolC2t09880H	0	+	270	254	254	1.0000000
C2	33478155	33478501	BolC2t09881H	0	+	224	346	346	1.0000000
C2	33480487	33480874	BolC2t09882H	0	-	315	387	387	1.0000000
C2	33486331	33488874	BolC2t09883H	0	-	482	1958	2543	0.7699568
C2	33498396	33498516	BolC2t09884H	0	+	228	120	120	1.0000000
C2	33504891	33505970	BolC2t09885H	0	-	105	905	1079	0.8387396
C2	33529229	33529423	BolC2t09886H	0	-	181	194	194	1.0000000
C2	33533029	33533519	BolC2t09887H	0	-	305	490	490	1.0000000
C2	33563192	33563981	BolC2t09888H	0	+	374	789	789	1.0000000
C2	33591835	33594047	BolC2t09889H	0	+	634	2130	2212	0.9629295
C2	33600195	33600715	BolC2t09890H	0	-	399	520	520	1.0000000
C2	33602636	33605991	BolC2t09891H	0	+	353	2671	3355	0.7961252
C2	33608044	33609097	BolC2t09892H	0	-	59	582	1053	0.5527065
C2	33614052	33616483	BolC2t09893H	0	-	789	1901	2431	0.7819827
C2	33637245	33638354	BolC2t09894H	0	+	192	936	1109	0.8440036
C2	33638757	33640495	BolC2t09895H	0	-	217	817	1738	0.4700806
C2	33665386	33666612	BolC2t09896H	0	+	6	143	1226	0.1166395
C2	33667190	33667745	BolC2t09897H	0	+	8	274	555	0.4936937
C2	33701485	33705170	BolC2t09898H	0	+	151	1590	3685	0.4314790
C2	33710933	33712445	BolC2t09899H	0	-	822	1375	1512	0.9093915
C2	33742688	33745179	BolC2t09900H	0	-	68	1332	2491	0.5347250
C2	33770437	33772822	BolC2t09901H	0	+	77	967	2385	0.4054507
C2	33773649	33774150	BolC2t09902H	0	+	101	421	501	0.8403193
C2	33777298	33777658	BolC2t09903H	0	+	0	0	360	0.0000000
C2	33788318	33791963	BolC2t09904H	0	+	719	3280	3645	0.8998628
C2	33794748	33798520	BolC2t09905H	0	+	937	3269	3772	0.8666490
C2	33799038	33801007	BolC2t09906H	0	-	604	1611	1969	0.8181818
C2	33819650	33820660	BolC2t09907H	0	-	550	1010	1010	1.0000000
C2	33827414	33828729	BolC2t09908H	0	-	0	0	1315	0.0000000
C2	33830981	33832191	BolC2t09909H	0	-	266	1191	1210	0.9842975
C2	33841316	33849858	BolC2t09910H	0	+	2397	8481	8542	0.9928588
C2	33853103	33853367	BolC2t09911H	0	+	5	131	264	0.4962121
C2	33853585	33853696	BolC2t09912H	0	+	27	110	111	0.9909910
C2	33858282	33859443	BolC2t09913H	0	-	147	997	1161	0.8587425
C2	33862583	33865023	BolC2t09914H	0	+	1519	2440	2440	1.0000000
C2	33873835	33880079	BolC2t09915H	0	-	1779	5315	6244	0.8512172
C2	33881839	33888036	BolC2t09916H	0	-	1195	5319	6197	0.8583186
C2	33893767	33894828	BolC2t09917H	0	-	237	877	1061	0.8265787
C2	33909185	33911567	BolC2t09918H	0	+	555	2102	2382	0.8824517
C2	33911871	33912885	BolC2t09919H	0	-	76	687	1014	0.6775148
C2	33913414	33914364	BolC2t09920H	0	+	404	950	950	1.0000000
C2	33928089	33929289	BolC2t09921H	0	-	1169	1200	1200	1.0000000
C2	33930771	33931161	BolC2t09922H	0	+	270	390	390	1.0000000
C2	33933998	33934211	BolC2t09923H	0	+	28	213	213	1.0000000
C2	33935503	33936182	BolC2t09924H	0	+	553	679	679	1.0000000
C2	33937445	33938568	BolC2t09925H	0	-	76	186	1123	0.1656278
C2	33948355	33948554	BolC2t09926H	0	+	177	199	199	1.0000000
C2	33950116	33951143	BolC2t09927H	0	-	875	1027	1027	1.0000000
C2	33951188	33951482	BolC2t09928H	0	-	245	294	294	1.0000000
C2	33951979	33952856	BolC2t09929H	0	+	707	877	877	1.0000000
C2	33952929	33957061	BolC2t09930H	0	+	2131	4132	4132	1.0000000
C2	33958046	33958534	BolC2t09931H	0	-	224	488	488	1.0000000
C2	33978719	33981181	BolC2t09932H	0	+	389	1679	2462	0.6819659
C2	34035126	34035489	BolC2t09933H	0	-	51	322	363	0.8870524
C2	34035909	34037130	BolC2t09934H	0	+	163	644	1221	0.5274366
C2	34058645	34059926	BolC2t09935H	0	+	771	1281	1281	1.0000000
C2	34060275	34062967	BolC2t09936H	0	-	404	1794	2692	0.6664190
C2	34074528	34076333	BolC2t09937H	0	+	627	1765	1805	0.9778394
C2	34082783	34085248	BolC2t09938H	0	-	1562	2465	2465	1.0000000
C2	34087370	34088161	BolC2t09939H	0	-	748	791	791	1.0000000
C2	34093635	34098174	BolC2t09940H	0	+	530	1868	4539	0.4115444
C2	34114600	34115316	BolC2t09941H	0	-	773	716	716	1.0000000
C2	34120852	34121854	BolC2t09942H	0	+	512	718	1002	0.7165669
C2	34124789	34125604	BolC2t09943H	0	+	82	733	815	0.8993865
C2	34128731	34129103	BolC2t09944H	0	-	5	123	372	0.3306452
C2	34139084	34139603	BolC2t09945H	0	+	257	519	519	1.0000000
C2	34139618	34140340	BolC2t09946H	0	+	617	722	722	1.0000000
C2	34152456	34154256	BolC2t09947H	0	-	178	1198	1800	0.6655555
C2	34157926	34158514	BolC2t09948H	0	-	59	443	588	0.7534013
C2	34181129	34183742	BolC2t09949H	0	-	261	1830	2613	0.7003444
C2	34207008	34207779	BolC2t09950H	0	-	40	638	771	0.8274968
C2	34213790	34214054	BolC2t09951H	0	+	4673	264	264	1.0000000
C2	34214494	34214641	BolC2t09952H	0	+	99	147	147	1.0000000
C2	34216678	34217421	BolC2t09953H	0	-	897	743	743	1.0000000
C2	34218864	34218996	BolC2t09954H	0	-	46	132	132	1.0000000
C2	34226898	34227342	BolC2t09955H	0	-	57	249	444	0.5608108
C2	34229103	34231582	BolC2t09956H	0	-	362	2163	2479	0.8725293
C2	34267995	34269699	BolC2t09957H	0	+	98	1591	1704	0.9336854
C2	34273492	34274170	BolC2t09958H	0	+	5	262	678	0.3864307
C2	34276735	34277593	BolC2t09959H	0	-	21	468	858	0.5454546
C2	34279156	34279568	BolC2t09960H	0	+	0	0	412	0.0000000
C2	34287477	34291068	BolC2t09961H	0	-	134	1808	3591	0.5034809
C2	34291083	34291786	BolC2t09962H	0	-	118	687	703	0.9772404
C2	34302409	34305497	BolC2t09963H	0	+	2089	3088	3088	1.0000000
C2	34322835	34325170	BolC2t09964H	0	-	1180	2335	2335	1.0000000
C2	34328078	34328351	BolC2t09965H	0	-	3	171	273	0.6263736
C2	34328543	34328855	BolC2t09966H	0	-	8	219	312	0.7019231
C2	34332980	34334862	BolC2t09967H	0	-	268	1184	1882	0.6291180
C2	34367869	34370247	BolC2t09968H	0	+	2842	2378	2378	1.0000000
C2	34376946	34377631	BolC2t09969H	0	+	309	685	685	1.0000000
C2	34379296	34380970	BolC2t09970H	0	+	350	1352	1674	0.8076463
C2	34385558	34386959	BolC2t09971H	0	+	15	268	1401	0.1912919
C2	34393246	34394426	BolC2t09972H	0	+	0	0	1180	0.0000000
C2	34401173	34404103	BolC2t09973H	0	+	1138	2342	2930	0.7993174
C2	34424414	34424819	BolC2t09974H	0	+	285	405	405	1.0000000
C2	34449676	34450479	BolC2t09975H	0	-	647	803	803	1.0000000
C2	34468944	34469361	BolC2t09976H	0	+	172	417	417	1.0000000
C2	34470949	34471135	BolC2t09977H	0	-	186	186	186	1.0000000
C2	34486874	34487655	BolC2t09978H	0	-	134	770	781	0.9859155
C2	34491146	34493166	BolC2t09979H	0	+	1621	2011	2020	0.9955446
C2	34492861	34500744	BolC2t09980H	0	-	11971	4829	7883	0.6125841
C2	34521279	34523516	BolC2t09981H	0	+	425	1837	2237	0.8211891
C2	34533990	34534528	BolC2t09982H	0	-	24	214	538	0.3977695
C2	34563052	34563238	BolC2t09983H	0	+	100	186	186	1.0000000
C2	34564203	34568408	BolC2t09984H	0	-	1794	4039	4205	0.9605232
C2	34573234	34573914	BolC2t09985H	0	+	2	85	680	0.1250000
C2	34581711	34581843	BolC2t09986H	0	+	99	132	132	1.0000000
C2	34588648	34588795	BolC2t09987H	0	+	59	147	147	1.0000000
C2	34604674	34605587	BolC2t09988H	0	+	480	913	913	1.0000000
C2	34607296	34612760	BolC2t09989H	0	+	849	2654	5464	0.4857247
C2	34615697	34618389	BolC2t09990H	0	-	262	1101	2692	0.4089896
C2	34619331	34627397	BolC2t09991H	0	-	2454	5830	8066	0.7227870
C2	34633510	34633756	BolC2t09992H	0	+	6	52	246	0.2113821
C2	34652815	34653016	BolC2t09993H	0	-	154	201	201	1.0000000
C2	34654527	34656857	BolC2t09994H	0	-	314	1139	2330	0.4888412
C2	34660882	34661203	BolC2t09995H	0	-	146	321	321	1.0000000
C2	34661490	34662459	BolC2t09996H	0	-	461	969	969	1.0000000
C2	34662570	34663053	BolC2t09997H	0	-	168	483	483	1.0000000
C2	34692469	34692865	BolC2t09998H	0	-	58	303	396	0.7651515
C2	34714227	34723071	BolC2t09999H	0	+	757	5676	8844	0.6417910
C2	34789105	34790112	BolC2t10000H	0	+	188	961	1007	0.9543198
C2	34803604	34821385	BolC2t10001H	0	-	6614	16505	17781	0.9282380
C2	34825115	34825517	BolC2t10002H	0	-	2	25	402	0.0621891
C2	34840041	34840671	BolC2t10003H	0	+	2306	630	630	1.0000000
C2	34840761	34841076	BolC2t10004H	0	+	8	315	315	1.0000000
C2	34925715	34928373	BolC2t10005H	0	-	835	1769	2658	0.6655380
C2	34960592	34965929	BolC2t10006H	0	-	500	3550	5337	0.6651677
C2	34969844	34970571	BolC2t10007H	0	+	79	494	727	0.6795048
C2	34972672	34979464	BolC2t10008H	0	-	1017	4691	6792	0.6906655
C2	34996573	34999816	BolC2t10009H	0	-	124	1105	3243	0.3407339
C2	35012381	35015019	BolC2t10010H	0	-	27	372	2638	0.1410159
C2	35016596	35016698	BolC2t10011H	0	-	11	102	102	1.0000000
C2	35020041	35021062	BolC2t10012H	0	-	50	607	1021	0.5945152
C2	35022736	35023930	BolC2t10013H	0	+	371	1190	1194	0.9966499
C2	35048970	35050195	BolC2t10014H	0	+	0	0	1225	0.0000000
C2	35055113	35055661	BolC2t10015H	0	+	426	548	548	1.0000000
C2	35061598	35061943	BolC2t10016H	0	+	0	0	345	0.0000000
C2	35071940	35072751	BolC2t10017H	0	+	53	578	811	0.7127004
C2	35072979	35073536	BolC2t10018H	0	-	4	231	557	0.4147217
C2	35076699	35077001	BolC2t10019H	0	-	0	0	302	0.0000000
C2	35085038	35087824	BolC2t10020H	0	+	4	40	2786	0.0143575
C2	35090791	35091683	BolC2t10021H	0	+	0	0	892	0.0000000
C2	35117815	35120886	BolC2t10022H	0	-	191	1279	3071	0.4164767
C2	35153217	35154092	BolC2t10023H	0	-	4	54	875	0.0617143
C2	35155677	35156003	BolC2t10024H	0	-	37	326	326	1.0000000
C2	35156482	35156817	BolC2t10025H	0	-	65	324	335	0.9671642
C2	35170537	35170882	BolC2t10026H	0	-	0	0	345	0.0000000
C2	35203307	35203550	BolC2t10027H	0	+	0	0	243	0.0000000
C2	35213549	35214149	BolC2t10028H	0	+	30	492	600	0.8200000
C2	35233653	35237281	BolC2t10029H	0	-	492	2871	3628	0.7913451
C2	35251411	35269883	BolC2t10030H	0	+	4056	12637	18472	0.6841165
C2	35287994	35289823	BolC2t10031H	0	-	140	1270	1829	0.6943685
C2	35396933	35397899	BolC2t10032H	0	-	319	920	966	0.9523810
C2	35408857	35435544	BolC2t10033H	0	-	1091	8790	26687	0.3293739
C2	35441921	35442389	BolC2t10034H	0	+	92	468	468	1.0000000
C2	35456445	35457283	BolC2t10035H	0	-	0	0	838	0.0000000
C2	35457999	35458308	BolC2t10036H	0	-	40	309	309	1.0000000
C2	35489537	35490422	BolC2t10037H	0	+	9	296	885	0.3344633
C2	35496884	35500076	BolC2t10038H	0	-	109	968	3192	0.3032582
C2	35512547	35512742	BolC2t10039H	0	-	25	185	195	0.9487180
C2	35512896	35513058	BolC2t10040H	0	-	1	9	162	0.0555556
C2	35528441	35531036	BolC2t10041H	0	+	45	810	2595	0.3121387
C2	35537890	35538804	BolC2t10042H	0	-	36	256	914	0.2800875
C2	35555188	35583730	BolC2t10043H	0	+	2319	15642	28542	0.5480345
C2	35571899	35572868	BolC2t10044H	0	+	126	856	969	0.8833849
C2	35575534	35576521	BolC2t10045H	0	+	124	954	987	0.9665654
C2	35579176	35579582	BolC2t10046H	0	-	114	373	406	0.9187192
C2	35580631	35581330	BolC2t10047H	0	+	110	648	699	0.9270386
C2	35584306	35585481	BolC2t10048H	0	-	794	1175	1175	1.0000000
C2	35625808	35626033	BolC2t10049H	0	-	130	225	225	1.0000000
C2	35638217	35638331	BolC2t10050H	0	+	2	109	114	0.9561403
C2	35658583	35662904	BolC2t10051H	0	+	551	3167	4321	0.7329322
C2	35667846	35668179	BolC2t10052H	0	+	1	55	333	0.1651652
C2	35672215	35679324	BolC2t10053H	0	-	218	3216	7109	0.4523843
C2	35680420	35680942	BolC2t10054H	0	+	157	519	522	0.9942529
C2	35680999	35698352	BolC2t10055H	0	+	3193	13845	17353	0.7978448
C2	35699201	35699393	BolC2t10056H	0	+	188	192	192	1.0000000
C2	35700893	35701742	BolC2t10057H	0	+	6	108	849	0.1272085
C2	35702274	35702589	BolC2t10058H	0	+	0	0	315	0.0000000
C2	35725297	35725838	BolC2t10059H	0	+	413	541	541	1.0000000
C2	35737569	35737946	BolC2t10060H	0	-	254	377	377	1.0000000
C2	35777572	35778247	BolC2t10061H	0	-	102	555	675	0.8222222
C2	35795189	35795470	BolC2t10062H	0	-	0	0	281	0.0000000
C2	35825206	35830386	BolC2t10063H	0	-	764	3508	5180	0.6772201
C2	35872174	35873775	BolC2t10064H	0	-	136	1249	1601	0.7801374
C2	35889304	35893608	BolC2t10065H	0	-	367	3208	4304	0.7453532
C2	35906667	35909838	BolC2t10066H	0	-	1099	2520	3171	0.7947020
C2	35910465	35911098	BolC2t10067H	0	+	0	0	633	0.0000000
C2	35912467	35915743	BolC2t10068H	0	-	737	1869	3276	0.5705128
C2	35924831	35925637	BolC2t10069H	0	+	19	220	806	0.2729529
C2	35933668	35934227	BolC2t10070H	0	-	0	0	559	0.0000000
C2	35954125	35955236	BolC2t10071H	0	-	43	784	1111	0.7056706
C2	35974131	35982647	BolC2t10072H	0	+	3454	7919	8516	0.9298967
C2	35988079	35994827	BolC2t10073H	0	+	570	4606	6748	0.6825726
C2	36017070	36018622	BolC2t10074H	0	-	66	1148	1552	0.7396907
C2	36027329	36043740	BolC2t10075H	0	+	326	4315	16411	0.2629334
C2	36041790	36042141	BolC2t10076H	0	-	2	55	351	0.1566952
C2	36043391	36045017	BolC2t10077H	0	+	31	407	1626	0.2503075
C2	36048278	36048867	BolC2t10078H	0	+	21	334	589	0.5670628
C2	36050724	36051540	BolC2t10079H	0	-	44	628	816	0.7696078
C2	36063760	36064027	BolC2t10080H	0	+	8	168	267	0.6292135
C2	36064418	36067055	BolC2t10081H	0	-	546	1924	2637	0.7296170
C2	36067295	36068478	BolC2t10082H	0	+	3	12	1183	0.0101437
C2	36081584	36082517	BolC2t10083H	0	-	138	779	933	0.8349410
C2	36082698	36084304	BolC2t10084H	0	-	257	1109	1606	0.6905355
C2	36085938	36087534	BolC2t10085H	0	-	41	757	1596	0.4743108
C2	36145788	36159463	BolC2t10086H	0	-	2877	12046	13675	0.8808775
C2	36146869	36147223	BolC2t10087H	0	+	46	265	354	0.7485875
C2	36171853	36193303	BolC2t10088H	0	-	4392	19821	21450	0.9240559
C2	36195094	36197863	BolC2t10089H	0	-	911	2759	2769	0.9963886
C2	36257727	36258940	BolC2t10090H	0	+	95	904	1213	0.7452597
C2	36274045	36276962	BolC2t10091H	0	+	389	1401	2917	0.4802880
C2	36302281	36302671	BolC2t10092H	0	+	286	387	390	0.9923077
C2	36303131	36303845	BolC2t10093H	0	+	752	714	714	1.0000000
C2	36328689	36328950	BolC2t10094H	0	+	220	261	261	1.0000000
C2	36329927	36332285	BolC2t10095H	0	+	237	1456	2358	0.6174724
C2	36336124	36336337	BolC2t10096H	0	-	12	178	213	0.8356807
C2	36339074	36339738	BolC2t10097H	0	+	11	387	664	0.5828313
C2	36340363	36340654	BolC2t10098H	0	-	215	272	291	0.9347079
C2	36343016	36349097	BolC2t10099H	0	-	2308	5414	6081	0.8903141
C2	36355197	36357178	BolC2t10100H	0	+	1586	1981	1981	1.0000000
C2	36396800	36398424	BolC2t10101H	0	+	1010	1624	1624	1.0000000
C2	36433673	36436732	BolC2t10102H	0	+	1152	2931	3059	0.9581563
C2	36438698	36439327	BolC2t10103H	0	+	385	629	629	1.0000000
C2	36451072	36452648	BolC2t10104H	0	+	781	1576	1576	1.0000000
C2	36483663	36484448	BolC2t10105H	0	-	221	785	785	1.0000000
C2	36497368	36497875	BolC2t10106H	0	+	646	507	507	1.0000000
C2	36504084	36504775	BolC2t10107H	0	-	370	691	691	1.0000000
C2	36517543	36519256	BolC2t10108H	0	+	59	555	1713	0.3239930
C2	36548792	36548983	BolC2t10109H	0	+	119	191	191	1.0000000
C2	36560658	36561631	BolC2t10110H	0	-	204	914	973	0.9393628
C2	36578157	36580087	BolC2t10111H	0	-	183	697	1930	0.3611399
C2	36581346	36582119	BolC2t10112H	0	+	47	618	773	0.7994825
C2	36586606	36586792	BolC2t10113H	0	-	130	186	186	1.0000000
C2	36605677	36608235	BolC2t10114H	0	-	21	411	2558	0.1606724
C2	36617958	36618181	BolC2t10115H	0	+	52	223	223	1.0000000
C2	36620573	36621219	BolC2t10116H	0	-	0	0	646	0.0000000
C2	36623877	36624212	BolC2t10117H	0	+	561	335	335	1.0000000
C2	36639749	36658844	BolC2t10118H	0	-	6463	16089	19095	0.8425766
C2	36660361	36660742	BolC2t10119H	0	+	9	206	381	0.5406824
C2	36665309	36666236	BolC2t10120H	0	-	467	927	927	1.0000000
C2	36668588	36668776	BolC2t10121H	0	+	0	0	188	0.0000000
C2	36671787	36672100	BolC2t10122H	0	-	138	313	313	1.0000000
C2	36676749	36677163	BolC2t10123H	0	-	851	414	414	1.0000000
C2	36680875	36681814	BolC2t10124H	0	-	841	939	939	1.0000000
C2	36684062	36684792	BolC2t10125H	0	-	2207	730	730	1.0000000
C2	36685022	36685326	BolC2t10126H	0	-	76	291	304	0.9572368
C2	36689583	36696788	BolC2t10127H	0	-	2421	5033	7205	0.6985427
C2	36706986	36707286	BolC2t10128H	0	+	0	0	300	0.0000000
C2	36712965	36713265	BolC2t10129H	0	+	2	31	300	0.1033333
C2	36716950	36718432	BolC2t10130H	0	+	54	1082	1482	0.7300945
C2	36728017	36729307	BolC2t10131H	0	+	41	597	1290	0.4627907
C2	36757663	36759409	BolC2t10132H	0	-	73	1090	1746	0.6242841
C2	36767604	36767943	BolC2t10133H	0	-	0	0	339	0.0000000
C2	36768075	36768956	BolC2t10134H	0	-	64	315	881	0.3575482
C2	36806558	36806978	BolC2t10135H	0	-	0	0	420	0.0000000
C2	36809077	36813663	BolC2t10136H	0	+	2375	4585	4586	0.9997820
C2	36825190	36825496	BolC2t10137H	0	-	22	257	306	0.8398693
C2	36865437	36866676	BolC2t10138H	0	+	37	352	1239	0.2841001
C2	36880714	36881559	BolC2t10139H	0	+	43	564	845	0.6674556
C2	36889144	36890688	BolC2t10140H	0	+	102	359	1544	0.2325130
C2	36897276	36898524	BolC2t10141H	0	+	660	1162	1248	0.9310898
C2	36906713	36907208	BolC2t10142H	0	+	94	384	495	0.7757576
C2	36908918	36909401	BolC2t10143H	0	+	129	436	483	0.9026915
C2	36912311	36913357	BolC2t10144H	0	-	1034	273	1046	0.2609943
C2	36915882	36916462	BolC2t10145H	0	-	135	575	580	0.9913793
C2	36921271	36922945	BolC2t10146H	0	-	53	733	1674	0.4378734
C2	36941959	36949365	BolC2t10147H	0	-	51316	7286	7406	0.9837969
C2	36961076	36963762	BolC2t10148H	0	-	48	835	2686	0.3108712
C2	36967340	36967490	BolC2t10149H	0	-	0	0	150	0.0000000
C2	36979906	36980008	BolC2t10150H	0	+	137	102	102	1.0000000
C2	36980062	36980561	BolC2t10151H	0	+	197	408	499	0.8176353
C2	37019880	37021280	BolC2t10152H	0	-	185	508	1400	0.3628571
C2	37042008	37042992	BolC2t10153H	0	+	582	984	984	1.0000000
C2	37085752	37086271	BolC2t10154H	0	-	54	378	519	0.7283237
C2	37188526	37190341	BolC2t10155H	0	-	122	1060	1815	0.5840220
C2	37267051	37268255	BolC2t10156H	0	-	968	1204	1204	1.0000000
C2	37308055	37308172	BolC2t10157H	0	-	0	0	117	0.0000000
C2	37311915	37312887	BolC2t10158H	0	+	5	278	972	0.2860082
C2	37336584	37336884	BolC2t10159H	0	-	70	300	300	1.0000000
C2	37338351	37338588	BolC2t10160H	0	+	86	237	237	1.0000000
C2	37344256	37347104	BolC2t10161H	0	+	160	1479	2848	0.5193118
C2	37357434	37357608	BolC2t10162H	0	+	63	174	174	1.0000000
C2	37363531	37367743	BolC2t10163H	0	+	237	1971	4212	0.4679487
C2	37368892	37369591	BolC2t10164H	0	-	161	613	699	0.8769671
C2	37372890	37373100	BolC2t10165H	0	+	229	210	210	1.0000000
C2	37412670	37415508	BolC2t10166H	0	-	887	2570	2838	0.9055673
C2	37431820	37433674	BolC2t10167H	0	-	557	1614	1854	0.8705502
C2	37439083	37439350	BolC2t10168H	0	+	231	267	267	1.0000000
C2	37453921	37454269	BolC2t10169H	0	+	70	236	348	0.6781609
C2	37455167	37457981	BolC2t10170H	0	-	1573	2735	2814	0.9719261
C2	37481142	37481319	BolC2t10171H	0	+	65	177	177	1.0000000
C2	37483124	37483589	BolC2t10172H	0	-	60	407	465	0.8752688
C2	37513995	37515099	BolC2t10173H	0	-	708	1104	1104	1.0000000
C2	37518630	37519701	BolC2t10174H	0	+	1020	1071	1071	1.0000000
C2	37523808	37524000	BolC2t10175H	0	+	353	192	192	1.0000000
C2	37538069	37538664	BolC2t10176H	0	-	412	455	595	0.7647059
C2	37540577	37542080	BolC2t10177H	0	+	423	980	1503	0.6520293
C2	37546810	37548880	BolC2t10178H	0	-	1705	2070	2070	1.0000000
C2	37552907	37553263	BolC2t10179H	0	+	156	356	356	1.0000000
C2	37571721	37572713	BolC2t10180H	0	-	916	992	992	1.0000000
C2	37580275	37580611	BolC2t10181H	0	+	330	336	336	1.0000000
C2	37588278	37589651	BolC2t10182H	0	-	704	1373	1373	1.0000000
C2	37613791	37615136	BolC2t10183H	0	+	307	1259	1345	0.9360595
C2	37654688	37655039	BolC2t10184H	0	+	262	351	351	1.0000000
C2	37666430	37668105	BolC2t10185H	0	-	816	1675	1675	1.0000000
C2	37673404	37674782	BolC2t10186H	0	-	1326	1378	1378	1.0000000
C2	37677629	37677944	BolC2t10187H	0	+	147	315	315	1.0000000
C2	37693185	37694577	BolC2t10188H	0	-	1459	1392	1392	1.0000000
C2	37698376	37698675	BolC2t10189H	0	-	222	299	299	1.0000000
C2	37730846	37733014	BolC2t10190H	0	+	252	1605	2168	0.7403136
C2	37733454	37735602	BolC2t10191H	0	-	684	1767	2148	0.8226257
C2	37758168	37762375	BolC2t10192H	0	+	295	2560	4207	0.6085096
C2	37786202	37787878	BolC2t10193H	0	-	1464	1591	1676	0.9492840
C2	37804416	37804899	BolC2t10194H	0	-	48	315	483	0.6521739
C2	37819432	37819588	BolC2t10195H	0	-	66	156	156	1.0000000
C2	37820834	37821198	BolC2t10196H	0	+	396	364	364	1.0000000
C2	37821808	37821973	BolC2t10197H	0	+	88	165	165	1.0000000
C2	37822267	37822502	BolC2t10198H	0	+	138	235	235	1.0000000
C2	37905667	37905820	BolC2t10199H	0	-	0	0	153	0.0000000
C2	37907525	37907985	BolC2t10200H	0	-	0	0	460	0.0000000
C2	37908105	37908531	BolC2t10201H	0	-	0	0	426	0.0000000
C2	37911154	37911777	BolC2t10202H	0	+	7	213	623	0.3418941
C2	37912605	37913298	BolC2t10203H	0	+	1	22	693	0.0317460
C2	37917630	37918014	BolC2t10204H	0	+	57	384	384	1.0000000
C2	37948474	37948855	BolC2t10205H	0	-	1	32	381	0.0839895
C2	37951978	37952332	BolC2t10206H	0	-	0	0	354	0.0000000
C2	37954358	37954981	BolC2t10207H	0	+	0	0	623	0.0000000
C2	37956123	37956334	BolC2t10208H	0	+	3	124	211	0.5876777
C2	38010821	38011130	BolC2t10209H	0	-	0	0	309	0.0000000
C2	38014632	38015144	BolC2t10210H	0	+	1	84	512	0.1640625
C2	38024360	38026206	BolC2t10211H	0	+	2888	1805	1846	0.9777898
C2	38031353	38041313	BolC2t10212H	0	+	1185	4066	9960	0.4082329
C2	38063680	38066334	BolC2t10213H	0	+	54	933	2654	0.3515448
C2	38066436	38088169	BolC2t10214H	0	+	1524	11987	21733	0.5515575
C2	38085614	38086109	BolC2t10215H	0	-	1	74	495	0.1494949
C2	38088052	38088841	BolC2t10216H	0	-	8	410	789	0.5196451
C2	38093235	38093799	BolC2t10217H	0	-	369	564	564	1.0000000
C2	38111269	38111520	BolC2t10218H	0	-	144	251	251	1.0000000
C2	38127173	38130152	BolC2t10219H	0	-	175	1172	2979	0.3934206
C2	38159443	38159875	BolC2t10220H	0	-	34	327	432	0.7569444
C2	38160005	38160287	BolC2t10221H	0	-	14	282	282	1.0000000
C2	38179359	38179812	BolC2t10222H	0	-	1	23	453	0.0507726
C2	38182226	38183442	BolC2t10223H	0	-	388	1216	1216	1.0000000
C2	38189570	38190651	BolC2t10224H	0	+	185	810	1081	0.7493062
C2	38191037	38191869	BolC2t10225H	0	-	300	792	832	0.9519231
C2	38203352	38204559	BolC2t10226H	0	-	22	507	1207	0.4200497
C2	38240103	38240331	BolC2t10227H	0	+	236	228	228	1.0000000
C2	38241853	38245724	BolC2t10228H	0	-	1216	3344	3871	0.8638595
C2	38272949	38273303	BolC2t10229H	0	+	2	174	354	0.4915254
C2	38282914	38283246	BolC2t10230H	0	+	102	332	332	1.0000000
C2	38283425	38283674	BolC2t10231H	0	+	120	249	249	1.0000000
C2	38312600	38313040	BolC2t10232H	0	-	111	440	440	1.0000000
C2	38313045	38317012	BolC2t10233H	0	-	909	2608	3967	0.6574237
C2	38323946	38325596	BolC2t10234H	0	+	941	1621	1650	0.9824243
C2	38331481	38331880	BolC2t10235H	0	-	332	399	399	1.0000000
C2	38332361	38332469	BolC2t10236H	0	-	134	108	108	1.0000000
C2	38344058	38345044	BolC2t10237H	0	-	693	986	986	1.0000000
C2	38378911	38380327	BolC2t10238H	0	+	189	1197	1416	0.8453390
C2	38381591	38381969	BolC2t10239H	0	-	11	290	378	0.7671958
C2	38389044	38389478	BolC2t10240H	0	-	285	434	434	1.0000000
C2	38390092	38390710	BolC2t10241H	0	-	439	618	618	1.0000000
C2	38395114	38395447	BolC2t10242H	0	+	330	333	333	1.0000000
C2	38399423	38399975	BolC2t10243H	0	+	620	552	552	1.0000000
C2	38403644	38404726	BolC2t10244H	0	+	975	1082	1082	1.0000000
C2	38405384	38405558	BolC2t10245H	0	-	1	6	174	0.0344828
C2	38406247	38406475	BolC2t10246H	0	-	52	116	228	0.5087720
C2	38411496	38412297	BolC2t10247H	0	-	30	575	801	0.7178527
C2	38413077	38413614	BolC2t10248H	0	-	177	511	537	0.9515828
C2	38425551	38426851	BolC2t10249H	0	-	624	1300	1300	1.0000000
C2	38426890	38427163	BolC2t10250H	0	-	71	273	273	1.0000000
C2	38459756	38460479	BolC2t10251H	0	-	361	723	723	1.0000000
C2	38471498	38471618	BolC2t10252H	0	+	168	120	120	1.0000000
C2	38476390	38476579	BolC2t10253H	0	+	199	189	189	1.0000000
C2	38485191	38506700	BolC2t10254H	0	+	6619	20855	21509	0.9695941
C2	38518681	38518855	BolC2t10255H	0	+	76	174	174	1.0000000
C2	38521486	38522535	BolC2t10256H	0	-	833	1049	1049	1.0000000
C2	38541191	38544805	BolC2t10257H	0	+	1699	3506	3614	0.9701162
C2	38574090	38577748	BolC2t10258H	0	+	324	2865	3658	0.7832149
C2	38586142	38586938	BolC2t10259H	0	+	73	469	796	0.5891960
C2	38600542	38601208	BolC2t10260H	0	+	0	0	666	0.0000000
C2	38617352	38620519	BolC2t10261H	0	+	441	1389	3167	0.4385854
C2	38636805	38646765	BolC2t10262H	0	-	1325	6631	9960	0.6657631
C2	38653866	38654807	BolC2t10263H	0	+	92	739	941	0.7853348
C2	38655970	38658173	BolC2t10264H	0	+	87	780	2203	0.3540626
C2	38662755	38662878	BolC2t10265H	0	+	0	0	123	0.0000000
C2	38685517	38688290	BolC2t10266H	0	+	1028	2393	2773	0.8629643
C2	38724375	38724801	BolC2t10267H	0	+	164	426	426	1.0000000
C2	38733755	38734284	BolC2t10268H	0	+	593	529	529	1.0000000
C2	38761580	38761778	BolC2t10269H	0	+	153	198	198	1.0000000
C2	38778307	38778409	BolC2t10270H	0	-	42	102	102	1.0000000
C2	38781863	38782099	BolC2t10271H	0	+	104	236	236	1.0000000
C2	38794464	38799070	BolC2t10272H	0	+	1129	3878	4606	0.8419453
C2	38846858	38848237	BolC2t10273H	0	+	421	1379	1379	1.0000000
C2	38860326	38860494	BolC2t10274H	0	+	34	168	168	1.0000000
C2	38866870	38867941	BolC2t10275H	0	+	743	1071	1071	1.0000000
C2	38888918	38890192	BolC2t10276H	0	-	618	1274	1274	1.0000000
C2	38890821	38891412	BolC2t10277H	0	-	86	591	591	1.0000000
C2	39046938	39047276	BolC2t10278H	0	-	0	0	338	0.0000000
C2	39160681	39163805	BolC2t10279H	0	-	959	1909	3124	0.6110755
C2	39194816	39194978	BolC2t10280H	0	-	6	44	162	0.2716049
C2	39194997	39196187	BolC2t10281H	0	-	14	170	1190	0.1428571
C2	39234395	39234512	BolC2t10282H	0	-	108	117	117	1.0000000
C2	39242693	39249012	BolC2t10283H	0	-	3240	6094	6319	0.9643931
C2	39245170	39246222	BolC2t10284H	0	+	701	1052	1052	1.0000000
C2	39251110	39251389	BolC2t10285H	0	+	136	279	279	1.0000000
C2	39255189	39256123	BolC2t10286H	0	-	18	550	934	0.5888651
C2	39257561	39257857	BolC2t10287H	0	+	1	1	296	0.0033784
C2	39302562	39306799	BolC2t10288H	0	-	108	2272	4237	0.5362285
C2	39333615	39333767	BolC2t10289H	0	+	169	152	152	1.0000000
C2	39349723	39349888	BolC2t10290H	0	-	111	165	165	1.0000000
C2	39349769	39368590	BolC2t10291H	0	-	2422	16615	18821	0.8827905
C2	39399636	39400900	BolC2t10292H	0	+	508	1254	1264	0.9920886
C2	39401299	39403306	BolC2t10293H	0	-	204	1176	2007	0.5859492
C2	39412102	39412363	BolC2t10294H	0	-	36	244	261	0.9348659
C2	39420178	39423137	BolC2t10295H	0	-	328	1874	2959	0.6333221
C2	39435856	39443788	BolC2t10296H	0	+	1582	6101	7932	0.7691629
C2	39436992	39437252	BolC2t10297H	0	+	34	119	260	0.4576923
C2	39445507	39448174	BolC2t10298H	0	+	1881	2650	2667	0.9936258
C2	39456817	39457085	BolC2t10299H	0	-	12	89	268	0.3320895
C2	39460100	39460379	BolC2t10300H	0	-	61	279	279	1.0000000
C2	39462563	39463270	BolC2t10301H	0	+	971	698	707	0.9872702
C2	39463964	39464769	BolC2t10302H	0	+	377	805	805	1.0000000
C2	39465064	39465910	BolC2t10303H	0	+	555	811	846	0.9586288
C2	39474682	39474970	BolC2t10304H	0	-	204	288	288	1.0000000
C2	39481786	39482872	BolC2t10305H	0	-	16	411	1086	0.3784530
C2	39483663	39484987	BolC2t10306H	0	-	116	1087	1324	0.8209970
C2	39526025	39526671	BolC2t10307H	0	-	10	19	646	0.0294118
C2	39531621	39532247	BolC2t10308H	0	-	3	268	626	0.4281150
C2	39830581	39830875	BolC2t10309H	0	+	49	294	294	1.0000000
C2	40348497	40350339	BolC2t10310H	0	-	8	236	1842	0.1281216
C2	40454474	40454681	BolC2t10311H	0	-	118	207	207	1.0000000
C2	40461438	40462197	BolC2t10312H	0	-	551	759	759	1.0000000
C2	40462604	40462772	BolC2t10313H	0	-	72	168	168	1.0000000
C2	40482230	40483128	BolC2t10314H	0	+	503	898	898	1.0000000
C2	40499417	40499750	BolC2t10315H	0	-	58	322	333	0.9669670
C2	40503402	40503528	BolC2t10316H	0	-	46	126	126	1.0000000
C2	40505791	40523950	BolC2t10317H	0	-	7809	17542	18159	0.9660224
C2	40530774	40531519	BolC2t10318H	0	+	7	353	745	0.4738255
C2	40684486	40684783	BolC2t10319H	0	-	37	297	297	1.0000000
C2	40686654	40710352	BolC2t10320H	0	-	4031	21632	23698	0.9128196
C2	40699483	40700583	BolC2t10321H	0	+	138	1100	1100	1.0000000
C2	40700589	40701831	BolC2t10322H	0	+	221	1233	1242	0.9927536
C2	40769765	40770338	BolC2t10323H	0	-	453	573	573	1.0000000
C2	40775913	40776081	BolC2t10324H	0	-	18	168	168	1.0000000
C2	40777746	40778268	BolC2t10325H	0	-	125	340	522	0.6513410
C2	40799303	40808617	BolC2t10326H	0	-	5921	7374	9314	0.7917114
C2	40814849	40815706	BolC2t10327H	0	-	1536	857	857	1.0000000
C2	40825770	40826256	BolC2t10328H	0	-	5	181	486	0.3724280
C2	40826618	40827826	BolC2t10329H	0	-	6	573	1208	0.4743378
C2	40838891	40840354	BolC2t10330H	0	-	225	1022	1463	0.6985646
C2	40849702	40851439	BolC2t10331H	0	+	1445	1737	1737	1.0000000
C2	40856145	40858021	BolC2t10332H	0	+	423	1696	1876	0.9040512
C2	40859966	40860879	BolC2t10333H	0	-	95	709	913	0.7765608
C2	40864182	40864593	BolC2t10334H	0	-	263	411	411	1.0000000
C2	40874961	40904357	BolC2t10335H	0	-	7546	26463	29396	0.9002245
C2	40908244	40909118	BolC2t10336H	0	+	103	874	874	1.0000000
C2	40909159	40909897	BolC2t10337H	0	+	74	738	738	1.0000000
C2	40924425	40926750	BolC2t10338H	0	-	439	2325	2325	1.0000000
C2	40930528	40931026	BolC2t10339H	0	+	76	498	498	1.0000000
C2	40931301	40931892	BolC2t10340H	0	+	137	591	591	1.0000000
C2	40935603	40936804	BolC2t10341H	0	+	130	1113	1201	0.9267277
C2	40950934	40951039	BolC2t10342H	0	+	0	0	105	0.0000000
C2	40981885	40983465	BolC2t10343H	0	+	74	906	1580	0.5734177
C2	40988555	40989125	BolC2t10344H	0	-	368	570	570	1.0000000
C2	41013543	41013729	BolC2t10345H	0	-	72	158	186	0.8494624
C2	41013900	41015498	BolC2t10346H	0	-	178	535	1598	0.3347935
C2	41021353	41022937	BolC2t10347H	0	+	264	664	1584	0.4191919
C2	41051898	41053141	BolC2t10348H	0	+	1252	1243	1243	1.0000000
C2	41068875	41069960	BolC2t10349H	0	-	0	0	1085	0.0000000
C2	41070548	41076702	BolC2t10350H	0	-	20	695	6154	0.1129347
C2	41072405	41072897	BolC2t10351H	0	-	0	0	492	0.0000000
C2	41076716	41080609	BolC2t10352H	0	-	41	1228	3893	0.3154380
C2	41080716	41081027	BolC2t10353H	0	-	0	0	311	0.0000000
C2	41094388	41103906	BolC2t10354H	0	-	5146	7027	9518	0.7382854
C2	41266158	41266275	BolC2t10355H	0	-	20	101	117	0.8632479
C2	41318105	41318998	BolC2t10356H	0	+	3	40	893	0.0447928
C2	41319278	41320139	BolC2t10357H	0	+	18	201	861	0.2334495
C2	41357883	41358114	BolC2t10358H	0	+	7	182	231	0.7878788
C2	41367083	41369088	BolC2t10359H	0	-	155	917	2005	0.4573566
C2	41413321	41413474	BolC2t10360H	0	-	160	153	153	1.0000000
C2	41475290	41476073	BolC2t10361H	0	+	132	747	783	0.9540230
C2	41479088	41480288	BolC2t10362H	0	-	206	1008	1200	0.8400000
C2	41480408	41481364	BolC2t10363H	0	-	289	826	956	0.8640167
C2	41489118	41489400	BolC2t10364H	0	-	75	282	282	1.0000000
C2	41490123	41490270	BolC2t10365H	0	-	8	74	147	0.5034013
C2	41491309	41503640	BolC2t10366H	0	+	752	2429	12331	0.1969832
C2	41513833	41514013	BolC2t10367H	0	-	155	180	180	1.0000000
C2	41514519	41514836	BolC2t10368H	0	-	213	317	317	1.0000000
C2	41537841	41543213	BolC2t10369H	0	+	704	3856	5372	0.7177960
C2	41541624	41542784	BolC2t10370H	0	-	126	680	1160	0.5862069
C2	41547573	41547876	BolC2t10371H	0	-	264	303	303	1.0000000
C2	41595222	41596567	BolC2t10372H	0	+	413	1122	1345	0.8342007
C2	41636435	41636935	BolC2t10373H	0	-	108	418	500	0.8360000
C2	41637683	41638503	BolC2t10374H	0	-	14	328	820	0.4000000
C2	41664060	41664579	BolC2t10375H	0	-	7	322	519	0.6204239
C2	41668836	41670845	BolC2t10376H	0	-	835	1985	2009	0.9880537
C2	41685689	41685887	BolC2t10377H	0	-	62	198	198	1.0000000
C2	41737593	41738619	BolC2t10378H	0	+	35	302	1026	0.2943470
C2	41747055	41747349	BolC2t10379H	0	+	203	294	294	1.0000000
C2	41776678	41776999	BolC2t10380H	0	+	47	321	321	1.0000000
C2	41808141	41810166	BolC2t10381H	0	+	161	985	2025	0.4864198
C2	41840964	41842110	BolC2t10382H	0	-	40	766	1146	0.6684119
C2	41892834	41893162	BolC2t10383H	0	+	3	194	328	0.5914634
C2	41897635	41898680	BolC2t10384H	0	+	426	1045	1045	1.0000000
C2	41901514	41901682	BolC2t10385H	0	+	91	168	168	1.0000000
C2	41902096	41902669	BolC2t10386H	0	+	23	507	573	0.8848168
C2	42019083	42019350	BolC2t10387H	0	+	196	267	267	1.0000000
C2	42024803	42043288	BolC2t10388H	0	+	227	1915	18485	0.1035975
C2	42045938	42046175	BolC2t10389H	0	-	2	162	237	0.6835443
C2	42107884	42107995	BolC2t10390H	0	+	222	111	111	1.0000000
C2	42117379	42117535	BolC2t10391H	0	+	523	156	156	1.0000000
C2	42119156	42119282	BolC2t10392H	0	-	106	126	126	1.0000000
C2	42148439	42149250	BolC2t10393H	0	+	22	212	811	0.2614057
C2	42169291	42171062	BolC2t10394H	0	+	44	646	1771	0.3647657
C2	42244893	42245181	BolC2t10395H	0	+	8	219	288	0.7604167
C2	42245486	42272571	BolC2t10396H	0	+	14391	26103	27085	0.9637437
C2	42293937	42295602	BolC2t10397H	0	-	189	1227	1665	0.7369369
C2	42315374	42316198	BolC2t10398H	0	+	183	824	824	1.0000000
C2	42326130	42326325	BolC2t10399H	0	+	170	195	195	1.0000000
C2	42420831	42421933	BolC2t10400H	0	+	178	1102	1102	1.0000000
C2	42466804	42467395	BolC2t10401H	0	+	157	590	591	0.9983079
C2	42565315	42566412	BolC2t10402H	0	+	239	962	1097	0.8769371
C2	42570435	42575935	BolC2t10403H	0	-	1112	5013	5500	0.9114546
C2	42736588	42737432	BolC2t10404H	0	+	38	310	844	0.3672986
C2	42741653	42742635	BolC2t10405H	0	-	28	446	982	0.4541751
C2	42754837	42757375	BolC2t10406H	0	-	183	1435	2538	0.5654058
C2	42790326	42791251	BolC2t10407H	0	+	620	925	925	1.0000000
C2	42804909	42806255	BolC2t10408H	0	-	1467	1346	1346	1.0000000
C2	42816167	42816530	BolC2t10409H	0	-	17	248	363	0.6831956
C2	42817788	42818172	BolC2t10410H	0	+	292	384	384	1.0000000
C2	42818361	42818901	BolC2t10411H	0	+	583	540	540	1.0000000
C2	42819606	42820347	BolC2t10412H	0	+	172	741	741	1.0000000
C2	42872844	42875237	BolC2t10413H	0	-	664	2092	2393	0.8742164
C2	42876892	42879778	BolC2t10414H	0	-	74	1453	2886	0.5034650
C2	42885543	42885777	BolC2t10415H	0	-	76	234	234	1.0000000
C2	42940666	42940924	BolC2t10416H	0	+	12	147	258	0.5697674
C2	42978651	42979264	BolC2t10417H	0	+	0	0	613	0.0000000
C2	42995831	42996459	BolC2t10418H	0	+	0	0	628	0.0000000
C2	42997035	42997578	BolC2t10419H	0	-	15	396	543	0.7292818
C2	43055479	43055791	BolC2t10420H	0	-	307	312	312	1.0000000
C2	43057346	43057526	BolC2t10421H	0	+	377	180	180	1.0000000
C2	43063379	43067864	BolC2t10422H	0	+	947	3021	4485	0.6735786
C2	43143565	43147472	BolC2t10423H	0	-	1690	3407	3907	0.8720246
C2	43147859	43148168	BolC2t10424H	0	-	175	309	309	1.0000000
C2	43269329	43270318	BolC2t10425H	0	+	53	276	989	0.2790698
C2	43316905	43317978	BolC2t10426H	0	+	11	361	1073	0.3364399
C2	43436099	43436433	BolC2t10427H	0	+	1	12	334	0.0359281
C2	43460568	43461328	BolC2t10428H	0	+	6	102	760	0.1342105
C2	43505963	43506476	BolC2t10429H	0	-	0	0	513	0.0000000
C2	43528811	43534348	BolC2t10430H	0	+	535	3366	5537	0.6079104
C2	43551965	43555027	BolC2t10431H	0	-	1132	2939	3062	0.9598302
C2	43572788	43577731	BolC2t10432H	0	-	1478	4273	4943	0.8644548
C2	43582483	43583308	BolC2t10433H	0	+	519	430	825	0.5212121
C2	43610574	43610790	BolC2t10434H	0	-	26	193	216	0.8935185
C2	43629693	43632566	BolC2t10435H	0	-	660	2429	2873	0.8454577
C2	43633873	43637871	BolC2t10436H	0	-	1638	3992	3998	0.9984993
C2	43717123	43718677	BolC2t10437H	0	-	45	172	1554	0.1106821
C2	43719932	43720453	BolC2t10438H	0	-	15	372	521	0.7140115
C2	43741308	43742974	BolC2t10439H	0	-	3	167	1666	0.1002401
C2	43768780	43770444	BolC2t10440H	0	+	15	188	1664	0.1129808
C2	43784904	43786130	BolC2t10441H	0	+	1336	1226	1226	1.0000000
C2	43793208	43794250	BolC2t10442H	0	-	238	766	1042	0.7351248
C2	43797855	43799136	BolC2t10443H	0	-	185	1200	1281	0.9367682
C2	43799741	43800112	BolC2t10444H	0	-	206	371	371	1.0000000
C2	43806590	43808508	BolC2t10445H	0	-	28	396	1918	0.2064651
C2	43832634	43833572	BolC2t10446H	0	+	1	73	938	0.0778252
C2	43835352	43838462	BolC2t10447H	0	+	980	2667	3110	0.8575563
C2	43841222	43841435	BolC2t10448H	0	-	43	205	213	0.9624413
C2	43880891	43884462	BolC2t10449H	0	-	1014	2888	3571	0.8087370
C2	43885101	43885320	BolC2t10450H	0	+	116	219	219	1.0000000
C2	43887045	43888687	BolC2t10451H	0	-	504	1642	1642	1.0000000
C2	43889699	43890064	BolC2t10452H	0	+	262	365	365	1.0000000
C2	43890984	43891256	BolC2t10453H	0	-	83	272	272	1.0000000
C2	43899941	43900337	BolC2t10454H	0	-	12	317	396	0.8005050
C2	43952174	43954140	BolC2t10455H	0	-	392	1844	1966	0.9379451
C2	43963690	43968712	BolC2t10456H	0	-	697	3711	5022	0.7389486
C2	43991778	43992922	BolC2t10457H	0	-	22	334	1144	0.2919580
C2	44002083	44002389	BolC2t10458H	0	+	13	271	306	0.8856209
C2	44012429	44015313	BolC2t10459H	0	-	195	1446	2884	0.5013869
C2	44089682	44090410	BolC2t10460H	0	-	175	728	728	1.0000000
C2	44123200	44123494	BolC2t10461H	0	+	137	294	294	1.0000000
C2	44124422	44124908	BolC2t10462H	0	+	252	486	486	1.0000000
C2	44131566	44133261	BolC2t10463H	0	-	396	494	1695	0.2914454
C2	44135180	44137732	BolC2t10464H	0	+	38	678	2552	0.2656740
C2	44151218	44152102	BolC2t10465H	0	-	539	752	884	0.8506787
C2	44164038	44164179	BolC2t10466H	0	-	406	141	141	1.0000000
C2	44165686	44166394	BolC2t10467H	0	-	708	708	708	1.0000000
C2	44177458	44178415	BolC2t10468H	0	-	14	52	957	0.0543365
C2	44202971	44203628	BolC2t10469H	0	-	338	657	657	1.0000000
C2	44204433	44205685	BolC2t10470H	0	-	15	138	1252	0.1102236
C2	44210519	44211233	BolC2t10471H	0	+	14	339	714	0.4747899
C2	44216304	44217141	BolC2t10472H	0	-	2007	837	837	1.0000000
C2	44228673	44231110	BolC2t10473H	0	-	8568	2437	2437	1.0000000
C2	44265770	44266928	BolC2t10474H	0	+	0	0	1158	0.0000000
C2	44269235	44269730	BolC2t10475H	0	+	2	35	495	0.0707071
C2	44269961	44270418	BolC2t10476H	0	+	0	0	457	0.0000000
C2	44272478	44273629	BolC2t10477H	0	+	148	908	1151	0.7888792
C2	44279514	44280873	BolC2t10478H	0	+	0	0	1359	0.0000000
C2	44286714	44287658	BolC2t10479H	0	+	0	0	944	0.0000000
C2	44289963	44290459	BolC2t10480H	0	+	88	234	496	0.4717742
C2	44290442	44291142	BolC2t10481H	0	+	4	265	700	0.3785714
C2	44293200	44293993	BolC2t10482H	0	+	725	752	793	0.9482976
C2	44294989	44295593	BolC2t10483H	0	+	0	0	604	0.0000000
C2	44300212	44302061	BolC2t10484H	0	+	10	343	1849	0.1855057
C2	44310270	44310805	BolC2t10485H	0	+	65	535	535	1.0000000
C2	44317056	44317529	BolC2t10486H	0	+	327	473	473	1.0000000
C2	44343004	44344976	BolC2t10487H	0	-	133	1265	1972	0.6414807
C2	44352962	44354322	BolC2t10488H	0	+	405	1360	1360	1.0000000
C2	44375584	44377067	BolC2t10489H	0	-	37	651	1483	0.4389750
C2	44380950	44381509	BolC2t10490H	0	-	997	559	559	1.0000000
C2	44406914	44407611	BolC2t10491H	0	-	494	649	697	0.9311334
C2	44449932	44450331	BolC2t10492H	0	+	33	92	399	0.2305764
C2	44464568	44466751	BolC2t10493H	0	-	311	989	2183	0.4530463
C2	44478952	44479885	BolC2t10494H	0	+	256	760	933	0.8145766
C2	44488139	44490105	BolC2t10495H	0	-	134	1070	1966	0.5442523
C2	44491632	44491794	BolC2t10496H	0	+	109	162	162	1.0000000
C2	44495263	44495437	BolC2t10497H	0	-	51	174	174	1.0000000
C2	44501424	44502428	BolC2t10498H	0	-	75	415	1004	0.4133466
C2	44504358	44507386	BolC2t10499H	0	+	467	2622	3028	0.8659181
C2	44556379	44557409	BolC2t10500H	0	+	260	678	1030	0.6582524
C2	44558693	44559459	BolC2t10501H	0	+	20	234	766	0.3054830
C2	44560152	44560386	BolC2t10502H	0	+	56	234	234	1.0000000
C2	44571761	44572454	BolC2t10503H	0	-	7	382	693	0.5512266
C2	44581819	44581948	BolC2t10504H	0	-	177	129	129	1.0000000
C2	44586618	44589171	BolC2t10505H	0	+	189	1871	2553	0.7328633
C2	44606861	44608029	BolC2t10506H	0	-	77	939	1168	0.8039383
C2	44611886	44612588	BolC2t10507H	0	-	398	633	702	0.9017094
C2	44636273	44636909	BolC2t10508H	0	+	261	604	636	0.9496855
C2	44655866	44656855	BolC2t10509H	0	-	984	989	989	1.0000000
C2	44662613	44663904	BolC2t10510H	0	-	25	330	1291	0.2556158
C2	44683445	44684595	BolC2t10511H	0	+	502	1087	1150	0.9452174
C2	44687269	44687452	BolC2t10512H	0	+	193	183	183	1.0000000
C2	44698181	44699695	BolC2t10513H	0	+	255	1360	1514	0.8982827
C2	44733484	44733823	BolC2t10514H	0	-	315	339	339	1.0000000
C2	44735986	44736327	BolC2t10515H	0	-	389	341	341	1.0000000
C2	44803943	44807481	BolC2t10516H	0	+	1163	3006	3538	0.8496326
C2	44811263	44812725	BolC2t10517H	0	+	677	1447	1462	0.9897401
C2	44825241	44825787	BolC2t10518H	0	-	411	546	546	1.0000000
C2	44826393	44834201	BolC2t10519H	0	+	2934	7253	7808	0.9289191
C2	44830921	44831503	BolC2t10520H	0	+	5	101	582	0.1735395
C2	44836060	44836234	BolC2t10521H	0	+	0	0	174	0.0000000
C2	44863496	44869525	BolC2t10522H	0	+	3638	5910	6029	0.9802620
C2	44877959	44878331	BolC2t10523H	0	-	1	38	372	0.1021505
C2	44879566	44881911	BolC2t10524H	0	-	296	1562	2345	0.6660981
C2	44890043	44891729	BolC2t10525H	0	+	288	1466	1686	0.8695136
C2	44896213	44898318	BolC2t10526H	0	-	52	1118	2105	0.5311164
C2	44900182	44901618	BolC2t10527H	0	-	309	1206	1436	0.8398328
C2	44920818	44921507	BolC2t10528H	0	+	341	689	689	1.0000000
C2	44923020	44924566	BolC2t10529H	0	-	126	1462	1546	0.9456663
C2	44953431	44954220	BolC2t10530H	0	+	206	761	789	0.9645121
C2	44971839	44971983	BolC2t10531H	0	-	0	0	144	0.0000000
C2	44993793	44994045	BolC2t10532H	0	-	2	19	252	0.0753968
C2	45027441	45027977	BolC2t10533H	0	-	389	536	536	1.0000000
C2	45034200	45035495	BolC2t10534H	0	-	492	1295	1295	1.0000000
C2	45038912	45039402	BolC2t10535H	0	+	248	490	490	1.0000000
C2	45060165	45060315	BolC2t10536H	0	+	176	150	150	1.0000000
C2	45076531	45077607	BolC2t10537H	0	-	760	1076	1076	1.0000000
C2	45114244	45114796	BolC2t10538H	0	+	30	156	552	0.2826087
C2	45152812	45157006	BolC2t10539H	0	+	1476	1580	4194	0.3767287
C2	45167395	45167815	BolC2t10540H	0	-	104	420	420	1.0000000
C2	45168027	45168471	BolC2t10541H	0	-	315	444	444	1.0000000
C2	45169237	45170376	BolC2t10542H	0	+	313	1068	1139	0.9376646
C2	45170586	45171809	BolC2t10543H	0	+	222	1223	1223	1.0000000
C2	45171917	45172226	BolC2t10544H	0	+	67	309	309	1.0000000
C2	45200496	45200796	BolC2t10545H	0	-	139	300	300	1.0000000
C2	45213140	45214215	BolC2t10546H	0	-	165	533	1075	0.4958140
C2	45218935	45220513	BolC2t10547H	0	+	92	813	1578	0.5152091
C2	45222366	45223721	BolC2t10548H	0	-	476	1203	1355	0.8878229
C2	45286012	45288944	BolC2t10549H	0	-	1721	2932	2932	1.0000000
C2	45291970	45292507	BolC2t10550H	0	+	181	537	537	1.0000000
C2	45296257	45296953	BolC2t10551H	0	+	1238	696	696	1.0000000
C2	45308237	45308384	BolC2t10552H	0	-	8	144	147	0.9795918
C2	45335307	45338944	BolC2t10553H	0	-	1964	3631	3637	0.9983503
C2	45340144	45341305	BolC2t10554H	0	+	481	1152	1161	0.9922481
C2	45341833	45342826	BolC2t10555H	0	+	12	225	993	0.2265861
C2	45356363	45358056	BolC2t10556H	0	-	31	835	1693	0.4932073
C2	45363915	45373798	BolC2t10557H	0	-	2224	6561	9883	0.6638672
C2	45376988	45380795	BolC2t10558H	0	-	604	2974	3807	0.7811925
C2	45383527	45385976	BolC2t10559H	0	+	106	1487	2449	0.6071866
C2	45386605	45389981	BolC2t10560H	0	+	734	2456	3376	0.7274882
C2	45396910	45397733	BolC2t10561H	0	+	127	753	823	0.9149453
C2	45398176	45398395	BolC2t10562H	0	-	343	219	219	1.0000000
C2	45398792	45399113	BolC2t10563H	0	-	0	0	321	0.0000000
C2	45405240	45408740	BolC2t10564H	0	+	805	3042	3500	0.8691428
C2	45406311	45407247	BolC2t10565H	0	+	158	879	936	0.9391026
C2	45433080	45434213	BolC2t10566H	0	-	287	1002	1133	0.8843778
C2	45453190	45453619	BolC2t10567H	0	-	5	83	429	0.1934732
C2	45461657	45464756	BolC2t10568H	0	+	29	381	3099	0.1229429
C2	45471074	45471531	BolC2t10569H	0	-	3	111	457	0.2428884
C2	45492385	45503206	BolC2t10570H	0	-	1221	7459	10821	0.6893078
C2	45504901	45505102	BolC2t10571H	0	+	260	201	201	1.0000000
C2	45513714	45513936	BolC2t10572H	0	+	2251	222	222	1.0000000
C2	45514880	45515174	BolC2t10573H	0	+	31828	294	294	1.0000000
C2	45516643	45516835	BolC2t10574H	0	+	206	192	192	1.0000000
C2	45516996	45517440	BolC2t10575H	0	+	779	444	444	1.0000000
C2	45520583	45520694	BolC2t10576H	0	-	16	111	111	1.0000000
C2	45521001	45521187	BolC2t10577H	0	-	2	181	186	0.9731183
C2	45525338	45525977	BolC2t10578H	0	+	82938	639	639	1.0000000
C2	45526593	45527655	BolC2t10579H	0	+	123016	1062	1062	1.0000000
C2	45528151	45529291	BolC2t10580H	0	-	599	849	1140	0.7447369
C2	45529269	45529659	BolC2t10581H	0	-	544	390	390	1.0000000
C2	45529677	45529956	BolC2t10582H	0	-	36	279	279	1.0000000
C2	45530293	45531178	BolC2t10583H	0	+	272	784	885	0.8858757
C2	45532006	45532427	BolC2t10584H	0	+	181	416	421	0.9881235
C2	45534968	45535799	BolC2t10585H	0	+	243	785	831	0.9446450
C2	45539192	45540926	BolC2t10586H	0	-	211	865	1734	0.4988466
C2	45541241	45541709	BolC2t10587H	0	-	270	468	468	1.0000000
C2	45542404	45544631	BolC2t10588H	0	-	1716	2042	2227	0.9169286
C2	45546789	45547080	BolC2t10589H	0	-	21	285	291	0.9793814
C2	45548918	45549383	BolC2t10590H	0	+	2793	465	465	1.0000000
C2	45550092	45550311	BolC2t10591H	0	-	3	129	219	0.5890411
C2	45552750	45552897	BolC2t10592H	0	+	233	147	147	1.0000000
C2	45553770	45554133	BolC2t10593H	0	+	1346	363	363	1.0000000
C2	45556129	45556462	BolC2t10594H	0	-	26461	333	333	1.0000000
C2	45556748	45556865	BolC2t10595H	0	-	1537	117	117	1.0000000
C2	45557109	45557415	BolC2t10596H	0	-	9189	306	306	1.0000000
C2	45557674	45558205	BolC2t10597H	0	-	25681	531	531	1.0000000
C2	45558805	45559036	BolC2t10598H	0	-	3	60	231	0.2597403
C2	45559149	45559575	BolC2t10599H	0	-	56	344	426	0.8075117
C2	45560836	45561295	BolC2t10600H	0	-	148	420	459	0.9150327
C2	45561493	45561811	BolC2t10601H	0	-	1	25	318	0.0786164
C2	45562574	45562841	BolC2t10602H	0	-	60	140	267	0.5243446
C2	45563830	45565216	BolC2t10603H	0	-	2491	1341	1386	0.9675325
C2	45567634	45567871	BolC2t10604H	0	-	1785	237	237	1.0000000
C2	45567953	45568493	BolC2t10605H	0	-	1655	540	540	1.0000000
C2	45570155	45570413	BolC2t10606H	0	+	1	50	258	0.1937985
C2	45609834	45610089	BolC2t10607H	0	-	0	0	255	0.0000000
C2	45621449	45621677	BolC2t10608H	0	+	230	164	228	0.7192982
C2	45624411	45624648	BolC2t10609H	0	-	2	87	237	0.3670886
C2	45626927	45627146	BolC2t10610H	0	+	24	159	219	0.7260274
C2	45627762	45628440	BolC2t10611H	0	-	31555	678	678	1.0000000
C2	45630656	45630911	BolC2t10612H	0	-	12	255	255	1.0000000
C2	45631238	45631742	BolC2t10613H	0	-	4	152	504	0.3015873
C2	45633640	45633994	BolC2t10614H	0	-	0	0	354	0.0000000
C2	45660281	45660461	BolC2t10615H	0	+	157	180	180	1.0000000
C2	45720543	45721115	BolC2t10616H	0	-	15	106	572	0.1853147
C2	45754433	45755911	BolC2t10617H	0	-	31	232	1478	0.1569689
C2	45816809	45816926	BolC2t10618H	0	-	123	117	117	1.0000000
C2	45829791	45832115	BolC2t10619H	0	+	1261	2324	2324	1.0000000
C2	45837003	45837942	BolC2t10620H	0	+	1167	939	939	1.0000000
C2	45839070	45843642	BolC2t10621H	0	+	1240	3728	4572	0.8153981
C2	45871114	45872102	BolC2t10622H	0	+	307	988	988	1.0000000
C2	45871709	45872022	BolC2t10623H	0	+	171	313	313	1.0000000
C2	45894315	45894444	BolC2t10624H	0	-	88	129	129	1.0000000
C2	45905132	45905411	BolC2t10625H	0	+	283	279	279	1.0000000
C2	45908965	45910288	BolC2t10626H	0	+	156	958	1323	0.7241119
C2	45911251	45912262	BolC2t10627H	0	-	0	0	1011	0.0000000
C2	45917710	45918421	BolC2t10628H	0	+	0	0	711	0.0000000
C2	45951816	45952179	BolC2t10629H	0	+	383	363	363	1.0000000
C2	45955608	45957598	BolC2t10630H	0	-	424	1558	1990	0.7829146
C2	45972247	45973046	BolC2t10631H	0	-	781	799	799	1.0000000
C2	45977455	45979522	BolC2t10632H	0	+	4	540	2067	0.2612482
C2	45983598	45983976	BolC2t10633H	0	-	51	378	378	1.0000000
C2	46019004	46020325	BolC2t10634H	0	+	24	326	1321	0.2467827
C2	46021307	46022333	BolC2t10635H	0	-	0	0	1026	0.0000000
C2	46032764	46033693	BolC2t10636H	0	-	85	603	929	0.6490850
C2	46050357	46067425	BolC2t10637H	0	-	2775	11284	17068	0.6611202
C2	46074203	46077344	BolC2t10638H	0	-	64	567	3141	0.1805158
C2	46096471	46097521	BolC2t10639H	0	-	145	691	1050	0.6580952
C2	46107038	46107427	BolC2t10640H	0	-	380	389	389	1.0000000
C2	46109139	46109535	BolC2t10641H	0	-	148	396	396	1.0000000
C2	46115333	46115666	BolC2t10642H	0	+	82	333	333	1.0000000
C2	46129241	46129386	BolC2t10643H	0	+	286	145	145	1.0000000
C2	46151301	46151562	BolC2t10644H	0	-	0	0	261	0.0000000
C2	46182681	46183302	BolC2t10645H	0	+	19	321	621	0.5169082
C2	46186679	46187779	BolC2t10646H	0	-	31	345	1100	0.3136364
C2	46192012	46213810	BolC2t10647H	0	-	9187	16053	21798	0.7364437
C2	46206443	46206791	BolC2t10648H	0	+	267	348	348	1.0000000
C2	46255097	46256682	BolC2t10649H	0	+	689	1585	1585	1.0000000
C2	46258328	46266728	BolC2t10650H	0	-	11572	8400	8400	1.0000000
C2	46279454	46281969	BolC2t10651H	0	-	857	2375	2515	0.9443340
C2	46298729	46299123	BolC2t10652H	0	+	198	394	394	1.0000000
C2	46312313	46312952	BolC2t10653H	0	+	0	0	639	0.0000000
C2	46316223	46318417	BolC2t10654H	0	-	217	699	2194	0.3185962
C2	46321826	46322366	BolC2t10655H	0	-	21	90	540	0.1666667
C2	46336906	46340518	BolC2t10656H	0	+	97	848	3612	0.2347730
C2	46345122	46351293	BolC2t10657H	0	-	1177	2754	6171	0.4462810
C2	46356855	46357779	BolC2t10658H	0	+	1	66	924	0.0714286
C2	46358159	46358639	BolC2t10659H	0	+	0	0	480	0.0000000
C2	46374924	46377190	BolC2t10660H	0	-	1595	2010	2266	0.8870256
C2	46377140	46377671	BolC2t10661H	0	-	5	92	531	0.1732580
C2	46396615	46397113	BolC2t10662H	0	+	0	0	498	0.0000000
C2	46414482	46416353	BolC2t10663H	0	+	415	1726	1871	0.9225013
C2	46422424	46447669	BolC2t10664H	0	-	8391	21426	25245	0.8487225
C2	46458026	46460740	BolC2t10665H	0	-	595	2350	2714	0.8658806
C2	46481769	46482033	BolC2t10666H	0	-	227	264	264	1.0000000
C2	46506608	46509314	BolC2t10667H	0	+	81	1471	2706	0.5436068
C2	46528553	46531544	BolC2t10668H	0	+	410	2656	2991	0.8879973
C2	46544037	46544220	BolC2t10669H	0	-	14	183	183	1.0000000
C2	46549773	46550452	BolC2t10670H	0	-	0	0	679	0.0000000
C2	46552857	46555287	BolC2t10671H	0	-	492	2247	2430	0.9246914
C2	46561426	46562929	BolC2t10672H	0	+	49	382	1503	0.2541583
C2	46568055	46569934	BolC2t10673H	0	-	49	909	1879	0.4837680
C2	46624519	46631720	BolC2t10674H	0	+	1697	4077	7201	0.5661713
C2	46633952	46634210	BolC2t10675H	0	+	41	201	258	0.7790698
C2	46638832	46641342	BolC2t10676H	0	+	570	1616	2510	0.6438247
C2	46641570	46642757	BolC2t10677H	0	-	478	1140	1187	0.9604044
C2	46682115	46682400	BolC2t10678H	0	-	442	285	285	1.0000000
C2	46710121	46710460	BolC2t10679H	0	-	289	339	339	1.0000000
C2	46727795	46727921	BolC2t10680H	0	+	273	126	126	1.0000000
C2	46731815	46741316	BolC2t10681H	0	+	2189	6763	9501	0.7118198
C2	46743991	46744315	BolC2t10682H	0	+	26	274	324	0.8456790
C2	46756225	46756375	BolC2t10683H	0	-	192	150	150	1.0000000
C2	46759270	46759551	BolC2t10684H	0	+	226	281	281	1.0000000
C2	46767943	46768510	BolC2t10685H	0	-	0	0	567	0.0000000
C2	46769053	46769572	BolC2t10686H	0	-	0	0	519	0.0000000
C2	46770041	46770566	BolC2t10687H	0	-	0	0	525	0.0000000
C2	46787321	46789883	BolC2t10688H	0	-	11	692	2562	0.2701015
C2	46803387	46817580	BolC2t10689H	0	-	852	6840	14193	0.4819277
C2	46820936	46821188	BolC2t10690H	0	+	27	187	252	0.7420635
C2	46823191	46823677	BolC2t10691H	0	-	284	464	486	0.9547325
C2	46832225	46833368	BolC2t10692H	0	+	2	61	1143	0.0533683
C2	46834772	46836050	BolC2t10693H	0	-	0	0	1278	0.0000000
C2	46856759	46858871	BolC2t10694H	0	-	4	44	2112	0.0208333
C2	46868266	46869385	BolC2t10695H	0	+	40	247	1119	0.2207328
C2	46869894	46871981	BolC2t10696H	0	-	306	1371	2087	0.6569238
C2	46875768	46876281	BolC2t10697H	0	+	35	513	513	1.0000000
C2	46910992	46914427	BolC2t10698H	0	+	1075	2445	3435	0.7117904
C2	46931603	46932243	BolC2t10699H	0	+	57	67	640	0.1046875
C2	46932317	46932972	BolC2t10700H	0	+	252	616	655	0.9404580
C2	46936266	46936614	BolC2t10701H	0	+	173	348	348	1.0000000
C2	46986592	46986921	BolC2t10702H	0	+	209	329	329	1.0000000
C2	46991452	46992092	BolC2t10703H	0	-	413	640	640	1.0000000
C2	47019827	47020333	BolC2t10704H	0	-	34	311	506	0.6146245
C2	47020311	47020629	BolC2t10705H	0	-	0	0	318	0.0000000
C2	47028718	47029887	BolC2t10706H	0	-	628	1169	1169	1.0000000
C2	47035962	47037717	BolC2t10707H	0	+	503	1732	1755	0.9868946
C2	47063226	47063493	BolC2t10708H	0	-	5	37	267	0.1385768
C2	47069262	47069385	BolC2t10709H	0	-	30	123	123	1.0000000
C2	47071697	47072250	BolC2t10710H	0	+	93	499	553	0.9023508
C2	47091029	47093050	BolC2t10711H	0	-	370	1946	2021	0.9628897
C2	47098464	47100576	BolC2t10712H	0	-	1232	2015	2112	0.9540720
C2	47116568	47118292	BolC2t10713H	0	+	253	946	1724	0.5487239
C2	47120498	47120744	BolC2t10714H	0	+	0	0	246	0.0000000
C2	47120876	47121779	BolC2t10715H	0	+	49	448	903	0.4961240
C2	47171960	47173268	BolC2t10716H	0	-	93	525	1308	0.4013762
C2	47175341	47175723	BolC2t10717H	0	+	531	382	382	1.0000000
C2	47190016	47193196	BolC2t10718H	0	-	70	788	3180	0.2477987
C2	47197648	47199034	BolC2t10719H	0	-	122	692	1386	0.4992785
C2	47222538	47223081	BolC2t10720H	0	-	88	244	543	0.4493554
C2	47252277	47253590	BolC2t10721H	0	-	90	911	1313	0.6938309
C2	47261592	47263794	BolC2t10722H	0	+	59	812	2202	0.3687557
C2	47264621	47267721	BolC2t10723H	0	+	1667	3083	3100	0.9945161
C2	47271900	47273346	BolC2t10724H	0	+	245	1173	1446	0.8112033
C2	47273430	47274311	BolC2t10725H	0	-	542	828	881	0.9398411
C2	47288953	47289588	BolC2t10726H	0	-	414	635	635	1.0000000
C2	47291224	47292941	BolC2t10727H	0	-	1152	1717	1717	1.0000000
C2	47313548	47316101	BolC2t10728H	0	+	497	2000	2553	0.7833921
C2	47326450	47341572	BolC2t10729H	0	-	1622	5123	15122	0.3387779
C2	47378307	47379958	BolC2t10730H	0	+	252	1651	1651	1.0000000
C2	47390383	47390762	BolC2t10731H	0	+	496	379	379	1.0000000
C2	47392801	47396867	BolC2t10732H	0	+	2038	3668	4066	0.9021151
C2	47400910	47403813	BolC2t10733H	0	-	2208	2903	2903	1.0000000
C2	47404307	47404598	BolC2t10734H	0	-	244	291	291	1.0000000
C2	47413535	47413885	BolC2t10735H	0	+	86	320	350	0.9142857
C2	47414358	47415850	BolC2t10736H	0	+	220	861	1492	0.5770777
C2	47418157	47418454	BolC2t10737H	0	+	0	0	297	0.0000000
C2	47426365	47427876	BolC2t10738H	0	+	226	985	1511	0.6518862
C2	47446929	47448379	BolC2t10739H	0	-	918	1450	1450	1.0000000
C2	47476511	47476948	BolC2t10740H	0	-	91	398	437	0.9107552
C2	47489388	47490912	BolC2t10741H	0	-	8	486	1524	0.3188976
C2	47492007	47492656	BolC2t10742H	0	+	247	649	649	1.0000000
C2	47492834	47495965	BolC2t10743H	0	-	1448	2683	3131	0.8569147
C2	47497372	47498178	BolC2t10744H	0	+	3	285	806	0.3535980
C2	47504904	47512374	BolC2t10745H	0	-	2181	5726	7470	0.7665328
C2	47507722	47508292	BolC2t10746H	0	+	559	487	570	0.8543860
C2	47513987	47535299	BolC2t10747H	0	-	4901	14262	21312	0.6692005
C2	47545493	47547538	BolC2t10748H	0	-	39	525	2045	0.2567237
C2	47555390	47555906	BolC2t10749H	0	+	1	127	516	0.2461240
C2	47556007	47557194	BolC2t10750H	0	+	4	118	1187	0.0994103
C2	47567062	47567957	BolC2t10751H	0	+	231	720	895	0.8044693
C2	47572839	47573043	BolC2t10752H	0	-	140	204	204	1.0000000
C2	47574919	47576249	BolC2t10753H	0	-	1233	1330	1330	1.0000000
C2	47577829	47578075	BolC2t10754H	0	+	234	246	246	1.0000000
C2	47578821	47582618	BolC2t10755H	0	+	514	2728	3797	0.7184619
C2	47586962	47588500	BolC2t10756H	0	-	273	1497	1538	0.9733420
C2	47602278	47602518	BolC2t10757H	0	-	30	147	240	0.6125000
C2	47604748	47605356	BolC2t10758H	0	-	156	608	608	1.0000000
C2	47614378	47615500	BolC2t10759H	0	-	215	1044	1122	0.9304813
C2	47625960	47634502	BolC2t10760H	0	-	148	1871	8542	0.2190354
C2	47642376	47647294	BolC2t10761H	0	-	543	2873	4918	0.5841805
C2	47651504	47660194	BolC2t10762H	0	+	4237	6547	8690	0.7533947
C2	47660965	47661397	BolC2t10763H	0	-	540	432	432	1.0000000
C2	47663515	47663863	BolC2t10764H	0	-	42	348	348	1.0000000
C2	47670654	47676823	BolC2t10765H	0	+	2766	5602	6169	0.9080888
C2	47678590	47681090	BolC2t10766H	0	-	1296	2500	2500	1.0000000
C2	47704535	47716485	BolC2t10767H	0	-	811	7042	11950	0.5892887
C2	47724946	47725159	BolC2t10768H	0	-	10	201	213	0.9436620
C2	47738049	47738377	BolC2t10769H	0	+	7	133	328	0.4054878
C2	47759986	47763654	BolC2t10770H	0	+	379	2500	3668	0.6815704
C2	47764782	47765457	BolC2t10771H	0	+	588	641	675	0.9496296
C2	47788369	47792031	BolC2t10772H	0	-	1090	3340	3662	0.9120699
C2	47810336	47817564	BolC2t10773H	0	+	3158	4694	7228	0.6494190
C2	47822427	47822871	BolC2t10774H	0	+	2	199	444	0.4481982
C2	47829408	47829591	BolC2t10775H	0	-	3	35	183	0.1912568
C2	47829699	47832105	BolC2t10776H	0	+	988	1625	2406	0.6753948
C2	47846354	47847670	BolC2t10777H	0	+	1983	1316	1316	1.0000000
C2	47848861	47850432	BolC2t10778H	0	+	1047	1571	1571	1.0000000
C2	47850452	47850896	BolC2t10779H	0	+	59	306	444	0.6891892
C2	47851048	47851738	BolC2t10780H	0	+	82	579	690	0.8391305
C2	47869298	47871498	BolC2t10781H	0	-	552	1750	2200	0.7954546
C2	47875181	47896123	BolC2t10782H	0	+	4607	13323	20942	0.6361856
C2	47887173	47887647	BolC2t10783H	0	+	196	474	474	1.0000000
C2	47921052	47921442	BolC2t10784H	0	-	181	390	390	1.0000000
C2	47935141	47935312	BolC2t10785H	0	-	126	171	171	1.0000000
C2	47957858	47958113	BolC2t10786H	0	-	2	76	255	0.2980392
C2	47967300	47967555	BolC2t10787H	0	-	1	24	255	0.0941176
C2	47996559	48000812	BolC2t10788H	0	+	1125	3709	4253	0.8720903
C2	48016279	48016471	BolC2t10789H	0	+	11	72	192	0.3750000
C2	48027712	48031566	BolC2t10790H	0	+	511	3404	3854	0.8832382
C2	48037967	48038594	BolC2t10791H	0	+	476	627	627	1.0000000
C2	48051403	48053900	BolC2t10792H	0	+	848	2248	2497	0.9002804
C2	48054943	48056241	BolC2t10793H	0	+	1234	1298	1298	1.0000000
C2	48065862	48068157	BolC2t10794H	0	+	1331	2295	2295	1.0000000
C2	48078415	48079011	BolC2t10795H	0	-	97	513	596	0.8607383
C2	48080020	48082313	BolC2t10796H	0	-	758	1915	2293	0.8351505
C2	48098233	48099363	BolC2t10797H	0	+	41	243	1130	0.2150442
C2	48101541	48101808	BolC2t10798H	0	-	219	267	267	1.0000000
C2	48111326	48122498	BolC2t10799H	0	-	4847	10161	11172	0.9095059
C2	48138534	48139786	BolC2t10800H	0	-	456	1223	1252	0.9768370
C2	48148449	48148977	BolC2t10801H	0	+	323	528	528	1.0000000
C2	48150371	48151216	BolC2t10802H	0	-	272	845	845	1.0000000
C2	48151813	48154262	BolC2t10803H	0	+	948	2394	2449	0.9775419
C2	48162177	48179764	BolC2t10804H	0	+	3585	15517	17587	0.8822994
C2	48163727	48164431	BolC2t10805H	0	+	162	704	704	1.0000000
C2	48165867	48166221	BolC2t10806H	0	+	17	354	354	1.0000000
C2	48171020	48171786	BolC2t10807H	0	+	47	703	766	0.9177546
C2	48173695	48174277	BolC2t10808H	0	+	8	366	582	0.6288660
C2	48183095	48184493	BolC2t10809H	0	+	1109	1398	1398	1.0000000
C2	48187647	48188061	BolC2t10810H	0	+	209	414	414	1.0000000
C2	48189208	48190466	BolC2t10811H	0	-	1035	1258	1258	1.0000000
C2	48204499	48205171	BolC2t10812H	0	-	1226	672	672	1.0000000
C2	48207092	48207469	BolC2t10813H	0	-	176	377	377	1.0000000
C2	48217138	48218471	BolC2t10814H	0	+	809	1333	1333	1.0000000
C2	48231424	48235321	BolC2t10815H	0	-	1517	3766	3897	0.9663844
C2	48261630	48264617	BolC2t10816H	0	-	785	2903	2987	0.9718781
C2	48268352	48268760	BolC2t10817H	0	+	99	347	408	0.8504902
C2	48284677	48285608	BolC2t10818H	0	+	145	825	931	0.8861439
C2	48292422	48292761	BolC2t10819H	0	+	201	257	339	0.7581121
C2	48300248	48301319	BolC2t10820H	0	-	269	881	1071	0.8225957
C2	48308492	48309465	BolC2t10821H	0	-	118	740	973	0.7605344
C2	48316952	48317111	BolC2t10822H	0	+	156	159	159	1.0000000
C2	48325565	48329489	BolC2t10823H	0	+	914	2870	3924	0.7313966
C2	48339810	48340311	BolC2t10824H	0	+	441	501	501	1.0000000
C2	48358319	48358598	BolC2t10825H	0	-	450	279	279	1.0000000
C2	48367237	48370132	BolC2t10826H	0	-	835	2652	2895	0.9160622
C2	48370430	48371100	BolC2t10827H	0	-	345	670	670	1.0000000
C2	48377149	48377975	BolC2t10828H	0	+	161	811	826	0.9818402
C2	48379331	48390091	BolC2t10829H	0	-	4900	10648	10760	0.9895911
C2	48390125	48390410	BolC2t10830H	0	-	147	285	285	1.0000000
C2	48390462	48390912	BolC2t10831H	0	-	371	450	450	1.0000000
C2	48407119	48407395	BolC2t10832H	0	+	158	276	276	1.0000000
C2	48407743	48409331	BolC2t10833H	0	-	1197	1588	1588	1.0000000
C2	48418076	48418217	BolC2t10834H	0	+	3	40	141	0.2836879
C2	48419371	48419587	BolC2t10835H	0	-	34	183	216	0.8472222
C2	48441395	48442407	BolC2t10836H	0	-	9	324	1012	0.3201581
C2	48449593	48452844	BolC2t10837H	0	+	537	2894	3251	0.8901876
C2	48457919	48458170	BolC2t10838H	0	-	190	251	251	1.0000000
C2	48468438	48470434	BolC2t10839H	0	+	487	1529	1996	0.7660320
C2	48470929	48471466	BolC2t10840H	0	-	18	335	537	0.6238361
C2	48483348	48483877	BolC2t10841H	0	+	219	493	529	0.9319471
C2	48492051	48493223	BolC2t10842H	0	+	124	839	1172	0.7158703
C2	48506982	48507695	BolC2t10843H	0	+	249	703	713	0.9859747
C2	48529682	48530054	BolC2t10844H	0	+	104	358	372	0.9623656
C2	48533633	48534214	BolC2t10845H	0	+	18	359	581	0.6179002
C2	48535343	48535871	BolC2t10846H	0	-	156	528	528	1.0000000
C2	48540704	48541232	BolC2t10847H	0	+	105	528	528	1.0000000
C2	48552166	48553123	BolC2t10848H	0	-	405	957	957	1.0000000
C2	48558257	48560970	BolC2t10849H	0	-	3400	2713	2713	1.0000000
C2	48562896	48563472	BolC2t10850H	0	-	88	253	576	0.4392361
C2	48574973	48575295	BolC2t10851H	0	+	260	322	322	1.0000000
C2	48594905	48595901	BolC2t10852H	0	-	57	105	996	0.1054217
C2	48611035	48617897	BolC2t10853H	0	+	858	5608	6862	0.8172544
C2	48619818	48621261	BolC2t10854H	0	+	879	1395	1443	0.9667360
C2	48638278	48638844	BolC2t10855H	0	-	246	566	566	1.0000000
C2	48675926	48676220	BolC2t10856H	0	-	0	0	294	0.0000000
C2	48682870	48683999	BolC2t10857H	0	+	281	980	1129	0.8680248
C2	48703376	48706243	BolC2t10858H	0	+	970	2625	2867	0.9155912
C2	48709510	48709962	BolC2t10859H	0	-	614	452	452	1.0000000
C2	48711597	48713624	BolC2t10860H	0	+	1338	2027	2027	1.0000000
C2	48717245	48719982	BolC2t10861H	0	-	320	1825	2737	0.6667885
C2	48736853	48737090	BolC2t10862H	0	-	587	237	237	1.0000000
C2	48772792	48773602	BolC2t10863H	0	+	532	810	810	1.0000000
C2	48774379	48776104	BolC2t10864H	0	-	1001	1725	1725	1.0000000
C2	48776670	48776988	BolC2t10865H	0	-	306	318	318	1.0000000
C2	48795006	48796472	BolC2t10866H	0	-	400	1247	1466	0.8506139
C2	48797455	48798766	BolC2t10867H	0	-	359	1071	1311	0.8169336
C2	48799225	48800929	BolC2t10868H	0	-	703	1598	1704	0.9377934
C2	48802085	48809971	BolC2t10869H	0	-	31542	7515	7886	0.9529546
C2	48811024	48812248	BolC2t10870H	0	+	790	1224	1224	1.0000000
C2	48820914	48822836	BolC2t10871H	0	+	1346	1922	1922	1.0000000
C2	48823437	48824372	BolC2t10872H	0	-	575	903	935	0.9657754
C2	48825140	48827352	BolC2t10873H	0	+	905	2212	2212	1.0000000
C2	48827877	48828551	BolC2t10874H	0	+	346	674	674	1.0000000
C2	48829200	48829532	BolC2t10875H	0	+	301	332	332	1.0000000
C2	48830988	48831354	BolC2t10876H	0	+	102	366	366	1.0000000
C2	48839049	48839493	BolC2t10877H	0	+	179	444	444	1.0000000
C2	48840854	48841707	BolC2t10878H	0	+	173	825	853	0.9671746
C2	48841830	48842622	BolC2t10879H	0	+	130	792	792	1.0000000
C2	48845833	48846041	BolC2t10880H	0	+	2	201	208	0.9663461
C2	48852433	48853923	BolC2t10881H	0	+	879	1490	1490	1.0000000
C2	48861841	48863782	BolC2t10882H	0	+	954	1918	1941	0.9881504
C2	48866724	48867903	BolC2t10883H	0	+	158	890	1179	0.7548770
C2	48873078	48873930	BolC2t10884H	0	+	237	707	852	0.8298122
C2	48876046	48877665	BolC2t10885H	0	-	740	1528	1619	0.9437925
C2	48892700	48893004	BolC2t10886H	0	-	10	89	304	0.2927631
C2	48892755	48907359	BolC2t10887H	0	-	3453	10422	14604	0.7136401
C2	48921503	48922751	BolC2t10888H	0	+	563	1248	1248	1.0000000
C2	48923184	48925066	BolC2t10889H	0	-	388	1813	1882	0.9633369
C2	48934159	48935812	BolC2t10890H	0	+	0	0	1653	0.0000000
C2	48942392	48943094	BolC2t10891H	0	-	13	173	702	0.2464387
C2	48961636	48961921	BolC2t10892H	0	-	12	147	285	0.5157894
C2	48964351	48964780	BolC2t10893H	0	+	0	0	429	0.0000000
C2	48971632	48972223	BolC2t10894H	0	-	69	495	591	0.8375635
C2	48974471	48974678	BolC2t10895H	0	-	0	0	207	0.0000000
C2	49005977	49006568	BolC2t10896H	0	-	173	591	591	1.0000000
C2	49013577	49013796	BolC2t10897H	0	-	0	0	219	0.0000000
C2	49029647	49030238	BolC2t10898H	0	-	26	494	591	0.8358714
C2	49037312	49037531	BolC2t10899H	0	-	0	0	219	0.0000000
C2	49053386	49053977	BolC2t10900H	0	-	40	559	591	0.9458545
C2	49055549	49056003	BolC2t10901H	0	-	377	454	454	1.0000000
C2	49058076	49058490	BolC2t10902H	0	+	42	412	414	0.9951691
C2	49065059	49065644	BolC2t10903H	0	-	4	237	585	0.4051282
C2	49080232	49080508	BolC2t10904H	0	-	0	0	276	0.0000000
C2	49082950	49083379	BolC2t10905H	0	+	9	276	429	0.6433566
C2	49086318	49086603	BolC2t10906H	0	+	0	0	285	0.0000000
C2	49099140	49100567	BolC2t10907H	0	+	2	131	1427	0.0918010
C2	49110644	49111311	BolC2t10908H	0	+	0	0	667	0.0000000
C2	49114960	49115179	BolC2t10909H	0	-	3	56	219	0.2557078
C2	49131410	49131512	BolC2t10910H	0	-	150	102	102	1.0000000
C2	49141175	49141742	BolC2t10911H	0	-	4	177	567	0.3121693
C2	49148108	49148510	BolC2t10912H	0	-	0	0	402	0.0000000
C2	49149055	49149826	BolC2t10913H	0	-	0	0	771	0.0000000
C2	49158234	49159855	BolC2t10914H	0	-	2	19	1621	0.0117212
C2	49160722	49161205	BolC2t10915H	0	+	0	0	483	0.0000000
C2	49163944	49164130	BolC2t10916H	0	+	0	0	186	0.0000000
C2	49164647	49164782	BolC2t10917H	0	+	0	0	135	0.0000000
C2	49167005	49167560	BolC2t10918H	0	+	4	19	555	0.0342342
C2	49178563	49190360	BolC2t10919H	0	+	1199	9460	11797	0.8018988
C2	49191362	49192176	BolC2t10920H	0	+	18	201	814	0.2469288
C2	49268054	49268788	BolC2t10921H	0	+	204	718	734	0.9782016
C2	49269134	49272279	BolC2t10922H	0	+	35	204	3145	0.0648649
C2	49278088	49279081	BolC2t10923H	0	+	58	679	993	0.6837865
C2	49279541	49281030	BolC2t10924H	0	+	22	61	1489	0.0409671
C2	49307360	49307972	BolC2t10925H	0	-	0	0	612	0.0000000
C2	49339266	49339744	BolC2t10926H	0	+	0	0	478	0.0000000
C2	49350472	49351285	BolC2t10927H	0	+	2	131	813	0.1611316
C2	49352825	49353767	BolC2t10928H	0	+	39	570	942	0.6050956
C2	49386372	49387658	BolC2t10929H	0	+	10	346	1286	0.2690513
C2	49391812	49397318	BolC2t10930H	0	+	17	405	5506	0.0735561
C2	49415064	49415331	BolC2t10931H	0	+	5	98	267	0.3670412
C2	49426417	49426681	BolC2t10932H	0	+	5	264	264	1.0000000
C2	49427362	49427998	BolC2t10933H	0	-	330	636	636	1.0000000
C2	49428432	49434928	BolC2t10934H	0	-	28772	6271	6496	0.9653633
C2	49442824	49443415	BolC2t10935H	0	-	19	488	591	0.8257191
C2	49454311	49454918	BolC2t10936H	0	+	4	160	607	0.2635914
C2	49473710	49474226	BolC2t10937H	0	+	0	0	516	0.0000000
C2	49474490	49474838	BolC2t10938H	0	+	0	0	348	0.0000000
C2	49493555	49510759	BolC2t10939H	0	+	1749	12240	17204	0.7114624
C2	49510919	49511585	BolC2t10940H	0	+	61	459	666	0.6891892
C2	49534366	49537039	BolC2t10941H	0	+	1104	2084	2673	0.7796484
C2	49587943	49588174	BolC2t10942H	0	-	5	171	231	0.7402598
C2	49616131	49616313	BolC2t10943H	0	-	2	19	182	0.1043956
C2	49616749	49617143	BolC2t10944H	0	-	0	0	394	0.0000000
C2	49620382	49623606	BolC2t10945H	0	+	973	2140	3224	0.6637717
C2	49627726	49630514	BolC2t10946H	0	+	273	944	2788	0.3385940
C2	49631648	49632451	BolC2t10947H	0	+	1	16	803	0.0199253
C2	49642061	49643159	BolC2t10948H	0	+	13	172	1098	0.1566485
C2	49678756	49679281	BolC2t10949H	0	+	0	0	525	0.0000000
C2	49680376	49680865	BolC2t10950H	0	+	10	276	489	0.5644172
C2	49710310	49710523	BolC2t10951H	0	-	0	0	213	0.0000000
C2	49713080	49714076	BolC2t10952H	0	+	96	618	996	0.6204819
C2	49722272	49722377	BolC2t10953H	0	-	1	46	105	0.4380952
C2	49742707	49742914	BolC2t10954H	0	-	0	0	207	0.0000000
C2	49755960	49757090	BolC2t10955H	0	-	931	1130	1130	1.0000000
C2	49762433	49763768	BolC2t10956H	0	+	262	1001	1335	0.7498127
C2	49764761	49766606	BolC2t10957H	0	+	981	1779	1845	0.9642276
C2	49766911	49768926	BolC2t10958H	0	-	627	1820	2015	0.9032258
C2	49787300	49788625	BolC2t10959H	0	-	111	595	1325	0.4490566
C2	49792184	49792600	BolC2t10960H	0	+	322	416	416	1.0000000
C2	49793799	49795551	BolC2t10961H	0	-	845	1752	1752	1.0000000
C2	49796674	49796884	BolC2t10962H	0	+	35	193	210	0.9190476
C2	49798825	49800449	BolC2t10963H	0	-	118	1062	1624	0.6539409
C2	49810726	49812003	BolC2t10964H	0	+	579	1223	1277	0.9577134
C2	49812469	49813218	BolC2t10965H	0	-	50	519	749	0.6929239
C2	49818685	49820186	BolC2t10966H	0	+	256	1191	1501	0.7934710
C2	49820652	49822744	BolC2t10967H	0	-	1431	2092	2092	1.0000000
C2	49831855	49832195	BolC2t10968H	0	-	151	340	340	1.0000000
C2	49832161	49832500	BolC2t10969H	0	-	175	331	339	0.9764012
C2	49835431	49838833	BolC2t10970H	0	-	1325	2741	3402	0.8057025
C2	49841294	49842660	BolC2t10971H	0	-	818	1366	1366	1.0000000
C2	49843615	49844137	BolC2t10972H	0	-	124	439	522	0.8409961
C2	49844846	49846302	BolC2t10973H	0	-	372	1443	1456	0.9910714
C2	49850105	49852237	BolC2t10974H	0	-	23	680	2132	0.3189493
C2	49864859	49867222	BolC2t10975H	0	+	675	1664	2363	0.7041896
C2	49869755	49870313	BolC2t10976H	0	+	332	558	558	1.0000000
C2	49870648	49872175	BolC2t10977H	0	-	1205	1527	1527	1.0000000
C2	49873028	49915657	BolC2t10978H	0	+	12596	33165	42629	0.7779915
C2	49876564	49877685	BolC2t10979H	0	+	69	756	1121	0.6743979
C2	49881570	49882245	BolC2t10980H	0	-	395	675	675	1.0000000
C2	49884140	49892881	BolC2t10981H	0	+	2884	7859	8741	0.8990962
C2	49894038	49895233	BolC2t10982H	0	+	316	1047	1195	0.8761506
C2	49898467	49900482	BolC2t10983H	0	-	457	1694	2015	0.8406948
C2	49908818	49910300	BolC2t10984H	0	+	257	1278	1482	0.8623482
C2	49924004	49924868	BolC2t10985H	0	+	19	448	864	0.5185185
C2	49930622	49931195	BolC2t10986H	0	-	337	531	573	0.9267015
C2	49942421	49944316	BolC2t10987H	0	+	320	1628	1895	0.8591029
C2	49953461	49955281	BolC2t10988H	0	+	121	973	1820	0.5346154
C2	49974805	49978486	BolC2t10989H	0	+	751	3082	3681	0.8372725
C2	49982107	49985491	BolC2t10990H	0	+	348	2529	3384	0.7473404
C2	49996944	49998278	BolC2t10991H	0	-	496	1334	1334	1.0000000
C2	49999353	50000749	BolC2t10992H	0	+	1121	1396	1396	1.0000000
C2	50001656	50002828	BolC2t10993H	0	+	331	1172	1172	1.0000000
C2	50003345	50004101	BolC2t10994H	0	-	273	756	756	1.0000000
C2	50004255	50005362	BolC2t10995H	0	+	152	920	1107	0.8310750
C2	50008198	50008894	BolC2t10996H	0	+	220	696	696	1.0000000
C2	50013037	50014361	BolC2t10997H	0	-	318	1312	1324	0.9909366
C2	50014756	50016858	BolC2t10998H	0	+	745	2004	2102	0.9533777
C2	50017345	50019016	BolC2t10999H	0	-	524	1563	1671	0.9353681
C2	50027734	50028193	BolC2t11000H	0	+	224	459	459	1.0000000
C2	50038161	50040457	BolC2t11001H	0	-	627	1756	2296	0.7648084
C2	50050236	50050437	BolC2t11002H	0	-	184	201	201	1.0000000
C2	50056792	50056918	BolC2t11003H	0	+	215	126	126	1.0000000
C2	50112762	50113506	BolC2t11004H	0	-	61	625	744	0.8400537
C2	50113894	50113999	BolC2t11005H	0	-	68	105	105	1.0000000
C2	50126763	50127833	BolC2t11006H	0	-	469	1070	1070	1.0000000
C2	50139269	50140301	BolC2t11007H	0	-	242	1019	1032	0.9874031
C2	50151259	50151628	BolC2t11008H	0	-	3	235	369	0.6368564
C2	50158026	50159323	BolC2t11009H	0	-	334	1207	1297	0.9306091
C2	50165830	50165980	BolC2t11010H	0	-	148	150	150	1.0000000
C2	50168491	50181863	BolC2t11011H	0	-	3635	11448	13372	0.8561172
C2	50169960	50170793	BolC2t11012H	0	+	194	750	833	0.9003602
C2	50178788	50179622	BolC2t11013H	0	+	66	771	834	0.9244604
C2	50191973	50192329	BolC2t11014H	0	-	297	356	356	1.0000000
C2	50193794	50195861	BolC2t11015H	0	-	897	1995	2067	0.9651669
C2	50205689	50208557	BolC2t11016H	0	+	1096	2461	2868	0.8580893
C2	50208935	50210041	BolC2t11017H	0	-	280	978	1106	0.8842676
C2	50212185	50212989	BolC2t11018H	0	-	280	756	804	0.9402985
C2	50217235	50218614	BolC2t11019H	0	-	271	1290	1379	0.9354605
C2	50220850	50221309	BolC2t11020H	0	-	112	355	459	0.7734205
C2	50223187	50226425	BolC2t11021H	0	-	950	2983	3238	0.9212477
C2	50227990	50229067	BolC2t11022H	0	+	363	983	1077	0.9127205
C2	50236439	50237017	BolC2t11023H	0	-	158	525	578	0.9083045
C2	50237201	50237733	BolC2t11024H	0	+	442	532	532	1.0000000
C2	50271125	50272589	BolC2t11025H	0	+	614	1454	1464	0.9931694
C2	50272893	50274621	BolC2t11026H	0	-	1490	1728	1728	1.0000000
C2	50286362	50286608	BolC2t11027H	0	+	30	216	246	0.8780488
C2	50292161	50292332	BolC2t11028H	0	-	81	171	171	1.0000000
C2	50301987	50302167	BolC2t11029H	0	+	108	180	180	1.0000000
C2	50303204	50303444	BolC2t11030H	0	-	594	240	240	1.0000000
C2	50307337	50308284	BolC2t11031H	0	+	681	937	947	0.9894403
C2	50327957	50330616	BolC2t11032H	0	-	1242	2495	2659	0.9383227
C2	50344506	50346879	BolC2t11033H	0	-	853	2351	2373	0.9907290
C2	50348837	50359238	BolC2t11034H	0	-	8007	9770	10401	0.9393328
C2	50374188	50379623	BolC2t11035H	0	+	1869	3838	5435	0.7061638
C2	50380111	50382267	BolC2t11036H	0	-	754	2102	2156	0.9749536
C2	50402538	50405494	BolC2t11037H	0	+	1965	2838	2956	0.9600812
C2	50408234	50410242	BolC2t11038H	0	+	777	2008	2008	1.0000000
C2	50414735	50415059	BolC2t11039H	0	-	48	324	324	1.0000000
C2	50428398	50429010	BolC2t11040H	0	+	394	612	612	1.0000000
C2	50433778	50434145	BolC2t11041H	0	+	30	201	367	0.5476839
C2	50436498	50438603	BolC2t11042H	0	-	348	1807	2105	0.8584323
C2	50439026	50439416	BolC2t11043H	0	+	366	390	390	1.0000000
C2	50440939	50441131	BolC2t11044H	0	+	52	176	192	0.9166667
C2	50441191	50441545	BolC2t11045H	0	+	365	354	354	1.0000000
C2	50443687	50444011	BolC2t11046H	0	+	10	104	324	0.3209876
C2	50478013	50478789	BolC2t11047H	0	-	414	776	776	1.0000000
C2	50483875	50485298	BolC2t11048H	0	-	121	758	1423	0.5326775
C2	50504984	50505772	BolC2t11049H	0	+	0	0	788	0.0000000
C2	50517051	50517838	BolC2t11050H	0	+	2	172	787	0.2185515
C2	50537767	50538095	BolC2t11051H	0	-	30	297	328	0.9054878
C2	50545050	50545835	BolC2t11052H	0	-	7	185	785	0.2356688
C2	50548438	50549260	BolC2t11053H	0	-	9	198	822	0.2408759
C2	50551649	50552316	BolC2t11054H	0	+	95	529	667	0.7931035
C2	50553558	50555115	BolC2t11055H	0	-	102	1227	1557	0.7880539
C2	50559357	50562378	BolC2t11056H	0	+	1574	2907	3021	0.9622642
C2	50562878	50563409	BolC2t11057H	0	+	314	516	531	0.9717514
C2	50563711	50564673	BolC2t11058H	0	+	883	962	962	1.0000000
C2	50567290	50567914	BolC2t11059H	0	-	78	580	624	0.9294872
C2	50570755	50571848	BolC2t11060H	0	+	442	983	1093	0.8993596
C2	50580458	50581525	BolC2t11061H	0	+	533	1046	1067	0.9803187
C2	50581882	50584226	BolC2t11062H	0	-	476	1875	2344	0.7999147
C2	50585542	50586648	BolC2t11063H	0	+	409	1004	1106	0.9077758
C2	50587893	50588867	BolC2t11064H	0	-	20	190	974	0.1950719
C2	50613607	50618124	BolC2t11065H	0	-	537	1908	4517	0.4224043
C2	50629813	50630767	BolC2t11066H	0	+	270	930	954	0.9748428
C2	50631771	50636708	BolC2t11067H	0	-	2172	4152	4937	0.8409966
C2	50637224	50640235	BolC2t11068H	0	+	457	1839	3011	0.6107606
C2	50648641	50650072	BolC2t11069H	0	+	134	887	1431	0.6198463
C2	50660818	50662788	BolC2t11070H	0	+	596	1740	1970	0.8832487
C2	50665369	50667718	BolC2t11071H	0	-	1164	1959	2349	0.8339719
C2	50680894	50681705	BolC2t11072H	0	+	174	705	811	0.8692971
C2	50700053	50701454	BolC2t11073H	0	+	419	1272	1401	0.9079229
C2	50704816	50706285	BolC2t11074H	0	-	282	757	1469	0.5153165
C2	50743605	50746587	BolC2t11075H	0	-	617	2375	2982	0.7964453
C2	50767937	50768094	BolC2t11076H	0	-	427	157	157	1.0000000
C2	50769537	50770140	BolC2t11077H	0	+	444	603	603	1.0000000
C2	50871027	50878111	BolC2t11078H	0	+	316	1755	7084	0.2477414
C2	50883504	50883867	BolC2t11079H	0	-	416	363	363	1.0000000
C2	50889960	50894683	BolC2t11080H	0	-	2165	4687	4723	0.9923777
C2	50954836	50955079	BolC2t11081H	0	-	183	243	243	1.0000000
C2	50965573	50968645	BolC2t11082H	0	+	1037	2801	3072	0.9117839
C2	50980672	50980960	BolC2t11083H	0	+	237	288	288	1.0000000
C2	50985395	50985762	BolC2t11084H	0	+	442	367	367	1.0000000
C2	50995445	50997921	BolC2t11085H	0	+	786	2184	2476	0.8820679
C2	51015453	51016155	BolC2t11086H	0	-	315	702	702	1.0000000
C2	51016201	51016774	BolC2t11087H	0	-	237	573	573	1.0000000
C2	51019748	51022262	BolC2t11088H	0	-	1958	2514	2514	1.0000000
C2	51023330	51024439	BolC2t11089H	0	+	269	1086	1109	0.9792606
C2	51030127	51031089	BolC2t11090H	0	+	656	962	962	1.0000000
C2	51059485	51060998	BolC2t11091H	0	-	630	1416	1513	0.9358889
C2	51135643	51138069	BolC2t11092H	0	-	263	1652	2426	0.6809563
C2	51156212	51156524	BolC2t11093H	0	+	17	43	312	0.1378205
C2	51157457	51159770	BolC2t11094H	0	+	827	1654	2313	0.7150886
C2	51161303	51161486	BolC2t11095H	0	-	319	183	183	1.0000000
C2	51167784	51168060	BolC2t11096H	0	+	410	276	276	1.0000000
C2	51187614	51189637	BolC2t11097H	0	+	197	1664	2023	0.8225408
C2	51199350	51203797	BolC2t11098H	0	+	1466	3283	4447	0.7382505
C2	51223942	51224736	BolC2t11099H	0	-	8	80	794	0.1007557
C2	51234107	51236953	BolC2t11100H	0	-	111	680	2846	0.2389318
C2	51266385	51266664	BolC2t11101H	0	-	806	279	279	1.0000000
C2	51309002	51309520	BolC2t11102H	0	+	17	231	518	0.4459459
C2	51323148	51323695	BolC2t11103H	0	-	365	547	547	1.0000000
C2	51357478	51368350	BolC2t11104H	0	+	3101	9085	10872	0.8356328
C2	51383532	51384144	BolC2t11105H	0	+	37	476	612	0.7777778
C2	51386511	51387040	BolC2t11106H	0	+	209	529	529	1.0000000
C2	51396638	51397470	BolC2t11107H	0	+	711	832	832	1.0000000
C2	51413556	51413994	BolC2t11108H	0	-	4	268	438	0.6118721
C2	51417295	51418711	BolC2t11109H	0	-	727	1416	1416	1.0000000
C2	51418728	51418962	BolC2t11110H	0	+	253	234	234	1.0000000
C2	51422222	51422489	BolC2t11111H	0	-	30	203	267	0.7602996
C2	51423894	51425922	BolC2t11112H	0	-	599	1953	2028	0.9630178
C2	51435473	51435917	BolC2t11113H	0	-	373	444	444	1.0000000
C2	51436679	51438686	BolC2t11114H	0	+	1734	1989	2007	0.9910314
C2	51451126	51453943	BolC2t11115H	0	-	363	2165	2817	0.7685481
C2	51460286	51461438	BolC2t11116H	0	-	247	1152	1152	1.0000000
C2	51472199	51473886	BolC2t11117H	0	-	425	1417	1687	0.8399526
C2	51476034	51476446	BolC2t11118H	0	-	559	412	412	1.0000000
C2	51478917	51482267	BolC2t11119H	0	+	1077	2544	3350	0.7594030
C2	51486076	51488896	BolC2t11120H	0	-	335	1623	2820	0.5755319
C2	51499595	51499923	BolC2t11121H	0	+	143	328	328	1.0000000
C2	51506533	51506881	BolC2t11122H	0	-	992	348	348	1.0000000
C2	51509715	51510202	BolC2t11123H	0	+	0	0	487	0.0000000
C2	51514869	51530953	BolC2t11124H	0	-	4293	12133	16084	0.7543522
C2	51534773	51543383	BolC2t11125H	0	-	3584	8084	8610	0.9389082
C2	51543316	51543527	BolC2t11126H	0	-	20	211	211	1.0000000
C2	51545709	51547210	BolC2t11127H	0	-	501	1168	1501	0.7781479
C2	51554162	51555391	BolC2t11128H	0	+	569	1217	1229	0.9902360
C2	51572961	51581390	BolC2t11129H	0	+	2970	6676	8429	0.7920275
C2	51592134	51593904	BolC2t11130H	0	-	1257	1770	1770	1.0000000
C2	51621905	51622154	BolC2t11131H	0	+	12	249	249	1.0000000
C2	51623351	51623645	BolC2t11132H	0	+	4	165	294	0.5612245
C2	51627674	51627968	BolC2t11133H	0	-	146	294	294	1.0000000
C2	51628718	51629054	BolC2t11134H	0	+	27	232	336	0.6904762
C2	51630300	51630501	BolC2t11135H	0	-	85	201	201	1.0000000
C2	51630691	51631966	BolC2t11136H	0	+	562	1275	1275	1.0000000
C2	51649292	51649994	BolC2t11137H	0	+	63	702	702	1.0000000
C2	51669754	51672357	BolC2t11138H	0	+	1129	1776	2603	0.6822897
C2	51681354	51682417	BolC2t11139H	0	+	564	949	1063	0.8927563
C2	51684708	51685799	BolC2t11140H	0	+	56	650	1091	0.5957837
C2	51686259	51686427	BolC2t11141H	0	+	20	164	168	0.9761904
C2	51689777	51690328	BolC2t11142H	0	+	9	177	551	0.3212341
C2	51691420	51693500	BolC2t11143H	0	-	21	874	2080	0.4201923
C2	51694083	51695285	BolC2t11144H	0	-	68	1090	1202	0.9068220
C2	51704645	51706696	BolC2t11145H	0	+	1302	2051	2051	1.0000000
C2	51721317	51721681	BolC2t11146H	0	+	496	364	364	1.0000000
C2	51732237	51736391	BolC2t11147H	0	+	1915	3958	4154	0.9528165
C2	51737596	51739504	BolC2t11148H	0	-	171	1474	1908	0.7725367
C2	51739794	51740013	BolC2t11149H	0	+	11	152	219	0.6940639
C2	51746688	51747499	BolC2t11150H	0	+	61	562	811	0.6929716
C2	51779735	51780632	BolC2t11151H	0	+	287	854	897	0.9520624
C2	51786221	51787376	BolC2t11152H	0	+	18	294	1155	0.2545455
C2	51800588	51800693	BolC2t11153H	0	-	0	0	105	0.0000000
C2	51800762	51801061	BolC2t11154H	0	-	0	0	299	0.0000000
C2	51808124	51809022	BolC2t11155H	0	+	422	898	898	1.0000000
C2	51812372	51815109	BolC2t11156H	0	+	0	0	2737	0.0000000
C2	51816598	51819290	BolC2t11157H	0	+	8	383	2692	0.1422734
C2	51825930	51838211	BolC2t11158H	0	-	10162	10639	12281	0.8662975
C2	51854211	51854622	BolC2t11159H	0	-	39	366	411	0.8905110
C2	51891044	51891326	BolC2t11160H	0	+	16	158	282	0.5602837
C2	51902014	51902911	BolC2t11161H	0	+	134	681	897	0.7591973
C2	51910005	51916893	BolC2t11162H	0	+	271	3188	6888	0.4628339
C2	51924570	51925551	BolC2t11163H	0	+	1	35	981	0.0356779
C2	51947349	51950385	BolC2t11164H	0	-	908	2355	3036	0.7756917
C2	51952656	51955567	BolC2t11165H	0	+	586	2620	2911	0.9000344
C2	51956842	51957961	BolC2t11166H	0	+	185	1022	1119	0.9133155
C2	51960198	51960528	BolC2t11167H	0	-	108	330	330	1.0000000
C2	51964734	51965485	BolC2t11168H	0	-	31	519	751	0.6910785
C2	51966364	51967083	BolC2t11169H	0	+	31	133	719	0.1849791
C2	51967742	51968160	BolC2t11170H	0	+	320	418	418	1.0000000
C2	51974239	51974491	BolC2t11171H	0	-	120	252	252	1.0000000
C2	51975488	51978025	BolC2t11172H	0	-	483	2087	2537	0.8226252
C2	51980109	51980431	BolC2t11173H	0	+	94	322	322	1.0000000
C2	51980809	51981501	BolC2t11174H	0	-	382	692	692	1.0000000
C2	51982692	51983465	BolC2t11175H	0	+	507	773	773	1.0000000
C2	51982914	51983353	BolC2t11176H	0	+	301	439	439	1.0000000
C2	52001431	52003535	BolC2t11177H	0	+	52	1076	2104	0.5114068
C2	52005321	52006160	BolC2t11178H	0	+	375	839	839	1.0000000
C2	52007277	52007982	BolC2t11179H	0	-	452	635	705	0.9007092
C2	52010160	52010265	BolC2t11180H	0	+	24	105	105	1.0000000
C2	52011845	52013966	BolC2t11181H	0	+	464	2113	2121	0.9962282
C2	52014579	52016724	BolC2t11182H	0	-	433	2010	2145	0.9370629
C2	52025274	52027073	BolC2t11183H	0	+	596	1773	1799	0.9855475
C2	52028444	52030621	BolC2t11184H	0	-	880	2066	2177	0.9490124
C2	52056674	52057984	BolC2t11185H	0	+	8	535	1310	0.4083970
C2	52061795	52067153	BolC2t11186H	0	-	3018	5259	5358	0.9815230
C2	52069877	52072486	BolC2t11187H	0	-	1021	2109	2609	0.8083557
C2	52076266	52076603	BolC2t11188H	0	+	4	272	337	0.8071216
C2	52096443	52097787	BolC2t11189H	0	+	420	1335	1344	0.9933036
C2	52099284	52101192	BolC2t11190H	0	+	1303	1908	1908	1.0000000
C2	52102382	52104736	BolC2t11191H	0	-	1223	2354	2354	1.0000000
C2	52107696	52108923	BolC2t11192H	0	-	143	1083	1227	0.8826406
C2	52129506	52130355	BolC2t11193H	0	+	5	232	849	0.2732626
C2	52135016	52136840	BolC2t11194H	0	+	887	1824	1824	1.0000000
C2	52141404	52142405	BolC2t11195H	0	+	270	815	1001	0.8141858
C2	52147911	52148034	BolC2t11196H	0	+	221	123	123	1.0000000
C2	52156388	52157398	BolC2t11197H	0	-	592	1010	1010	1.0000000
C2	52160959	52161549	BolC2t11198H	0	-	48	465	590	0.7881356
C2	52173490	52173985	BolC2t11199H	0	+	190	460	495	0.9292929
C2	52192727	52194965	BolC2t11200H	0	+	1711	2238	2238	1.0000000
C2	52195759	52196318	BolC2t11201H	0	+	569	559	559	1.0000000
C2	52196586	52196853	BolC2t11202H	0	+	218	267	267	1.0000000
C2	52198121	52199573	BolC2t11203H	0	+	946	1452	1452	1.0000000
C2	52207950	52217732	BolC2t11204H	0	+	6680	9782	9782	1.0000000
C2	52218200	52222131	BolC2t11205H	0	-	1465	3613	3931	0.9191046
C2	52252181	52252310	BolC2t11206H	0	+	142	129	129	1.0000000
C2	52255170	52256106	BolC2t11207H	0	+	0	0	936	0.0000000
C2	52260325	52260936	BolC2t11208H	0	-	305	611	611	1.0000000
C2	52263116	52263437	BolC2t11209H	0	-	78	321	321	1.0000000
C2	52274357	52278236	BolC2t11210H	0	+	1368	3251	3879	0.8381026
C2	52302323	52302993	BolC2t11211H	0	+	246	670	670	1.0000000
C2	52303193	52310454	BolC2t11212H	0	-	3681	7115	7261	0.9798926
C2	52312129	52314319	BolC2t11213H	0	+	128	1404	2190	0.6410959
C2	52325179	52326311	BolC2t11214H	0	+	585	1132	1132	1.0000000
C2	52344037	52345058	BolC2t11215H	0	-	477	1021	1021	1.0000000
C2	52365725	52366056	BolC2t11216H	0	-	114	295	331	0.8912387
C2	52389077	52390193	BolC2t11217H	0	+	445	1116	1116	1.0000000
C2	52431010	52432028	BolC2t11218H	0	-	151	804	1018	0.7897839
C2	52433941	52434226	BolC2t11219H	0	+	4	85	285	0.2982456
C2	52446787	52448710	BolC2t11220H	0	+	348	1862	1923	0.9682787
C2	52450739	52451776	BolC2t11221H	0	+	165	969	1037	0.9344262
C2	52452925	52453618	BolC2t11222H	0	-	193	693	693	1.0000000
C2	52461647	52462289	BolC2t11223H	0	-	0	0	642	0.0000000
C2	52469444	52469964	BolC2t11224H	0	-	0	0	520	0.0000000
C2	52481395	52481869	BolC2t11225H	0	+	5	47	474	0.0991561
C2	52482335	52483800	BolC2t11226H	0	-	1013	1465	1465	1.0000000
C2	52510350	52510893	BolC2t11227H	0	+	31	420	543	0.7734807
C2	52511741	52513721	BolC2t11228H	0	-	1432	1980	1980	1.0000000
C2	52534096	52535267	BolC2t11229H	0	-	151	792	1171	0.6763450
C2	52536748	52536898	BolC2t11230H	0	+	209	150	150	1.0000000
C2	52537127	52537843	BolC2t11231H	0	-	400	716	716	1.0000000
C2	52538238	52538742	BolC2t11232H	0	-	144	457	504	0.9067460
C2	52539804	52541739	BolC2t11233H	0	+	1010	1808	1935	0.9343669
C2	52551284	52553715	BolC2t11234H	0	+	780	2337	2431	0.9613328
C2	52560361	52562459	BolC2t11235H	0	+	291	1019	2098	0.4857007
C2	52567240	52567843	BolC2t11236H	0	+	44	406	603	0.6733001
C2	52580177	52580384	BolC2t11237H	0	-	212	207	207	1.0000000
C2	52581496	52582164	BolC2t11238H	0	+	28	248	668	0.3712575
C2	52584822	52585632	BolC2t11239H	0	+	0	0	810	0.0000000
C2	52587034	52587680	BolC2t11240H	0	+	0	0	646	0.0000000
C2	52593042	52593358	BolC2t11241H	0	-	43	208	316	0.6582279
C2	52604480	52605466	BolC2t11242H	0	+	703	986	986	1.0000000
C2	52607913	52609682	BolC2t11243H	0	+	1123	1769	1769	1.0000000
C2	52628457	52630025	BolC2t11244H	0	+	324	1477	1568	0.9419643
C2	52630786	52631521	BolC2t11245H	0	+	62	319	735	0.4340136
C2	52633537	52633868	BolC2t11246H	0	-	334	331	331	1.0000000
C2	52634275	52634614	BolC2t11247H	0	-	252	339	339	1.0000000
C2	52640093	52640522	BolC2t11248H	0	+	294	429	429	1.0000000
C2	52640812	52641619	BolC2t11249H	0	-	442	807	807	1.0000000
C2	52669306	52671396	BolC2t11250H	0	+	74	937	2090	0.4483254
C2	52678733	52680097	BolC2t11251H	0	-	2	228	1364	0.1671554
C2	52687362	52688973	BolC2t11252H	0	-	504	1395	1611	0.8659218
C2	52732001	52732280	BolC2t11253H	0	-	354	279	279	1.0000000
C2	52733244	52734168	BolC2t11254H	0	-	28	379	924	0.4101731
C2	52735176	52744163	BolC2t11255H	0	-	670	3840	8987	0.4272839
C2	52744655	52745627	BolC2t11256H	0	-	215	801	972	0.8240741
C2	52752121	52753093	BolC2t11257H	0	-	52	568	972	0.5843621
C2	52758363	52759353	BolC2t11258H	0	-	899	990	990	1.0000000
C2	52760469	52761108	BolC2t11259H	0	+	130	576	639	0.9014084
C2	52771719	52772641	BolC2t11260H	0	+	185	277	922	0.3004338
C2	52775293	52775683	BolC2t11261H	0	-	18	174	390	0.4461538
C2	52775744	52776777	BolC2t11262H	0	-	4	240	1033	0.2323330
C2	52789800	52791562	BolC2t11263H	0	+	441	1682	1762	0.9545971
C2	52799248	52806849	BolC2t11264H	0	+	2559	6037	7601	0.7942376
C2	52814383	52815352	BolC2t11265H	0	+	107	742	969	0.7657379
C2	52820610	52820961	BolC2t11266H	0	+	51	139	351	0.3960114
C2	52821415	52822378	BolC2t11267H	0	+	180	574	963	0.5960540
C2	52822969	52824042	BolC2t11268H	0	+	1084	1073	1073	1.0000000
C2	52842136	52842292	BolC2t11269H	0	-	255	156	156	1.0000000
C2	52844913	52845048	BolC2t11270H	0	-	106	135	135	1.0000000
C2	52850688	52851099	BolC2t11271H	0	+	387	411	411	1.0000000
C2	52858893	52859092	BolC2t11272H	0	+	231	199	199	1.0000000
C2	52875286	52876339	BolC2t11273H	0	-	142	807	1053	0.7663817
C2	52903925	52904781	BolC2t11274H	0	+	355	777	856	0.9077103
C2	52921497	52927453	BolC2t11275H	0	+	933	4663	5956	0.7829080
C2	52928354	52941904	BolC2t11276H	0	-	1365	4832	13550	0.3566052
C2	52942903	52944152	BolC2t11277H	0	-	1049	1249	1249	1.0000000
C2	52952933	52953125	BolC2t11278H	0	+	376	192	192	1.0000000
C2	52958458	52962434	BolC2t11279H	0	+	2070	3976	3976	1.0000000
C2	52963178	52963606	BolC2t11280H	0	+	26	196	428	0.4579439
C2	52983678	52984313	BolC2t11281H	0	-	0	0	635	0.0000000
C2	52992801	52993168	BolC2t11282H	0	+	3	59	367	0.1607629
C2	53001464	53001838	BolC2t11283H	0	+	17	114	374	0.3048128
C2	53008882	53028047	BolC2t11284H	0	+	17225	14591	19165	0.7613358
C2	53014907	53015110	BolC2t11285H	0	+	248	180	203	0.8866995
C2	53015183	53015759	BolC2t11286H	0	+	1108	414	576	0.7187500
C2	53015741	53019804	BolC2t11287H	0	+	1130	1539	4063	0.3787841
C2	53020564	53021050	BolC2t11288H	0	+	181	486	486	1.0000000
C2	53022318	53025703	BolC2t11289H	0	-	9891	2926	3385	0.8644018
C2	53026457	53027190	BolC2t11290H	0	-	69	441	733	0.6016371
C2	53050200	53050740	BolC2t11291H	0	+	7	186	540	0.3444445
C2	53055394	53057159	BolC2t11292H	0	+	510	1702	1765	0.9643059
C2	53062464	53065950	BolC2t11293H	0	+	210	1008	3486	0.2891566
C2	53067916	53069841	BolC2t11294H	0	-	4	61	1925	0.0316883
C2	53070803	53073819	BolC2t11295H	0	-	165	858	3016	0.2844827
C2	53075485	53076298	BolC2t11296H	0	+	467	794	813	0.9766298
C2	53079260	53080064	BolC2t11297H	0	-	751	804	804	1.0000000
C2	53085140	53086686	BolC2t11298H	0	-	809	1207	1546	0.7807245
C2	53087626	53089191	BolC2t11299H	0	+	1323	1565	1565	1.0000000
C2	53089418	53089619	BolC2t11300H	0	+	157	201	201	1.0000000
C2	53110063	53112534	BolC2t11301H	0	+	1757	2471	2471	1.0000000
C2	53118055	53119219	BolC2t11302H	0	+	296	1074	1164	0.9226804
C2	53127220	53127724	BolC2t11303H	0	+	12	84	504	0.1666667
C2	53138858	53144014	BolC2t11304H	0	-	1344	3979	5156	0.7717223
C2	53146978	53147794	BolC2t11305H	0	+	11	312	816	0.3823529
C2	53167256	53168018	BolC2t11306H	0	-	731	762	762	1.0000000
C2	53189210	53192489	BolC2t11307H	0	-	588	2359	3279	0.7194266
C2	53246947	53247736	BolC2t11308H	0	+	277	789	789	1.0000000
C2	53248866	53250285	BolC2t11309H	0	+	715	1419	1419	1.0000000
C2	53258920	53260469	BolC2t11310H	0	+	288	1549	1549	1.0000000
C2	53262233	53262506	BolC2t11311H	0	-	9	174	273	0.6373627
C2	53268585	53268858	BolC2t11312H	0	-	15	189	273	0.6923077
C2	53278929	53280033	BolC2t11313H	0	+	378	1104	1104	1.0000000
C2	53288937	53289236	BolC2t11314H	0	+	72	299	299	1.0000000
C2	53290154	53291536	BolC2t11315H	0	-	640	1382	1382	1.0000000
C2	53299483	53300955	BolC2t11316H	0	+	265	1057	1472	0.7180706
C2	53339359	53340409	BolC2t11317H	0	+	347	894	1050	0.8514286
C2	53341542	53344563	BolC2t11318H	0	-	1592	2916	3021	0.9652433
C2	53346516	53347023	BolC2t11319H	0	-	334	507	507	1.0000000
C2	53372813	53372993	BolC2t11320H	0	+	158	180	180	1.0000000
C2	53419712	53420153	BolC2t11321H	0	-	357	441	441	1.0000000
C2	53474795	53475106	BolC2t11322H	0	-	18	226	311	0.7266881
C2	53504278	53504632	BolC2t11323H	0	-	79	346	354	0.9774011
C2	53511574	53514066	BolC2t11324H	0	-	1330	2247	2492	0.9016854
C2	53516018	53516252	BolC2t11325H	0	+	0	0	234	0.0000000
C2	53556955	53557663	BolC2t11326H	0	+	183	695	708	0.9816384
C2	53563893	53565465	BolC2t11327H	0	+	1042	1572	1572	1.0000000
C2	53570937	53571219	BolC2t11328H	0	-	10	161	282	0.5709220
C2	53574765	53574930	BolC2t11329H	0	+	168	165	165	1.0000000
C2	53587639	53588647	BolC2t11330H	0	+	431	1008	1008	1.0000000
C2	53590102	53591972	BolC2t11331H	0	-	1049	1775	1870	0.9491979
C2	53594003	53596115	BolC2t11332H	0	-	569	1969	2112	0.9322917
C2	53596782	53598461	BolC2t11333H	0	-	599	1679	1679	1.0000000
C2	53605715	53607117	BolC2t11334H	0	-	546	1341	1402	0.9564908
C2	53619072	53623837	BolC2t11335H	0	+	2454	4572	4765	0.9594963
C2	53625775	53628116	BolC2t11336H	0	+	1508	2339	2341	0.9991457
C2	53633039	53635394	BolC2t11337H	0	+	697	2332	2355	0.9902335
C2	53642858	53643215	BolC2t11338H	0	+	68	250	357	0.7002801
C2	53648866	53649112	BolC2t11339H	0	+	444	246	246	1.0000000
C2	53650174	53651506	BolC2t11340H	0	+	835	1332	1332	1.0000000
C2	53662229	53664990	BolC2t11341H	0	+	486	2363	2761	0.8558493
C2	53669779	53679705	BolC2t11342H	0	-	3283	6859	9926	0.6910135
C2	53686027	53687618	BolC2t11343H	0	-	88	692	1591	0.4349466
C2	53718736	53719455	BolC2t11344H	0	-	62	606	719	0.8428373
C2	53738336	53739050	BolC2t11345H	0	+	0	0	714	0.0000000
C2	53748038	53748347	BolC2t11346H	0	+	0	0	309	0.0000000
C2	53750581	53753781	BolC2t11347H	0	-	0	0	3200	0.0000000
C2	53758717	53759005	BolC2t11348H	0	-	0	0	288	0.0000000
C2	53770048	53771757	BolC2t11349H	0	+	196	1203	1709	0.7039204
C2	53790327	53790573	BolC2t11350H	0	-	169	246	246	1.0000000
C2	53791039	53793205	BolC2t11351H	0	-	702	1616	2166	0.7460757
C2	53794518	53799707	BolC2t11352H	0	-	1156	4243	5189	0.8176913
C2	53801413	53803513	BolC2t11353H	0	-	243	1131	2100	0.5385714
C2	53807318	53815575	BolC2t11354H	0	+	15474	7818	8257	0.9468330
C2	53822667	53824359	BolC2t11355H	0	-	780	1389	1692	0.8209220
C2	53874693	53884462	BolC2t11356H	0	+	1753	7007	9769	0.7172689
C2	53887354	53887667	BolC2t11357H	0	+	209	313	313	1.0000000
C2	53905719	53909132	BolC2t11358H	0	+	1191	1137	3413	0.3331380
C2	53930796	53931024	BolC2t11359H	0	-	10	116	228	0.5087720
C2	53939327	53942320	BolC2t11360H	0	+	251	1738	2993	0.5806883
C2	53956258	53974633	BolC2t11361H	0	+	849	9028	18375	0.4913197
C2	53977257	53979198	BolC2t11362H	0	+	1963	1918	1941	0.9881504
C2	53980022	53981096	BolC2t11363H	0	-	189	991	1074	0.9227188
C2	53982314	53982644	BolC2t11364H	0	-	124	330	330	1.0000000
C2	53985650	53996939	BolC2t11365H	0	+	2380	5222	11289	0.4625742
C2	53998318	53999539	BolC2t11366H	0	-	50	707	1221	0.5790336
C2	54010413	54010605	BolC2t11367H	0	+	7	172	192	0.8958333
C2	54222993	54223806	BolC2t11368H	0	+	96192	813	813	1.0000000
C2	54261802	54262188	BolC2t11369H	0	+	0	0	386	0.0000000
C2	54270464	54271976	BolC2t11370H	0	-	684	1512	1512	1.0000000
C2	54310746	54312337	BolC2t11371H	0	+	0	0	1591	0.0000000
C2	54367753	54368434	BolC2t11372H	0	+	159	681	681	1.0000000
C2	54370111	54370282	BolC2t11373H	0	-	112	171	171	1.0000000
C2	54374155	54374973	BolC2t11374H	0	+	211	818	818	1.0000000
C2	54375298	54376143	BolC2t11375H	0	+	321	845	845	1.0000000
C2	54378888	54379500	BolC2t11376H	0	+	470	612	612	1.0000000
C2	54388915	54389260	BolC2t11377H	0	+	182	345	345	1.0000000
C2	54392868	54393054	BolC2t11378H	0	-	0	0	186	0.0000000
C2	54392998	54393443	BolC2t11379H	0	-	5	280	445	0.6292135
C2	54399251	54400501	BolC2t11380H	0	+	309	1065	1250	0.8520000
C2	54400871	54402676	BolC2t11381H	0	-	181	961	1805	0.5324100
C2	54403119	54404000	BolC2t11382H	0	+	101	825	881	0.9364359
C2	54411253	54412603	BolC2t11383H	0	+	592	1350	1350	1.0000000
C2	54435481	54435616	BolC2t11384H	0	-	63	135	135	1.0000000
C2	54445888	54446215	BolC2t11385H	0	+	349	327	327	1.0000000
C2	54452183	54452810	BolC2t11386H	0	-	453	627	627	1.0000000
C2	54477367	54477541	BolC2t11387H	0	+	36	174	174	1.0000000
C2	54485336	54486608	BolC2t11388H	0	-	513	1156	1272	0.9088050
C2	54490832	54491447	BolC2t11389H	0	-	48	383	615	0.6227642
C2	54492138	54492297	BolC2t11390H	0	+	17	106	159	0.6666667
C2	54493350	54494936	BolC2t11391H	0	+	1930	1586	1586	1.0000000
C2	54495410	54495894	BolC2t11392H	0	+	312	484	484	1.0000000
C2	54496797	54498910	BolC2t11393H	0	+	1388	2068	2113	0.9787033
C2	54499434	54501566	BolC2t11394H	0	-	1795	2090	2132	0.9803002
C2	54503289	54504281	BolC2t11395H	0	-	248	923	992	0.9304435
C2	54513787	54515536	BolC2t11396H	0	+	789	1749	1749	1.0000000
C2	54516500	54517535	BolC2t11397H	0	+	662	1004	1035	0.9700483
C2	54523658	54527019	BolC2t11398H	0	+	1067	3019	3361	0.8982446
C2	54527454	54527849	BolC2t11399H	0	+	184	395	395	1.0000000
C2	54529932	54530184	BolC2t11400H	0	+	215	252	252	1.0000000
C2	54531717	54532010	BolC2t11401H	0	+	237	293	293	1.0000000
C2	54534445	54536010	BolC2t11402H	0	-	813	1565	1565	1.0000000
C2	54540744	54541962	BolC2t11403H	0	+	168	948	1218	0.7783251
C2	54568482	54570944	BolC2t11404H	0	+	275	1519	2462	0.6169780
C2	54572140	54573740	BolC2t11405H	0	+	595	1494	1600	0.9337500
C2	54578638	54593568	BolC2t11406H	0	-	5496	11983	14930	0.8026122
C2	54583507	54585367	BolC2t11407H	0	-	835	1632	1860	0.8774194
C2	54593754	54595615	BolC2t11408H	0	-	346	1861	1861	1.0000000
C2	54597794	54598199	BolC2t11409H	0	+	1137	405	405	1.0000000
C2	54605964	54608330	BolC2t11410H	0	+	587	2133	2366	0.9015216
C2	54610381	54611909	BolC2t11411H	0	-	157	730	1528	0.4777487
C2	54620248	54620677	BolC2t11412H	0	+	0	0	429	0.0000000
C2	54622840	54624291	BolC2t11413H	0	-	23	465	1451	0.3204686
C2	54635572	54637029	BolC2t11414H	0	-	0	0	1457	0.0000000
C2	54645743	54671950	BolC2t11415H	0	+	5450	15246	26207	0.5817530
C2	54648334	54649791	BolC2t11416H	0	-	5	150	1457	0.1029513
C2	54658786	54660672	BolC2t11417H	0	+	1	21	1886	0.0111347
C2	54680778	54692299	BolC2t11418H	0	+	3942	7195	11521	0.6245118
C2	54702695	54708200	BolC2t11419H	0	+	2262	5208	5505	0.9460490
C2	54708304	54710867	BolC2t11420H	0	-	1213	2518	2563	0.9824424
C2	54724941	54727678	BolC2t11421H	0	-	1063	2616	2737	0.9557910
C2	54730057	54730784	BolC2t11422H	0	+	418	727	727	1.0000000
C2	54739206	54739407	BolC2t11423H	0	-	10	121	201	0.6019900
C2	54742109	54743407	BolC2t11424H	0	-	497	1298	1298	1.0000000
C2	54744538	54746771	BolC2t11425H	0	-	1285	2145	2233	0.9605911
C2	54751002	54752930	BolC2t11426H	0	-	1113	1832	1928	0.9502075
C2	54776175	54777761	BolC2t11427H	0	-	376	1470	1586	0.9268600
C2	54781586	54782229	BolC2t11428H	0	+	980	643	643	1.0000000
C2	54799312	54800074	BolC2t11429H	0	+	526	762	762	1.0000000
C2	54802259	54802938	BolC2t11430H	0	-	209	679	679	1.0000000
C2	54805860	54806472	BolC2t11431H	0	+	194	612	612	1.0000000
C2	54808643	54809065	BolC2t11432H	0	-	88	422	422	1.0000000
C2	54810864	54811170	BolC2t11433H	0	+	109	306	306	1.0000000
C2	54830990	54831398	BolC2t11434H	0	-	262	408	408	1.0000000
C2	54837862	54839679	BolC2t11435H	0	+	656	1594	1817	0.8772702
C2	54840647	54840857	BolC2t11436H	0	+	26	176	210	0.8380952
C2	54841462	54845949	BolC2t11437H	0	-	1939	4284	4487	0.9547582
C2	54877099	54878098	BolC2t11438H	0	-	148	913	999	0.9139139
C2	54884638	54885296	BolC2t11439H	0	+	966	658	658	1.0000000
C2	54903075	54903339	BolC2t11440H	0	+	340	264	264	1.0000000
C2	54903517	54904937	BolC2t11441H	0	-	666	1145	1420	0.8063380
C2	54907241	54908437	BolC2t11442H	0	+	753	1196	1196	1.0000000
C2	54909108	54909363	BolC2t11443H	0	+	355	255	255	1.0000000
C2	54914383	54915391	BolC2t11444H	0	-	1216	1008	1008	1.0000000
C2	54919311	54920547	BolC2t11445H	0	-	278	1143	1236	0.9247573
C2	54951273	54952088	BolC2t11446H	0	+	244	736	815	0.9030675
C2	54958992	54961896	BolC2t11447H	0	+	389	2600	2904	0.8953168
C2	54964554	54967972	BolC2t11448H	0	-	2344	3418	3418	1.0000000
C2	54970950	54971793	BolC2t11449H	0	-	118	843	843	1.0000000
C2	54973927	54974486	BolC2t11450H	0	+	174	559	559	1.0000000
C2	54975225	54975399	BolC2t11451H	0	+	81	174	174	1.0000000
C2	54975687	54976285	BolC2t11452H	0	-	68	479	598	0.8010033
C2	54976943	54978699	BolC2t11453H	0	-	1019	1756	1756	1.0000000
C2	54995883	54996588	BolC2t11454H	0	+	187	705	705	1.0000000
C2	55002554	55004269	BolC2t11455H	0	-	1199	1715	1715	1.0000000
C2	55009656	55023661	BolC2t11456H	0	-	5106	12801	14005	0.9140307
C2	55037201	55062817	BolC2t11457H	0	+	5082	16205	25616	0.6326124
C2	55040642	55042227	BolC2t11458H	0	+	140	1102	1585	0.6952682
C2	55073849	55074125	BolC2t11459H	0	-	7	117	276	0.4239130
C2	55084377	55086903	BolC2t11460H	0	+	1098	2526	2526	1.0000000
C2	55092407	55092746	BolC2t11461H	0	+	68	339	339	1.0000000
C2	55109175	55109525	BolC2t11462H	0	-	3	164	350	0.4685714
C2	55110857	55111433	BolC2t11463H	0	-	118	562	576	0.9756944
C2	55114062	55114335	BolC2t11464H	0	+	57	273	273	1.0000000
C2	55127302	55128055	BolC2t11465H	0	+	299	753	753	1.0000000
C2	55134644	55136327	BolC2t11466H	0	+	490	1001	1683	0.5947713
C2	55148544	55150746	BolC2t11467H	0	+	809	2045	2202	0.9287012
C2	55151444	55155716	BolC2t11468H	0	-	1273	4185	4272	0.9796348
C2	55158224	55163486	BolC2t11469H	0	+	2963	5239	5262	0.9956290
C2	55163956	55164154	BolC2t11470H	0	-	183	198	198	1.0000000
C2	55165433	55165673	BolC2t11471H	0	-	15	140	240	0.5833333
C2	55168889	55172480	BolC2t11472H	0	-	1228	3556	3591	0.9902534
C2	55173313	55174797	BolC2t11473H	0	+	1124	1484	1484	1.0000000
C2	55177643	55179111	BolC2t11474H	0	+	1025	1468	1468	1.0000000
C2	55179667	55179817	BolC2t11475H	0	-	281	150	150	1.0000000
C2	55194154	55195979	BolC2t11476H	0	-	1545	1825	1825	1.0000000
C2	55198564	55201629	BolC2t11477H	0	-	1277	2916	3065	0.9513866
C2	55215950	55218559	BolC2t11478H	0	+	739	1355	2609	0.5193561
C2	55219398	55219608	BolC2t11479H	0	+	186	210	210	1.0000000
C2	55220622	55221006	BolC2t11480H	0	-	129	308	384	0.8020833
C2	55224697	55225066	BolC2t11481H	0	-	288	369	369	1.0000000
C2	55228680	55233703	BolC2t11482H	0	+	2759	5023	5023	1.0000000
C2	55239929	55242070	BolC2t11483H	0	+	1310	2023	2141	0.9448856
C2	55245507	55252465	BolC2t11484H	0	-	2094	6438	6958	0.9252659
C2	55249538	55249736	BolC2t11485H	0	-	42	198	198	1.0000000
C2	55258674	55259896	BolC2t11486H	0	+	757	1220	1222	0.9983633
C2	55260418	55260535	BolC2t11487H	0	+	59	117	117	1.0000000
C2	55262788	55263209	BolC2t11488H	0	-	487	421	421	1.0000000
C2	55267711	55269158	BolC2t11489H	0	-	92	1014	1447	0.7007602
C2	55269864	55271168	BolC2t11490H	0	-	742	1279	1304	0.9808282
C2	55272800	55272950	BolC2t11491H	0	-	602	150	150	1.0000000
C2	55274332	55275312	BolC2t11492H	0	-	613	980	980	1.0000000
C2	55276958	55278858	BolC2t11493H	0	+	1009	1799	1900	0.9468421
C2	55290457	55290690	BolC2t11494H	0	+	172	233	233	1.0000000
C2	55291079	55291415	BolC2t11495H	0	+	185	336	336	1.0000000
C2	55291627	55292152	BolC2t11496H	0	+	112	507	525	0.9657143
C2	55295215	55296057	BolC2t11497H	0	+	237	725	842	0.8610451
C2	55296264	55301957	BolC2t11498H	0	-	2841	5444	5693	0.9562621
C2	55305886	55308390	BolC2t11499H	0	-	1845	2484	2504	0.9920128
C2	55311304	55311580	BolC2t11500H	0	-	309	276	276	1.0000000
C2	55322976	55323375	BolC2t11501H	0	+	4	309	399	0.7744361
C2	55356510	55357453	BolC2t11502H	0	+	926	943	943	1.0000000
C2	55357976	55358861	BolC2t11503H	0	+	410	885	885	1.0000000
C2	55359459	55362979	BolC2t11504H	0	-	1071	3457	3520	0.9821023
C2	55365783	55365989	BolC2t11505H	0	-	162	206	206	1.0000000
C2	55368313	55369885	BolC2t11506H	0	+	253	1302	1572	0.8282443
C2	55370123	55376013	BolC2t11507H	0	-	1595	4899	5890	0.8317487
C2	55378230	55380051	BolC2t11508H	0	-	1675	1821	1821	1.0000000
C2	55381207	55383368	BolC2t11509H	0	-	1460	1957	2161	0.9055992
C2	55399579	55400648	BolC2t11510H	0	-	37	711	1069	0.6651075
C2	55402327	55402953	BolC2t11511H	0	-	28	426	626	0.6805112
C2	55419482	55422340	BolC2t11512H	0	+	649	2018	2858	0.7060882
C2	55428591	55429173	BolC2t11513H	0	+	614	582	582	1.0000000
C2	55434785	55435553	BolC2t11514H	0	+	121	748	768	0.9739583
C2	55444515	55452513	BolC2t11515H	0	-	3106	7373	7998	0.9218554
C2	55455118	55456625	BolC2t11516H	0	+	66	768	1507	0.5096217
C2	55466925	55467509	BolC2t11517H	0	+	24	356	584	0.6095890
C2	55472136	55472852	BolC2t11518H	0	+	222	534	716	0.7458100
C2	55475086	55475524	BolC2t11519H	0	+	12	181	438	0.4132420
C2	55482739	55485909	BolC2t11520H	0	-	317	2761	3170	0.8709779
C2	55487547	55497610	BolC2t11521H	0	+	3279	8995	10063	0.8938686
C2	55501782	55503986	BolC2t11522H	0	+	516	1836	2204	0.8330309
C2	55515785	55517534	BolC2t11523H	0	-	396	1540	1749	0.8805031
C2	55520950	55526054	BolC2t11524H	0	+	2267	5076	5104	0.9945141
C2	55545541	55548099	BolC2t11525H	0	+	82	948	2558	0.3706020
C2	55558305	55566188	BolC2t11526H	0	+	1275	4704	7883	0.5967271
C2	55567439	55569008	BolC2t11527H	0	-	211	879	1569	0.5602294
C2	55595647	55600939	BolC2t11528H	0	+	1570	3754	5292	0.7093726
C2	55604410	55607233	BolC2t11529H	0	+	1840	2823	2823	1.0000000
C2	55613216	55613381	BolC2t11530H	0	+	166	165	165	1.0000000
C2	55613911	55614701	BolC2t11531H	0	-	504	790	790	1.0000000
C2	55619660	55620629	BolC2t11532H	0	+	222	868	969	0.8957688
C2	55622045	55622345	BolC2t11533H	0	+	53	266	300	0.8866667
C2	55627657	55627897	BolC2t11534H	0	-	303	240	240	1.0000000
C2	55638250	55644970	BolC2t11535H	0	+	2871	6720	6720	1.0000000
C2	55661835	55663112	BolC2t11536H	0	-	194	669	1277	0.5238841
C2	55666508	55671737	BolC2t11537H	0	-	1987	4590	5229	0.8777969
C2	55698890	55699872	BolC2t11538H	0	-	1166	982	982	1.0000000
C2	55704959	55706768	BolC2t11539H	0	+	990	1806	1809	0.9983416
C2	55708263	55708987	BolC2t11540H	0	-	246	679	724	0.9378453
C2	55710403	55710919	BolC2t11541H	0	-	466	516	516	1.0000000
C2	55712811	55713153	BolC2t11542H	0	+	147	342	342	1.0000000
C2	55714917	55716276	BolC2t11543H	0	+	1268	1359	1359	1.0000000
C2	55724205	55725702	BolC2t11544H	0	+	214	1175	1497	0.7849032
C2	55733791	55736116	BolC2t11545H	0	+	1062	2325	2325	1.0000000
C2	55737354	55739832	BolC2t11546H	0	+	294	1951	2478	0.7873285
C2	55741322	55744647	BolC2t11547H	0	+	709	3192	3325	0.9600000
C2	55744891	55746833	BolC2t11548H	0	-	316	1577	1942	0.8120494
C2	55747348	55754217	BolC2t11549H	0	-	1189	4250	6869	0.6187218
C2	55760771	55769532	BolC2t11550H	0	+	13367	8190	8761	0.9348248
C2	55770659	55773261	BolC2t11551H	0	-	201	1453	2602	0.5584166
C2	55809960	55810358	BolC2t11552H	0	+	0	0	398	0.0000000
C2	55812403	55812910	BolC2t11553H	0	+	0	0	507	0.0000000
C2	55814868	55815683	BolC2t11554H	0	+	16	309	815	0.3791411
C2	55818390	55819173	BolC2t11555H	0	-	0	0	783	0.0000000
C2	55836796	55839394	BolC2t11556H	0	-	3	96	2598	0.0369515
C2	55852190	55852618	BolC2t11557H	0	-	252	428	428	1.0000000
C2	55866087	55866418	BolC2t11558H	0	+	554	331	331	1.0000000
C2	55869392	55891626	BolC2t11559H	0	-	8191	13522	22234	0.6081676
C2	55894174	55895188	BolC2t11560H	0	+	226	957	1014	0.9437870
C2	55897366	55897895	BolC2t11561H	0	-	198	425	529	0.8034027
C2	55915978	55917153	BolC2t11562H	0	-	796	1175	1175	1.0000000
C2	55934102	55937326	BolC2t11563H	0	+	1092	3206	3224	0.9944169
C2	55953426	55954854	BolC2t11564H	0	+	255	1352	1428	0.9467787
C2	55976689	55977193	BolC2t11565H	0	-	593	504	504	1.0000000
C2	55978933	55979313	BolC2t11566H	0	+	427	380	380	1.0000000
C2	55993619	55994482	BolC2t11567H	0	-	477	863	863	1.0000000
C2	55997841	56009748	BolC2t11568H	0	-	7587	9843	11907	0.8266566
C2	56015660	56017216	BolC2t11569H	0	-	592	780	1556	0.5012854
C2	56029454	56038184	BolC2t11570H	0	+	3042	7320	8730	0.8384880
C2	56038334	56039463	BolC2t11571H	0	+	137	998	1129	0.8839681
C2	56040272	56040917	BolC2t11572H	0	-	56	234	645	0.3627907
C2	56045035	56045515	BolC2t11573H	0	+	446	458	480	0.9541667
C2	56052908	56053157	BolC2t11574H	0	-	0	0	249	0.0000000
C2	56055415	56059318	BolC2t11575H	0	-	810	3341	3903	0.8560082
C2	56059708	56061096	BolC2t11576H	0	+	448	1296	1388	0.9337176
C2	56061581	56062792	BolC2t11577H	0	-	677	1211	1211	1.0000000
C2	56064454	56065413	BolC2t11578H	0	+	504	959	959	1.0000000
C2	56067288	56067594	BolC2t11579H	0	-	223	306	306	1.0000000
C2	56071366	56073213	BolC2t11580H	0	-	776	1710	1847	0.9258257
C2	56076326	56076697	BolC2t11581H	0	+	27	293	371	0.7897574
C2	56115549	56116462	BolC2t11582H	0	-	4	19	913	0.0208105
C2	56127030	56127504	BolC2t11583H	0	+	1	84	474	0.1772152
C2	56129868	56130568	BolC2t11584H	0	-	53	480	700	0.6857143
C2	56144026	56144235	BolC2t11585H	0	+	10	197	209	0.9425837
C2	56144191	56144542	BolC2t11586H	0	+	69	351	351	1.0000000
C2	56145348	56146468	BolC2t11587H	0	+	112	1039	1120	0.9276786
C2	56151127	56151959	BolC2t11588H	0	-	19	218	832	0.2620192
C2	56153262	56159295	BolC2t11589H	0	+	478	1521	6033	0.2521134
C2	56161195	56161498	BolC2t11590H	0	-	15	198	303	0.6534653
C2	56172019	56174592	BolC2t11591H	0	-	550	2308	2573	0.8970074
C2	56177105	56178215	BolC2t11592H	0	-	1072	1110	1110	1.0000000
C2	56186132	56186315	BolC2t11593H	0	-	279	183	183	1.0000000
C2	56191907	56192984	BolC2t11594H	0	+	31	738	1077	0.6852368
C2	56194081	56194364	BolC2t11595H	0	-	267	283	283	1.0000000
C2	56195025	56195484	BolC2t11596H	0	-	139	415	459	0.9041395
C2	56195963	56196378	BolC2t11597H	0	+	213	415	415	1.0000000
C2	56196969	56197911	BolC2t11598H	0	-	743	942	942	1.0000000
C2	56198723	56200216	BolC2t11599H	0	+	1164	1493	1493	1.0000000
C2	56215342	56216362	BolC2t11600H	0	+	164	670	1020	0.6568627
C2	56227922	56228675	BolC2t11601H	0	+	827	753	753	1.0000000
C2	56229097	56231111	BolC2t11602H	0	-	1250	2014	2014	1.0000000
C2	56231868	56232687	BolC2t11603H	0	+	707	819	819	1.0000000
C2	56233023	56234057	BolC2t11604H	0	-	863	1034	1034	1.0000000
C2	56234672	56235962	BolC2t11605H	0	+	1190	1290	1290	1.0000000
C2	56238363	56238618	BolC2t11606H	0	+	14	254	255	0.9960784
C2	56238867	56239271	BolC2t11607H	0	-	11	338	404	0.8366337
C2	56249517	56250998	BolC2t11608H	0	+	717	1481	1481	1.0000000
C2	56251864	56256663	BolC2t11609H	0	+	2645	4741	4799	0.9879141
C2	56258111	56259014	BolC2t11610H	0	+	360	578	903	0.6400886
C2	56265859	56266634	BolC2t11611H	0	+	735	775	775	1.0000000
C2	56267892	56268660	BolC2t11612H	0	-	7	161	768	0.2096354
C2	56269850	56269997	BolC2t11613H	0	+	39	147	147	1.0000000
C2	56282837	56283944	BolC2t11614H	0	-	372	1107	1107	1.0000000
C2	56284721	56285996	BolC2t11615H	0	+	1162	1275	1275	1.0000000
C2	56288245	56292382	BolC2t11616H	0	+	2561	4008	4137	0.9688180
C2	56292737	56294678	BolC2t11617H	0	-	175	1395	1941	0.7187017
C2	56299649	56299763	BolC2t11618H	0	-	0	0	114	0.0000000
C2	56311506	56312120	BolC2t11619H	0	-	4	296	614	0.4820847
C2	56315901	56316895	BolC2t11620H	0	-	67	773	994	0.7776660
C2	56325499	56326690	BolC2t11621H	0	-	94	610	1191	0.5121747
C2	56339001	56339469	BolC2t11622H	0	+	4	137	468	0.2927350
C2	56339472	56339613	BolC2t11623H	0	+	1	22	141	0.1560284
C2	56372842	56373725	BolC2t11624H	0	+	134	881	883	0.9977350
C2	56377675	56377867	BolC2t11625H	0	+	73	166	192	0.8645833
C2	56379907	56381242	BolC2t11626H	0	-	634	1046	1335	0.7835206
C2	56386024	56386591	BolC2t11627H	0	-	381	559	567	0.9858906
C2	56439487	56439850	BolC2t11628H	0	+	1	32	363	0.0881543
C2	56445642	56446539	BolC2t11629H	0	+	21	325	897	0.3623188
C2	56446901	56447249	BolC2t11630H	0	+	0	0	348	0.0000000
C2	56447687	56448026	BolC2t11631H	0	+	0	0	339	0.0000000
C2	56448245	56448491	BolC2t11632H	0	+	0	0	246	0.0000000
C2	56449646	56450246	BolC2t11633H	0	+	31	109	600	0.1816667
C2	56471399	56472110	BolC2t11634H	0	-	137	518	711	0.7285513
C2	56479544	56483403	BolC2t11635H	0	+	457	2066	3859	0.5353718
C2	56488271	56489003	BolC2t11636H	0	+	5	254	732	0.3469945
C2	56494843	56495914	BolC2t11637H	0	+	1	73	1071	0.0681606
C2	56498551	56498904	BolC2t11638H	0	-	30	106	353	0.3002833
C2	56502510	56503029	BolC2t11639H	0	-	0	0	519	0.0000000
C2	56503450	56503693	BolC2t11640H	0	+	6	84	243	0.3456790
C2	56511381	56511636	BolC2t11641H	0	+	3	167	255	0.6549020
C2	56511816	56512288	BolC2t11642H	0	-	2	189	472	0.4004237
C2	56549922	56550817	BolC2t11643H	0	+	0	0	895	0.0000000
C2	56564394	56566022	BolC2t11644H	0	+	0	0	1628	0.0000000
C2	56570332	56570521	BolC2t11645H	0	-	2	85	189	0.4497355
C2	56596899	56597160	BolC2t11646H	0	+	10	131	261	0.5019157
C2	56609714	56613290	BolC2t11647H	0	+	448	2368	3576	0.6621924
C2	56623640	56624439	BolC2t11648H	0	-	19	375	799	0.4693367
C2	56639667	56640080	BolC2t11649H	0	-	3	114	413	0.2760291
C2	56646865	56649539	BolC2t11650H	0	+	20	379	2674	0.1417352
C2	56651047	56652391	BolC2t11651H	0	+	61	104	1344	0.0773810
C2	56654081	56654276	BolC2t11652H	0	+	0	0	195	0.0000000
C2	56672758	56676560	BolC2t11653H	0	-	1058	3255	3802	0.8561283
C2	56743367	56746255	BolC2t11654H	0	+	603	2437	2888	0.8438365
C2	56785710	56792241	BolC2t11655H	0	+	2383	3988	6531	0.6106262
C2	56787734	56788982	BolC2t11656H	0	-	0	0	1248	0.0000000
C2	56819741	56828413	BolC2t11657H	0	+	587	4828	8672	0.5567343
C2	56846998	56847175	BolC2t11658H	0	-	20	104	177	0.5875706
C2	56870629	56873130	BolC2t11659H	0	+	476	2156	2501	0.8620552
C2	56873791	56875007	BolC2t11660H	0	-	495	1216	1216	1.0000000
C2	56879056	56881210	BolC2t11661H	0	+	296	1524	2154	0.7075209
C2	56881546	56884312	BolC2t11662H	0	-	457	2527	2766	0.9135936
C2	56903963	56904479	BolC2t11663H	0	+	17	169	516	0.3275194
C2	56918175	56919954	BolC2t11664H	0	+	55	908	1779	0.5103991
C2	56921874	56922252	BolC2t11665H	0	+	670	378	378	1.0000000
C2	56924092	56924491	BolC2t11666H	0	-	53	353	399	0.8847118
C2	56936954	56937299	BolC2t11667H	0	+	6	40	345	0.1159420
C2	56952583	56954876	BolC2t11668H	0	-	535	1734	2293	0.7562146
C2	56969107	56971323	BolC2t11669H	0	+	803	2216	2216	1.0000000
C2	56975871	56981837	BolC2t11670H	0	+	3126	5912	5966	0.9909487
C2	56982361	56983229	BolC2t11671H	0	-	203	825	868	0.9504609
C2	56987275	56988432	BolC2t11672H	0	-	93	641	1157	0.5540190
C2	56990930	56995117	BolC2t11673H	0	+	1712	3119	4187	0.7449248
C2	56996314	56997601	BolC2t11674H	0	-	764	1287	1287	1.0000000
C2	56998054	56998881	BolC2t11675H	0	+	694	825	827	0.9975816
C2	57008811	57013435	BolC2t11676H	0	+	343	2845	4624	0.6152682
C2	57016298	57016853	BolC2t11677H	0	-	121	551	555	0.9927928
C2	57019773	57020569	BolC2t11678H	0	-	543	796	796	1.0000000
C2	57021215	57021746	BolC2t11679H	0	+	131	531	531	1.0000000
C2	57021883	57022302	BolC2t11680H	0	+	121	419	419	1.0000000
C2	57028818	57032015	BolC2t11681H	0	-	1221	3197	3197	1.0000000
C2	57032435	57037913	BolC2t11682H	0	-	2829	5274	5478	0.9627602
C2	57045057	57050548	BolC2t11683H	0	-	2237	5326	5491	0.9699509
C2	57060750	57061378	BolC2t11684H	0	-	1	81	628	0.1289809
C2	57088985	57090442	BolC2t11685H	0	-	5	115	1457	0.0789293
C2	57096431	57098119	BolC2t11686H	0	-	290	1592	1688	0.9431280
C2	57111703	57112174	BolC2t11687H	0	-	2	52	471	0.1104034
C2	57113719	57113914	BolC2t11688H	0	+	15	195	195	1.0000000
C2	57114832	57115743	BolC2t11689H	0	+	485	911	911	1.0000000
C2	57138455	57139506	BolC2t11690H	0	-	138	876	1051	0.8334919
C2	57150677	57151401	BolC2t11691H	0	-	564	724	724	1.0000000
C2	57152221	57153833	BolC2t11692H	0	-	180	1002	1612	0.6215881
C2	57170542	57170842	BolC2t11693H	0	+	120	300	300	1.0000000
C2	57177136	57177755	BolC2t11694H	0	-	56	561	619	0.9063005
C2	57181661	57181967	BolC2t11695H	0	-	22	306	306	1.0000000
C2	57197943	57198267	BolC2t11696H	0	-	197	324	324	1.0000000
C2	57199087	57199387	BolC2t11697H	0	+	192	300	300	1.0000000
C2	57201597	57201771	BolC2t11698H	0	+	123	174	174	1.0000000
C2	57208838	57216868	BolC2t11699H	0	-	4226	7885	8030	0.9819427
C2	57218144	57219630	BolC2t11700H	0	-	613	1429	1486	0.9616420
C2	57221635	57222604	BolC2t11701H	0	-	15	594	969	0.6130031
C2	57230189	57230330	BolC2t11702H	0	+	262	141	141	1.0000000
C2	57230528	57230939	BolC2t11703H	0	+	249	411	411	1.0000000
C2	57231470	57232911	BolC2t11704H	0	+	1050	1437	1441	0.9972242
C2	57233122	57234926	BolC2t11705H	0	+	481	1699	1804	0.9417960
C2	57238644	57241725	BolC2t11706H	0	+	77	1143	3081	0.3709835
C2	57245978	57248212	BolC2t11707H	0	-	348	1218	2234	0.5452104
C2	57249773	57252049	BolC2t11708H	0	+	546	2218	2276	0.9745167
C2	57253033	57263711	BolC2t11709H	0	+	5143	10097	10678	0.9455891
C2	57272383	57281678	BolC2t11710H	0	+	3790	7869	9295	0.8465842
C2	57288083	57293137	BolC2t11711H	0	+	1390	3719	5054	0.7358528
C2	57293574	57296244	BolC2t11712H	0	-	609	2375	2670	0.8895131
C2	57298839	57299464	BolC2t11713H	0	+	282	563	625	0.9008000
C2	57302064	57302785	BolC2t11714H	0	+	320	721	721	1.0000000
C2	57303459	57303771	BolC2t11715H	0	-	654	312	312	1.0000000
C2	57305527	57306418	BolC2t11716H	0	+	14	409	891	0.4590348
C2	57311799	57312458	BolC2t11717H	0	+	159	637	659	0.9666161
C2	57323012	57326266	BolC2t11718H	0	+	604	2113	3254	0.6493546
C2	57331350	57332453	BolC2t11719H	0	-	900	1103	1103	1.0000000
C2	57333436	57334883	BolC2t11720H	0	-	265	660	1447	0.4561161
C2	57339774	57340038	BolC2t11721H	0	-	33	234	264	0.8863636
C2	57357833	57358488	BolC2t11722H	0	-	7	231	655	0.3526717
C2	57375381	57376490	BolC2t11723H	0	-	1098	1109	1109	1.0000000
C2	57378590	57379360	BolC2t11724H	0	-	0	0	770	0.0000000
C2	57380863	57381520	BolC2t11725H	0	+	289	657	657	1.0000000
C2	57391491	57396468	BolC2t11726H	0	+	513	3322	4977	0.6674703
C2	57398277	57400440	BolC2t11727H	0	+	971	2021	2163	0.9343504
C2	57402593	57403751	BolC2t11728H	0	-	1501	1158	1158	1.0000000
C2	57405264	57411302	BolC2t11729H	0	-	1891	5160	6038	0.8545876
C2	57416090	57417449	BolC2t11730H	0	-	507	1336	1359	0.9830758
C2	57422512	57423124	BolC2t11731H	0	-	233	612	612	1.0000000
C2	57424131	57424778	BolC2t11732H	0	-	1	46	647	0.0710974
C2	57433154	57433730	BolC2t11733H	0	+	0	0	576	0.0000000
C2	57435596	57436727	BolC2t11734H	0	+	41	295	1131	0.2608311
C2	57437631	57437757	BolC2t11735H	0	+	5	62	126	0.4920635
C2	57438149	57438563	BolC2t11736H	0	-	77	414	414	1.0000000
C2	57445512	57446373	BolC2t11737H	0	+	1	23	861	0.0267131
C2	57447089	57447588	BolC2t11738H	0	-	72	389	499	0.7795591
C2	57460706	57460886	BolC2t11739H	0	-	0	0	180	0.0000000
C2	57462134	57463403	BolC2t11740H	0	+	156	803	1269	0.6327817
C2	57463634	57466024	BolC2t11741H	0	-	898	1696	2390	0.7096235
C2	57466648	57468131	BolC2t11742H	0	-	761	1193	1483	0.8044505
C2	57492710	57494472	BolC2t11743H	0	-	1223	1744	1762	0.9897844
C2	57495431	57496195	BolC2t11744H	0	-	723	764	764	1.0000000
C2	57497267	57498141	BolC2t11745H	0	+	586	866	874	0.9908467
C2	57500773	57501301	BolC2t11746H	0	+	278	520	528	0.9848485
C2	57503936	57505657	BolC2t11747H	0	-	1806	1721	1721	1.0000000
C2	57510467	57510620	BolC2t11748H	0	-	38	153	153	1.0000000
C2	57540941	57541043	BolC2t11749H	0	-	0	0	102	0.0000000
C2	57541451	57541814	BolC2t11750H	0	-	17	20	363	0.0550964
C2	57543086	57544985	BolC2t11751H	0	-	338	1634	1899	0.8604529
C2	57546713	57547199	BolC2t11752H	0	-	574	486	486	1.0000000
C2	57548709	57550969	BolC2t11753H	0	-	927	1817	2260	0.8039823
C2	57562748	57562904	BolC2t11754H	0	-	0	0	156	0.0000000
C2	57563780	57564754	BolC2t11755H	0	+	589	918	974	0.9425051
C2	57564968	57567221	BolC2t11756H	0	-	678	2163	2253	0.9600533
C2	57569522	57570029	BolC2t11757H	0	+	327	507	507	1.0000000
C2	57582258	57585833	BolC2t11758H	0	+	703	2830	3575	0.7916084
C2	57588632	57588944	BolC2t11759H	0	+	37	312	312	1.0000000
C2	57591081	57592073	BolC2t11760H	0	-	719	992	992	1.0000000
C2	57595376	57595526	BolC2t11761H	0	+	220	150	150	1.0000000
C2	57599314	57599963	BolC2t11762H	0	-	0	0	649	0.0000000
C2	57600097	57600785	BolC2t11763H	0	-	179	652	688	0.9476744
C2	57622454	57623192	BolC2t11764H	0	-	596	738	738	1.0000000
C2	57625019	57625385	BolC2t11765H	0	+	145	366	366	1.0000000
C2	57627167	57628439	BolC2t11766H	0	+	797	1272	1272	1.0000000
C2	57629617	57631127	BolC2t11767H	0	-	180	1006	1510	0.6662252
C2	57633825	57634474	BolC2t11768H	0	-	3	30	649	0.0462250
C2	57658229	57661782	BolC2t11769H	0	+	2444	3553	3553	1.0000000
C2	57662563	57665740	BolC2t11770H	0	+	2934	3177	3177	1.0000000
C2	57666350	57673613	BolC2t11771H	0	-	2387	6359	7263	0.8755335
C2	57676800	57677304	BolC2t11772H	0	+	33	419	504	0.8313492
C2	57678058	57679432	BolC2t11773H	0	-	317	1142	1374	0.8311499
C2	57689375	57690425	BolC2t11774H	0	-	681	1050	1050	1.0000000
C2	57691893	57697888	BolC2t11775H	0	+	1754	5006	5995	0.8350292
C2	57698219	57703683	BolC2t11776H	0	+	2422	5237	5464	0.9584553
C2	57706154	57708179	BolC2t11777H	0	-	1047	1615	2025	0.7975309
C2	57715812	57716351	BolC2t11778H	0	-	60	338	539	0.6270872
C2	57721085	57723931	BolC2t11779H	0	-	71	868	2846	0.3049895
C2	57724806	57725324	BolC2t11780H	0	-	0	0	518	0.0000000
C2	57725468	57725859	BolC2t11781H	0	-	0	0	391	0.0000000
C2	57726217	57726382	BolC2t11782H	0	-	0	0	165	0.0000000
C2	57726682	57727282	BolC2t11783H	0	-	165	600	600	1.0000000
C2	57729757	57732415	BolC2t11784H	0	-	420	2115	2658	0.7957110
C2	57736316	57737404	BolC2t11785H	0	+	1007	1088	1088	1.0000000
C2	57745553	57747752	BolC2t11786H	0	+	1345	2199	2199	1.0000000
C2	57756965	57758777	BolC2t11787H	0	+	1320	1777	1812	0.9806843
C2	57775680	57778849	BolC2t11788H	0	+	1196	2609	3169	0.8232881
C2	57797581	57798127	BolC2t11789H	0	-	144	508	546	0.9304029
C2	57802060	57802364	BolC2t11790H	0	-	153	304	304	1.0000000
C2	57803712	57805709	BolC2t11791H	0	-	758	1858	1997	0.9303956
C2	57806402	57807994	BolC2t11792H	0	-	738	1592	1592	1.0000000
C2	57819415	57836807	BolC2t11793H	0	-	7389	15857	17392	0.9117410
C2	57843512	57845516	BolC2t11794H	0	-	828	1987	2004	0.9915169
C2	57850458	57856107	BolC2t11795H	0	-	2240	5026	5649	0.8897150
C2	57864470	57865201	BolC2t11796H	0	-	550	731	731	1.0000000
C2	57865300	57865405	BolC2t11797H	0	-	60	105	105	1.0000000
C2	57880437	57885909	BolC2t11798H	0	+	2647	4186	5472	0.7649854
C2	57886874	57889151	BolC2t11799H	0	+	1374	2205	2277	0.9683794
C2	57889389	57889563	BolC2t11800H	0	-	349	174	174	1.0000000
C2	57892477	57900517	BolC2t11801H	0	-	1154	6472	8040	0.8049752
C2	57903950	57906395	BolC2t11802H	0	+	2287	2445	2445	1.0000000
C2	57906444	57906829	BolC2t11803H	0	+	182	385	385	1.0000000
C2	57911524	57912180	BolC2t11804H	0	+	0	0	656	0.0000000
C2	57917937	57918982	BolC2t11805H	0	+	32	807	1045	0.7722488
C2	57954631	57955340	BolC2t11806H	0	+	37	207	709	0.2919605
C2	57961438	57961786	BolC2t11807H	0	-	7	155	348	0.4454023
C2	57970677	57971666	BolC2t11808H	0	+	191	505	989	0.5106168
C2	57977355	57978786	BolC2t11809H	0	-	13	69	1431	0.0482180
C2	57990843	57993444	BolC2t11810H	0	+	62	255	2601	0.0980392
C2	57996530	57997055	BolC2t11811H	0	+	7	7	525	0.0133333
C2	58000329	58001386	BolC2t11812H	0	+	79	775	1057	0.7332072
C2	58003016	58045706	BolC2t11813H	0	+	6108	21294	42690	0.4988053
C2	58023600	58024264	BolC2t11814H	0	+	541	583	664	0.8780121
C2	58040343	58040969	BolC2t11815H	0	+	88	425	626	0.6789137
C2	58075922	58076390	BolC2t11816H	0	-	0	0	468	0.0000000
C2	58077082	58077226	BolC2t11817H	0	-	70	144	144	1.0000000
C2	58080154	58080644	BolC2t11818H	0	-	433	490	490	1.0000000
C2	58086787	58088127	BolC2t11819H	0	-	1060	1340	1340	1.0000000
C2	58103319	58105684	BolC2t11820H	0	+	741	1606	2365	0.6790698
C2	58108727	58109310	BolC2t11821H	0	+	401	583	583	1.0000000
C2	58110869	58111061	BolC2t11822H	0	-	497	192	192	1.0000000
C2	58111123	58111800	BolC2t11823H	0	-	1012	677	677	1.0000000
C2	58112754	58113204	BolC2t11824H	0	-	407	437	450	0.9711111
C2	58122204	58123658	BolC2t11825H	0	-	62	912	1454	0.6272352
C2	58130168	58131920	BolC2t11826H	0	-	5	60	1752	0.0342466
C2	58143488	58143992	BolC2t11827H	0	+	95	504	504	1.0000000
C2	58144785	58145868	BolC2t11828H	0	-	176	1083	1083	1.0000000
C2	58148136	58148244	BolC2t11829H	0	-	28	108	108	1.0000000
C2	58155967	58157830	BolC2t11830H	0	-	361	1624	1863	0.8717123
C2	58175169	58178198	BolC2t11831H	0	-	691	2776	3029	0.9164741
C2	58179977	58181943	BolC2t11832H	0	+	558	1891	1966	0.9618515
C2	58186009	58187899	BolC2t11833H	0	+	990	1890	1890	1.0000000
C2	58190966	58192715	BolC2t11834H	0	+	873	1627	1749	0.9302459
C2	58194400	58195183	BolC2t11835H	0	+	832	783	783	1.0000000
C2	58195647	58198865	BolC2t11836H	0	-	930	3148	3218	0.9782473
C2	58204557	58207507	BolC2t11837H	0	+	462	2700	2950	0.9152542
C2	58215240	58216397	BolC2t11838H	0	+	373	1119	1157	0.9671564
C2	58228937	58230660	BolC2t11839H	0	+	1697	1723	1723	1.0000000
C2	58235243	58235825	BolC2t11840H	0	-	651	582	582	1.0000000
C2	58239316	58239730	BolC2t11841H	0	-	367	414	414	1.0000000
C2	58244039	58244929	BolC2t11842H	0	+	378	890	890	1.0000000
C2	58266900	58268863	BolC2t11843H	0	+	1017	1963	1963	1.0000000
C2	58270922	58273633	BolC2t11844H	0	+	1602	2658	2711	0.9804500
C2	58282018	58282594	BolC2t11845H	0	+	22	271	576	0.4704861
C2	58287374	58290365	BolC2t11846H	0	-	370	1978	2991	0.6613173
C2	58291179	58292611	BolC2t11847H	0	-	219	1184	1432	0.8268157
C2	58307948	58310217	BolC2t11848H	0	+	223	1524	2269	0.6716615
C2	58321664	58323297	BolC2t11849H	0	+	956	1633	1633	1.0000000
C2	58329983	58330822	BolC2t11850H	0	+	985	839	839	1.0000000
C2	58332589	58334952	BolC2t11851H	0	+	777	2343	2363	0.9915362
C2	58346529	58347281	BolC2t11852H	0	+	380	752	752	1.0000000
C2	58347410	58358060	BolC2t11853H	0	-	4358	9667	10650	0.9076995
C2	58365958	58366288	BolC2t11854H	0	+	0	0	330	0.0000000
C2	58384688	58386164	BolC2t11855H	0	+	442	1458	1476	0.9878049
C2	58388071	58388863	BolC2t11856H	0	+	343	792	792	1.0000000
C2	58389263	58390029	BolC2t11857H	0	+	450	766	766	1.0000000
C2	58404828	58407994	BolC2t11858H	0	+	1449	2947	3166	0.9308276
C2	58410439	58413085	BolC2t11859H	0	+	1341	2520	2646	0.9523810
C2	58416510	58424359	BolC2t11860H	0	+	3863	3297	7849	0.4200535
C2	58431621	58431989	BolC2t11861H	0	-	8	133	368	0.3614130
C2	58432603	58432858	BolC2t11862H	0	-	34	237	255	0.9294118
C2	58434026	58436705	BolC2t11863H	0	+	1390	2023	2679	0.7551325
C2	58459399	58460383	BolC2t11864H	0	+	2	278	984	0.2825203
C2	58472798	58478447	BolC2t11865H	0	+	2825	5615	5649	0.9939812
C2	58517998	58518407	BolC2t11866H	0	+	15	236	409	0.5770171
C2	58529570	58530119	BolC2t11867H	0	-	172	549	549	1.0000000
C2	58539377	58542284	BolC2t11868H	0	+	824	2907	2907	1.0000000
C2	58544326	58545889	BolC2t11869H	0	+	112	562	1563	0.3595649
C2	58546287	58546721	BolC2t11870H	0	+	55	237	434	0.5460830
C2	58577857	58578145	BolC2t11871H	0	+	252	288	288	1.0000000
C2	58579370	58579920	BolC2t11872H	0	-	411	550	550	1.0000000
C2	58586290	58586737	BolC2t11873H	0	+	381	447	447	1.0000000
C2	58592550	58592742	BolC2t11874H	0	-	21	157	192	0.8177083
C2	58603227	58603827	BolC2t11875H	0	+	182	543	600	0.9050000
C2	58607988	58612898	BolC2t11876H	0	+	1563	4049	4910	0.8246436
C2	58621759	58622522	BolC2t11877H	0	-	1	22	763	0.0288336
C2	58645800	58646913	BolC2t11878H	0	+	95	605	1113	0.5435759
C2	58658856	58660483	BolC2t11879H	0	+	1527	1627	1627	1.0000000
C2	58660854	58662932	BolC2t11880H	0	+	1443	2078	2078	1.0000000
C2	58664588	58665473	BolC2t11881H	0	-	583	885	885	1.0000000
C2	58673761	58675749	BolC2t11882H	0	+	1044	1986	1988	0.9989940
C2	58677042	58678063	BolC2t11883H	0	+	60	268	1021	0.2624878
C2	58679570	58683949	BolC2t11884H	0	+	2471	4358	4379	0.9952044
C2	58684636	58688024	BolC2t11885H	0	-	2667	3388	3388	1.0000000
C2	58690800	58699135	BolC2t11886H	0	+	5966	8325	8335	0.9988002
C2	58702533	58707025	BolC2t11887H	0	+	1702	3984	4492	0.8869101
C2	58708918	58709455	BolC2t11888H	0	-	276	537	537	1.0000000
C2	58717505	58718778	BolC2t11889H	0	+	1104	1273	1273	1.0000000
C2	58725236	58725712	BolC2t11890H	0	-	261	476	476	1.0000000
C2	58727054	58729404	BolC2t11891H	0	+	1374	2350	2350	1.0000000
C2	58734598	58737492	BolC2t11892H	0	+	1700	2894	2894	1.0000000
C2	58738474	58739449	BolC2t11893H	0	+	804	975	975	1.0000000
C2	58742278	58742990	BolC2t11894H	0	+	254	417	712	0.5856742
C2	58756342	58756734	BolC2t11895H	0	+	152	392	392	1.0000000
C2	58764235	58764580	BolC2t11896H	0	+	316	345	345	1.0000000
C2	58765340	58766958	BolC2t11897H	0	-	987	1618	1618	1.0000000
C2	58767409	58768433	BolC2t11898H	0	+	446	1024	1024	1.0000000
C2	58769264	58771207	BolC2t11899H	0	+	1218	1943	1943	1.0000000
C2	58773413	58774232	BolC2t11900H	0	+	128	607	819	0.7411478
C2	58779824	58780247	BolC2t11901H	0	+	10	120	423	0.2836879
C2	58792360	58794470	BolC2t11902H	0	-	132	1171	2110	0.5549763
C2	58802310	58803054	BolC2t11903H	0	-	117	728	744	0.9784946
C2	58804966	58807509	BolC2t11904H	0	-	595	1940	2543	0.7628785
C2	58814655	58815249	BolC2t11905H	0	-	144	491	594	0.8265993
C2	58819631	58821198	BolC2t11906H	0	-	111	371	1567	0.2367581
C2	58826451	58827131	BolC2t11907H	0	-	3	172	680	0.2529412
C2	58831136	58831453	BolC2t11908H	0	+	239	317	317	1.0000000
C2	58840642	58847049	BolC2t11909H	0	+	1442	4892	6407	0.7635399
C2	58854946	58856785	BolC2t11910H	0	-	1816	1839	1839	1.0000000
C2	58857654	58858078	BolC2t11911H	0	-	499	424	424	1.0000000
C2	58860309	58861693	BolC2t11912H	0	-	985	1384	1384	1.0000000
C2	58864363	58866917	BolC2t11913H	0	+	2112	2554	2554	1.0000000
C2	58872832	58873453	BolC2t11914H	0	-	133	621	621	1.0000000
C2	58874096	58876899	BolC2t11915H	0	-	1034	2645	2803	0.9436318
C2	58900192	58903422	BolC2t11916H	0	+	2625	3185	3230	0.9860681
C2	58908338	58914206	BolC2t11917H	0	-	2436	5481	5868	0.9340491
C2	58918157	58918958	BolC2t11918H	0	-	411	801	801	1.0000000
C2	58924934	58925457	BolC2t11919H	0	-	270	523	523	1.0000000
C2	58939141	58942455	BolC2t11920H	0	-	1032	3051	3314	0.9206397
C2	58944436	58944892	BolC2t11921H	0	-	3	61	456	0.1337719
C2	58945464	58946048	BolC2t11922H	0	-	204	584	584	1.0000000
C2	58948502	58957366	BolC2t11923H	0	+	71	1558	8864	0.1757672
C2	58959160	58962870	BolC2t11924H	0	+	2284	3710	3710	1.0000000
C2	58966970	58967225	BolC2t11925H	0	+	88	255	255	1.0000000
C2	59002169	59002820	BolC2t11926H	0	-	156	505	651	0.7757297
C2	59004882	59005014	BolC2t11927H	0	+	34	132	132	1.0000000
C2	59009288	59009704	BolC2t11928H	0	+	133	397	416	0.9543269
C2	59011683	59012332	BolC2t11929H	0	-	8	72	649	0.1109399
C2	59013612	59016116	BolC2t11930H	0	-	704	2136	2504	0.8530352
C2	59037587	59038752	BolC2t11931H	0	-	125	923	1165	0.7922747
C2	59042257	59045074	BolC2t11932H	0	-	1668	2791	2817	0.9907703
C2	59050089	59050845	BolC2t11933H	0	-	32	496	756	0.6560847
C2	59053665	59054919	BolC2t11934H	0	-	161	1229	1254	0.9800638
C2	59057627	59060427	BolC2t11935H	0	-	752	2694	2800	0.9621429
C2	59081343	59081955	BolC2t11936H	0	-	587	593	612	0.9689543
C2	59090626	59090986	BolC2t11937H	0	-	21	175	360	0.4861111
C2	59092142	59092688	BolC2t11938H	0	-	72	428	546	0.7838828
C2	59098640	59099171	BolC2t11939H	0	-	49	287	531	0.5404896
C2	59100984	59105038	BolC2t11940H	0	-	690	3455	4054	0.8522447
C2	59111243	59112646	BolC2t11941H	0	-	349	1244	1403	0.8866714
C2	59114233	59117939	BolC2t11942H	0	+	2203	3404	3706	0.9185105
C2	59126480	59126780	BolC2t11943H	0	-	198	300	300	1.0000000
C2	59135525	59135642	BolC2t11944H	0	+	8	93	117	0.7948718
C2	59137294	59146644	BolC2t11945H	0	+	2077	7470	9350	0.7989305
C2	59149183	59149550	BolC2t11946H	0	+	262	367	367	1.0000000
C2	59159646	59162659	BolC2t11947H	0	+	626	2999	3013	0.9953535
C2	59169408	59169666	BolC2t11948H	0	+	161	258	258	1.0000000
C2	59179239	59179662	BolC2t11949H	0	+	6	318	423	0.7517731
C2	59180243	59182131	BolC2t11950H	0	+	167	1463	1888	0.7748941
C2	59188783	59188924	BolC2t11951H	0	+	0	0	141	0.0000000
C2	59199106	59199937	BolC2t11952H	0	+	645	831	831	1.0000000
C2	59217932	59219380	BolC2t11953H	0	+	131	956	1448	0.6602210
C2	59239230	59256219	BolC2t11954H	0	+	1479	8114	16989	0.4776032
C2	59269829	59271179	BolC2t11955H	0	-	41	247	1350	0.1829630
C2	59277452	59278714	BolC2t11956H	0	-	213	895	1262	0.7091917
C2	59282590	59290127	BolC2t11957H	0	+	2835	6891	7537	0.9142895
C2	59291757	59293481	BolC2t11958H	0	+	322	1520	1724	0.8816705
C2	59295370	59295631	BolC2t11959H	0	+	154	261	261	1.0000000
C2	59297433	59297697	BolC2t11960H	0	+	82	264	264	1.0000000
C2	59302679	59302943	BolC2t11961H	0	+	2	19	264	0.0719697
C2	59312337	59312601	BolC2t11962H	0	+	6	255	264	0.9659091
C2	59313116	59318171	BolC2t11963H	0	-	1443	4333	5055	0.8571711
C2	59322524	59324691	BolC2t11964H	0	+	685	2086	2167	0.9626212
C2	59325693	59327823	BolC2t11965H	0	+	235	1504	2130	0.7061033
C2	59330289	59330649	BolC2t11966H	0	+	239	360	360	1.0000000
C2	59336766	59341010	BolC2t11967H	0	+	692	4045	4244	0.9531103
C2	59341172	59342010	BolC2t11968H	0	-	198	656	838	0.7828162
C2	59342963	59343400	BolC2t11969H	0	+	161	437	437	1.0000000
C2	59343731	59347011	BolC2t11970H	0	-	2026	2930	3280	0.8932927
C2	59360181	59361401	BolC2t11971H	0	-	110	764	1220	0.6262295
C2	59389139	59389546	BolC2t11972H	0	-	9	60	407	0.1474202
C2	59410629	59411817	BolC2t11973H	0	+	272	1149	1188	0.9671717
C2	59415166	59415968	BolC2t11974H	0	-	278	802	802	1.0000000
C2	59417628	59420428	BolC2t11975H	0	+	168	1922	2800	0.6864285
C2	59421990	59422479	BolC2t11976H	0	+	2	112	489	0.2290388
C2	59422615	59423137	BolC2t11977H	0	+	13	247	522	0.4731801
C2	59425379	59430409	BolC2t11978H	0	-	68	282	5030	0.0560636
C2	59430498	59430939	BolC2t11979H	0	+	0	0	441	0.0000000
C2	59437021	59438273	BolC2t11980H	0	+	243	1129	1252	0.9017572
C2	59445426	59446493	BolC2t11981H	0	+	17	437	1067	0.4095595
C2	59451844	59453032	BolC2t11982H	0	+	457	1188	1188	1.0000000
C2	59457053	59464752	BolC2t11983H	0	+	881	4174	7699	0.5421484
C2	59470866	59471342	BolC2t11984H	0	+	101	476	476	1.0000000
C2	59472708	59476501	BolC2t11985H	0	+	2009	3566	3793	0.9401529
C2	59478324	59479101	BolC2t11986H	0	+	502	777	777	1.0000000
C2	59479772	59483407	BolC2t11987H	0	-	1177	3539	3635	0.9735901
C2	59487232	59487479	BolC2t11988H	0	+	156	247	247	1.0000000
C2	59487487	59487819	BolC2t11989H	0	+	38	167	332	0.5030121
C2	59492093	59492354	BolC2t11990H	0	-	11	141	261	0.5402299
C2	59492682	59493565	BolC2t11991H	0	+	539	883	883	1.0000000
C2	59498711	59499107	BolC2t11992H	0	-	304	396	396	1.0000000
C2	59528919	59529195	BolC2t11993H	0	+	222	276	276	1.0000000
C2	59559493	59561380	BolC2t11994H	0	+	1269	1887	1887	1.0000000
C2	59565249	59566969	BolC2t11995H	0	+	117	1323	1720	0.7691860
C2	59567484	59569177	BolC2t11996H	0	+	3156	1693	1693	1.0000000
C2	59572099	59575413	BolC2t11997H	0	+	2911	3314	3314	1.0000000
C2	59576427	59578545	BolC2t11998H	0	+	1470	2109	2118	0.9957507
C2	59580009	59582629	BolC2t11999H	0	+	858	2511	2620	0.9583970
C2	59583731	59584105	BolC2t12000H	0	-	363	374	374	1.0000000
C2	59584561	59589832	BolC2t12001H	0	+	4371	5271	5271	1.0000000
C2	59592384	59594951	BolC2t12002H	0	+	872	2265	2567	0.8823529
C2	59599780	59600032	BolC2t12003H	0	+	296	252	252	1.0000000
C2	59625021	59628046	BolC2t12004H	0	+	1098	2661	3025	0.8796694
C2	59644580	59646724	BolC2t12005H	0	+	454	1723	2144	0.8036380
C2	59647784	59648651	BolC2t12006H	0	-	179	310	867	0.3575548
C2	59649529	59651435	BolC2t12007H	0	-	337	1160	1906	0.6086044
C2	59655523	59656079	BolC2t12008H	0	+	604	556	556	1.0000000
C2	59656803	59658156	BolC2t12009H	0	+	222	941	1353	0.6954915
C2	59659446	59661328	BolC2t12010H	0	+	542	1801	1882	0.9569607
C2	59664055	59665225	BolC2t12011H	0	-	149	924	1170	0.7897436
C2	59669227	59669967	BolC2t12012H	0	-	39	511	740	0.6905406
C2	59681189	59682352	BolC2t12013H	0	+	395	1090	1163	0.9372313
C2	59682961	59685170	BolC2t12014H	0	-	477	2033	2209	0.9203259
C2	59688388	59694519	BolC2t12015H	0	+	2785	5513	6131	0.8992008
C2	59695474	59696105	BolC2t12016H	0	-	149	631	631	1.0000000
C2	59710788	59711829	BolC2t12017H	0	-	64	492	1041	0.4726225
C2	59712754	59716805	BolC2t12018H	0	+	839	2936	4051	0.7247593
C2	59720643	59721732	BolC2t12019H	0	-	209	1048	1089	0.9623508
C2	59724177	59725015	BolC2t12020H	0	-	564	838	838	1.0000000
C2	59731940	59732505	BolC2t12021H	0	-	111	562	565	0.9946902
C2	59750985	59751774	BolC2t12022H	0	-	377	789	789	1.0000000
C2	59754979	59755896	BolC2t12023H	0	+	150	350	917	0.3816794
C2	59756690	59757951	BolC2t12024H	0	+	1039	1261	1261	1.0000000
C2	59764366	59765415	BolC2t12025H	0	-	733	1049	1049	1.0000000
C2	59785592	59787321	BolC2t12026H	0	+	960	1729	1729	1.0000000
C2	59801849	59802239	BolC2t12027H	0	-	837	390	390	1.0000000
C2	59805632	59807581	BolC2t12028H	0	+	773	1910	1949	0.9799898
C2	59820031	59820765	BolC2t12029H	0	+	359	648	734	0.8828338
C2	59823216	59825241	BolC2t12030H	0	-	570	1815	2025	0.8962963
C2	59827690	59828068	BolC2t12031H	0	+	188	378	378	1.0000000
C2	59829122	59831111	BolC2t12032H	0	-	1062	1989	1989	1.0000000
C2	59847058	59847244	BolC2t12033H	0	+	17	119	186	0.6397849
C2	59871254	59871935	BolC2t12034H	0	+	199	627	681	0.9207048
C2	59882103	59882322	BolC2t12035H	0	+	145	217	219	0.9908676
C2	59883921	59885485	BolC2t12036H	0	+	179	996	1564	0.6368287
C2	59889554	59891105	BolC2t12037H	0	+	245	1227	1551	0.7911025
C2	59891366	59892211	BolC2t12038H	0	-	81	575	845	0.6804734
C2	59905993	59906740	BolC2t12039H	0	-	422	692	747	0.9263722
C2	59909964	59910210	BolC2t12040H	0	+	0	0	246	0.0000000
C2	59920113	59924585	BolC2t12041H	0	-	1567	4062	4472	0.9083184
C2	59925305	59926870	BolC2t12042H	0	-	60	424	1565	0.2709265
C2	59932034	59932502	BolC2t12043H	0	-	29	163	468	0.3482906
C2	59933756	59935858	BolC2t12044H	0	-	658	2073	2102	0.9862036
C2	59939804	59940866	BolC2t12045H	0	+	872	889	1062	0.8370998
C2	59946531	59950488	BolC2t12046H	0	+	879	3068	3957	0.7753348
C2	59951096	59953048	BolC2t12047H	0	+	964	1949	1952	0.9984631
C2	59955751	59955910	BolC2t12048H	0	-	567	159	159	1.0000000
C2	59957539	59957737	BolC2t12049H	0	-	272	198	198	1.0000000
C2	59959403	59960239	BolC2t12050H	0	+	755	836	836	1.0000000
C2	59973909	59974014	BolC2t12051H	0	+	2	32	105	0.3047619
C2	59974311	59975055	BolC2t12052H	0	+	58	642	744	0.8629032
C2	59984381	59984709	BolC2t12053H	0	+	266	328	328	1.0000000
C2	59994558	59994723	BolC2t12054H	0	+	149	165	165	1.0000000
C2	60006530	60007271	BolC2t12055H	0	+	351	729	741	0.9838057
C2	60012176	60012629	BolC2t12056H	0	+	284	453	453	1.0000000
C2	60020086	60021120	BolC2t12057H	0	-	673	1034	1034	1.0000000
C2	60021930	60024451	BolC2t12058H	0	+	106	384	2521	0.1523205
C2	60037993	60044215	BolC2t12059H	0	+	3628	6183	6222	0.9937319
C2	60045332	60046531	BolC2t12060H	0	-	217	1057	1199	0.8815680
C2	60059434	60059840	BolC2t12061H	0	+	1315	406	406	1.0000000
C2	60069356	60070636	BolC2t12062H	0	+	1167	1280	1280	1.0000000
C2	60073462	60075419	BolC2t12063H	0	+	1064	1957	1957	1.0000000
C2	60076252	60079580	BolC2t12064H	0	+	2648	3328	3328	1.0000000
C2	60081335	60083776	BolC2t12065H	0	+	549	2177	2441	0.8918476
C2	60088089	60088383	BolC2t12066H	0	+	37	291	294	0.9897959
C2	60092313	60092463	BolC2t12067H	0	+	103	126	150	0.8400000
C2	60093499	60094051	BolC2t12068H	0	-	142	552	552	1.0000000
C2	60096762	60097209	BolC2t12069H	0	-	87	447	447	1.0000000
C2	60115339	60116888	BolC2t12070H	0	+	7	271	1549	0.1749516
C2	60146747	60148414	BolC2t12071H	0	+	867	1666	1667	0.9994001
C2	60165190	60165373	BolC2t12072H	0	-	24	183	183	1.0000000
C2	60168595	60168808	BolC2t12073H	0	+	61	213	213	1.0000000
C2	60175037	60181651	BolC2t12074H	0	-	3659	6179	6614	0.9342304
C2	60198361	60198860	BolC2t12075H	0	+	20	439	499	0.8797595
C2	60199385	60199850	BolC2t12076H	0	+	0	0	465	0.0000000
C2	60200807	60202597	BolC2t12077H	0	-	335	1619	1790	0.9044693
C2	60202147	60204187	BolC2t12078H	0	-	239	1452	2040	0.7117647
C2	60216690	60217039	BolC2t12079H	0	+	166	279	349	0.7994269
C2	60217050	60217292	BolC2t12080H	0	+	296	242	242	1.0000000
C2	60217211	60218265	BolC2t12081H	0	+	1087	1054	1054	1.0000000
C2	60219374	60220705	BolC2t12082H	0	+	336	1078	1331	0.8099173
C2	60240963	60241344	BolC2t12083H	0	+	612	381	381	1.0000000
C2	60246576	60248575	BolC2t12084H	0	+	1670	1999	1999	1.0000000
C2	60248798	60252404	BolC2t12085H	0	-	1630	2377	3606	0.6591792
C2	60292120	60334597	BolC2t12086H	0	+	10397	21080	42477	0.4962686
C2	60297165	60298028	BolC2t12087H	0	-	648	863	863	1.0000000
C2	60318640	60320790	BolC2t12088H	0	-	671	1567	2150	0.7288372
C2	60335130	60335442	BolC2t12089H	0	-	170	169	312	0.5416667
C2	60343792	60344389	BolC2t12090H	0	+	94	212	597	0.3551089
C2	60346102	60346420	BolC2t12091H	0	+	44	84	318	0.2641509
C2	60347936	60348385	BolC2t12092H	0	+	0	0	449	0.0000000
C2	60368301	60371388	BolC2t12093H	0	-	571	1807	3087	0.5853580
C2	60371732	60379406	BolC2t12094H	0	+	1845	4253	7674	0.5542090
C2	60378294	60378783	BolC2t12095H	0	+	243	251	489	0.5132924
C2	60385788	60393332	BolC2t12096H	0	-	509	4387	7544	0.5815217
C2	60397286	60427180	BolC2t12097H	0	-	3889	12610	29894	0.4218238
C2	60401396	60402217	BolC2t12098H	0	-	142	619	821	0.7539586
C2	60401534	60401920	BolC2t12099H	0	-	90	322	386	0.8341969
C2	60422821	60423241	BolC2t12100H	0	-	1	36	420	0.0857143
C2	60434999	60435803	BolC2t12101H	0	-	240	792	804	0.9850746
C2	60438669	60438822	BolC2t12102H	0	+	8	49	153	0.3202614
C2	60449725	60450445	BolC2t12103H	0	-	573	714	720	0.9916667
C2	60451196	60451704	BolC2t12104H	0	-	1	55	508	0.1082677
C2	60460357	60460698	BolC2t12105H	0	-	255	341	341	1.0000000
C2	60460841	60461424	BolC2t12106H	0	-	142	583	583	1.0000000
C2	60463823	60465881	BolC2t12107H	0	+	8	60	2058	0.0291545
C2	60484981	60486451	BolC2t12108H	0	+	344	1187	1470	0.8074830
C2	60487549	60489243	BolC2t12109H	0	-	456	1565	1694	0.9238489
C2	60501747	60502294	BolC2t12110H	0	-	84	364	547	0.6654479
C2	60521486	60525188	BolC2t12111H	0	+	1802	3134	3702	0.8465694
C2	60530568	60530975	BolC2t12112H	0	+	6	93	407	0.2285012
C2	60538629	60539071	BolC2t12113H	0	-	3	293	442	0.6628959
C2	60546900	60547068	BolC2t12114H	0	-	63	142	168	0.8452381
C2	60547834	60548806	BolC2t12115H	0	+	1142	621	972	0.6388889
C2	60585986	60586139	BolC2t12116H	0	-	0	0	153	0.0000000
C2	60595244	60603216	BolC2t12117H	0	+	979	4648	7972	0.5830407
C2	60606827	60610029	BolC2t12118H	0	+	323	2332	3202	0.7282948
C2	60612169	60615447	BolC2t12119H	0	+	2281	2877	3278	0.8776693
C2	60617633	60622163	BolC2t12120H	0	+	459	3168	4530	0.6993377
C2	60635067	60646933	BolC2t12121H	0	+	1784	6263	11866	0.5278106
C2	60649973	60653266	BolC2t12122H	0	+	1475	2737	3293	0.8311570
C2	60662833	60665581	BolC2t12123H	0	+	371	2297	2748	0.8358806
C2	60666163	60681021	BolC2t12124H	0	-	949	4616	14858	0.3106744
C2	60681944	60682431	BolC2t12125H	0	+	0	0	487	0.0000000
C2	60687089	60687365	BolC2t12126H	0	+	255	276	276	1.0000000
C2	60688705	60692160	BolC2t12127H	0	+	1240	3199	3455	0.9259045
C2	60694340	60695762	BolC2t12128H	0	+	492	936	1422	0.6582279
C2	60710438	60711812	BolC2t12129H	0	+	571	1170	1374	0.8515284
C2	60718650	60725636	BolC2t12130H	0	+	1875	6268	6986	0.8972230
C2	60726813	60729020	BolC2t12131H	0	+	490	1954	2207	0.8853648
C2	60733060	60733282	BolC2t12132H	0	+	96	211	222	0.9504505
C2	60734392	60736304	BolC2t12133H	0	+	243	1631	1912	0.8530335
C2	60737420	60744042	BolC2t12134H	0	+	1798	5433	6622	0.8204470
C2	60744360	60746414	BolC2t12135H	0	-	1562	1833	2054	0.8924051
C2	60746839	60749130	BolC2t12136H	0	-	1170	2158	2291	0.9419467
C2	60751525	60755330	BolC2t12137H	0	+	524	2306	3805	0.6060447
C2	60756471	60756948	BolC2t12138H	0	+	198	477	477	1.0000000
C2	60767135	60768717	BolC2t12139H	0	+	1282	1380	1582	0.8723135
C2	60774037	60774412	BolC2t12140H	0	+	106	375	375	1.0000000
C2	60793547	60794417	BolC2t12141H	0	+	239	830	870	0.9540230
C2	60797914	60798562	BolC2t12142H	0	+	128	648	648	1.0000000
C2	60807866	60808559	BolC2t12143H	0	-	133	670	693	0.9668109
C2	60810561	60812539	BolC2t12144H	0	-	1445	1948	1978	0.9848332
C2	60816097	60816694	BolC2t12145H	0	+	396	597	597	1.0000000
C2	60817301	60821305	BolC2t12146H	0	-	824	2956	4004	0.7382618
C2	60823983	60825165	BolC2t12147H	0	-	1325	1182	1182	1.0000000
C2	60828146	60830776	BolC2t12148H	0	+	1234	2284	2630	0.8684410
C2	60833929	60834761	BolC2t12149H	0	+	653	696	832	0.8365384
C2	60837585	60843232	BolC2t12150H	0	-	1201	3715	5647	0.6578714
C2	60846342	60846522	BolC2t12151H	0	-	503	108	180	0.6000000
C2	60847751	60848236	BolC2t12152H	0	+	720	485	485	1.0000000
C2	60848828	60850102	BolC2t12153H	0	-	567	1200	1274	0.9419152
C2	60853683	60854022	BolC2t12154H	0	-	169	339	339	1.0000000
C2	60876107	60876293	BolC2t12155H	0	+	0	0	186	0.0000000
C2	60879154	60883478	BolC2t12156H	0	-	2236	3594	4324	0.8311749
C2	60887581	60890811	BolC2t12157H	0	-	996	2468	3230	0.7640867
C2	60906227	60906801	BolC2t12158H	0	-	42	401	574	0.6986063
C2	60919342	60919873	BolC2t12159H	0	+	11	201	531	0.3785311
C2	60927410	60928262	BolC2t12160H	0	+	137	665	852	0.7805164
C2	60932305	60933945	BolC2t12161H	0	+	18	381	1640	0.2323171
C2	60949457	60950930	BolC2t12162H	0	-	817	1342	1473	0.9110659
C2	60969085	61004784	BolC2t12163H	0	+	6384	21754	35699	0.6093728
C2	60978012	60978601	BolC2t12164H	0	-	180	589	589	1.0000000
C2	60979437	60979940	BolC2t12165H	0	-	8	231	503	0.4592445
C2	60979619	60980009	BolC2t12166H	0	-	8	265	390	0.6794872
C2	61006504	61006726	BolC2t12167H	0	+	98	118	222	0.5315315
C2	61008584	61016721	BolC2t12168H	0	-	419	2417	8137	0.2970382
C2	61015277	61015580	BolC2t12169H	0	-	0	0	303	0.0000000
C2	61020744	61025283	BolC2t12170H	0	-	2712	3717	4539	0.8189029
C2	61034350	61034761	BolC2t12171H	0	+	1958	385	411	0.9367397
C2	61036130	61037498	BolC2t12172H	0	-	407	989	1368	0.7229532
C2	61038762	61045459	BolC2t12173H	0	-	2012	5963	6697	0.8903987
C2	61047134	61047308	BolC2t12174H	0	-	37	174	174	1.0000000
C2	61048025	61049101	BolC2t12175H	0	-	56	700	1076	0.6505576
C2	61053383	61055703	BolC2t12176H	0	+	589	2107	2320	0.9081897
C2	61056164	61058659	BolC2t12177H	0	-	630	2306	2495	0.9242485
C2	61060818	61063181	BolC2t12178H	0	-	594	1427	2363	0.6038933
C2	61087656	61088094	BolC2t12179H	0	-	47	192	438	0.4383562
C2	61093124	61094380	BolC2t12180H	0	-	9	111	1256	0.0883758
C2	61096509	61099387	BolC2t12181H	0	-	1998	2679	2878	0.9308547
C2	61099861	61101782	BolC2t12182H	0	-	509	1754	1921	0.9130661
C2	61107741	61108883	BolC2t12183H	0	-	338	825	1142	0.7224168
C2	61109971	61110595	BolC2t12184H	0	-	103	552	624	0.8846154
C2	61115641	61118484	BolC2t12185H	0	-	926	2405	2843	0.8459374
C2	61119314	61122196	BolC2t12186H	0	-	1365	2486	2882	0.8625954
C2	61122947	61135405	BolC2t12187H	0	+	4650	8723	12458	0.7001926
C2	61136169	61139804	BolC2t12188H	0	-	1938	3488	3635	0.9595599
C2	61140608	61141188	BolC2t12189H	0	+	77	556	580	0.9586207
C2	61143507	61144535	BolC2t12190H	0	+	861	726	1028	0.7062257
C2	61144691	61145079	BolC2t12191H	0	+	2	19	388	0.0489691
C2	61147923	61148311	BolC2t12192H	0	-	14	276	388	0.7113402
C2	61152242	61152584	BolC2t12193H	0	-	278	211	342	0.6169590
C2	61154517	61157311	BolC2t12194H	0	+	625	2575	2794	0.9216177
C2	61158987	61160551	BolC2t12195H	0	+	566	1516	1564	0.9693094
C2	61167427	61169538	BolC2t12196H	0	-	1373	2110	2111	0.9995263
C2	61171012	61171276	BolC2t12197H	0	-	64	186	264	0.7045454
C2	61172590	61174113	BolC2t12198H	0	+	742	1024	1523	0.6723572
C2	61175766	61176936	BolC2t12199H	0	+	697	1087	1170	0.9290598
C2	61183082	61183929	BolC2t12200H	0	+	100	670	847	0.7910271
C2	61184205	61185386	BolC2t12201H	0	-	260	954	1181	0.8077900
C2	61194024	61194708	BolC2t12202H	0	+	11	382	684	0.5584795
C2	61208653	61211976	BolC2t12203H	0	-	1098	2697	3323	0.8116160
C2	61218868	61222406	BolC2t12204H	0	-	457	2252	3538	0.6365178
C2	61226922	61230534	BolC2t12205H	0	-	913	3202	3612	0.8864895
C2	61235855	61236825	BolC2t12206H	0	-	0	0	970	0.0000000
C2	61239057	61240588	BolC2t12207H	0	+	2317	1531	1531	1.0000000
C2	61255450	61256368	BolC2t12208H	0	-	619	889	918	0.9684096
C2	61257138	61258452	BolC2t12209H	0	-	37	810	1314	0.6164383
C2	61263361	61264165	BolC2t12210H	0	-	252	737	804	0.9166667
C2	61264845	61272579	BolC2t12211H	0	-	3308	6673	7734	0.8628135
C2	61284190	61284331	BolC2t12212H	0	+	26	63	141	0.4468085
C2	61297385	61298522	BolC2t12213H	0	+	336	1137	1137	1.0000000
C2	61303884	61304361	BolC2t12214H	0	-	57	324	477	0.6792453
C2	61315388	61315544	BolC2t12215H	0	-	0	0	156	0.0000000
C2	61326550	61328159	BolC2t12216H	0	+	1047	1597	1609	0.9925420
C2	61334406	61335154	BolC2t12217H	0	+	308	478	748	0.6390374
C2	61346920	61358901	BolC2t12218H	0	+	1491	4988	11981	0.4163258
C2	61353582	61355122	BolC2t12219H	0	+	0	0	1540	0.0000000
C2	61359908	61360208	BolC2t12220H	0	+	0	0	300	0.0000000
C2	61360931	61362711	BolC2t12221H	0	+	87	1136	1780	0.6382023
C2	61363562	61366144	BolC2t12222H	0	-	1155	2349	2582	0.9097599
C2	61367586	61369903	BolC2t12223H	0	-	1149	2197	2317	0.9482089
C2	61391536	61394081	BolC2t12224H	0	+	609	2108	2545	0.8282908
C2	61395393	61400945	BolC2t12225H	0	-	2466	5378	5552	0.9686599
C2	61405711	61406759	BolC2t12226H	0	-	264	1022	1048	0.9751908
C2	61413543	61419145	BolC2t12227H	0	-	1510	4458	5602	0.7957872
C2	61421696	61424525	BolC2t12228H	0	-	627	2369	2829	0.8373984
C2	61425932	61438144	BolC2t12229H	0	+	4069	10685	12212	0.8749591
C2	61438739	61442708	BolC2t12230H	0	-	491	3023	3969	0.7616528
C2	61445494	61448305	BolC2t12231H	0	-	144	747	2811	0.2657417
C2	61446033	61446360	BolC2t12232H	0	-	0	0	327	0.0000000
C2	61448805	61449268	BolC2t12233H	0	-	2	136	463	0.2937365
C2	61453310	61453604	BolC2t12234H	0	+	0	0	294	0.0000000
C2	61454058	61457845	BolC2t12235H	0	+	2253	3372	3787	0.8904146
C2	61459415	61464810	BolC2t12236H	0	+	1459	4269	5395	0.7912883
C2	61486932	61490607	BolC2t12237H	0	+	1775	3424	3675	0.9317007
C2	61495553	61496399	BolC2t12238H	0	+	770	790	846	0.9338061
C2	61498074	61503733	BolC2t12239H	0	+	1908	3972	5659	0.7018908
C2	61504692	61504884	BolC2t12240H	0	+	0	0	192	0.0000000
C2	61506018	61508290	BolC2t12241H	0	-	1848	1953	2272	0.8595951
C2	61509939	61513118	BolC2t12242H	0	-	1413	3159	3179	0.9937087
C2	61525171	61526448	BolC2t12243H	0	+	183	770	1277	0.6029757
C2	61526768	61531654	BolC2t12244H	0	-	759	3959	4886	0.8102742
C2	61550076	61552409	BolC2t12245H	0	-	957	1884	2333	0.8075439
C2	61557420	61558654	BolC2t12246H	0	-	394	1016	1234	0.8233387
C2	61563338	61563566	BolC2t12247H	0	-	60	228	228	1.0000000
C2	61568631	61569794	BolC2t12248H	0	+	151	733	1163	0.6302665
C2	61570860	61571450	BolC2t12249H	0	+	391	570	590	0.9661017
C2	61571759	61572045	BolC2t12250H	0	+	2	24	286	0.0839161
C2	61578769	61579310	BolC2t12251H	0	+	4	34	541	0.0628466
C2	61580841	61581675	BolC2t12252H	0	-	212	304	834	0.3645084
C2	61584799	61586272	BolC2t12253H	0	+	298	1239	1473	0.8411405
C2	61587198	61587571	BolC2t12254H	0	+	159	373	373	1.0000000
C2	61589170	61591046	BolC2t12255H	0	+	19	61	1876	0.0325160
C2	61603227	61604712	BolC2t12256H	0	-	19	236	1485	0.1589226
C2	61607508	61611550	BolC2t12257H	0	+	1362	3484	4042	0.8619495
C2	61612011	61612510	BolC2t12258H	0	-	820	481	499	0.9639279
C2	61630148	61631126	BolC2t12259H	0	-	689	978	978	1.0000000
C2	61632244	61633454	BolC2t12260H	0	-	484	939	1210	0.7760330
C2	61646136	61646703	BolC2t12261H	0	-	241	428	567	0.7548501
C2	61648601	61650507	BolC2t12262H	0	-	458	1878	1906	0.9853095
C2	61653447	61654933	BolC2t12263H	0	-	1336	1411	1486	0.9495289
C2	61667200	61668372	BolC2t12264H	0	-	560	1129	1172	0.9633106
C2	61680790	61682778	BolC2t12265H	0	+	582	1899	1988	0.9552314
C2	61683708	61685355	BolC2t12266H	0	+	476	1642	1647	0.9969642
C2	61693418	61694351	BolC2t12267H	0	+	101	518	933	0.5551983
C2	61699366	61699631	BolC2t12268H	0	+	180	265	265	1.0000000
C2	61707827	61711503	BolC2t12269H	0	+	852	3334	3676	0.9069641
C2	61712520	61717547	BolC2t12270H	0	+	1706	4189	5027	0.8333002
C2	61722477	61723360	BolC2t12271H	0	+	52	562	883	0.6364666
C2	61732191	61733408	BolC2t12272H	0	+	1115	1217	1217	1.0000000
C2	61736702	61737030	BolC2t12273H	0	+	305	328	328	1.0000000
C2	61743203	61744860	BolC2t12274H	0	+	494	1351	1657	0.8153289
C2	61749312	61749495	BolC2t12275H	0	-	16	183	183	1.0000000
C2	61752652	61753975	BolC2t12276H	0	-	513	1313	1323	0.9924414
C2	61755883	61757547	BolC2t12277H	0	+	1061	1468	1664	0.8822116
C2	61760994	61762390	BolC2t12278H	0	-	347	1360	1396	0.9742121
C2	61772331	61774118	BolC2t12279H	0	+	721	1510	1787	0.8449916
C2	61775042	61776129	BolC2t12280H	0	+	342	916	1087	0.8426863
C2	61776934	61778884	BolC2t12281H	0	+	546	1694	1950	0.8687180
C2	61779102	61780091	BolC2t12282H	0	-	144	970	989	0.9807886
C2	61781878	61782289	BolC2t12283H	0	-	0	0	411	0.0000000
C2	61783966	61785432	BolC2t12284H	0	+	372	1239	1466	0.8451569
C2	61787161	61787815	BolC2t12285H	0	-	1	39	654	0.0596330
C2	61788264	61790935	BolC2t12286H	0	-	183	846	2671	0.3167353
C2	61792014	61792947	BolC2t12287H	0	+	424	796	933	0.8531619
C2	61793846	61794155	BolC2t12288H	0	-	292	309	309	1.0000000
C2	61795841	61796174	BolC2t12289H	0	+	529	333	333	1.0000000
C2	61800035	61801703	BolC2t12290H	0	+	209	1107	1668	0.6636690
C2	61810991	61815570	BolC2t12291H	0	+	1661	4176	4579	0.9119895
C2	61815969	61818365	BolC2t12292H	0	-	42	705	2396	0.2942404
C2	61850055	61851409	BolC2t12293H	0	+	315	1060	1354	0.7828656
C2	61852881	61853091	BolC2t12294H	0	-	119	210	210	1.0000000
C2	61856548	61856912	BolC2t12295H	0	+	301	364	364	1.0000000
C2	61861003	61863178	BolC2t12296H	0	-	537	1725	2175	0.7931035
C2	61864833	61866215	BolC2t12297H	0	-	472	1338	1382	0.9681621
C2	61866300	61871039	BolC2t12298H	0	-	3238	4203	4739	0.8868960
C2	61867946	61879291	BolC2t12299H	0	+	3580	8362	11345	0.7370648
C2	61880714	61888091	BolC2t12300H	0	+	1914	5249	7377	0.7115359
C2	61894822	61896438	BolC2t12301H	0	+	610	1376	1616	0.8514851
C2	61905693	61906560	BolC2t12302H	0	+	40	698	867	0.8050750
C2	61907947	61908311	BolC2t12303H	0	+	31	304	364	0.8351648
C2	61908762	61909237	BolC2t12304H	0	+	3	12	475	0.0252632
C2	61911039	61911347	BolC2t12305H	0	-	8	271	308	0.8798701
C2	61914639	61917705	BolC2t12306H	0	+	784	2899	3066	0.9455317
C2	61918878	61920000	BolC2t12307H	0	+	915	1074	1122	0.9572192
C2	61923630	61924686	BolC2t12308H	0	-	717	969	1056	0.9176136
C2	61935066	61935213	BolC2t12309H	0	-	91	107	147	0.7278911
C2	61936759	61944610	BolC2t12310H	0	+	2668	3852	7851	0.4906381
C2	61954942	61957822	BolC2t12311H	0	-	956	2359	2880	0.8190972
C2	61965986	61967245	BolC2t12312H	0	-	231	1090	1259	0.8657665
C2	61969749	61971263	BolC2t12313H	0	-	199	1135	1514	0.7496697
C2	61973816	61975581	BolC2t12314H	0	+	764	1429	1765	0.8096317
C2	61976353	61976863	BolC2t12315H	0	+	480	510	510	1.0000000
C2	61979468	61980202	BolC2t12316H	0	-	51	147	734	0.2002725
C2	61984200	61986703	BolC2t12317H	0	-	1515	2160	2503	0.8629645
C2	62008079	62010089	BolC2t12318H	0	-	680	1824	2010	0.9074627
C2	62012080	62014400	BolC2t12319H	0	-	789	1951	2320	0.8409483
C2	62018278	62024470	BolC2t12320H	0	+	21781	4856	6192	0.7842377
C2	62028242	62028970	BolC2t12321H	0	-	173	558	728	0.7664835
C2	62031129	62031587	BolC2t12322H	0	+	384	458	458	1.0000000
C2	62040952	62041648	BolC2t12323H	0	-	0	0	696	0.0000000
C2	62054425	62054590	BolC2t12324H	0	+	0	0	165	0.0000000
C2	62054820	62059773	BolC2t12325H	0	+	6	139	4953	0.0280638
C2	62064540	62065076	BolC2t12326H	0	+	48	347	536	0.6473880
C2	62067881	62068328	BolC2t12327H	0	+	243	384	447	0.8590604
C2	62068888	62069517	BolC2t12328H	0	+	17	425	629	0.6756757
C2	62072380	62073263	BolC2t12329H	0	+	32	593	883	0.6715742
C2	62089149	62090981	BolC2t12330H	0	-	57	392	1832	0.2139738
C2	62101589	62101972	BolC2t12331H	0	+	0	0	383	0.0000000
C2	62124128	62124982	BolC2t12332H	0	+	484	851	854	0.9964871
C2	62128148	62128865	BolC2t12333H	0	-	3	27	717	0.0376569
C2	62138588	62139136	BolC2t12334H	0	-	62	477	548	0.8704380
C2	62147871	62148123	BolC2t12335H	0	-	1	36	252	0.1428571
C2	62150965	62151163	BolC2t12336H	0	-	50	198	198	1.0000000
C2	62156371	62157298	BolC2t12337H	0	-	4	19	927	0.0204962
C2	62160592	62160811	BolC2t12338H	0	-	24	136	219	0.6210046
C2	62174591	62174937	BolC2t12339H	0	-	77	279	346	0.8063584
C2	62189504	62190581	BolC2t12340H	0	+	119	820	1077	0.7613742
C2	62196867	62197300	BolC2t12341H	0	-	0	0	433	0.0000000
C2	62205718	62208236	BolC2t12342H	0	-	135	1654	2518	0.6568705
C2	62211130	62212592	BolC2t12343H	0	+	15	377	1462	0.2578659
C2	62218726	62219107	BolC2t12344H	0	+	0	0	381	0.0000000
C2	62223018	62224614	BolC2t12345H	0	-	1134	1482	1596	0.9285714
C2	62232449	62237458	BolC2t12346H	0	-	1894	4360	5009	0.8704332
C2	62238364	62239587	BolC2t12347H	0	+	247	1018	1223	0.8323794
C2	62240707	62241040	BolC2t12348H	0	+	2	56	333	0.1681682
C2	62242116	62242701	BolC2t12349H	0	+	475	585	585	1.0000000
C2	62242822	62245409	BolC2t12350H	0	-	1493	2322	2587	0.8975648
C2	62251365	62251527	BolC2t12351H	0	+	201	162	162	1.0000000
C2	62265578	62268201	BolC2t12352H	0	+	1361	2568	2623	0.9790316
C2	62281506	62283235	BolC2t12353H	0	+	177	1151	1729	0.6657027
C2	62290184	62291915	BolC2t12354H	0	-	1836	1323	1731	0.7642981
C2	62298004	62298172	BolC2t12355H	0	-	104	168	168	1.0000000
C2	62300433	62302554	BolC2t12356H	0	-	1057	1559	2121	0.7350307
C2	62303329	62305745	BolC2t12357H	0	+	437	2315	2416	0.9581954
C2	62307092	62307532	BolC2t12358H	0	+	189	440	440	1.0000000
C2	62308065	62308922	BolC2t12359H	0	-	170	594	857	0.6931155
C2	62309366	62310134	BolC2t12360H	0	-	616	737	768	0.9596354
C2	62311075	62312286	BolC2t12361H	0	+	452	924	1211	0.7630058
C2	62313624	62316515	BolC2t12362H	0	+	75	306	2891	0.1058457
C2	62317233	62317662	BolC2t12363H	0	-	575	429	429	1.0000000
C2	62317796	62318569	BolC2t12364H	0	-	482	458	773	0.5924968
C2	62318692	62320576	BolC2t12365H	0	-	770	1742	1884	0.9246284
C2	62322267	62325383	BolC2t12366H	0	+	380	1018	3116	0.3267009
C2	62327870	62329148	BolC2t12367H	0	+	338	993	1278	0.7769953
C2	62329755	62330853	BolC2t12368H	0	-	226	932	1098	0.8488160
C2	62332462	62338841	BolC2t12369H	0	+	1167	5553	6379	0.8705126
C2	62342460	62344407	BolC2t12370H	0	+	175	1171	1947	0.6014381
C2	62345525	62348939	BolC2t12371H	0	-	1172	2951	3414	0.8643820
C2	62349196	62349883	BolC2t12372H	0	+	442	341	687	0.4963610
C2	62350156	62351759	BolC2t12373H	0	-	397	589	1603	0.3674361
C2	62352877	62354116	BolC2t12374H	0	-	276	909	1239	0.7336562
C2	62358233	62362306	BolC2t12375H	0	+	2448	3274	4073	0.8038301
C2	62366476	62369718	BolC2t12376H	0	+	1521	2831	3242	0.8732264
C2	62370071	62372012	BolC2t12377H	0	-	2013	1724	1941	0.8882020
C2	62379119	62379688	BolC2t12378H	0	-	430	342	569	0.6010545
C2	62380576	62383382	BolC2t12379H	0	+	801	1212	2806	0.4319316
C2	62384184	62386212	BolC2t12380H	0	+	639	1729	2028	0.8525641
C2	62392559	62395330	BolC2t12381H	0	-	1157	2307	2771	0.8325514
C2	62403426	62406316	BolC2t12382H	0	+	717	2672	2890	0.9245675
C2	62406660	62407352	BolC2t12383H	0	-	101	662	692	0.9566474
C2	62408856	62415099	BolC2t12384H	0	-	2784	5178	6243	0.8294089
C2	62424416	62425541	BolC2t12385H	0	-	218	1054	1125	0.9368889
C2	62439377	62440953	BolC2t12386H	0	-	266	1313	1576	0.8331218
C2	62468243	62469624	BolC2t12387H	0	-	388	965	1381	0.6987690
C2	62471902	62472675	BolC2t12388H	0	-	1212	579	773	0.7490298
C2	62505477	62506183	BolC2t12389H	0	-	93	706	706	1.0000000
C2	62508405	62510289	BolC2t12390H	0	-	1156	1433	1884	0.7606157
C2	62518393	62524427	BolC2t12391H	0	-	21	125	6034	0.0207159
C2	62525627	62527079	BolC2t12392H	0	+	350	1218	1452	0.8388430
C2	62528075	62530116	BolC2t12393H	0	-	653	1891	2041	0.9265066
C2	62533029	62535140	BolC2t12394H	0	+	326	2027	2111	0.9602084
C2	62542820	62543735	BolC2t12395H	0	+	23	524	915	0.5726776
C2	62577901	62582235	BolC2t12396H	0	-	1294	3386	4334	0.7812644
C2	62583040	62583433	BolC2t12397H	0	+	193	393	393	1.0000000
C2	62584034	62586182	BolC2t12398H	0	-	842	2148	2148	1.0000000
C2	62588448	62589153	BolC2t12399H	0	-	527	705	705	1.0000000
C2	62591595	62592354	BolC2t12400H	0	-	966	759	759	1.0000000
C2	62593296	62593798	BolC2t12401H	0	-	402	502	502	1.0000000
C2	62594623	62595823	BolC2t12402H	0	-	1391	1200	1200	1.0000000
C2	62596789	62601160	BolC2t12403H	0	-	1785	4272	4371	0.9773507
C2	62608094	62612731	BolC2t12404H	0	+	2183	3451	4637	0.7442312
C2	62617906	62618740	BolC2t12405H	0	-	12	322	834	0.3860911
C2	62620765	62625104	BolC2t12406H	0	+	1416	3793	4339	0.8741646
C2	62626537	62626744	BolC2t12407H	0	+	179	207	207	1.0000000
C2	62628297	62630064	BolC2t12408H	0	+	92	995	1767	0.5631013
C2	62641074	62641338	BolC2t12409H	0	+	1	45	264	0.1704545
C2	62642869	62646445	BolC2t12410H	0	+	449	2477	3576	0.6926734
C2	62650018	62651695	BolC2t12411H	0	-	193	1596	1677	0.9516994
C2	62655272	62657644	BolC2t12412H	0	-	264	1681	2372	0.7086847
C2	62658795	62662092	BolC2t12413H	0	-	376	2642	3297	0.8013346
C2	62681940	62683695	BolC2t12414H	0	-	1297	1755	1755	1.0000000
C2	62684311	62685152	BolC2t12415H	0	+	103	790	841	0.9393579
C2	62686173	62687812	BolC2t12416H	0	+	793	1586	1639	0.9676632
C2	62688465	62691342	BolC2t12417H	0	+	1298	2591	2877	0.9005909
C2	62691999	62692266	BolC2t12418H	0	-	180	259	267	0.9700375
C2	62698406	62699150	BolC2t12419H	0	-	4	123	744	0.1653226
C2	62704253	62709603	BolC2t12420H	0	+	981	4554	5350	0.8512149
C2	62721307	62723108	BolC2t12421H	0	+	750	1724	1801	0.9572459
C2	62725415	62725821	BolC2t12422H	0	-	196	406	406	1.0000000
C2	62729747	62732051	BolC2t12423H	0	+	412	1547	2304	0.6714410
C2	62746632	62755429	BolC2t12424H	0	+	1523	5787	8797	0.6578379
C2	62755795	62756323	BolC2t12425H	0	-	649	528	528	1.0000000
C2	62758293	62758575	BolC2t12426H	0	-	353	282	282	1.0000000
C2	62764761	62767950	BolC2t12427H	0	-	728	2391	3189	0.7497648
C2	62769894	62771325	BolC2t12428H	0	+	524	1314	1431	0.9182390
C2	62772587	62773303	BolC2t12429H	0	-	195	716	716	1.0000000
C2	62776981	62777200	BolC2t12430H	0	-	0	0	219	0.0000000
C2	62791489	62792254	BolC2t12431H	0	+	77	706	765	0.9228758
C2	62810596	62812330	BolC2t12432H	0	-	147	1012	1734	0.5836217
C2	62821048	62821446	BolC2t12433H	0	-	19	51	398	0.1281407
C2	62846461	62846566	BolC2t12434H	0	+	0	0	105	0.0000000
C2	62850775	62851063	BolC2t12435H	0	+	19	255	288	0.8854167
C2	62851142	62852037	BolC2t12436H	0	+	345	737	895	0.8234637
C2	62852247	62852853	BolC2t12437H	0	-	243	603	606	0.9950495
C2	62856209	62868377	BolC2t12438H	0	+	132	2726	12168	0.2240302
C2	62873493	62875952	BolC2t12439H	0	+	622	2343	2459	0.9528264
C2	62877330	62889041	BolC2t12440H	0	-	1150	4559	11711	0.3892921
C2	62891609	62894194	BolC2t12441H	0	+	210	1810	2585	0.7001934
C2	62900894	62901374	BolC2t12442H	0	-	12	164	480	0.3416667
C2	62914112	62930843	BolC2t12443H	0	+	642	5272	16731	0.3151037
C2	62921558	62922101	BolC2t12444H	0	-	0	0	543	0.0000000
C2	62922653	62923687	BolC2t12445H	0	-	1	64	1034	0.0618956
C2	62942974	62948601	BolC2t12446H	0	+	4131	4936	5627	0.8771992
C2	62945883	62946641	BolC2t12447H	0	+	207	712	758	0.9393140
C2	62959928	62960189	BolC2t12448H	0	-	171	261	261	1.0000000
C2	62969682	62972477	BolC2t12449H	0	+	422	1732	2795	0.6196780
C2	62977083	62977911	BolC2t12450H	0	+	929	828	828	1.0000000
C2	62979493	62981783	BolC2t12451H	0	-	146	1718	2290	0.7502183
C2	62995914	62996525	BolC2t12452H	0	+	0	0	611	0.0000000
C2	62997014	62998466	BolC2t12453H	0	-	186	604	1452	0.4159780
C2	62999525	63000032	BolC2t12454H	0	-	120	342	507	0.6745562
C2	63007570	63008533	BolC2t12455H	0	+	78	671	963	0.6967809
C2	63012081	63013737	BolC2t12456H	0	-	645	1610	1656	0.9722222
C2	63014696	63015714	BolC2t12457H	0	-	445	1018	1018	1.0000000
C2	63016064	63016283	BolC2t12458H	0	-	86	219	219	1.0000000
C2	63029801	63029939	BolC2t12459H	0	-	33	138	138	1.0000000
C2	63030821	63032620	BolC2t12460H	0	+	124	1385	1799	0.7698721
C2	63033795	63033960	BolC2t12461H	0	+	117	165	165	1.0000000
C2	63034643	63035681	BolC2t12462H	0	-	411	944	1038	0.9094412
C2	63036031	63037599	BolC2t12463H	0	-	396	1247	1568	0.7952806
C2	63039982	63040151	BolC2t12464H	0	+	0	0	169	0.0000000
C2	63041067	63044998	BolC2t12465H	0	+	2144	3867	3931	0.9837192
C2	63045947	63046391	BolC2t12466H	0	-	309	444	444	1.0000000
C2	63054901	63056771	BolC2t12467H	0	-	736	1664	1870	0.8898396
C2	63065845	63067346	BolC2t12468H	0	-	1492	1501	1501	1.0000000
C2	63068349	63069433	BolC2t12469H	0	+	1494	1084	1084	1.0000000
C2	63070046	63071075	BolC2t12470H	0	+	408	1029	1029	1.0000000
C2	63073295	63074045	BolC2t12471H	0	-	104	472	750	0.6293333
C2	63080059	63083195	BolC2t12472H	0	-	2130	3136	3136	1.0000000
C2	63087290	63088681	BolC2t12473H	0	+	1151	1391	1391	1.0000000
C2	63101139	63101949	BolC2t12474H	0	+	432	810	810	1.0000000
C2	63113198	63115051	BolC2t12475H	0	-	559	1837	1853	0.9913654
C2	63119509	63122271	BolC2t12476H	0	+	543	2146	2762	0.7769732
C2	63267567	63268243	BolC2t12477H	0	+	286	676	676	1.0000000
C2	63268832	63269266	BolC2t12478H	0	-	238	434	434	1.0000000
C2	63269418	63269749	BolC2t12479H	0	-	368	331	331	1.0000000
C2	63271222	63272286	BolC2t12480H	0	+	40	521	1064	0.4896617
C2	63273589	63274056	BolC2t12481H	0	+	0	0	467	0.0000000
C2	63275352	63278506	BolC2t12482H	0	+	354	2150	3154	0.6816741
C2	63279293	63280035	BolC2t12483H	0	+	177	540	742	0.7277628
C2	63281244	63281403	BolC2t12484H	0	+	106	159	159	1.0000000
C2	63282662	63285047	BolC2t12485H	0	-	733	1931	2385	0.8096436
C2	63291853	63292762	BolC2t12486H	0	-	93	733	909	0.8063806
C2	63309082	63309751	BolC2t12487H	0	-	13	253	669	0.3781764
C2	63309952	63310323	BolC2t12488H	0	-	16	186	371	0.5013477
C2	63319754	63321673	BolC2t12489H	0	+	907	1584	1919	0.8254299
C2	63337711	63337987	BolC2t12490H	0	-	43	276	276	1.0000000
C2	63346340	63347500	BolC2t12491H	0	+	697	1160	1160	1.0000000
C2	63350409	63351111	BolC2t12492H	0	+	352	702	702	1.0000000
C2	63354087	63356446	BolC2t12493H	0	+	131	1580	2359	0.6697753
C2	63360060	63360321	BolC2t12494H	0	+	258	261	261	1.0000000
C2	63361671	63364727	BolC2t12495H	0	+	347	2317	3056	0.7581806
C2	63375803	63377130	BolC2t12496H	0	+	93	756	1327	0.5697061
C2	63389434	63391068	BolC2t12497H	0	-	47	979	1634	0.5991432
C2	63402608	63403214	BolC2t12498H	0	-	116	431	606	0.7112211
C2	63413557	63413959	BolC2t12499H	0	-	295	402	402	1.0000000
C2	63416557	63416901	BolC2t12500H	0	+	139	340	344	0.9883721
C2	63418971	63419466	BolC2t12501H	0	+	91	408	495	0.8242424
C2	63423833	63424530	BolC2t12502H	0	+	13	317	697	0.4548063
C2	63428697	63429143	BolC2t12503H	0	+	20	338	446	0.7578475
C2	63429829	63430137	BolC2t12504H	0	-	139	184	308	0.5974026
C2	63432221	63434629	BolC2t12505H	0	+	244	1654	2408	0.6868771
C2	63435061	63435256	BolC2t12506H	0	-	29	195	195	1.0000000
C2	63441434	63442801	BolC2t12507H	0	+	398	1032	1367	0.7549378
C2	63448352	63450627	BolC2t12508H	0	-	629	1547	2275	0.6800000
C2	63450935	63453998	BolC2t12509H	0	-	1549	2833	3063	0.9249102
C2	63459295	63460763	BolC2t12510H	0	+	373	1412	1468	0.9618528
C2	63462526	63463234	BolC2t12511H	0	+	36	465	708	0.6567796
C2	63466866	63467707	BolC2t12512H	0	+	234	841	841	1.0000000
C2	63473560	63478463	BolC2t12513H	0	-	975	4655	4903	0.9494187
C2	63479453	63479705	BolC2t12514H	0	+	175	252	252	1.0000000
C2	63491578	63492196	BolC2t12515H	0	+	6	252	618	0.4077670
C2	63493117	63495704	BolC2t12516H	0	-	51	702	2587	0.2713568
C2	63497405	63497742	BolC2t12517H	0	-	50	284	337	0.8427300
C2	63498627	63502466	BolC2t12518H	0	+	695	3522	3839	0.9174264
C2	63505699	63508163	BolC2t12519H	0	+	155	1590	2464	0.6452922
C2	63510164	63511007	BolC2t12520H	0	-	162	794	843	0.9418743
C2	63512131	63514051	BolC2t12521H	0	-	221	972	1920	0.5062500
C2	63524869	63526505	BolC2t12522H	0	+	803	1493	1636	0.9125917
C2	63544124	63544307	BolC2t12523H	0	-	7	181	183	0.9890710
C2	63556031	63559059	BolC2t12524H	0	+	830	2641	3028	0.8721929
C2	63561575	63561968	BolC2t12525H	0	-	274	393	393	1.0000000
C2	63563189	63563904	BolC2t12526H	0	-	1	33	715	0.0461538
C2	63568525	63569221	BolC2t12527H	0	-	28	313	696	0.4497126
C2	63586998	63588470	BolC2t12528H	0	-	1025	1472	1472	1.0000000
C2	63589281	63591372	BolC2t12529H	0	-	64	869	2091	0.4155906
C2	63599912	63601350	BolC2t12530H	0	+	1296	1438	1438	1.0000000
C2	63602631	63605532	BolC2t12531H	0	+	2733	2901	2901	1.0000000
C2	63605891	63607421	BolC2t12532H	0	+	1387	1530	1530	1.0000000
C2	63614646	63615585	BolC2t12533H	0	-	965	939	939	1.0000000
C2	63619452	63620148	BolC2t12534H	0	+	404	696	696	1.0000000
C2	63621882	63622238	BolC2t12535H	0	+	408	356	356	1.0000000
C2	63623796	63624054	BolC2t12536H	0	-	145	258	258	1.0000000
C2	63628379	63628610	BolC2t12537H	0	-	28	165	231	0.7142857
C2	63636772	63636964	BolC2t12538H	0	-	128	192	192	1.0000000
C2	63643546	63643846	BolC2t12539H	0	-	192	300	300	1.0000000
C2	63647998	63648633	BolC2t12540H	0	-	290	635	635	1.0000000
C2	63649736	63652864	BolC2t12541H	0	-	1632	3124	3128	0.9987212
C2	63653621	63654900	BolC2t12542H	0	-	158	1193	1279	0.9327599
C2	63657598	63659471	BolC2t12543H	0	+	1437	1873	1873	1.0000000
C2	63661203	63662259	BolC2t12544H	0	-	80	669	1056	0.6335227
C2	63676429	63677501	BolC2t12545H	0	+	10	246	1072	0.2294776
C2	63685242	63685542	BolC2t12546H	0	+	9	91	300	0.3033333
C2	63725770	63727048	BolC2t12547H	0	-	245	980	1278	0.7668232
C2	63728549	63728822	BolC2t12548H	0	-	7	25	273	0.0915751
C2	63729741	63730164	BolC2t12549H	0	-	181	423	423	1.0000000
C2	63730391	63731072	BolC2t12550H	0	+	128	461	681	0.6769457
C2	63731489	63732848	BolC2t12551H	0	+	756	1359	1359	1.0000000
C2	63735453	63736539	BolC2t12552H	0	+	350	1086	1086	1.0000000
C2	63737407	63739192	BolC2t12553H	0	-	1051	1785	1785	1.0000000
C2	63741619	63742285	BolC2t12554H	0	-	161	514	666	0.7717718
C2	63743123	63744942	BolC2t12555H	0	-	697	1819	1819	1.0000000
C2	63746129	63750341	BolC2t12556H	0	+	1740	4017	4212	0.9537037
C2	63750670	63752528	BolC2t12557H	0	-	922	1858	1858	1.0000000
C2	63752979	63753862	BolC2t12558H	0	-	574	883	883	1.0000000
C2	63756492	63756804	BolC2t12559H	0	-	143	312	312	1.0000000
C2	63757254	63758236	BolC2t12560H	0	-	604	935	982	0.9521385
C2	63760335	63762134	BolC2t12561H	0	-	129	1187	1799	0.6598110
C2	63764405	63766912	BolC2t12562H	0	+	1168	2507	2507	1.0000000
C2	63767421	63775344	BolC2t12563H	0	+	858	4643	7923	0.5860154
C3	5397	6017	BolC3t12564H	0	-	3	113	620	0.1822581
C3	11084	11558	BolC3t12565H	0	+	299	474	474	1.0000000
C3	13570	18202	BolC3t12566H	0	+	584	929	4632	0.2005613
C3	20115	20852	BolC3t12567H	0	-	36	468	737	0.6350068
C3	27057	27574	BolC3t12568H	0	-	357	517	517	1.0000000
C3	28683	30372	BolC3t12569H	0	+	1284	1689	1689	1.0000000
C3	41073	41376	BolC3t12570H	0	+	262	303	303	1.0000000
C3	43944	44258	BolC3t12571H	0	-	1	108	314	0.3439490
C3	45225	45724	BolC3t12572H	0	+	0	0	499	0.0000000
C3	46359	46800	BolC3t12573H	0	+	0	0	441	0.0000000
C3	56318	56882	BolC3t12574H	0	+	104	541	564	0.9592199
C3	62932	64912	BolC3t12575H	0	+	100	1157	1980	0.5843434
C3	67758	70441	BolC3t12576H	0	+	957	2544	2683	0.9481923
C3	89941	90520	BolC3t12577H	0	+	26	330	579	0.5699482
C3	99800	100943	BolC3t12578H	0	+	127	846	1143	0.7401575
C3	100955	102074	BolC3t12579H	0	+	14	437	1119	0.3905272
C3	104798	106329	BolC3t12580H	0	+	623	1518	1531	0.9915088
C3	108974	110429	BolC3t12581H	0	+	1016	1455	1455	1.0000000
C3	118122	119491	BolC3t12582H	0	-	2240	1369	1369	1.0000000
C3	120716	121944	BolC3t12583H	0	+	126	892	1228	0.7263843
C3	124109	126266	BolC3t12584H	0	+	635	2040	2157	0.9457580
C3	128990	133452	BolC3t12585H	0	+	1073	3958	4462	0.8870462
C3	134309	138686	BolC3t12586H	0	+	2005	4030	4377	0.9207219
C3	143344	146796	BolC3t12587H	0	+	850	2972	3452	0.8609502
C3	147154	148649	BolC3t12588H	0	-	596	1387	1495	0.9277592
C3	149248	149977	BolC3t12589H	0	+	82	668	729	0.9163237
C3	150732	151419	BolC3t12590H	0	-	7	80	687	0.1164483
C3	156644	157220	BolC3t12591H	0	+	9	98	576	0.1701389
C3	158490	159914	BolC3t12592H	0	-	919	1409	1424	0.9894663
C3	162854	163845	BolC3t12593H	0	+	608	973	991	0.9818366
C3	164650	166385	BolC3t12594H	0	+	882	1673	1735	0.9642651
C3	166690	172426	BolC3t12595H	0	-	2124	4868	5736	0.8486750
C3	173000	173645	BolC3t12596H	0	-	206	572	645	0.8868217
C3	174607	175412	BolC3t12597H	0	-	202	743	805	0.9229814
C3	175830	177497	BolC3t12598H	0	+	261	1325	1667	0.7948411
C3	179975	182844	BolC3t12599H	0	+	212	1936	2869	0.6747996
C3	183738	185250	BolC3t12600H	0	-	315	1507	1512	0.9966931
C3	189750	192336	BolC3t12601H	0	-	470	2153	2586	0.8325599
C3	195986	197155	BolC3t12602H	0	+	92	1004	1169	0.8588537
C3	200559	204062	BolC3t12603H	0	+	956	3325	3503	0.9491864
C3	205388	214040	BolC3t12604H	0	-	4609	8614	8652	0.9956080
C3	215399	217342	BolC3t12605H	0	-	527	1839	1943	0.9464746
C3	217751	218811	BolC3t12606H	0	+	660	1060	1060	1.0000000
C3	220071	222129	BolC3t12607H	0	+	52	1266	2058	0.6151603
C3	229378	231389	BolC3t12608H	0	+	526	1801	2011	0.8955743
C3	231954	233476	BolC3t12609H	0	-	812	1522	1522	1.0000000
C3	235158	238338	BolC3t12610H	0	-	2278	2738	3180	0.8610063
C3	238714	241123	BolC3t12611H	0	-	658	2275	2409	0.9443753
C3	241635	243991	BolC3t12612H	0	+	1031	2315	2356	0.9825976
C3	244984	246169	BolC3t12613H	0	+	1144	1185	1185	1.0000000
C3	249137	250067	BolC3t12614H	0	+	174	793	930	0.8526882
C3	254921	256637	BolC3t12615H	0	+	996	1624	1716	0.9463869
C3	259180	260973	BolC3t12616H	0	+	369	1632	1793	0.9102064
C3	261593	264692	BolC3t12617H	0	+	2087	3031	3099	0.9780574
C3	267589	270978	BolC3t12618H	0	-	1600	3285	3389	0.9693125
C3	271682	275591	BolC3t12619H	0	+	691	3409	3909	0.8720900
C3	276519	278529	BolC3t12620H	0	-	1604	1864	2010	0.9273632
C3	281365	283900	BolC3t12621H	0	+	2197	2535	2535	1.0000000
C3	287765	288041	BolC3t12622H	0	-	300	276	276	1.0000000
C3	288244	288691	BolC3t12623H	0	+	446	447	447	1.0000000
C3	292775	293873	BolC3t12624H	0	+	761	1098	1098	1.0000000
C3	294508	295236	BolC3t12625H	0	+	504	728	728	1.0000000
C3	298303	300870	BolC3t12626H	0	-	34	341	2567	0.1328399
C3	308590	308857	BolC3t12627H	0	+	1	72	267	0.2696629
C3	309800	309998	BolC3t12628H	0	-	3	69	198	0.3484848
C3	313471	313849	BolC3t12629H	0	-	30	231	378	0.6111111
C3	314692	316894	BolC3t12630H	0	+	773	2044	2202	0.9282470
C3	317323	318391	BolC3t12631H	0	-	134	1040	1068	0.9737828
C3	325118	325818	BolC3t12632H	0	+	27	204	700	0.2914286
C3	332195	335104	BolC3t12633H	0	+	198	1709	2909	0.5874871
C3	338671	342483	BolC3t12634H	0	+	1359	3434	3812	0.9008394
C3	342926	345018	BolC3t12635H	0	-	1360	1908	2092	0.9120459
C3	346258	346645	BolC3t12636H	0	+	304	387	387	1.0000000
C3	351839	352978	BolC3t12637H	0	-	960	1139	1139	1.0000000
C3	370711	374039	BolC3t12638H	0	+	2248	3328	3328	1.0000000
C3	383367	384641	BolC3t12639H	0	+	808	1274	1274	1.0000000
C3	384907	385892	BolC3t12640H	0	-	322	985	985	1.0000000
C3	395857	396608	BolC3t12641H	0	+	610	751	751	1.0000000
C3	399719	399941	BolC3t12642H	0	+	381	222	222	1.0000000
C3	401691	404331	BolC3t12643H	0	+	1773	2640	2640	1.0000000
C3	406271	406565	BolC3t12644H	0	-	225	294	294	1.0000000
C3	407643	408481	BolC3t12645H	0	+	121	648	838	0.7732697
C3	410551	420946	BolC3t12646H	0	+	5031	8584	10395	0.8257816
C3	421372	422793	BolC3t12647H	0	+	641	1419	1421	0.9985926
C3	424889	425115	BolC3t12648H	0	+	73	226	226	1.0000000
C3	430718	432704	BolC3t12649H	0	+	977	1921	1986	0.9672709
C3	436295	436451	BolC3t12650H	0	-	155	156	156	1.0000000
C3	438309	438552	BolC3t12651H	0	+	118	243	243	1.0000000
C3	438881	440637	BolC3t12652H	0	-	173	1450	1756	0.8257403
C3	444031	451742	BolC3t12653H	0	+	1979	7046	7711	0.9137596
C3	452101	454975	BolC3t12654H	0	+	1298	2861	2874	0.9954767
C3	455329	455624	BolC3t12655H	0	-	88	295	295	1.0000000
C3	457160	462684	BolC3t12656H	0	-	2997	5504	5524	0.9963794
C3	471521	471854	BolC3t12657H	0	+	14	174	333	0.5225225
C3	473213	476369	BolC3t12658H	0	+	543	2313	3156	0.7328897
C3	482192	483682	BolC3t12659H	0	-	138	819	1490	0.5496644
C3	487054	488743	BolC3t12660H	0	-	657	1665	1689	0.9857904
C3	489697	491896	BolC3t12661H	0	+	1333	2199	2199	1.0000000
C3	493366	493639	BolC3t12662H	0	-	62	273	273	1.0000000
C3	494586	496104	BolC3t12663H	0	+	272	1317	1518	0.8675889
C3	497034	497408	BolC3t12664H	0	-	391	374	374	1.0000000
C3	498062	499356	BolC3t12665H	0	-	256	1224	1294	0.9459042
C3	502894	505376	BolC3t12666H	0	+	243	1847	2482	0.7441579
C3	506087	506315	BolC3t12667H	0	-	23	119	228	0.5219298
C3	517913	518240	BolC3t12668H	0	-	296	327	327	1.0000000
C3	519008	519938	BolC3t12669H	0	+	868	930	930	1.0000000
C3	522643	523879	BolC3t12670H	0	+	922	1236	1236	1.0000000
C3	525655	526120	BolC3t12671H	0	-	621	465	465	1.0000000
C3	533267	534827	BolC3t12672H	0	+	1290	1539	1560	0.9865385
C3	535022	535468	BolC3t12673H	0	-	439	446	446	1.0000000
C3	542576	543773	BolC3t12674H	0	+	106	998	1197	0.8337510
C3	545039	546350	BolC3t12675H	0	+	939	1311	1311	1.0000000
C3	547632	548178	BolC3t12676H	0	+	16	305	546	0.5586081
C3	549357	551025	BolC3t12677H	0	-	113	1430	1668	0.8573142
C3	552939	553641	BolC3t12678H	0	+	236	679	702	0.9672365
C3	557094	558868	BolC3t12679H	0	+	683	1736	1774	0.9785795
C3	560292	561563	BolC3t12680H	0	+	720	1018	1271	0.8009441
C3	562397	563835	BolC3t12681H	0	+	358	1243	1438	0.8643950
C3	565508	571804	BolC3t12682H	0	+	1775	4875	6296	0.7743012
C3	572166	573521	BolC3t12683H	0	-	259	1280	1355	0.9446495
C3	574076	577269	BolC3t12684H	0	+	1217	2892	3193	0.9057313
C3	578388	580020	BolC3t12685H	0	+	1367	1567	1632	0.9601716
C3	580464	581045	BolC3t12686H	0	-	324	521	581	0.8967298
C3	581717	582300	BolC3t12687H	0	-	345	576	583	0.9879931
C3	584566	586434	BolC3t12688H	0	-	1271	1868	1868	1.0000000
C3	588590	589746	BolC3t12689H	0	+	1376	1156	1156	1.0000000
C3	593820	594173	BolC3t12690H	0	+	571	353	353	1.0000000
C3	596929	599086	BolC3t12691H	0	-	234	1250	2157	0.5795086
C3	600397	601135	BolC3t12692H	0	+	1	73	738	0.0989160
C3	605495	608086	BolC3t12693H	0	+	212	2108	2591	0.8135855
C3	609466	610198	BolC3t12694H	0	-	83	525	732	0.7172131
C3	611091	612918	BolC3t12695H	0	-	204	1468	1827	0.8035030
C3	614325	614517	BolC3t12696H	0	-	14	109	192	0.5677083
C3	620065	620605	BolC3t12697H	0	+	123	540	540	1.0000000
C3	623059	625767	BolC3t12698H	0	+	535	2100	2708	0.7754800
C3	627156	632066	BolC3t12699H	0	+	3327	4352	4910	0.8863544
C3	638523	640352	BolC3t12700H	0	+	2259	1829	1829	1.0000000
C3	640818	643754	BolC3t12701H	0	-	1381	2936	2936	1.0000000
C3	644431	645532	BolC3t12702H	0	-	908	1101	1101	1.0000000
C3	663097	665027	BolC3t12703H	0	-	1005	1902	1930	0.9854922
C3	665415	667513	BolC3t12704H	0	+	1535	2088	2098	0.9952335
C3	667997	671413	BolC3t12705H	0	-	2725	3416	3416	1.0000000
C3	672409	673492	BolC3t12706H	0	+	867	1031	1083	0.9519852
C3	677601	678969	BolC3t12707H	0	+	0	0	1368	0.0000000
C3	683128	683959	BolC3t12708H	0	+	221	772	831	0.9290012
C3	686571	688194	BolC3t12709H	0	+	249	1031	1623	0.6352434
C3	691252	691549	BolC3t12710H	0	-	691	297	297	1.0000000
C3	693458	695632	BolC3t12711H	0	-	421	1730	2174	0.7957681
C3	696159	697648	BolC3t12712H	0	-	258	1175	1489	0.7891202
C3	705782	708131	BolC3t12713H	0	+	1947	2349	2349	1.0000000
C3	708616	709873	BolC3t12714H	0	-	959	1257	1257	1.0000000
C3	710688	711105	BolC3t12715H	0	-	388	417	417	1.0000000
C3	712252	712717	BolC3t12716H	0	-	436	465	465	1.0000000
C3	714546	727223	BolC3t12717H	0	+	1889	5153	12677	0.4064842
C3	727617	730049	BolC3t12718H	0	-	1020	2254	2432	0.9268092
C3	747471	750042	BolC3t12719H	0	+	319	1707	2571	0.6639440
C3	754744	755602	BolC3t12720H	0	-	3	191	858	0.2226107
C3	764452	767292	BolC3t12721H	0	+	940	2586	2840	0.9105634
C3	771442	776162	BolC3t12722H	0	-	2805	4663	4720	0.9879237
C3	783712	784337	BolC3t12723H	0	+	17	63	625	0.1008000
C3	787302	789003	BolC3t12724H	0	-	0	0	1701	0.0000000
C3	791968	796444	BolC3t12725H	0	-	613	3678	4476	0.8217158
C3	801970	802183	BolC3t12726H	0	+	273	213	213	1.0000000
C3	809578	811054	BolC3t12727H	0	+	191	1059	1476	0.7174796
C3	811737	814730	BolC3t12728H	0	-	247	1841	2993	0.6151019
C3	815668	817450	BolC3t12729H	0	-	273	1590	1782	0.8922559
C3	829655	830710	BolC3t12730H	0	-	78	573	1055	0.5431280
C3	834518	834713	BolC3t12731H	0	-	50	195	195	1.0000000
C3	835433	835868	BolC3t12732H	0	+	119	331	435	0.7609195
C3	836477	836690	BolC3t12733H	0	+	162	213	213	1.0000000
C3	837543	838644	BolC3t12734H	0	-	226	658	1101	0.5976385
C3	840116	842517	BolC3t12735H	0	-	2239	2399	2401	0.9991670
C3	847791	848307	BolC3t12736H	0	+	91	387	516	0.7500000
C3	849305	852245	BolC3t12737H	0	+	759	2810	2940	0.9557823
C3	856004	856657	BolC3t12738H	0	-	140	646	653	0.9892802
C3	858168	860076	BolC3t12739H	0	+	603	1814	1908	0.9507338
C3	864310	864785	BolC3t12740H	0	+	206	475	475	1.0000000
C3	866925	872166	BolC3t12741H	0	-	2743	4833	5241	0.9221523
C3	877628	880197	BolC3t12742H	0	-	1001	2285	2569	0.8894511
C3	882963	884091	BolC3t12743H	0	+	46	654	1128	0.5797873
C3	886782	887715	BolC3t12744H	0	-	564	933	933	1.0000000
C3	894307	895835	BolC3t12745H	0	+	818	1528	1528	1.0000000
C3	900802	903173	BolC3t12746H	0	+	2071	2371	2371	1.0000000
C3	912063	914693	BolC3t12747H	0	+	1975	2534	2630	0.9634981
C3	912932	913562	BolC3t12748H	0	-	718	630	630	1.0000000
C3	915639	915986	BolC3t12749H	0	+	70	347	347	1.0000000
C3	920645	921757	BolC3t12750H	0	-	568	1112	1112	1.0000000
C3	924080	924601	BolC3t12751H	0	+	542	521	521	1.0000000
C3	925448	925859	BolC3t12752H	0	+	18	128	411	0.3114355
C3	930836	932233	BolC3t12753H	0	-	399	1244	1397	0.8904796
C3	935256	939651	BolC3t12754H	0	+	2088	3749	4395	0.8530148
C3	941228	942317	BolC3t12755H	0	+	135	775	1089	0.7116621
C3	945318	947572	BolC3t12756H	0	+	1002	2254	2254	1.0000000
C3	947971	950522	BolC3t12757H	0	-	1205	2406	2551	0.9431595
C3	951599	953789	BolC3t12758H	0	-	1141	2172	2190	0.9917808
C3	953993	956453	BolC3t12759H	0	+	763	1697	2460	0.6898374
C3	959608	960010	BolC3t12760H	0	-	5	290	402	0.7213930
C3	964886	965021	BolC3t12761H	0	+	7	64	135	0.4740741
C3	965246	965633	BolC3t12762H	0	+	5	186	387	0.4806201
C3	971865	974605	BolC3t12763H	0	+	970	2496	2740	0.9109489
C3	981774	982941	BolC3t12764H	0	-	319	1032	1167	0.8843188
C3	983978	985721	BolC3t12765H	0	-	1210	1743	1743	1.0000000
C3	992237	993752	BolC3t12766H	0	+	174	928	1515	0.6125413
C3	994184	996720	BolC3t12767H	0	-	894	2486	2536	0.9802839
C3	1010211	1020100	BolC3t12768H	0	-	5821	9643	9889	0.9751239
C3	1023750	1026211	BolC3t12769H	0	-	1607	2400	2461	0.9752133
C3	1027446	1028278	BolC3t12770H	0	+	442	821	832	0.9867789
C3	1028690	1029490	BolC3t12771H	0	-	88	602	800	0.7525000
C3	1033576	1036605	BolC3t12772H	0	+	654	2592	3029	0.8557280
C3	1041110	1043929	BolC3t12773H	0	+	1092	2637	2819	0.9354381
C3	1044079	1045539	BolC3t12774H	0	-	1462	1419	1460	0.9719178
C3	1046947	1047144	BolC3t12775H	0	+	144	188	197	0.9543147
C3	1047450	1048672	BolC3t12776H	0	-	954	1222	1222	1.0000000
C3	1049510	1051809	BolC3t12777H	0	-	508	1897	2299	0.8251414
C3	1054352	1057409	BolC3t12778H	0	+	1132	2735	3057	0.8946680
C3	1058434	1058671	BolC3t12779H	0	+	178	237	237	1.0000000
C3	1059490	1061520	BolC3t12780H	0	+	2465	2030	2030	1.0000000
C3	1062492	1068457	BolC3t12781H	0	+	1630	5264	5965	0.8824812
C3	1083520	1084702	BolC3t12782H	0	-	18	124	1182	0.1049069
C3	1086893	1087433	BolC3t12783H	0	-	369	540	540	1.0000000
C3	1091576	1095886	BolC3t12784H	0	+	1624	4152	4310	0.9633411
C3	1096592	1098527	BolC3t12785H	0	-	222	1701	1935	0.8790697
C3	1100857	1101820	BolC3t12786H	0	-	356	944	963	0.9802700
C3	1109130	1111201	BolC3t12787H	0	+	185	999	2071	0.4823757
C3	1111953	1112277	BolC3t12788H	0	+	0	0	324	0.0000000
C3	1113092	1116327	BolC3t12789H	0	-	979	2715	3235	0.8392581
C3	1118035	1120336	BolC3t12790H	0	-	616	2000	2301	0.8691873
C3	1121369	1122769	BolC3t12791H	0	-	389	1346	1400	0.9614286
C3	1123279	1124434	BolC3t12792H	0	+	537	1155	1155	1.0000000
C3	1130635	1130920	BolC3t12793H	0	+	214	285	285	1.0000000
C3	1131505	1134854	BolC3t12794H	0	-	1193	2670	3349	0.7972529
C3	1137531	1138266	BolC3t12795H	0	+	415	735	735	1.0000000
C3	1142162	1143555	BolC3t12796H	0	-	556	1393	1393	1.0000000
C3	1144103	1145188	BolC3t12797H	0	-	535	1085	1085	1.0000000
C3	1146202	1146676	BolC3t12798H	0	+	172	373	474	0.7869198
C3	1147625	1150765	BolC3t12799H	0	+	3596	3140	3140	1.0000000
C3	1151638	1151818	BolC3t12800H	0	-	199	180	180	1.0000000
C3	1152003	1152269	BolC3t12801H	0	+	0	0	266	0.0000000
C3	1152355	1153026	BolC3t12802H	0	+	31	456	671	0.6795827
C3	1157445	1159301	BolC3t12803H	0	+	1018	1581	1856	0.8518319
C3	1169338	1172552	BolC3t12804H	0	+	3226	2939	3214	0.9144368
C3	1172848	1174417	BolC3t12805H	0	-	795	1518	1569	0.9674952
C3	1175134	1179802	BolC3t12806H	0	-	1062	4216	4668	0.9031705
C3	1179999	1181287	BolC3t12807H	0	-	511	1242	1288	0.9642857
C3	1181674	1182947	BolC3t12808H	0	+	363	1179	1273	0.9261587
C3	1185485	1187604	BolC3t12809H	0	+	327	1400	2119	0.6606890
C3	1189322	1190535	BolC3t12810H	0	-	989	1213	1213	1.0000000
C3	1191091	1192248	BolC3t12811H	0	+	580	1157	1157	1.0000000
C3	1193215	1194879	BolC3t12812H	0	-	344	1572	1664	0.9447116
C3	1201810	1202083	BolC3t12813H	0	+	0	0	273	0.0000000
C3	1204839	1205802	BolC3t12814H	0	+	261	782	963	0.8120457
C3	1209159	1209282	BolC3t12815H	0	-	193	123	123	1.0000000
C3	1215960	1216572	BolC3t12816H	0	+	245	612	612	1.0000000
C3	1225494	1229009	BolC3t12817H	0	+	536	3122	3515	0.8881934
C3	1229250	1231131	BolC3t12818H	0	-	107	1027	1881	0.5459862
C3	1233603	1233852	BolC3t12819H	0	-	0	0	249	0.0000000
C3	1242679	1253812	BolC3t12820H	0	+	6078	10335	11133	0.9283212
C3	1254533	1255214	BolC3t12821H	0	+	4	189	681	0.2775331
C3	1256610	1256775	BolC3t12822H	0	+	0	0	165	0.0000000
C3	1258980	1259496	BolC3t12823H	0	+	362	516	516	1.0000000
C3	1260725	1260953	BolC3t12824H	0	-	399	228	228	1.0000000
C3	1274903	1277553	BolC3t12825H	0	+	603	2177	2650	0.8215094
C3	1280307	1281155	BolC3t12826H	0	-	819	848	848	1.0000000
C3	1281638	1283160	BolC3t12827H	0	-	1054	1466	1522	0.9632063
C3	1284137	1286832	BolC3t12828H	0	-	329	2075	2695	0.7699444
C3	1287809	1290537	BolC3t12829H	0	-	709	2669	2728	0.9783725
C3	1291238	1293846	BolC3t12830H	0	-	1891	2608	2608	1.0000000
C3	1294549	1296619	BolC3t12831H	0	-	1175	2070	2070	1.0000000
C3	1297312	1299404	BolC3t12832H	0	+	886	2092	2092	1.0000000
C3	1299640	1301083	BolC3t12833H	0	+	402	1373	1443	0.9514899
C3	1302225	1303971	BolC3t12834H	0	-	1013	1746	1746	1.0000000
C3	1313251	1315280	BolC3t12835H	0	+	1123	1976	2029	0.9738787
C3	1327088	1327768	BolC3t12836H	0	+	701	680	680	1.0000000
C3	1338631	1340653	BolC3t12837H	0	+	1734	1998	2022	0.9881306
C3	1341004	1344809	BolC3t12838H	0	-	3942	3805	3805	1.0000000
C3	1345061	1346753	BolC3t12839H	0	+	1400	1692	1692	1.0000000
C3	1347131	1348098	BolC3t12840H	0	-	1254	967	967	1.0000000
C3	1352207	1352861	BolC3t12841H	0	-	87	542	654	0.8287462
C3	1354337	1355768	BolC3t12842H	0	-	95	746	1431	0.5213138
C3	1357581	1358518	BolC3t12843H	0	-	209	881	937	0.9402348
C3	1360326	1361775	BolC3t12844H	0	+	225	885	1449	0.6107661
C3	1364133	1364700	BolC3t12845H	0	+	202	567	567	1.0000000
C3	1370687	1374281	BolC3t12846H	0	+	2065	3590	3594	0.9988871
C3	1375161	1376940	BolC3t12847H	0	-	409	1746	1779	0.9814503
C3	1377346	1378951	BolC3t12848H	0	+	504	1355	1605	0.8442367
C3	1379493	1382478	BolC3t12849H	0	-	2966	2985	2985	1.0000000
C3	1385231	1386844	BolC3t12850H	0	+	390	1473	1613	0.9132052
C3	1389300	1394785	BolC3t12851H	0	+	2728	4882	5485	0.8900638
C3	1397457	1399682	BolC3t12852H	0	-	926	2109	2225	0.9478652
C3	1405254	1405668	BolC3t12853H	0	+	62	414	414	1.0000000
C3	1407309	1407675	BolC3t12854H	0	+	26	352	366	0.9617487
C3	1411334	1411850	BolC3t12855H	0	-	250	514	516	0.9961240
C3	1419745	1420453	BolC3t12856H	0	-	272	708	708	1.0000000
C3	1421798	1422440	BolC3t12857H	0	-	75	551	642	0.8582554
C3	1423054	1424064	BolC3t12858H	0	-	1031	1010	1010	1.0000000
C3	1425645	1427620	BolC3t12859H	0	+	391	1751	1975	0.8865823
C3	1428535	1432347	BolC3t12860H	0	-	2146	3812	3812	1.0000000
C3	1434079	1434679	BolC3t12861H	0	-	384	600	600	1.0000000
C3	1435506	1436250	BolC3t12862H	0	-	302	744	744	1.0000000
C3	1439225	1442213	BolC3t12863H	0	-	151	1551	2988	0.5190763
C3	1443644	1452265	BolC3t12864H	0	-	1037	6200	8621	0.7191741
C3	1454408	1457706	BolC3t12865H	0	+	669	2773	3298	0.8408126
C3	1458564	1459191	BolC3t12866H	0	-	112	460	627	0.7336523
C3	1473312	1475335	BolC3t12867H	0	+	650	1955	2023	0.9663866
C3	1476536	1478529	BolC3t12868H	0	-	643	1951	1993	0.9789262
C3	1482109	1483688	BolC3t12869H	0	-	27	417	1579	0.2640912
C3	1490820	1492599	BolC3t12870H	0	-	25	579	1779	0.3254637
C3	1495315	1496199	BolC3t12871H	0	-	122	707	884	0.7997738
C3	1499961	1501260	BolC3t12872H	0	-	0	0	1299	0.0000000
C3	1521420	1522996	BolC3t12873H	0	-	2	142	1576	0.0901015
C3	1526442	1527367	BolC3t12874H	0	-	44	415	925	0.4486487
C3	1530211	1530790	BolC3t12875H	0	-	43	312	579	0.5388601
C3	1545477	1547847	BolC3t12876H	0	+	1278	2255	2370	0.9514768
C3	1549138	1552495	BolC3t12877H	0	+	1715	3139	3357	0.9350610
C3	1555571	1561805	BolC3t12878H	0	+	1617	4597	6234	0.7374077
C3	1570677	1573059	BolC3t12879H	0	-	150	1276	2382	0.5356843
C3	1575120	1576598	BolC3t12880H	0	+	533	1241	1478	0.8396482
C3	1582469	1583744	BolC3t12881H	0	+	943	1121	1275	0.8792157
C3	1585206	1585596	BolC3t12882H	0	-	354	390	390	1.0000000
C3	1586448	1588550	BolC3t12883H	0	+	1643	2076	2102	0.9876308
C3	1588625	1588958	BolC3t12884H	0	+	645	333	333	1.0000000
C3	1592827	1593088	BolC3t12885H	0	-	179	261	261	1.0000000
C3	1593320	1593762	BolC3t12886H	0	+	304	442	442	1.0000000
C3	1593950	1595030	BolC3t12887H	0	-	31	783	1080	0.7250000
C3	1596485	1598461	BolC3t12888H	0	-	322	1299	1976	0.6573887
C3	1599209	1600795	BolC3t12889H	0	+	743	1583	1586	0.9981084
C3	1601616	1602273	BolC3t12890H	0	+	208	543	657	0.8264840
C3	1602546	1604377	BolC3t12891H	0	-	570	1691	1831	0.9235390
C3	1605471	1605948	BolC3t12892H	0	+	531	477	477	1.0000000
C3	1606274	1608915	BolC3t12893H	0	+	2860	2641	2641	1.0000000
C3	1609676	1610435	BolC3t12894H	0	+	62	469	759	0.6179183
C3	1613487	1615073	BolC3t12895H	0	-	127	1021	1586	0.6437579
C3	1628250	1629162	BolC3t12896H	0	+	4	149	912	0.1633772
C3	1632028	1636398	BolC3t12897H	0	+	1097	4061	4370	0.9292906
C3	1638314	1639875	BolC3t12898H	0	+	209	1229	1561	0.7873158
C3	1640137	1640929	BolC3t12899H	0	-	229	744	792	0.9393939
C3	1646308	1649895	BolC3t12900H	0	+	1945	3587	3587	1.0000000
C3	1658549	1659571	BolC3t12901H	0	+	240	669	1022	0.6545988
C3	1667052	1668156	BolC3t12902H	0	-	314	1104	1104	1.0000000
C3	1669703	1674383	BolC3t12903H	0	-	1722	4571	4680	0.9767094
C3	1679197	1708864	BolC3t12904H	0	-	9994	22581	29667	0.7611488
C3	1693530	1695000	BolC3t12905H	0	-	73	440	1470	0.2993197
C3	1709883	1711499	BolC3t12906H	0	+	484	1540	1616	0.9529703
C3	1713659	1715519	BolC3t12907H	0	+	721	1828	1860	0.9827957
C3	1715778	1716735	BolC3t12908H	0	-	558	870	957	0.9090909
C3	1718238	1724283	BolC3t12909H	0	-	1777	5103	6045	0.8441687
C3	1724598	1725671	BolC3t12910H	0	-	98	926	1073	0.8630009
C3	1728606	1729365	BolC3t12911H	0	-	239	759	759	1.0000000
C3	1731782	1732626	BolC3t12912H	0	-	85	767	844	0.9087678
C3	1733852	1734489	BolC3t12913H	0	+	237	637	637	1.0000000
C3	1735684	1736708	BolC3t12914H	0	-	47	663	1024	0.6474609
C3	1741738	1742803	BolC3t12915H	0	-	512	765	1065	0.7183099
C3	1745609	1746608	BolC3t12916H	0	+	821	999	999	1.0000000
C3	1747307	1748900	BolC3t12917H	0	-	1020	1535	1593	0.9635907
C3	1750267	1750968	BolC3t12918H	0	+	420	701	701	1.0000000
C3	1752115	1753384	BolC3t12919H	0	+	329	1261	1269	0.9936958
C3	1753392	1755099	BolC3t12920H	0	-	567	1700	1707	0.9958993
C3	1764363	1765787	BolC3t12921H	0	+	1555	1418	1424	0.9957865
C3	1773643	1774142	BolC3t12922H	0	+	113	435	499	0.8717435
C3	1774603	1775445	BolC3t12923H	0	-	987	842	842	1.0000000
C3	1776203	1782545	BolC3t12924H	0	-	2781	5626	6342	0.8871019
C3	1786572	1787474	BolC3t12925H	0	+	570	902	902	1.0000000
C3	1790187	1791925	BolC3t12926H	0	+	739	1690	1738	0.9723821
C3	1792265	1798842	BolC3t12927H	0	-	1225	5447	6577	0.8281891
C3	1801894	1803312	BolC3t12928H	0	-	1081	1418	1418	1.0000000
C3	1808082	1809483	BolC3t12929H	0	+	1156	1401	1401	1.0000000
C3	1809705	1817020	BolC3t12930H	0	-	2569	5525	7315	0.7552974
C3	1814718	1816165	BolC3t12931H	0	+	954	1447	1447	1.0000000
C3	1817514	1819271	BolC3t12932H	0	-	913	1623	1757	0.9237337
C3	1822391	1823116	BolC3t12933H	0	-	1111	725	725	1.0000000
C3	1824314	1826062	BolC3t12934H	0	-	1145	1748	1748	1.0000000
C3	1826910	1829655	BolC3t12935H	0	-	1201	2720	2745	0.9908925
C3	1831816	1834523	BolC3t12936H	0	+	1602	2707	2707	1.0000000
C3	1835206	1835708	BolC3t12937H	0	-	54	316	502	0.6294821
C3	1836009	1836556	BolC3t12938H	0	+	11	375	547	0.6855576
C3	1837086	1837467	BolC3t12939H	0	+	53	381	381	1.0000000
C3	1840942	1841677	BolC3t12940H	0	+	344	735	735	1.0000000
C3	1856077	1856286	BolC3t12941H	0	-	233	209	209	1.0000000
C3	1875756	1876623	BolC3t12942H	0	+	371	867	867	1.0000000
C3	1878095	1879402	BolC3t12943H	0	+	172	891	1307	0.6817138
C3	1880950	1881364	BolC3t12944H	0	-	6	157	414	0.3792270
C3	1889049	1890984	BolC3t12945H	0	-	392	1758	1935	0.9085271
C3	1891497	1893765	BolC3t12946H	0	-	1460	2113	2268	0.9316579
C3	1894333	1895903	BolC3t12947H	0	-	681	1570	1570	1.0000000
C3	1898261	1899880	BolC3t12948H	0	+	240	482	1619	0.2977147
C3	1901840	1904039	BolC3t12949H	0	+	837	1955	2199	0.8890405
C3	1905459	1906393	BolC3t12950H	0	-	134	852	934	0.9122056
C3	1910965	1914901	BolC3t12951H	0	+	1428	3324	3936	0.8445122
C3	1915381	1917572	BolC3t12952H	0	-	1640	2191	2191	1.0000000
C3	1919301	1920003	BolC3t12953H	0	+	190	690	702	0.9829060
C3	1920862	1922663	BolC3t12954H	0	+	1078	1801	1801	1.0000000
C3	1931621	1933235	BolC3t12955H	0	-	545	1614	1614	1.0000000
C3	1935195	1935903	BolC3t12956H	0	+	360	708	708	1.0000000
C3	1937588	1938182	BolC3t12957H	0	+	213	594	594	1.0000000
C3	1938715	1940459	BolC3t12958H	0	+	1197	1670	1744	0.9575688
C3	1941401	1942010	BolC3t12959H	0	-	289	609	609	1.0000000
C3	1943607	1945884	BolC3t12960H	0	-	1978	2277	2277	1.0000000
C3	1946922	1949327	BolC3t12961H	0	-	490	2125	2405	0.8835759
C3	1951034	1951247	BolC3t12962H	0	+	4	72	213	0.3380282
C3	1952935	1957630	BolC3t12963H	0	+	2850	4632	4695	0.9865814
C3	1957950	1959622	BolC3t12964H	0	-	1765	1672	1672	1.0000000
C3	1961138	1961672	BolC3t12965H	0	-	338	492	534	0.9213483
C3	1962755	1964818	BolC3t12966H	0	-	1447	2063	2063	1.0000000
C3	1966140	1967160	BolC3t12967H	0	-	645	1000	1020	0.9803922
C3	1967213	1971569	BolC3t12968H	0	-	2077	4249	4356	0.9754362
C3	1973591	1975189	BolC3t12969H	0	+	121	1138	1598	0.7121402
C3	1975337	1980533	BolC3t12970H	0	-	3556	5050	5196	0.9719015
C3	1982858	1984310	BolC3t12971H	0	-	727	1419	1452	0.9772727
C3	1986380	1987885	BolC3t12972H	0	+	1467	1505	1505	1.0000000
C3	1992439	1992844	BolC3t12973H	0	+	26	320	405	0.7901235
C3	1996349	2000356	BolC3t12974H	0	-	2145	3868	4007	0.9653107
C3	2000803	2003200	BolC3t12975H	0	-	897	2293	2397	0.9566124
C3	2021078	2021321	BolC3t12976H	0	+	24	243	243	1.0000000
C3	2021981	2024300	BolC3t12977H	0	+	1258	2319	2319	1.0000000
C3	2024836	2026993	BolC3t12978H	0	-	2303	2157	2157	1.0000000
C3	2027984	2030074	BolC3t12979H	0	+	1884	2090	2090	1.0000000
C3	2033920	2039295	BolC3t12980H	0	-	2342	3194	5375	0.5942326
C3	2035727	2036905	BolC3t12981H	0	-	44	421	1178	0.3573854
C3	2039748	2042244	BolC3t12982H	0	-	561	2362	2496	0.9463141
C3	2043048	2045523	BolC3t12983H	0	+	366	2165	2475	0.8747475
C3	2046485	2048036	BolC3t12984H	0	-	376	1530	1551	0.9864603
C3	2054740	2056797	BolC3t12985H	0	+	1275	1923	2057	0.9348566
C3	2059610	2061695	BolC3t12986H	0	-	1226	2085	2085	1.0000000
C3	2062414	2063081	BolC3t12987H	0	-	689	667	667	1.0000000
C3	2063644	2065222	BolC3t12988H	0	-	999	1578	1578	1.0000000
C3	2065416	2065530	BolC3t12989H	0	-	50	114	114	1.0000000
C3	2066208	2069734	BolC3t12990H	0	+	704	3363	3526	0.9537720
C3	2070147	2071243	BolC3t12991H	0	+	50	678	1096	0.6186131
C3	2076586	2078012	BolC3t12992H	0	-	710	1317	1426	0.9235624
C3	2078642	2082117	BolC3t12993H	0	-	1690	3326	3475	0.9571223
C3	2083132	2085864	BolC3t12994H	0	+	884	2646	2732	0.9685212
C3	2094881	2097674	BolC3t12995H	0	+	651	2790	2793	0.9989259
C3	2098058	2099204	BolC3t12996H	0	-	191	1105	1146	0.9642234
C3	2101608	2103118	BolC3t12997H	0	-	485	1471	1510	0.9741722
C3	2104015	2104744	BolC3t12998H	0	+	160	654	729	0.8971193
C3	2104829	2105453	BolC3t12999H	0	-	279	283	624	0.4535256
C3	2107634	2107965	BolC3t13000H	0	+	0	0	331	0.0000000
C3	2112918	2113476	BolC3t13001H	0	+	8	432	558	0.7741935
C3	2114343	2115539	BolC3t13002H	0	-	24	511	1196	0.4272575
C3	2115669	2115975	BolC3t13003H	0	+	0	0	306	0.0000000
C3	2116842	2118042	BolC3t13004H	0	-	58	346	1200	0.2883333
C3	2123809	2124121	BolC3t13005H	0	+	8	223	312	0.7147436
C3	2130681	2132079	BolC3t13006H	0	+	386	1341	1398	0.9592274
C3	2133586	2134782	BolC3t13007H	0	-	334	1196	1196	1.0000000
C3	2142168	2143882	BolC3t13008H	0	-	1403	1650	1714	0.9626604
C3	2147649	2153051	BolC3t13009H	0	+	1551	4878	5402	0.9029989
C3	2154448	2154721	BolC3t13010H	0	+	26	208	273	0.7619048
C3	2158455	2160951	BolC3t13011H	0	-	1460	2460	2496	0.9855769
C3	2161368	2162722	BolC3t13012H	0	+	479	1163	1354	0.8589365
C3	2163542	2164127	BolC3t13013H	0	+	460	585	585	1.0000000
C3	2169025	2169787	BolC3t13014H	0	+	1020	618	762	0.8110236
C3	2182380	2182560	BolC3t13015H	0	+	166	134	180	0.7444444
C3	2187179	2190620	BolC3t13016H	0	+	370	2600	3441	0.7555943
C3	2198525	2200519	BolC3t13017H	0	+	638	1180	1994	0.5917753
C3	2200842	2203005	BolC3t13018H	0	-	366	1669	2163	0.7716135
C3	2203616	2205730	BolC3t13019H	0	-	307	1557	2114	0.7365184
C3	2221580	2222709	BolC3t13020H	0	-	390	998	1129	0.8839681
C3	2226978	2227493	BolC3t13021H	0	+	4	169	515	0.3281553
C3	2230807	2231651	BolC3t13022H	0	+	588	844	844	1.0000000
C3	2232686	2235808	BolC3t13023H	0	-	1000	2782	3122	0.8910955
C3	2236688	2238080	BolC3t13024H	0	+	558	1184	1392	0.8505747
C3	2239038	2241880	BolC3t13025H	0	-	302	1913	2842	0.6731175
C3	2245300	2246927	BolC3t13026H	0	+	442	1555	1627	0.9557468
C3	2248048	2248291	BolC3t13027H	0	+	85	134	243	0.5514404
C3	2253909	2255059	BolC3t13028H	0	+	272	996	1150	0.8660870
C3	2259854	2261311	BolC3t13029H	0	-	1011	1255	1457	0.8613589
C3	2261763	2267342	BolC3t13030H	0	+	1080	3721	5579	0.6669654
C3	2268065	2268476	BolC3t13031H	0	-	73	352	411	0.8564477
C3	2269203	2272083	BolC3t13032H	0	-	1525	2319	2880	0.8052083
C3	2273279	2274044	BolC3t13033H	0	+	0	0	765	0.0000000
C3	2280137	2280410	BolC3t13034H	0	-	140	262	273	0.9597070
C3	2473899	2558938	BolC3t13035H	0	+	277468	50915	85039	0.5987253
C3	2477166	2478261	BolC3t13036H	0	-	48	306	1095	0.2794521
C3	2484817	2485339	BolC3t13037H	0	-	36	507	522	0.9712644
C3	2520162	2521909	BolC3t13038H	0	-	490	1655	1747	0.9473383
C3	2524080	2525672	BolC3t13039H	0	-	148	1133	1592	0.7116834
C3	2559546	2560623	BolC3t13040H	0	-	23	370	1077	0.3435469
C3	2561848	2562676	BolC3t13041H	0	-	0	0	828	0.0000000
C3	2566046	2566341	BolC3t13042H	0	-	171	295	295	1.0000000
C3	2598067	2601874	BolC3t13043H	0	+	98	1313	3807	0.3448910
C3	2602926	2604879	BolC3t13044H	0	-	5	149	1953	0.0762929
C3	2606178	2609914	BolC3t13045H	0	+	1196	3372	3736	0.9025696
C3	2610341	2612132	BolC3t13046H	0	-	444	1743	1791	0.9731993
C3	2619249	2619444	BolC3t13047H	0	+	0	0	195	0.0000000
C3	2622739	2624155	BolC3t13048H	0	+	56	366	1416	0.2584746
C3	2627628	2628419	BolC3t13049H	0	-	56	103	791	0.1302149
C3	2635197	2635527	BolC3t13050H	0	+	0	0	330	0.0000000
C3	2636292	2639160	BolC3t13051H	0	+	1781	2867	2868	0.9996513
C3	2640917	2641484	BolC3t13052H	0	-	143	503	567	0.8871252
C3	2644654	2652603	BolC3t13053H	0	+	3122	6751	7949	0.8492892
C3	2653475	2670508	BolC3t13054H	0	+	4517	8635	17033	0.5069571
C3	2671275	2671518	BolC3t13055H	0	+	240	243	243	1.0000000
C3	2673277	2674189	BolC3t13056H	0	+	93	853	912	0.9353070
C3	2676667	2677770	BolC3t13057H	0	+	596	1103	1103	1.0000000
C3	2678854	2681616	BolC3t13058H	0	-	705	2315	2762	0.8381608
C3	2682365	2685000	BolC3t13059H	0	+	936	1911	2635	0.7252372
C3	2686304	2688245	BolC3t13060H	0	+	1446	1941	1941	1.0000000
C3	2688794	2689583	BolC3t13061H	0	-	611	789	789	1.0000000
C3	2696729	2698092	BolC3t13062H	0	-	1493	1363	1363	1.0000000
C3	2704617	2705451	BolC3t13063H	0	+	155	827	834	0.9916067
C3	2706053	2706691	BolC3t13064H	0	-	101	488	638	0.7648903
C3	2716144	2718581	BolC3t13065H	0	+	676	2048	2437	0.8403775
C3	2724265	2725253	BolC3t13066H	0	-	366	952	988	0.9635627
C3	2725263	2725683	BolC3t13067H	0	+	34	420	420	1.0000000
C3	2725941	2726250	BolC3t13068H	0	+	0	0	309	0.0000000
C3	2731936	2733046	BolC3t13069H	0	+	616	1072	1110	0.9657658
C3	2736849	2737518	BolC3t13070H	0	+	361	669	669	1.0000000
C3	2743979	2748720	BolC3t13071H	0	+	1553	4384	4741	0.9246994
C3	2749490	2752580	BolC3t13072H	0	-	1608	2829	3090	0.9155340
C3	2755752	2756799	BolC3t13073H	0	+	647	1047	1047	1.0000000
C3	2757430	2757734	BolC3t13074H	0	-	426	304	304	1.0000000
C3	2757933	2759034	BolC3t13075H	0	-	320	629	1101	0.5712988
C3	2759218	2760971	BolC3t13076H	0	-	106	1178	1753	0.6719909
C3	2761831	2761993	BolC3t13077H	0	+	0	0	162	0.0000000
C3	2762293	2762455	BolC3t13078H	0	+	10	64	162	0.3950617
C3	2764703	2766151	BolC3t13079H	0	-	569	1364	1448	0.9419889
C3	2769258	2771080	BolC3t13080H	0	+	649	1313	1822	0.7206367
C3	2775081	2775561	BolC3t13081H	0	-	1	150	480	0.3125000
C3	2777066	2778440	BolC3t13082H	0	+	438	1344	1374	0.9781659
C3	2781292	2782472	BolC3t13083H	0	-	47	73	1180	0.0618644
C3	2788894	2789819	BolC3t13084H	0	+	311	693	925	0.7491892
C3	2792838	2793442	BolC3t13085H	0	-	1	19	604	0.0314570
C3	2794299	2795778	BolC3t13086H	0	-	118	934	1479	0.6315078
C3	2796435	2797019	BolC3t13087H	0	-	338	584	584	1.0000000
C3	2797942	2800549	BolC3t13088H	0	-	1164	2438	2607	0.9351745
C3	2802017	2804385	BolC3t13089H	0	-	1900	2315	2368	0.9776182
C3	2804706	2808561	BolC3t13090H	0	+	1204	3388	3855	0.8788586
C3	2809094	2810981	BolC3t13091H	0	+	1388	1873	1887	0.9925808
C3	2818534	2822886	BolC3t13092H	0	+	2552	4092	4352	0.9402574
C3	2823454	2826026	BolC3t13093H	0	-	1453	2423	2572	0.9420685
C3	2836236	2839937	BolC3t13094H	0	+	437	2914	3701	0.7873548
C3	2843692	2844559	BolC3t13095H	0	-	945	867	867	1.0000000
C3	2845192	2845976	BolC3t13096H	0	-	677	784	784	1.0000000
C3	2846826	2847393	BolC3t13097H	0	-	453	567	567	1.0000000
C3	2848733	2851320	BolC3t13098H	0	+	53	595	2587	0.2299961
C3	2853000	2853252	BolC3t13099H	0	+	127	252	252	1.0000000
C3	2865729	2869277	BolC3t13100H	0	+	1807	3453	3548	0.9732243
C3	2870906	2873328	BolC3t13101H	0	+	1112	2302	2422	0.9504542
C3	2873898	2874426	BolC3t13102H	0	-	435	528	528	1.0000000
C3	2876210	2884423	BolC3t13103H	0	-	2081	5576	8213	0.6789237
C3	2886316	2889566	BolC3t13104H	0	+	1204	3075	3250	0.9461538
C3	2889771	2891349	BolC3t13105H	0	-	177	822	1578	0.5209125
C3	2895160	2896500	BolC3t13106H	0	+	1039	1340	1340	1.0000000
C3	2905754	2905949	BolC3t13107H	0	+	106	195	195	1.0000000
C3	2907150	2908686	BolC3t13108H	0	+	1608	1536	1536	1.0000000
C3	2909042	2910080	BolC3t13109H	0	-	426	1038	1038	1.0000000
C3	2910546	2912265	BolC3t13110H	0	-	1541	1679	1719	0.9767306
C3	2917275	2917665	BolC3t13111H	0	+	30	304	390	0.7794872
C3	2921485	2923062	BolC3t13112H	0	+	938	1577	1577	1.0000000
C3	2923457	2932618	BolC3t13113H	0	-	4467	8698	9161	0.9494597
C3	2934967	2937282	BolC3t13114H	0	-	1249	2149	2315	0.9282938
C3	2941518	2942370	BolC3t13115H	0	+	287	852	852	1.0000000
C3	2951810	2953489	BolC3t13116H	0	+	1692	1633	1679	0.9726027
C3	2953803	2955243	BolC3t13117H	0	-	1328	1440	1440	1.0000000
C3	2956123	2956665	BolC3t13118H	0	+	449	542	542	1.0000000
C3	2957130	2961855	BolC3t13119H	0	+	3102	4549	4725	0.9627513
C3	2963654	2964074	BolC3t13120H	0	-	46	235	420	0.5595238
C3	2966895	2967507	BolC3t13121H	0	-	825	612	612	1.0000000
C3	2976882	2977209	BolC3t13122H	0	+	243	327	327	1.0000000
C3	2988484	2991687	BolC3t13123H	0	-	2163	3154	3203	0.9847018
C3	2997038	2998535	BolC3t13124H	0	-	409	1497	1497	1.0000000
C3	3001730	3002195	BolC3t13125H	0	-	299	465	465	1.0000000
C3	3002773	3004949	BolC3t13126H	0	+	860	2148	2176	0.9871324
C3	3006318	3007503	BolC3t13127H	0	+	324	1185	1185	1.0000000
C3	3010952	3011423	BolC3t13128H	0	-	287	471	471	1.0000000
C3	3019459	3019889	BolC3t13129H	0	-	6	336	430	0.7813954
C3	3022417	3023766	BolC3t13130H	0	-	734	1349	1349	1.0000000
C3	3024636	3026080	BolC3t13131H	0	-	809	1444	1444	1.0000000
C3	3028104	3034501	BolC3t13132H	0	-	4317	6376	6397	0.9967172
C3	3038905	3039805	BolC3t13133H	0	-	368	900	900	1.0000000
C3	3040541	3041341	BolC3t13134H	0	+	632	800	800	1.0000000
C3	3042069	3042537	BolC3t13135H	0	-	788	468	468	1.0000000
C3	3047103	3047466	BolC3t13136H	0	-	1	20	363	0.0550964
C3	3048424	3051340	BolC3t13137H	0	-	1158	2815	2916	0.9653635
C3	3053317	3055045	BolC3t13138H	0	-	1832	1728	1728	1.0000000
C3	3059762	3061752	BolC3t13139H	0	+	1172	1927	1990	0.9683417
C3	3062433	3062808	BolC3t13140H	0	-	197	375	375	1.0000000
C3	3063027	3066113	BolC3t13141H	0	+	1234	2513	3086	0.8143228
C3	3067352	3071011	BolC3t13142H	0	+	5364	3590	3659	0.9811424
C3	3072182	3075021	BolC3t13143H	0	+	1773	2839	2839	1.0000000
C3	3075564	3076791	BolC3t13144H	0	-	740	1227	1227	1.0000000
C3	3078996	3079305	BolC3t13145H	0	+	42	200	309	0.6472492
C3	3080455	3088007	BolC3t13146H	0	-	2285	3019	7552	0.3997616
C3	3115453	3115969	BolC3t13147H	0	+	616	516	516	1.0000000
C3	3119405	3120446	BolC3t13148H	0	+	1736	1034	1041	0.9932757
C3	3120834	3124056	BolC3t13149H	0	-	2656	3222	3222	1.0000000
C3	3125510	3125896	BolC3t13150H	0	-	124	381	386	0.9870467
C3	3127888	3129448	BolC3t13151H	0	-	1555	1560	1560	1.0000000
C3	3131122	3132307	BolC3t13152H	0	-	258	1035	1185	0.8734177
C3	3135230	3136773	BolC3t13153H	0	-	1190	1543	1543	1.0000000
C3	3139839	3144796	BolC3t13154H	0	-	2766	4804	4957	0.9691346
C3	3148195	3190033	BolC3t13155H	0	+	1269	13252	41838	0.3167455
C3	3155475	3157111	BolC3t13156H	0	-	197	1514	1636	0.9254279
C3	3157667	3159854	BolC3t13157H	0	-	151	1357	2187	0.6204847
C3	3161366	3195233	BolC3t13158H	0	-	1055	9637	33867	0.2845543
C3	3164492	3165623	BolC3t13159H	0	-	36	619	1131	0.5473033
C3	3192021	3192515	BolC3t13160H	0	-	73	494	494	1.0000000
C3	3196744	3207830	BolC3t13161H	0	-	1510	4907	11086	0.4426304
C3	3197233	3211685	BolC3t13162H	0	-	1553	6821	14452	0.4719762
C3	3200118	3201282	BolC3t13163H	0	-	2	246	1164	0.2113402
C3	3220702	3222831	BolC3t13164H	0	-	1260	1871	2129	0.8788164
C3	3234018	3236361	BolC3t13165H	0	+	1491	2343	2343	1.0000000
C3	3236534	3238871	BolC3t13166H	0	-	765	2109	2337	0.9024390
C3	3239429	3240769	BolC3t13167H	0	-	1407	1340	1340	1.0000000
C3	3243108	3243871	BolC3t13168H	0	+	176	745	763	0.9764089
C3	3244710	3246653	BolC3t13169H	0	-	518	1499	1943	0.7714874
C3	3250423	3252537	BolC3t13170H	0	-	452	1809	2114	0.8557237
C3	3253146	3256676	BolC3t13171H	0	-	2936	3434	3530	0.9728045
C3	3257354	3259325	BolC3t13172H	0	-	1404	1961	1971	0.9949265
C3	3271329	3275202	BolC3t13173H	0	+	811	3692	3873	0.9532662
C3	3276633	3278943	BolC3t13174H	0	+	157	2126	2310	0.9203463
C3	3279214	3281794	BolC3t13175H	0	-	792	1878	2580	0.7279070
C3	3283006	3283549	BolC3t13176H	0	-	77	543	543	1.0000000
C3	3285127	3287261	BolC3t13177H	0	-	1187	2134	2134	1.0000000
C3	3288327	3291549	BolC3t13178H	0	+	2109	3200	3222	0.9931719
C3	3292639	3293156	BolC3t13179H	0	+	8	226	517	0.4371373
C3	3294225	3295460	BolC3t13180H	0	+	1029	1235	1235	1.0000000
C3	3295905	3296938	BolC3t13181H	0	-	181	890	1033	0.8615683
C3	3299578	3300259	BolC3t13182H	0	-	524	681	681	1.0000000
C3	3301964	3306609	BolC3t13183H	0	+	3106	4450	4645	0.9580194
C3	3306937	3308613	BolC3t13184H	0	-	1305	1676	1676	1.0000000
C3	3309840	3311724	BolC3t13185H	0	-	225	1094	1884	0.5806794
C3	3320286	3320511	BolC3t13186H	0	+	141	225	225	1.0000000
C3	3320554	3328285	BolC3t13187H	0	+	1027	3282	7731	0.4245246
C3	3330262	3332045	BolC3t13188H	0	-	1708	1783	1783	1.0000000
C3	3347122	3348236	BolC3t13189H	0	+	610	1013	1114	0.9093357
C3	3364711	3366191	BolC3t13190H	0	+	53	607	1480	0.4101351
C3	3366748	3366928	BolC3t13191H	0	-	135	180	180	1.0000000
C3	3375037	3375771	BolC3t13192H	0	-	323	734	734	1.0000000
C3	3379546	3387204	BolC3t13193H	0	+	2513	5549	7658	0.7246017
C3	3388576	3389988	BolC3t13194H	0	-	782	1386	1412	0.9815864
C3	3391087	3396202	BolC3t13195H	0	-	2747	4859	5115	0.9499511
C3	3398623	3403714	BolC3t13196H	0	+	1316	4655	5091	0.9143587
C3	3417578	3417683	BolC3t13197H	0	-	15	105	105	1.0000000
C3	3420109	3424969	BolC3t13198H	0	+	1762	4549	4860	0.9360082
C3	3425581	3427709	BolC3t13199H	0	-	1308	2097	2128	0.9854323
C3	3428373	3432073	BolC3t13200H	0	-	2915	3700	3700	1.0000000
C3	3432487	3433735	BolC3t13201H	0	-	830	1248	1248	1.0000000
C3	3435121	3437252	BolC3t13202H	0	+	1049	1996	2131	0.9366494
C3	3437669	3441993	BolC3t13203H	0	-	1611	4025	4324	0.9308510
C3	3444613	3449565	BolC3t13204H	0	+	3074	4613	4952	0.9315428
C3	3453603	3461306	BolC3t13205H	0	+	3533	7264	7703	0.9430092
C3	3461708	3465539	BolC3t13206H	0	-	1913	3531	3831	0.9216915
C3	3477683	3477956	BolC3t13207H	0	+	2	49	273	0.1794872
C3	3485404	3486589	BolC3t13208H	0	+	141	986	1185	0.8320675
C3	3487447	3489355	BolC3t13209H	0	+	1459	1908	1908	1.0000000
C3	3489753	3489981	BolC3t13210H	0	-	567	228	228	1.0000000
C3	3491127	3496466	BolC3t13211H	0	-	1313	4594	5339	0.8604608
C3	3504330	3505067	BolC3t13212H	0	+	11	41	737	0.0556309
C3	3509325	3510930	BolC3t13213H	0	+	1448	1605	1605	1.0000000
C3	3511744	3515143	BolC3t13214H	0	-	977	2931	3399	0.8623124
C3	3517510	3518951	BolC3t13215H	0	-	697	1441	1441	1.0000000
C3	3519084	3519674	BolC3t13216H	0	-	309	590	590	1.0000000
C3	3523243	3526434	BolC3t13217H	0	+	1890	3191	3191	1.0000000
C3	3531357	3534174	BolC3t13218H	0	+	1338	2186	2817	0.7760028
C3	3534748	3536416	BolC3t13219H	0	-	975	1535	1668	0.9202638
C3	3537258	3539240	BolC3t13220H	0	-	1038	1964	1982	0.9909183
C3	3540727	3541534	BolC3t13221H	0	+	441	782	807	0.9690211
C3	3548038	3549695	BolC3t13222H	0	+	1181	1657	1657	1.0000000
C3	3551354	3553738	BolC3t13223H	0	-	1198	2379	2384	0.9979027
C3	3554616	3555952	BolC3t13224H	0	-	98	629	1336	0.4708084
C3	3556849	3557356	BolC3t13225H	0	-	337	507	507	1.0000000
C3	3560308	3560947	BolC3t13226H	0	-	76	508	639	0.7949921
C3	3562868	3563552	BolC3t13227H	0	+	235	684	684	1.0000000
C3	3564706	3566071	BolC3t13228H	0	-	411	1365	1365	1.0000000
C3	3567639	3569128	BolC3t13229H	0	+	324	1326	1489	0.8905306
C3	3570019	3573436	BolC3t13230H	0	-	2210	3417	3417	1.0000000
C3	3574374	3577812	BolC3t13231H	0	+	1891	3308	3438	0.9621873
C3	3578586	3584128	BolC3t13232H	0	+	3098	5521	5542	0.9962108
C3	3584326	3586375	BolC3t13233H	0	-	259	1843	2049	0.8994632
C3	3587780	3588632	BolC3t13234H	0	+	572	841	852	0.9870892
C3	3591843	3592368	BolC3t13235H	0	+	168	525	525	1.0000000
C3	3595635	3597419	BolC3t13236H	0	-	566	1784	1784	1.0000000
C3	3598928	3600611	BolC3t13237H	0	+	833	1607	1683	0.9548426
C3	3603233	3652778	BolC3t13238H	0	-	21595	36023	49545	0.7270764
C3	3610613	3613571	BolC3t13239H	0	+	882	2233	2958	0.7549019
C3	3614610	3616399	BolC3t13240H	0	-	453	1719	1789	0.9608720
C3	3622808	3623453	BolC3t13241H	0	+	404	645	645	1.0000000
C3	3623608	3625398	BolC3t13242H	0	+	595	1790	1790	1.0000000
C3	3634411	3634825	BolC3t13243H	0	+	53	346	414	0.8357488
C3	3640724	3642495	BolC3t13244H	0	+	407	1724	1771	0.9734613
C3	3656116	3656329	BolC3t13245H	0	-	68	202	213	0.9483568
C3	3658236	3660939	BolC3t13246H	0	+	1091	2683	2703	0.9926008
C3	3662101	3663572	BolC3t13247H	0	+	1003	1458	1471	0.9911625
C3	3663764	3665120	BolC3t13248H	0	-	618	1322	1356	0.9749262
C3	3665645	3671175	BolC3t13249H	0	-	2930	5525	5530	0.9990959
C3	3676504	3680106	BolC3t13250H	0	+	1909	3565	3602	0.9897279
C3	3680328	3681506	BolC3t13251H	0	-	909	1178	1178	1.0000000
C3	3683013	3685245	BolC3t13252H	0	-	529	1730	2232	0.7750896
C3	3695244	3695711	BolC3t13253H	0	+	516	467	467	1.0000000
C3	3696083	3696684	BolC3t13254H	0	+	667	601	601	1.0000000
C3	3698030	3699951	BolC3t13255H	0	+	716	1883	1921	0.9802186
C3	3700336	3701096	BolC3t13256H	0	-	301	760	760	1.0000000
C3	3702639	3703173	BolC3t13257H	0	-	568	534	534	1.0000000
C3	3715053	3716131	BolC3t13258H	0	+	4	197	1078	0.1827458
C3	3722563	3724498	BolC3t13259H	0	-	762	1859	1935	0.9607235
C3	3726752	3727514	BolC3t13260H	0	+	178	508	762	0.6666667
C3	3727969	3729362	BolC3t13261H	0	-	867	1393	1393	1.0000000
C3	3731063	3731492	BolC3t13262H	0	-	20	62	429	0.1445221
C3	3732432	3734504	BolC3t13263H	0	-	965	2002	2072	0.9662162
C3	3739582	3742846	BolC3t13264H	0	+	804	2481	3264	0.7601103
C3	3743193	3744589	BolC3t13265H	0	-	222	1330	1396	0.9527221
C3	3747118	3748526	BolC3t13266H	0	+	396	1310	1408	0.9303977
C3	3749211	3750956	BolC3t13267H	0	-	362	1299	1745	0.7444126
C3	3758356	3760029	BolC3t13268H	0	-	847	1597	1673	0.9545726
C3	3762524	3763593	BolC3t13269H	0	-	219	1022	1069	0.9560336
C3	3765518	3768696	BolC3t13270H	0	-	1449	3072	3178	0.9666457
C3	3771012	3776047	BolC3t13271H	0	-	2409	4850	5035	0.9632572
C3	3776542	3779615	BolC3t13272H	0	-	2359	2917	3073	0.9492353
C3	3780225	3782615	BolC3t13273H	0	-	1937	2390	2390	1.0000000
C3	3783652	3784727	BolC3t13274H	0	+	655	1075	1075	1.0000000
C3	3784911	3786019	BolC3t13275H	0	-	1385	1108	1108	1.0000000
C3	3787032	3788331	BolC3t13276H	0	-	3328	1299	1299	1.0000000
C3	3791541	3791751	BolC3t13277H	0	+	483	210	210	1.0000000
C3	3791882	3792439	BolC3t13278H	0	-	2	91	557	0.1633752
C3	3802537	3803094	BolC3t13279H	0	-	0	0	557	0.0000000
C3	3804148	3805576	BolC3t13280H	0	+	666	1428	1428	1.0000000
C3	3806170	3807648	BolC3t13281H	0	-	831	1478	1478	1.0000000
C3	3810718	3812808	BolC3t13282H	0	+	409	1765	2090	0.8444976
C3	3813650	3818391	BolC3t13283H	0	+	2156	4664	4741	0.9837587
C3	3818825	3821290	BolC3t13284H	0	+	2878	2465	2465	1.0000000
C3	3823681	3826298	BolC3t13285H	0	+	2216	2617	2617	1.0000000
C3	3826632	3830792	BolC3t13286H	0	-	1435	3797	4160	0.9127404
C3	3831776	3838064	BolC3t13287H	0	-	2065	5772	6288	0.9179389
C3	3846438	3854417	BolC3t13288H	0	+	2920	7273	7979	0.9115177
C3	3855205	3857238	BolC3t13289H	0	+	718	1826	2033	0.8981800
C3	3858047	3859920	BolC3t13290H	0	+	442	1216	1873	0.6492258
C3	3861546	3863175	BolC3t13291H	0	+	752	1525	1629	0.9361572
C3	3864548	3865082	BolC3t13292H	0	-	302	534	534	1.0000000
C3	3869585	3871788	BolC3t13293H	0	+	174	1540	2203	0.6990467
C3	3872360	3874597	BolC3t13294H	0	+	343	1574	2237	0.7036209
C3	3877143	3878752	BolC3t13295H	0	-	183	1112	1609	0.6911125
C3	3893755	3894770	BolC3t13296H	0	-	90	599	1015	0.5901478
C3	3901499	3905097	BolC3t13297H	0	-	1662	3518	3598	0.9777654
C3	3905354	3905702	BolC3t13298H	0	-	12	120	348	0.3448276
C3	3907060	3908350	BolC3t13299H	0	-	248	1131	1290	0.8767442
C3	3909179	3909826	BolC3t13300H	0	-	419	647	647	1.0000000
C3	3914498	3915354	BolC3t13301H	0	+	219	824	856	0.9626168
C3	3916361	3916970	BolC3t13302H	0	-	246	609	609	1.0000000
C3	3918858	3919419	BolC3t13303H	0	+	108	497	561	0.8859180
C3	3920662	3923249	BolC3t13304H	0	+	545	2457	2587	0.9497488
C3	3924864	3925614	BolC3t13305H	0	+	558	750	750	1.0000000
C3	3928916	3930160	BolC3t13306H	0	+	424	1244	1244	1.0000000
C3	3935061	3935736	BolC3t13307H	0	+	505	675	675	1.0000000
C3	3937334	3938302	BolC3t13308H	0	-	90	714	968	0.7376033
C3	3940241	3941642	BolC3t13309H	0	+	740	1401	1401	1.0000000
C3	3943262	3944246	BolC3t13310H	0	+	474	942	984	0.9573171
C3	3944695	3945415	BolC3t13311H	0	-	252	709	720	0.9847222
C3	3946701	3949291	BolC3t13312H	0	-	445	2323	2590	0.8969112
C3	3951059	3952160	BolC3t13313H	0	-	193	999	1101	0.9073570
C3	3954411	3955158	BolC3t13314H	0	-	85	747	747	1.0000000
C3	3957991	3960159	BolC3t13315H	0	-	296	1831	2168	0.8445572
C3	3961805	3963287	BolC3t13316H	0	+	1230	1482	1482	1.0000000
C3	3970695	3971385	BolC3t13317H	0	+	2	43	690	0.0623188
C3	3977329	3978058	BolC3t13318H	0	+	286	729	729	1.0000000
C3	3979817	3983512	BolC3t13319H	0	+	1295	3565	3695	0.9648173
C3	3985310	3985726	BolC3t13320H	0	-	0	0	416	0.0000000
C3	3987488	3987951	BolC3t13321H	0	-	0	0	463	0.0000000
C3	3989592	3989844	BolC3t13322H	0	-	0	0	252	0.0000000
C3	3992247	3992889	BolC3t13323H	0	+	4	45	642	0.0700935
C3	3994434	3995612	BolC3t13324H	0	-	0	0	1178	0.0000000
C3	3997605	3998162	BolC3t13325H	0	+	0	0	557	0.0000000
C3	4000094	4001438	BolC3t13326H	0	-	125	287	1344	0.2135417
C3	4005660	4006257	BolC3t13327H	0	+	164	293	597	0.4907873
C3	4006590	4007145	BolC3t13328H	0	+	0	0	555	0.0000000
C3	4013644	4013963	BolC3t13329H	0	+	0	0	319	0.0000000
C3	4014239	4015824	BolC3t13330H	0	-	37	435	1585	0.2744479
C3	4030646	4031548	BolC3t13331H	0	+	4	213	902	0.2361419
C3	4031962	4034064	BolC3t13332H	0	-	15	366	2102	0.1741199
C3	4034673	4035847	BolC3t13333H	0	+	189	927	1174	0.7896082
C3	4037201	4037438	BolC3t13334H	0	+	7	221	237	0.9324895
C3	4037996	4038194	BolC3t13335H	0	+	2	82	198	0.4141414
C3	4046808	4047399	BolC3t13336H	0	+	298	591	591	1.0000000
C3	4053161	4053428	BolC3t13337H	0	-	1	124	267	0.4644195
C3	4075068	4075383	BolC3t13338H	0	-	0	0	315	0.0000000
C3	4087032	4091509	BolC3t13339H	0	+	3960	4458	4477	0.9957561
C3	4092579	4094487	BolC3t13340H	0	+	915	1762	1908	0.9234801
C3	4095562	4097079	BolC3t13341H	0	+	864	1517	1517	1.0000000
C3	4099679	4101568	BolC3t13342H	0	+	632	1861	1889	0.9851773
C3	4101814	4109793	BolC3t13343H	0	-	393	3030	7979	0.3797468
C3	4110812	4111287	BolC3t13344H	0	-	379	475	475	1.0000000
C3	4113078	4114383	BolC3t13345H	0	+	945	1305	1305	1.0000000
C3	4120552	4121679	BolC3t13346H	0	-	563	1127	1127	1.0000000
C3	4124548	4125513	BolC3t13347H	0	-	578	965	965	1.0000000
C3	4126825	4129073	BolC3t13348H	0	+	1524	2248	2248	1.0000000
C3	4131587	4133669	BolC3t13349H	0	-	1234	2082	2082	1.0000000
C3	4143038	4143617	BolC3t13350H	0	+	32	522	579	0.9015544
C3	4145005	4145485	BolC3t13351H	0	-	11	187	480	0.3895833
C3	4150240	4151030	BolC3t13352H	0	-	351	790	790	1.0000000
C3	4154377	4154515	BolC3t13353H	0	+	5	57	138	0.4130435
C3	4164717	4165330	BolC3t13354H	0	+	396	613	613	1.0000000
C3	4165366	4166602	BolC3t13355H	0	-	305	1162	1236	0.9401295
C3	4167023	4168664	BolC3t13356H	0	+	721	1641	1641	1.0000000
C3	4172850	4174925	BolC3t13357H	0	-	1018	2061	2075	0.9932530
C3	4181962	4183174	BolC3t13358H	0	+	1231	1212	1212	1.0000000
C3	4184361	4185291	BolC3t13359H	0	+	92	723	930	0.7774193
C3	4185925	4188123	BolC3t13360H	0	-	295	1993	2198	0.9067334
C3	4190264	4193184	BolC3t13361H	0	+	1227	2920	2920	1.0000000
C3	4197191	4197398	BolC3t13362H	0	+	421	207	207	1.0000000
C3	4212821	4213394	BolC3t13363H	0	+	124	312	573	0.5445026
C3	4216607	4217273	BolC3t13364H	0	+	37	495	666	0.7432432
C3	4220061	4220826	BolC3t13365H	0	-	80	466	765	0.6091504
C3	4224095	4225605	BolC3t13366H	0	+	263	1413	1510	0.9357616
C3	4231566	4234896	BolC3t13367H	0	+	487	2189	3330	0.6573573
C3	4235116	4237624	BolC3t13368H	0	+	1757	2508	2508	1.0000000
C3	4237720	4238812	BolC3t13369H	0	+	805	1092	1092	1.0000000
C3	4244396	4248063	BolC3t13370H	0	+	1503	2681	3667	0.7311153
C3	4248750	4249657	BolC3t13371H	0	+	657	878	907	0.9680265
C3	4251297	4251432	BolC3t13372H	0	-	59	78	135	0.5777778
C3	4265895	4268097	BolC3t13373H	0	+	510	1713	2202	0.7779291
C3	4268863	4272146	BolC3t13374H	0	-	2055	3283	3283	1.0000000
C3	4274169	4275308	BolC3t13375H	0	-	1425	1139	1139	1.0000000
C3	4277888	4278824	BolC3t13376H	0	+	245	910	936	0.9722222
C3	4279093	4282657	BolC3t13377H	0	+	3032	3564	3564	1.0000000
C3	4283170	4283314	BolC3t13378H	0	-	309	144	144	1.0000000
C3	4289156	4290669	BolC3t13379H	0	+	1413	1481	1513	0.9788499
C3	4298827	4303911	BolC3t13380H	0	-	3401	4930	5084	0.9697089
C3	4307350	4309301	BolC3t13381H	0	-	865	1883	1951	0.9651461
C3	4311058	4311604	BolC3t13382H	0	-	218	546	546	1.0000000
C3	4312552	4317461	BolC3t13383H	0	+	6920	4909	4909	1.0000000
C3	4324052	4331462	BolC3t13384H	0	-	3658	5888	7410	0.7946019
C3	4332170	4336104	BolC3t13385H	0	+	1942	3792	3934	0.9639044
C3	4336333	4337667	BolC3t13386H	0	-	1975	1334	1334	1.0000000
C3	4338462	4339253	BolC3t13387H	0	-	533	791	791	1.0000000
C3	4340422	4341489	BolC3t13388H	0	-	232	968	1067	0.9072165
C3	4347883	4348685	BolC3t13389H	0	-	151	438	802	0.5461347
C3	4349837	4350904	BolC3t13390H	0	-	1414	1067	1067	1.0000000
C3	4360706	4362362	BolC3t13391H	0	-	354	1515	1656	0.9148551
C3	4363723	4364444	BolC3t13392H	0	-	283	713	721	0.9889043
C3	4365640	4367804	BolC3t13393H	0	-	1504	2102	2164	0.9713494
C3	4368288	4369881	BolC3t13394H	0	+	408	1369	1593	0.8593848
C3	4370567	4372538	BolC3t13395H	0	+	767	1960	1971	0.9944191
C3	4373197	4373816	BolC3t13396H	0	+	266	619	619	1.0000000
C3	4373998	4375222	BolC3t13397H	0	-	653	1224	1224	1.0000000
C3	4376223	4376541	BolC3t13398H	0	+	41	272	318	0.8553459
C3	4377903	4379990	BolC3t13399H	0	-	75	1424	2087	0.6823191
C3	4382858	4385850	BolC3t13400H	0	-	1264	2622	2992	0.8763369
C3	4389188	4391276	BolC3t13401H	0	+	271	1635	2088	0.7830459
C3	4392042	4392967	BolC3t13402H	0	+	674	925	925	1.0000000
C3	4396015	4400178	BolC3t13403H	0	-	1771	3422	4163	0.8220034
C3	4409345	4410321	BolC3t13404H	0	-	0	0	976	0.0000000
C3	4411981	4414493	BolC3t13405H	0	+	259	1407	2512	0.5601115
C3	4414941	4416175	BolC3t13406H	0	-	1004	1087	1234	0.8808752
C3	4417324	4417760	BolC3t13407H	0	-	398	436	436	1.0000000
C3	4418075	4422813	BolC3t13408H	0	-	1759	4576	4738	0.9658083
C3	4434864	4435593	BolC3t13409H	0	+	381	729	729	1.0000000
C3	4437497	4439960	BolC3t13410H	0	+	581	2437	2463	0.9894438
C3	4441123	4442098	BolC3t13411H	0	+	407	969	975	0.9938462
C3	4450327	4452381	BolC3t13412H	0	+	344	1892	2054	0.9211295
C3	4456973	4458501	BolC3t13413H	0	+	239	1007	1528	0.6590314
C3	4460731	4462397	BolC3t13414H	0	-	960	1666	1666	1.0000000
C3	4479136	4479458	BolC3t13415H	0	+	232	322	322	1.0000000
C3	4480874	4481304	BolC3t13416H	0	+	396	430	430	1.0000000
C3	4482023	4482434	BolC3t13417H	0	+	82	408	411	0.9927008
C3	4485320	4486897	BolC3t13418H	0	+	0	0	1577	0.0000000
C3	4490881	4491301	BolC3t13419H	0	+	252	418	420	0.9952381
C3	4496644	4497403	BolC3t13420H	0	+	349	759	759	1.0000000
C3	4498897	4499250	BolC3t13421H	0	+	282	353	353	1.0000000
C3	4503930	4505729	BolC3t13422H	0	-	1411	1699	1799	0.9444135
C3	4507026	4508498	BolC3t13423H	0	+	446	1456	1472	0.9891304
C3	4509676	4512065	BolC3t13424H	0	+	958	2389	2389	1.0000000
C3	4512848	4515352	BolC3t13425H	0	+	1607	2504	2504	1.0000000
C3	4516188	4517060	BolC3t13426H	0	-	627	872	872	1.0000000
C3	4518173	4519547	BolC3t13427H	0	+	236	1129	1374	0.8216885
C3	4520007	4522352	BolC3t13428H	0	+	817	2148	2345	0.9159915
C3	4522691	4523102	BolC3t13429H	0	-	378	411	411	1.0000000
C3	4523617	4523932	BolC3t13430H	0	+	81	247	315	0.7841270
C3	4524325	4528773	BolC3t13431H	0	-	1343	4191	4448	0.9422212
C3	4534946	4595770	BolC3t13432H	0	+	2995	18220	60824	0.2995528
C3	4548721	4549154	BolC3t13433H	0	-	0	0	433	0.0000000
C3	4554082	4554723	BolC3t13434H	0	+	6	22	641	0.0343214
C3	4560386	4565122	BolC3t13435H	0	-	352	1304	4736	0.2753378
C3	4562833	4591769	BolC3t13436H	0	-	1591	8241	28936	0.2848009
C3	4583397	4583830	BolC3t13437H	0	-	0	0	433	0.0000000
C3	4588126	4589416	BolC3t13438H	0	+	7	243	1290	0.1883721
C3	4593507	4594067	BolC3t13439H	0	+	0	0	560	0.0000000
C3	4595776	4596385	BolC3t13440H	0	-	70	397	609	0.6518884
C3	4600809	4602110	BolC3t13441H	0	+	27	761	1301	0.5849347
C3	4604226	4604418	BolC3t13442H	0	-	0	0	192	0.0000000
C3	4604955	4611137	BolC3t13443H	0	+	575	1165	6182	0.1884503
C3	4612147	4614452	BolC3t13444H	0	+	302	1860	2305	0.8069414
C3	4625427	4638161	BolC3t13445H	0	-	4253	8928	12734	0.7011151
C3	4627695	4629024	BolC3t13446H	0	+	0	0	1329	0.0000000
C3	4638730	4646067	BolC3t13447H	0	-	845	4952	7337	0.6749353
C3	4647053	4649129	BolC3t13448H	0	-	698	1943	2076	0.9359345
C3	4657651	4661825	BolC3t13449H	0	-	2190	4059	4174	0.9724485
C3	4664486	4669340	BolC3t13450H	0	+	3735	4789	4854	0.9866090
C3	4669645	4671316	BolC3t13451H	0	-	1025	1602	1671	0.9587073
C3	4676012	4679347	BolC3t13452H	0	-	2420	3335	3335	1.0000000
C3	4689588	4696886	BolC3t13453H	0	+	1689	5436	7298	0.7448616
C3	4697407	4697770	BolC3t13454H	0	-	33	363	363	1.0000000
C3	4699743	4700112	BolC3t13455H	0	-	16	320	369	0.8672087
C3	4704792	4705155	BolC3t13456H	0	-	15	329	363	0.9063361
C3	4706559	4707144	BolC3t13457H	0	+	15	214	585	0.3658120
C3	4709013	4709376	BolC3t13458H	0	-	54	344	363	0.9476584
C3	4710755	4718069	BolC3t13459H	0	+	1272	5767	7314	0.7884879
C3	4712090	4712909	BolC3t13460H	0	+	16	508	819	0.6202686
C3	4713440	4713809	BolC3t13461H	0	-	34	341	369	0.9241192
C3	4715942	4716305	BolC3t13462H	0	-	30	363	363	1.0000000
C3	4720813	4725512	BolC3t13463H	0	+	2659	4667	4699	0.9931901
C3	4725928	4730760	BolC3t13464H	0	-	1232	4257	4832	0.8810017
C3	4731684	4747400	BolC3t13465H	0	+	1890	5841	15716	0.3716595
C3	4747841	4748841	BolC3t13466H	0	-	2091	1000	1000	1.0000000
C3	4751374	4751581	BolC3t13467H	0	+	117	207	207	1.0000000
C3	4755986	4762428	BolC3t13468H	0	-	1510	5517	6442	0.8564110
C3	4767826	4768243	BolC3t13469H	0	+	2	51	417	0.1223022
C3	4770782	4772071	BolC3t13470H	0	+	782	1244	1289	0.9650892
C3	4772797	4773154	BolC3t13471H	0	-	21	238	357	0.6666667
C3	4775426	4776437	BolC3t13472H	0	-	719	1011	1011	1.0000000
C3	4778766	4779443	BolC3t13473H	0	-	159	471	677	0.6957164
C3	4781459	4783161	BolC3t13474H	0	-	592	1644	1702	0.9659224
C3	4785422	4787386	BolC3t13475H	0	-	876	1834	1964	0.9338086
C3	4790573	4792388	BolC3t13476H	0	-	1387	1815	1815	1.0000000
C3	4794612	4797235	BolC3t13477H	0	-	627	1863	2623	0.7102554
C3	4800493	4802418	BolC3t13478H	0	+	6	330	1925	0.1714286
C3	4803101	4805064	BolC3t13479H	0	-	7	104	1963	0.0529801
C3	4805937	4807282	BolC3t13480H	0	+	17	572	1345	0.4252788
C3	4808963	4809738	BolC3t13481H	0	-	8	97	775	0.1251613
C3	4810064	4810403	BolC3t13482H	0	+	21	131	339	0.3864307
C3	4810859	4815979	BolC3t13483H	0	-	1620	3938	5120	0.7691406
C3	4823958	4832981	BolC3t13484H	0	+	1099	2258	9023	0.2502494
C3	4834127	4835608	BolC3t13485H	0	+	245	1236	1481	0.8345712
C3	4836992	4841473	BolC3t13486H	0	+	264	2409	4481	0.5376032
C3	4846926	4850260	BolC3t13487H	0	+	507	2799	3334	0.8395321
C3	4851004	4851283	BolC3t13488H	0	-	2	61	279	0.2186380
C3	4852113	4852398	BolC3t13489H	0	+	23	82	285	0.2877193
C3	4853181	4853460	BolC3t13490H	0	-	7	98	279	0.3512545
C3	4854163	4856899	BolC3t13491H	0	+	406	2310	2736	0.8442982
C3	4857712	4858009	BolC3t13492H	0	-	21	297	297	1.0000000
C3	4859039	4860677	BolC3t13493H	0	+	181	1322	1638	0.8070818
C3	4861531	4861795	BolC3t13494H	0	+	4	184	264	0.6969697
C3	4863145	4864474	BolC3t13495H	0	-	145	874	1329	0.6576373
C3	4865088	4866622	BolC3t13496H	0	+	11	290	1534	0.1890482
C3	4868077	4869589	BolC3t13497H	0	+	6	232	1512	0.1534391
C3	4870383	4870709	BolC3t13498H	0	-	15	271	326	0.8312883
C3	4892898	4893929	BolC3t13499H	0	-	38	634	1031	0.6149369
C3	4900659	4901220	BolC3t13500H	0	-	50	463	561	0.8253120
C3	4901960	4905322	BolC3t13501H	0	-	65	914	3362	0.2718620
C3	4906604	4911867	BolC3t13502H	0	-	107	895	5263	0.1700551
C3	4912574	4915881	BolC3t13503H	0	+	39	978	3307	0.2957363
C3	4919100	4920629	BolC3t13504H	0	-	6	42	1529	0.0274689
C3	4926538	4927156	BolC3t13505H	0	+	251	618	618	1.0000000
C3	4943542	4953299	BolC3t13506H	0	-	1858	4675	9757	0.4791432
C3	4955655	4957729	BolC3t13507H	0	-	1643	2074	2074	1.0000000
C3	4958156	4961444	BolC3t13508H	0	+	1083	2318	3288	0.7049878
C3	4962424	4962865	BolC3t13509H	0	-	60	350	441	0.7936508
C3	4963150	4964542	BolC3t13510H	0	+	158	1153	1392	0.8283046
C3	4965144	4966701	BolC3t13511H	0	-	138	550	1557	0.3532434
C3	4967509	4974334	BolC3t13512H	0	-	2431	6002	6825	0.8794139
C3	4977994	4979492	BolC3t13513H	0	+	255	925	1498	0.6174900
C3	4980178	4983482	BolC3t13514H	0	-	1667	2879	3304	0.8713681
C3	4985688	4986567	BolC3t13515H	0	-	10	246	879	0.2798635
C3	4998527	4999748	BolC3t13516H	0	+	0	0	1221	0.0000000
C3	5000035	5002352	BolC3t13517H	0	-	7	90	2317	0.0388433
C3	5003776	5006221	BolC3t13518H	0	+	25	619	2445	0.2531697
C3	5007119	5008439	BolC3t13519H	0	+	41	134	1320	0.1015152
C3	5012985	5015167	BolC3t13520H	0	+	322	1884	2182	0.8634281
C3	5017086	5018085	BolC3t13521H	0	-	426	871	999	0.8718719
C3	5019488	5019993	BolC3t13522H	0	+	11	170	505	0.3366337
C3	5038392	5038728	BolC3t13523H	0	+	434	336	336	1.0000000
C3	5039717	5042433	BolC3t13524H	0	+	1013	2696	2716	0.9926362
C3	5042919	5043228	BolC3t13525H	0	-	168	309	309	1.0000000
C3	5053748	5056055	BolC3t13526H	0	+	1157	2306	2307	0.9995666
C3	5058333	5060439	BolC3t13527H	0	+	1835	2106	2106	1.0000000
C3	5089374	5090054	BolC3t13528H	0	-	1	128	680	0.1882353
C3	5090333	5090796	BolC3t13529H	0	-	0	0	463	0.0000000
C3	5091286	5091517	BolC3t13530H	0	-	2	56	231	0.2424242
C3	5095416	5096672	BolC3t13531H	0	+	159	700	1256	0.5573248
C3	5130786	5133031	BolC3t13532H	0	+	2155	2245	2245	1.0000000
C3	5134437	5136210	BolC3t13533H	0	-	447	1673	1773	0.9435984
C3	5139378	5141256	BolC3t13534H	0	-	191	1460	1878	0.7774228
C3	5148041	5153414	BolC3t13535H	0	-	3012	5350	5373	0.9957193
C3	5154229	5155984	BolC3t13536H	0	+	637	1632	1755	0.9299145
C3	5156804	5165496	BolC3t13537H	0	+	4438	8053	8692	0.9264841
C3	5162301	5164976	BolC3t13538H	0	-	1886	2675	2675	1.0000000
C3	5167183	5168748	BolC3t13539H	0	+	2827	1565	1565	1.0000000
C3	5170793	5171630	BolC3t13540H	0	+	986	837	837	1.0000000
C3	5174004	5188270	BolC3t13541H	0	+	7873	13483	14266	0.9451143
C3	5188510	5188687	BolC3t13542H	0	-	257	177	177	1.0000000
C3	5189380	5190356	BolC3t13543H	0	+	653	976	976	1.0000000
C3	5194517	5194890	BolC3t13544H	0	+	480	373	373	1.0000000
C3	5195382	5197924	BolC3t13545H	0	-	1028	2417	2542	0.9508261
C3	5198834	5199173	BolC3t13546H	0	+	289	304	339	0.8967552
C3	5201061	5202105	BolC3t13547H	0	-	157	944	1044	0.9042146
C3	5221240	5223589	BolC3t13548H	0	+	266	2156	2349	0.9178374
C3	5226022	5226639	BolC3t13549H	0	+	571	617	617	1.0000000
C3	5227350	5228150	BolC3t13550H	0	-	636	800	800	1.0000000
C3	5230600	5232595	BolC3t13551H	0	+	1551	1995	1995	1.0000000
C3	5232857	5235257	BolC3t13552H	0	-	1900	2400	2400	1.0000000
C3	5237356	5238573	BolC3t13553H	0	-	1291	1217	1217	1.0000000
C3	5238828	5241236	BolC3t13554H	0	+	2429	2408	2408	1.0000000
C3	5242025	5243994	BolC3t13555H	0	+	1075	1782	1969	0.9050279
C3	5244699	5245875	BolC3t13556H	0	+	24	318	1176	0.2704082
C3	5248718	5249855	BolC3t13557H	0	-	50	178	1137	0.1565523
C3	5250928	5251356	BolC3t13558H	0	+	1103	428	428	1.0000000
C3	5254996	5262421	BolC3t13559H	0	+	1695	6731	7425	0.9065320
C3	5262986	5294999	BolC3t13560H	0	-	21030	23508	32013	0.7343267
C3	5274264	5275851	BolC3t13561H	0	+	1419	1543	1587	0.9722747
C3	5275908	5279145	BolC3t13562H	0	+	988	2512	3237	0.7760272
C3	5279392	5281867	BolC3t13563H	0	+	2824	2340	2475	0.9454545
C3	5283826	5284990	BolC3t13564H	0	+	311	982	1164	0.8436426
C3	5289979	5292471	BolC3t13565H	0	+	2773	2242	2492	0.8996789
C3	5296353	5297030	BolC3t13566H	0	+	223	677	677	1.0000000
C3	5297724	5299877	BolC3t13567H	0	+	1284	1982	2153	0.9205759
C3	5300748	5301325	BolC3t13568H	0	+	463	577	577	1.0000000
C3	5305719	5306319	BolC3t13569H	0	+	613	600	600	1.0000000
C3	5309606	5311154	BolC3t13570H	0	-	1026	1548	1548	1.0000000
C3	5312916	5313657	BolC3t13571H	0	-	437	741	741	1.0000000
C3	5319770	5321886	BolC3t13572H	0	+	549	1687	2116	0.7972590
C3	5322348	5324720	BolC3t13573H	0	-	3346	2372	2372	1.0000000
C3	5325318	5330326	BolC3t13574H	0	-	1150	3382	5008	0.6753195
C3	5331078	5332318	BolC3t13575H	0	+	1114	1240	1240	1.0000000
C3	5331469	5331830	BolC3t13576H	0	+	309	361	361	1.0000000
C3	5333521	5334245	BolC3t13577H	0	+	904	724	724	1.0000000
C3	5334703	5336215	BolC3t13578H	0	-	1178	1512	1512	1.0000000
C3	5338998	5341596	BolC3t13579H	0	+	1265	2518	2598	0.9692071
C3	5343552	5346853	BolC3t13580H	0	+	1356	2785	3301	0.8436837
C3	5348478	5350802	BolC3t13581H	0	+	1223	2162	2324	0.9302926
C3	5351377	5356907	BolC3t13582H	0	-	1996	5093	5530	0.9209765
C3	5358789	5360025	BolC3t13583H	0	-	513	1051	1236	0.8503236
C3	5360824	5365198	BolC3t13584H	0	-	628	2787	4374	0.6371742
C3	5365998	5370948	BolC3t13585H	0	+	2483	4476	4950	0.9042424
C3	5371407	5373340	BolC3t13586H	0	+	1028	1933	1933	1.0000000
C3	5373775	5375822	BolC3t13587H	0	-	1164	2047	2047	1.0000000
C3	5377557	5377869	BolC3t13588H	0	-	199	312	312	1.0000000
C3	5381756	5383918	BolC3t13589H	0	+	640	2149	2162	0.9939870
C3	5384239	5385004	BolC3t13590H	0	-	91	683	765	0.8928105
C3	5385838	5391701	BolC3t13591H	0	-	701	3687	5863	0.6288589
C3	5393994	5394240	BolC3t13592H	0	+	135	246	246	1.0000000
C3	5394417	5398168	BolC3t13593H	0	+	3317	3686	3751	0.9826713
C3	5400335	5400833	BolC3t13594H	0	-	28	470	498	0.9437751
C3	5402319	5403272	BolC3t13595H	0	+	995	953	953	1.0000000
C3	5403902	5405175	BolC3t13596H	0	-	345	1160	1273	0.9112333
C3	5407547	5407919	BolC3t13597H	0	+	19	144	372	0.3870968
C3	5409633	5410818	BolC3t13598H	0	-	445	1185	1185	1.0000000
C3	5411537	5412499	BolC3t13599H	0	+	485	962	962	1.0000000
C3	5415003	5417220	BolC3t13600H	0	+	2270	2217	2217	1.0000000
C3	5417461	5417836	BolC3t13601H	0	-	366	375	375	1.0000000
C3	5419984	5420343	BolC3t13602H	0	-	0	0	359	0.0000000
C3	5422624	5422980	BolC3t13603H	0	-	0	0	356	0.0000000
C3	5427706	5428061	BolC3t13604H	0	-	0	0	355	0.0000000
C3	5428646	5429660	BolC3t13605H	0	-	40	814	1014	0.8027613
C3	5434764	5438967	BolC3t13606H	0	+	1050	3733	4203	0.8881751
C3	5439282	5440309	BolC3t13607H	0	-	934	1027	1027	1.0000000
C3	5441626	5442139	BolC3t13608H	0	-	227	513	513	1.0000000
C3	5443539	5446215	BolC3t13609H	0	-	1498	2627	2676	0.9816891
C3	5447217	5447454	BolC3t13610H	0	-	24	148	237	0.6244726
C3	5452346	5453717	BolC3t13611H	0	+	270	1332	1371	0.9715536
C3	5460203	5466625	BolC3t13612H	0	+	3078	5926	6422	0.9227655
C3	5469826	5470531	BolC3t13613H	0	-	534	705	705	1.0000000
C3	5477595	5477928	BolC3t13614H	0	+	7	20	333	0.0600601
C3	5479041	5480984	BolC3t13615H	0	-	666	1621	1943	0.8342769
C3	5483574	5484886	BolC3t13616H	0	+	616	1312	1312	1.0000000
C3	5486252	5487232	BolC3t13617H	0	+	180	870	980	0.8877551
C3	5487703	5488597	BolC3t13618H	0	-	446	894	894	1.0000000
C3	5488980	5489709	BolC3t13619H	0	-	442	729	729	1.0000000
C3	5490551	5493424	BolC3t13620H	0	-	1317	2672	2873	0.9300383
C3	5493956	5494627	BolC3t13621H	0	+	117	545	671	0.8122206
C3	5501327	5502293	BolC3t13622H	0	+	470	952	966	0.9855072
C3	5503706	5504945	BolC3t13623H	0	+	931	1197	1239	0.9661017
C3	5507075	5509088	BolC3t13624H	0	+	64	995	2013	0.4942871
C3	5509577	5513229	BolC3t13625H	0	-	218	1846	3652	0.5054765
C3	5515604	5517495	BolC3t13626H	0	-	1174	1891	1891	1.0000000
C3	5520568	5521799	BolC3t13627H	0	-	364	1135	1231	0.9220146
C3	5537581	5538934	BolC3t13628H	0	+	11	263	1353	0.1943828
C3	5540022	5543958	BolC3t13629H	0	+	1741	3795	3936	0.9641768
C3	5544901	5546992	BolC3t13630H	0	-	940	1995	2091	0.9540889
C3	5553341	5553845	BolC3t13631H	0	-	146	504	504	1.0000000
C3	5555846	5557289	BolC3t13632H	0	+	386	1153	1443	0.7990298
C3	5558663	5559829	BolC3t13633H	0	-	41	631	1166	0.5411664
C3	5566436	5583505	BolC3t13634H	0	-	2466	9973	17069	0.5842756
C3	5585296	5586035	BolC3t13635H	0	-	322	704	739	0.9526387
C3	5587775	5591929	BolC3t13636H	0	+	2565	4118	4154	0.9913337
C3	5594825	5596373	BolC3t13637H	0	+	1257	1548	1548	1.0000000
C3	5597444	5598576	BolC3t13638H	0	-	1318	1132	1132	1.0000000
C3	5599810	5605055	BolC3t13639H	0	-	4218	5129	5245	0.9778837
C3	5611564	5612200	BolC3t13640H	0	-	397	636	636	1.0000000
C3	5615794	5618115	BolC3t13641H	0	-	727	2143	2321	0.9233089
C3	5618816	5619224	BolC3t13642H	0	-	126	408	408	1.0000000
C3	5625465	5625921	BolC3t13643H	0	-	51	305	456	0.6688597
C3	5636862	5639411	BolC3t13644H	0	+	1941	2293	2549	0.8995684
C3	5640628	5641943	BolC3t13645H	0	+	1106	1315	1315	1.0000000
C3	5645440	5648346	BolC3t13646H	0	+	1302	2604	2906	0.8960771
C3	5648848	5649463	BolC3t13647H	0	-	28	192	615	0.3121951
C3	5652604	5653177	BolC3t13648H	0	-	12	293	573	0.5113438
C3	5655362	5656232	BolC3t13649H	0	+	306	731	870	0.8402299
C3	5657249	5657756	BolC3t13650H	0	-	397	507	507	1.0000000
C3	5667073	5671194	BolC3t13651H	0	-	890	3408	4121	0.8269837
C3	5679412	5685484	BolC3t13652H	0	-	2386	5459	6072	0.8990448
C3	5689115	5691098	BolC3t13653H	0	-	1452	1983	1983	1.0000000
C3	5693261	5694851	BolC3t13654H	0	-	376	1497	1590	0.9415094
C3	5695741	5696569	BolC3t13655H	0	-	604	828	828	1.0000000
C3	5697583	5698087	BolC3t13656H	0	-	172	504	504	1.0000000
C3	5700909	5713250	BolC3t13657H	0	-	2045	8385	12341	0.6794425
C3	5710249	5710444	BolC3t13658H	0	-	2	46	195	0.2358974
C3	5714912	5715431	BolC3t13659H	0	+	324	519	519	1.0000000
C3	5715563	5718518	BolC3t13660H	0	-	1154	2679	2955	0.9065990
C3	5719738	5720581	BolC3t13661H	0	+	228	843	843	1.0000000
C3	5721135	5725841	BolC3t13662H	0	-	2225	4036	4706	0.8576286
C3	5726451	5731161	BolC3t13663H	0	-	2596	4576	4710	0.9715499
C3	5734424	5736268	BolC3t13664H	0	+	444	1740	1844	0.9436009
C3	5737193	5738856	BolC3t13665H	0	+	367	1627	1663	0.9783524
C3	5739931	5740323	BolC3t13666H	0	-	308	392	392	1.0000000
C3	5742273	5744196	BolC3t13667H	0	-	443	983	1923	0.5111805
C3	5748123	5750048	BolC3t13668H	0	+	1220	1862	1925	0.9672727
C3	5752442	5752622	BolC3t13669H	0	-	17	180	180	1.0000000
C3	5754182	5755091	BolC3t13670H	0	+	184	754	909	0.8294830
C3	5757830	5759219	BolC3t13671H	0	-	272	1244	1389	0.8956084
C3	5759676	5760666	BolC3t13672H	0	-	367	990	990	1.0000000
C3	5761521	5763662	BolC3t13673H	0	+	1093	2141	2141	1.0000000
C3	5764018	5765138	BolC3t13674H	0	-	494	1096	1120	0.9785714
C3	5771297	5773180	BolC3t13675H	0	-	1285	1883	1883	1.0000000
C3	5790430	5791121	BolC3t13676H	0	-	45	632	691	0.9146165
C3	5792929	5793562	BolC3t13677H	0	-	127	597	633	0.9431280
C3	5795586	5795849	BolC3t13678H	0	+	550	263	263	1.0000000
C3	5796250	5797527	BolC3t13679H	0	-	609	1270	1277	0.9945184
C3	5804866	5805413	BolC3t13680H	0	-	0	0	547	0.0000000
C3	5808710	5811666	BolC3t13681H	0	+	1152	2673	2956	0.9042625
C3	5813790	5815706	BolC3t13682H	0	+	905	1867	1916	0.9744259
C3	5816817	5817807	BolC3t13683H	0	+	849	990	990	1.0000000
C3	5821565	5822765	BolC3t13684H	0	+	1106	1200	1200	1.0000000
C3	5823372	5824583	BolC3t13685H	0	-	776	1211	1211	1.0000000
C3	5825411	5830313	BolC3t13686H	0	-	1997	4817	4902	0.9826601
C3	5832030	5833216	BolC3t13687H	0	-	557	1061	1186	0.8946037
C3	5834333	5836107	BolC3t13688H	0	+	521	1557	1774	0.8776776
C3	5836522	5838335	BolC3t13689H	0	-	592	1783	1813	0.9834529
C3	5840565	5841651	BolC3t13690H	0	+	151	960	1086	0.8839779
C3	5844795	5845146	BolC3t13691H	0	+	613	351	351	1.0000000
C3	5864861	5866217	BolC3t13692H	0	-	76	874	1356	0.6445428
C3	5891760	5893512	BolC3t13693H	0	-	1285	1752	1752	1.0000000
C3	5896965	5901671	BolC3t13694H	0	+	2939	3938	4706	0.8368041
C3	5903621	5903804	BolC3t13695H	0	-	66	183	183	1.0000000
C3	5905521	5906055	BolC3t13696H	0	-	101	532	534	0.9962547
C3	5908558	5912263	BolC3t13697H	0	+	3191	3362	3705	0.9074224
C3	5912539	5913397	BolC3t13698H	0	-	149	473	858	0.5512820
C3	5922305	5922584	BolC3t13699H	0	-	10	50	279	0.1792115
C3	5925949	5926681	BolC3t13700H	0	-	261	732	732	1.0000000
C3	5927758	5930119	BolC3t13701H	0	-	1467	2360	2361	0.9995764
C3	5932368	5933971	BolC3t13702H	0	-	716	1586	1603	0.9893949
C3	5943021	5945521	BolC3t13703H	0	-	660	2456	2500	0.9824000
C3	5946039	5948448	BolC3t13704H	0	+	2105	2409	2409	1.0000000
C3	5949515	5950615	BolC3t13705H	0	-	507	1100	1100	1.0000000
C3	5960213	5961491	BolC3t13706H	0	-	231	1113	1278	0.8708920
C3	5973978	5977554	BolC3t13707H	0	+	913	2753	3576	0.7698546
C3	5978630	5985537	BolC3t13708H	0	-	2398	6595	6907	0.9548284
C3	5987812	5995644	BolC3t13709H	0	-	5661	7832	7832	1.0000000
C3	5994432	5994780	BolC3t13710H	0	+	268	348	348	1.0000000
C3	5997953	6001446	BolC3t13711H	0	-	3449	3313	3493	0.9484684
C3	6003425	6006916	BolC3t13712H	0	-	3039	3491	3491	1.0000000
C3	6012767	6014207	BolC3t13713H	0	-	989	1440	1440	1.0000000
C3	6018730	6019802	BolC3t13714H	0	+	799	1072	1072	1.0000000
C3	6022701	6024316	BolC3t13715H	0	-	1654	1615	1615	1.0000000
C3	6025970	6027603	BolC3t13716H	0	-	797	1618	1633	0.9908144
C3	6028588	6039900	BolC3t13717H	0	-	4144	7796	11312	0.6891797
C3	6041176	6046213	BolC3t13718H	0	-	1757	4528	5037	0.8989478
C3	6054478	6059285	BolC3t13719H	0	-	2242	4758	4807	0.9898065
C3	6060106	6065727	BolC3t13720H	0	+	1347	5197	5621	0.9245686
C3	6075220	6083133	BolC3t13721H	0	-	1007	2728	7913	0.3447492
C3	6097319	6099988	BolC3t13722H	0	-	2020	2669	2669	1.0000000
C3	6104597	6104962	BolC3t13723H	0	+	0	0	365	0.0000000
C3	6108154	6108340	BolC3t13724H	0	-	57	186	186	1.0000000
C3	6112883	6113249	BolC3t13725H	0	+	6	271	366	0.7404372
C3	6115387	6115777	BolC3t13726H	0	-	181	390	390	1.0000000
C3	6116689	6119856	BolC3t13727H	0	-	1099	2377	3167	0.7505526
C3	6123339	6125161	BolC3t13728H	0	+	690	1734	1822	0.9517014
C3	6127086	6128259	BolC3t13729H	0	-	184	704	1173	0.6001705
C3	6145451	6147150	BolC3t13730H	0	+	719	1669	1699	0.9823425
C3	6148352	6149654	BolC3t13731H	0	+	480	1253	1302	0.9623656
C3	6151422	6153528	BolC3t13732H	0	+	3004	2106	2106	1.0000000
C3	6153818	6154286	BolC3t13733H	0	-	6	322	468	0.6880342
C3	6156855	6158114	BolC3t13734H	0	+	806	1259	1259	1.0000000
C3	6163954	6164065	BolC3t13735H	0	+	42	99	111	0.8918919
C3	6164768	6165260	BolC3t13736H	0	-	463	492	492	1.0000000
C3	6166119	6172730	BolC3t13737H	0	+	1827	6247	6611	0.9449403
C3	6173567	6177460	BolC3t13738H	0	+	727	3312	3893	0.8507578
C3	6178916	6183249	BolC3t13739H	0	+	2928	4013	4333	0.9261482
C3	6187048	6188463	BolC3t13740H	0	+	861	1415	1415	1.0000000
C3	6189196	6190410	BolC3t13741H	0	+	1255	1214	1214	1.0000000
C3	6191414	6191825	BolC3t13742H	0	+	102	411	411	1.0000000
C3	6192682	6193023	BolC3t13743H	0	+	158	341	341	1.0000000
C3	6193548	6194873	BolC3t13744H	0	-	1019	1325	1325	1.0000000
C3	6196666	6198074	BolC3t13745H	0	+	198	1173	1408	0.8330966
C3	6200545	6201292	BolC3t13746H	0	+	504	747	747	1.0000000
C3	6210195	6210525	BolC3t13747H	0	+	94	330	330	1.0000000
C3	6214146	6214538	BolC3t13748H	0	+	247	392	392	1.0000000
C3	6215075	6216507	BolC3t13749H	0	-	407	1432	1432	1.0000000
C3	6223499	6224172	BolC3t13750H	0	-	216	671	673	0.9970282
C3	6225498	6225911	BolC3t13751H	0	-	400	413	413	1.0000000
C3	6228900	6229179	BolC3t13752H	0	-	0	0	279	0.0000000
C3	6233320	6236254	BolC3t13753H	0	-	2414	2934	2934	1.0000000
C3	6243323	6245364	BolC3t13754H	0	+	1559	2041	2041	1.0000000
C3	6245664	6247674	BolC3t13755H	0	-	1002	1904	2010	0.9472637
C3	6250074	6258745	BolC3t13756H	0	-	3288	8484	8671	0.9784338
C3	6259902	6262516	BolC3t13757H	0	-	936	2392	2614	0.9150727
C3	6263534	6264302	BolC3t13758H	0	+	151	768	768	1.0000000
C3	6265819	6267307	BolC3t13759H	0	+	10	385	1488	0.2587366
C3	6268890	6269237	BolC3t13760H	0	+	21	203	347	0.5850144
C3	6269817	6270333	BolC3t13761H	0	+	88	486	516	0.9418604
C3	6271006	6272478	BolC3t13762H	0	-	1013	1364	1472	0.9266304
C3	6277363	6279417	BolC3t13763H	0	+	1028	1902	2054	0.9259980
C3	6281498	6282491	BolC3t13764H	0	-	364	993	993	1.0000000
C3	6288795	6289473	BolC3t13765H	0	-	467	678	678	1.0000000
C3	6294090	6294450	BolC3t13766H	0	-	26	323	360	0.8972222
C3	6298380	6313881	BolC3t13767H	0	+	4175	9718	15501	0.6269273
C3	6298699	6299332	BolC3t13768H	0	+	78	633	633	1.0000000
C3	6300413	6304702	BolC3t13769H	0	-	1202	3305	4289	0.7705759
C3	6310374	6310716	BolC3t13770H	0	+	84	177	342	0.5175439
C3	6315016	6319357	BolC3t13771H	0	-	593	3093	4341	0.7125086
C3	6324382	6326436	BolC3t13772H	0	+	224	1153	2054	0.5613437
C3	6328901	6329984	BolC3t13773H	0	+	929	1083	1083	1.0000000
C3	6330477	6331026	BolC3t13774H	0	+	596	549	549	1.0000000
C3	6331975	6334026	BolC3t13775H	0	-	401	1873	2051	0.9132131
C3	6339803	6340111	BolC3t13776H	0	-	292	308	308	1.0000000
C3	6341805	6342231	BolC3t13777H	0	-	149	426	426	1.0000000
C3	6356505	6356805	BolC3t13778H	0	+	93	300	300	1.0000000
C3	6357933	6359874	BolC3t13779H	0	-	1364	1941	1941	1.0000000
C3	6361077	6362365	BolC3t13780H	0	-	171	280	1288	0.2173913
C3	6372552	6373709	BolC3t13781H	0	-	474	1145	1157	0.9896284
C3	6377840	6378029	BolC3t13782H	0	+	42	83	189	0.4391534
C3	6380367	6381081	BolC3t13783H	0	+	460	714	714	1.0000000
C3	6383501	6384177	BolC3t13784H	0	-	421	650	676	0.9615384
C3	6385634	6386156	BolC3t13785H	0	+	97	522	522	1.0000000
C3	6386411	6388054	BolC3t13786H	0	+	1171	1643	1643	1.0000000
C3	6388361	6388785	BolC3t13787H	0	+	455	424	424	1.0000000
C3	6389359	6391271	BolC3t13788H	0	-	150	352	1912	0.1841004
C3	6393755	6394478	BolC3t13789H	0	+	419	723	723	1.0000000
C3	6396371	6396848	BolC3t13790H	0	-	113	477	477	1.0000000
C3	6401975	6403294	BolC3t13791H	0	+	1042	1319	1319	1.0000000
C3	6410326	6411259	BolC3t13792H	0	+	303	890	933	0.9539121
C3	6413831	6414339	BolC3t13793H	0	+	653	508	508	1.0000000
C3	6414680	6417822	BolC3t13794H	0	+	2044	3129	3142	0.9958625
C3	6425725	6427594	BolC3t13795H	0	+	86	1270	1869	0.6795077
C3	6429491	6429974	BolC3t13796H	0	-	303	483	483	1.0000000
C3	6431065	6434217	BolC3t13797H	0	-	1959	3065	3152	0.9723985
C3	6436048	6436360	BolC3t13798H	0	-	308	312	312	1.0000000
C3	6438412	6478461	BolC3t13799H	0	-	27905	38908	40049	0.9715099
C3	6450811	6452487	BolC3t13800H	0	+	2843	1676	1676	1.0000000
C3	6463530	6464547	BolC3t13801H	0	+	757	1017	1017	1.0000000
C3	6479273	6479615	BolC3t13802H	0	+	204	342	342	1.0000000
C3	6480333	6481386	BolC3t13803H	0	-	565	1053	1053	1.0000000
C3	6483155	6484184	BolC3t13804H	0	-	96	774	1029	0.7521866
C3	6487331	6488396	BolC3t13805H	0	-	351	1021	1065	0.9586855
C3	6493362	6494043	BolC3t13806H	0	-	91	542	681	0.7958884
C3	6498497	6498875	BolC3t13807H	0	-	29	281	378	0.7433863
C3	6499580	6500588	BolC3t13808H	0	-	682	986	1008	0.9781746
C3	6501758	6505413	BolC3t13809H	0	+	1012	3603	3655	0.9857729
C3	6506622	6507838	BolC3t13810H	0	+	284	1144	1216	0.9407895
C3	6511787	6513230	BolC3t13811H	0	+	594	1443	1443	1.0000000
C3	6522383	6523680	BolC3t13812H	0	+	175	1033	1297	0.7964534
C3	6526177	6527087	BolC3t13813H	0	+	763	910	910	1.0000000
C3	6529865	6531568	BolC3t13814H	0	+	513	1575	1703	0.9248385
C3	6533116	6533532	BolC3t13815H	0	+	75	416	416	1.0000000
C3	6537874	6540318	BolC3t13816H	0	-	412	1696	2444	0.6939443
C3	6542127	6543617	BolC3t13817H	0	+	407	1488	1490	0.9986577
C3	6543824	6544597	BolC3t13818H	0	-	416	712	773	0.9210867
C3	6544930	6546035	BolC3t13819H	0	+	9	261	1105	0.2361991
C3	6546851	6574775	BolC3t13820H	0	-	1967	11182	27924	0.4004441
C3	6575126	6576239	BolC3t13821H	0	-	90	810	1113	0.7277628
C3	6588692	6589022	BolC3t13822H	0	-	11	230	330	0.6969697
C3	6590324	6591611	BolC3t13823H	0	-	5	355	1287	0.2758353
C3	6592274	6592917	BolC3t13824H	0	-	0	0	643	0.0000000
C3	6592970	6593771	BolC3t13825H	0	-	0	0	801	0.0000000
C3	6593894	6614235	BolC3t13826H	0	-	15653	18268	20341	0.8980876
C3	6621118	6622869	BolC3t13827H	0	-	1303	1751	1751	1.0000000
C3	6623189	6624878	BolC3t13828H	0	-	699	1660	1689	0.9828300
C3	6628290	6629112	BolC3t13829H	0	-	415	822	822	1.0000000
C3	6634034	6634385	BolC3t13830H	0	-	65	242	351	0.6894587
C3	6638277	6638532	BolC3t13831H	0	+	21	240	255	0.9411765
C3	6645592	6647594	BolC3t13832H	0	+	1366	2002	2002	1.0000000
C3	6650281	6651076	BolC3t13833H	0	+	181	746	795	0.9383648
C3	6653523	6654012	BolC3t13834H	0	-	215	426	489	0.8711656
C3	6655049	6655511	BolC3t13835H	0	+	12	56	462	0.1212121
C3	6656801	6659631	BolC3t13836H	0	-	1073	2493	2830	0.8809187
C3	6662194	6662900	BolC3t13837H	0	-	10	164	706	0.2322946
C3	6675174	6675536	BolC3t13838H	0	+	1	5	362	0.0138122
C3	6679140	6679505	BolC3t13839H	0	-	177	365	365	1.0000000
C3	6680921	6683692	BolC3t13840H	0	-	333	1765	2771	0.6369542
C3	6686656	6690113	BolC3t13841H	0	-	1462	3391	3457	0.9809083
C3	6690996	6691967	BolC3t13842H	0	-	614	971	971	1.0000000
C3	6693745	6694102	BolC3t13843H	0	+	269	357	357	1.0000000
C3	6696228	6697451	BolC3t13844H	0	+	350	1223	1223	1.0000000
C3	6699412	6700552	BolC3t13845H	0	+	382	852	1140	0.7473684
C3	6702773	6707263	BolC3t13846H	0	-	2351	4490	4490	1.0000000
C3	6708637	6709866	BolC3t13847H	0	-	847	1229	1229	1.0000000
C3	6712549	6713420	BolC3t13848H	0	-	246	769	871	0.8828932
C3	6714261	6716432	BolC3t13849H	0	-	588	1990	2171	0.9166283
C3	6717586	6717925	BolC3t13850H	0	-	217	339	339	1.0000000
C3	6718180	6718300	BolC3t13851H	0	+	128	120	120	1.0000000
C3	6718664	6720343	BolC3t13852H	0	+	513	1328	1679	0.7909470
C3	6722264	6723587	BolC3t13853H	0	+	130	1143	1323	0.8639456
C3	6724093	6724888	BolC3t13854H	0	-	301	795	795	1.0000000
C3	6733631	6734709	BolC3t13855H	0	+	300	1075	1078	0.9972171
C3	6746747	6748183	BolC3t13856H	0	-	277	1187	1436	0.8266017
C3	6749618	6751766	BolC3t13857H	0	+	749	2071	2148	0.9641527
C3	6752302	6753823	BolC3t13858H	0	-	992	1459	1521	0.9592373
C3	6765542	6767149	BolC3t13859H	0	-	1252	1607	1607	1.0000000
C3	6781514	6784153	BolC3t13860H	0	+	964	2639	2639	1.0000000
C3	6785163	6787784	BolC3t13861H	0	+	940	2477	2621	0.9450591
C3	6788203	6789551	BolC3t13862H	0	-	768	1271	1348	0.9428784
C3	6792077	6795634	BolC3t13863H	0	+	782	2496	3557	0.7017149
C3	6795925	6797316	BolC3t13864H	0	-	487	1166	1391	0.8382459
C3	6799423	6799636	BolC3t13865H	0	+	399	213	213	1.0000000
C3	6802800	6803718	BolC3t13866H	0	+	837	918	918	1.0000000
C3	6804799	6805469	BolC3t13867H	0	-	533	670	670	1.0000000
C3	6806453	6809707	BolC3t13868H	0	-	717	3146	3254	0.9668101
C3	6810193	6816460	BolC3t13869H	0	+	2156	6082	6267	0.9704803
C3	6816789	6818067	BolC3t13870H	0	-	104	171	1278	0.1338028
C3	6826885	6828049	BolC3t13871H	0	-	921	1164	1164	1.0000000
C3	6833663	6834476	BolC3t13872H	0	-	180	787	813	0.9680197
C3	6836544	6839071	BolC3t13873H	0	-	788	2470	2527	0.9774436
C3	6840069	6846059	BolC3t13874H	0	+	2265	5408	5990	0.9028381
C3	6846753	6847890	BolC3t13875H	0	+	741	1137	1137	1.0000000
C3	6851609	6854267	BolC3t13876H	0	+	864	2553	2658	0.9604966
C3	6854458	6855516	BolC3t13877H	0	-	370	1058	1058	1.0000000
C3	6857229	6857953	BolC3t13878H	0	+	328	724	724	1.0000000
C3	6858561	6860415	BolC3t13879H	0	+	188	1494	1854	0.8058252
C3	6863353	6864323	BolC3t13880H	0	-	194	859	970	0.8855670
C3	6865597	6873060	BolC3t13881H	0	-	1153	3841	7463	0.5146724
C3	6874662	6884490	BolC3t13882H	0	+	4152	9447	9828	0.9612332
C3	6879702	6879959	BolC3t13883H	0	+	37	257	257	1.0000000
C3	6885745	6886069	BolC3t13884H	0	-	335	324	324	1.0000000
C3	6887035	6889023	BolC3t13885H	0	-	749	1859	1988	0.9351107
C3	6891025	6893250	BolC3t13886H	0	+	1192	2225	2225	1.0000000
C3	6893592	6897472	BolC3t13887H	0	-	1711	3637	3880	0.9373711
C3	6897872	6899916	BolC3t13888H	0	-	615	1931	2044	0.9447162
C3	6901532	6903550	BolC3t13889H	0	-	88	1297	2018	0.6427156
C3	6905783	6909839	BolC3t13890H	0	-	1472	3894	4056	0.9600592
C3	6915345	6915635	BolC3t13891H	0	+	8	252	290	0.8689655
C3	6922307	6923157	BolC3t13892H	0	+	740	850	850	1.0000000
C3	6923530	6926719	BolC3t13893H	0	-	1054	3134	3189	0.9827532
C3	6927202	6928936	BolC3t13894H	0	-	527	1661	1734	0.9579008
C3	6930103	6932477	BolC3t13895H	0	-	815	2312	2374	0.9738837
C3	6936485	6938795	BolC3t13896H	0	+	372	1850	2310	0.8008658
C3	6939109	6943770	BolC3t13897H	0	-	1622	4422	4661	0.9487234
C3	6945218	6946303	BolC3t13898H	0	-	625	1085	1085	1.0000000
C3	6947815	6948460	BolC3t13899H	0	+	184	645	645	1.0000000
C3	6949059	6949946	BolC3t13900H	0	-	1249	887	887	1.0000000
C3	6959120	6959864	BolC3t13901H	0	-	20	200	744	0.2688172
C3	6960439	6963335	BolC3t13902H	0	+	954	2475	2896	0.8546271
C3	6964948	6968973	BolC3t13903H	0	-	2575	3856	4025	0.9580124
C3	6969350	6970748	BolC3t13904H	0	+	461	1398	1398	1.0000000
C3	6971100	6971265	BolC3t13905H	0	-	296	165	165	1.0000000
C3	6971827	6973075	BolC3t13906H	0	+	936	1248	1248	1.0000000
C3	6973999	6977112	BolC3t13907H	0	-	491	2884	3113	0.9264375
C3	6977584	6981018	BolC3t13908H	0	+	1555	3425	3434	0.9973791
C3	6981671	6982381	BolC3t13909H	0	+	181	629	710	0.8859155
C3	6982843	6983465	BolC3t13910H	0	-	524	622	622	1.0000000
C3	6984492	6985691	BolC3t13911H	0	+	250	1153	1199	0.9616347
C3	6989203	6989925	BolC3t13912H	0	-	450	722	722	1.0000000
C3	6990348	6990543	BolC3t13913H	0	-	131	195	195	1.0000000
C3	6990813	6992638	BolC3t13914H	0	+	1196	1825	1825	1.0000000
C3	6997983	6999542	BolC3t13915H	0	+	1736	1559	1559	1.0000000
C3	7000312	7001544	BolC3t13916H	0	+	1086	1232	1232	1.0000000
C3	7003053	7006795	BolC3t13917H	0	-	1641	3742	3742	1.0000000
C3	7007729	7011418	BolC3t13918H	0	-	2123	3526	3689	0.9558146
C3	7017113	7017761	BolC3t13919H	0	+	353	648	648	1.0000000
C3	7022007	7022861	BolC3t13920H	0	+	418	625	854	0.7318501
C3	7026552	7026833	BolC3t13921H	0	-	140	281	281	1.0000000
C3	7030045	7030267	BolC3t13922H	0	+	27	171	222	0.7702703
C3	7036358	7036619	BolC3t13923H	0	+	433	261	261	1.0000000
C3	7037972	7038203	BolC3t13924H	0	-	50	222	231	0.9610389
C3	7045559	7047574	BolC3t13925H	0	-	1601	1970	2015	0.9776675
C3	7047989	7051665	BolC3t13926H	0	+	1393	3355	3676	0.9126768
C3	7064698	7068967	BolC3t13927H	0	+	2339	3576	4269	0.8376669
C3	7073278	7073656	BolC3t13928H	0	+	189	378	378	1.0000000
C3	7073693	7074397	BolC3t13929H	0	+	41	550	704	0.7812500
C3	7075762	7077843	BolC3t13930H	0	+	368	1317	2081	0.6328688
C3	7079128	7080185	BolC3t13931H	0	-	418	932	1057	0.8817407
C3	7081447	7083044	BolC3t13932H	0	-	46	699	1597	0.4376957
C3	7091839	7095616	BolC3t13933H	0	-	267	2367	3777	0.6266878
C3	7099921	7103987	BolC3t13934H	0	+	2467	4066	4066	1.0000000
C3	7104702	7105933	BolC3t13935H	0	+	265	846	1231	0.6872461
C3	7109491	7109944	BolC3t13936H	0	-	22	211	453	0.4657837
C3	7124563	7126019	BolC3t13937H	0	+	404	1220	1456	0.8379121
C3	7128412	7128559	BolC3t13938H	0	+	15	147	147	1.0000000
C3	7130049	7131668	BolC3t13939H	0	+	296	1488	1619	0.9190859
C3	7133995	7135924	BolC3t13940H	0	-	220	1790	1929	0.9279419
C3	7140523	7141426	BolC3t13941H	0	+	161	775	903	0.8582503
C3	7142689	7145168	BolC3t13942H	0	+	1248	2245	2479	0.9056071
C3	7148998	7149229	BolC3t13943H	0	+	158	231	231	1.0000000
C3	7151592	7154017	BolC3t13944H	0	+	1194	2203	2425	0.9084536
C3	7154682	7156945	BolC3t13945H	0	-	798	2156	2263	0.9527176
C3	7157728	7162440	BolC3t13946H	0	-	1902	4398	4712	0.9333616
C3	7164050	7165787	BolC3t13947H	0	+	786	1737	1737	1.0000000
C3	7166214	7166838	BolC3t13948H	0	+	422	624	624	1.0000000
C3	7167393	7169159	BolC3t13949H	0	-	1641	1766	1766	1.0000000
C3	7170895	7172698	BolC3t13950H	0	+	834	1784	1803	0.9894620
C3	7174144	7176010	BolC3t13951H	0	+	296	1719	1866	0.9212219
C3	7177352	7186848	BolC3t13952H	0	-	5074	8501	9496	0.8952190
C3	7192533	7192686	BolC3t13953H	0	-	0	0	153	0.0000000
C3	7198288	7200550	BolC3t13954H	0	-	757	2011	2262	0.8890362
C3	7217440	7217644	BolC3t13955H	0	+	259	204	204	1.0000000
C3	7221971	7223800	BolC3t13956H	0	+	856	1829	1829	1.0000000
C3	7229608	7233408	BolC3t13957H	0	-	1153	3323	3800	0.8744737
C3	7238379	7239261	BolC3t13958H	0	+	384	882	882	1.0000000
C3	7239652	7243059	BolC3t13959H	0	-	743	2366	3407	0.6944526
C3	7247297	7247552	BolC3t13960H	0	+	185	255	255	1.0000000
C3	7247863	7249453	BolC3t13961H	0	+	1260	1590	1590	1.0000000
C3	7250036	7252695	BolC3t13962H	0	-	1420	2649	2659	0.9962392
C3	7254351	7256947	BolC3t13963H	0	-	1115	2559	2596	0.9857473
C3	7258804	7259575	BolC3t13964H	0	+	167	716	771	0.9286641
C3	7266335	7267024	BolC3t13965H	0	+	0	0	689	0.0000000
C3	7269926	7270845	BolC3t13966H	0	-	735	919	919	1.0000000
C3	7277168	7279556	BolC3t13967H	0	+	1870	2388	2388	1.0000000
C3	7279962	7281114	BolC3t13968H	0	-	857	1152	1152	1.0000000
C3	7283087	7283422	BolC3t13969H	0	+	323	335	335	1.0000000
C3	7288976	7294593	BolC3t13970H	0	-	1750	4017	5617	0.7151504
C3	7291031	7291961	BolC3t13971H	0	-	102	760	930	0.8172043
C3	7296847	7297510	BolC3t13972H	0	-	394	663	663	1.0000000
C3	7299900	7301014	BolC3t13973H	0	-	832	1114	1114	1.0000000
C3	7304332	7304812	BolC3t13974H	0	+	163	480	480	1.0000000
C3	7310050	7314242	BolC3t13975H	0	-	1396	4042	4192	0.9642175
C3	7333492	7335147	BolC3t13976H	0	+	229	1292	1655	0.7806646
C3	7336903	7339203	BolC3t13977H	0	+	1612	2300	2300	1.0000000
C3	7341737	7350131	BolC3t13978H	0	-	1131	4231	8394	0.5040505
C3	7351509	7352196	BolC3t13979H	0	-	194	534	687	0.7772925
C3	7356500	7357450	BolC3t13980H	0	+	2	195	950	0.2052632
C3	7369716	7370625	BolC3t13981H	0	-	764	909	909	1.0000000
C3	7379124	7380121	BolC3t13982H	0	-	829	997	997	1.0000000
C3	7391260	7391458	BolC3t13983H	0	-	236	198	198	1.0000000
C3	7391577	7392013	BolC3t13984H	0	-	453	436	436	1.0000000
C3	7395749	7396960	BolC3t13985H	0	+	373	1145	1211	0.9454996
C3	7397871	7400535	BolC3t13986H	0	-	1119	2605	2664	0.9778529
C3	7401621	7404106	BolC3t13987H	0	+	656	2445	2485	0.9839034
C3	7404724	7405659	BolC3t13988H	0	+	631	935	935	1.0000000
C3	7406593	7409229	BolC3t13989H	0	-	1411	2636	2636	1.0000000
C3	7410080	7414939	BolC3t13990H	0	+	1753	3776	4859	0.7771146
C3	7415274	7417724	BolC3t13991H	0	-	2387	2450	2450	1.0000000
C3	7419871	7422219	BolC3t13992H	0	-	808	1896	2348	0.8074957
C3	7425986	7426711	BolC3t13993H	0	+	107	710	725	0.9793103
C3	7427088	7429019	BolC3t13994H	0	+	466	1826	1931	0.9456241
C3	7429516	7431672	BolC3t13995H	0	-	836	1399	2156	0.6488868
C3	7434581	7435227	BolC3t13996H	0	+	11	228	646	0.3529412
C3	7437641	7437914	BolC3t13997H	0	-	94	273	273	1.0000000
C3	7460593	7460970	BolC3t13998H	0	+	10	264	377	0.7002652
C3	7497023	7499100	BolC3t13999H	0	-	1366	1912	2077	0.9205585
C3	7512842	7515511	BolC3t14000H	0	-	1261	2641	2669	0.9895092
C3	7516265	7516601	BolC3t14001H	0	+	156	336	336	1.0000000
C3	7516942	7517573	BolC3t14002H	0	+	28	584	631	0.9255151
C3	7518689	7521088	BolC3t14003H	0	-	292	2069	2399	0.8624427
C3	7522024	7523356	BolC3t14004H	0	+	266	1311	1332	0.9842342
C3	7526955	7528395	BolC3t14005H	0	+	110	500	1440	0.3472222
C3	7528544	7528838	BolC3t14006H	0	-	76	294	294	1.0000000
C3	7530039	7551454	BolC3t14007H	0	+	4435	10694	21415	0.4993696
C3	7552254	7552578	BolC3t14008H	0	+	193	319	324	0.9845679
C3	7553672	7555664	BolC3t14009H	0	+	865	1816	1992	0.9116466
C3	7565775	7567508	BolC3t14010H	0	-	828	1480	1733	0.8540104
C3	7575046	7579027	BolC3t14011H	0	+	3000	3981	3981	1.0000000
C3	7580490	7583059	BolC3t14012H	0	+	1765	2569	2569	1.0000000
C3	7584275	7594871	BolC3t14013H	0	-	7981	10272	10596	0.9694224
C3	7595485	7595916	BolC3t14014H	0	-	104	361	431	0.8375870
C3	7599700	7601400	BolC3t14015H	0	-	225	1311	1700	0.7711765
C3	7602131	7604504	BolC3t14016H	0	-	1670	2373	2373	1.0000000
C3	7605125	7606775	BolC3t14017H	0	-	738	1572	1650	0.9527273
C3	7608651	7610835	BolC3t14018H	0	-	1676	1998	2184	0.9148352
C3	7619904	7624719	BolC3t14019H	0	-	2601	4784	4815	0.9935618
C3	7627887	7628831	BolC3t14020H	0	+	252	944	944	1.0000000
C3	7630875	7631418	BolC3t14021H	0	+	9	129	543	0.2375691
C3	7635191	7635923	BolC3t14022H	0	-	0	0	732	0.0000000
C3	7642884	7644995	BolC3t14023H	0	-	640	2105	2111	0.9971578
C3	7651502	7652039	BolC3t14024H	0	+	20	537	537	1.0000000
C3	7652326	7652883	BolC3t14025H	0	-	563	557	557	1.0000000
C3	7661266	7664036	BolC3t14026H	0	+	1676	2605	2770	0.9404332
C3	7671295	7674354	BolC3t14027H	0	+	2004	3040	3059	0.9937888
C3	7677044	7678244	BolC3t14028H	0	-	496	1196	1200	0.9966667
C3	7687301	7700024	BolC3t14029H	0	-	2801	7033	12723	0.5527784
C3	7687875	7688624	BolC3t14030H	0	-	76	391	749	0.5220294
C3	7689821	7694811	BolC3t14031H	0	-	15	277	4990	0.0555110
C3	7698913	7699282	BolC3t14032H	0	-	51	323	369	0.8753387
C3	7700955	7703567	BolC3t14033H	0	-	274	1477	2612	0.5654671
C3	7704913	7706605	BolC3t14034H	0	-	1411	1692	1692	1.0000000
C3	7707669	7710086	BolC3t14035H	0	-	1769	2417	2417	1.0000000
C3	7717461	7719794	BolC3t14036H	0	+	495	2315	2333	0.9922846
C3	7720776	7722079	BolC3t14037H	0	-	666	1303	1303	1.0000000
C3	7727397	7728734	BolC3t14038H	0	-	224	1277	1337	0.9551234
C3	7749175	7749463	BolC3t14039H	0	+	6	251	288	0.8715278
C3	7752090	7753363	BolC3t14040H	0	+	973	1259	1273	0.9890023
C3	7754604	7756794	BolC3t14041H	0	-	1611	2190	2190	1.0000000
C3	7763770	7764169	BolC3t14042H	0	+	312	399	399	1.0000000
C3	7767139	7769192	BolC3t14043H	0	+	538	1683	2053	0.8197759
C3	7769526	7771530	BolC3t14044H	0	-	987	1976	2004	0.9860280
C3	7774002	7774335	BolC3t14045H	0	-	303	333	333	1.0000000
C3	7776538	7784177	BolC3t14046H	0	-	1951	6352	7639	0.8315225
C3	7784458	7786224	BolC3t14047H	0	+	1048	1619	1766	0.9167610
C3	7786549	7787082	BolC3t14048H	0	-	291	533	533	1.0000000
C3	7788179	7791200	BolC3t14049H	0	-	1178	2811	3021	0.9304866
C3	7795753	7795897	BolC3t14050H	0	+	131	144	144	1.0000000
C3	7799890	7800466	BolC3t14051H	0	+	316	576	576	1.0000000
C3	7802421	7802829	BolC3t14052H	0	+	296	408	408	1.0000000
C3	7804323	7804968	BolC3t14053H	0	+	195	645	645	1.0000000
C3	7805198	7807916	BolC3t14054H	0	-	329	1814	2718	0.6674025
C3	7812746	7813571	BolC3t14055H	0	+	119	553	825	0.6703030
C3	7814408	7816364	BolC3t14056H	0	+	660	1696	1956	0.8670757
C3	7817727	7818888	BolC3t14057H	0	-	46	709	1161	0.6106805
C3	7820994	7821297	BolC3t14058H	0	-	61	294	303	0.9702970
C3	7825332	7827808	BolC3t14059H	0	+	971	2422	2476	0.9781906
C3	7828687	7830683	BolC3t14060H	0	-	863	1783	1996	0.8932866
C3	7831551	7833597	BolC3t14061H	0	-	1309	2046	2046	1.0000000
C3	7841292	7842288	BolC3t14062H	0	+	210	936	996	0.9397590
C3	7844993	7845655	BolC3t14063H	0	+	426	662	662	1.0000000
C3	7857965	7859156	BolC3t14064H	0	-	142	1006	1191	0.8446683
C3	7861645	7863279	BolC3t14065H	0	+	296	1572	1634	0.9620563
C3	7864360	7866254	BolC3t14066H	0	-	586	1838	1894	0.9704329
C3	7867491	7869488	BolC3t14067H	0	+	573	1844	1997	0.9233851
C3	7869983	7881131	BolC3t14068H	0	-	7329	11120	11148	0.9974883
C3	7892098	7892398	BolC3t14069H	0	-	0	0	300	0.0000000
C3	7893108	7893540	BolC3t14070H	0	-	66	432	432	1.0000000
C3	7896791	7906737	BolC3t14071H	0	+	1144	3642	9946	0.3661774
C3	7909938	7910958	BolC3t14072H	0	+	63	569	1020	0.5578431
C3	7916594	7917602	BolC3t14073H	0	+	1384	1008	1008	1.0000000
C3	7919241	7920300	BolC3t14074H	0	+	150	980	1059	0.9254013
C3	7924304	7925314	BolC3t14075H	0	-	213	991	1010	0.9811881
C3	7928212	7933037	BolC3t14076H	0	-	2038	4636	4825	0.9608290
C3	7933340	7933989	BolC3t14077H	0	+	234	649	649	1.0000000
C3	7934429	7934663	BolC3t14078H	0	-	143	225	234	0.9615384
C3	7934837	7935836	BolC3t14079H	0	-	351	701	999	0.7017017
C3	7936561	7938149	BolC3t14080H	0	-	125	1459	1588	0.9187657
C3	7941590	7942691	BolC3t14081H	0	+	511	1101	1101	1.0000000
C3	7943790	7944036	BolC3t14082H	0	-	2	23	246	0.0934959
C3	7948590	7949079	BolC3t14083H	0	-	212	467	489	0.9550102
C3	7956525	7957166	BolC3t14084H	0	-	273	434	641	0.6770671
C3	7967555	7967918	BolC3t14085H	0	-	3	46	363	0.1267218
C3	7970325	7973507	BolC3t14086H	0	-	679	3016	3182	0.9478316
C3	7974430	7978441	BolC3t14087H	0	-	856	3119	4011	0.7776116
C3	7997453	7999166	BolC3t14088H	0	-	37	799	1713	0.4664332
C3	8002140	8005156	BolC3t14089H	0	-	397	2226	3016	0.7380636
C3	8009725	8011705	BolC3t14090H	0	-	759	1904	1980	0.9616162
C3	8032215	8034270	BolC3t14091H	0	+	859	1978	2055	0.9625304
C3	8035506	8037761	BolC3t14092H	0	-	626	2127	2255	0.9432372
C3	8042304	8043054	BolC3t14093H	0	-	53	610	750	0.8133333
C3	8045511	8046006	BolC3t14094H	0	-	433	495	495	1.0000000
C3	8052658	8053200	BolC3t14095H	0	+	131	451	542	0.8321033
C3	8055871	8056701	BolC3t14096H	0	+	193	622	830	0.7493976
C3	8067458	8069777	BolC3t14097H	0	-	743	2319	2319	1.0000000
C3	8085902	8087863	BolC3t14098H	0	-	301	1856	1961	0.9464559
C3	8089253	8092223	BolC3t14099H	0	+	1833	2827	2970	0.9518518
C3	8092954	8094749	BolC3t14100H	0	-	781	1795	1795	1.0000000
C3	8097454	8100442	BolC3t14101H	0	+	268	1708	2988	0.5716198
C3	8102489	8104297	BolC3t14102H	0	+	36	370	1808	0.2046460
C3	8110765	8111052	BolC3t14103H	0	+	1	47	287	0.1637631
C3	8115263	8116841	BolC3t14104H	0	-	273	1235	1578	0.7826362
C3	8122413	8122539	BolC3t14105H	0	+	148	126	126	1.0000000
C3	8123345	8124842	BolC3t14106H	0	-	1233	1497	1497	1.0000000
C3	8126448	8127180	BolC3t14107H	0	-	600	732	732	1.0000000
C3	8134572	8137465	BolC3t14108H	0	+	845	2701	2893	0.9336329
C3	8138046	8138773	BolC3t14109H	0	-	36	488	727	0.6712517
C3	8142181	8155559	BolC3t14110H	0	+	5687	6660	13378	0.4978323
C3	8156233	8156667	BolC3t14111H	0	-	250	434	434	1.0000000
C3	8157803	8158139	BolC3t14112H	0	-	345	336	336	1.0000000
C3	8158460	8160142	BolC3t14113H	0	-	1641	1682	1682	1.0000000
C3	8165889	8166465	BolC3t14114H	0	-	663	576	576	1.0000000
C3	8170373	8171474	BolC3t14115H	0	-	1417	1101	1101	1.0000000
C3	8172410	8173901	BolC3t14116H	0	+	698	1491	1491	1.0000000
C3	8183641	8183953	BolC3t14117H	0	+	28	284	312	0.9102564
C3	8187313	8188389	BolC3t14118H	0	+	35	739	1076	0.6868030
C3	8188746	8189350	BolC3t14119H	0	+	55	150	604	0.2483444
C3	8189514	8189664	BolC3t14120H	0	-	90	150	150	1.0000000
C3	8189710	8189946	BolC3t14121H	0	+	139	236	236	1.0000000
C3	8201097	8203199	BolC3t14122H	0	+	266	1670	2102	0.7944815
C3	8207458	8210054	BolC3t14123H	0	+	53	1017	2596	0.3917565
C3	8211793	8212484	BolC3t14124H	0	-	629	691	691	1.0000000
C3	8212661	8214093	BolC3t14125H	0	-	825	1432	1432	1.0000000
C3	8218229	8218568	BolC3t14126H	0	-	321	339	339	1.0000000
C3	8222828	8223220	BolC3t14127H	0	+	791	392	392	1.0000000
C3	8233157	8234177	BolC3t14128H	0	+	390	992	1020	0.9725490
C3	8235761	8238263	BolC3t14129H	0	+	1368	2502	2502	1.0000000
C3	8239796	8240989	BolC3t14130H	0	-	327	1138	1193	0.9538977
C3	8252473	8253946	BolC3t14131H	0	-	266	1303	1473	0.8845893
C3	8255805	8259195	BolC3t14132H	0	+	2374	3300	3390	0.9734513
C3	8261751	8264430	BolC3t14133H	0	+	260	1402	2679	0.5233296
C3	8265713	8268615	BolC3t14134H	0	-	1451	2902	2902	1.0000000
C3	8287357	8289018	BolC3t14135H	0	+	320	1551	1661	0.9337748
C3	8290913	8291295	BolC3t14136H	0	-	174	382	382	1.0000000
C3	8294564	8295128	BolC3t14137H	0	-	218	564	564	1.0000000
C3	8314367	8315357	BolC3t14138H	0	+	437	990	990	1.0000000
C3	8322392	8328779	BolC3t14139H	0	+	1234	5743	6387	0.8991702
C3	8328902	8329157	BolC3t14140H	0	-	58	255	255	1.0000000
C3	8330052	8333079	BolC3t14141H	0	-	453	1591	3027	0.5256029
C3	8340753	8341544	BolC3t14142H	0	+	318	780	791	0.9860936
C3	8342681	8344946	BolC3t14143H	0	+	1340	2253	2265	0.9947020
C3	8345544	8345815	BolC3t14144H	0	+	277	271	271	1.0000000
C3	8346839	8347142	BolC3t14145H	0	+	0	0	303	0.0000000
C3	8349636	8350020	BolC3t14146H	0	+	11	196	384	0.5104167
C3	8351349	8352116	BolC3t14147H	0	-	476	767	767	1.0000000
C3	8356500	8357844	BolC3t14148H	0	+	242	1267	1344	0.9427083
C3	8375750	8377094	BolC3t14149H	0	+	160	1318	1344	0.9806548
C3	8385079	8385441	BolC3t14150H	0	+	143	309	362	0.8535911
C3	8402305	8403649	BolC3t14151H	0	+	20	450	1344	0.3348214
C3	8405268	8405972	BolC3t14152H	0	-	72	702	704	0.9971591
C3	8406293	8407215	BolC3t14153H	0	-	170	533	922	0.5780911
C3	8407506	8408619	BolC3t14154H	0	+	44	880	1113	0.7906559
C3	8409488	8409809	BolC3t14155H	0	+	27	212	321	0.6604362
C3	8416558	8416957	BolC3t14156H	0	-	6	184	399	0.4611529
C3	8416957	8417475	BolC3t14157H	0	-	8	140	518	0.2702703
C3	8419466	8420267	BolC3t14158H	0	-	98	326	801	0.4069913
C3	8422209	8423553	BolC3t14159H	0	+	11	461	1344	0.3430060
C3	8424981	8425769	BolC3t14160H	0	-	995	788	788	1.0000000
C3	8438649	8439132	BolC3t14161H	0	-	633	483	483	1.0000000
C3	8444657	8445424	BolC3t14162H	0	+	537	767	767	1.0000000
C3	8452105	8453406	BolC3t14163H	0	-	230	1077	1301	0.8278248
C3	8459727	8460342	BolC3t14164H	0	-	134	588	615	0.9560975
C3	8461160	8462184	BolC3t14165H	0	-	947	1024	1024	1.0000000
C3	8462608	8465570	BolC3t14166H	0	+	1097	2427	2962	0.8193788
C3	8469540	8470360	BolC3t14167H	0	+	0	0	820	0.0000000
C3	8470308	8470674	BolC3t14168H	0	+	38	185	366	0.5054645
C3	8470897	8472411	BolC3t14169H	0	-	25	398	1514	0.2628798
C3	8477983	8479677	BolC3t14170H	0	-	68	748	1694	0.4415585
C3	8484483	8484840	BolC3t14171H	0	-	3	147	357	0.4117647
C3	8492125	8492906	BolC3t14172H	0	-	313	731	781	0.9359795
C3	8495517	8497163	BolC3t14173H	0	+	671	1495	1646	0.9082624
C3	8497894	8501257	BolC3t14174H	0	-	1230	2594	3363	0.7713351
C3	8507006	8514800	BolC3t14175H	0	-	2153	6434	7794	0.8255068
C3	8527815	8530341	BolC3t14176H	0	+	1475	2274	2526	0.9002375
C3	8531884	8540772	BolC3t14177H	0	-	2011	8098	8888	0.9111161
C3	8557093	8557312	BolC3t14178H	0	-	119	219	219	1.0000000
C3	8567892	8571811	BolC3t14179H	0	+	1959	3554	3919	0.9068640
C3	8591919	8594332	BolC3t14180H	0	+	661	2343	2413	0.9709905
C3	8594576	8597818	BolC3t14181H	0	-	1325	3158	3242	0.9740900
C3	8598862	8600542	BolC3t14182H	0	-	584	1642	1680	0.9773809
C3	8604769	8606730	BolC3t14183H	0	+	423	1795	1961	0.9153493
C3	8608318	8609360	BolC3t14184H	0	+	652	1042	1042	1.0000000
C3	8640444	8641482	BolC3t14185H	0	+	4	263	1038	0.2533719
C3	8659096	8659997	BolC3t14186H	0	+	360	762	901	0.8457270
C3	8661482	8663498	BolC3t14187H	0	-	1168	1840	2016	0.9126984
C3	8664978	8665470	BolC3t14188H	0	-	427	492	492	1.0000000
C3	8670559	8671476	BolC3t14189H	0	+	260	567	917	0.6183206
C3	8673623	8674623	BolC3t14190H	0	-	757	1000	1000	1.0000000
C3	8675920	8676166	BolC3t14191H	0	+	59	177	246	0.7195122
C3	8677353	8677651	BolC3t14192H	0	-	158	298	298	1.0000000
C3	8678261	8679790	BolC3t14193H	0	-	1295	1529	1529	1.0000000
C3	8693859	8695885	BolC3t14194H	0	+	477	1407	2026	0.6944718
C3	8716715	8717793	BolC3t14195H	0	-	123	885	1078	0.8209648
C3	8738552	8741489	BolC3t14196H	0	+	964	2891	2937	0.9843377
C3	8741834	8742350	BolC3t14197H	0	+	202	516	516	1.0000000
C3	8752907	8754196	BolC3t14198H	0	+	747	1281	1289	0.9937937
C3	8755389	8756936	BolC3t14199H	0	-	1101	1546	1547	0.9993536
C3	8766916	8767863	BolC3t14200H	0	-	128	243	947	0.2565998
C3	8769420	8769645	BolC3t14201H	0	-	0	0	225	0.0000000
C3	8772566	8773591	BolC3t14202H	0	+	13	513	1025	0.5004878
C3	8776210	8783300	BolC3t14203H	0	-	1919	5547	7090	0.7823696
C3	8784641	8785658	BolC3t14204H	0	+	407	486	1017	0.4778761
C3	8786652	8793367	BolC3t14205H	0	-	3102	5934	6715	0.8836932
C3	8796225	8798935	BolC3t14206H	0	+	1612	2710	2710	1.0000000
C3	8799973	8800820	BolC3t14207H	0	+	682	847	847	1.0000000
C3	8802103	8802421	BolC3t14208H	0	+	231	318	318	1.0000000
C3	8802960	8811239	BolC3t14209H	0	+	6026	8116	8279	0.9803116
C3	8813252	8820097	BolC3t14210H	0	-	5618	6845	6845	1.0000000
C3	8832072	8832795	BolC3t14211H	0	+	129	723	723	1.0000000
C3	8855033	8855556	BolC3t14212H	0	+	387	523	523	1.0000000
C3	8860288	8861639	BolC3t14213H	0	-	151	773	1351	0.5721688
C3	8877136	8880998	BolC3t14214H	0	+	1013	3590	3862	0.9295702
C3	8883565	8885518	BolC3t14215H	0	-	1756	1662	1953	0.8509985
C3	8890124	8891151	BolC3t14216H	0	+	289	1027	1027	1.0000000
C3	8908619	8910489	BolC3t14217H	0	-	1451	1870	1870	1.0000000
C3	8912070	8912552	BolC3t14218H	0	-	0	0	482	0.0000000
C3	8923094	8924581	BolC3t14219H	0	+	434	1487	1487	1.0000000
C3	8926069	8926551	BolC3t14220H	0	-	2	268	482	0.5560166
C3	8930606	8933334	BolC3t14221H	0	-	690	2261	2728	0.8288123
C3	8938133	8940395	BolC3t14222H	0	+	670	1954	2262	0.8638373
C3	8942634	8943944	BolC3t14223H	0	+	617	1310	1310	1.0000000
C3	8944725	8945064	BolC3t14224H	0	-	127	339	339	1.0000000
C3	8946837	8947510	BolC3t14225H	0	+	218	628	673	0.9331352
C3	8947710	8949453	BolC3t14226H	0	-	149	660	1743	0.3786575
C3	8949659	8950019	BolC3t14227H	0	-	251	360	360	1.0000000
C3	8953630	8953804	BolC3t14228H	0	-	175	174	174	1.0000000
C3	8964114	8965527	BolC3t14229H	0	-	920	1413	1413	1.0000000
C3	8967413	8969994	BolC3t14230H	0	-	206	1618	2581	0.6268888
C3	8978191	8978566	BolC3t14231H	0	+	338	375	375	1.0000000
C3	8979218	8982433	BolC3t14232H	0	+	1497	2737	3215	0.8513219
C3	8985922	8987420	BolC3t14233H	0	+	448	1229	1498	0.8204272
C3	8989532	8991865	BolC3t14234H	0	-	315	2034	2333	0.8718388
C3	8994946	8996311	BolC3t14235H	0	+	2697	1365	1365	1.0000000
C3	8998614	9000421	BolC3t14236H	0	-	2352	1807	1807	1.0000000
C3	9003583	9005006	BolC3t14237H	0	+	2060	1423	1423	1.0000000
C3	9009104	9015039	BolC3t14238H	0	+	1238	5053	5935	0.8513901
C3	9016731	9017691	BolC3t14239H	0	+	55	929	960	0.9677083
C3	9018092	9019172	BolC3t14240H	0	-	124	828	1080	0.7666667
C3	9023286	9024357	BolC3t14241H	0	-	345	1026	1071	0.9579832
C3	9025935	9027550	BolC3t14242H	0	-	972	1357	1615	0.8402477
C3	9028482	9029196	BolC3t14243H	0	+	510	714	714	1.0000000
C3	9029509	9030124	BolC3t14244H	0	+	272	608	615	0.9886179
C3	9030519	9030813	BolC3t14245H	0	-	31	144	294	0.4897959
C3	9043214	9046920	BolC3t14246H	0	+	589	2793	3706	0.7536427
C3	9047533	9048779	BolC3t14247H	0	+	948	1246	1246	1.0000000
C3	9054684	9057264	BolC3t14248H	0	-	1571	2580	2580	1.0000000
C3	9074941	9076701	BolC3t14249H	0	-	123	1014	1760	0.5761364
C3	9085949	9086913	BolC3t14250H	0	-	929	964	964	1.0000000
C3	9087116	9090267	BolC3t14251H	0	-	1812	3151	3151	1.0000000
C3	9093625	9097489	BolC3t14252H	0	-	3473	3628	3864	0.9389234
C3	9105362	9106718	BolC3t14253H	0	+	194	1273	1356	0.9387906
C3	9113219	9114080	BolC3t14254H	0	+	513	634	861	0.7363531
C3	9114853	9116193	BolC3t14255H	0	+	909	1220	1340	0.9104478
C3	9122065	9122635	BolC3t14256H	0	+	497	570	570	1.0000000
C3	9125165	9126698	BolC3t14257H	0	-	744	1472	1533	0.9602087
C3	9130644	9131539	BolC3t14258H	0	+	13	483	895	0.5396648
C3	9134448	9135827	BolC3t14259H	0	+	32	480	1379	0.3480783
C3	9140367	9141426	BolC3t14260H	0	+	30	779	1059	0.7355996
C3	9148882	9149074	BolC3t14261H	0	-	0	0	192	0.0000000
C3	9151183	9153219	BolC3t14262H	0	-	1200	1942	2036	0.9538310
C3	9167549	9168212	BolC3t14263H	0	+	90	507	663	0.7647059
C3	9168917	9170078	BolC3t14264H	0	+	333	962	1161	0.8285961
C3	9171007	9173315	BolC3t14265H	0	+	1319	2268	2308	0.9826690
C3	9173510	9174061	BolC3t14266H	0	-	302	551	551	1.0000000
C3	9174645	9177438	BolC3t14267H	0	+	1349	2708	2793	0.9695668
C3	9178174	9180280	BolC3t14268H	0	-	975	2022	2106	0.9601139
C3	9183572	9186951	BolC3t14269H	0	-	2428	3353	3379	0.9923054
C3	9186989	9187170	BolC3t14270H	0	-	290	181	181	1.0000000
C3	9189031	9190670	BolC3t14271H	0	+	960	1356	1639	0.8273337
C3	9201590	9205582	BolC3t14272H	0	+	915	3483	3992	0.8724950
C3	9211305	9213504	BolC3t14273H	0	+	554	1847	2199	0.8399273
C3	9215779	9217400	BolC3t14274H	0	-	1673	1596	1621	0.9845774
C3	9217943	9219473	BolC3t14275H	0	-	902	1530	1530	1.0000000
C3	9222277	9222701	BolC3t14276H	0	+	115	424	424	1.0000000
C3	9229370	9231194	BolC3t14277H	0	-	796	1819	1824	0.9972588
C3	9234665	9236859	BolC3t14278H	0	-	468	1934	2194	0.8814950
C3	9242053	9242530	BolC3t14279H	0	-	81	477	477	1.0000000
C3	9255178	9255694	BolC3t14280H	0	+	330	516	516	1.0000000
C3	9255890	9256193	BolC3t14281H	0	+	172	303	303	1.0000000
C3	9256769	9265732	BolC3t14282H	0	-	1239	4829	8963	0.5387705
C3	9271325	9273120	BolC3t14283H	0	+	989	1655	1795	0.9220056
C3	9275627	9276290	BolC3t14284H	0	-	265	663	663	1.0000000
C3	9278074	9279493	BolC3t14285H	0	-	573	1285	1419	0.9055673
C3	9280291	9281037	BolC3t14286H	0	-	138	746	746	1.0000000
C3	9282563	9283454	BolC3t14287H	0	-	378	891	891	1.0000000
C3	9284433	9288054	BolC3t14288H	0	-	2293	3621	3621	1.0000000
C3	9289733	9291660	BolC3t14289H	0	+	997	1927	1927	1.0000000
C3	9291955	9294348	BolC3t14290H	0	-	1499	2393	2393	1.0000000
C3	9299668	9300001	BolC3t14291H	0	+	125	332	333	0.9969970
C3	9301783	9304013	BolC3t14292H	0	-	1172	2208	2230	0.9901345
C3	9306807	9308169	BolC3t14293H	0	+	5	196	1362	0.1439060
C3	9311983	9312348	BolC3t14294H	0	-	201	365	365	1.0000000
C3	9317660	9318332	BolC3t14295H	0	-	485	672	672	1.0000000
C3	9318869	9320397	BolC3t14296H	0	+	190	1336	1528	0.8743455
C3	9322058	9323621	BolC3t14297H	0	-	217	1384	1563	0.8854766
C3	9329312	9331625	BolC3t14298H	0	+	98	527	2313	0.2278426
C3	9333254	9336624	BolC3t14299H	0	+	823	3107	3370	0.9219584
C3	9341478	9358807	BolC3t14300H	0	-	1277	9371	17329	0.5407698
C3	9351178	9351986	BolC3t14301H	0	+	85	291	808	0.3601485
C3	9372885	9373239	BolC3t14302H	0	-	218	354	354	1.0000000
C3	9375829	9377206	BolC3t14303H	0	-	628	1340	1377	0.9731300
C3	9377616	9379995	BolC3t14304H	0	-	843	2320	2379	0.9751996
C3	9381033	9383518	BolC3t14305H	0	+	1233	2260	2485	0.9094567
C3	9383885	9385923	BolC3t14306H	0	-	1109	2038	2038	1.0000000
C3	9386725	9390694	BolC3t14307H	0	-	1829	3899	3969	0.9823633
C3	9391033	9392433	BolC3t14308H	0	+	689	1400	1400	1.0000000
C3	9400605	9400965	BolC3t14309H	0	+	30	217	360	0.6027778
C3	9413804	9415594	BolC3t14310H	0	+	610	1751	1790	0.9782123
C3	9415723	9417934	BolC3t14311H	0	-	1218	2211	2211	1.0000000
C3	9422346	9426790	BolC3t14312H	0	-	1055	4061	4444	0.9138164
C3	9430925	9435756	BolC3t14313H	0	+	1664	3912	4831	0.8097702
C3	9470294	9471679	BolC3t14314H	0	+	396	881	1385	0.6361011
C3	9478249	9481272	BolC3t14315H	0	-	839	2735	3023	0.9047304
C3	9481531	9489637	BolC3t14316H	0	+	3068	5332	8106	0.6577843
C3	9490013	9490777	BolC3t14317H	0	-	825	764	764	1.0000000
C3	9491901	9494361	BolC3t14318H	0	-	1983	2460	2460	1.0000000
C3	9502980	9503755	BolC3t14319H	0	+	799	746	775	0.9625806
C3	9504895	9505814	BolC3t14320H	0	-	870	919	919	1.0000000
C3	9508546	9512128	BolC3t14321H	0	+	1010	3058	3582	0.8537130
C3	9513033	9514875	BolC3t14322H	0	+	614	1759	1842	0.9549403
C3	9515355	9515891	BolC3t14323H	0	+	39	430	536	0.8022388
C3	9521960	9523488	BolC3t14324H	0	+	717	1409	1528	0.9221204
C3	9526585	9527596	BolC3t14325H	0	+	181	983	1011	0.9723046
C3	9545672	9547337	BolC3t14326H	0	+	217	1464	1665	0.8792793
C3	9549214	9550614	BolC3t14327H	0	+	575	1336	1400	0.9542857
C3	9553173	9555693	BolC3t14328H	0	+	928	2374	2520	0.9420635
C3	9556431	9559219	BolC3t14329H	0	-	1532	2777	2788	0.9960545
C3	9560124	9562681	BolC3t14330H	0	-	1316	2508	2557	0.9808369
C3	9569487	9570766	BolC3t14331H	0	-	33	680	1279	0.5316654
C3	9571635	9572035	BolC3t14332H	0	+	141	400	400	1.0000000
C3	9579171	9580495	BolC3t14333H	0	+	16	590	1324	0.4456193
C3	9581416	9585418	BolC3t14334H	0	-	1552	3506	4002	0.8760620
C3	9592033	9592558	BolC3t14335H	0	-	97	479	525	0.9123809
C3	9602403	9602583	BolC3t14336H	0	-	236	180	180	1.0000000
C3	9611624	9613455	BolC3t14337H	0	+	666	1453	1831	0.7935554
C3	9615106	9615790	BolC3t14338H	0	+	534	684	684	1.0000000
C3	9615979	9616668	BolC3t14339H	0	+	77	569	689	0.8258346
C3	9617928	9619093	BolC3t14340H	0	-	537	1165	1165	1.0000000
C3	9623602	9624935	BolC3t14341H	0	+	264	1095	1333	0.8214554
C3	9627858	9628317	BolC3t14342H	0	-	15	124	459	0.2701525
C3	9631182	9637154	BolC3t14343H	0	-	2581	5904	5972	0.9886135
C3	9647735	9650490	BolC3t14344H	0	-	719	2478	2755	0.8994555
C3	9651274	9651607	BolC3t14345H	0	-	90	333	333	1.0000000
C3	9664341	9664857	BolC3t14346H	0	+	203	516	516	1.0000000
C3	9683393	9685592	BolC3t14347H	0	+	883	1972	2199	0.8967713
C3	9691068	9692313	BolC3t14348H	0	+	289	1062	1245	0.8530120
C3	9700023	9701343	BolC3t14349H	0	+	193	1163	1320	0.8810606
C3	9712185	9713091	BolC3t14350H	0	+	251	740	906	0.8167771
C3	9714382	9715999	BolC3t14351H	0	+	660	1617	1617	1.0000000
C3	9724549	9728310	BolC3t14352H	0	+	903	3396	3761	0.9029514
C3	9729609	9730005	BolC3t14353H	0	+	20	369	396	0.9318182
C3	9732136	9732286	BolC3t14354H	0	-	20	150	150	1.0000000
C3	9735561	9736608	BolC3t14355H	0	+	110	555	1047	0.5300860
C3	9740303	9740732	BolC3t14356H	0	+	312	429	429	1.0000000
C3	9741553	9745929	BolC3t14357H	0	-	1417	4000	4376	0.9140768
C3	9757468	9758281	BolC3t14358H	0	+	3	31	813	0.0381304
C3	9761872	9764719	BolC3t14359H	0	+	1782	2847	2847	1.0000000
C3	9766149	9766505	BolC3t14360H	0	-	467	356	356	1.0000000
C3	9778319	9779315	BolC3t14361H	0	+	208	708	996	0.7108434
C3	9779513	9780401	BolC3t14362H	0	-	510	888	888	1.0000000
C3	9783758	9784151	BolC3t14363H	0	-	109	393	393	1.0000000
C3	9786135	9788554	BolC3t14364H	0	-	1687	2419	2419	1.0000000
C3	9801285	9801810	BolC3t14365H	0	+	172	341	525	0.6495238
C3	9804939	9806310	BolC3t14366H	0	+	964	1371	1371	1.0000000
C3	9808977	9812454	BolC3t14367H	0	-	201	1417	3477	0.4075352
C3	9813220	9814800	BolC3t14368H	0	-	522	1580	1580	1.0000000
C3	9816306	9816453	BolC3t14369H	0	-	144	147	147	1.0000000
C3	9818755	9819629	BolC3t14370H	0	-	397	874	874	1.0000000
C3	9829756	9831546	BolC3t14371H	0	+	648	1786	1790	0.9977654
C3	9836666	9838541	BolC3t14372H	0	-	1093	1846	1875	0.9845333
C3	9841119	9842163	BolC3t14373H	0	-	379	996	1044	0.9540230
C3	9844221	9844761	BolC3t14374H	0	-	47	292	540	0.5407407
C3	9845060	9845453	BolC3t14375H	0	-	111	340	393	0.8651400
C3	9846712	9849170	BolC3t14376H	0	-	1818	2458	2458	1.0000000
C3	9850091	9850292	BolC3t14377H	0	-	287	201	201	1.0000000
C3	9850545	9851814	BolC3t14378H	0	-	463	1087	1269	0.8565800
C3	9857083	9859087	BolC3t14379H	0	-	1855	2004	2004	1.0000000
C3	9865271	9866444	BolC3t14380H	0	+	225	536	1173	0.4569480
C3	9872808	9873796	BolC3t14381H	0	-	27	220	988	0.2226721
C3	9876237	9877167	BolC3t14382H	0	+	90	865	930	0.9301075
C3	9907311	9908460	BolC3t14383H	0	+	1332	1149	1149	1.0000000
C3	9913515	9913822	BolC3t14384H	0	+	569	307	307	1.0000000
C3	9918034	9919484	BolC3t14385H	0	-	2343	1450	1450	1.0000000
C3	9926429	9926908	BolC3t14386H	0	+	260	479	479	1.0000000
C3	9929140	9930136	BolC3t14387H	0	-	135	785	996	0.7881526
C3	9931569	9935197	BolC3t14388H	0	-	582	3161	3628	0.8712789
C3	9939299	9941523	BolC3t14389H	0	-	432	1009	2224	0.4536870
C3	9944238	9944466	BolC3t14390H	0	-	1014	228	228	1.0000000
C3	9948559	9950445	BolC3t14391H	0	-	554	1682	1886	0.8918346
C3	9955127	9968875	BolC3t14392H	0	-	4532	8210	13748	0.5971777
C3	9970477	9987609	BolC3t14393H	0	-	1697	8904	17132	0.5197291
C3	9993162	9994593	BolC3t14394H	0	+	1275	1395	1431	0.9748428
C3	9994992	9995298	BolC3t14395H	0	-	71	257	306	0.8398693
C3	10010573	10011700	BolC3t14396H	0	-	1184	1127	1127	1.0000000
C3	10013195	10014391	BolC3t14397H	0	+	197	1122	1196	0.9381271
C3	10019023	10019812	BolC3t14398H	0	+	282	789	789	1.0000000
C3	10022966	10023666	BolC3t14399H	0	+	8	22	700	0.0314286
C3	10024924	10025491	BolC3t14400H	0	-	35	119	567	0.2098765
C3	10035651	10050282	BolC3t14401H	0	-	2383	6774	14631	0.4629895
C3	10054307	10055485	BolC3t14402H	0	-	1214	1178	1178	1.0000000
C3	10057302	10058862	BolC3t14403H	0	+	406	1441	1560	0.9237180
C3	10063453	10063600	BolC3t14404H	0	+	170	147	147	1.0000000
C3	10066959	10069294	BolC3t14405H	0	-	24	497	2335	0.2128480
C3	10079370	10081645	BolC3t14406H	0	+	1921	2274	2275	0.9995604
C3	10084858	10085130	BolC3t14407H	0	+	46	226	272	0.8308824
C3	10085366	10085840	BolC3t14408H	0	+	19	143	474	0.3016878
C3	10086246	10086396	BolC3t14409H	0	+	2	87	150	0.5800000
C3	10088861	10088972	BolC3t14410H	0	+	7	111	111	1.0000000
C3	10091251	10092156	BolC3t14411H	0	+	96	885	905	0.9779006
C3	10096466	10097663	BolC3t14412H	0	+	446	1049	1197	0.8763576
C3	10098240	10106064	BolC3t14413H	0	-	1796	4015	7824	0.5131646
C3	10109059	10111122	BolC3t14414H	0	+	536	1546	2063	0.7493941
C3	10115457	10119690	BolC3t14415H	0	+	2869	4233	4233	1.0000000
C3	10121630	10124467	BolC3t14416H	0	+	2513	2837	2837	1.0000000
C3	10125030	10125764	BolC3t14417H	0	-	754	734	734	1.0000000
C3	10127851	10128481	BolC3t14418H	0	-	387	630	630	1.0000000
C3	10128940	10131664	BolC3t14419H	0	-	650	2424	2724	0.8898678
C3	10134639	10139731	BolC3t14420H	0	+	728	2635	5092	0.5174784
C3	10140621	10140873	BolC3t14421H	0	+	83	252	252	1.0000000
C3	10141049	10143343	BolC3t14422H	0	-	1188	2213	2294	0.9646905
C3	10144468	10145372	BolC3t14423H	0	+	135	719	904	0.7953540
C3	10148084	10148876	BolC3t14424H	0	-	281	574	792	0.7247475
C3	10149396	10149639	BolC3t14425H	0	-	0	0	243	0.0000000
C3	10152186	10152339	BolC3t14426H	0	-	0	0	153	0.0000000
C3	10156281	10156554	BolC3t14427H	0	-	0	0	273	0.0000000
C3	10162070	10162283	BolC3t14428H	0	-	145	213	213	1.0000000
C3	10165732	10165972	BolC3t14429H	0	+	4	27	240	0.1125000
C3	10169241	10172275	BolC3t14430H	0	+	239	2792	3034	0.9202373
C3	10179625	10181394	BolC3t14431H	0	-	765	1671	1769	0.9446015
C3	10181741	10186392	BolC3t14432H	0	-	1216	4102	4651	0.8819609
C3	10188386	10189331	BolC3t14433H	0	-	67	732	945	0.7746032
C3	10191763	10193096	BolC3t14434H	0	+	795	1333	1333	1.0000000
C3	10197313	10199005	BolC3t14435H	0	+	442	970	1692	0.5732861
C3	10216725	10218020	BolC3t14436H	0	-	2	162	1295	0.1250965
C3	10247436	10249296	BolC3t14437H	0	+	807	1860	1860	1.0000000
C3	10251012	10254540	BolC3t14438H	0	+	1964	3158	3528	0.8951247
C3	10255970	10256942	BolC3t14439H	0	-	158	861	972	0.8858024
C3	10258783	10258999	BolC3t14440H	0	-	3	135	216	0.6250000
C3	10262136	10263783	BolC3t14441H	0	+	28	894	1647	0.5428051
C3	10264623	10265317	BolC3t14442H	0	-	184	694	694	1.0000000
C3	10265761	10267119	BolC3t14443H	0	-	510	1358	1358	1.0000000
C3	10270856	10270988	BolC3t14444H	0	+	44	132	132	1.0000000
C3	10275058	10275424	BolC3t14445H	0	+	128	349	366	0.9535519
C3	10276816	10279355	BolC3t14446H	0	-	969	2513	2539	0.9897597
C3	10279996	10281444	BolC3t14447H	0	+	811	1448	1448	1.0000000
C3	10282925	10287085	BolC3t14448H	0	+	4074	4160	4160	1.0000000
C3	10287722	10290580	BolC3t14449H	0	-	586	1948	2858	0.6815955
C3	10291570	10292330	BolC3t14450H	0	-	493	756	760	0.9947369
C3	10292605	10295046	BolC3t14451H	0	+	1583	2341	2441	0.9590332
C3	10300335	10302326	BolC3t14452H	0	+	811	1913	1991	0.9608237
C3	10304723	10306615	BolC3t14453H	0	+	771	1880	1892	0.9936575
C3	10310215	10312639	BolC3t14454H	0	+	1287	2350	2424	0.9694719
C3	10312886	10313072	BolC3t14455H	0	-	17	186	186	1.0000000
C3	10313859	10314195	BolC3t14456H	0	-	259	336	336	1.0000000
C3	10319505	10320950	BolC3t14457H	0	+	322	1315	1445	0.9100346
C3	10324986	10326755	BolC3t14458H	0	-	895	1712	1769	0.9677784
C3	10335812	10338022	BolC3t14459H	0	-	1384	2153	2210	0.9742081
C3	10339473	10342574	BolC3t14460H	0	+	1408	2623	3101	0.8458562
C3	10357104	10357806	BolC3t14461H	0	+	8	169	702	0.2407407
C3	10372849	10374269	BolC3t14462H	0	+	76	567	1420	0.3992958
C3	10379709	10380247	BolC3t14463H	0	+	239	469	538	0.8717472
C3	10381582	10382682	BolC3t14464H	0	+	492	1100	1100	1.0000000
C3	10384896	10387521	BolC3t14465H	0	-	894	1929	2625	0.7348571
C3	10391789	10393507	BolC3t14466H	0	-	416	1062	1718	0.6181607
C3	10399972	10401270	BolC3t14467H	0	+	0	0	1298	0.0000000
C3	10476408	10477777	BolC3t14468H	0	+	609	1369	1369	1.0000000
C3	10479245	10486126	BolC3t14469H	0	+	911	5384	6881	0.7824444
C3	10486881	10487958	BolC3t14470H	0	-	329	1034	1077	0.9600743
C3	10494325	10495750	BolC3t14471H	0	-	275	1134	1425	0.7957895
C3	10503584	10507923	BolC3t14472H	0	-	2620	4339	4339	1.0000000
C3	10511087	10511429	BolC3t14473H	0	-	150	342	342	1.0000000
C3	10511539	10511869	BolC3t14474H	0	-	104	330	330	1.0000000
C3	10519817	10521642	BolC3t14475H	0	+	221	1082	1825	0.5928767
C3	10523603	10525295	BolC3t14476H	0	+	69	1266	1692	0.7482269
C3	10525745	10529331	BolC3t14477H	0	-	1304	3077	3586	0.8580591
C3	10531277	10534695	BolC3t14478H	0	+	1944	3418	3418	1.0000000
C3	10535521	10537100	BolC3t14479H	0	-	1291	1579	1579	1.0000000
C3	10540856	10542794	BolC3t14480H	0	+	122	1395	1938	0.7198142
C3	10543055	10545574	BolC3t14481H	0	-	884	2519	2519	1.0000000
C3	10546461	10554493	BolC3t14482H	0	-	5549	7769	8032	0.9672559
C3	10556569	10558434	BolC3t14483H	0	-	990	1693	1865	0.9077748
C3	10570100	10578674	BolC3t14484H	0	+	950	4741	8574	0.5529508
C3	10579131	10580745	BolC3t14485H	0	+	1355	1614	1614	1.0000000
C3	10581082	10587278	BolC3t14486H	0	-	1840	5859	6196	0.9456100
C3	10589950	10590527	BolC3t14487H	0	-	341	577	577	1.0000000
C3	10594909	10596259	BolC3t14488H	0	-	1209	1350	1350	1.0000000
C3	10596569	10597787	BolC3t14489H	0	+	1064	1218	1218	1.0000000
C3	10600473	10601649	BolC3t14490H	0	+	490	1108	1176	0.9421769
C3	10606719	10607320	BolC3t14491H	0	-	493	601	601	1.0000000
C3	10613303	10614459	BolC3t14492H	0	-	726	1156	1156	1.0000000
C3	10615544	10618343	BolC3t14493H	0	-	747	2505	2799	0.8949625
C3	10626139	10626825	BolC3t14494H	0	+	189	686	686	1.0000000
C3	10627175	10628467	BolC3t14495H	0	+	854	1204	1292	0.9318885
C3	10630041	10630290	BolC3t14496H	0	+	0	0	249	0.0000000
C3	10632384	10634292	BolC3t14497H	0	+	318	1667	1908	0.8736897
C3	10635313	10636245	BolC3t14498H	0	-	76	585	932	0.6276824
C3	10636988	10639405	BolC3t14499H	0	-	323	1881	2417	0.7782375
C3	10643554	10645467	BolC3t14500H	0	+	2446	1913	1913	1.0000000
C3	10652864	10653365	BolC3t14501H	0	-	523	501	501	1.0000000
C3	10654358	10662148	BolC3t14502H	0	-	990	5399	7790	0.6930680
C3	10665533	10667355	BolC3t14503H	0	-	520	1479	1822	0.8117453
C3	10676204	10677883	BolC3t14504H	0	-	914	1679	1679	1.0000000
C3	10682153	10685883	BolC3t14505H	0	+	3261	3730	3730	1.0000000
C3	10702530	10703594	BolC3t14506H	0	+	11	240	1064	0.2255639
C3	10705272	10707126	BolC3t14507H	0	+	745	1668	1854	0.8996764
C3	10707597	10711030	BolC3t14508H	0	-	904	2468	3433	0.7189047
C3	10712808	10714313	BolC3t14509H	0	+	1341	1505	1505	1.0000000
C3	10714826	10729273	BolC3t14510H	0	-	767	5440	14447	0.3765488
C3	10734101	10736287	BolC3t14511H	0	-	46	767	2186	0.3508692
C3	10737995	10738655	BolC3t14512H	0	-	166	660	660	1.0000000
C3	10742213	10751539	BolC3t14513H	0	+	2898	7973	9326	0.8549217
C3	10755274	10756667	BolC3t14514H	0	+	682	1340	1393	0.9619526
C3	10758188	10758987	BolC3t14515H	0	-	738	799	799	1.0000000
C3	10762304	10763035	BolC3t14516H	0	+	39	724	731	0.9904241
C3	10764987	10769841	BolC3t14517H	0	+	551	3591	4854	0.7398022
C3	10770775	10772281	BolC3t14518H	0	+	152	1053	1506	0.6992032
C3	10773654	10775637	BolC3t14519H	0	+	630	1907	1983	0.9616742
C3	10776256	10777099	BolC3t14520H	0	+	106	381	843	0.4519573
C3	10777920	10780415	BolC3t14521H	0	+	532	2317	2495	0.9286573
C3	10782777	10782966	BolC3t14522H	0	+	140	189	189	1.0000000
C3	10786819	10787464	BolC3t14523H	0	-	28	323	645	0.5007752
C3	10796744	10799309	BolC3t14524H	0	+	61	1388	2565	0.5411306
C3	10806180	10807101	BolC3t14525H	0	+	765	921	921	1.0000000
C3	10808213	10808759	BolC3t14526H	0	+	75	528	546	0.9670330
C3	10810134	10811093	BolC3t14527H	0	-	9	323	959	0.3368092
C3	10811674	10819489	BolC3t14528H	0	-	1358	4629	7815	0.5923225
C3	10815832	10816259	BolC3t14529H	0	+	0	0	427	0.0000000
C3	10828325	10830327	BolC3t14530H	0	+	870	1914	2002	0.9560440
C3	10837174	10837396	BolC3t14531H	0	+	5	125	222	0.5630631
C3	10837881	10838903	BolC3t14532H	0	+	2	195	1022	0.1908024
C3	10842749	10844673	BolC3t14533H	0	+	1911	1924	1924	1.0000000
C3	10844964	10846125	BolC3t14534H	0	-	324	894	1161	0.7700258
C3	10864986	10866240	BolC3t14535H	0	-	460	1194	1254	0.9521531
C3	10867100	10867949	BolC3t14536H	0	-	237	836	849	0.9846879
C3	10871784	10874028	BolC3t14537H	0	+	401	1482	2244	0.6604278
C3	10881209	10884299	BolC3t14538H	0	+	720	2782	3090	0.9003236
C3	10894485	10895579	BolC3t14539H	0	-	726	1094	1094	1.0000000
C3	10901383	10903609	BolC3t14540H	0	+	1151	2177	2226	0.9779874
C3	10907336	10909120	BolC3t14541H	0	+	1046	1784	1784	1.0000000
C3	10909574	10913297	BolC3t14542H	0	-	2712	3721	3723	0.9994628
C3	10916370	10917683	BolC3t14543H	0	-	11	617	1313	0.4699162
C3	10930318	10930549	BolC3t14544H	0	+	69	213	231	0.9220779
C3	10935588	10937730	BolC3t14545H	0	+	1124	2105	2142	0.9827264
C3	10940151	10942609	BolC3t14546H	0	+	1090	2384	2458	0.9698942
C3	10945537	10948866	BolC3t14547H	0	+	1699	3292	3329	0.9888855
C3	10953729	10954248	BolC3t14548H	0	-	282	519	519	1.0000000
C3	10955170	10956880	BolC3t14549H	0	-	524	1710	1710	1.0000000
C3	10959940	10962295	BolC3t14550H	0	+	1887	2355	2355	1.0000000
C3	10963586	10965120	BolC3t14551H	0	-	1211	1534	1534	1.0000000
C3	10969190	10972151	BolC3t14552H	0	-	2213	2961	2961	1.0000000
C3	10973568	10973727	BolC3t14553H	0	+	10	153	159	0.9622642
C3	10976677	10978288	BolC3t14554H	0	+	543	1307	1611	0.8112974
C3	10988270	10989353	BolC3t14555H	0	+	65	289	1083	0.2668513
C3	10991320	10991695	BolC3t14556H	0	-	216	375	375	1.0000000
C3	10991774	10992863	BolC3t14557H	0	+	1188	1089	1089	1.0000000
C3	10996231	10996504	BolC3t14558H	0	+	240	273	273	1.0000000
C3	10997088	10997608	BolC3t14559H	0	+	636	520	520	1.0000000
C3	10999563	11002706	BolC3t14560H	0	-	1096	2861	3143	0.9102768
C3	11006706	11007694	BolC3t14561H	0	+	405	918	988	0.9291498
C3	11008404	11017804	BolC3t14562H	0	-	3181	7104	9400	0.7557447
C3	11018642	11019996	BolC3t14563H	0	+	804	1255	1354	0.9268833
C3	11020578	11021799	BolC3t14564H	0	-	482	1207	1221	0.9885340
C3	11029910	11030177	BolC3t14565H	0	+	0	0	267	0.0000000
C3	11031251	11034193	BolC3t14566H	0	+	1650	2855	2942	0.9704283
C3	11034849	11036395	BolC3t14567H	0	-	146	1066	1546	0.6895214
C3	11039794	11040625	BolC3t14568H	0	+	386	831	831	1.0000000
C3	11042443	11042778	BolC3t14569H	0	-	250	335	335	1.0000000
C3	11045535	11047204	BolC3t14570H	0	+	522	1669	1669	1.0000000
C3	11048909	11053221	BolC3t14571H	0	+	1147	3650	4312	0.8464749
C3	11055365	11056898	BolC3t14572H	0	+	1169	1533	1533	1.0000000
C3	11059445	11066341	BolC3t14573H	0	+	934	4339	6896	0.6292053
C3	11067979	11068804	BolC3t14574H	0	-	351	530	825	0.6424242
C3	11077280	11078501	BolC3t14575H	0	-	66	503	1221	0.4119574
C3	11084271	11085195	BolC3t14576H	0	-	3	20	924	0.0216450
C3	11089094	11089807	BolC3t14577H	0	+	171	705	713	0.9887798
C3	11092155	11094271	BolC3t14578H	0	+	989	2116	2116	1.0000000
C3	11094711	11096491	BolC3t14579H	0	-	1321	1780	1780	1.0000000
C3	11098439	11098902	BolC3t14580H	0	-	338	378	463	0.8164147
C3	11102912	11104771	BolC3t14581H	0	+	300	1530	1859	0.8230231
C3	11105015	11107003	BolC3t14582H	0	-	468	1845	1988	0.9280684
C3	11110601	11110817	BolC3t14583H	0	+	274	216	216	1.0000000
C3	11116663	11117386	BolC3t14584H	0	+	6	104	723	0.1438451
C3	11121923	11123882	BolC3t14585H	0	-	231	1196	1959	0.6105156
C3	11126237	11127320	BolC3t14586H	0	+	132	413	1083	0.3813481
C3	11127956	11129280	BolC3t14587H	0	-	181	1114	1324	0.8413897
C3	11133025	11133691	BolC3t14588H	0	+	1028	666	666	1.0000000
C3	11134039	11135535	BolC3t14589H	0	-	1647	1496	1496	1.0000000
C3	11138719	11154756	BolC3t14590H	0	-	201	2534	16037	0.1580096
C3	11162258	11164349	BolC3t14591H	0	-	1690	2091	2091	1.0000000
C3	11179513	11180871	BolC3t14592H	0	-	588	1261	1358	0.9285714
C3	11191084	11191285	BolC3t14593H	0	+	244	201	201	1.0000000
C3	11194947	11197087	BolC3t14594H	0	-	596	1648	2140	0.7700934
C3	11205643	11208237	BolC3t14595H	0	-	2231	2594	2594	1.0000000
C3	11217813	11217930	BolC3t14596H	0	-	262	117	117	1.0000000
C3	11225949	11227244	BolC3t14597H	0	+	244	1110	1295	0.8571429
C3	11227934	11230540	BolC3t14598H	0	-	398	1699	2606	0.6519570
C3	11240773	11240908	BolC3t14599H	0	-	144	135	135	1.0000000
C3	11241655	11242318	BolC3t14600H	0	-	149	663	663	1.0000000
C3	11247561	11253365	BolC3t14601H	0	-	2192	5264	5804	0.9069607
C3	11259979	11260846	BolC3t14602H	0	-	704	867	867	1.0000000
C3	11269278	11271977	BolC3t14603H	0	-	807	2313	2699	0.8569841
C3	11280937	11283030	BolC3t14604H	0	-	1446	2093	2093	1.0000000
C3	11290181	11293081	BolC3t14605H	0	+	422	2496	2900	0.8606896
C3	11295203	11295983	BolC3t14606H	0	+	386	760	780	0.9743590
C3	11300456	11305625	BolC3t14607H	0	+	2107	4959	5169	0.9593732
C3	11306931	11308939	BolC3t14608H	0	+	589	2002	2008	0.9970120
C3	11309799	11314136	BolC3t14609H	0	-	2911	4271	4337	0.9847821
C3	11331789	11332233	BolC3t14610H	0	+	307	444	444	1.0000000
C3	11337177	11341653	BolC3t14611H	0	+	2891	4476	4476	1.0000000
C3	11346376	11349694	BolC3t14612H	0	+	1873	3274	3318	0.9867390
C3	11352749	11354396	BolC3t14613H	0	-	103	267	1647	0.1621129
C3	11358114	11364268	BolC3t14614H	0	+	1467	5656	6154	0.9190770
C3	11372430	11378011	BolC3t14615H	0	+	2836	5369	5581	0.9620140
C3	11379079	11382355	BolC3t14616H	0	+	2207	3106	3276	0.9481074
C3	11382982	11383783	BolC3t14617H	0	-	172	796	801	0.9937578
C3	11387942	11388143	BolC3t14618H	0	-	39	201	201	1.0000000
C3	11388764	11389867	BolC3t14619H	0	-	432	1103	1103	1.0000000
C3	11398350	11400093	BolC3t14620H	0	+	567	1642	1743	0.9420539
C3	11406490	11409004	BolC3t14621H	0	+	2011	2367	2514	0.9415274
C3	11409317	11410858	BolC3t14622H	0	-	835	1541	1541	1.0000000
C3	11414080	11414422	BolC3t14623H	0	+	180	327	342	0.9561403
C3	11416648	11419266	BolC3t14624H	0	+	1112	2025	2618	0.7734912
C3	11419877	11422309	BolC3t14625H	0	-	448	2124	2432	0.8733553
C3	11424267	11435215	BolC3t14626H	0	-	2743	8760	10948	0.8001462
C3	11437366	11438658	BolC3t14627H	0	+	704	1292	1292	1.0000000
C3	11438934	11440308	BolC3t14628H	0	-	491	1374	1374	1.0000000
C3	11445807	11446086	BolC3t14629H	0	+	85	279	279	1.0000000
C3	11449215	11449600	BolC3t14630H	0	-	2	20	385	0.0519481
C3	11452926	11453313	BolC3t14631H	0	-	0	0	387	0.0000000
C3	11457969	11462016	BolC3t14632H	0	+	549	1822	4047	0.4502100
C3	11462194	11463261	BolC3t14633H	0	+	1	32	1067	0.0299906
C3	11463558	11464380	BolC3t14634H	0	-	2	62	822	0.0754258
C3	11525136	11525544	BolC3t14635H	0	-	6	5	408	0.0122549
C3	11526822	11527889	BolC3t14636H	0	+	13	55	1067	0.0515464
C3	11529389	11530520	BolC3t14637H	0	-	279	900	1131	0.7957560
C3	11543377	11544748	BolC3t14638H	0	+	0	0	1371	0.0000000
C3	11545959	11546522	BolC3t14639H	0	+	364	265	563	0.4706927
C3	11551683	11553011	BolC3t14640H	0	+	66	427	1328	0.3215362
C3	11554682	11554817	BolC3t14641H	0	+	111	135	135	1.0000000
C3	11558271	11561030	BolC3t14642H	0	+	740	2499	2759	0.9057630
C3	11561527	11563031	BolC3t14643H	0	+	33	369	1504	0.2453457
C3	11563170	11566275	BolC3t14644H	0	-	602	2737	3105	0.8814815
C3	11570148	11571349	BolC3t14645H	0	+	653	1201	1201	1.0000000
C3	11572467	11574003	BolC3t14646H	0	+	1138	1536	1536	1.0000000
C3	11585261	11585528	BolC3t14647H	0	-	662	267	267	1.0000000
C3	11593600	11594917	BolC3t14648H	0	+	201	1230	1317	0.9339408
C3	11609797	11611444	BolC3t14649H	0	+	176	1191	1647	0.7231330
C3	11612740	11613947	BolC3t14650H	0	-	1218	1207	1207	1.0000000
C3	11615646	11615757	BolC3t14651H	0	-	0	0	111	0.0000000
C3	11619331	11621771	BolC3t14652H	0	-	1622	2440	2440	1.0000000
C3	11625409	11626715	BolC3t14653H	0	-	1002	1306	1306	1.0000000
C3	11637215	11638172	BolC3t14654H	0	+	538	944	957	0.9864159
C3	11641423	11643484	BolC3t14655H	0	+	156	1758	2061	0.8529840
C3	11644678	11645011	BolC3t14656H	0	+	0	0	333	0.0000000
C3	11646509	11647352	BolC3t14657H	0	+	12	391	843	0.4638197
C3	11662376	11663328	BolC3t14658H	0	+	3	22	952	0.0231092
C3	11663809	11680284	BolC3t14659H	0	-	1297	6222	16475	0.3776631
C3	11707372	11707501	BolC3t14660H	0	+	2	50	129	0.3875969
C3	11714397	11719475	BolC3t14661H	0	+	283	2406	5078	0.4738086
C3	11720165	11720702	BolC3t14662H	0	-	0	0	537	0.0000000
C3	11724084	11724357	BolC3t14663H	0	+	47	273	273	1.0000000
C3	11733044	11734681	BolC3t14664H	0	-	261	1572	1637	0.9602932
C3	11737195	11737859	BolC3t14665H	0	+	57	475	664	0.7153614
C3	11739420	11740353	BolC3t14666H	0	-	122	745	933	0.7984995
C3	11741011	11743201	BolC3t14667H	0	-	670	2100	2190	0.9589041
C3	11745861	11747631	BolC3t14668H	0	+	397	1700	1770	0.9604520
C3	11754909	11756211	BolC3t14669H	0	+	624	1287	1302	0.9884793
C3	11756829	11757917	BolC3t14670H	0	-	662	1088	1088	1.0000000
C3	11762170	11764206	BolC3t14671H	0	+	961	1956	2036	0.9607072
C3	11783838	11784660	BolC3t14672H	0	+	130	795	822	0.9671533
C3	11796012	11797229	BolC3t14673H	0	-	790	1217	1217	1.0000000
C3	11799976	11801714	BolC3t14674H	0	-	127	1217	1738	0.7002301
C3	11807357	11808628	BolC3t14675H	0	-	342	897	1271	0.7057435
C3	11809790	11812167	BolC3t14676H	0	+	997	2187	2377	0.9200673
C3	11816504	11816732	BolC3t14677H	0	-	183	228	228	1.0000000
C3	11825335	11827883	BolC3t14678H	0	-	1891	2548	2548	1.0000000
C3	11828896	11830096	BolC3t14679H	0	+	936	1200	1200	1.0000000
C3	11830502	11831837	BolC3t14680H	0	-	513	1209	1335	0.9056180
C3	11833436	11834835	BolC3t14681H	0	-	1006	1399	1399	1.0000000
C3	11838527	11839587	BolC3t14682H	0	+	285	775	1060	0.7311321
C3	11844244	11844505	BolC3t14683H	0	-	6	90	261	0.3448276
C3	11855874	11857206	BolC3t14684H	0	+	564	1332	1332	1.0000000
C3	11857842	11861057	BolC3t14685H	0	-	1172	2853	3215	0.8874028
C3	11863900	11877619	BolC3t14686H	0	+	1397	9023	13719	0.6577010
C3	11878296	11878485	BolC3t14687H	0	-	11	189	189	1.0000000
C3	11883283	11885793	BolC3t14688H	0	+	542	2361	2510	0.9406375
C3	11886204	11886625	BolC3t14689H	0	-	462	421	421	1.0000000
C3	11887996	11891097	BolC3t14690H	0	-	1080	1872	3101	0.6036763
C3	11893988	11895793	BolC3t14691H	0	+	11	472	1805	0.2614959
C3	11896560	11897130	BolC3t14692H	0	+	52	558	570	0.9789473
C3	11900218	11901730	BolC3t14693H	0	-	1095	1337	1512	0.8842593
C3	11914047	11917165	BolC3t14694H	0	+	857	2977	3118	0.9547787
C3	11919203	11919821	BolC3t14695H	0	+	116	318	618	0.5145631
C3	11923189	11925072	BolC3t14696H	0	+	200	476	1883	0.2527881
C3	11946237	11947273	BolC3t14697H	0	+	322	912	1036	0.8803089
C3	11948560	11948803	BolC3t14698H	0	+	15	142	243	0.5843621
C3	11950895	11950997	BolC3t14699H	0	+	10	102	102	1.0000000
C3	11953576	11954277	BolC3t14700H	0	+	922	701	701	1.0000000
C3	11955213	11958186	BolC3t14701H	0	+	1069	2872	2973	0.9660276
C3	11959409	11960579	BolC3t14702H	0	+	32	126	1170	0.1076923
C3	11961598	11961937	BolC3t14703H	0	+	162	339	339	1.0000000
C3	11963623	11966085	BolC3t14704H	0	+	337	1588	2462	0.6450040
C3	11965411	11970054	BolC3t14705H	0	+	587	3271	4643	0.7045014
C3	11972329	11974046	BolC3t14706H	0	+	1453	1628	1717	0.9481654
C3	11975811	11975987	BolC3t14707H	0	+	56	176	176	1.0000000
C3	11975997	11977654	BolC3t14708H	0	+	103	1445	1657	0.8720579
C3	11982744	11983153	BolC3t14709H	0	+	49	393	409	0.9608802
C3	11990757	11992840	BolC3t14710H	0	+	426	1492	2083	0.7162746
C3	11995773	11997779	BolC3t14711H	0	-	1514	2006	2006	1.0000000
C3	12000794	12010633	BolC3t14712H	0	+	9441	9148	9839	0.9297693
C3	12006122	12007899	BolC3t14713H	0	-	2104	1777	1777	1.0000000
C3	12009533	12010326	BolC3t14714H	0	+	1022	793	793	1.0000000
C3	12011250	12011915	BolC3t14715H	0	-	234	665	665	1.0000000
C3	12020645	12021173	BolC3t14716H	0	-	21	151	528	0.2859848
C3	12030193	12030826	BolC3t14717H	0	+	449	633	633	1.0000000
C3	12033477	12033975	BolC3t14718H	0	-	84	340	498	0.6827309
C3	12037878	12042365	BolC3t14719H	0	+	745	3660	4487	0.8156897
C3	12042711	12043800	BolC3t14720H	0	-	749	979	1089	0.8989899
C3	12053317	12053710	BolC3t14721H	0	+	307	393	393	1.0000000
C3	12054791	12056018	BolC3t14722H	0	-	242	1187	1227	0.9674001
C3	12072102	12075568	BolC3t14723H	0	-	445	2873	3466	0.8289094
C3	12078128	12078446	BolC3t14724H	0	+	8	140	318	0.4402516
C3	12098327	12100546	BolC3t14725H	0	+	43	843	2219	0.3799008
C3	12101606	12105004	BolC3t14726H	0	-	97	2085	3398	0.6135963
C3	12110959	12111156	BolC3t14727H	0	+	256	197	197	1.0000000
C3	12127436	12128120	BolC3t14728H	0	+	530	684	684	1.0000000
C3	12137639	12140141	BolC3t14729H	0	+	1618	2325	2502	0.9292566
C3	12141603	12141747	BolC3t14730H	0	+	286	144	144	1.0000000
C3	12146581	12149357	BolC3t14731H	0	+	2234	2718	2776	0.9791066
C3	12149742	12151410	BolC3t14732H	0	-	96	633	1668	0.3794964
C3	12152659	12153904	BolC3t14733H	0	-	477	1245	1245	1.0000000
C3	12169358	12170054	BolC3t14734H	0	+	146	696	696	1.0000000
C3	12190078	12190794	BolC3t14735H	0	+	1429	716	716	1.0000000
C3	12197044	12197850	BolC3t14736H	0	+	381	798	806	0.9900745
C3	12198963	12199889	BolC3t14737H	0	+	454	891	926	0.9622030
C3	12200788	12204371	BolC3t14738H	0	-	522	2378	3583	0.6636897
C3	12213114	12213498	BolC3t14739H	0	-	250	384	384	1.0000000
C3	12216386	12218105	BolC3t14740H	0	-	670	1707	1719	0.9930192
C3	12220801	12222480	BolC3t14741H	0	+	1222	1679	1679	1.0000000
C3	12224063	12225564	BolC3t14742H	0	+	29	816	1501	0.5436376
C3	12228466	12229702	BolC3t14743H	0	+	166	543	1236	0.4393204
C3	12230745	12230958	BolC3t14744H	0	-	4	77	213	0.3615023
C3	12242864	12244923	BolC3t14745H	0	-	1898	2018	2059	0.9800874
C3	12250025	12250526	BolC3t14746H	0	+	264	501	501	1.0000000
C3	12251976	12254755	BolC3t14747H	0	+	94	1435	2779	0.5163728
C3	12256950	12258813	BolC3t14748H	0	+	285	1850	1863	0.9930220
C3	12267292	12274211	BolC3t14749H	0	+	968	4563	6919	0.6594884
C3	12274592	12276887	BolC3t14750H	0	-	440	1720	2295	0.7494553
C3	12288620	12289569	BolC3t14751H	0	+	58	609	949	0.6417282
C3	12294037	12295048	BolC3t14752H	0	+	9	240	1011	0.2373887
C3	12295655	12298232	BolC3t14753H	0	+	1460	2577	2577	1.0000000
C3	12310758	12313717	BolC3t14754H	0	+	698	2650	2959	0.8955728
C3	12314213	12314447	BolC3t14755H	0	+	7	113	234	0.4829060
C3	12316209	12316773	BolC3t14756H	0	-	8	86	564	0.1524823
C3	12321437	12322391	BolC3t14757H	0	-	242	857	954	0.8983229
C3	12326558	12329111	BolC3t14758H	0	-	658	2398	2553	0.9392871
C3	12337564	12339580	BolC3t14759H	0	-	839	1944	2016	0.9642857
C3	12343154	12344978	BolC3t14760H	0	-	433	860	1824	0.4714912
C3	12349176	12350339	BolC3t14761H	0	+	0	0	1163	0.0000000
C3	12356480	12358590	BolC3t14762H	0	+	244	1532	2110	0.7260664
C3	12364975	12366374	BolC3t14763H	0	-	467	1318	1399	0.9421015
C3	12367483	12368574	BolC3t14764H	0	+	329	1075	1091	0.9853346
C3	12369327	12370231	BolC3t14765H	0	-	885	904	904	1.0000000
C3	12376483	12377521	BolC3t14766H	0	+	1083	1038	1038	1.0000000
C3	12383502	12384993	BolC3t14767H	0	-	214	647	1491	0.4339370
C3	12392448	12393937	BolC3t14768H	0	-	332	1182	1489	0.7938213
C3	12402039	12403530	BolC3t14769H	0	-	49	477	1491	0.3199195
C3	12429361	12430324	BolC3t14770H	0	+	694	963	963	1.0000000
C3	12435480	12437260	BolC3t14771H	0	+	288	888	1780	0.4988764
C3	12445354	12445746	BolC3t14772H	0	-	0	0	392	0.0000000
C3	12445830	12447091	BolC3t14773H	0	-	50	514	1261	0.4076130
C3	12458995	12460394	BolC3t14774H	0	+	178	1103	1399	0.7884203
C3	12466716	12467603	BolC3t14775H	0	-	924	887	887	1.0000000
C3	12498299	12498428	BolC3t14776H	0	+	53	129	129	1.0000000
C3	12498590	12498793	BolC3t14777H	0	-	7	44	203	0.2167488
C3	12498809	12499102	BolC3t14778H	0	-	122	293	293	1.0000000
C3	12499118	12499382	BolC3t14779H	0	-	110	264	264	1.0000000
C3	12503316	12508538	BolC3t14780H	0	+	1346	4671	5222	0.8944849
C3	12511764	12512790	BolC3t14781H	0	-	440	946	1026	0.9220273
C3	12516908	12517223	BolC3t14782H	0	+	616	315	315	1.0000000
C3	12525996	12526158	BolC3t14783H	0	-	4	21	162	0.1296296
C3	12526636	12527164	BolC3t14784H	0	+	68	521	528	0.9867424
C3	12528897	12529955	BolC3t14785H	0	-	593	1058	1058	1.0000000
C3	12530192	12532060	BolC3t14786H	0	-	236	1243	1868	0.6654176
C3	12532189	12535238	BolC3t14787H	0	-	1775	3049	3049	1.0000000
C3	12536287	12538050	BolC3t14788H	0	+	1412	1763	1763	1.0000000
C3	12539101	12541110	BolC3t14789H	0	+	2379	2009	2009	1.0000000
C3	12546903	12547278	BolC3t14790H	0	+	94	289	375	0.7706667
C3	12550735	12555253	BolC3t14791H	0	+	1380	4394	4518	0.9725542
C3	12557815	12559350	BolC3t14792H	0	+	1700	1535	1535	1.0000000
C3	12559913	12561809	BolC3t14793H	0	-	761	1853	1896	0.9773207
C3	12569361	12570280	BolC3t14794H	0	+	790	685	919	0.7453754
C3	12570910	12572298	BolC3t14795H	0	+	340	1340	1388	0.9654179
C3	12576224	12577921	BolC3t14796H	0	-	59	658	1697	0.3877431
C3	12580510	12581467	BolC3t14797H	0	+	5	65	957	0.0679206
C3	12587156	12587576	BolC3t14798H	0	+	1	35	420	0.0833333
C3	12588796	12591077	BolC3t14799H	0	-	361	2104	2281	0.9224024
C3	12593873	12595009	BolC3t14800H	0	-	100	832	1136	0.7323943
C3	12606684	12607842	BolC3t14801H	0	+	278	746	1158	0.6442142
C3	12608194	12608695	BolC3t14802H	0	-	35	313	501	0.6247505
C3	12614006	12615916	BolC3t14803H	0	-	1596	1910	1910	1.0000000
C3	12617438	12618196	BolC3t14804H	0	+	465	758	758	1.0000000
C3	12619506	12621732	BolC3t14805H	0	-	537	2010	2226	0.9029649
C3	12623577	12623796	BolC3t14806H	0	+	60	219	219	1.0000000
C3	12636464	12637842	BolC3t14807H	0	-	960	1378	1378	1.0000000
C3	12639153	12641409	BolC3t14808H	0	-	250	1533	2256	0.6795213
C3	12641922	12644496	BolC3t14809H	0	+	103	1589	2574	0.6173271
C3	12645019	12646239	BolC3t14810H	0	+	535	1082	1220	0.8868852
C3	12651130	12652255	BolC3t14811H	0	-	809	1125	1125	1.0000000
C3	12666305	12667825	BolC3t14812H	0	+	672	1487	1520	0.9782895
C3	12668344	12669522	BolC3t14813H	0	-	375	1178	1178	1.0000000
C3	12670589	12671499	BolC3t14814H	0	-	383	910	910	1.0000000
C3	12673164	12675321	BolC3t14815H	0	-	1200	2147	2157	0.9953640
C3	12679035	12679212	BolC3t14816H	0	+	207	177	177	1.0000000
C3	12682882	12683779	BolC3t14817H	0	+	350	758	897	0.8450390
C3	12712405	12713044	BolC3t14818H	0	-	328	639	639	1.0000000
C3	12715610	12723586	BolC3t14819H	0	+	2720	6165	7976	0.7729439
C3	12725097	12725289	BolC3t14820H	0	+	19	183	192	0.9531250
C3	12726329	12726710	BolC3t14821H	0	-	678	381	381	1.0000000
C3	12731239	12731731	BolC3t14822H	0	-	11	310	492	0.6300813
C3	12736024	12739138	BolC3t14823H	0	+	350	2458	3114	0.7893385
C3	12745127	12747538	BolC3t14824H	0	-	385	1924	2411	0.7980091
C3	12754881	12755500	BolC3t14825H	0	+	2	19	619	0.0306947
C3	12757792	12758646	BolC3t14826H	0	+	304	854	854	1.0000000
C3	12762366	12762712	BolC3t14827H	0	+	118	346	346	1.0000000
C3	12771334	12771672	BolC3t14828H	0	+	0	0	338	0.0000000
C3	12775815	12776153	BolC3t14829H	0	+	0	0	338	0.0000000
C3	12780308	12780638	BolC3t14830H	0	+	135	330	330	1.0000000
C3	12781987	12782362	BolC3t14831H	0	+	164	375	375	1.0000000
C3	12783258	12785224	BolC3t14832H	0	-	1036	1966	1966	1.0000000
C3	12786877	12787189	BolC3t14833H	0	-	84	312	312	1.0000000
C3	12790407	12791094	BolC3t14834H	0	+	158	684	687	0.9956332
C3	12796777	12797926	BolC3t14835H	0	-	495	1058	1149	0.9208007
C3	12811284	12812470	BolC3t14836H	0	+	188	965	1186	0.8136594
C3	12817950	12821530	BolC3t14837H	0	-	846	3204	3580	0.8949721
C3	12824757	12830115	BolC3t14838H	0	-	3140	5332	5358	0.9951475
C3	12832033	12833833	BolC3t14839H	0	+	237	1467	1800	0.8150000
C3	12834290	12835331	BolC3t14840H	0	-	246	988	1041	0.9490874
C3	12864143	12864326	BolC3t14841H	0	-	196	183	183	1.0000000
C3	12879824	12881855	BolC3t14842H	0	+	177	1196	2031	0.5888725
C3	12884013	12887148	BolC3t14843H	0	+	2730	3135	3135	1.0000000
C3	12887545	12909199	BolC3t14844H	0	-	7974	14881	21654	0.6872171
C3	12891726	12892200	BolC3t14845H	0	-	144	440	474	0.9282700
C3	12912355	12914383	BolC3t14846H	0	-	2439	2028	2028	1.0000000
C3	12932409	12932634	BolC3t14847H	0	+	50	189	225	0.8400000
C3	12934596	12936483	BolC3t14848H	0	+	877	1858	1887	0.9846317
C3	12943238	12951054	BolC3t14849H	0	+	2363	5927	7816	0.7583163
C3	12952125	12952827	BolC3t14850H	0	-	57	145	702	0.2065527
C3	12953059	12953812	BolC3t14851H	0	-	91	664	753	0.8818061
C3	12959013	12962589	BolC3t14852H	0	+	458	2348	3576	0.6565996
C3	12963467	12965215	BolC3t14853H	0	+	534	1710	1748	0.9782609
C3	12968556	12969303	BolC3t14854H	0	+	153	548	747	0.7336011
C3	12969673	12971595	BolC3t14855H	0	-	212	1702	1922	0.8855359
C3	12975079	12977367	BolC3t14856H	0	-	203	1513	2288	0.6612762
C3	12979811	12980585	BolC3t14857H	0	-	132	615	774	0.7945737
C3	12984591	12986470	BolC3t14858H	0	+	1927	1879	1879	1.0000000
C3	12986814	12988216	BolC3t14859H	0	-	686	1360	1402	0.9700428
C3	12994386	12994992	BolC3t14860H	0	+	183	605	606	0.9983498
C3	12995173	13000341	BolC3t14861H	0	-	1069	4586	5168	0.8873839
C3	13017493	13019588	BolC3t14862H	0	+	1064	2095	2095	1.0000000
C3	13025983	13026508	BolC3t14863H	0	+	415	525	525	1.0000000
C3	13039176	13043167	BolC3t14864H	0	-	1293	3425	3991	0.8581809
C3	13045936	13047639	BolC3t14865H	0	-	948	1554	1703	0.9125074
C3	13048391	13051310	BolC3t14866H	0	+	934	2835	2919	0.9712230
C3	13053602	13055678	BolC3t14867H	0	+	1164	2076	2076	1.0000000
C3	13056058	13056181	BolC3t14868H	0	+	110	123	123	1.0000000
C3	13077447	13079360	BolC3t14869H	0	+	145	1278	1913	0.6680607
C3	13087350	13087590	BolC3t14870H	0	-	242	240	240	1.0000000
C3	13101394	13101698	BolC3t14871H	0	-	0	0	304	0.0000000
C3	13105295	13110876	BolC3t14872H	0	+	2133	5381	5581	0.9641641
C3	13113121	13114935	BolC3t14873H	0	+	1302	1814	1814	1.0000000
C3	13115217	13115646	BolC3t14874H	0	+	344	429	429	1.0000000
C3	13116188	13116509	BolC3t14875H	0	-	439	321	321	1.0000000
C3	13119001	13119574	BolC3t14876H	0	-	402	573	573	1.0000000
C3	13125077	13126272	BolC3t14877H	0	-	1115	1195	1195	1.0000000
C3	13133916	13136293	BolC3t14878H	0	+	1222	2141	2377	0.9007152
C3	13139391	13140179	BolC3t14879H	0	+	332	788	788	1.0000000
C3	13143749	13145006	BolC3t14880H	0	+	918	1257	1257	1.0000000
C3	13149786	13152073	BolC3t14881H	0	+	1626	2185	2287	0.9554001
C3	13162202	13162406	BolC3t14882H	0	+	219	204	204	1.0000000
C3	13163836	13165954	BolC3t14883H	0	-	2441	2118	2118	1.0000000
C3	13172962	13173205	BolC3t14884H	0	-	66	243	243	1.0000000
C3	13186563	13187482	BolC3t14885H	0	-	1090	919	919	1.0000000
C3	13191108	13203380	BolC3t14886H	0	+	4901	8692	12272	0.7082790
C3	13206325	13206466	BolC3t14887H	0	+	178	141	141	1.0000000
C3	13211303	13214260	BolC3t14888H	0	-	1218	2598	2957	0.8785931
C3	13237250	13237786	BolC3t14889H	0	+	417	536	536	1.0000000
C3	13246127	13247265	BolC3t14890H	0	+	282	972	1138	0.8541300
C3	13255371	13256935	BolC3t14891H	0	-	540	1299	1564	0.8305627
C3	13258487	13261834	BolC3t14892H	0	+	562	2745	3347	0.8201374
C3	13277991	13278615	BolC3t14893H	0	+	6	56	624	0.0897436
C3	13286750	13286939	BolC3t14894H	0	-	209	189	189	1.0000000
C3	13290112	13292758	BolC3t14895H	0	+	387	1574	2646	0.5948601
C3	13295240	13297238	BolC3t14896H	0	-	585	1830	1998	0.9159159
C3	13299259	13299445	BolC3t14897H	0	+	5	91	186	0.4892473
C3	13299496	13300368	BolC3t14898H	0	+	74	525	872	0.6020642
C3	13303952	13304477	BolC3t14899H	0	-	198	525	525	1.0000000
C3	13324775	13327419	BolC3t14900H	0	+	1268	2519	2644	0.9527231
C3	13328936	13329605	BolC3t14901H	0	-	679	669	669	1.0000000
C3	13330654	13332408	BolC3t14902H	0	-	1278	1714	1754	0.9771950
C3	13337329	13339228	BolC3t14903H	0	+	283	1105	1899	0.5818852
C3	13356395	13357383	BolC3t14904H	0	-	1	89	988	0.0900810
C3	13359916	13361930	BolC3t14905H	0	+	472	1622	2014	0.8053625
C3	13368131	13370809	BolC3t14906H	0	+	130	1094	2678	0.4085138
C3	13371027	13371198	BolC3t14907H	0	+	0	0	171	0.0000000
C3	13376034	13376205	BolC3t14908H	0	-	8	148	171	0.8654971
C3	13378282	13379530	BolC3t14909H	0	-	2	39	1248	0.0312500
C3	13380351	13380941	BolC3t14910H	0	-	0	0	590	0.0000000
C3	13384671	13384959	BolC3t14911H	0	+	0	0	288	0.0000000
C3	13434600	13435472	BolC3t14912H	0	+	0	0	872	0.0000000
C3	13437488	13438417	BolC3t14913H	0	+	103	872	929	0.9386437
C3	13440978	13447422	BolC3t14914H	0	-	670	4248	6444	0.6592179
C3	13451156	13451818	BolC3t14915H	0	+	111	640	662	0.9667674
C3	13454858	13456824	BolC3t14916H	0	+	484	1527	1966	0.7767040
C3	13462210	13463503	BolC3t14917H	0	-	121	1122	1293	0.8677494
C3	13471369	13473146	BolC3t14918H	0	-	700	1549	1777	0.8716938
C3	13478589	13480050	BolC3t14919H	0	+	480	1359	1461	0.9301848
C3	13480628	13482231	BolC3t14920H	0	-	1438	1603	1603	1.0000000
C3	13484438	13487890	BolC3t14921H	0	+	2666	3383	3452	0.9800116
C3	13488517	13489506	BolC3t14922H	0	-	179	975	989	0.9858443
C3	13491120	13491935	BolC3t14923H	0	-	94	574	815	0.7042945
C3	13492678	13493732	BolC3t14924H	0	+	290	1054	1054	1.0000000
C3	13500608	13501463	BolC3t14925H	0	+	476	855	855	1.0000000
C3	13502936	13503279	BolC3t14926H	0	-	339	343	343	1.0000000
C3	13510404	13511520	BolC3t14927H	0	+	1159	1055	1116	0.9453405
C3	13512188	13514272	BolC3t14928H	0	-	858	1982	2084	0.9510556
C3	13525586	13526489	BolC3t14929H	0	+	714	883	903	0.9778516
C3	13527387	13530806	BolC3t14930H	0	+	1103	3244	3419	0.9488155
C3	13531568	13532831	BolC3t14931H	0	+	354	1256	1263	0.9944577
C3	13533262	13533506	BolC3t14932H	0	-	54	222	244	0.9098361
C3	13535741	13536451	BolC3t14933H	0	-	29	254	710	0.3577465
C3	13544446	13545142	BolC3t14934H	0	-	2	18	696	0.0258621
C3	13550184	13553892	BolC3t14935H	0	-	2078	3322	3708	0.8959007
C3	13555221	13557181	BolC3t14936H	0	-	431	1677	1960	0.8556122
C3	13564807	13567373	BolC3t14937H	0	+	401	2366	2566	0.9220577
C3	13567780	13569659	BolC3t14938H	0	-	1503	1879	1879	1.0000000
C3	13570957	13571693	BolC3t14939H	0	-	514	736	736	1.0000000
C3	13572798	13574648	BolC3t14940H	0	+	2472	1850	1850	1.0000000
C3	13575194	13576556	BolC3t14941H	0	-	1086	1362	1362	1.0000000
C3	13577944	13578552	BolC3t14942H	0	+	468	608	608	1.0000000
C3	13582318	13583446	BolC3t14943H	0	-	232	1064	1128	0.9432624
C3	13584067	13585671	BolC3t14944H	0	-	780	1604	1604	1.0000000
C3	13588082	13589617	BolC3t14945H	0	+	677	1446	1535	0.9420195
C3	13590672	13593537	BolC3t14946H	0	+	2153	2758	2865	0.9626527
C3	13593920	13594493	BolC3t14947H	0	-	351	573	573	1.0000000
C3	13596495	13599065	BolC3t14948H	0	+	780	2224	2570	0.8653697
C3	13599883	13600207	BolC3t14949H	0	-	52	324	324	1.0000000
C3	13601463	13602984	BolC3t14950H	0	+	1181	1521	1521	1.0000000
C3	13603575	13604507	BolC3t14951H	0	-	837	932	932	1.0000000
C3	13605917	13607083	BolC3t14952H	0	+	183	948	1166	0.8130360
C3	13610440	13611610	BolC3t14953H	0	+	36	576	1170	0.4923077
C3	13613445	13617519	BolC3t14954H	0	+	2950	4019	4074	0.9864997
C3	13619149	13619323	BolC3t14955H	0	-	304	174	174	1.0000000
C3	13621902	13622575	BolC3t14956H	0	+	74	174	673	0.2585438
C3	13625626	13627315	BolC3t14957H	0	+	1170	1656	1689	0.9804618
C3	13629009	13630052	BolC3t14958H	0	+	738	1043	1043	1.0000000
C3	13631183	13632745	BolC3t14959H	0	+	957	1506	1562	0.9641485
C3	13633475	13633723	BolC3t14960H	0	-	69	247	248	0.9959677
C3	13634473	13636983	BolC3t14961H	0	-	205	2039	2510	0.8123506
C3	13639170	13641519	BolC3t14962H	0	-	451	1400	2349	0.5959983
C3	13660896	13662504	BolC3t14963H	0	+	95	1074	1608	0.6679105
C3	13664707	13667859	BolC3t14964H	0	+	669	1853	3152	0.5878807
C3	13687850	13688280	BolC3t14965H	0	-	4	149	430	0.3465116
C3	13700681	13701020	BolC3t14966H	0	-	0	0	339	0.0000000
C3	13710147	13710486	BolC3t14967H	0	-	366	339	339	1.0000000
C3	13726602	13729237	BolC3t14968H	0	+	278	1659	2635	0.6296015
C3	13735044	13735272	BolC3t14969H	0	-	6	77	228	0.3377193
C3	13737350	13739728	BolC3t14970H	0	+	271	1944	2378	0.8174937
C3	13740153	13741259	BolC3t14971H	0	-	1210	1106	1106	1.0000000
C3	13760602	13766958	BolC3t14972H	0	+	391	2048	6356	0.3222152
C3	13768008	13768707	BolC3t14973H	0	-	179	699	699	1.0000000
C3	13769187	13771089	BolC3t14974H	0	+	497	1320	1902	0.6940063
C3	13773785	13777188	BolC3t14975H	0	-	1347	2953	3403	0.8677638
C3	13778079	13793880	BolC3t14976H	0	-	3790	11672	15801	0.7386874
C3	13797520	13798759	BolC3t14977H	0	+	828	1239	1239	1.0000000
C3	13799843	13801221	BolC3t14978H	0	-	128	1023	1378	0.7423803
C3	13803270	13804960	BolC3t14979H	0	-	1766	1690	1690	1.0000000
C3	13805241	13805946	BolC3t14980H	0	-	662	705	705	1.0000000
C3	13824106	13826470	BolC3t14981H	0	-	324	1490	2364	0.6302876
C3	13842704	13847966	BolC3t14982H	0	+	1117	3740	5262	0.7107564
C3	13848423	13853272	BolC3t14983H	0	-	2104	4604	4849	0.9494741
C3	13880820	13884129	BolC3t14984H	0	-	533	2573	3309	0.7775763
C3	13884132	13884604	BolC3t14985H	0	-	182	472	472	1.0000000
C3	13905749	13907770	BolC3t14986H	0	-	577	1958	2021	0.9688273
C3	13908142	13911518	BolC3t14987H	0	-	293	2214	3376	0.6558057
C3	13911556	13912028	BolC3t14988H	0	-	260	472	472	1.0000000
C3	13932994	13935610	BolC3t14989H	0	-	283	1994	2616	0.7622324
C3	13948889	13951044	BolC3t14990H	0	-	312	1883	2155	0.8737819
C3	13960581	13967744	BolC3t14991H	0	-	877	4906	7163	0.6849086
C3	13968888	13969071	BolC3t14992H	0	-	4	133	183	0.7267759
C3	13975418	13975640	BolC3t14993H	0	+	98	214	222	0.9639640
C3	13976773	13978086	BolC3t14994H	0	+	1055	1313	1313	1.0000000
C3	13981113	13981260	BolC3t14995H	0	-	112	147	147	1.0000000
C3	13982694	13984678	BolC3t14996H	0	-	705	1299	1984	0.6547379
C3	13985354	13986081	BolC3t14997H	0	-	41	600	727	0.8253095
C3	13986328	13986984	BolC3t14998H	0	+	146	614	656	0.9359756
C3	13989606	13992054	BolC3t14999H	0	-	314	2227	2448	0.9097222
C3	13994264	13995003	BolC3t15000H	0	-	647	739	739	1.0000000
C3	13997222	13997756	BolC3t15001H	0	-	233	534	534	1.0000000
C3	13999585	14004867	BolC3t15002H	0	-	1643	4257	5282	0.8059447
C3	14005578	14009843	BolC3t15003H	0	+	1697	4110	4265	0.9636577
C3	14010945	14011875	BolC3t15004H	0	+	301	930	930	1.0000000
C3	14012180	14013725	BolC3t15005H	0	-	471	1500	1545	0.9708738
C3	14015850	14016832	BolC3t15006H	0	+	568	982	982	1.0000000
C3	14017409	14017714	BolC3t15007H	0	+	376	305	305	1.0000000
C3	14018270	14024669	BolC3t15008H	0	-	1630	4074	6399	0.6366620
C3	14026570	14029084	BolC3t15009H	0	-	1072	2418	2514	0.9618139
C3	14029764	14033725	BolC3t15010H	0	-	1580	3349	3961	0.8454936
C3	14034961	14036875	BolC3t15011H	0	-	448	1841	1914	0.9618600
C3	14043348	14045300	BolC3t15012H	0	+	133	985	1952	0.5046107
C3	14047048	14047300	BolC3t15013H	0	-	29	184	252	0.7301587
C3	14047387	14048557	BolC3t15014H	0	-	149	1170	1170	1.0000000
C3	14050473	14051547	BolC3t15015H	0	-	23	763	1074	0.7104283
C3	14061010	14062144	BolC3t15016H	0	-	197	1134	1134	1.0000000
C3	14065709	14065874	BolC3t15017H	0	+	210	165	165	1.0000000
C3	14070028	14072371	BolC3t15018H	0	-	577	1985	2343	0.8472044
C3	14073261	14076244	BolC3t15019H	0	-	781	2240	2983	0.7509219
C3	14078411	14079050	BolC3t15020H	0	-	12	265	639	0.4147105
C3	14080571	14083395	BolC3t15021H	0	+	767	2581	2824	0.9139518
C3	14084133	14084802	BolC3t15022H	0	-	78	499	669	0.7458894
C3	14095451	14097118	BolC3t15023H	0	+	843	1491	1667	0.8944211
C3	14098202	14102001	BolC3t15024H	0	-	749	3685	3799	0.9699921
C3	14105474	14105709	BolC3t15025H	0	+	6	91	235	0.3872340
C3	14112158	14114065	BolC3t15026H	0	-	836	1907	1907	1.0000000
C3	14115944	14118887	BolC3t15027H	0	+	2250	2943	2943	1.0000000
C3	14119592	14123849	BolC3t15028H	0	-	1186	3924	4257	0.9217759
C3	14128755	14128962	BolC3t15029H	0	+	21	207	207	1.0000000
C3	14139232	14140808	BolC3t15030H	0	+	626	1500	1576	0.9517766
C3	14144354	14144861	BolC3t15031H	0	+	0	0	507	0.0000000
C3	14153711	14155914	BolC3t15032H	0	-	48	698	2203	0.3168407
C3	14155959	14156160	BolC3t15033H	0	-	2	70	201	0.3482587
C3	14157250	14159445	BolC3t15034H	0	+	638	2174	2195	0.9904328
C3	14160215	14160927	BolC3t15035H	0	+	233	712	712	1.0000000
C3	14161632	14163449	BolC3t15036H	0	+	504	1794	1817	0.9873418
C3	14163722	14166038	BolC3t15037H	0	-	233	1305	2316	0.5634715
C3	14169179	14169335	BolC3t15038H	0	+	89	156	156	1.0000000
C3	14169553	14169834	BolC3t15039H	0	+	0	0	281	0.0000000
C3	14179208	14179355	BolC3t15040H	0	-	170	143	147	0.9727891
C3	14187424	14192930	BolC3t15041H	0	-	2212	4100	5506	0.7446422
C3	14197393	14197537	BolC3t15042H	0	+	134	144	144	1.0000000
C3	14203016	14204674	BolC3t15043H	0	-	682	1650	1658	0.9951749
C3	14207386	14208655	BolC3t15044H	0	-	281	1263	1269	0.9952719
C3	14218272	14218754	BolC3t15045H	0	-	3	144	482	0.2987552
C3	14219745	14221323	BolC3t15046H	0	-	958	1408	1578	0.8922687
C3	14225125	14227064	BolC3t15047H	0	+	125	1318	1939	0.6797318
C3	14229392	14230687	BolC3t15048H	0	+	428	1295	1295	1.0000000
C3	14238717	14247242	BolC3t15049H	0	+	1424	4848	8525	0.5686803
C3	14247804	14249543	BolC3t15050H	0	+	540	1673	1739	0.9620472
C3	14249871	14252631	BolC3t15051H	0	-	1181	2292	2760	0.8304348
C3	14254797	14255142	BolC3t15052H	0	-	10	159	345	0.4608696
C3	14257183	14258642	BolC3t15053H	0	-	502	1325	1459	0.9081563
C3	14259615	14261186	BolC3t15054H	0	-	1121	1571	1571	1.0000000
C3	14264412	14265218	BolC3t15055H	0	+	92	556	806	0.6898263
C3	14269632	14272215	BolC3t15056H	0	+	373	2357	2583	0.9125049
C3	14276827	14277714	BolC3t15057H	0	-	16	156	887	0.1758737
C3	14278024	14278577	BolC3t15058H	0	-	12	21	553	0.0379747
C3	14280398	14281178	BolC3t15059H	0	+	737	780	780	1.0000000
C3	14301873	14302489	BolC3t15060H	0	-	277	584	616	0.9480519
C3	14303369	14306917	BolC3t15061H	0	+	659	2983	3548	0.8407553
C3	14309348	14311016	BolC3t15062H	0	+	300	1584	1668	0.9496403
C3	14312401	14316379	BolC3t15063H	0	+	909	3275	3978	0.8232780
C3	14316648	14317017	BolC3t15064H	0	-	347	369	369	1.0000000
C3	14321270	14326700	BolC3t15065H	0	+	2561	4597	5430	0.8465930
C3	14335839	14337015	BolC3t15066H	0	+	523	1176	1176	1.0000000
C3	14337258	14362569	BolC3t15067H	0	-	10804	21835	25311	0.8626684
C3	14377790	14378575	BolC3t15068H	0	-	46	742	785	0.9452229
C3	14394755	14395091	BolC3t15069H	0	-	301	336	336	1.0000000
C3	14401816	14403109	BolC3t15070H	0	-	369	1175	1293	0.9087394
C3	14417996	14418804	BolC3t15071H	0	-	143	785	808	0.9715347
C3	14434170	14434551	BolC3t15072H	0	-	746	381	381	1.0000000
C3	14454039	14457663	BolC3t15073H	0	-	2581	3621	3624	0.9991722
C3	14459852	14461566	BolC3t15074H	0	-	1247	1693	1714	0.9877480
C3	14467133	14468757	BolC3t15075H	0	+	476	1624	1624	1.0000000
C3	14472067	14472694	BolC3t15076H	0	-	354	627	627	1.0000000
C3	14487996	14489367	BolC3t15077H	0	-	616	1346	1371	0.9817652
C3	14493333	14494881	BolC3t15078H	0	-	879	1526	1548	0.9857881
C3	14500080	14501188	BolC3t15079H	0	-	678	1108	1108	1.0000000
C3	14504082	14504788	BolC3t15080H	0	-	210	706	706	1.0000000
C3	14507926	14513982	BolC3t15081H	0	+	3141	5245	6056	0.8660832
C3	14519542	14520604	BolC3t15082H	0	-	169	961	1062	0.9048964
C3	14527522	14527702	BolC3t15083H	0	-	82	180	180	1.0000000
C3	14539073	14541093	BolC3t15084H	0	+	715	1921	2020	0.9509901
C3	14550565	14550871	BolC3t15085H	0	+	18	185	306	0.6045752
C3	14552339	14552528	BolC3t15086H	0	-	32	189	189	1.0000000
C3	14558589	14560097	BolC3t15087H	0	-	758	1508	1508	1.0000000
C3	14560456	14561952	BolC3t15088H	0	-	268	879	1496	0.5875669
C3	14573604	14575601	BolC3t15089H	0	-	785	1997	1997	1.0000000
C3	14580089	14580239	BolC3t15090H	0	+	60	150	150	1.0000000
C3	14583034	14583414	BolC3t15091H	0	-	315	380	380	1.0000000
C3	14585535	14587515	BolC3t15092H	0	-	464	1974	1980	0.9969697
C3	14593077	14594581	BolC3t15093H	0	+	1437	1504	1504	1.0000000
C3	14609649	14612205	BolC3t15094H	0	+	996	2322	2556	0.9084507
C3	14612426	14617605	BolC3t15095H	0	-	929	4448	5179	0.8588530
C3	14620400	14622418	BolC3t15096H	0	+	312	1579	2018	0.7824579
C3	14625901	14627472	BolC3t15097H	0	-	159	940	1571	0.5983450
C3	14634155	14634653	BolC3t15098H	0	+	315	498	498	1.0000000
C3	14637629	14637800	BolC3t15099H	0	+	47	171	171	1.0000000
C3	14639219	14640851	BolC3t15100H	0	-	1100	1632	1632	1.0000000
C3	14644797	14645267	BolC3t15101H	0	+	356	389	470	0.8276595
C3	14646014	14646341	BolC3t15102H	0	+	241	327	327	1.0000000
C3	14668782	14670046	BolC3t15103H	0	+	358	1204	1264	0.9525316
C3	14672360	14673630	BolC3t15104H	0	-	1210	1270	1270	1.0000000
C3	14676819	14677652	BolC3t15105H	0	-	439	833	833	1.0000000
C3	14679482	14680710	BolC3t15106H	0	-	497	1228	1228	1.0000000
C3	14682701	14683613	BolC3t15107H	0	+	487	787	912	0.8629386
C3	14685326	14686916	BolC3t15108H	0	+	68	733	1590	0.4610063
C3	14687374	14690303	BolC3t15109H	0	-	1266	2769	2929	0.9453738
C3	14690640	14691086	BolC3t15110H	0	+	428	446	446	1.0000000
C3	14691519	14693838	BolC3t15111H	0	-	393	2033	2319	0.8766710
C3	14698680	14702630	BolC3t15112H	0	-	498	1860	3950	0.4708861
C3	14700246	14701491	BolC3t15113H	0	+	2	50	1245	0.0401606
C3	14708817	14709747	BolC3t15114H	0	-	281	930	930	1.0000000
C3	14713757	14715863	BolC3t15115H	0	+	620	1908	2106	0.9059829
C3	14719119	14719462	BolC3t15116H	0	+	386	343	343	1.0000000
C3	14721597	14723115	BolC3t15117H	0	+	195	1328	1518	0.8748353
C3	14725695	14726086	BolC3t15118H	0	-	12	294	391	0.7519181
C3	14730394	14731902	BolC3t15119H	0	+	1170	1451	1508	0.9622016
C3	14748698	14750331	BolC3t15120H	0	-	1027	1633	1633	1.0000000
C3	14764944	14766120	BolC3t15121H	0	+	607	1176	1176	1.0000000
C3	14771202	14771448	BolC3t15122H	0	+	502	246	246	1.0000000
C3	14772214	14772760	BolC3t15123H	0	+	66	358	546	0.6556777
C3	14773973	14775278	BolC3t15124H	0	+	841	1305	1305	1.0000000
C3	14786230	14787198	BolC3t15125H	0	+	555	941	968	0.9721074
C3	14801243	14801669	BolC3t15126H	0	+	182	426	426	1.0000000
C3	14805565	14808683	BolC3t15127H	0	-	2084	3092	3118	0.9916613
C3	14811080	14812199	BolC3t15128H	0	+	659	1119	1119	1.0000000
C3	14813091	14816232	BolC3t15129H	0	+	571	2841	3141	0.9044890
C3	14817956	14828250	BolC3t15130H	0	+	1165	6713	10294	0.6521274
C3	14830422	14830677	BolC3t15131H	0	-	1	36	255	0.1411765
C3	14838619	14838916	BolC3t15132H	0	+	0	0	297	0.0000000
C3	14839924	14840149	BolC3t15133H	0	+	151	225	225	1.0000000
C3	14852472	14853207	BolC3t15134H	0	+	651	735	735	1.0000000
C3	14854324	14856475	BolC3t15135H	0	-	93	1214	2151	0.5643886
C3	14865142	14867385	BolC3t15136H	0	-	286	1541	2243	0.6870263
C3	14868922	14869444	BolC3t15137H	0	+	276	522	522	1.0000000
C3	14885433	14885961	BolC3t15138H	0	+	37	442	528	0.8371212
C3	14886244	14888154	BolC3t15139H	0	+	91	930	1910	0.4869110
C3	14899605	14900899	BolC3t15140H	0	+	80	1046	1294	0.8083462
C3	14905094	14906092	BolC3t15141H	0	+	147	715	998	0.7164329
C3	14906652	14906898	BolC3t15142H	0	-	1	23	246	0.0934959
C3	14907991	14909594	BolC3t15143H	0	+	1735	1603	1603	1.0000000
C3	14911040	14911393	BolC3t15144H	0	-	366	353	353	1.0000000
C3	14916721	14916996	BolC3t15145H	0	-	98	275	275	1.0000000
C3	14921720	14924052	BolC3t15146H	0	-	522	2280	2332	0.9777015
C3	14932127	14932630	BolC3t15147H	0	+	370	503	503	1.0000000
C3	14933415	14936081	BolC3t15148H	0	+	808	2621	2666	0.9831208
C3	14943302	14943707	BolC3t15149H	0	-	20	405	405	1.0000000
C3	14951904	14952494	BolC3t15150H	0	-	94	428	590	0.7254238
C3	14964435	14965978	BolC3t15151H	0	-	35	333	1543	0.2158134
C3	14985889	14986216	BolC3t15152H	0	+	284	327	327	1.0000000
C3	14991493	14991840	BolC3t15153H	0	-	323	347	347	1.0000000
C3	15010499	15012169	BolC3t15154H	0	-	1218	1626	1670	0.9736527
C3	15014573	15017222	BolC3t15155H	0	+	630	2058	2649	0.7768970
C3	15018890	15020215	BolC3t15156H	0	-	236	916	1325	0.6913208
C3	15027521	15028326	BolC3t15157H	0	-	40	303	805	0.3763975
C3	15033868	15034735	BolC3t15158H	0	+	326	867	867	1.0000000
C3	15047584	15050227	BolC3t15159H	0	-	1198	2615	2643	0.9894060
C3	15058988	15061251	BolC3t15160H	0	+	1068	2201	2263	0.9726027
C3	15061549	15073421	BolC3t15161H	0	-	3285	9844	11872	0.8291779
C3	15074086	15074391	BolC3t15162H	0	-	170	305	305	1.0000000
C3	15077168	15079751	BolC3t15163H	0	-	2289	2583	2583	1.0000000
C3	15081387	15086736	BolC3t15164H	0	-	1779	4951	5349	0.9255936
C3	15089703	15090955	BolC3t15165H	0	+	457	1160	1252	0.9265175
C3	15091211	15093643	BolC3t15166H	0	-	366	2132	2432	0.8766447
C3	15094802	15096491	BolC3t15167H	0	+	842	1689	1689	1.0000000
C3	15098047	15099504	BolC3t15168H	0	-	386	1116	1457	0.7659575
C3	15101931	15103716	BolC3t15169H	0	+	633	1746	1785	0.9781513
C3	15106202	15106388	BolC3t15170H	0	+	52	186	186	1.0000000
C3	15122583	15123339	BolC3t15171H	0	+	275	756	756	1.0000000
C3	15135533	15137028	BolC3t15172H	0	-	1507	1495	1495	1.0000000
C3	15137464	15140477	BolC3t15173H	0	-	2482	2988	3013	0.9917026
C3	15141538	15144764	BolC3t15174H	0	-	819	3055	3226	0.9469932
C3	15146001	15147103	BolC3t15175H	0	-	454	1082	1102	0.9818512
C3	15161453	15162986	BolC3t15176H	0	-	1168	1533	1533	1.0000000
C3	15167780	15169287	BolC3t15177H	0	+	1445	1402	1507	0.9303252
C3	15173582	15174401	BolC3t15178H	0	+	512	819	819	1.0000000
C3	15174957	15176289	BolC3t15179H	0	-	1190	1332	1332	1.0000000
C3	15179667	15180495	BolC3t15180H	0	-	889	828	828	1.0000000
C3	15181172	15181502	BolC3t15181H	0	-	424	330	330	1.0000000
C3	15182769	15184630	BolC3t15182H	0	+	1327	1861	1861	1.0000000
C3	15187306	15193789	BolC3t15183H	0	+	4067	6483	6483	1.0000000
C3	15200072	15200837	BolC3t15184H	0	+	141	221	765	0.2888889
C3	15208195	15208454	BolC3t15185H	0	-	217	259	259	1.0000000
C3	15209677	15210352	BolC3t15186H	0	-	759	675	675	1.0000000
C3	15211603	15213404	BolC3t15187H	0	+	158	1246	1801	0.6918378
C3	15224798	15226841	BolC3t15188H	0	-	550	1500	2043	0.7342144
C3	15231086	15231704	BolC3t15189H	0	+	481	618	618	1.0000000
C3	15234823	15235213	BolC3t15190H	0	+	11	147	390	0.3769231
C3	15242580	15244835	BolC3t15191H	0	-	459	1845	2255	0.8181818
C3	15246641	15252354	BolC3t15192H	0	-	1417	5104	5713	0.8934010
C3	15261101	15264630	BolC3t15193H	0	-	337	2560	3529	0.7254180
C3	15267244	15268734	BolC3t15194H	0	-	415	1316	1490	0.8832214
C3	15270011	15270544	BolC3t15195H	0	-	423	533	533	1.0000000
C3	15270606	15270837	BolC3t15196H	0	+	164	231	231	1.0000000
C3	15276083	15276756	BolC3t15197H	0	-	113	651	673	0.9673105
C3	15278713	15278974	BolC3t15198H	0	+	121	258	261	0.9885057
C3	15280212	15281342	BolC3t15199H	0	-	360	1121	1130	0.9920354
C3	15286361	15286940	BolC3t15200H	0	-	112	561	579	0.9689119
C3	15305750	15308221	BolC3t15201H	0	+	1056	2471	2471	1.0000000
C3	15308859	15310542	BolC3t15202H	0	-	732	1640	1683	0.9744504
C3	15317366	15317584	BolC3t15203H	0	-	281	218	218	1.0000000
C3	15322735	15323269	BolC3t15204H	0	+	40	326	534	0.6104869
C3	15327197	15329237	BolC3t15205H	0	-	1292	1989	2040	0.9750000
C3	15333375	15334728	BolC3t15206H	0	-	1082	1353	1353	1.0000000
C3	15334854	15335457	BolC3t15207H	0	+	432	603	603	1.0000000
C3	15338266	15339295	BolC3t15208H	0	+	1028	1029	1029	1.0000000
C3	15343433	15345648	BolC3t15209H	0	+	1726	2215	2215	1.0000000
C3	15348408	15348762	BolC3t15210H	0	-	358	354	354	1.0000000
C3	15352711	15355467	BolC3t15211H	0	-	684	1892	2756	0.6865022
C3	15363081	15366866	BolC3t15212H	0	+	2518	3682	3785	0.9727873
C3	15367396	15367805	BolC3t15213H	0	-	121	409	409	1.0000000
C3	15383872	15387477	BolC3t15214H	0	+	2017	3587	3605	0.9950069
C3	15392168	15393967	BolC3t15215H	0	+	538	1555	1799	0.8643691
C3	15394575	15398004	BolC3t15216H	0	-	2533	3324	3429	0.9693788
C3	15413381	15415210	BolC3t15217H	0	+	186	1320	1829	0.7217059
C3	15422241	15424788	BolC3t15218H	0	+	709	2284	2547	0.8967413
C3	15425722	15426532	BolC3t15219H	0	+	101	791	810	0.9765432
C3	15426899	15429321	BolC3t15220H	0	-	189	1822	2422	0.7522709
C3	15431372	15431720	BolC3t15221H	0	+	154	343	348	0.9856322
C3	15433133	15433871	BolC3t15222H	0	+	166	729	738	0.9878049
C3	15436950	15437174	BolC3t15223H	0	+	232	224	224	1.0000000
C3	15444937	15446490	BolC3t15224H	0	+	47	883	1553	0.5685769
C3	15447340	15448082	BolC3t15225H	0	-	210	742	742	1.0000000
C3	15452349	15454368	BolC3t15226H	0	-	2989	2019	2019	1.0000000
C3	15504886	15508575	BolC3t15227H	0	+	6318	3192	3689	0.8652751
C3	15529806	15530582	BolC3t15228H	0	+	454	776	776	1.0000000
C3	15532411	15536783	BolC3t15229H	0	+	1981	3893	4372	0.8904392
C3	15537154	15539256	BolC3t15230H	0	-	732	1846	2102	0.8782112
C3	15540901	15541096	BolC3t15231H	0	+	36	98	195	0.5025641
C3	15543403	15543836	BolC3t15232H	0	+	176	431	433	0.9953811
C3	15544360	15547042	BolC3t15233H	0	+	708	2175	2682	0.8109620
C3	15547433	15549317	BolC3t15234H	0	-	1184	1884	1884	1.0000000
C3	15551514	15555236	BolC3t15235H	0	-	2181	3485	3722	0.9363245
C3	15581229	15581594	BolC3t15236H	0	-	239	365	365	1.0000000
C3	15593632	15593993	BolC3t15237H	0	-	9	160	361	0.4432133
C3	15597829	15599657	BolC3t15238H	0	-	994	1698	1828	0.9288840
C3	15602512	15602716	BolC3t15239H	0	-	195	204	204	1.0000000
C3	15605662	15607453	BolC3t15240H	0	-	588	1791	1791	1.0000000
C3	15609100	15609510	BolC3t15241H	0	+	109	410	410	1.0000000
C3	15614562	15615185	BolC3t15242H	0	+	126	591	623	0.9486356
C3	15615412	15620668	BolC3t15243H	0	-	1478	4084	5256	0.7770168
C3	15620938	15622624	BolC3t15244H	0	+	1034	1639	1686	0.9721234
C3	15623010	15623181	BolC3t15245H	0	+	44	171	171	1.0000000
C3	15625706	15625877	BolC3t15246H	0	-	159	171	171	1.0000000
C3	15626466	15628653	BolC3t15247H	0	-	424	1895	2187	0.8664837
C3	15630468	15631627	BolC3t15248H	0	-	1109	1159	1159	1.0000000
C3	15631813	15633073	BolC3t15249H	0	-	463	1260	1260	1.0000000
C3	15661199	15664674	BolC3t15250H	0	+	683	2739	3475	0.7882015
C3	15666775	15668684	BolC3t15251H	0	+	796	1889	1909	0.9895233
C3	15669711	15671413	BolC3t15252H	0	-	673	1481	1702	0.8701528
C3	15679934	15681111	BolC3t15253H	0	-	183	878	1177	0.7459643
C3	15686167	15702025	BolC3t15254H	0	-	2971	8109	15858	0.5113508
C3	15713943	15715328	BolC3t15255H	0	-	156	1023	1385	0.7386281
C3	15716344	15725525	BolC3t15256H	0	-	7384	8940	9181	0.9737501
C3	15717817	15718656	BolC3t15257H	0	+	1071	839	839	1.0000000
C3	15740162	15740351	BolC3t15258H	0	+	43	17	189	0.0899471
C3	15744219	15745660	BolC3t15259H	0	-	35	724	1441	0.5024289
C3	15746315	15747024	BolC3t15260H	0	-	368	709	709	1.0000000
C3	15747672	15770438	BolC3t15261H	0	+	5218	17683	22766	0.7767285
C3	15771096	15771222	BolC3t15262H	0	+	146	126	126	1.0000000
C3	15773404	15775601	BolC3t15263H	0	+	1097	2123	2197	0.9663177
C3	15776832	15777352	BolC3t15264H	0	-	481	520	520	1.0000000
C3	15780082	15780942	BolC3t15265H	0	-	402	816	860	0.9488372
C3	15787059	15788719	BolC3t15266H	0	-	1151	1599	1660	0.9632530
C3	15791991	15792539	BolC3t15267H	0	-	250	548	548	1.0000000
C3	15794374	15796510	BolC3t15268H	0	+	983	2019	2136	0.9452247
C3	15797699	15799526	BolC3t15269H	0	+	489	1613	1827	0.8828681
C3	15810108	15812941	BolC3t15270H	0	+	728	2495	2833	0.8806918
C3	15816280	15817724	BolC3t15271H	0	+	22	562	1444	0.3891967
C3	15821210	15821336	BolC3t15272H	0	+	164	126	126	1.0000000
C3	15823554	15825001	BolC3t15273H	0	+	242	1104	1447	0.7629579
C3	15827940	15829611	BolC3t15274H	0	+	313	1469	1671	0.8791143
C3	15830932	15833194	BolC3t15275H	0	-	425	815	2262	0.3603006
C3	15838687	15840897	BolC3t15276H	0	-	504	1658	2210	0.7502263
C3	15851121	15856464	BolC3t15277H	0	-	543	3644	5343	0.6820139
C3	15857286	15862324	BolC3t15278H	0	-	2847	4930	5038	0.9785630
C3	15858770	15859457	BolC3t15279H	0	+	590	687	687	1.0000000
C3	15862374	15864285	BolC3t15280H	0	-	764	1665	1911	0.8712716
C3	15864612	15866540	BolC3t15281H	0	-	1126	1920	1928	0.9958506
C3	15866821	15868795	BolC3t15282H	0	+	491	1642	1974	0.8318136
C3	15871321	15871945	BolC3t15283H	0	+	26	172	624	0.2756410
C3	15874217	15874508	BolC3t15284H	0	+	204	275	291	0.9450172
C3	15875158	15876864	BolC3t15285H	0	-	787	1706	1706	1.0000000
C3	15877195	15878983	BolC3t15286H	0	+	513	1788	1788	1.0000000
C3	15879801	15880791	BolC3t15287H	0	+	221	762	990	0.7696970
C3	15885221	15886737	BolC3t15288H	0	+	517	1184	1516	0.7810026
C3	15892736	15893446	BolC3t15289H	0	+	192	595	710	0.8380282
C3	15893756	15893921	BolC3t15290H	0	-	74	165	165	1.0000000
C3	15923968	15925141	BolC3t15291H	0	+	912	1173	1173	1.0000000
C3	15926810	15929440	BolC3t15292H	0	+	468	1539	2630	0.5851711
C3	15932177	15934905	BolC3t15293H	0	-	416	1842	2728	0.6752200
C3	15935353	15937121	BolC3t15294H	0	+	504	1740	1768	0.9841629
C3	15937563	15939306	BolC3t15295H	0	+	309	1567	1743	0.8990247
C3	15942791	15946226	BolC3t15296H	0	+	208	547	3435	0.1592431
C3	15948196	15950114	BolC3t15297H	0	+	184	1401	1918	0.7304484
C3	15963230	15963470	BolC3t15298H	0	+	193	240	240	1.0000000
C3	15967156	15972046	BolC3t15299H	0	+	1126	3942	4890	0.8061350
C3	15974918	15975563	BolC3t15300H	0	+	15	251	645	0.3891473
C3	15978919	15979348	BolC3t15301H	0	+	111	412	429	0.9603730
C3	15999983	16000517	BolC3t15302H	0	+	184	424	534	0.7940075
C3	16005649	16006096	BolC3t15303H	0	+	101	379	447	0.8478747
C3	16019355	16023100	BolC3t15304H	0	+	2253	3683	3745	0.9834446
C3	16025004	16025733	BolC3t15305H	0	-	442	729	729	1.0000000
C3	16026665	16030475	BolC3t15306H	0	-	2044	3711	3810	0.9740158
C3	16031105	16032470	BolC3t15307H	0	+	950	1365	1365	1.0000000
C3	16032650	16034569	BolC3t15308H	0	-	681	1919	1919	1.0000000
C3	16038633	16040089	BolC3t15309H	0	-	1257	1456	1456	1.0000000
C3	16040428	16041115	BolC3t15310H	0	+	291	687	687	1.0000000
C3	16041580	16043424	BolC3t15311H	0	+	315	1711	1844	0.9278742
C3	16047760	16048148	BolC3t15312H	0	+	143	345	388	0.8891752
C3	16049474	16050551	BolC3t15313H	0	-	258	851	1077	0.7901579
C3	16051198	16052260	BolC3t15314H	0	-	165	815	1062	0.7674199
C3	16054508	16055493	BolC3t15315H	0	-	206	978	985	0.9928934
C3	16061949	16062120	BolC3t15316H	0	+	117	171	171	1.0000000
C3	16063783	16065544	BolC3t15317H	0	+	977	1761	1761	1.0000000
C3	16068208	16071363	BolC3t15318H	0	-	719	2560	3155	0.8114105
C3	16082326	16083040	BolC3t15319H	0	-	247	714	714	1.0000000
C3	16086320	16087974	BolC3t15320H	0	+	1064	1609	1654	0.9727932
C3	16090025	16090850	BolC3t15321H	0	-	97	585	825	0.7090909
C3	16093822	16099050	BolC3t15322H	0	+	6	251	5228	0.0480107
C3	16112166	16115397	BolC3t15323H	0	-	694	2627	3231	0.8130610
C3	16118821	16119583	BolC3t15324H	0	+	581	762	762	1.0000000
C3	16120102	16123217	BolC3t15325H	0	-	603	2358	3115	0.7569823
C3	16148771	16149602	BolC3t15326H	0	+	307	690	831	0.8303249
C3	16162148	16164645	BolC3t15327H	0	-	704	2400	2497	0.9611534
C3	16182289	16183071	BolC3t15328H	0	+	50	234	782	0.2992328
C3	16184087	16184579	BolC3t15329H	0	-	26	152	492	0.3089431
C3	16184718	16185093	BolC3t15330H	0	-	48	288	375	0.7680000
C3	16186170	16187672	BolC3t15331H	0	+	235	1326	1502	0.8828229
C3	16189789	16193269	BolC3t15332H	0	-	947	3199	3480	0.9192529
C3	16198650	16199535	BolC3t15333H	0	+	147	885	885	1.0000000
C3	16202736	16204383	BolC3t15334H	0	+	755	1303	1647	0.7911354
C3	16205502	16207296	BolC3t15335H	0	+	832	1601	1794	0.8924192
C3	16207860	16209659	BolC3t15336H	0	+	498	1753	1799	0.9744303
C3	16214484	16216299	BolC3t15337H	0	-	126	1471	1815	0.8104683
C3	16223148	16223973	BolC3t15338H	0	+	218	752	825	0.9115152
C3	16225859	16226255	BolC3t15339H	0	+	127	396	396	1.0000000
C3	16239432	16242386	BolC3t15340H	0	-	773	2235	2954	0.7566012
C3	16256612	16258199	BolC3t15341H	0	-	651	1566	1587	0.9867675
C3	16259675	16260531	BolC3t15342H	0	-	279	856	856	1.0000000
C3	16268881	16269367	BolC3t15343H	0	+	7	141	486	0.2901235
C3	16273278	16275175	BolC3t15344H	0	-	198	1109	1897	0.5846073
C3	16280447	16281689	BolC3t15345H	0	-	230	1125	1242	0.9057971
C3	16288432	16288672	BolC3t15346H	0	-	188	240	240	1.0000000
C3	16303380	16305608	BolC3t15347H	0	+	856	2153	2228	0.9663375
C3	16306874	16308182	BolC3t15348H	0	+	52	692	1308	0.5290520
C3	16308365	16310183	BolC3t15349H	0	-	378	1505	1818	0.8278328
C3	16310501	16313183	BolC3t15350H	0	-	316	2118	2682	0.7897092
C3	16325112	16325460	BolC3t15351H	0	+	25	248	348	0.7126437
C3	16329086	16329290	BolC3t15352H	0	-	4	122	204	0.5980392
C3	16329713	16330059	BolC3t15353H	0	-	15	100	346	0.2890173
C3	16330151	16330608	BolC3t15354H	0	-	0	0	457	0.0000000
C3	16335415	16335736	BolC3t15355H	0	+	15	214	321	0.6666667
C3	16346946	16375914	BolC3t15356H	0	+	10182	22114	28968	0.7633941
C3	16349329	16349974	BolC3t15357H	0	-	152	394	645	0.6108527
C3	16351255	16352461	BolC3t15358H	0	+	100	583	1206	0.4834163
C3	16358417	16360404	BolC3t15359H	0	+	588	1710	1987	0.8605939
C3	16363915	16365843	BolC3t15360H	0	+	190	1100	1928	0.5705394
C3	16366850	16367664	BolC3t15361H	0	-	173	804	814	0.9877150
C3	16378720	16378924	BolC3t15362H	0	+	17	101	204	0.4950980
C3	16380266	16380467	BolC3t15363H	0	+	12	75	201	0.3731343
C3	16388802	16389911	BolC3t15364H	0	+	915	1109	1109	1.0000000
C3	16399551	16401979	BolC3t15365H	0	-	1284	2245	2428	0.9246293
C3	16426244	16429481	BolC3t15366H	0	-	1647	3237	3237	1.0000000
C3	16431344	16432226	BolC3t15367H	0	-	72	550	882	0.6235828
C3	16432957	16433720	BolC3t15368H	0	+	608	650	763	0.8519004
C3	16442086	16443843	BolC3t15369H	0	-	335	1210	1757	0.6886739
C3	16444229	16444845	BolC3t15370H	0	+	381	616	616	1.0000000
C3	16445390	16445516	BolC3t15371H	0	-	223	126	126	1.0000000
C3	16446217	16446718	BolC3t15372H	0	+	369	501	501	1.0000000
C3	16451814	16453134	BolC3t15373H	0	+	341	1320	1320	1.0000000
C3	16453387	16455539	BolC3t15374H	0	-	363	1965	2152	0.9131041
C3	16456241	16457480	BolC3t15375H	0	+	366	1107	1239	0.8934625
C3	16457925	16458537	BolC3t15376H	0	-	22	151	612	0.2467320
C3	16482822	16484902	BolC3t15377H	0	+	802	1780	2080	0.8557692
C3	16485287	16486212	BolC3t15378H	0	-	111	896	925	0.9686487
C3	16495139	16496561	BolC3t15379H	0	-	853	1422	1422	1.0000000
C3	16499078	16500298	BolC3t15380H	0	-	802	1188	1220	0.9737705
C3	16517992	16520007	BolC3t15381H	0	-	430	1497	2015	0.7429280
C3	16525171	16531531	BolC3t15382H	0	+	1044	5491	6360	0.8633648
C3	16533585	16534354	BolC3t15383H	0	-	1089	769	769	1.0000000
C3	16535132	16543262	BolC3t15384H	0	+	410	1911	8130	0.2350554
C3	16543689	16544841	BolC3t15385H	0	-	445	1152	1152	1.0000000
C3	16547080	16548543	BolC3t15386H	0	-	1117	1411	1463	0.9644566
C3	16550470	16557547	BolC3t15387H	0	-	7212	6740	7077	0.9523810
C3	16566071	16566346	BolC3t15388H	0	-	114	275	275	1.0000000
C3	16573608	16574922	BolC3t15389H	0	+	1414	1314	1314	1.0000000
C3	16576678	16577562	BolC3t15390H	0	+	1209	805	884	0.9106335
C3	16580286	16581116	BolC3t15391H	0	+	1088	830	830	1.0000000
C3	16581904	16583848	BolC3t15392H	0	+	1572	1944	1944	1.0000000
C3	16586438	16588533	BolC3t15393H	0	+	930	2045	2095	0.9761336
C3	16595799	16597403	BolC3t15394H	0	+	1513	1604	1604	1.0000000
C3	16598893	16599640	BolC3t15395H	0	+	101	680	747	0.9103079
C3	16607176	16608017	BolC3t15396H	0	+	664	841	841	1.0000000
C3	16616346	16616717	BolC3t15397H	0	+	22	371	371	1.0000000
C3	16617537	16617765	BolC3t15398H	0	+	33	219	228	0.9605263
C3	16619192	16619384	BolC3t15399H	0	-	76	123	192	0.6406250
C3	16622967	16626748	BolC3t15400H	0	-	1538	3198	3781	0.8458080
C3	16630263	16631288	BolC3t15401H	0	-	1389	1025	1025	1.0000000
C3	16637098	16637480	BolC3t15402H	0	-	194	382	382	1.0000000
C3	16640444	16649123	BolC3t15403H	0	+	5888	8463	8679	0.9751123
C3	16651232	16651652	BolC3t15404H	0	+	166	420	420	1.0000000
C3	16652282	16652854	BolC3t15405H	0	-	696	572	572	1.0000000
C3	16654565	16657102	BolC3t15406H	0	-	10	359	2537	0.1415057
C3	16657754	16658081	BolC3t15407H	0	-	226	327	327	1.0000000
C3	16666027	16667336	BolC3t15408H	0	-	24	411	1309	0.3139801
C3	16668841	16669524	BolC3t15409H	0	-	361	683	683	1.0000000
C3	16669780	16670140	BolC3t15410H	0	+	20	360	360	1.0000000
C3	16677518	16679569	BolC3t15411H	0	+	1040	2051	2051	1.0000000
C3	16683420	16683804	BolC3t15412H	0	+	252	384	384	1.0000000
C3	16685260	16687046	BolC3t15413H	0	-	267	1633	1786	0.9143337
C3	16688735	16689155	BolC3t15414H	0	-	174	420	420	1.0000000
C3	16706111	16708043	BolC3t15415H	0	+	12	102	1932	0.0527950
C3	16711005	16713836	BolC3t15416H	0	+	1940	2614	2831	0.9233487
C3	16725972	16726209	BolC3t15417H	0	+	1	23	237	0.0970464
C3	16728490	16728895	BolC3t15418H	0	+	33	255	405	0.6296296
C3	16729305	16729916	BolC3t15419H	0	-	234	565	611	0.9247136
C3	16733483	16733815	BolC3t15420H	0	+	252	332	332	1.0000000
C3	16761857	16762808	BolC3t15421H	0	+	66	534	951	0.5615142
C3	16767787	16769934	BolC3t15422H	0	+	2089	2147	2147	1.0000000
C3	16775966	16776828	BolC3t15423H	0	-	80	772	862	0.8955917
C3	16781982	16783003	BolC3t15424H	0	-	151	890	1021	0.8716944
C3	16784890	16786735	BolC3t15425H	0	-	406	1784	1845	0.9669377
C3	16787609	16789600	BolC3t15426H	0	-	42	622	1991	0.3124058
C3	16798761	16799412	BolC3t15427H	0	-	26	163	651	0.2503840
C3	16800049	16800575	BolC3t15428H	0	-	504	526	526	1.0000000
C3	16805388	16805862	BolC3t15429H	0	+	59	393	474	0.8291139
C3	16806089	16807565	BolC3t15430H	0	-	444	1257	1476	0.8516260
C3	16808847	16812697	BolC3t15431H	0	-	1295	3477	3850	0.9031169
C3	16823374	16823779	BolC3t15432H	0	+	52	352	405	0.8691358
C3	16834073	16837015	BolC3t15433H	0	-	645	2523	2942	0.8575799
C3	16844925	16845842	BolC3t15434H	0	+	20	351	917	0.3827699
C3	16867468	16868014	BolC3t15435H	0	+	399	546	546	1.0000000
C3	16875172	16875325	BolC3t15436H	0	-	263	153	153	1.0000000
C3	16877868	16884968	BolC3t15437H	0	+	5134	6779	7100	0.9547887
C3	16886262	16887516	BolC3t15438H	0	+	9	316	1254	0.2519936
C3	16887707	16890625	BolC3t15439H	0	-	819	2606	2918	0.8930774
C3	16897143	16897533	BolC3t15440H	0	-	509	390	390	1.0000000
C3	16927896	16931479	BolC3t15441H	0	+	2915	3530	3583	0.9852079
C3	16933058	16935774	BolC3t15442H	0	-	1072	2159	2716	0.7949190
C3	16945136	16947359	BolC3t15443H	0	+	170	1871	2223	0.8416554
C3	16949727	16951140	BolC3t15444H	0	+	147	870	1413	0.6157113
C3	16952982	16953177	BolC3t15445H	0	+	151	195	195	1.0000000
C3	16953772	16954150	BolC3t15446H	0	+	170	378	378	1.0000000
C3	16957889	16959005	BolC3t15447H	0	+	739	1116	1116	1.0000000
C3	16962210	16965130	BolC3t15448H	0	+	2124	2920	2920	1.0000000
C3	16966208	16967435	BolC3t15449H	0	+	851	1227	1227	1.0000000
C3	16974215	16977416	BolC3t15450H	0	+	2021	2891	3201	0.9031553
C3	16978925	16981174	BolC3t15451H	0	+	770	2078	2249	0.9239662
C3	16988827	16989761	BolC3t15452H	0	-	205	912	934	0.9764454
C3	16992172	16993103	BolC3t15453H	0	+	372	915	931	0.9828142
C3	16993398	16996846	BolC3t15454H	0	-	979	3036	3448	0.8805104
C3	16996915	16997807	BolC3t15455H	0	-	890	892	892	1.0000000
C3	17016390	17016864	BolC3t15456H	0	-	117	474	474	1.0000000
C3	17040391	17042524	BolC3t15457H	0	+	247	1562	2133	0.7323020
C3	17042806	17045297	BolC3t15458H	0	-	368	2088	2491	0.8382176
C3	17045869	17046585	BolC3t15459H	0	-	205	716	716	1.0000000
C3	17050477	17052819	BolC3t15460H	0	+	495	1892	2342	0.8078566
C3	17054715	17055024	BolC3t15461H	0	+	166	309	309	1.0000000
C3	17058910	17059336	BolC3t15462H	0	+	29	295	426	0.6924883
C3	17062513	17062939	BolC3t15463H	0	-	151	426	426	1.0000000
C3	17063530	17069576	BolC3t15464H	0	-	1187	5404	6046	0.8938141
C3	17073194	17085636	BolC3t15465H	0	+	5860	11683	12442	0.9389970
C3	17081035	17081305	BolC3t15466H	0	+	23	137	270	0.5074074
C3	17088476	17091101	BolC3t15467H	0	-	765	2383	2625	0.9078095
C3	17092046	17094716	BolC3t15468H	0	-	753	2134	2670	0.7992510
C3	17095192	17098780	BolC3t15469H	0	-	1292	3201	3588	0.8921404
C3	17113357	17113981	BolC3t15470H	0	-	356	624	624	1.0000000
C3	17117133	17118471	BolC3t15471H	0	-	752	1338	1338	1.0000000
C3	17123586	17124338	BolC3t15472H	0	+	93	490	752	0.6515958
C3	17129963	17131743	BolC3t15473H	0	+	218	1442	1780	0.8101124
C3	17133770	17135234	BolC3t15474H	0	-	220	1204	1464	0.8224044
C3	17145318	17146483	BolC3t15475H	0	-	551	1165	1165	1.0000000
C3	17146993	17148143	BolC3t15476H	0	-	357	897	1150	0.7800000
C3	17149151	17150300	BolC3t15477H	0	+	126	774	1149	0.6736292
C3	17157333	17158911	BolC3t15478H	0	-	7	306	1578	0.1939164
C3	17169084	17169213	BolC3t15479H	0	+	112	129	129	1.0000000
C3	17185551	17185974	BolC3t15480H	0	+	99	402	423	0.9503546
C3	17187633	17189078	BolC3t15481H	0	+	143	747	1445	0.5169550
C3	17191245	17191640	BolC3t15482H	0	+	564	395	395	1.0000000
C3	17211005	17213010	BolC3t15483H	0	-	424	1599	2005	0.7975062
C3	17227121	17227433	BolC3t15484H	0	+	282	312	312	1.0000000
C3	17228455	17228794	BolC3t15485H	0	-	63	277	339	0.8171092
C3	17229756	17230212	BolC3t15486H	0	-	124	239	456	0.5241228
C3	17237854	17238007	BolC3t15487H	0	-	230	153	153	1.0000000
C3	17239721	17240989	BolC3t15488H	0	-	852	1268	1268	1.0000000
C3	17257480	17258585	BolC3t15489H	0	-	100	846	1105	0.7656109
C3	17278252	17280167	BolC3t15490H	0	-	403	1817	1915	0.9488251
C3	17291205	17291562	BolC3t15491H	0	+	76	357	357	1.0000000
C3	17299947	17302151	BolC3t15492H	0	+	557	1722	2204	0.7813067
C3	17305567	17306796	BolC3t15493H	0	-	22	322	1229	0.2620016
C3	17310039	17313269	BolC3t15494H	0	+	4862	3230	3230	1.0000000
C3	17314750	17315751	BolC3t15495H	0	-	1760	1001	1001	1.0000000
C3	17317179	17317647	BolC3t15496H	0	-	1024	468	468	1.0000000
C3	17328837	17330015	BolC3t15497H	0	-	28	219	1178	0.1859083
C3	17345612	17346692	BolC3t15498H	0	+	583	1080	1080	1.0000000
C3	17349416	17351199	BolC3t15499H	0	+	679	1783	1783	1.0000000
C3	17365921	17371207	BolC3t15500H	0	-	404	3719	5286	0.7035565
C3	17375929	17376334	BolC3t15501H	0	-	67	405	405	1.0000000
C3	17385970	17386141	BolC3t15502H	0	+	437	171	171	1.0000000
C3	17394995	17396560	BolC3t15503H	0	+	729	1177	1565	0.7520767
C3	17407125	17409594	BolC3t15504H	0	-	2015	2469	2469	1.0000000
C3	17413297	17414584	BolC3t15505H	0	+	201	959	1287	0.7451438
C3	17418314	17421850	BolC3t15506H	0	+	384	2039	3536	0.5766402
C3	17430748	17434381	BolC3t15507H	0	+	475	2378	3633	0.6545554
C3	17443583	17444715	BolC3t15508H	0	+	2	187	1132	0.1651943
C3	17446079	17447080	BolC3t15509H	0	-	1097	1001	1001	1.0000000
C3	17450281	17451589	BolC3t15510H	0	-	33	478	1308	0.3654434
C3	17458511	17459395	BolC3t15511H	0	+	527	823	884	0.9309955
C3	17468127	17468832	BolC3t15512H	0	-	246	617	705	0.8751773
C3	17480293	17480479	BolC3t15513H	0	-	0	0	186	0.0000000
C3	17487033	17487411	BolC3t15514H	0	+	16	263	378	0.6957672
C3	17501749	17502705	BolC3t15515H	0	-	707	956	956	1.0000000
C3	17545299	17547698	BolC3t15516H	0	-	697	1421	2399	0.5923302
C3	17555240	17562503	BolC3t15517H	0	-	812	5062	7263	0.6969572
C3	17565177	17565441	BolC3t15518H	0	+	522	264	264	1.0000000
C3	17566126	17566833	BolC3t15519H	0	-	258	678	707	0.9589816
C3	17571495	17572323	BolC3t15520H	0	+	245	815	828	0.9842995
C3	17579082	17581573	BolC3t15521H	0	-	1297	2491	2491	1.0000000
C3	17589225	17590152	BolC3t15522H	0	+	156	713	927	0.7691478
C3	17609498	17610008	BolC3t15523H	0	+	168	510	510	1.0000000
C3	17613579	17617132	BolC3t15524H	0	-	876	2922	3553	0.8224036
C3	17632689	17633154	BolC3t15525H	0	+	41	333	465	0.7161290
C3	17643696	17644812	BolC3t15526H	0	+	643	926	1116	0.8297491
C3	17649914	17650803	BolC3t15527H	0	+	249	889	889	1.0000000
C3	17650993	17652042	BolC3t15528H	0	-	584	1015	1049	0.9675882
C3	17653390	17654342	BolC3t15529H	0	+	1093	952	952	1.0000000
C3	17658420	17662113	BolC3t15530H	0	+	288	2424	3693	0.6563770
C3	17664467	17665194	BolC3t15531H	0	-	197	558	727	0.7675378
C3	17670338	17670638	BolC3t15532H	0	-	252	300	300	1.0000000
C3	17674462	17674864	BolC3t15533H	0	-	20	285	402	0.7089552
C3	17677964	17679161	BolC3t15534H	0	-	54	382	1197	0.3191312
C3	17692127	17693327	BolC3t15535H	0	+	29	434	1200	0.3616667
C3	17702078	17702354	BolC3t15536H	0	+	316	276	276	1.0000000
C3	17707081	17708380	BolC3t15537H	0	+	868	1299	1299	1.0000000
C3	17723103	17724138	BolC3t15538H	0	+	139	639	1035	0.6173913
C3	17728550	17729554	BolC3t15539H	0	-	509	744	1004	0.7410359
C3	17733232	17733802	BolC3t15540H	0	+	466	570	570	1.0000000
C3	17734355	17735054	BolC3t15541H	0	-	152	396	699	0.5665236
C3	17743359	17746034	BolC3t15542H	0	-	376	2460	2675	0.9196262
C3	17749792	17750512	BolC3t15543H	0	-	5	142	720	0.1972222
C3	17753869	17753989	BolC3t15544H	0	-	157	120	120	1.0000000
C3	17758766	17759492	BolC3t15545H	0	-	430	726	726	1.0000000
C3	17781380	17781839	BolC3t15546H	0	-	18	341	459	0.7429194
C3	17788213	17794754	BolC3t15547H	0	+	830	4020	6541	0.6145849
C3	17802929	17803064	BolC3t15548H	0	+	11	135	135	1.0000000
C3	17805582	17807427	BolC3t15549H	0	+	153	1389	1845	0.7528455
C3	17808535	17811703	BolC3t15550H	0	+	690	1428	3168	0.4507576
C3	17821549	17822320	BolC3t15551H	0	-	99	656	771	0.8508431
C3	17834761	17835688	BolC3t15552H	0	+	205	642	927	0.6925566
C3	17846502	17848218	BolC3t15553H	0	+	158	1208	1716	0.7039627
C3	17852428	17852791	BolC3t15554H	0	-	79	363	363	1.0000000
C3	17856229	17858106	BolC3t15555H	0	+	615	1694	1877	0.9025040
C3	17862654	17864061	BolC3t15556H	0	-	151	1166	1407	0.8287136
C3	17885061	17887039	BolC3t15557H	0	-	1403	1978	1978	1.0000000
C3	17896859	17898324	BolC3t15558H	0	+	561	1458	1465	0.9952219
C3	17899448	17903668	BolC3t15559H	0	+	1201	4020	4220	0.9526066
C3	17908196	17910383	BolC3t15560H	0	+	1073	2187	2187	1.0000000
C3	17913463	17918924	BolC3t15561H	0	-	411	3671	5461	0.6722212
C3	17919427	17920731	BolC3t15562H	0	-	957	1304	1304	1.0000000
C3	17924757	17931618	BolC3t15563H	0	+	2233	6554	6861	0.9552543
C3	17941889	17942800	BolC3t15564H	0	+	320	869	911	0.9538968
C3	17945244	17945775	BolC3t15565H	0	+	0	0	531	0.0000000
C3	17961691	17964085	BolC3t15566H	0	+	241	2013	2394	0.8408521
C3	17984219	17984732	BolC3t15567H	0	+	1	66	513	0.1286550
C3	17986974	17988376	BolC3t15568H	0	+	517	1367	1402	0.9750357
C3	17994359	17996333	BolC3t15569H	0	-	254	1810	1974	0.9169199
C3	18002032	18004086	BolC3t15570H	0	+	43	672	2054	0.3271665
C3	18006900	18007249	BolC3t15571H	0	+	396	349	349	1.0000000
C3	18009585	18011964	BolC3t15572H	0	+	316	1280	2379	0.5380412
C3	18016591	18018025	BolC3t15573H	0	+	205	793	1434	0.5529986
C3	18023104	18026261	BolC3t15574H	0	+	620	3020	3157	0.9566044
C3	18034422	18034611	BolC3t15575H	0	-	160	189	189	1.0000000
C3	18036570	18037530	BolC3t15576H	0	+	59	766	960	0.7979167
C3	18047340	18049263	BolC3t15577H	0	-	259	1378	1923	0.7165887
C3	18050392	18051204	BolC3t15578H	0	+	697	812	812	1.0000000
C3	18060391	18060577	BolC3t15579H	0	+	134	186	186	1.0000000
C3	18067387	18069543	BolC3t15580H	0	+	222	972	2156	0.4508349
C3	18072057	18074245	BolC3t15581H	0	-	332	1686	2188	0.7705667
C3	18082657	18084054	BolC3t15582H	0	-	1347	1397	1397	1.0000000
C3	18088870	18091165	BolC3t15583H	0	-	397	1780	2295	0.7755991
C3	18097600	18101351	BolC3t15584H	0	+	717	3299	3751	0.8794988
C3	18106504	18107628	BolC3t15585H	0	-	86	903	1124	0.8033808
C3	18118797	18134539	BolC3t15586H	0	-	701	6718	15742	0.4267564
C3	18142736	18145015	BolC3t15587H	0	+	260	1328	2279	0.5827117
C3	18164006	18166816	BolC3t15588H	0	+	226	1498	2810	0.5330961
C3	18168328	18171538	BolC3t15589H	0	-	2100	3210	3210	1.0000000
C3	18191443	18194869	BolC3t15590H	0	+	134	1680	3426	0.4903678
C3	18196961	18200534	BolC3t15591H	0	+	1483	2501	3573	0.6999720
C3	18205064	18206541	BolC3t15592H	0	+	343	1237	1477	0.8375084
C3	18217598	18219989	BolC3t15593H	0	+	415	1416	2391	0.5922208
C3	18220167	18221246	BolC3t15594H	0	-	828	1079	1079	1.0000000
C3	18222023	18223314	BolC3t15595H	0	+	78	610	1291	0.4725019
C3	18229365	18229591	BolC3t15596H	0	-	292	226	226	1.0000000
C3	18234577	18236710	BolC3t15597H	0	+	187	1778	2133	0.8335677
C3	18246136	18252271	BolC3t15598H	0	-	317	2642	6135	0.4306439
C3	18255577	18256201	BolC3t15599H	0	+	7	47	624	0.0753205
C3	18259874	18272192	BolC3t15600H	0	+	2014	8220	12318	0.6673161
C3	18273035	18273389	BolC3t15601H	0	+	17	306	354	0.8644068
C3	18275100	18277344	BolC3t15602H	0	-	86	791	2244	0.3524956
C3	18277941	18278784	BolC3t15603H	0	+	1	19	843	0.0225386
C3	18281316	18282030	BolC3t15604H	0	-	15	227	714	0.3179272
C3	18284929	18292208	BolC3t15605H	0	-	4804	6932	7279	0.9523286
C3	18309940	18310465	BolC3t15606H	0	-	86	525	525	1.0000000
C3	18316581	18319851	BolC3t15607H	0	+	698	2667	3270	0.8155963
C3	18341701	18343055	BolC3t15608H	0	-	951	1354	1354	1.0000000
C3	18352015	18353186	BolC3t15609H	0	+	131	1035	1171	0.8838599
C3	18358856	18360309	BolC3t15610H	0	-	688	1453	1453	1.0000000
C3	18360585	18360855	BolC3t15611H	0	-	254	270	270	1.0000000
C3	18361331	18363851	BolC3t15612H	0	-	202	1700	2520	0.6746032
C3	18367278	18370258	BolC3t15613H	0	-	1571	2414	2980	0.8100671
C3	18380535	18382308	BolC3t15614H	0	+	164	1053	1773	0.5939086
C3	18384151	18384604	BolC3t15615H	0	+	164	453	453	1.0000000
C3	18397381	18399748	BolC3t15616H	0	-	436	1930	2367	0.8153781
C3	18404447	18408685	BolC3t15617H	0	+	2452	3859	4238	0.9105710
C3	18410512	18411519	BolC3t15618H	0	-	349	971	1007	0.9642503
C3	18415697	18416393	BolC3t15619H	0	-	175	368	696	0.5287356
C3	18420157	18422119	BolC3t15620H	0	+	704	1670	1962	0.8511723
C3	18435080	18437162	BolC3t15621H	0	+	4541	2082	2082	1.0000000
C3	18438085	18438448	BolC3t15622H	0	-	23	288	363	0.7933884
C3	18453578	18456178	BolC3t15623H	0	-	976	1813	2600	0.6973077
C3	18470540	18471154	BolC3t15624H	0	+	15	246	614	0.4006515
C3	18490886	18491150	BolC3t15625H	0	-	190	264	264	1.0000000
C3	18505811	18513174	BolC3t15626H	0	-	649	3349	7363	0.4548418
C3	18523810	18525100	BolC3t15627H	0	-	1182	1290	1290	1.0000000
C3	18525581	18527394	BolC3t15628H	0	+	220	1319	1813	0.7275234
C3	18528272	18531343	BolC3t15629H	0	-	1313	2959	3071	0.9635298
C3	18537933	18540251	BolC3t15630H	0	-	395	1833	2318	0.7907679
C3	18553761	18555737	BolC3t15631H	0	+	520	1854	1976	0.9382591
C3	18556000	18577451	BolC3t15632H	0	-	9041	20894	21451	0.9740338
C3	18578927	18579938	BolC3t15633H	0	-	128	863	1011	0.8536103
C3	18580782	18581134	BolC3t15634H	0	+	101	271	352	0.7698864
C3	18599139	18601356	BolC3t15635H	0	+	192	1515	2217	0.6833559
C3	18603005	18603402	BolC3t15636H	0	-	471	397	397	1.0000000
C3	18606152	18607364	BolC3t15637H	0	-	36	231	1212	0.1905941
C3	18611031	18615457	BolC3t15638H	0	-	332	2803	4426	0.6333032
C3	18622626	18629806	BolC3t15639H	0	-	2750	4967	7180	0.6917827
C3	18642564	18643356	BolC3t15640H	0	+	60	330	792	0.4166667
C3	18644752	18644944	BolC3t15641H	0	-	430	192	192	1.0000000
C3	18657840	18660294	BolC3t15642H	0	-	215	1844	2454	0.7514262
C3	18673056	18673465	BolC3t15643H	0	+	23	183	409	0.4474328
C3	18680507	18683146	BolC3t15644H	0	+	504	2511	2639	0.9514968
C3	18685785	18688874	BolC3t15645H	0	-	613	2168	3089	0.7018452
C3	18692153	18692285	BolC3t15646H	0	-	9	21	132	0.1590909
C3	18696200	18701064	BolC3t15647H	0	-	683	3345	4864	0.6877056
C3	18709271	18710149	BolC3t15648H	0	-	310	878	878	1.0000000
C3	18712952	18717389	BolC3t15649H	0	-	350	2434	4437	0.5485688
C3	18720624	18721757	BolC3t15650H	0	+	508	1081	1133	0.9541041
C3	18724821	18726712	BolC3t15651H	0	+	523	1709	1891	0.9037547
C3	18727552	18730474	BolC3t15652H	0	+	1028	2838	2922	0.9712526
C3	18735069	18737028	BolC3t15653H	0	-	590	1595	1959	0.8141909
C3	18757313	18759368	BolC3t15654H	0	-	429	2038	2055	0.9917275
C3	18763913	18766235	BolC3t15655H	0	+	868	2222	2322	0.9569337
C3	18770232	18770427	BolC3t15656H	0	+	231	195	195	1.0000000
C3	18780382	18780892	BolC3t15657H	0	+	60	243	510	0.4764706
C3	18794756	18795726	BolC3t15658H	0	+	247	818	970	0.8432990
C3	18798370	18801379	BolC3t15659H	0	+	1676	2745	3009	0.9122632
C3	18802590	18803661	BolC3t15660H	0	-	221	808	1071	0.7544351
C3	18814550	18814892	BolC3t15661H	0	+	5	17	342	0.0497076
C3	18828921	18829569	BolC3t15662H	0	-	686	648	648	1.0000000
C3	18834520	18836343	BolC3t15663H	0	+	202	1720	1823	0.9434997
C3	18846253	18846574	BolC3t15664H	0	+	43	211	321	0.6573209
C3	18860643	18863869	BolC3t15665H	0	+	1557	3154	3226	0.9776813
C3	18869317	18870509	BolC3t15666H	0	+	274	1091	1192	0.9152685
C3	18880515	18882171	BolC3t15667H	0	+	240	1538	1656	0.9287440
C3	18890293	18892503	BolC3t15668H	0	+	556	2068	2210	0.9357466
C3	18892763	18894857	BolC3t15669H	0	+	140	1095	2094	0.5229226
C3	18901614	18905727	BolC3t15670H	0	+	770	3142	4113	0.7639193
C3	18914175	18917193	BolC3t15671H	0	+	674	2666	3018	0.8833665
C3	18924020	18927118	BolC3t15672H	0	-	1187	3011	3098	0.9719174
C3	18931114	18935515	BolC3t15673H	0	-	2075	3912	4401	0.8888889
C3	18937086	18939814	BolC3t15674H	0	-	796	2413	2728	0.8845308
C3	18945382	18947820	BolC3t15675H	0	+	892	2147	2438	0.8806399
C3	18948170	18949379	BolC3t15676H	0	-	179	982	1209	0.8122415
C3	18951936	18953596	BolC3t15677H	0	+	414	1625	1660	0.9789157
C3	18957733	18961402	BolC3t15678H	0	-	3331	3669	3669	1.0000000
C3	18962153	18963735	BolC3t15679H	0	+	150	1165	1582	0.7364096
C3	18981045	18982233	BolC3t15680H	0	+	769	1188	1188	1.0000000
C3	18988107	18988403	BolC3t15681H	0	+	208	296	296	1.0000000
C3	18992047	18992290	BolC3t15682H	0	+	306	243	243	1.0000000
C3	18996724	18998031	BolC3t15683H	0	+	34	443	1307	0.3389441
C3	19013208	19013697	BolC3t15684H	0	+	75	406	489	0.8302658
C3	19020809	19021762	BolC3t15685H	0	-	59	418	953	0.4386149
C3	19023102	19024037	BolC3t15686H	0	-	164	805	935	0.8609626
C3	19027391	19028832	BolC3t15687H	0	+	1304	1441	1441	1.0000000
C3	19039258	19040548	BolC3t15688H	0	-	435	1290	1290	1.0000000
C3	19045747	19049203	BolC3t15689H	0	-	1253	3341	3456	0.9667245
C3	19051827	19054177	BolC3t15690H	0	-	232	1713	2350	0.7289362
C3	19078941	19080175	BolC3t15691H	0	-	790	1220	1234	0.9886548
C3	19120812	19122498	BolC3t15692H	0	+	191	1116	1686	0.6619217
C3	19127563	19128715	BolC3t15693H	0	-	223	1152	1152	1.0000000
C3	19134262	19137933	BolC3t15694H	0	-	826	2819	3671	0.7679107
C3	19167798	19172216	BolC3t15695H	0	-	1391	2667	4418	0.6036668
C3	19176156	19176558	BolC3t15696H	0	+	118	402	402	1.0000000
C3	19181802	19183427	BolC3t15697H	0	-	449	1625	1625	1.0000000
C3	19192080	19194141	BolC3t15698H	0	-	923	1992	2061	0.9665211
C3	19196708	19197713	BolC3t15699H	0	-	933	1005	1005	1.0000000
C3	19201109	19202257	BolC3t15700H	0	+	512	1144	1148	0.9965157
C3	19204047	19209034	BolC3t15701H	0	+	1298	4655	4987	0.9334269
C3	19211200	19212626	BolC3t15702H	0	+	278	1341	1426	0.9403927
C3	19224616	19226033	BolC3t15703H	0	+	612	1333	1417	0.9407198
C3	19228365	19229163	BolC3t15704H	0	-	204	596	798	0.7468672
C3	19236459	19238847	BolC3t15705H	0	-	703	2320	2388	0.9715243
C3	19244856	19245021	BolC3t15706H	0	-	105	165	165	1.0000000
C3	19248544	19249045	BolC3t15707H	0	+	0	0	501	0.0000000
C3	19256610	19258086	BolC3t15708H	0	+	49	985	1476	0.6673442
C3	19267170	19268563	BolC3t15709H	0	+	8	461	1393	0.3309404
C3	19282251	19283414	BolC3t15710H	0	+	109	807	1163	0.6938951
C3	19283388	19283808	BolC3t15711H	0	+	4	170	420	0.4047619
C3	19293907	19295671	BolC3t15712H	0	+	2	23	1764	0.0130385
C3	19307021	19307288	BolC3t15713H	0	+	2	66	267	0.2471910
C3	19315682	19317507	BolC3t15714H	0	+	0	0	1825	0.0000000
C3	19325789	19326116	BolC3t15715H	0	-	138	327	327	1.0000000
C3	19325962	19327332	BolC3t15716H	0	-	526	1370	1370	1.0000000
C3	19332075	19333953	BolC3t15717H	0	-	2	94	1878	0.0500532
C3	19350012	19350225	BolC3t15718H	0	+	103	213	213	1.0000000
C3	19357512	19358912	BolC3t15719H	0	-	698	1339	1400	0.9564286
C3	19365046	19369224	BolC3t15720H	0	+	1594	2738	4178	0.6553375
C3	19371145	19371727	BolC3t15721H	0	+	179	582	582	1.0000000
C3	19371952	19373366	BolC3t15722H	0	-	775	1414	1414	1.0000000
C3	19399620	19403213	BolC3t15723H	0	+	2443	3593	3593	1.0000000
C3	19412792	19414466	BolC3t15724H	0	-	96	1078	1674	0.6439666
C3	19416895	19417210	BolC3t15725H	0	-	69	315	315	1.0000000
C3	19422743	19424280	BolC3t15726H	0	-	1544	1521	1537	0.9895901
C3	19426093	19429612	BolC3t15727H	0	-	323	2323	3519	0.6601307
C3	19437895	19439101	BolC3t15728H	0	-	664	1099	1206	0.9112769
C3	19442100	19443539	BolC3t15729H	0	-	1313	1386	1439	0.9631689
C3	19457091	19457421	BolC3t15730H	0	+	159	330	330	1.0000000
C3	19460462	19461973	BolC3t15731H	0	+	407	1439	1511	0.9523494
C3	19471158	19472103	BolC3t15732H	0	+	89	506	945	0.5354497
C3	19483905	19485237	BolC3t15733H	0	+	354	1235	1332	0.9271772
C3	19491824	19492928	BolC3t15734H	0	+	200	1033	1104	0.9356884
C3	19494112	19495899	BolC3t15735H	0	-	272	1609	1787	0.9003917
C3	19496992	19498084	BolC3t15736H	0	+	51	708	1092	0.6483517
C3	19499434	19500520	BolC3t15737H	0	+	286	1086	1086	1.0000000
C3	19502431	19503535	BolC3t15738H	0	+	247	980	1104	0.8876812
C3	19504656	19505238	BolC3t15739H	0	-	309	582	582	1.0000000
C3	19517405	19521592	BolC3t15740H	0	+	568	3300	4187	0.7881538
C3	19524022	19525105	BolC3t15741H	0	-	53	936	1083	0.8642659
C3	19528157	19529237	BolC3t15742H	0	-	93	863	1080	0.7990741
C3	19542847	19543997	BolC3t15743H	0	-	110	668	1150	0.5808696
C3	19545406	19545802	BolC3t15744H	0	+	253	396	396	1.0000000
C3	19555235	19555955	BolC3t15745H	0	+	134	667	720	0.9263889
C3	19556290	19558515	BolC3t15746H	0	-	1309	2223	2225	0.9991011
C3	19561368	19561731	BolC3t15747H	0	-	42	258	363	0.7107438
C3	19563991	19564981	BolC3t15748H	0	+	679	990	990	1.0000000
C3	19565169	19568821	BolC3t15749H	0	-	1504	3103	3652	0.8496714
C3	19573990	19576359	BolC3t15750H	0	+	950	2235	2369	0.9434360
C3	19577362	19577731	BolC3t15751H	0	-	302	369	369	1.0000000
C3	19583440	19584499	BolC3t15752H	0	+	1556	1059	1059	1.0000000
C3	19585519	19586683	BolC3t15753H	0	+	122	383	1164	0.3290378
C3	19596715	19599385	BolC3t15754H	0	+	3077	2670	2670	1.0000000
C3	19602799	19604284	BolC3t15755H	0	+	2095	1485	1485	1.0000000
C3	19604789	19605530	BolC3t15756H	0	-	84	352	741	0.4750337
C3	19605859	19606890	BolC3t15757H	0	+	306	873	1031	0.8467507
C3	19615220	19616387	BolC3t15758H	0	+	0	0	1167	0.0000000
C3	19618279	19620675	BolC3t15759H	0	-	39	859	2396	0.3585142
C3	19627232	19628315	BolC3t15760H	0	+	0	0	1083	0.0000000
C3	19634937	19637247	BolC3t15761H	0	-	213	1511	2310	0.6541126
C3	19643358	19644311	BolC3t15762H	0	+	213	909	953	0.9538300
C3	19649627	19650329	BolC3t15763H	0	-	0	0	702	0.0000000
C3	19659436	19659649	BolC3t15764H	0	-	244	213	213	1.0000000
C3	19668101	19670504	BolC3t15765H	0	-	109	956	2403	0.3978360
C3	19672438	19672913	BolC3t15766H	0	+	113	461	475	0.9705263
C3	19693678	19694301	BolC3t15767H	0	-	247	623	623	1.0000000
C3	19697645	19697942	BolC3t15768H	0	-	18	138	297	0.4646465
C3	19705121	19705496	BolC3t15769H	0	+	382	375	375	1.0000000
C3	19722432	19724052	BolC3t15770H	0	-	857	1540	1620	0.9506173
C3	19731776	19734258	BolC3t15771H	0	+	450	2270	2482	0.9145850
C3	19738828	19739420	BolC3t15772H	0	-	284	568	592	0.9594595
C3	19743042	19743751	BolC3t15773H	0	-	111	709	709	1.0000000
C3	19756586	19756715	BolC3t15774H	0	+	181	129	129	1.0000000
C3	19760845	19761160	BolC3t15775H	0	-	144	315	315	1.0000000
C3	19764361	19766677	BolC3t15776H	0	+	570	1731	2316	0.7474093
C3	19769385	19770865	BolC3t15777H	0	+	916	1480	1480	1.0000000
C3	19771170	19772018	BolC3t15778H	0	-	451	848	848	1.0000000
C3	19772315	19774634	BolC3t15779H	0	+	2188	2319	2319	1.0000000
C3	19781647	19782352	BolC3t15780H	0	-	92	645	705	0.9148936
C3	19785869	19787144	BolC3t15781H	0	-	198	1110	1275	0.8705882
C3	19791824	19793368	BolC3t15782H	0	+	1583	1544	1544	1.0000000
C3	19795309	19798198	BolC3t15783H	0	+	1872	2638	2889	0.9131187
C3	19801087	19801835	BolC3t15784H	0	-	569	748	748	1.0000000
C3	19808003	19810713	BolC3t15785H	0	-	869	2519	2710	0.9295203
C3	19830290	19831802	BolC3t15786H	0	+	1232	1512	1512	1.0000000
C3	19832320	19834009	BolC3t15787H	0	-	690	1678	1689	0.9934873
C3	19837477	19838549	BolC3t15788H	0	+	333	964	1072	0.8992537
C3	19840669	19851431	BolC3t15789H	0	-	219	2034	10762	0.1889983
C3	19857977	19858169	BolC3t15790H	0	+	220	192	192	1.0000000
C3	19859756	19860254	BolC3t15791H	0	+	88	488	498	0.9799197
C3	19877082	19877493	BolC3t15792H	0	-	127	411	411	1.0000000
C3	19878675	19878831	BolC3t15793H	0	+	245	156	156	1.0000000
C3	19886666	19887354	BolC3t15794H	0	-	0	0	688	0.0000000
C3	19897086	19897935	BolC3t15795H	0	-	0	0	849	0.0000000
C3	19907571	19909822	BolC3t15796H	0	+	997	1968	2251	0.8742781
C3	19910092	19912374	BolC3t15797H	0	-	2378	2190	2282	0.9596845
C3	19915629	19916591	BolC3t15798H	0	+	686	960	962	0.9979210
C3	19920187	19922741	BolC3t15799H	0	-	1049	2493	2554	0.9761159
C3	19924905	19925679	BolC3t15800H	0	+	10	373	774	0.4819121
C3	19927359	19929832	BolC3t15801H	0	+	601	1870	2473	0.7561666
C3	19930822	19931416	BolC3t15802H	0	+	182	539	594	0.9074074
C3	19932022	19933450	BolC3t15803H	0	-	152	965	1428	0.6757703
C3	19939474	19939918	BolC3t15804H	0	-	7	305	444	0.6869369
C3	19940408	19941327	BolC3t15805H	0	-	105	657	919	0.7149075
C3	19950638	19951106	BolC3t15806H	0	+	392	468	468	1.0000000
C3	19955474	19956044	BolC3t15807H	0	+	53	455	570	0.7982456
C3	19960083	19960311	BolC3t15808H	0	+	107	228	228	1.0000000
C3	19963141	19967384	BolC3t15809H	0	+	1961	3733	4243	0.8798020
C3	19966106	19966859	BolC3t15810H	0	+	178	718	753	0.9535193
C3	19970414	19971707	BolC3t15811H	0	+	222	1176	1293	0.9095128
C3	19972015	19973560	BolC3t15812H	0	-	77	805	1545	0.5210356
C3	19988417	19994958	BolC3t15813H	0	-	3277	5273	6541	0.8061458
C3	20012040	20012278	BolC3t15814H	0	+	62	220	238	0.9243698
C3	20024359	20025293	BolC3t15815H	0	-	350	934	934	1.0000000
C3	20034866	20035052	BolC3t15816H	0	+	173	186	186	1.0000000
C3	20047665	20049402	BolC3t15817H	0	+	501	1505	1737	0.8664364
C3	20053690	20053843	BolC3t15818H	0	-	211	153	153	1.0000000
C3	20081101	20091582	BolC3t15819H	0	+	8024	10061	10481	0.9599275
C3	20112086	20116062	BolC3t15820H	0	-	983	2507	3976	0.6305332
C3	20119927	20121108	BolC3t15821H	0	+	313	1181	1181	1.0000000
C3	20129560	20131553	BolC3t15822H	0	+	250	1585	1993	0.7952835
C3	20134349	20135279	BolC3t15823H	0	-	221	451	930	0.4849463
C3	20142709	20142829	BolC3t15824H	0	+	146	120	120	1.0000000
C3	20145659	20148227	BolC3t15825H	0	+	908	2364	2568	0.9205608
C3	20163087	20166184	BolC3t15826H	0	+	1014	2877	3097	0.9289635
C3	20167102	20171238	BolC3t15827H	0	-	327	1362	4136	0.3293037
C3	20172802	20173349	BolC3t15828H	0	+	69	517	547	0.9451554
C3	20176825	20179601	BolC3t15829H	0	+	1773	2489	2776	0.8966138
C3	20193382	20195397	BolC3t15830H	0	-	341	1766	2015	0.8764268
C3	20197130	20197385	BolC3t15831H	0	-	101	255	255	1.0000000
C3	20197844	20198479	BolC3t15832H	0	-	806	635	635	1.0000000
C3	20199023	20207094	BolC3t15833H	0	-	841	6112	8071	0.7572792
C3	20208911	20209157	BolC3t15834H	0	-	121	246	246	1.0000000
C3	20211402	20213072	BolC3t15835H	0	+	409	1515	1670	0.9071856
C3	20215228	20215945	BolC3t15836H	0	+	208	684	717	0.9539749
C3	20217698	20217926	BolC3t15837H	0	+	32	228	228	1.0000000
C3	20223725	20227003	BolC3t15838H	0	+	905	3011	3278	0.9185479
C3	20234325	20235550	BolC3t15839H	0	-	1101	1225	1225	1.0000000
C3	20238002	20243752	BolC3t15840H	0	-	1895	4306	5750	0.7488695
C3	20246617	20248136	BolC3t15841H	0	-	541	1417	1519	0.9328505
C3	20256969	20260860	BolC3t15842H	0	+	836	2434	3891	0.6255462
C3	20267758	20270959	BolC3t15843H	0	-	2043	3054	3201	0.9540768
C3	20282221	20285926	BolC3t15844H	0	-	1688	2831	3705	0.7641026
C3	20313999	20319078	BolC3t15845H	0	+	1022	2462	5079	0.4847411
C3	20326213	20330347	BolC3t15846H	0	+	175	1676	4134	0.4054185
C3	20330846	20333386	BolC3t15847H	0	+	682	2120	2540	0.8346457
C3	20342228	20343131	BolC3t15848H	0	-	42	586	903	0.6489480
C3	20357684	20358804	BolC3t15849H	0	+	610	1120	1120	1.0000000
C3	20362832	20364020	BolC3t15850H	0	+	788	1188	1188	1.0000000
C3	20364038	20365059	BolC3t15851H	0	+	140	903	1021	0.8844270
C3	20373838	20377519	BolC3t15852H	0	+	793	3243	3681	0.8810106
C3	20379040	20379241	BolC3t15853H	0	+	186	201	201	1.0000000
C3	20385717	20387292	BolC3t15854H	0	-	604	1547	1575	0.9822222
C3	20390573	20391980	BolC3t15855H	0	+	616	1100	1407	0.7818053
C3	20392458	20394641	BolC3t15856H	0	-	557	2050	2183	0.9390747
C3	20404211	20404622	BolC3t15857H	0	+	3	73	411	0.1776156
C3	20409207	20410042	BolC3t15858H	0	+	820	814	835	0.9748503
C3	20413360	20413597	BolC3t15859H	0	+	0	0	237	0.0000000
C3	20413749	20414025	BolC3t15860H	0	+	0	0	276	0.0000000
C3	20417373	20421252	BolC3t15861H	0	-	427	3154	3879	0.8130962
C3	20433637	20460802	BolC3t15862H	0	+	4645	17451	27165	0.6424075
C3	20475437	20480244	BolC3t15863H	0	+	1640	3655	4807	0.7603495
C3	20486496	20489694	BolC3t15864H	0	-	930	2808	3198	0.8780488
C3	20493997	20498090	BolC3t15865H	0	+	1694	3975	4093	0.9711703
C3	20503598	20507918	BolC3t15866H	0	+	1397	3558	4320	0.8236111
C3	20524398	20524797	BolC3t15867H	0	-	0	0	399	0.0000000
C3	20531475	20532463	BolC3t15868H	0	-	2	19	988	0.0192308
C3	20573287	20574037	BolC3t15869H	0	-	36	56	750	0.0746667
C3	20575549	20575681	BolC3t15870H	0	-	0	0	132	0.0000000
C3	20590391	20591092	BolC3t15871H	0	+	0	0	701	0.0000000
C3	20593127	20594171	BolC3t15872H	0	+	284	986	1044	0.9444444
C3	20595652	20597718	BolC3t15873H	0	-	455	1880	2066	0.9099709
C3	20609318	20613591	BolC3t15874H	0	-	116	1569	4273	0.3671893
C3	20640380	20643768	BolC3t15875H	0	-	48	744	3388	0.2195986
C3	20654000	20655366	BolC3t15876H	0	+	442	919	1366	0.6727672
C3	20657199	20658411	BolC3t15877H	0	+	926	1212	1212	1.0000000
C3	20665074	20666226	BolC3t15878H	0	+	1997	1152	1152	1.0000000
C3	20675573	20676849	BolC3t15879H	0	-	1	143	1276	0.1120690
C3	20683181	20683970	BolC3t15880H	0	-	394	789	789	1.0000000
C3	20690518	20692621	BolC3t15881H	0	-	941	1604	2103	0.7627199
C3	20693815	20694052	BolC3t15882H	0	-	1	48	237	0.2025317
C3	20698884	20702814	BolC3t15883H	0	+	16	500	3930	0.1272265
C3	20704205	20706048	BolC3t15884H	0	+	383	1281	1843	0.6950624
C3	20709076	20709556	BolC3t15885H	0	+	152	425	480	0.8854167
C3	20713540	20714117	BolC3t15886H	0	-	370	577	577	1.0000000
C3	20719498	20720966	BolC3t15887H	0	+	1810	1441	1468	0.9816076
C3	20728145	20728624	BolC3t15888H	0	-	37	420	479	0.8768267
C3	20731361	20731768	BolC3t15889H	0	-	0	0	407	0.0000000
C3	20746103	20750427	BolC3t15890H	0	-	682	3259	4324	0.7537003
C3	20751229	20752822	BolC3t15891H	0	+	467	1472	1593	0.9240427
C3	20755255	20755786	BolC3t15892H	0	+	19	240	531	0.4519774
C3	20756177	20756363	BolC3t15893H	0	+	5	156	186	0.8387097
C3	20756758	20757436	BolC3t15894H	0	-	52	435	678	0.6415929
C3	20759130	20759337	BolC3t15895H	0	-	66	207	207	1.0000000
C3	20761487	20763890	BolC3t15896H	0	+	1677	2340	2403	0.9737828
C3	20764862	20765939	BolC3t15897H	0	+	421	1077	1077	1.0000000
C3	20768340	20768598	BolC3t15898H	0	-	7	201	258	0.7790698
C3	20779259	20781217	BolC3t15899H	0	-	60	1180	1958	0.6026558
C3	20790376	20791354	BolC3t15900H	0	+	16	125	978	0.1278119
C3	20798026	20798524	BolC3t15901H	0	-	15	196	498	0.3935743
C3	20812110	20821810	BolC3t15902H	0	+	132	2114	9700	0.2179381
C3	20826686	20828241	BolC3t15903H	0	-	387	1171	1555	0.7530547
C3	20838899	20839726	BolC3t15904H	0	-	112	549	827	0.6638452
C3	20845347	20849920	BolC3t15905H	0	+	375	2141	4573	0.4681828
C3	20870365	20870866	BolC3t15906H	0	-	22	287	501	0.5728543
C3	20874943	20875345	BolC3t15907H	0	-	20	378	402	0.9402985
C3	20877164	20877774	BolC3t15908H	0	-	334	522	610	0.8557377
C3	20884147	20884836	BolC3t15909H	0	+	81	657	689	0.9535559
C3	20889275	20890538	BolC3t15910H	0	-	1682	1263	1263	1.0000000
C3	20893698	20894719	BolC3t15911H	0	-	764	1021	1021	1.0000000
C3	20896787	20897177	BolC3t15912H	0	+	47	342	390	0.8769231
C3	20915148	20915562	BolC3t15913H	0	+	45	364	414	0.8792270
C3	20935825	20938610	BolC3t15914H	0	+	567	1882	2785	0.6757630
C3	20939018	20939213	BolC3t15915H	0	-	217	195	195	1.0000000
C3	20957540	20959410	BolC3t15916H	0	+	26	419	1870	0.2240642
C3	20972747	20973559	BolC3t15917H	0	+	191	637	812	0.7844828
C3	20976572	20979257	BolC3t15918H	0	+	488	1839	2685	0.6849162
C3	20983978	20984374	BolC3t15919H	0	+	2965	396	396	1.0000000
C3	20989725	20991471	BolC3t15920H	0	+	68	1110	1746	0.6357388
C3	20997597	20997996	BolC3t15921H	0	+	93	328	399	0.8220552
C3	21001209	21001703	BolC3t15922H	0	-	666	494	494	1.0000000
C3	21002460	21003800	BolC3t15923H	0	+	612	1340	1340	1.0000000
C3	21012377	21012986	BolC3t15924H	0	+	9	268	609	0.4400657
C3	21015914	21018093	BolC3t15925H	0	+	700	1906	2179	0.8747132
C3	21018500	21019070	BolC3t15926H	0	-	70	370	570	0.6491228
C3	21025021	21025359	BolC3t15927H	0	-	181	338	338	1.0000000
C3	21027665	21028003	BolC3t15928H	0	-	219	338	338	1.0000000
C3	21032340	21032562	BolC3t15929H	0	+	169	222	222	1.0000000
C3	21033570	21035234	BolC3t15930H	0	+	1303	1664	1664	1.0000000
C3	21037363	21040390	BolC3t15931H	0	+	902	2605	3027	0.8605880
C3	21047752	21051316	BolC3t15932H	0	+	611	2470	3564	0.6930415
C3	21051661	21052205	BolC3t15933H	0	-	627	544	544	1.0000000
C3	21064152	21068872	BolC3t15934H	0	+	807	3071	4720	0.6506356
C3	21068989	21069646	BolC3t15935H	0	-	94	574	657	0.8736682
C3	21073563	21075901	BolC3t15936H	0	+	109	1474	2338	0.6304534
C3	21080374	21080509	BolC3t15937H	0	-	240	135	135	1.0000000
C3	21083323	21083745	BolC3t15938H	0	-	83	422	422	1.0000000
C3	21086885	21089382	BolC3t15939H	0	+	249	1554	2497	0.6223468
C3	21090678	21091884	BolC3t15940H	0	+	148	1124	1206	0.9320067
C3	21096329	21096665	BolC3t15941H	0	+	273	336	336	1.0000000
C3	21111855	21114211	BolC3t15942H	0	+	1464	2119	2356	0.8994058
C3	21125073	21125557	BolC3t15943H	0	+	258	484	484	1.0000000
C3	21154793	21156734	BolC3t15944H	0	-	442	1917	1941	0.9876353
C3	21173307	21173966	BolC3t15945H	0	-	221	659	659	1.0000000
C3	21176708	21179444	BolC3t15946H	0	+	3107	2736	2736	1.0000000
C3	21184192	21184297	BolC3t15947H	0	-	12	105	105	1.0000000
C3	21184785	21186557	BolC3t15948H	0	-	32	712	1772	0.4018059
C3	21192571	21195120	BolC3t15949H	0	+	478	1313	2549	0.5151039
C3	21200297	21200738	BolC3t15950H	0	-	14	289	441	0.6553288
C3	21204147	21207324	BolC3t15951H	0	-	74	1087	3177	0.3421467
C3	21221527	21222652	BolC3t15952H	0	-	60	601	1125	0.5342222
C3	21226528	21230930	BolC3t15953H	0	+	1077	2603	4402	0.5913221
C3	21236378	21238184	BolC3t15954H	0	-	2239	1734	1806	0.9601329
C3	21243695	21244115	BolC3t15955H	0	-	1	68	420	0.1619048
C3	21256727	21260391	BolC3t15956H	0	+	918	3567	3664	0.9735262
C3	21261667	21263001	BolC3t15957H	0	-	1643	1334	1334	1.0000000
C3	21263846	21265065	BolC3t15958H	0	-	413	1153	1219	0.9458573
C3	21269103	21269795	BolC3t15959H	0	+	194	657	692	0.9494219
C3	21275310	21280130	BolC3t15960H	0	-	1892	4532	4820	0.9402490
C3	21290821	21296115	BolC3t15961H	0	-	4519	5171	5294	0.9767662
C3	21299171	21304321	BolC3t15962H	0	-	3876	4413	5150	0.8568932
C3	21304888	21307014	BolC3t15963H	0	-	877	1920	2126	0.9031044
C3	21327850	21328565	BolC3t15964H	0	+	143	715	715	1.0000000
C3	21332621	21333952	BolC3t15965H	0	+	953	1331	1331	1.0000000
C3	21334364	21335337	BolC3t15966H	0	-	1017	973	973	1.0000000
C3	21341751	21342030	BolC3t15967H	0	-	71	224	279	0.8028674
C3	21343984	21344563	BolC3t15968H	0	+	54	525	579	0.9067358
C3	21344809	21345154	BolC3t15969H	0	+	10	323	345	0.9362319
C3	21347834	21349107	BolC3t15970H	0	+	0	0	1273	0.0000000
C3	21355162	21355342	BolC3t15971H	0	+	3	146	180	0.8111111
C3	21366049	21367731	BolC3t15972H	0	-	649	1437	1682	0.8543401
C3	21369102	21371348	BolC3t15973H	0	-	629	2013	2246	0.8962600
C3	21374859	21375773	BolC3t15974H	0	+	554	914	914	1.0000000
C3	21376208	21382048	BolC3t15975H	0	-	477	2803	5840	0.4799657
C3	21385055	21386340	BolC3t15976H	0	-	974	1285	1285	1.0000000
C3	21387432	21389350	BolC3t15977H	0	-	248	1425	1918	0.7429614
C3	21411580	21411826	BolC3t15978H	0	-	62	246	246	1.0000000
C3	21416255	21417240	BolC3t15979H	0	-	72	541	985	0.5492386
C3	21419624	21424490	BolC3t15980H	0	-	1032	3123	4866	0.6418002
C3	21426648	21427409	BolC3t15981H	0	+	528	761	761	1.0000000
C3	21437197	21437551	BolC3t15982H	0	+	1	122	354	0.3446328
C3	21442592	21444299	BolC3t15983H	0	+	1063	1707	1707	1.0000000
C3	21445511	21445898	BolC3t15984H	0	-	227	387	387	1.0000000
C3	21451470	21453124	BolC3t15985H	0	+	101	892	1654	0.5392987
C3	21460996	21464449	BolC3t15986H	0	+	567	2241	3453	0.6490009
C3	21474244	21476773	BolC3t15987H	0	+	126	1281	2529	0.5065243
C3	21494224	21495987	BolC3t15988H	0	-	1109	1763	1763	1.0000000
C3	21502351	21503201	BolC3t15989H	0	-	0	0	850	0.0000000
C3	21516222	21517944	BolC3t15990H	0	+	122	952	1722	0.5528455
C3	21522628	21523862	BolC3t15991H	0	-	268	1183	1234	0.9586710
C3	21530068	21531475	BolC3t15992H	0	-	622	1407	1407	1.0000000
C3	21538577	21542270	BolC3t15993H	0	+	1253	3518	3693	0.9526131
C3	21550704	21551480	BolC3t15994H	0	-	907	776	776	1.0000000
C3	21557222	21558846	BolC3t15995H	0	-	2294	1624	1624	1.0000000
C3	21561660	21569632	BolC3t15996H	0	+	1182	4544	7972	0.5699950
C3	21572728	21575261	BolC3t15997H	0	-	885	2053	2533	0.8105014
C3	21576408	21577692	BolC3t15998H	0	-	79	1151	1284	0.8964174
C3	21579218	21581540	BolC3t15999H	0	-	838	2121	2322	0.9134367
C3	21584487	21585418	BolC3t16000H	0	+	395	931	931	1.0000000
C3	21598937	21599255	BolC3t16001H	0	-	31	297	318	0.9339623
C3	21619472	21619828	BolC3t16002H	0	+	12	39	356	0.1095506
C3	21626462	21628670	BolC3t16003H	0	+	113	1370	2208	0.6204710
C3	21631907	21632448	BolC3t16004H	0	-	104	537	541	0.9926063
C3	21632592	21633737	BolC3t16005H	0	-	234	1136	1145	0.9921398
C3	21636808	21636982	BolC3t16006H	0	+	31	142	174	0.8160920
C3	21637929	21645094	BolC3t16007H	0	-	7351	6606	7165	0.9219819
C3	21645963	21646455	BolC3t16008H	0	+	40	489	492	0.9939024
C3	21648145	21648316	BolC3t16009H	0	+	8	171	171	1.0000000
C3	21660240	21662918	BolC3t16010H	0	+	730	2368	2678	0.8842420
C3	21671650	21672860	BolC3t16011H	0	-	52	594	1210	0.4909091
C3	21687894	21689310	BolC3t16012H	0	-	773	1416	1416	1.0000000
C3	21693477	21694480	BolC3t16013H	0	-	424	848	1003	0.8454636
C3	21695797	21697902	BolC3t16014H	0	-	1090	2105	2105	1.0000000
C3	21711945	21728953	BolC3t16015H	0	+	6637	15171	17008	0.8919920
C3	21732410	21737870	BolC3t16016H	0	-	2001	5326	5460	0.9754578
C3	21742550	21744031	BolC3t16017H	0	-	162	1035	1481	0.6988521
C3	21751842	21756899	BolC3t16018H	0	+	588	3600	5057	0.7118845
C3	21758353	21759024	BolC3t16019H	0	-	410	671	671	1.0000000
C3	21767200	21772088	BolC3t16020H	0	-	119	2369	4888	0.4846563
C3	21775513	21776944	BolC3t16021H	0	-	186	636	1431	0.4444444
C3	21780436	21781653	BolC3t16022H	0	+	1016	1217	1217	1.0000000
C3	21799576	21799784	BolC3t16023H	0	-	153	208	208	1.0000000
C3	21800196	21801655	BolC3t16024H	0	+	208	1066	1459	0.7306374
C3	21810046	21811343	BolC3t16025H	0	-	863	1297	1297	1.0000000
C3	21814217	21816788	BolC3t16026H	0	+	1961	2571	2571	1.0000000
C3	21818568	21818988	BolC3t16027H	0	-	447	420	420	1.0000000
C3	21833333	21834122	BolC3t16028H	0	+	32	507	789	0.6425856
C3	21841268	21841661	BolC3t16029H	0	+	35	270	393	0.6870229
C3	21856083	21858462	BolC3t16030H	0	+	131	1461	2379	0.6141236
C3	21867657	21868862	BolC3t16031H	0	+	17	323	1205	0.2680498
C3	21874135	21875395	BolC3t16032H	0	-	388	1250	1260	0.9920635
C3	21879860	21880832	BolC3t16033H	0	-	118	763	972	0.7849794
C3	21883869	21886349	BolC3t16034H	0	+	621	1604	2480	0.6467742
C3	21887679	21889955	BolC3t16035H	0	-	1503	2069	2276	0.9090509
C3	21891395	21895317	BolC3t16036H	0	-	1895	2773	3922	0.7070372
C3	21906152	21907422	BolC3t16037H	0	-	295	1063	1270	0.8370079
C3	21908088	21910450	BolC3t16038H	0	-	1193	2284	2362	0.9669771
C3	21922540	21925094	BolC3t16039H	0	+	301	1436	2554	0.5622553
C3	21925311	21926828	BolC3t16040H	0	-	127	949	1517	0.6255768
C3	21927387	21928405	BolC3t16041H	0	-	0	0	1018	0.0000000
C3	21937310	21938688	BolC3t16042H	0	-	640	1307	1378	0.9484761
C3	21941398	21942534	BolC3t16043H	0	-	87	791	1136	0.6963028
C3	21952421	21953450	BolC3t16044H	0	+	155	997	1029	0.9689019
C3	21954651	21955951	BolC3t16045H	0	-	707	1300	1300	1.0000000
C3	21959951	21962161	BolC3t16046H	0	-	543	1793	2210	0.8113122
C3	21963487	21964495	BolC3t16047H	0	-	1213	1008	1008	1.0000000
C3	21972404	21973373	BolC3t16048H	0	+	3	292	969	0.3013416
C3	21974113	21974351	BolC3t16049H	0	+	6	215	238	0.9033613
C3	21997358	21998405	BolC3t16050H	0	+	743	1047	1047	1.0000000
C3	22010105	22039353	BolC3t16051H	0	+	4708	14398	29248	0.4922730
C3	22033682	22034114	BolC3t16052H	0	+	0	0	432	0.0000000
C3	22039415	22039574	BolC3t16053H	0	+	65	159	159	1.0000000
C3	22043237	22045985	BolC3t16054H	0	+	889	2613	2748	0.9508734
C3	22046520	22047571	BolC3t16055H	0	+	542	1051	1051	1.0000000
C3	22054058	22054269	BolC3t16056H	0	+	19	164	211	0.7772512
C3	22056735	22060100	BolC3t16057H	0	+	888	3152	3365	0.9367014
C3	22061823	22062874	BolC3t16058H	0	+	525	1023	1051	0.9733587
C3	22066877	22075261	BolC3t16059H	0	+	79	1501	8384	0.1790315
C3	22079256	22080402	BolC3t16060H	0	-	263	908	1146	0.7923211
C3	22084385	22085528	BolC3t16061H	0	+	503	1007	1143	0.8810149
C3	22087138	22087300	BolC3t16062H	0	-	71	162	162	1.0000000
C3	22088982	22090573	BolC3t16063H	0	+	1005	1591	1591	1.0000000
C3	22092172	22093412	BolC3t16064H	0	+	751	1240	1240	1.0000000
C3	22094134	22096082	BolC3t16065H	0	+	709	1948	1948	1.0000000
C3	22096885	22098812	BolC3t16066H	0	-	2137	1927	1927	1.0000000
C3	22107802	22111813	BolC3t16067H	0	-	1527	3707	4011	0.9242084
C3	22117191	22117710	BolC3t16068H	0	-	74	519	519	1.0000000
C3	22120736	22121839	BolC3t16069H	0	+	579	1096	1103	0.9936537
C3	22129989	22131085	BolC3t16070H	0	+	438	1040	1096	0.9489051
C3	22132714	22134693	BolC3t16071H	0	-	120	882	1979	0.4456796
C3	22152085	22158966	BolC3t16072H	0	+	1551	5759	6881	0.8369423
C3	22171433	22174083	BolC3t16073H	0	+	2515	2650	2650	1.0000000
C3	22175304	22177663	BolC3t16074H	0	-	1351	2359	2359	1.0000000
C3	22180633	22183202	BolC3t16075H	0	+	968	2362	2569	0.9194239
C3	22187119	22189147	BolC3t16076H	0	+	589	1902	2028	0.9378698
C3	22190855	22192620	BolC3t16077H	0	+	521	1577	1765	0.8934844
C3	22193405	22197601	BolC3t16078H	0	-	1917	3810	4196	0.9080076
C3	22205971	22206559	BolC3t16079H	0	+	37	490	588	0.8333333
C3	22214097	22214745	BolC3t16080H	0	-	121	559	648	0.8626543
C3	22217930	22219267	BolC3t16081H	0	+	648	1302	1337	0.9738220
C3	22220129	22220678	BolC3t16082H	0	-	372	549	549	1.0000000
C3	22228012	22229194	BolC3t16083H	0	+	512	1182	1182	1.0000000
C3	22234919	22235372	BolC3t16084H	0	-	2	132	453	0.2913907
C3	22258273	22259834	BolC3t16085H	0	+	212	1123	1561	0.7194107
C3	22270202	22270739	BolC3t16086H	0	-	52	521	537	0.9702048
C3	22273685	22276238	BolC3t16087H	0	+	628	2092	2553	0.8194281
C3	22280885	22282029	BolC3t16088H	0	+	373	1144	1144	1.0000000
C3	22292857	22293994	BolC3t16089H	0	+	2018	1137	1137	1.0000000
C3	22295439	22309155	BolC3t16090H	0	+	1608	5593	13716	0.4077719
C3	22310354	22313487	BolC3t16091H	0	-	2145	3133	3133	1.0000000
C3	22322657	22327391	BolC3t16092H	0	-	3105	4578	4734	0.9670469
C3	22337171	22337423	BolC3t16093H	0	-	0	0	252	0.0000000
C3	22340206	22341406	BolC3t16094H	0	+	1	63	1200	0.0525000
C3	22341672	22343672	BolC3t16095H	0	-	306	1736	2000	0.8680000
C3	22359910	22361466	BolC3t16096H	0	-	586	1512	1556	0.9717224
C3	22363538	22370341	BolC3t16097H	0	-	4719	6778	6803	0.9963251
C3	22371998	22375997	BolC3t16098H	0	-	2280	3927	3999	0.9819955
C3	22378073	22380380	BolC3t16099H	0	+	428	1715	2307	0.7433897
C3	22380692	22381130	BolC3t16100H	0	-	243	438	438	1.0000000
C3	22392686	22393845	BolC3t16101H	0	+	644	1047	1159	0.9033650
C3	22397273	22400679	BolC3t16102H	0	-	1018	2920	3406	0.8573107
C3	22401337	22402130	BolC3t16103H	0	+	304	569	793	0.7175284
C3	22403920	22405555	BolC3t16104H	0	-	961	1625	1635	0.9938838
C3	22406156	22408388	BolC3t16105H	0	+	725	2181	2232	0.9771506
C3	22410839	22411946	BolC3t16106H	0	+	842	1107	1107	1.0000000
C3	22418810	22421114	BolC3t16107H	0	+	552	1592	2304	0.6909722
C3	22436457	22438311	BolC3t16108H	0	+	879	1854	1854	1.0000000
C3	22439165	22440608	BolC3t16109H	0	+	192	1199	1443	0.8309078
C3	22444262	22446498	BolC3t16110H	0	-	2218	2236	2236	1.0000000
C3	22448301	22451578	BolC3t16111H	0	+	1383	2112	3277	0.6444919
C3	22451989	22453904	BolC3t16112H	0	-	1650	1696	1915	0.8856397
C3	22454538	22455499	BolC3t16113H	0	+	190	807	961	0.8397503
C3	22455597	22456017	BolC3t16114H	0	-	185	420	420	1.0000000
C3	22460722	22471576	BolC3t16115H	0	-	8408	10485	10854	0.9660033
C3	22484460	22486715	BolC3t16116H	0	-	282	870	2255	0.3858093
C3	22487436	22489355	BolC3t16117H	0	+	867	1884	1919	0.9817613
C3	22490814	22492767	BolC3t16118H	0	+	128	1524	1953	0.7803379
C3	22499215	22500397	BolC3t16119H	0	+	31	124	1182	0.1049069
C3	22501414	22506402	BolC3t16120H	0	+	988	2453	4988	0.4917803
C3	22506530	22507341	BolC3t16121H	0	-	150	421	811	0.5191122
C3	22512044	22512562	BolC3t16122H	0	-	211	513	518	0.9903475
C3	22516419	22517995	BolC3t16123H	0	+	143	856	1576	0.5431472
C3	22533907	22535167	BolC3t16124H	0	+	773	1004	1260	0.7968254
C3	22546277	22547994	BolC3t16125H	0	+	580	1717	1717	1.0000000
C3	22551785	22553005	BolC3t16126H	0	-	292	884	1220	0.7245902
C3	22568899	22569280	BolC3t16127H	0	+	66	381	381	1.0000000
C3	22586100	22588335	BolC3t16128H	0	-	287	1630	2235	0.7293065
C3	22607870	22609868	BolC3t16129H	0	+	622	1758	1998	0.8798799
C3	22628728	22631371	BolC3t16130H	0	+	818	2643	2643	1.0000000
C3	22636971	22638499	BolC3t16131H	0	+	312	1215	1528	0.7951571
C3	22652183	22654149	BolC3t16132H	0	-	87	1296	1966	0.6592065
C3	22669435	22671273	BolC3t16133H	0	-	55	537	1838	0.2921654
C3	22675523	22676400	BolC3t16134H	0	-	132	842	877	0.9600912
C3	22687105	22687795	BolC3t16135H	0	-	201	656	690	0.9507247
C3	22689874	22692321	BolC3t16136H	0	+	362	1913	2447	0.7817736
C3	22693715	22695756	BolC3t16137H	0	+	291	1814	2041	0.8887800
C3	22696900	22697002	BolC3t16138H	0	-	172	102	102	1.0000000
C3	22697130	22697966	BolC3t16139H	0	+	291	826	836	0.9880383
C3	22699276	22699998	BolC3t16140H	0	-	401	722	722	1.0000000
C3	22700812	22702409	BolC3t16141H	0	+	397	1349	1597	0.8447088
C3	22707834	22708157	BolC3t16142H	0	+	127	272	323	0.8421053
C3	22716611	22718535	BolC3t16143H	0	+	675	1901	1924	0.9880458
C3	22720420	22721656	BolC3t16144H	0	-	61	355	1236	0.2872168
C3	22723312	22725322	BolC3t16145H	0	+	1136	2010	2010	1.0000000
C3	22725824	22727581	BolC3t16146H	0	-	1022	1730	1757	0.9846329
C3	22730315	22730647	BolC3t16147H	0	-	158	332	332	1.0000000
C3	22731163	22734136	BolC3t16148H	0	-	1898	2883	2973	0.9697276
C3	22741047	22742135	BolC3t16149H	0	+	96	630	1088	0.5790441
C3	22750594	22751404	BolC3t16150H	0	+	799	810	810	1.0000000
C3	22751937	22752571	BolC3t16151H	0	+	459	634	634	1.0000000
C3	22760121	22767033	BolC3t16152H	0	+	3831	6794	6912	0.9829282
C3	22768295	22769837	BolC3t16153H	0	-	1280	1421	1542	0.9215305
C3	22775922	22776410	BolC3t16154H	0	-	6	170	488	0.3483607
C3	22817194	22821316	BolC3t16155H	0	-	2138	3946	4122	0.9573023
C3	22822758	22823023	BolC3t16156H	0	+	104	265	265	1.0000000
C3	22824411	22829383	BolC3t16157H	0	+	1912	3901	4972	0.7845937
C3	22835223	22835695	BolC3t16158H	0	+	29	198	472	0.4194915
C3	22842158	22843238	BolC3t16159H	0	-	18	387	1080	0.3583333
C3	22852025	22854551	BolC3t16160H	0	-	997	2079	2526	0.8230404
C3	22860341	22862540	BolC3t16161H	0	+	475	2005	2199	0.9117781
C3	22863318	22864092	BolC3t16162H	0	-	35	529	774	0.6834626
C3	22880994	22882649	BolC3t16163H	0	+	393	1486	1655	0.8978852
C3	22884410	22884554	BolC3t16164H	0	-	10	144	144	1.0000000
C3	22889886	22890874	BolC3t16165H	0	+	605	988	988	1.0000000
C3	22891218	22893230	BolC3t16166H	0	-	414	1458	2012	0.7246521
C3	22902567	22906989	BolC3t16167H	0	-	1515	3632	4422	0.8213478
C3	22909599	22911170	BolC3t16168H	0	-	592	1565	1571	0.9961808
C3	22911610	22914121	BolC3t16169H	0	+	698	2009	2511	0.8000796
C3	22914533	22919279	BolC3t16170H	0	-	1986	4389	4746	0.9247788
C3	22920669	22922033	BolC3t16171H	0	-	616	1334	1364	0.9780059
C3	22922369	22925367	BolC3t16172H	0	+	1354	2695	2998	0.8989326
C3	22926780	22928621	BolC3t16173H	0	+	579	1805	1841	0.9804454
C3	22929027	22930736	BolC3t16174H	0	-	591	1642	1709	0.9607958
C3	22931794	22933489	BolC3t16175H	0	-	1351	1695	1695	1.0000000
C3	22941914	22944499	BolC3t16176H	0	+	1389	2584	2585	0.9996132
C3	22945393	22948046	BolC3t16177H	0	+	546	2580	2653	0.9724840
C3	22951409	22955648	BolC3t16178H	0	+	580	3524	4239	0.8313282
C3	22957346	22960077	BolC3t16179H	0	+	1667	2731	2731	1.0000000
C3	22961301	22962592	BolC3t16180H	0	+	14	231	1291	0.1789311
C3	22964874	22967011	BolC3t16181H	0	-	310	1934	2137	0.9050070
C3	22968233	22971394	BolC3t16182H	0	-	424	2909	3161	0.9202784
C3	22979880	22980369	BolC3t16183H	0	+	54	458	489	0.9366053
C3	22981251	22983883	BolC3t16184H	0	-	1306	2632	2632	1.0000000
C3	22985222	22987146	BolC3t16185H	0	+	1247	1924	1924	1.0000000
C3	22988615	22992149	BolC3t16186H	0	+	854	3327	3534	0.9414262
C3	22992979	22993932	BolC3t16187H	0	-	533	944	953	0.9905561
C3	22994266	22997820	BolC3t16188H	0	-	3005	3554	3554	1.0000000
C3	22998490	23000229	BolC3t16189H	0	+	306	1407	1739	0.8090857
C3	23012807	23016317	BolC3t16190H	0	+	751	3106	3510	0.8849003
C3	23016367	23021353	BolC3t16191H	0	+	1144	4235	4986	0.8493783
C3	23021842	23030025	BolC3t16192H	0	-	219	2409	8183	0.2943908
C3	23034101	23036858	BolC3t16193H	0	-	736	2328	2757	0.8443961
C3	23066867	23067020	BolC3t16194H	0	+	0	0	153	0.0000000
C3	23081397	23082671	BolC3t16195H	0	+	390	1217	1274	0.9552590
C3	23083412	23086444	BolC3t16196H	0	+	984	2781	3032	0.9172164
C3	23087239	23089841	BolC3t16197H	0	-	540	2177	2602	0.8366641
C3	23096168	23097451	BolC3t16198H	0	+	24	859	1283	0.6695246
C3	23107008	23107641	BolC3t16199H	0	+	294	572	633	0.9036335
C3	23122839	23124768	BolC3t16200H	0	+	19	657	1929	0.3405910
C3	23128103	23130246	BolC3t16201H	0	-	176	1568	2143	0.7316846
C3	23150135	23150540	BolC3t16202H	0	+	158	369	405	0.9111111
C3	23150999	23152873	BolC3t16203H	0	-	61	1241	1874	0.6622198
C3	23153541	23156999	BolC3t16204H	0	-	1333	3240	3458	0.9369578
C3	23161813	23162239	BolC3t16205H	0	-	91	201	426	0.4718310
C3	23162926	23164116	BolC3t16206H	0	+	492	1182	1190	0.9932773
C3	23164580	23167609	BolC3t16207H	0	-	565	2931	3029	0.9676461
C3	23170515	23171904	BolC3t16208H	0	-	834	1389	1389	1.0000000
C3	23172277	23173624	BolC3t16209H	0	+	1280	1347	1347	1.0000000
C3	23174402	23177121	BolC3t16210H	0	-	665	2046	2719	0.7524825
C3	23179178	23179556	BolC3t16211H	0	-	56	312	378	0.8253968
C3	23185971	23186247	BolC3t16212H	0	-	267	276	276	1.0000000
C3	23187268	23190332	BolC3t16213H	0	+	488	2292	3064	0.7480417
C3	23191452	23191635	BolC3t16214H	0	+	96	183	183	1.0000000
C3	23193405	23193816	BolC3t16215H	0	-	352	383	411	0.9318735
C3	23194496	23197694	BolC3t16216H	0	-	3223	3198	3198	1.0000000
C3	23200509	23201585	BolC3t16217H	0	-	1666	1076	1076	1.0000000
C3	23202952	23204611	BolC3t16218H	0	-	560	1587	1659	0.9566004
C3	23207883	23208406	BolC3t16219H	0	-	4	165	523	0.3154876
C3	23208746	23209157	BolC3t16220H	0	-	4	19	411	0.0462287
C3	23222215	23225394	BolC3t16221H	0	-	1489	3101	3179	0.9754640
C3	23226288	23230631	BolC3t16222H	0	-	1564	4217	4343	0.9709878
C3	23232031	23235158	BolC3t16223H	0	+	810	2052	3127	0.6562200
C3	23236271	23241975	BolC3t16224H	0	+	3077	5625	5704	0.9861501
C3	23243971	23244881	BolC3t16225H	0	+	70	743	910	0.8164835
C3	23245526	23248191	BolC3t16226H	0	+	465	2567	2665	0.9632270
C3	23250127	23251319	BolC3t16227H	0	+	437	1148	1192	0.9630873
C3	23252851	23265365	BolC3t16228H	0	+	3244	7043	12514	0.5628096
C3	23259220	23259706	BolC3t16229H	0	+	0	0	486	0.0000000
C3	23265872	23266934	BolC3t16230H	0	-	204	1062	1062	1.0000000
C3	23288288	23295143	BolC3t16231H	0	+	2171	6185	6855	0.9022611
C3	23301760	23302846	BolC3t16232H	0	+	491	1086	1086	1.0000000
C3	23303544	23305249	BolC3t16233H	0	-	1170	1705	1705	1.0000000
C3	23308374	23310363	BolC3t16234H	0	+	240	1248	1989	0.6274510
C3	23311528	23314187	BolC3t16235H	0	+	945	1740	2659	0.6543813
C3	23314660	23315047	BolC3t16236H	0	+	42	293	387	0.7571059
C3	23316814	23317411	BolC3t16237H	0	+	158	584	597	0.9782245
C3	23318411	23318792	BolC3t16238H	0	+	9	179	381	0.4698163
C3	23330353	23330657	BolC3t16239H	0	-	188	304	304	1.0000000
C3	23331309	23332295	BolC3t16240H	0	-	233	888	986	0.9006085
C3	23332473	23334375	BolC3t16241H	0	+	206	921	1902	0.4842271
C3	23334863	23335349	BolC3t16242H	0	+	190	486	486	1.0000000
C3	23338661	23339428	BolC3t16243H	0	+	211	767	767	1.0000000
C3	23341182	23354392	BolC3t16244H	0	+	5473	12094	13210	0.9155185
C3	23354664	23359692	BolC3t16245H	0	-	757	3951	5028	0.7857995
C3	23374926	23376925	BolC3t16246H	0	-	631	1975	1999	0.9879940
C3	23376992	23379392	BolC3t16247H	0	-	521	2065	2400	0.8604167
C3	23380495	23381482	BolC3t16248H	0	-	396	987	987	1.0000000
C3	23382037	23384131	BolC3t16249H	0	+	644	2061	2094	0.9842407
C3	23384635	23388176	BolC3t16250H	0	-	1355	2489	3541	0.7029088
C3	23391552	23391834	BolC3t16251H	0	-	302	282	282	1.0000000
C3	23396032	23396395	BolC3t16252H	0	-	81	363	363	1.0000000
C3	23397403	23398820	BolC3t16253H	0	-	951	1417	1417	1.0000000
C3	23403357	23403936	BolC3t16254H	0	-	88	568	579	0.9810017
C3	23405109	23406252	BolC3t16255H	0	+	196	1087	1143	0.9510061
C3	23407189	23408041	BolC3t16256H	0	-	318	852	852	1.0000000
C3	23419937	23420843	BolC3t16257H	0	+	5	235	906	0.2593819
C3	23428600	23429749	BolC3t16258H	0	+	276	997	1149	0.8677111
C3	23430020	23433049	BolC3t16259H	0	-	312	2257	3029	0.7451304
C3	23442672	23448922	BolC3t16260H	0	+	1090	5058	6250	0.8092800
C3	23446902	23447409	BolC3t16261H	0	+	52	507	507	1.0000000
C3	23449420	23451465	BolC3t16262H	0	+	325	1653	2045	0.8083130
C3	23453797	23455241	BolC3t16263H	0	+	364	1325	1444	0.9175900
C3	23458048	23458870	BolC3t16264H	0	+	1144	822	822	1.0000000
C3	23467962	23470076	BolC3t16265H	0	-	982	2114	2114	1.0000000
C3	23477432	23480918	BolC3t16266H	0	+	1246	3486	3486	1.0000000
C3	23483519	23485309	BolC3t16267H	0	+	155	1435	1790	0.8016760
C3	23485717	23486740	BolC3t16268H	0	-	202	932	1023	0.9110460
C3	23489291	23489978	BolC3t16269H	0	-	929	687	687	1.0000000
C3	23491862	23496197	BolC3t16270H	0	+	2597	4325	4335	0.9976932
C3	23497858	23498098	BolC3t16271H	0	+	152	240	240	1.0000000
C3	23498230	23499334	BolC3t16272H	0	+	133	1041	1104	0.9429348
C3	23501112	23501494	BolC3t16273H	0	+	188	382	382	1.0000000
C3	23502130	23504089	BolC3t16274H	0	+	840	1932	1959	0.9862174
C3	23505399	23506049	BolC3t16275H	0	+	19	246	650	0.3784615
C3	23509575	23509716	BolC3t16276H	0	-	50	141	141	1.0000000
C3	23517107	23519706	BolC3t16277H	0	+	515	2254	2599	0.8672566
C3	23520818	23521193	BolC3t16278H	0	-	315	375	375	1.0000000
C3	23523408	23523624	BolC3t16279H	0	-	272	216	216	1.0000000
C3	23526312	23528917	BolC3t16280H	0	-	840	2379	2605	0.9132438
C3	23529565	23530433	BolC3t16281H	0	-	251	868	868	1.0000000
C3	23537597	23538428	BolC3t16282H	0	+	332	807	831	0.9711191
C3	23539924	23540936	BolC3t16283H	0	+	98	680	1012	0.6719368
C3	23541494	23542682	BolC3t16284H	0	+	135	841	1188	0.7079124
C3	23543479	23544746	BolC3t16285H	0	+	62	598	1267	0.4719810
C3	23550227	23551654	BolC3t16286H	0	+	4	336	1427	0.2354590
C3	23553694	23555319	BolC3t16287H	0	+	596	1542	1625	0.9489231
C3	23556929	23558540	BolC3t16288H	0	+	859	1240	1611	0.7697083
C3	23559457	23561143	BolC3t16289H	0	+	744	1601	1686	0.9495848
C3	23561357	23562848	BolC3t16290H	0	-	1765	1491	1491	1.0000000
C3	23565228	23567111	BolC3t16291H	0	-	846	1736	1883	0.9219331
C3	23568888	23571705	BolC3t16292H	0	-	659	2782	2817	0.9875754
C3	23578769	23579969	BolC3t16293H	0	-	1294	1200	1200	1.0000000
C3	23580639	23582713	BolC3t16294H	0	-	1125	2043	2074	0.9850531
C3	23583978	23584997	BolC3t16295H	0	-	385	1019	1019	1.0000000
C3	23592953	23595178	BolC3t16296H	0	-	120	1386	2225	0.6229213
C3	23597582	23599255	BolC3t16297H	0	+	657	1637	1673	0.9784818
C3	23600713	23601820	BolC3t16298H	0	+	59	790	1107	0.7136405
C3	23601869	23605955	BolC3t16299H	0	-	889	3102	4086	0.7591777
C3	23607972	23609731	BolC3t16300H	0	-	131	922	1759	0.5241615
C3	23613889	23615233	BolC3t16301H	0	-	673	1344	1344	1.0000000
C3	23625741	23631758	BolC3t16302H	0	-	2355	5535	6017	0.9198936
C3	23636750	23637848	BolC3t16303H	0	-	831	1098	1098	1.0000000
C3	23639644	23640719	BolC3t16304H	0	-	209	986	1075	0.9172093
C3	23649835	23650223	BolC3t16305H	0	+	53	385	388	0.9922680
C3	23652674	23653389	BolC3t16306H	0	-	1157	715	715	1.0000000
C3	23655023	23657092	BolC3t16307H	0	+	757	2004	2069	0.9685839
C3	23657857	23658915	BolC3t16308H	0	-	223	1058	1058	1.0000000
C3	23660330	23673139	BolC3t16309H	0	-	6326	11260	12809	0.8790694
C3	23673189	23673654	BolC3t16310H	0	+	485	465	465	1.0000000
C3	23679099	23682504	BolC3t16311H	0	-	350	2449	3405	0.7192364
C3	23679992	23680982	BolC3t16312H	0	+	80	511	990	0.5161616
C3	23682941	23683334	BolC3t16313H	0	+	80	393	393	1.0000000
C3	23686190	23686871	BolC3t16314H	0	+	25	319	681	0.4684288
C3	23687954	23688344	BolC3t16315H	0	-	0	0	390	0.0000000
C3	23689251	23689608	BolC3t16316H	0	+	329	357	357	1.0000000
C3	23700837	23701089	BolC3t16317H	0	+	2	69	252	0.2738095
C3	23701767	23703913	BolC3t16318H	0	-	391	1495	2146	0.6966449
C3	23705112	23706479	BolC3t16319H	0	-	208	1066	1367	0.7798098
C3	23707638	23708619	BolC3t16320H	0	-	575	981	981	1.0000000
C3	23710465	23713686	BolC3t16321H	0	-	1020	2952	3221	0.9164855
C3	23715239	23718923	BolC3t16322H	0	+	1301	3090	3684	0.8387622
C3	23719584	23720244	BolC3t16323H	0	-	79	497	660	0.7530303
C3	23721537	23723802	BolC3t16324H	0	-	183	983	2265	0.4339956
C3	23726521	23731497	BolC3t16325H	0	+	1276	4524	4976	0.9091640
C3	23735216	23736637	BolC3t16326H	0	+	1010	1421	1421	1.0000000
C3	23736843	23739990	BolC3t16327H	0	-	2052	2750	3147	0.8738481
C3	23745824	23749683	BolC3t16328H	0	+	949	3661	3859	0.9486914
C3	23750665	23754289	BolC3t16329H	0	-	1599	3476	3624	0.9591612
C3	23755520	23756372	BolC3t16330H	0	+	469	728	852	0.8544601
C3	23762617	23764230	BolC3t16331H	0	+	948	1613	1613	1.0000000
C3	23764814	23767540	BolC3t16332H	0	-	268	2214	2726	0.8121790
C3	23769965	23773094	BolC3t16333H	0	+	761	2858	3129	0.9133909
C3	23773871	23775576	BolC3t16334H	0	+	372	1404	1705	0.8234604
C3	23776998	23777151	BolC3t16335H	0	+	157	153	153	1.0000000
C3	23777155	23777511	BolC3t16336H	0	+	235	356	356	1.0000000
C3	23777905	23778671	BolC3t16337H	0	+	164	618	766	0.8067885
C3	23781966	23783734	BolC3t16338H	0	+	469	1713	1768	0.9688914
C3	23784656	23786917	BolC3t16339H	0	-	1025	2124	2261	0.9394073
C3	23789929	23790312	BolC3t16340H	0	-	71	144	383	0.3759791
C3	23793745	23794252	BolC3t16341H	0	-	28	217	507	0.4280079
C3	23796561	23797002	BolC3t16342H	0	-	272	441	441	1.0000000
C3	23798161	23798693	BolC3t16343H	0	-	142	505	532	0.9492481
C3	23802318	23804979	BolC3t16344H	0	-	2003	2641	2661	0.9924840
C3	23807752	23808141	BolC3t16345H	0	+	255	389	389	1.0000000
C3	23808778	23810252	BolC3t16346H	0	-	754	1474	1474	1.0000000
C3	23810314	23811490	BolC3t16347H	0	-	202	804	1176	0.6836734
C3	23814398	23817027	BolC3t16348H	0	+	1254	2397	2629	0.9117535
C3	23818213	23818786	BolC3t16349H	0	+	332	573	573	1.0000000
C3	23820912	23823513	BolC3t16350H	0	+	1066	2559	2601	0.9838524
C3	23824006	23827188	BolC3t16351H	0	-	1100	3131	3182	0.9839724
C3	23831534	23832057	BolC3t16352H	0	+	363	436	523	0.8336520
C3	23835631	23837221	BolC3t16353H	0	+	443	1513	1590	0.9515723
C3	23841834	23843737	BolC3t16354H	0	-	243	1442	1903	0.7577509
C3	23860563	23863351	BolC3t16355H	0	-	684	2092	2788	0.7503587
C3	23871605	23872178	BolC3t16356H	0	-	0	0	573	0.0000000
C3	23874044	23875257	BolC3t16357H	0	+	2	264	1213	0.2176422
C3	23876751	23882450	BolC3t16358H	0	-	4	158	5699	0.0277242
C3	23884299	23884746	BolC3t16359H	0	+	7	99	447	0.2214765
C3	23885859	23886456	BolC3t16360H	0	+	3	61	597	0.1021776
C3	23887843	23903895	BolC3t16361H	0	-	91	2938	16052	0.1830302
C3	23898532	23911322	BolC3t16362H	0	+	103	2208	12790	0.1726349
C3	23925345	23927554	BolC3t16363H	0	-	39	257	2209	0.1163422
C3	23927776	23932166	BolC3t16364H	0	-	19	530	4390	0.1207289
C3	23937573	23940148	BolC3t16365H	0	+	62	1166	2575	0.4528155
C3	23944106	23946104	BolC3t16366H	0	-	64	881	1998	0.4409409
C3	23949911	23950508	BolC3t16367H	0	+	8	110	597	0.1842546
C3	23952422	23953379	BolC3t16368H	0	-	24	631	957	0.6593521
C3	23977022	23977187	BolC3t16369H	0	-	0	0	165	0.0000000
C3	23988167	23988740	BolC3t16370H	0	-	0	0	573	0.0000000
C3	23991063	23992076	BolC3t16371H	0	+	0	0	1013	0.0000000
C3	23993192	23993603	BolC3t16372H	0	+	0	0	411	0.0000000
C3	23995408	24004901	BolC3t16373H	0	+	390	1629	9493	0.1716001
C3	24005108	24010740	BolC3t16374H	0	-	35	1207	5632	0.2143111
C3	24005961	24008900	BolC3t16375H	0	-	8	260	2939	0.0884655
C3	24014281	24028611	BolC3t16376H	0	+	1486	7838	14330	0.5469644
C3	24015307	24016081	BolC3t16377H	0	+	408	774	774	1.0000000
C3	24038159	24038300	BolC3t16378H	0	-	4	46	141	0.3262411
C3	24040286	24041234	BolC3t16379H	0	-	0	0	948	0.0000000
C3	24041890	24042031	BolC3t16380H	0	+	24	141	141	1.0000000
C3	24063079	24065628	BolC3t16381H	0	-	20	848	2549	0.3326795
C3	24066132	24066297	BolC3t16382H	0	-	0	0	165	0.0000000
C3	24077251	24077824	BolC3t16383H	0	-	0	0	573	0.0000000
C3	24080153	24093532	BolC3t16384H	0	+	281	3138	13379	0.2345467
C3	24081912	24082698	BolC3t16385H	0	+	0	0	786	0.0000000
C3	24093752	24099499	BolC3t16386H	0	-	21	766	5747	0.1332869
C3	24101100	24101547	BolC3t16387H	0	+	4	238	447	0.5324385
C3	24102660	24103257	BolC3t16388H	0	+	8	92	597	0.1541038
C3	24108423	24120856	BolC3t16389H	0	-	328	4416	12433	0.3551838
C3	24114615	24133460	BolC3t16390H	0	-	266	5002	18845	0.2654285
C3	24115297	24115730	BolC3t16391H	0	+	17	174	433	0.4018476
C3	24135525	24137377	BolC3t16392H	0	-	268	1132	1852	0.6112311
C3	24138526	24139494	BolC3t16393H	0	-	141	888	968	0.9173554
C3	24151664	24152723	BolC3t16394H	0	+	461	1059	1059	1.0000000
C3	24153524	24155909	BolC3t16395H	0	+	1061	2320	2385	0.9727463
C3	24156379	24157477	BolC3t16396H	0	-	606	1097	1098	0.9990892
C3	24163522	24165899	BolC3t16397H	0	-	2172	2377	2377	1.0000000
C3	24167637	24169282	BolC3t16398H	0	+	214	1063	1645	0.6462006
C3	24172568	24173330	BolC3t16399H	0	-	690	762	762	1.0000000
C3	24174355	24175233	BolC3t16400H	0	-	174	725	878	0.8257403
C3	24178463	24178748	BolC3t16401H	0	-	59	285	285	1.0000000
C3	24179536	24179785	BolC3t16402H	0	+	110	249	249	1.0000000
C3	24186938	24189951	BolC3t16403H	0	+	971	2789	3013	0.9256555
C3	24190312	24194367	BolC3t16404H	0	-	1887	3723	4055	0.9181257
C3	24195594	24198195	BolC3t16405H	0	+	1499	2497	2601	0.9600154
C3	24209103	24209559	BolC3t16406H	0	+	70	165	456	0.3618421
C3	24210699	24212015	BolC3t16407H	0	+	327	1275	1316	0.9688450
C3	24212765	24215171	BolC3t16408H	0	-	794	2315	2406	0.9621779
C3	24221897	24225121	BolC3t16409H	0	+	1047	3101	3224	0.9618486
C3	24230377	24232701	BolC3t16410H	0	+	2543	2324	2324	1.0000000
C3	24233174	24235036	BolC3t16411H	0	+	775	1215	1862	0.6525242
C3	24235224	24236181	BolC3t16412H	0	-	42	688	957	0.7189133
C3	24236519	24236878	BolC3t16413H	0	-	85	271	359	0.7548746
C3	24239138	24239464	BolC3t16414H	0	-	69	295	326	0.9049080
C3	24241073	24242880	BolC3t16415H	0	+	1019	1586	1807	0.8776978
C3	24244268	24246326	BolC3t16416H	0	+	1236	2053	2058	0.9975705
C3	24246702	24247583	BolC3t16417H	0	-	409	870	881	0.9875142
C3	24249227	24250275	BolC3t16418H	0	+	695	892	1048	0.8511450
C3	24251132	24255096	BolC3t16419H	0	-	1406	3795	3964	0.9573663
C3	24256356	24258047	BolC3t16420H	0	+	438	1610	1691	0.9520993
C3	24259151	24261793	BolC3t16421H	0	-	589	1960	2642	0.7418622
C3	24264000	24266302	BolC3t16422H	0	+	372	1714	2302	0.7445700
C3	24276146	24277798	BolC3t16423H	0	+	208	1649	1652	0.9981840
C3	24283500	24284552	BolC3t16424H	0	+	355	1024	1052	0.9733840
C3	24288185	24289349	BolC3t16425H	0	+	58	415	1164	0.3565292
C3	24294709	24295070	BolC3t16426H	0	-	11	332	361	0.9196676
C3	24295389	24296093	BolC3t16427H	0	-	3	125	704	0.1775568
C3	24298071	24299625	BolC3t16428H	0	-	665	1479	1554	0.9517375
C3	24300455	24301938	BolC3t16429H	0	-	196	1405	1483	0.9474039
C3	24302849	24303942	BolC3t16430H	0	-	361	1059	1093	0.9688929
C3	24306058	24308966	BolC3t16431H	0	+	201	1574	2908	0.5412655
C3	24309440	24313962	BolC3t16432H	0	+	1063	4079	4522	0.9020345
C3	24314207	24316966	BolC3t16433H	0	-	573	2429	2759	0.8803914
C3	24320249	24321047	BolC3t16434H	0	+	380	798	798	1.0000000
C3	24324495	24324852	BolC3t16435H	0	+	21	304	357	0.8515406
C3	24326038	24328436	BolC3t16436H	0	+	342	2119	2398	0.8836530
C3	24329116	24331450	BolC3t16437H	0	+	2122	2334	2334	1.0000000
C3	24331969	24334168	BolC3t16438H	0	+	1407	2199	2199	1.0000000
C3	24335193	24337430	BolC3t16439H	0	+	542	1984	2237	0.8869021
C3	24338666	24339134	BolC3t16440H	0	+	78	437	468	0.9337607
C3	24340008	24341922	BolC3t16441H	0	-	543	1833	1914	0.9576802
C3	24344443	24345279	BolC3t16442H	0	+	210	822	836	0.9832536
C3	24345751	24348193	BolC3t16443H	0	-	245	1813	2442	0.7424242
C3	24350808	24391970	BolC3t16444H	0	+	19393	33089	41162	0.8038725
C3	24355018	24356473	BolC3t16445H	0	+	542	1221	1455	0.8391753
C3	24358264	24361327	BolC3t16446H	0	+	1156	2850	3063	0.9304603
C3	24375987	24379512	BolC3t16447H	0	+	1877	3525	3525	1.0000000
C3	24384086	24385397	BolC3t16448H	0	-	935	1311	1311	1.0000000
C3	24386578	24387123	BolC3t16449H	0	+	402	545	545	1.0000000
C3	24387367	24388220	BolC3t16450H	0	+	1088	853	853	1.0000000
C3	24392706	24403471	BolC3t16451H	0	-	3522	9070	10765	0.8425453
C3	24404572	24406061	BolC3t16452H	0	-	511	1423	1489	0.9556749
C3	24430266	24430706	BolC3t16453H	0	+	105	440	440	1.0000000
C3	24446688	24447088	BolC3t16454H	0	+	25	362	400	0.9050000
C3	24457278	24457718	BolC3t16455H	0	+	94	409	440	0.9295455
C3	24470239	24470442	BolC3t16456H	0	-	113	203	203	1.0000000
C3	24470574	24473482	BolC3t16457H	0	-	1129	2908	2908	1.0000000
C3	24470916	24472598	BolC3t16458H	0	-	879	1682	1682	1.0000000
C3	24473617	24474218	BolC3t16459H	0	-	241	601	601	1.0000000
C3	24477127	24477694	BolC3t16460H	0	+	25	230	567	0.4056437
C3	24481534	24483970	BolC3t16461H	0	+	896	2343	2436	0.9618227
C3	24497015	24497288	BolC3t16462H	0	+	4	125	273	0.4578755
C3	24500510	24500675	BolC3t16463H	0	+	107	165	165	1.0000000
C3	24501749	24502020	BolC3t16464H	0	-	322	271	271	1.0000000
C3	24515679	24515950	BolC3t16465H	0	-	70	271	271	1.0000000
C3	24520076	24524543	BolC3t16466H	0	-	1709	4031	4467	0.9023954
C3	24534937	24535856	BolC3t16467H	0	+	300	852	919	0.9270946
C3	24536675	24537005	BolC3t16468H	0	-	83	303	330	0.9181818
C3	24538626	24538947	BolC3t16469H	0	-	66	321	321	1.0000000
C3	24540887	24543819	BolC3t16470H	0	+	1155	2743	2932	0.9355389
C3	24545831	24546831	BolC3t16471H	0	+	32	428	1000	0.4280000
C3	24548874	24549766	BolC3t16472H	0	+	173	885	892	0.9921525
C3	24551209	24553871	BolC3t16473H	0	-	984	2623	2662	0.9853494
C3	24555309	24560258	BolC3t16474H	0	-	1830	4167	4949	0.8419883
C3	24568667	24569513	BolC3t16475H	0	+	367	791	846	0.9349882
C3	24583873	24585194	BolC3t16476H	0	-	740	1232	1321	0.9326268
C3	24585891	24591698	BolC3t16477H	0	-	3500	5550	5807	0.9557431
C3	24597991	24598512	BolC3t16478H	0	-	627	521	521	1.0000000
C3	24600511	24602734	BolC3t16479H	0	-	445	1892	2223	0.8511021
C3	24612675	24613703	BolC3t16480H	0	+	77	585	1028	0.5690662
C3	24614329	24615951	BolC3t16481H	0	-	93	887	1622	0.5468557
C3	24617456	24619214	BolC3t16482H	0	-	918	1740	1758	0.9897611
C3	24621732	24623472	BolC3t16483H	0	+	253	1104	1740	0.6344827
C3	24625793	24626999	BolC3t16484H	0	+	300	1206	1206	1.0000000
C3	24631561	24632181	BolC3t16485H	0	-	169	599	620	0.9661290
C3	24634581	24635622	BolC3t16486H	0	-	105	820	1041	0.7877041
C3	24638897	24640030	BolC3t16487H	0	+	291	1123	1133	0.9911739
C3	24641120	24648882	BolC3t16488H	0	-	2777	6169	7762	0.7947694
C3	24649272	24651071	BolC3t16489H	0	+	814	1604	1799	0.8916065
C3	24653740	24656417	BolC3t16490H	0	+	1167	2473	2677	0.9237953
C3	24656813	24658787	BolC3t16491H	0	-	1079	1974	1974	1.0000000
C3	24665176	24668534	BolC3t16492H	0	-	2017	3320	3358	0.9886838
C3	24669587	24671868	BolC3t16493H	0	-	1147	2249	2281	0.9859711
C3	24675217	24675387	BolC3t16494H	0	-	134	170	170	1.0000000
C3	24685077	24686332	BolC3t16495H	0	-	592	1255	1255	1.0000000
C3	24687178	24690651	BolC3t16496H	0	-	1643	3371	3473	0.9706306
C3	24694581	24695418	BolC3t16497H	0	+	148	803	837	0.9593787
C3	24696082	24699931	BolC3t16498H	0	-	465	2050	3849	0.5326059
C3	24700939	24702944	BolC3t16499H	0	-	497	2004	2005	0.9995012
C3	24715824	24717644	BolC3t16500H	0	+	200	1649	1820	0.9060439
C3	24726819	24735913	BolC3t16501H	0	+	1658	7754	9094	0.8526501
C3	24751734	24754783	BolC3t16502H	0	-	729	2145	3049	0.7035093
C3	24757618	24763783	BolC3t16503H	0	-	3207	5496	6165	0.8914842
C3	24767333	24771843	BolC3t16504H	0	+	2059	3750	4510	0.8314856
C3	24773649	24774189	BolC3t16505H	0	-	63	446	540	0.8259259
C3	24778766	24778928	BolC3t16506H	0	-	0	0	162	0.0000000
C3	24779459	24781411	BolC3t16507H	0	-	771	1843	1952	0.9441599
C3	24784047	24785765	BolC3t16508H	0	+	896	1718	1718	1.0000000
C3	24789134	24795538	BolC3t16509H	0	-	1543	4982	6404	0.7779513
C3	24796976	24797229	BolC3t16510H	0	-	342	253	253	1.0000000
C3	24800975	24804415	BolC3t16511H	0	-	336	2312	3440	0.6720930
C3	24808336	24808801	BolC3t16512H	0	-	58	444	465	0.9548387
C3	24818715	24820598	BolC3t16513H	0	+	740	1815	1883	0.9638874
C3	24821081	24823241	BolC3t16514H	0	-	497	1780	2160	0.8240741
C3	24827872	24829106	BolC3t16515H	0	-	25	486	1234	0.3938412
C3	24831655	24832174	BolC3t16516H	0	+	420	519	519	1.0000000
C3	24832388	24833418	BolC3t16517H	0	-	1080	1030	1030	1.0000000
C3	24834600	24837120	BolC3t16518H	0	+	462	2111	2520	0.8376984
C3	24841710	24843873	BolC3t16519H	0	-	1419	2163	2163	1.0000000
C3	24844769	24849179	BolC3t16520H	0	+	1731	4194	4410	0.9510204
C3	24850226	24851102	BolC3t16521H	0	+	1108	876	876	1.0000000
C3	24852714	24857959	BolC3t16522H	0	-	2250	5016	5245	0.9563394
C3	24861408	24861789	BolC3t16523H	0	+	10	239	381	0.6272966
C3	24864466	24867118	BolC3t16524H	0	+	653	2159	2652	0.8141026
C3	24872259	24874975	BolC3t16525H	0	-	333	2065	2716	0.7603093
C3	24875546	24877273	BolC3t16526H	0	+	642	1492	1727	0.8639259
C3	24877640	24879421	BolC3t16527H	0	-	457	808	1781	0.4536777
C3	24883872	24884930	BolC3t16528H	0	+	233	656	1058	0.6200378
C3	24885597	24888433	BolC3t16529H	0	-	803	2490	2836	0.8779972
C3	24898599	24900396	BolC3t16530H	0	-	1615	1797	1797	1.0000000
C3	24900588	24902036	BolC3t16531H	0	+	775	1439	1448	0.9937845
C3	24902374	24905165	BolC3t16532H	0	-	1021	2791	2791	1.0000000
C3	24919513	24919822	BolC3t16533H	0	+	0	0	309	0.0000000
C3	24923810	24925229	BolC3t16534H	0	+	1023	1419	1419	1.0000000
C3	24925798	24930432	BolC3t16535H	0	-	3248	4586	4634	0.9896418
C3	24934176	24934533	BolC3t16536H	0	+	504	357	357	1.0000000
C3	24957875	24960593	BolC3t16537H	0	+	1633	2718	2718	1.0000000
C3	24962069	24974424	BolC3t16538H	0	+	1918	7870	12355	0.6369891
C3	24975280	24976582	BolC3t16539H	0	-	85	1043	1302	0.8010753
C3	24979773	24980846	BolC3t16540H	0	+	23	363	1073	0.3383038
C3	24981146	24993654	BolC3t16541H	0	-	1260	7143	12508	0.5710745
C3	24995850	24997113	BolC3t16542H	0	+	857	1263	1263	1.0000000
C3	25009482	25010357	BolC3t16543H	0	+	66	449	875	0.5131429
C3	25010869	25011123	BolC3t16544H	0	+	568	254	254	1.0000000
C3	25011735	25013056	BolC3t16545H	0	-	361	1219	1321	0.9227858
C3	25014813	25017021	BolC3t16546H	0	-	2083	2208	2208	1.0000000
C3	25018907	25022963	BolC3t16547H	0	-	908	3426	4056	0.8446745
C3	25025296	25028371	BolC3t16548H	0	-	750	2798	3075	0.9099187
C3	25051917	25053748	BolC3t16549H	0	+	609	1587	1831	0.8667395
C3	25055906	25057250	BolC3t16550H	0	-	1419	1344	1344	1.0000000
C3	25068127	25069085	BolC3t16551H	0	+	133	805	958	0.8402923
C3	25069641	25070265	BolC3t16552H	0	-	258	624	624	1.0000000
C3	25070641	25071391	BolC3t16553H	0	+	404	750	750	1.0000000
C3	25072390	25074873	BolC3t16554H	0	-	941	2483	2483	1.0000000
C3	25076771	25077068	BolC3t16555H	0	+	8	135	297	0.4545455
C3	25082054	25082366	BolC3t16556H	0	-	2	20	312	0.0641026
C3	25086075	25087146	BolC3t16557H	0	-	78	726	1071	0.6778712
C3	25093948	25094410	BolC3t16558H	0	+	21	298	462	0.6450216
C3	25095604	25096177	BolC3t16559H	0	-	102	573	573	1.0000000
C3	25098268	25100035	BolC3t16560H	0	-	1626	1697	1767	0.9603848
C3	25104315	25106776	BolC3t16561H	0	-	1548	2461	2461	1.0000000
C3	25108233	25110002	BolC3t16562H	0	-	799	1623	1769	0.9174675
C3	25110112	25111907	BolC3t16563H	0	+	736	1484	1795	0.8267409
C3	25112924	25114777	BolC3t16564H	0	-	584	1685	1853	0.9093362
C3	25117093	25117919	BolC3t16565H	0	+	78	245	826	0.2966102
C3	25118247	25119034	BolC3t16566H	0	-	689	727	787	0.9237611
C3	25120300	25122705	BolC3t16567H	0	+	1300	2050	2405	0.8523908
C3	25129414	25130869	BolC3t16568H	0	+	1143	1429	1455	0.9821306
C3	25134209	25135692	BolC3t16569H	0	-	5	43	1483	0.0289953
C3	25135973	25136872	BolC3t16570H	0	-	5	230	899	0.2558398
C3	25143185	25144655	BolC3t16571H	0	+	383	1109	1470	0.7544218
C3	25146766	25147629	BolC3t16572H	0	+	235	863	863	1.0000000
C3	25148446	25149080	BolC3t16573H	0	+	199	634	634	1.0000000
C3	25149593	25150574	BolC3t16574H	0	-	285	981	981	1.0000000
C3	25152101	25153810	BolC3t16575H	0	+	275	1699	1709	0.9941486
C3	25155555	25156910	BolC3t16576H	0	-	208	786	1355	0.5800738
C3	25160304	25160580	BolC3t16577H	0	+	30	224	276	0.8115942
C3	25164963	25166587	BolC3t16578H	0	-	311	1396	1624	0.8596059
C3	25167737	25170348	BolC3t16579H	0	-	464	1445	2611	0.5534278
C3	25172297	25172899	BolC3t16580H	0	+	568	592	602	0.9833887
C3	25172965	25173079	BolC3t16581H	0	+	127	114	114	1.0000000
C3	25176112	25177736	BolC3t16582H	0	+	121	1286	1624	0.7918719
C3	25183367	25186672	BolC3t16583H	0	-	966	2734	3305	0.8272315
C3	25186905	25187778	BolC3t16584H	0	+	566	873	873	1.0000000
C3	25190779	25192009	BolC3t16585H	0	+	26	474	1230	0.3853658
C3	25194221	25195369	BolC3t16586H	0	+	813	1148	1148	1.0000000
C3	25196317	25198533	BolC3t16587H	0	-	1550	2131	2216	0.9616426
C3	25200305	25200949	BolC3t16588H	0	-	328	644	644	1.0000000
C3	25203662	25205759	BolC3t16589H	0	+	119	1545	2097	0.7367668
C3	25206787	25209920	BolC3t16590H	0	+	320	1706	3133	0.5445260
C3	25213226	25215715	BolC3t16591H	0	+	635	1955	2489	0.7854560
C3	25216071	25223306	BolC3t16592H	0	-	3483	6903	7235	0.9541119
C3	25224405	25225745	BolC3t16593H	0	+	712	1331	1340	0.9932836
C3	25226096	25229410	BolC3t16594H	0	-	1370	3208	3314	0.9680145
C3	25236698	25236878	BolC3t16595H	0	+	101	180	180	1.0000000
C3	25237479	25240459	BolC3t16596H	0	-	928	1889	2980	0.6338926
C3	25247403	25248651	BolC3t16597H	0	-	155	649	1248	0.5200320
C3	25253647	25254118	BolC3t16598H	0	-	271	471	471	1.0000000
C3	25260590	25262005	BolC3t16599H	0	-	882	1411	1415	0.9971731
C3	25262559	25262846	BolC3t16600H	0	+	128	241	287	0.8397213
C3	25263762	25272252	BolC3t16601H	0	-	3340	7257	8490	0.8547703
C3	25277122	25277434	BolC3t16602H	0	+	349	312	312	1.0000000
C3	25278388	25285586	BolC3t16603H	0	+	2615	6603	7198	0.9173381
C3	25286132	25287975	BolC3t16604H	0	-	903	1821	1843	0.9880629
C3	25290122	25290482	BolC3t16605H	0	-	56	360	360	1.0000000
C3	25295165	25295423	BolC3t16606H	0	-	1	62	258	0.2403101
C3	25296921	25303413	BolC3t16607H	0	+	3184	6492	6492	1.0000000
C3	25304287	25304672	BolC3t16608H	0	-	453	385	385	1.0000000
C3	25307790	25311934	BolC3t16609H	0	+	1426	3903	4144	0.9418436
C3	25312914	25314147	BolC3t16610H	0	+	293	1138	1233	0.9229522
C3	25328149	25328608	BolC3t16611H	0	+	310	459	459	1.0000000
C3	25330304	25331469	BolC3t16612H	0	-	407	1070	1165	0.9184549
C3	25340962	25343546	BolC3t16613H	0	+	1769	2207	2584	0.8541022
C3	25343884	25344764	BolC3t16614H	0	+	56	743	880	0.8443182
C3	25349423	25350898	BolC3t16615H	0	-	1590	1475	1475	1.0000000
C3	25352666	25354234	BolC3t16616H	0	+	651	1519	1568	0.9687500
C3	25354657	25357938	BolC3t16617H	0	-	1154	3281	3281	1.0000000
C3	25363132	25365104	BolC3t16618H	0	+	1433	1972	1972	1.0000000
C3	25366146	25368642	BolC3t16619H	0	+	1562	2468	2496	0.9887820
C3	25372723	25373014	BolC3t16620H	0	+	178	291	291	1.0000000
C3	25374322	25374900	BolC3t16621H	0	+	504	578	578	1.0000000
C3	25375316	25377014	BolC3t16622H	0	-	1797	1698	1698	1.0000000
C3	25381684	25387687	BolC3t16623H	0	-	853	2781	6003	0.4632684
C3	25388692	25389271	BolC3t16624H	0	-	422	579	579	1.0000000
C3	25391794	25394435	BolC3t16625H	0	-	766	1766	2641	0.6686861
C3	25396707	25398588	BolC3t16626H	0	-	402	1711	1881	0.9096226
C3	25399481	25400329	BolC3t16627H	0	-	594	848	848	1.0000000
C3	25400588	25403072	BolC3t16628H	0	+	1296	2279	2484	0.9174718
C3	25408703	25411282	BolC3t16629H	0	+	988	1881	2579	0.7293525
C3	25436974	25441813	BolC3t16630H	0	-	1141	4770	4839	0.9857408
C3	25442018	25453543	BolC3t16631H	0	-	6015	11150	11525	0.9674621
C3	25465091	25465490	BolC3t16632H	0	+	453	399	399	1.0000000
C3	25469993	25470404	BolC3t16633H	0	-	153	380	411	0.9245742
C3	25474900	25476617	BolC3t16634H	0	-	2164	1717	1717	1.0000000
C3	25477187	25487299	BolC3t16635H	0	+	2086	7346	10112	0.7264636
C3	25487997	25488907	BolC3t16636H	0	+	78	819	910	0.9000000
C3	25489673	25491067	BolC3t16637H	0	+	952	1394	1394	1.0000000
C3	25491918	25493974	BolC3t16638H	0	-	808	1992	2056	0.9688716
C3	25495501	25495727	BolC3t16639H	0	+	498	226	226	1.0000000
C3	25497098	25497617	BolC3t16640H	0	-	516	519	519	1.0000000
C3	25500179	25500308	BolC3t16641H	0	-	17	129	129	1.0000000
C3	25507048	25508495	BolC3t16642H	0	+	157	1041	1447	0.7194195
C3	25536972	25539747	BolC3t16643H	0	+	265	1586	2775	0.5715315
C3	25541061	25544729	BolC3t16644H	0	-	992	2636	3668	0.7186478
C3	25544030	25546599	BolC3t16645H	0	+	888	2417	2569	0.9408330
C3	25546933	25548659	BolC3t16646H	0	-	1036	1666	1726	0.9652376
C3	25549167	25554114	BolC3t16647H	0	+	1820	4847	4947	0.9797857
C3	25558540	25558681	BolC3t16648H	0	+	17	128	141	0.9078014
C3	25561714	25563736	BolC3t16649H	0	+	358	1569	2022	0.7759644
C3	25564603	25566667	BolC3t16650H	0	+	636	1735	2064	0.8406008
C3	25570529	25579185	BolC3t16651H	0	+	1777	4093	8656	0.4728512
C3	25572726	25573131	BolC3t16652H	0	-	5	92	405	0.2271605
C3	25580689	25583761	BolC3t16653H	0	+	1004	2946	3072	0.9589844
C3	25584741	25587042	BolC3t16654H	0	+	1427	2301	2301	1.0000000
C3	25587640	25588681	BolC3t16655H	0	-	402	1041	1041	1.0000000
C3	25592875	25594863	BolC3t16656H	0	-	590	1951	1988	0.9813883
C3	25599412	25605801	BolC3t16657H	0	+	1963	4866	6389	0.7616215
C3	25607116	25608928	BolC3t16658H	0	-	1406	1750	1812	0.9657837
C3	25609479	25612581	BolC3t16659H	0	-	888	2490	3102	0.8027079
C3	25613253	25615324	BolC3t16660H	0	+	512	1943	2071	0.9381941
C3	25616095	25616779	BolC3t16661H	0	+	73	645	684	0.9429824
C3	25616798	25617557	BolC3t16662H	0	+	395	759	759	1.0000000
C3	25618125	25619573	BolC3t16663H	0	-	1210	1448	1448	1.0000000
C3	25622081	25622183	BolC3t16664H	0	-	81	102	102	1.0000000
C3	25627213	25630928	BolC3t16665H	0	+	1195	3136	3715	0.8441454
C3	25636663	25644406	BolC3t16666H	0	+	1791	5342	7743	0.6899135
C3	25645277	25646039	BolC3t16667H	0	+	67	497	762	0.6522310
C3	25650365	25656254	BolC3t16668H	0	+	5391	5846	5889	0.9926983
C3	25657470	25657812	BolC3t16669H	0	+	48	325	342	0.9502924
C3	25658668	25662761	BolC3t16670H	0	-	1538	3614	4093	0.8829709
C3	25665041	25666135	BolC3t16671H	0	-	793	1094	1094	1.0000000
C3	25666891	25667544	BolC3t16672H	0	+	29	579	653	0.8866768
C3	25670035	25672730	BolC3t16673H	0	-	809	2653	2695	0.9844156
C3	25675467	25678521	BolC3t16674H	0	-	1164	2743	3054	0.8981664
C3	25687137	25689234	BolC3t16675H	0	+	993	2097	2097	1.0000000
C3	25690583	25690905	BolC3t16676H	0	+	73	252	322	0.7826087
C3	25693078	25693981	BolC3t16677H	0	-	328	903	903	1.0000000
C3	25699415	25704931	BolC3t16678H	0	-	696	3453	5516	0.6259971
C3	25718423	25722334	BolC3t16679H	0	+	177	398	3911	0.1017643
C3	25723763	25723895	BolC3t16680H	0	+	80	132	132	1.0000000
C3	25729257	25731422	BolC3t16681H	0	-	361	1556	2165	0.7187067
C3	25735705	25736005	BolC3t16682H	0	-	153	300	300	1.0000000
C3	25740416	25741143	BolC3t16683H	0	+	341	705	727	0.9697387
C3	25742846	25746890	BolC3t16684H	0	-	2081	3884	4044	0.9604352
C3	25747910	25756162	BolC3t16685H	0	-	1077	4987	8252	0.6043383
C3	25758318	25761446	BolC3t16686H	0	+	755	2618	3128	0.8369565
C3	25761866	25762936	BolC3t16687H	0	-	180	1024	1070	0.9570094
C3	25763193	25765910	BolC3t16688H	0	-	1091	2634	2717	0.9694516
C3	25767163	25767976	BolC3t16689H	0	-	587	813	813	1.0000000
C3	25773883	25786698	BolC3t16690H	0	-	6227	10691	12815	0.8342567
C3	25793857	25796090	BolC3t16691H	0	-	2002	2233	2233	1.0000000
C3	25807353	25807914	BolC3t16692H	0	+	401	561	561	1.0000000
C3	25808927	25815760	BolC3t16693H	0	+	3125	6144	6833	0.8991658
C3	25820464	25820851	BolC3t16694H	0	-	80	358	387	0.9250646
C3	25844997	25847194	BolC3t16695H	0	+	880	2188	2197	0.9959035
C3	25849595	25850084	BolC3t16696H	0	-	65	483	489	0.9877301
C3	25851819	25855067	BolC3t16697H	0	+	496	2126	3248	0.6545566
C3	25857407	25859299	BolC3t16698H	0	+	267	1339	1892	0.7077167
C3	25861095	25861776	BolC3t16699H	0	+	225	535	681	0.7856094
C3	25862588	25863920	BolC3t16700H	0	-	479	1332	1332	1.0000000
C3	25864868	25869957	BolC3t16701H	0	-	810	3808	5089	0.7482806
C3	25870707	25875962	BolC3t16702H	0	-	2200	5193	5255	0.9882017
C3	25876776	25882758	BolC3t16703H	0	-	3521	5883	5982	0.9834504
C3	25884426	25887043	BolC3t16704H	0	+	1208	2500	2617	0.9552923
C3	25887666	25892974	BolC3t16705H	0	-	2294	5024	5308	0.9464958
C3	25895938	25896580	BolC3t16706H	0	-	4	222	642	0.3457944
C3	25921294	25923306	BolC3t16707H	0	-	26	268	2012	0.1332008
C3	25924088	25924364	BolC3t16708H	0	-	1	14	276	0.0507246
C3	25929641	25929818	BolC3t16709H	0	-	193	177	177	1.0000000
C3	25937591	25937859	BolC3t16710H	0	-	63	268	268	1.0000000
C3	25951334	25952562	BolC3t16711H	0	+	34	319	1228	0.2597720
C3	25955205	25956629	BolC3t16712H	0	-	878	1424	1424	1.0000000
C3	25958451	25959613	BolC3t16713H	0	+	660	1162	1162	1.0000000
C3	25961370	25962003	BolC3t16714H	0	-	168	593	633	0.9368088
C3	25963637	25964228	BolC3t16715H	0	-	62	357	591	0.6040609
C3	25968058	25968720	BolC3t16716H	0	+	0	0	662	0.0000000
C3	25968771	25982166	BolC3t16717H	0	+	1812	10231	13395	0.7637925
C3	25969791	25982636	BolC3t16718H	0	+	1853	10047	12845	0.7821720
C3	25984521	25987326	BolC3t16719H	0	+	60	553	2805	0.1971480
C3	25988359	25988551	BolC3t16720H	0	-	285	192	192	1.0000000
C3	25996742	25998776	BolC3t16721H	0	-	292	1142	2034	0.5614552
C3	26011657	26012239	BolC3t16722H	0	+	185	541	582	0.9295533
C3	26019450	26025173	BolC3t16723H	0	-	2390	5297	5723	0.9255635
C3	26033085	26034231	BolC3t16724H	0	+	137	1038	1146	0.9057592
C3	26042187	26043878	BolC3t16725H	0	+	1319	1691	1691	1.0000000
C3	26048635	26048875	BolC3t16726H	0	-	0	0	240	0.0000000
C3	26052710	26052968	BolC3t16727H	0	+	24	186	258	0.7209302
C3	26097711	26098997	BolC3t16728H	0	+	1364	1286	1286	1.0000000
C3	26100419	26103165	BolC3t16729H	0	-	551	2427	2746	0.8838310
C3	26109285	26111471	BolC3t16730H	0	-	375	2041	2186	0.9336688
C3	26115613	26116808	BolC3t16731H	0	+	890	1195	1195	1.0000000
C3	26117524	26118182	BolC3t16732H	0	-	63	433	658	0.6580547
C3	26119302	26127717	BolC3t16733H	0	-	5658	7436	8415	0.8836601
C3	26129373	26131961	BolC3t16734H	0	+	2186	2588	2588	1.0000000
C3	26132452	26134245	BolC3t16735H	0	-	1693	1793	1793	1.0000000
C3	26140621	26144387	BolC3t16736H	0	+	2373	3766	3766	1.0000000
C3	26146076	26146235	BolC3t16737H	0	-	191	159	159	1.0000000
C3	26155579	26157043	BolC3t16738H	0	+	302	1165	1464	0.7957650
C3	26158656	26159396	BolC3t16739H	0	-	210	740	740	1.0000000
C3	26160378	26160957	BolC3t16740H	0	-	55	579	579	1.0000000
C3	26161981	26163158	BolC3t16741H	0	+	910	1177	1177	1.0000000
C3	26163823	26165230	BolC3t16742H	0	-	369	1185	1407	0.8422175
C3	26166570	26168742	BolC3t16743H	0	-	1568	2151	2172	0.9903315
C3	26180319	26182463	BolC3t16744H	0	+	1098	2144	2144	1.0000000
C3	26184353	26185798	BolC3t16745H	0	+	901	1445	1445	1.0000000
C3	26188924	26233822	BolC3t16746H	0	+	32684	39717	44898	0.8846051
C3	26235598	26237073	BolC3t16747H	0	+	1498	1475	1475	1.0000000
C3	26237992	26239560	BolC3t16748H	0	+	543	1459	1568	0.9304847
C3	26250806	26253212	BolC3t16749H	0	+	616	2357	2406	0.9796342
C3	26253797	26253978	BolC3t16750H	0	-	1	109	181	0.6022099
C3	26254058	26254428	BolC3t16751H	0	-	27	176	370	0.4756757
C3	26255673	26257644	BolC3t16752H	0	-	553	1846	1971	0.9365804
C3	26268919	26271928	BolC3t16753H	0	+	3293	3009	3009	1.0000000
C3	26282884	26283765	BolC3t16754H	0	-	128	600	881	0.6810443
C3	26287593	26287725	BolC3t16755H	0	-	4	132	132	1.0000000
C3	26300156	26300507	BolC3t16756H	0	+	113	351	351	1.0000000
C3	26303855	26305420	BolC3t16757H	0	-	1551	1565	1565	1.0000000
C3	26305840	26306557	BolC3t16758H	0	-	392	717	717	1.0000000
C3	26317330	26318640	BolC3t16759H	0	-	1184	1310	1310	1.0000000
C3	26320140	26324094	BolC3t16760H	0	+	522	3434	3954	0.8684876
C3	26324752	26325786	BolC3t16761H	0	+	228	1034	1034	1.0000000
C3	26326354	26329978	BolC3t16762H	0	-	1773	2949	3624	0.8137417
C3	26341210	26341402	BolC3t16763H	0	+	81	192	192	1.0000000
C3	26356938	26357210	BolC3t16764H	0	-	61	228	272	0.8382353
C3	26357225	26359423	BolC3t16765H	0	-	1142	2082	2198	0.9472247
C3	26387927	26388837	BolC3t16766H	0	-	411	910	910	1.0000000
C3	26403365	26405034	BolC3t16767H	0	+	826	1669	1669	1.0000000
C3	26410855	26411215	BolC3t16768H	0	+	31	142	360	0.3944444
C3	26412719	26413439	BolC3t16769H	0	-	581	720	720	1.0000000
C3	26414742	26414950	BolC3t16770H	0	-	122	208	208	1.0000000
C3	26415321	26417030	BolC3t16771H	0	+	406	1516	1709	0.8870685
C3	26418107	26421351	BolC3t16772H	0	-	1231	2770	3244	0.8538841
C3	26424249	26425775	BolC3t16773H	0	+	45	355	1526	0.2326343
C3	26427561	26428995	BolC3t16774H	0	+	6	106	1434	0.0739191
C3	26429424	26431987	BolC3t16775H	0	-	1176	2336	2563	0.9114319
C3	26435972	26437901	BolC3t16776H	0	-	1151	1745	1929	0.9046138
C3	26441927	26442935	BolC3t16777H	0	+	296	1006	1008	0.9980159
C3	26443748	26445000	BolC3t16778H	0	-	430	1223	1252	0.9768370
C3	26446845	26448136	BolC3t16779H	0	+	883	1291	1291	1.0000000
C3	26448466	26449984	BolC3t16780H	0	-	346	1149	1518	0.7569170
C3	26466095	26469189	BolC3t16781H	0	-	42	683	3094	0.2207498
C3	26472810	26473645	BolC3t16782H	0	+	15	152	835	0.1820359
C3	26473884	26474288	BolC3t16783H	0	+	0	0	404	0.0000000
C3	26476274	26484384	BolC3t16784H	0	-	727	3357	8110	0.4139334
C3	26497249	26498905	BolC3t16785H	0	+	79	760	1656	0.4589372
C3	26497733	26497994	BolC3t16786H	0	-	0	0	261	0.0000000
C3	26503444	26504086	BolC3t16787H	0	+	260	619	642	0.9641744
C3	26511166	26511369	BolC3t16788H	0	+	11	41	203	0.2019704
C3	26512703	26513970	BolC3t16789H	0	-	3597	1256	1267	0.9913180
C3	26545224	26545602	BolC3t16790H	0	-	2	21	378	0.0555556
C3	26545617	26546112	BolC3t16791H	0	-	89	189	495	0.3818182
C3	26557068	26557752	BolC3t16792H	0	-	49	138	684	0.2017544
C3	26571200	26574960	BolC3t16793H	0	+	1661	3479	3760	0.9252660
C3	26575743	26577960	BolC3t16794H	0	-	928	1885	2217	0.8502481
C3	26587397	26588152	BolC3t16795H	0	-	1204	755	755	1.0000000
C3	26594953	26595328	BolC3t16796H	0	+	150	375	375	1.0000000
C3	26596215	26596517	BolC3t16797H	0	-	109	173	302	0.5728477
C3	26597789	26597897	BolC3t16798H	0	-	80	108	108	1.0000000
C3	26598932	26601054	BolC3t16799H	0	+	957	2032	2122	0.9575872
C3	26602127	26609572	BolC3t16800H	0	-	2552	6861	7445	0.9215581
C3	26612979	26621836	BolC3t16801H	0	+	1365	7505	8857	0.8473524
C3	26622178	26623585	BolC3t16802H	0	-	1302	1407	1407	1.0000000
C3	26630127	26632542	BolC3t16803H	0	-	1203	2367	2415	0.9801242
C3	26634892	26636922	BolC3t16804H	0	-	1857	2030	2030	1.0000000
C3	26637516	26637819	BolC3t16805H	0	-	41	303	303	1.0000000
C3	26638905	26645608	BolC3t16806H	0	+	3518	6489	6703	0.9680740
C3	26646442	26647777	BolC3t16807H	0	-	817	1241	1335	0.9295880
C3	26649019	26649433	BolC3t16808H	0	-	111	414	414	1.0000000
C3	26656083	26658129	BolC3t16809H	0	-	1143	1846	2046	0.9022483
C3	26662733	26664219	BolC3t16810H	0	-	265	1126	1486	0.7577389
C3	26664925	26668970	BolC3t16811H	0	+	2326	3788	4045	0.9364648
C3	26670422	26672130	BolC3t16812H	0	-	991	1708	1708	1.0000000
C3	26673252	26673527	BolC3t16813H	0	+	0	0	275	0.0000000
C3	26690339	26691975	BolC3t16814H	0	+	436	384	1636	0.2347188
C3	26692310	26693268	BolC3t16815H	0	-	44	60	958	0.0626305
C3	26700607	26734387	BolC3t16816H	0	-	10410	20118	33780	0.5955595
C3	26708859	26710732	BolC3t16817H	0	+	829	1804	1873	0.9631607
C3	26718900	26719363	BolC3t16818H	0	-	0	0	463	0.0000000
C3	26726975	26727555	BolC3t16819H	0	+	4	133	580	0.2293103
C3	26736618	26738033	BolC3t16820H	0	-	94	889	1415	0.6282685
C3	26743719	26746207	BolC3t16821H	0	-	1488	2488	2488	1.0000000
C3	26747001	26747641	BolC3t16822H	0	-	5	160	640	0.2500000
C3	26748453	26748826	BolC3t16823H	0	-	11	206	373	0.5522788
C3	26748923	26749761	BolC3t16824H	0	-	31	678	838	0.8090692
C3	26752343	26753121	BolC3t16825H	0	+	271	712	778	0.9151671
C3	26755581	26755856	BolC3t16826H	0	-	236	273	275	0.9927273
C3	26756211	26756531	BolC3t16827H	0	-	611	320	320	1.0000000
C3	26757894	26758038	BolC3t16828H	0	-	0	0	144	0.0000000
C3	26767718	26769655	BolC3t16829H	0	+	91	281	1937	0.1450697
C3	26773542	26775344	BolC3t16830H	0	+	975	1796	1802	0.9966704
C3	26775834	26777922	BolC3t16831H	0	-	1006	1834	2088	0.8783525
C3	26778514	26780799	BolC3t16832H	0	+	993	2285	2285	1.0000000
C3	26781073	26786435	BolC3t16833H	0	-	714	4365	5362	0.8140619
C3	26786672	26788316	BolC3t16834H	0	+	703	1562	1644	0.9501216
C3	26788894	26789732	BolC3t16835H	0	-	214	820	838	0.9785203
C3	26790540	26791771	BolC3t16836H	0	+	301	1227	1231	0.9967506
C3	26793862	26795053	BolC3t16837H	0	+	793	1087	1191	0.9126784
C3	26795512	26798010	BolC3t16838H	0	-	1359	2461	2498	0.9851881
C3	26800482	26802452	BolC3t16839H	0	+	1370	1894	1970	0.9614213
C3	26803213	26805946	BolC3t16840H	0	-	1060	2664	2733	0.9747530
C3	26808344	26825146	BolC3t16841H	0	-	3790	10288	16802	0.6123081
C3	26809121	26809951	BolC3t16842H	0	-	28	527	830	0.6349397
C3	26811365	26813133	BolC3t16843H	0	+	8	393	1768	0.2222851
C3	26838600	26842313	BolC3t16844H	0	-	1649	3414	3713	0.9194721
C3	26842910	26844184	BolC3t16845H	0	-	331	1226	1274	0.9623234
C3	26845255	26848149	BolC3t16846H	0	+	1281	2818	2894	0.9737388
C3	26849063	26851432	BolC3t16847H	0	-	994	2321	2369	0.9797383
C3	26852634	26852748	BolC3t16848H	0	-	137	114	114	1.0000000
C3	26857756	26862576	BolC3t16849H	0	-	1426	3559	4820	0.7383817
C3	26863234	26864354	BolC3t16850H	0	+	519	1094	1120	0.9767857
C3	26876354	26877473	BolC3t16851H	0	-	107	846	1119	0.7560322
C3	26887870	26888338	BolC3t16852H	0	+	209	468	468	1.0000000
C3	26889651	26892727	BolC3t16853H	0	+	1671	3050	3076	0.9915475
C3	26892843	26893551	BolC3t16854H	0	-	574	708	708	1.0000000
C3	26899143	26900755	BolC3t16855H	0	-	717	1612	1612	1.0000000
C3	26909142	26909400	BolC3t16856H	0	-	23	97	258	0.3759690
C3	26912016	26912817	BolC3t16857H	0	+	77	426	801	0.5318352
C3	26913789	26918126	BolC3t16858H	0	-	3214	4138	4337	0.9541157
C3	26928214	26930725	BolC3t16859H	0	+	870	2170	2511	0.8641976
C3	26931562	26938955	BolC3t16860H	0	+	3209	6477	7393	0.8760990
C3	26942258	26943407	BolC3t16861H	0	+	324	849	1149	0.7389034
C3	26943591	26946119	BolC3t16862H	0	-	2158	2528	2528	1.0000000
C3	26946934	26948628	BolC3t16863H	0	-	781	1694	1694	1.0000000
C3	26956176	26957727	BolC3t16864H	0	-	1175	1489	1551	0.9600258
C3	26965660	26965927	BolC3t16865H	0	-	0	0	267	0.0000000
C3	26968797	26969178	BolC3t16866H	0	-	96	381	381	1.0000000
C3	26983331	26985770	BolC3t16867H	0	+	1680	2439	2439	1.0000000
C3	26996583	26997936	BolC3t16868H	0	+	1357	1311	1353	0.9689579
C3	27004561	27006714	BolC3t16869H	0	+	412	1123	2153	0.5215977
C3	27022671	27024140	BolC3t16870H	0	+	728	1426	1469	0.9707284
C3	27032085	27033191	BolC3t16871H	0	-	83	668	1106	0.6039783
C3	27068436	27069480	BolC3t16872H	0	-	1239	1044	1044	1.0000000
C3	27073018	27075006	BolC3t16873H	0	+	859	1944	1988	0.9778672
C3	27075979	27077027	BolC3t16874H	0	+	92	969	1048	0.9246183
C3	27078296	27085364	BolC3t16875H	0	+	4147	7038	7068	0.9957555
C3	27085961	27088556	BolC3t16876H	0	-	1121	2282	2595	0.8793834
C3	27090534	27092297	BolC3t16877H	0	-	1049	1763	1763	1.0000000
C3	27093670	27094077	BolC3t16878H	0	-	762	407	407	1.0000000
C3	27094601	27096373	BolC3t16879H	0	-	631	1742	1772	0.9830700
C3	27098271	27098993	BolC3t16880H	0	-	110	716	722	0.9916897
C3	27103015	27105617	BolC3t16881H	0	+	1025	2525	2602	0.9704074
C3	27106237	27106789	BolC3t16882H	0	+	428	552	552	1.0000000
C3	27108000	27109721	BolC3t16883H	0	+	657	1615	1721	0.9384079
C3	27110181	27113244	BolC3t16884H	0	-	655	2935	3063	0.9582109
C3	27116260	27120122	BolC3t16885H	0	-	487	2135	3862	0.5528224
C3	27122225	27123351	BolC3t16886H	0	+	860	1117	1126	0.9920071
C3	27126142	27126439	BolC3t16887H	0	+	242	297	297	1.0000000
C3	27149317	27150505	BolC3t16888H	0	+	236	1083	1188	0.9116161
C3	27154459	27159706	BolC3t16889H	0	+	774	4275	5247	0.8147513
C3	27161310	27161940	BolC3t16890H	0	+	20	187	630	0.2968254
C3	27167530	27168706	BolC3t16891H	0	-	217	1124	1176	0.9557823
C3	27169947	27171666	BolC3t16892H	0	+	340	1678	1719	0.9761489
C3	27177402	27177753	BolC3t16893H	0	+	11	163	351	0.4643875
C3	27178612	27179479	BolC3t16894H	0	-	75	284	867	0.3275663
C3	27180416	27183228	BolC3t16895H	0	-	1180	2702	2812	0.9608819
C3	27184147	27184351	BolC3t16896H	0	-	19	94	204	0.4607843
C3	27192112	27192598	BolC3t16897H	0	-	119	486	486	1.0000000
C3	27201281	27204183	BolC3t16898H	0	+	1337	2833	2902	0.9762233
C3	27204603	27214202	BolC3t16899H	0	-	1438	6025	9599	0.6276696
C3	27217111	27219304	BolC3t16900H	0	+	966	2154	2193	0.9822161
C3	27219873	27221223	BolC3t16901H	0	-	343	1288	1350	0.9540741
C3	27222848	27224841	BolC3t16902H	0	-	293	1354	1993	0.6793778
C3	27227605	27230293	BolC3t16903H	0	+	469	2057	2688	0.7652529
C3	27234542	27236539	BolC3t16904H	0	-	723	1997	1997	1.0000000
C3	27286354	27289094	BolC3t16905H	0	-	1256	2651	2740	0.9675183
C3	27290493	27291276	BolC3t16906H	0	+	1	115	783	0.1468710
C3	27292250	27294872	BolC3t16907H	0	+	1874	2601	2622	0.9919909
C3	27304580	27311937	BolC3t16908H	0	-	4885	7332	7357	0.9966019
C3	27326130	27331233	BolC3t16909H	0	-	178	1588	5103	0.3111895
C3	27331597	27333313	BolC3t16910H	0	-	499	1621	1716	0.9446387
C3	27355134	27357257	BolC3t16911H	0	+	910	1613	2123	0.7597739
C3	27359284	27361063	BolC3t16912H	0	+	182	1530	1779	0.8600338
C3	27365791	27367576	BolC3t16913H	0	-	436	1339	1785	0.7501401
C3	27368604	27371345	BolC3t16914H	0	-	1140	2702	2741	0.9857716
C3	27373761	27374322	BolC3t16915H	0	+	313	561	561	1.0000000
C3	27385338	27386582	BolC3t16916H	0	-	4	168	1244	0.1350482
C3	27391811	27392874	BolC3t16917H	0	+	1180	1063	1063	1.0000000
C3	27396795	27400249	BolC3t16918H	0	+	2745	3454	3454	1.0000000
C3	27400417	27401200	BolC3t16919H	0	-	23	247	783	0.3154534
C3	27413161	27416067	BolC3t16920H	0	+	1535	2712	2906	0.9332415
C3	27421969	27429317	BolC3t16921H	0	+	891	4929	7348	0.6707948
C3	27438472	27441172	BolC3t16922H	0	-	1618	2611	2700	0.9670370
C3	27444684	27447075	BolC3t16923H	0	+	1365	2391	2391	1.0000000
C3	27467845	27472163	BolC3t16924H	0	+	2011	3994	4318	0.9249653
C3	27483846	27487145	BolC3t16925H	0	-	1667	3299	3299	1.0000000
C3	27487282	27489519	BolC3t16926H	0	-	1307	2237	2237	1.0000000
C3	27490064	27494664	BolC3t16927H	0	-	988	3420	4600	0.7434782
C3	27496349	27497527	BolC3t16928H	0	+	319	1178	1178	1.0000000
C3	27498442	27499083	BolC3t16929H	0	+	58	516	641	0.8049922
C3	27500287	27500569	BolC3t16930H	0	-	25	122	282	0.4326241
C3	27500670	27503719	BolC3t16931H	0	-	1215	3040	3049	0.9970482
C3	27504913	27508809	BolC3t16932H	0	+	1552	3666	3896	0.9409651
C3	27509741	27510022	BolC3t16933H	0	+	39	281	281	1.0000000
C3	27517013	27518341	BolC3t16934H	0	+	421	1094	1328	0.8237952
C3	27521991	27522504	BolC3t16935H	0	-	617	513	513	1.0000000
C3	27523292	27531191	BolC3t16936H	0	+	1152	5272	7899	0.6674262
C3	27532090	27533301	BolC3t16937H	0	-	637	1211	1211	1.0000000
C3	27534125	27535876	BolC3t16938H	0	-	165	1076	1751	0.6145060
C3	27536699	27538683	BolC3t16939H	0	-	2016	1984	1984	1.0000000
C3	27539469	27539910	BolC3t16940H	0	+	91	441	441	1.0000000
C3	27540399	27546414	BolC3t16941H	0	-	2729	5740	6015	0.9542810
C3	27549945	27551223	BolC3t16942H	0	-	842	1278	1278	1.0000000
C3	27551370	27552894	BolC3t16943H	0	+	1001	1515	1524	0.9940945
C3	27553597	27555020	BolC3t16944H	0	-	640	1423	1423	1.0000000
C3	27563088	27564358	BolC3t16945H	0	+	342	985	1270	0.7755905
C3	27566934	27567686	BolC3t16946H	0	+	946	752	752	1.0000000
C3	27570140	27570595	BolC3t16947H	0	-	320	455	455	1.0000000
C3	27591488	27593180	BolC3t16948H	0	-	1796	1692	1692	1.0000000
C3	27595017	27597318	BolC3t16949H	0	-	261	1634	2301	0.7101260
C3	27599312	27600136	BolC3t16950H	0	-	158	616	824	0.7475728
C3	27613457	27613721	BolC3t16951H	0	+	213	239	264	0.9053030
C3	27615452	27616241	BolC3t16952H	0	-	27	679	789	0.8605830
C3	27629059	27635274	BolC3t16953H	0	+	650	4429	6215	0.7126307
C3	27646734	27649118	BolC3t16954H	0	-	123	1013	2384	0.4249161
C3	27650301	27651199	BolC3t16955H	0	-	672	898	898	1.0000000
C3	27654472	27659884	BolC3t16956H	0	-	2551	4345	5412	0.8028455
C3	27670789	27671176	BolC3t16957H	0	-	61	231	387	0.5968992
C3	27672168	27672315	BolC3t16958H	0	-	13	147	147	1.0000000
C3	27682824	27683052	BolC3t16959H	0	+	5	77	228	0.3377193
C3	27683605	27686103	BolC3t16960H	0	-	1834	2498	2498	1.0000000
C3	27688451	27690542	BolC3t16961H	0	+	885	1967	2091	0.9406982
C3	27691258	27699443	BolC3t16962H	0	+	1390	5192	8185	0.6343311
C3	27703736	27704268	BolC3t16963H	0	-	60	488	532	0.9172933
C3	27710522	27712301	BolC3t16964H	0	-	92	1456	1779	0.8184373
C3	27721141	27721561	BolC3t16965H	0	+	302	417	420	0.9928572
C3	27721985	27722264	BolC3t16966H	0	+	187	267	279	0.9569892
C3	27754135	27755576	BolC3t16967H	0	+	6	250	1441	0.1734906
C3	27762414	27762837	BolC3t16968H	0	-	0	0	423	0.0000000
C3	27780759	27782860	BolC3t16969H	0	+	330	1493	2101	0.7106140
C3	27803664	27833916	BolC3t16970H	0	-	11961	21588	30252	0.7136057
C3	27816948	27818306	BolC3t16971H	0	-	454	1258	1358	0.9263623
C3	27836087	27837273	BolC3t16972H	0	+	552	1125	1186	0.9485666
C3	27848266	27849121	BolC3t16973H	0	-	272	484	855	0.5660819
C3	27855315	27855784	BolC3t16974H	0	+	247	409	469	0.8720682
C3	27859646	27860084	BolC3t16975H	0	-	325	438	438	1.0000000
C3	27863194	27864974	BolC3t16976H	0	-	22	679	1780	0.3814607
C3	27866097	27866797	BolC3t16977H	0	+	94	612	700	0.8742857
C3	27876389	27877238	BolC3t16978H	0	+	123	820	849	0.9658422
C3	27879450	27882856	BolC3t16979H	0	+	608	2557	3406	0.7507340
C3	27885669	27886816	BolC3t16980H	0	-	109	818	1147	0.7131648
C3	27891267	27891896	BolC3t16981H	0	+	310	629	629	1.0000000
C3	27909638	27911690	BolC3t16982H	0	+	1415	2052	2052	1.0000000
C3	27912325	27915258	BolC3t16983H	0	+	1449	2864	2933	0.9764746
C3	27935898	27936114	BolC3t16984H	0	-	47	150	216	0.6944444
C3	27938739	27939027	BolC3t16985H	0	+	42	130	288	0.4513889
C3	27945684	27948330	BolC3t16986H	0	+	356	2227	2646	0.8416477
C3	27949045	27951442	BolC3t16987H	0	+	917	2386	2397	0.9954109
C3	27960139	27960909	BolC3t16988H	0	-	3	17	770	0.0220779
C3	27962790	27965107	BolC3t16989H	0	-	179	1243	2317	0.5364696
C3	27965486	27968522	BolC3t16990H	0	-	252	1701	3036	0.5602767
C3	27996609	28003711	BolC3t16991H	0	+	1716	6427	7102	0.9049563
C3	28011114	28012655	BolC3t16992H	0	+	572	1494	1541	0.9695003
C3	28016062	28017373	BolC3t16993H	0	+	4	19	1311	0.0144928
C3	28029217	28034751	BolC3t16994H	0	+	2459	4532	5534	0.8189375
C3	28047095	28053067	BolC3t16995H	0	+	605	3697	5972	0.6190556
C3	28055055	28057025	BolC3t16996H	0	+	566	1635	1970	0.8299493
C3	28057628	28059703	BolC3t16997H	0	-	377	1964	2075	0.9465060
C3	28063639	28064959	BolC3t16998H	0	+	164	1310	1320	0.9924242
C3	28068955	28069168	BolC3t16999H	0	+	32	213	213	1.0000000
C3	28070810	28071283	BolC3t17000H	0	-	88	473	473	1.0000000
C3	28072913	28076155	BolC3t17001H	0	+	2034	3012	3242	0.9290562
C3	28077198	28079990	BolC3t17002H	0	+	1793	2792	2792	1.0000000
C3	28089048	28089762	BolC3t17003H	0	+	477	605	714	0.8473389
C3	28094594	28099005	BolC3t17004H	0	+	1495	4256	4411	0.9648606
C3	28099453	28101634	BolC3t17005H	0	-	1856	2181	2181	1.0000000
C3	28114739	28116903	BolC3t17006H	0	+	842	2094	2164	0.9676525
C3	28123448	28125123	BolC3t17007H	0	+	1128	1675	1675	1.0000000
C3	28133706	28134921	BolC3t17008H	0	+	267	1209	1215	0.9950618
C3	28136923	28138023	BolC3t17009H	0	-	551	1100	1100	1.0000000
C3	28147882	28148840	BolC3t17010H	0	+	174	910	958	0.9498956
C3	28149111	28150814	BolC3t17011H	0	-	866	1703	1703	1.0000000
C3	28157898	28158060	BolC3t17012H	0	-	656	162	162	1.0000000
C3	28158115	28158697	BolC3t17013H	0	+	1240	582	582	1.0000000
C3	28159957	28161957	BolC3t17014H	0	+	762	1904	2000	0.9520000
C3	28162639	28169033	BolC3t17015H	0	-	2128	5566	6394	0.8705036
C3	28173708	28173948	BolC3t17016H	0	+	20	240	240	1.0000000
C3	28175588	28175738	BolC3t17017H	0	-	235	150	150	1.0000000
C3	28176651	28180573	BolC3t17018H	0	-	2022	3918	3922	0.9989801
C3	28180961	28182726	BolC3t17019H	0	+	150	990	1765	0.5609065
C3	28186936	28194185	BolC3t17020H	0	-	238	2310	7249	0.3186646
C3	28203965	28204133	BolC3t17021H	0	+	0	0	168	0.0000000
C3	28207202	28207421	BolC3t17022H	0	-	50	219	219	1.0000000
C3	28213541	28214156	BolC3t17023H	0	-	0	0	615	0.0000000
C3	28217339	28218039	BolC3t17024H	0	+	25	308	700	0.4400000
C3	28219005	28233140	BolC3t17025H	0	-	824	9654	14135	0.6829855
C3	28243950	28247545	BolC3t17026H	0	+	3380	3595	3595	1.0000000
C3	28254540	28254738	BolC3t17027H	0	+	0	0	198	0.0000000
C3	28260153	28262627	BolC3t17028H	0	-	220	457	2474	0.1847211
C3	28263857	28264103	BolC3t17029H	0	-	68	246	246	1.0000000
C3	28264488	28267600	BolC3t17030H	0	+	1014	2676	3112	0.8598972
C3	28269547	28271032	BolC3t17031H	0	+	299	1485	1485	1.0000000
C3	28273266	28273904	BolC3t17032H	0	+	345	638	638	1.0000000
C3	28276838	28277453	BolC3t17033H	0	+	52	456	615	0.7414634
C3	28291444	28291717	BolC3t17034H	0	+	111	258	273	0.9450549
C3	28297040	28300084	BolC3t17035H	0	+	1383	3002	3044	0.9862024
C3	28306265	28309432	BolC3t17036H	0	-	665	3007	3167	0.9494790
C3	28316611	28317030	BolC3t17037H	0	-	362	419	419	1.0000000
C3	28317756	28318214	BolC3t17038H	0	-	458	458	458	1.0000000
C3	28320909	28329892	BolC3t17039H	0	+	3871	8006	8983	0.8912390
C3	28332726	28333526	BolC3t17040H	0	+	132	764	800	0.9550000
C3	28343143	28343389	BolC3t17041H	0	+	3	143	246	0.5813008
C3	28355285	28356649	BolC3t17042H	0	-	288	1362	1364	0.9985337
C3	28357629	28362162	BolC3t17043H	0	+	1419	4020	4533	0.8868299
C3	28363464	28365070	BolC3t17044H	0	-	651	1606	1606	1.0000000
C3	28366406	28367484	BolC3t17045H	0	+	68	743	1078	0.6892393
C3	28371121	28373266	BolC3t17046H	0	-	12	426	2145	0.1986014
C3	28382879	28383062	BolC3t17047H	0	+	177	173	183	0.9453552
C3	28400355	28402041	BolC3t17048H	0	+	264	1397	1686	0.8285884
C3	28410732	28412419	BolC3t17049H	0	+	199	978	1687	0.5797274
C3	28415239	28416112	BolC3t17050H	0	+	226	873	873	1.0000000
C3	28420961	28421923	BolC3t17051H	0	+	14	388	962	0.4033264
C3	28426159	28427252	BolC3t17052H	0	+	798	1034	1093	0.9460201
C3	28429115	28430957	BolC3t17053H	0	-	582	1790	1842	0.9717698
C3	28434436	28434775	BolC3t17054H	0	-	393	339	339	1.0000000
C3	28436243	28440152	BolC3t17055H	0	+	3439	3909	3909	1.0000000
C3	28446213	28463518	BolC3t17056H	0	+	3267	12517	17305	0.7233170
C3	28459756	28460300	BolC3t17057H	0	+	78	454	544	0.8345588
C3	28463870	28464086	BolC3t17058H	0	+	23	175	216	0.8101852
C3	28467595	28469194	BolC3t17059H	0	+	1268	1599	1599	1.0000000
C3	28469809	28470618	BolC3t17060H	0	-	899	809	809	1.0000000
C3	28489686	28490943	BolC3t17061H	0	+	574	907	1257	0.7215593
C3	28501427	28503639	BolC3t17062H	0	-	375	1484	2212	0.6708861
C3	28509482	28510027	BolC3t17063H	0	+	281	545	545	1.0000000
C3	28514603	28516223	BolC3t17064H	0	-	266	958	1620	0.5913580
C3	28520641	28523292	BolC3t17065H	0	+	213	1885	2651	0.7110524
C3	28527589	28528045	BolC3t17066H	0	-	51	233	456	0.5109649
C3	28529348	28531724	BolC3t17067H	0	-	119	1401	2376	0.5896465
C3	28532197	28533838	BolC3t17068H	0	+	124	931	1641	0.5673370
C3	28548211	28549952	BolC3t17069H	0	+	280	942	1741	0.5410684
C3	28557743	28557932	BolC3t17070H	0	+	10	140	189	0.7407407
C3	28571889	28572468	BolC3t17071H	0	-	226	568	579	0.9810017
C3	28577474	28581252	BolC3t17072H	0	+	1880	3489	3778	0.9235045
C3	28586196	28592578	BolC3t17073H	0	-	2973	6283	6382	0.9844876
C3	28596051	28597742	BolC3t17074H	0	+	734	1691	1691	1.0000000
C3	28597982	28598991	BolC3t17075H	0	-	937	1009	1009	1.0000000
C3	28604826	28605387	BolC3t17076H	0	-	184	375	561	0.6684492
C3	28614518	28619598	BolC3t17077H	0	-	3020	5080	5080	1.0000000
C3	28628765	28629785	BolC3t17078H	0	-	624	1020	1020	1.0000000
C3	28631373	28637453	BolC3t17079H	0	-	1513	4996	6080	0.8217105
C3	28660604	28661144	BolC3t17080H	0	+	304	540	540	1.0000000
C3	28669429	28673236	BolC3t17081H	0	+	1097	3306	3807	0.8684003
C3	28673559	28675994	BolC3t17082H	0	-	1689	2435	2435	1.0000000
C3	28676883	28678908	BolC3t17083H	0	+	1565	2025	2025	1.0000000
C3	28681021	28681627	BolC3t17084H	0	+	633	606	606	1.0000000
C3	28702165	28702775	BolC3t17085H	0	-	833	610	610	1.0000000
C3	28728300	28728813	BolC3t17086H	0	-	155	482	513	0.9395711
C3	28729153	28729728	BolC3t17087H	0	-	17	402	575	0.6991304
C3	28744199	28745297	BolC3t17088H	0	-	948	1098	1098	1.0000000
C3	28746111	28746887	BolC3t17089H	0	-	360	768	776	0.9896907
C3	28779764	28783391	BolC3t17090H	0	+	1469	3390	3627	0.9346567
C3	28784129	28785050	BolC3t17091H	0	+	1098	921	921	1.0000000
C3	28798292	28798916	BolC3t17092H	0	+	726	624	624	1.0000000
C3	28802197	28803015	BolC3t17093H	0	+	648	818	818	1.0000000
C3	28817691	28819589	BolC3t17094H	0	+	122	511	1898	0.2692308
C3	28820427	28823720	BolC3t17095H	0	+	17	372	3293	0.1129669
C3	28834563	28835986	BolC3t17096H	0	+	87	510	1423	0.3583978
C3	28836610	28837310	BolC3t17097H	0	-	7	278	700	0.3971429
C3	28845530	28845959	BolC3t17098H	0	+	506	429	429	1.0000000
C3	28850121	28850517	BolC3t17099H	0	+	376	396	396	1.0000000
C3	28855337	28855763	BolC3t17100H	0	-	382	426	426	1.0000000
C3	28858856	28859471	BolC3t17101H	0	+	6	226	615	0.3674797
C3	28880450	28882156	BolC3t17102H	0	+	757	1536	1706	0.9003517
C3	28898286	28898655	BolC3t17103H	0	+	740	369	369	1.0000000
C3	28913220	28914300	BolC3t17104H	0	+	22	292	1080	0.2703704
C3	28916393	28916664	BolC3t17105H	0	-	387	271	271	1.0000000
C3	28917933	28919337	BolC3t17106H	0	+	1012	1404	1404	1.0000000
C3	28921668	28929940	BolC3t17107H	0	+	1357	5973	8272	0.7220744
C3	28937597	28938753	BolC3t17108H	0	+	279	1037	1156	0.8970588
C3	28950581	28951970	BolC3t17109H	0	-	716	1334	1389	0.9604031
C3	28966889	28967189	BolC3t17110H	0	+	203	300	300	1.0000000
C3	28970289	28970586	BolC3t17111H	0	+	345	297	297	1.0000000
C3	28987386	28988683	BolC3t17112H	0	-	910	1297	1297	1.0000000
C3	28996923	28998129	BolC3t17113H	0	-	233	1149	1206	0.9527363
C3	29002508	29002910	BolC3t17114H	0	+	111	336	402	0.8358209
C3	29006425	29006870	BolC3t17115H	0	-	122	445	445	1.0000000
C3	29006920	29008223	BolC3t17116H	0	-	204	1301	1303	0.9984651
C3	29009257	29010310	BolC3t17117H	0	-	681	1053	1053	1.0000000
C3	29012828	29014337	BolC3t17118H	0	-	2271	1509	1509	1.0000000
C3	29021802	29022651	BolC3t17119H	0	+	462	849	849	1.0000000
C3	29027743	29029878	BolC3t17120H	0	-	628	1902	2135	0.8908665
C3	29081651	29082414	BolC3t17121H	0	-	68	615	763	0.8060288
C3	29094938	29096084	BolC3t17122H	0	+	225	1032	1146	0.9005235
C3	29101169	29102301	BolC3t17123H	0	-	393	989	1132	0.8736749
C3	29109287	29109512	BolC3t17124H	0	+	74	225	225	1.0000000
C3	29115226	29117673	BolC3t17125H	0	+	1238	2399	2447	0.9803842
C3	29136829	29139721	BolC3t17126H	0	+	1313	2892	2892	1.0000000
C3	29142840	29143468	BolC3t17127H	0	-	527	628	628	1.0000000
C3	29145986	29146307	BolC3t17128H	0	-	0	0	321	0.0000000
C3	29147531	29147684	BolC3t17129H	0	-	22	149	153	0.9738562
C3	29148251	29151659	BolC3t17130H	0	-	1858	3408	3408	1.0000000
C3	29152808	29153628	BolC3t17131H	0	-	251	814	820	0.9926829
C3	29155598	29157061	BolC3t17132H	0	+	432	1436	1463	0.9815448
C3	29159600	29160998	BolC3t17133H	0	+	302	1265	1398	0.9048641
C3	29161416	29167627	BolC3t17134H	0	-	804	3425	6211	0.5514410
C3	29187541	29191612	BolC3t17135H	0	+	2292	3851	4071	0.9459592
C3	29194363	29195793	BolC3t17136H	0	-	250	1101	1430	0.7699301
C3	29197359	29198784	BolC3t17137H	0	+	162	1202	1425	0.8435088
C3	29201439	29204224	BolC3t17138H	0	-	692	1519	2785	0.5454219
C3	29205259	29207665	BolC3t17139H	0	-	495	1794	2406	0.7456359
C3	29210914	29211434	BolC3t17140H	0	-	19	291	520	0.5596154
C3	29220967	29221974	BolC3t17141H	0	-	36	785	1007	0.7795432
C3	29240591	29241436	BolC3t17142H	0	+	7	225	845	0.2662722
C3	29241599	29242432	BolC3t17143H	0	+	121	689	833	0.8271309
C3	29243276	29248665	BolC3t17144H	0	-	385	1635	5389	0.3033958
C3	29258215	29261248	BolC3t17145H	0	-	776	1342	3033	0.4424662
C3	29266563	29266794	BolC3t17146H	0	+	5	173	231	0.7489178
C3	29273624	29274194	BolC3t17147H	0	+	261	570	570	1.0000000
C3	29279114	29281378	BolC3t17148H	0	+	908	2232	2264	0.9858657
C3	29282150	29282719	BolC3t17149H	0	-	200	569	569	1.0000000
C3	29289332	29290526	BolC3t17150H	0	+	24	255	1194	0.2135678
C3	29296976	29298360	BolC3t17151H	0	+	1090	1384	1384	1.0000000
C3	29299015	29299924	BolC3t17152H	0	-	1061	909	909	1.0000000
C3	29301162	29302741	BolC3t17153H	0	+	419	1158	1579	0.7333755
C3	29313926	29314049	BolC3t17154H	0	+	125	123	123	1.0000000
C3	29319623	29319740	BolC3t17155H	0	+	0	0	117	0.0000000
C3	29320669	29321193	BolC3t17156H	0	-	0	0	524	0.0000000
C3	29326120	29326270	BolC3t17157H	0	-	214	150	150	1.0000000
C3	29334898	29335045	BolC3t17158H	0	-	66	115	147	0.7823129
C3	29336974	29338353	BolC3t17159H	0	-	1270	1379	1379	1.0000000
C3	29338839	29340474	BolC3t17160H	0	+	1933	1635	1635	1.0000000
C3	29340791	29342407	BolC3t17161H	0	-	239	1324	1616	0.8193069
C3	29347388	29349206	BolC3t17162H	0	+	704	1683	1818	0.9257426
C3	29349757	29351612	BolC3t17163H	0	-	1203	1855	1855	1.0000000
C3	29352681	29352858	BolC3t17164H	0	-	198	177	177	1.0000000
C3	29354534	29366012	BolC3t17165H	0	+	5080	10370	11478	0.9034675
C3	29366853	29367323	BolC3t17166H	0	-	308	470	470	1.0000000
C3	29369357	29370597	BolC3t17167H	0	-	360	1185	1240	0.9556451
C3	29391283	29393689	BolC3t17168H	0	+	629	2180	2406	0.9060681
C3	29401956	29405570	BolC3t17169H	0	-	473	2535	3614	0.7014388
C3	29427878	29428745	BolC3t17170H	0	-	310	832	867	0.9596309
C3	29431197	29431626	BolC3t17171H	0	+	251	429	429	1.0000000
C3	29433825	29434574	BolC3t17172H	0	+	174	559	749	0.7463284
C3	29449680	29449923	BolC3t17173H	0	+	6	48	243	0.1975309
C3	29461225	29461471	BolC3t17174H	0	+	183	246	246	1.0000000
C3	29464094	29465957	BolC3t17175H	0	+	38	150	1863	0.0805153
C3	29467078	29467820	BolC3t17176H	0	-	83	529	742	0.7129380
C3	29471016	29471793	BolC3t17177H	0	+	51	664	777	0.8545688
C3	29472978	29475999	BolC3t17178H	0	+	290	2203	3021	0.7292287
C3	29483609	29485754	BolC3t17179H	0	-	1131	2061	2145	0.9608392
C3	29487016	29488207	BolC3t17180H	0	+	438	1191	1191	1.0000000
C3	29489402	29492912	BolC3t17181H	0	+	1100	3322	3510	0.9464387
C3	29503635	29504577	BolC3t17182H	0	+	79	700	942	0.7430998
C3	29508431	29509092	BolC3t17183H	0	+	724	661	661	1.0000000
C3	29510857	29528068	BolC3t17184H	0	-	2114	11284	17211	0.6556272
C3	29524779	29525738	BolC3t17185H	0	-	209	932	959	0.9718457
C3	29530855	29531247	BolC3t17186H	0	-	332	392	392	1.0000000
C3	29541791	29542632	BolC3t17187H	0	-	386	841	841	1.0000000
C3	29546040	29546481	BolC3t17188H	0	-	490	441	441	1.0000000
C3	29556807	29559989	BolC3t17189H	0	+	1394	2494	3182	0.7837838
C3	29561497	29561737	BolC3t17190H	0	-	135	240	240	1.0000000
C3	29562120	29568284	BolC3t17191H	0	+	2486	5831	6164	0.9459766
C3	29580957	29581077	BolC3t17192H	0	+	185	120	120	1.0000000
C3	29586194	29589070	BolC3t17193H	0	+	4525	2876	2876	1.0000000
C3	29600689	29602143	BolC3t17194H	0	-	84	414	1454	0.2847318
C3	29602746	29604200	BolC3t17195H	0	+	6	393	1454	0.2702889
C3	29604337	29605459	BolC3t17196H	0	-	258	876	1122	0.7807487
C3	29607265	29607845	BolC3t17197H	0	+	10	209	580	0.3603448
C3	29607896	29608760	BolC3t17198H	0	-	406	728	864	0.8425926
C3	29620491	29621627	BolC3t17199H	0	+	542	1039	1136	0.9146127
C3	29623496	29624585	BolC3t17200H	0	+	32	106	1089	0.0973370
C3	29624829	29626560	BolC3t17201H	0	-	290	1323	1731	0.7642981
C3	29632755	29634040	BolC3t17202H	0	+	254	615	1285	0.4785992
C3	29634551	29637002	BolC3t17203H	0	+	1537	2243	2451	0.9151367
C3	29641311	29641571	BolC3t17204H	0	-	8	187	260	0.7192308
C3	29644892	29645228	BolC3t17205H	0	-	46	277	336	0.8244048
C3	29650858	29653139	BolC3t17206H	0	+	520	1957	2281	0.8579571
C3	29655843	29656146	BolC3t17207H	0	-	3	32	303	0.1056106
C3	29656358	29660817	BolC3t17208H	0	-	725	1363	4459	0.3056739
C3	29672855	29673998	BolC3t17209H	0	-	111	944	1143	0.8258967
C3	29684269	29685725	BolC3t17210H	0	-	253	548	1456	0.3763736
C3	29686294	29686450	BolC3t17211H	0	+	0	0	156	0.0000000
C3	29687451	29687583	BolC3t17212H	0	-	0	0	132	0.0000000
C3	29693262	29694756	BolC3t17213H	0	+	10	466	1494	0.3119143
C3	29700988	29701477	BolC3t17214H	0	-	0	0	489	0.0000000
C3	29704453	29704645	BolC3t17215H	0	-	23	192	192	1.0000000
C3	29730937	29734177	BolC3t17216H	0	+	1767	3207	3240	0.9898148
C3	29735023	29736153	BolC3t17217H	0	-	93	836	1130	0.7398230
C3	29737487	29738046	BolC3t17218H	0	-	49	491	559	0.8783542
C3	29738777	29740040	BolC3t17219H	0	-	205	1194	1263	0.9453682
C3	29740873	29741098	BolC3t17220H	0	+	14	225	225	1.0000000
C3	29743479	29743608	BolC3t17221H	0	+	18	129	129	1.0000000
C3	29747335	29750689	BolC3t17222H	0	+	2893	3354	3354	1.0000000
C3	29751012	29751856	BolC3t17223H	0	+	446	844	844	1.0000000
C3	29768924	29770985	BolC3t17224H	0	-	400	1986	2061	0.9636099
C3	29775368	29776176	BolC3t17225H	0	-	357	769	808	0.9517327
C3	29779038	29781629	BolC3t17226H	0	-	1198	2290	2591	0.8838286
C3	29798680	29800179	BolC3t17227H	0	+	245	1358	1499	0.9059373
C3	29803912	29804395	BolC3t17228H	0	+	103	483	483	1.0000000
C3	29805179	29805779	BolC3t17229H	0	+	244	600	600	1.0000000
C3	29805990	29806185	BolC3t17230H	0	+	52	195	195	1.0000000
C3	29809112	29810637	BolC3t17231H	0	+	253	1400	1525	0.9180328
C3	29810994	29812642	BolC3t17232H	0	-	769	1641	1648	0.9957525
C3	29814357	29816312	BolC3t17233H	0	-	960	1955	1955	1.0000000
C3	29822681	29822864	BolC3t17234H	0	+	24	183	183	1.0000000
C3	29832885	29834517	BolC3t17235H	0	+	25	638	1632	0.3909314
C3	29848564	29849775	BolC3t17236H	0	-	233	1105	1211	0.9124690
C3	29853523	29853814	BolC3t17237H	0	+	12	144	291	0.4948454
C3	29854626	29857035	BolC3t17238H	0	+	1673	2409	2409	1.0000000
C3	29860869	29864640	BolC3t17239H	0	+	799	3194	3771	0.8469902
C3	29865090	29866720	BolC3t17240H	0	-	269	1485	1630	0.9110429
C3	29868544	29868945	BolC3t17241H	0	+	198	401	401	1.0000000
C3	29879477	29880989	BolC3t17242H	0	-	569	1487	1512	0.9834656
C3	29887258	29887411	BolC3t17243H	0	+	138	153	153	1.0000000
C3	29894116	29894491	BolC3t17244H	0	+	102	375	375	1.0000000
C3	29913409	29913625	BolC3t17245H	0	-	38	216	216	1.0000000
C3	29956622	29959076	BolC3t17246H	0	+	1102	2454	2454	1.0000000
C3	29959640	29963516	BolC3t17247H	0	-	1190	3369	3876	0.8691950
C3	29994049	29995875	BolC3t17248H	0	+	1079	1708	1826	0.9353779
C3	30002910	30003129	BolC3t17249H	0	+	27	182	219	0.8310502
C3	30009809	30011095	BolC3t17250H	0	-	239	1274	1286	0.9906687
C3	30011260	30015115	BolC3t17251H	0	-	1356	3598	3855	0.9333333
C3	30018624	30020089	BolC3t17252H	0	+	235	1406	1465	0.9597270
C3	30020296	30020981	BolC3t17253H	0	+	231	685	685	1.0000000
C3	30035216	30035714	BolC3t17254H	0	-	140	498	498	1.0000000
C3	30036880	30038032	BolC3t17255H	0	+	971	1152	1152	1.0000000
C3	30038584	30039126	BolC3t17256H	0	-	1	45	542	0.0830258
C3	30042462	30044375	BolC3t17257H	0	-	578	1913	1913	1.0000000
C3	30045351	30045987	BolC3t17258H	0	+	190	636	636	1.0000000
C3	30046566	30049651	BolC3t17259H	0	-	2132	3085	3085	1.0000000
C3	30050906	30052083	BolC3t17260H	0	+	578	978	1177	0.8309261
C3	30058120	30059987	BolC3t17261H	0	+	680	1837	1867	0.9839314
C3	30060250	30060889	BolC3t17262H	0	-	121	639	639	1.0000000
C3	30061895	30063170	BolC3t17263H	0	-	591	1275	1275	1.0000000
C3	30071844	30072165	BolC3t17264H	0	-	380	321	321	1.0000000
C3	30087623	30087908	BolC3t17265H	0	+	40	242	285	0.8491228
C3	30093267	30093693	BolC3t17266H	0	+	21	385	426	0.9037558
C3	30096478	30096920	BolC3t17267H	0	+	264	442	442	1.0000000
C3	30097657	30100249	BolC3t17268H	0	-	1476	2592	2592	1.0000000
C3	30101022	30101722	BolC3t17269H	0	-	398	700	700	1.0000000
C3	30111265	30111931	BolC3t17270H	0	+	190	666	666	1.0000000
C3	30119354	30119699	BolC3t17271H	0	+	33	210	345	0.6086956
C3	30120790	30123847	BolC3t17272H	0	-	2197	3036	3057	0.9931305
C3	30131527	30133266	BolC3t17273H	0	+	1350	1739	1739	1.0000000
C3	30133769	30136376	BolC3t17274H	0	-	385	2210	2607	0.8477177
C3	30146903	30147062	BolC3t17275H	0	-	45	159	159	1.0000000
C3	30154996	30155302	BolC3t17276H	0	-	417	306	306	1.0000000
C3	30156091	30156345	BolC3t17277H	0	-	370	254	254	1.0000000
C3	30158009	30163150	BolC3t17278H	0	+	4202	4907	5141	0.9544836
C3	30194893	30195001	BolC3t17279H	0	-	193	108	108	1.0000000
C3	30208995	30209284	BolC3t17280H	0	-	442	289	289	1.0000000
C3	30212570	30213252	BolC3t17281H	0	+	194	682	682	1.0000000
C3	30220859	30221096	BolC3t17282H	0	-	117	219	237	0.9240506
C3	30222197	30223469	BolC3t17283H	0	+	100	1163	1272	0.9143082
C3	30226806	30227934	BolC3t17284H	0	-	804	1128	1128	1.0000000
C3	30231022	30232547	BolC3t17285H	0	-	1361	1525	1525	1.0000000
C3	30260974	30262354	BolC3t17286H	0	+	1039	1380	1380	1.0000000
C3	30268202	30268340	BolC3t17287H	0	+	0	0	138	0.0000000
C3	30276958	30278950	BolC3t17288H	0	-	1318	1992	1992	1.0000000
C3	30281077	30282429	BolC3t17289H	0	-	5	9	1352	0.0066568
C3	30303585	30304395	BolC3t17290H	0	-	0	0	810	0.0000000
C3	30332131	30332437	BolC3t17291H	0	-	0	0	306	0.0000000
C3	30349142	30352282	BolC3t17292H	0	-	2656	2396	3140	0.7630574
C3	30353198	30354209	BolC3t17293H	0	+	692	1011	1011	1.0000000
C3	30355076	30355259	BolC3t17294H	0	-	18	59	183	0.3224044
C3	30355914	30356198	BolC3t17295H	0	-	161	284	284	1.0000000
C3	30361633	30363598	BolC3t17296H	0	-	648	1208	1965	0.6147583
C3	30366606	30366789	BolC3t17297H	0	-	1	8	183	0.0437158
C3	30369050	30369233	BolC3t17298H	0	-	1	31	183	0.1693989
C3	30372710	30376127	BolC3t17299H	0	+	1570	3217	3417	0.9414691
C3	30384901	30385578	BolC3t17300H	0	+	380	677	677	1.0000000
C3	30401031	30401489	BolC3t17301H	0	+	339	458	458	1.0000000
C3	30404717	30407054	BolC3t17302H	0	+	254	1649	2337	0.7056055
C3	30409209	30411961	BolC3t17303H	0	+	955	2539	2752	0.9226018
C3	30413540	30416056	BolC3t17304H	0	+	1204	2297	2516	0.9129571
C3	30416338	30417670	BolC3t17305H	0	-	416	1332	1332	1.0000000
C3	30418596	30421730	BolC3t17306H	0	-	1556	2987	3134	0.9530951
C3	30437054	30437919	BolC3t17307H	0	-	715	865	865	1.0000000
C3	30478040	30479312	BolC3t17308H	0	+	739	1272	1272	1.0000000
C3	30484111	30486262	BolC3t17309H	0	-	36	587	2151	0.2728963
C3	30499818	30501169	BolC3t17310H	0	-	164	1064	1351	0.7875648
C3	30503639	30508570	BolC3t17311H	0	-	1647	4217	4931	0.8552018
C3	30511214	30512255	BolC3t17312H	0	+	175	1003	1041	0.9634966
C3	30513134	30514959	BolC3t17313H	0	-	1087	1825	1825	1.0000000
C3	30541555	30545424	BolC3t17314H	0	-	2269	3858	3869	0.9971569
C3	30549992	30550614	BolC3t17315H	0	-	400	622	622	1.0000000
C3	30550731	30551894	BolC3t17316H	0	-	142	1050	1163	0.9028375
C3	30552952	30553159	BolC3t17317H	0	-	9	142	207	0.6859903
C3	30561397	30562862	BolC3t17318H	0	+	955	1414	1465	0.9651877
C3	30563186	30563847	BolC3t17319H	0	-	99	629	661	0.9515885
C3	30581350	30581815	BolC3t17320H	0	+	2	131	465	0.2817204
C3	30590708	30592965	BolC3t17321H	0	+	1403	2257	2257	1.0000000
C3	30596971	30597436	BolC3t17322H	0	+	0	0	465	0.0000000
C3	30603187	30603642	BolC3t17323H	0	+	372	455	455	1.0000000
C3	30604965	30606103	BolC3t17324H	0	+	521	1138	1138	1.0000000
C3	30609482	30610416	BolC3t17325H	0	-	164	761	934	0.8147752
C3	30616636	30619470	BolC3t17326H	0	+	544	2640	2834	0.9315455
C3	30619691	30622049	BolC3t17327H	0	-	463	1969	2358	0.8350297
C3	30623925	30625140	BolC3t17328H	0	-	372	1215	1215	1.0000000
C3	30626816	30628063	BolC3t17329H	0	-	994	1247	1247	1.0000000
C3	30629831	30630650	BolC3t17330H	0	-	519	819	819	1.0000000
C3	30631810	30633046	BolC3t17331H	0	-	159	1048	1236	0.8478965
C3	30647962	30648301	BolC3t17332H	0	+	248	300	339	0.8849558
C3	30649090	30653096	BolC3t17333H	0	-	2203	3738	4006	0.9331003
C3	30654866	30656073	BolC3t17334H	0	-	108	569	1207	0.4714167
C3	30668940	30669221	BolC3t17335H	0	-	95	255	281	0.9074733
C3	30670620	30671427	BolC3t17336H	0	-	173	807	807	1.0000000
C3	30675119	30685556	BolC3t17337H	0	-	4546	9478	10437	0.9081154
C3	30687341	30689501	BolC3t17338H	0	-	509	1880	2160	0.8703704
C3	30690212	30690506	BolC3t17339H	0	-	22	264	294	0.8979592
C3	30691231	30693099	BolC3t17340H	0	-	545	1735	1868	0.9288009
C3	30703393	30703810	BolC3t17341H	0	-	412	417	417	1.0000000
C3	30704810	30706661	BolC3t17342H	0	-	441	1816	1851	0.9810913
C3	30714153	30715407	BolC3t17343H	0	+	664	1254	1254	1.0000000
C3	30716364	30716871	BolC3t17344H	0	-	33	374	507	0.7376726
C3	30729862	30732187	BolC3t17345H	0	-	102	1327	2325	0.5707527
C3	30734880	30735093	BolC3t17346H	0	-	531	213	213	1.0000000
C3	30735760	30737001	BolC3t17347H	0	-	14	286	1241	0.2304593
C3	30737594	30740143	BolC3t17348H	0	+	921	2370	2549	0.9297764
C3	30767274	30768489	BolC3t17349H	0	+	58	421	1215	0.3465021
C3	30770309	30773033	BolC3t17350H	0	-	2156	2724	2724	1.0000000
C3	30800100	30800822	BolC3t17351H	0	-	37	529	722	0.7326870
C3	30801934	30802081	BolC3t17352H	0	-	352	147	147	1.0000000
C3	30819327	30821820	BolC3t17353H	0	-	819	2285	2493	0.9165664
C3	30837567	30839194	BolC3t17354H	0	-	581	1624	1627	0.9981561
C3	30844790	30845260	BolC3t17355H	0	-	23	384	470	0.8170213
C3	30852738	30852882	BolC3t17356H	0	-	101	144	144	1.0000000
C3	30853001	30853471	BolC3t17357H	0	-	74	470	470	1.0000000
C3	30865371	30866664	BolC3t17358H	0	-	53	424	1293	0.3279196
C3	30869086	30869323	BolC3t17359H	0	+	269	237	237	1.0000000
C3	30870205	30872457	BolC3t17360H	0	-	311	1919	2252	0.8521314
C3	30887887	30889087	BolC3t17361H	0	+	21	252	1200	0.2100000
C3	30904180	30905621	BolC3t17362H	0	+	1010	1441	1441	1.0000000
C3	30905780	30907401	BolC3t17363H	0	+	341	1076	1621	0.6637878
C3	30915644	30917578	BolC3t17364H	0	+	306	1602	1934	0.8283350
C3	30919743	30920694	BolC3t17365H	0	+	1148	951	951	1.0000000
C3	30931919	30938360	BolC3t17366H	0	+	4159	6332	6441	0.9830772
C3	30941086	30945334	BolC3t17367H	0	+	2245	4171	4248	0.9818738
C3	30946017	30948483	BolC3t17368H	0	+	1434	2466	2466	1.0000000
C3	30952529	30956736	BolC3t17369H	0	+	1226	3749	4207	0.8911338
C3	30960367	30964414	BolC3t17370H	0	-	3668	4047	4047	1.0000000
C3	30964931	30968504	BolC3t17371H	0	-	1639	3300	3573	0.9235936
C3	30976580	30978485	BolC3t17372H	0	+	501	1341	1905	0.7039370
C3	30997175	31010353	BolC3t17373H	0	+	5187	8395	13178	0.6370466
C3	31010608	31010978	BolC3t17374H	0	+	336	370	370	1.0000000
C3	31033557	31035387	BolC3t17375H	0	+	517	1020	1830	0.5573770
C3	31057859	31059339	BolC3t17376H	0	+	995	862	1480	0.5824324
C3	31059448	31059860	BolC3t17377H	0	+	0	0	412	0.0000000
C3	31071002	31072787	BolC3t17378H	0	+	1168	1785	1785	1.0000000
C3	31081235	31085965	BolC3t17379H	0	+	3075	4510	4730	0.9534883
C3	31092845	31093913	BolC3t17380H	0	+	955	1068	1068	1.0000000
C3	31095303	31096734	BolC3t17381H	0	+	234	1360	1431	0.9503843
C3	31097601	31099783	BolC3t17382H	0	+	201	1478	2182	0.6773602
C3	31101188	31102717	BolC3t17383H	0	+	303	1431	1529	0.9359058
C3	31105534	31106325	BolC3t17384H	0	-	416	791	791	1.0000000
C3	31109558	31110954	BolC3t17385H	0	-	473	1396	1396	1.0000000
C3	31125085	31127137	BolC3t17386H	0	-	163	1729	2052	0.8425926
C3	31129681	31130508	BolC3t17387H	0	-	2	260	827	0.3143893
C3	31133363	31133566	BolC3t17388H	0	-	268	203	203	1.0000000
C3	31133669	31136063	BolC3t17389H	0	-	1358	2363	2394	0.9870510
C3	31136472	31137282	BolC3t17390H	0	-	114	639	810	0.7888889
C3	31143330	31144098	BolC3t17391H	0	-	441	756	768	0.9843750
C3	31155786	31156443	BolC3t17392H	0	-	250	657	657	1.0000000
C3	31158065	31160129	BolC3t17393H	0	+	1636	2064	2064	1.0000000
C3	31160945	31161272	BolC3t17394H	0	-	285	327	327	1.0000000
C3	31171534	31171765	BolC3t17395H	0	-	19	231	231	1.0000000
C3	31173231	31173375	BolC3t17396H	0	-	27	138	144	0.9583333
C3	31183747	31189363	BolC3t17397H	0	+	2876	3087	5616	0.5496795
C3	31205573	31206109	BolC3t17398H	0	+	10	343	536	0.6399254
C3	31230591	31281286	BolC3t17399H	0	+	17984	36602	50695	0.7220041
C3	31239257	31241356	BolC3t17400H	0	-	27	490	2099	0.2334445
C3	31244934	31245951	BolC3t17401H	0	+	332	213	1017	0.2094395
C3	31278376	31278896	BolC3t17402H	0	-	388	520	520	1.0000000
C3	31282674	31283107	BolC3t17403H	0	-	390	433	433	1.0000000
C3	31300285	31302497	BolC3t17404H	0	+	1233	2037	2212	0.9208861
C3	31303792	31308388	BolC3t17405H	0	+	655	3333	4596	0.7251958
C3	31310191	31311647	BolC3t17406H	0	+	255	1201	1456	0.8248627
C3	31312362	31314994	BolC3t17407H	0	-	1418	2595	2632	0.9859422
C3	31317540	31330039	BolC3t17408H	0	+	5650	12128	12499	0.9703176
C3	31323385	31324510	BolC3t17409H	0	-	478	1115	1125	0.9911111
C3	31330343	31331031	BolC3t17410H	0	-	408	688	688	1.0000000
C3	31331576	31334126	BolC3t17411H	0	-	1291	2507	2550	0.9831372
C3	31363287	31363923	BolC3t17412H	0	+	381	590	636	0.9276730
C3	31364952	31370156	BolC3t17413H	0	-	1815	4673	5204	0.8979631
C3	31379568	31381996	BolC3t17414H	0	-	381	1866	2428	0.7685338
C3	31405565	31406128	BolC3t17415H	0	+	1023	563	563	1.0000000
C3	31418706	31419828	BolC3t17416H	0	+	492	1122	1122	1.0000000
C3	31422597	31424340	BolC3t17417H	0	-	720	1644	1743	0.9432014
C3	31436274	31436463	BolC3t17418H	0	-	287	189	189	1.0000000
C3	31437434	31439366	BolC3t17419H	0	-	1112	1853	1932	0.9591097
C3	31441166	31442315	BolC3t17420H	0	-	156	1118	1149	0.9730200
C3	31447083	31447914	BolC3t17421H	0	+	50	615	831	0.7400722
C3	31453035	31453449	BolC3t17422H	0	+	8	155	414	0.3743961
C3	31458399	31459037	BolC3t17423H	0	+	697	638	638	1.0000000
C3	31461762	31463087	BolC3t17424H	0	+	974	1325	1325	1.0000000
C3	31463421	31465161	BolC3t17425H	0	-	1168	1740	1740	1.0000000
C3	31472002	31472749	BolC3t17426H	0	+	274	747	747	1.0000000
C3	31473270	31473591	BolC3t17427H	0	-	304	321	321	1.0000000
C3	31474883	31477569	BolC3t17428H	0	-	1790	2577	2686	0.9594192
C3	31483792	31486197	BolC3t17429H	0	-	774	2369	2405	0.9850312
C3	31487525	31489238	BolC3t17430H	0	+	418	1387	1713	0.8096906
C3	31489822	31491291	BolC3t17431H	0	-	529	1262	1469	0.8590878
C3	31494073	31496072	BolC3t17432H	0	-	866	1999	1999	1.0000000
C3	31496853	31497516	BolC3t17433H	0	-	109	590	663	0.8898944
C3	31498404	31501449	BolC3t17434H	0	-	1923	3045	3045	1.0000000
C3	31506023	31506521	BolC3t17435H	0	-	6	223	498	0.4477912
C3	31507615	31507771	BolC3t17436H	0	-	60	156	156	1.0000000
C3	31508382	31508664	BolC3t17437H	0	+	486	282	282	1.0000000
C3	31515087	31520886	BolC3t17438H	0	+	2623	5621	5799	0.9693050
C3	31521686	31529204	BolC3t17439H	0	+	4253	7433	7518	0.9886938
C3	31530400	31534551	BolC3t17440H	0	-	2072	4000	4151	0.9636232
C3	31545806	31547079	BolC3t17441H	0	-	442	1273	1273	1.0000000
C3	31548661	31548957	BolC3t17442H	0	+	0	0	296	0.0000000
C3	31560190	31560673	BolC3t17443H	0	+	399	465	483	0.9627329
C3	31573133	31573754	BolC3t17444H	0	+	147	579	621	0.9323671
C3	31586348	31586642	BolC3t17445H	0	+	153	294	294	1.0000000
C3	31594188	31594407	BolC3t17446H	0	+	152	219	219	1.0000000
C3	31596703	31598199	BolC3t17447H	0	-	12	99	1496	0.0661765
C3	31604303	31606210	BolC3t17448H	0	-	140	690	1907	0.3618249
C3	31619013	31619700	BolC3t17449H	0	-	143	289	687	0.4206696
C3	31620032	31621034	BolC3t17450H	0	+	931	1002	1002	1.0000000
C3	31628390	31632641	BolC3t17451H	0	-	1613	4064	4251	0.9560103
C3	31644571	31644932	BolC3t17452H	0	+	171	361	361	1.0000000
C3	31651931	31652156	BolC3t17453H	0	-	128	225	225	1.0000000
C3	31652225	31653367	BolC3t17454H	0	-	476	1142	1142	1.0000000
C3	31659732	31660257	BolC3t17455H	0	-	300	525	525	1.0000000
C3	31668862	31669141	BolC3t17456H	0	-	94	201	279	0.7204301
C3	31671411	31671720	BolC3t17457H	0	-	7	100	309	0.3236246
C3	31692290	31692927	BolC3t17458H	0	+	190	590	637	0.9262167
C3	31693639	31696914	BolC3t17459H	0	-	1250	2925	3275	0.8931298
C3	31711570	31712382	BolC3t17460H	0	+	493	812	812	1.0000000
C3	31728142	31731999	BolC3t17461H	0	-	2282	3857	3857	1.0000000
C3	31733717	31735704	BolC3t17462H	0	-	1096	1987	1987	1.0000000
C3	31736235	31738543	BolC3t17463H	0	-	2511	2308	2308	1.0000000
C3	31740960	31742172	BolC3t17464H	0	-	1298	1212	1212	1.0000000
C3	31742938	31745908	BolC3t17465H	0	-	1234	2555	2970	0.8602694
C3	31757323	31757626	BolC3t17466H	0	+	92	303	303	1.0000000
C3	31763712	31766452	BolC3t17467H	0	-	28	677	2740	0.2470803
C3	31768271	31768613	BolC3t17468H	0	-	139	319	342	0.9327486
C3	31781437	31784294	BolC3t17469H	0	-	963	2711	2857	0.9488974
C3	31786421	31786868	BolC3t17470H	0	-	6	100	447	0.2237137
C3	31788905	31789388	BolC3t17471H	0	-	1	128	483	0.2650104
C3	31805334	31823757	BolC3t17472H	0	+	6367	13108	18423	0.7115020
C3	31806779	31807958	BolC3t17473H	0	+	95	1024	1179	0.8685327
C3	31827082	31828462	BolC3t17474H	0	+	779	1380	1380	1.0000000
C3	31831009	31832182	BolC3t17475H	0	+	91	790	1173	0.6734868
C3	31836313	31837617	BolC3t17476H	0	+	343	1146	1304	0.8788344
C3	31843218	31843512	BolC3t17477H	0	-	214	294	294	1.0000000
C3	31845422	31850046	BolC3t17478H	0	-	1993	4010	4624	0.8672146
C3	31852715	31855510	BolC3t17479H	0	-	2269	2784	2795	0.9960644
C3	31859258	31863437	BolC3t17480H	0	+	1161	4179	4179	1.0000000
C3	31869715	31871176	BolC3t17481H	0	+	636	1461	1461	1.0000000
C3	31871794	31873228	BolC3t17482H	0	+	225	1314	1434	0.9163180
C3	31874597	31875038	BolC3t17483H	0	-	22	266	441	0.6031746
C3	31877285	31878130	BolC3t17484H	0	+	696	845	845	1.0000000
C3	31908072	31909799	BolC3t17485H	0	-	2463	1727	1727	1.0000000
C3	31911172	31912573	BolC3t17486H	0	-	196	1368	1401	0.9764454
C3	31923725	31925621	BolC3t17487H	0	-	2110	1896	1896	1.0000000
C3	31935804	31936851	BolC3t17488H	0	+	205	974	1047	0.9302770
C3	31938674	31939786	BolC3t17489H	0	-	658	1111	1112	0.9991007
C3	31939800	31939983	BolC3t17490H	0	-	42	183	183	1.0000000
C3	31966032	31966215	BolC3t17491H	0	-	64	183	183	1.0000000
C3	31977810	31978969	BolC3t17492H	0	+	226	1157	1159	0.9982744
C3	31980510	31980942	BolC3t17493H	0	-	36	432	432	1.0000000
C3	32011474	32012411	BolC3t17494H	0	+	1240	937	937	1.0000000
C3	32046754	32049494	BolC3t17495H	0	+	758	2436	2740	0.8890511
C3	32051732	32052269	BolC3t17496H	0	-	144	537	537	1.0000000
C3	32065684	32066539	BolC3t17497H	0	-	43	685	855	0.8011696
C3	32072892	32073078	BolC3t17498H	0	-	144	186	186	1.0000000
C3	32077691	32078389	BolC3t17499H	0	+	776	698	698	1.0000000
C3	32082200	32082470	BolC3t17500H	0	-	113	270	270	1.0000000
C3	32083378	32088511	BolC3t17501H	0	-	3523	5133	5133	1.0000000
C3	32106083	32107943	BolC3t17502H	0	-	1072	1835	1860	0.9865592
C3	32108481	32109337	BolC3t17503H	0	-	549	856	856	1.0000000
C3	32114794	32116506	BolC3t17504H	0	-	1481	1712	1712	1.0000000
C3	32125839	32126247	BolC3t17505H	0	-	354	408	408	1.0000000
C3	32128443	32129170	BolC3t17506H	0	-	655	727	727	1.0000000
C3	32133014	32134833	BolC3t17507H	0	+	194	1231	1819	0.6767455
C3	32144129	32144870	BolC3t17508H	0	+	0	0	741	0.0000000
C3	32156257	32157060	BolC3t17509H	0	+	412	803	803	1.0000000
C3	32163126	32163699	BolC3t17510H	0	-	546	573	573	1.0000000
C3	32174808	32177305	BolC3t17511H	0	+	2196	2497	2497	1.0000000
C3	32179380	32179689	BolC3t17512H	0	+	330	309	309	1.0000000
C3	32184404	32185152	BolC3t17513H	0	+	932	748	748	1.0000000
C3	32186526	32187559	BolC3t17514H	0	-	726	1033	1033	1.0000000
C3	32189309	32189796	BolC3t17515H	0	+	229	452	487	0.9281314
C3	32190288	32197167	BolC3t17516H	0	+	3870	4248	6879	0.6175316
C3	32201476	32203590	BolC3t17517H	0	+	923	2091	2114	0.9891201
C3	32208176	32208485	BolC3t17518H	0	+	266	309	309	1.0000000
C3	32212954	32218405	BolC3t17519H	0	+	2392	5128	5451	0.9407448
C3	32225400	32225831	BolC3t17520H	0	+	91	387	431	0.8979118
C3	32230214	32232436	BolC3t17521H	0	+	534	1902	2222	0.8559856
C3	32233092	32233524	BolC3t17522H	0	+	189	432	432	1.0000000
C3	32233739	32234671	BolC3t17523H	0	-	770	932	932	1.0000000
C3	32234994	32235437	BolC3t17524H	0	+	642	443	443	1.0000000
C3	32242481	32244589	BolC3t17525H	0	+	1602	2108	2108	1.0000000
C3	32250298	32251142	BolC3t17526H	0	+	1159	844	844	1.0000000
C3	32252495	32252822	BolC3t17527H	0	-	57	259	327	0.7920489
C3	32270546	32270795	BolC3t17528H	0	+	209	249	249	1.0000000
C3	32279964	32280855	BolC3t17529H	0	-	309	891	891	1.0000000
C3	32297418	32298163	BolC3t17530H	0	-	133	624	745	0.8375839
C3	32300234	32300936	BolC3t17531H	0	+	49	681	702	0.9700854
C3	32301646	32302807	BolC3t17532H	0	+	341	677	1161	0.5831180
C3	32303895	32304807	BolC3t17533H	0	-	516	912	912	1.0000000
C3	32312095	32313781	BolC3t17534H	0	-	951	1686	1686	1.0000000
C3	32320803	32321374	BolC3t17535H	0	+	157	388	571	0.6795096
C3	32322124	32323595	BolC3t17536H	0	-	504	1410	1471	0.9585316
C3	32335162	32335609	BolC3t17537H	0	+	9	193	447	0.4317673
C3	32335632	32337246	BolC3t17538H	0	+	124	1146	1614	0.7100372
C3	32343106	32343937	BolC3t17539H	0	-	3	55	831	0.0661853
C3	32393466	32398700	BolC3t17540H	0	+	802	3509	5234	0.6704242
C3	32401412	32402243	BolC3t17541H	0	-	61	365	831	0.4392298
C3	32417028	32417130	BolC3t17542H	0	+	35	102	102	1.0000000
C3	32417322	32418030	BolC3t17543H	0	+	128	708	708	1.0000000
C3	32420445	32422181	BolC3t17544H	0	+	159	1270	1736	0.7315668
C3	32432480	32433505	BolC3t17545H	0	-	93	616	1025	0.6009756
C3	32435170	32435407	BolC3t17546H	0	-	18	143	237	0.6033756
C3	32439526	32441748	BolC3t17547H	0	+	476	1685	2222	0.7583258
C3	32464667	32464901	BolC3t17548H	0	-	13	234	234	1.0000000
C3	32469219	32470308	BolC3t17549H	0	+	772	1089	1089	1.0000000
C3	32470914	32472059	BolC3t17550H	0	+	375	1014	1145	0.8855895
C3	32497816	32500007	BolC3t17551H	0	+	630	1996	2191	0.9109995
C3	32510949	32512273	BolC3t17552H	0	-	18	412	1324	0.3111782
C3	32530804	32531758	BolC3t17553H	0	+	536	893	954	0.9360587
C3	32532047	32533778	BolC3t17554H	0	-	868	1603	1731	0.9260543
C3	32535205	32538686	BolC3t17555H	0	+	1087	2842	3481	0.8164321
C3	32585764	32586883	BolC3t17556H	0	+	220	1060	1119	0.9472743
C3	32610030	32610595	BolC3t17557H	0	-	353	565	565	1.0000000
C3	32617660	32617846	BolC3t17558H	0	-	142	186	186	1.0000000
C3	32650602	32651498	BolC3t17559H	0	-	228	759	896	0.8470982
C3	32666007	32668508	BolC3t17560H	0	+	1619	2501	2501	1.0000000
C3	32689562	32691334	BolC3t17561H	0	+	45	784	1772	0.4424379
C3	32695233	32695866	BolC3t17562H	0	-	340	633	633	1.0000000
C3	32704795	32706719	BolC3t17563H	0	+	1450	1924	1924	1.0000000
C3	32708693	32714104	BolC3t17564H	0	+	1956	4554	5411	0.8416189
C3	32718489	32721767	BolC3t17565H	0	-	883	3138	3278	0.9572910
C3	32730192	32730529	BolC3t17566H	0	-	302	337	337	1.0000000
C3	32733564	32734080	BolC3t17567H	0	+	438	485	516	0.9399225
C3	32740957	32741916	BolC3t17568H	0	-	726	959	959	1.0000000
C3	32745353	32745776	BolC3t17569H	0	+	53	423	423	1.0000000
C3	32746260	32748537	BolC3t17570H	0	-	1482	2033	2277	0.8928415
C3	32754816	32755947	BolC3t17571H	0	+	172	887	1131	0.7842617
C3	32805244	32806404	BolC3t17572H	0	+	93	631	1160	0.5439655
C3	32810548	32810650	BolC3t17573H	0	+	133	102	102	1.0000000
C3	32813211	32813373	BolC3t17574H	0	-	148	162	162	1.0000000
C3	32824219	32825014	BolC3t17575H	0	+	184	795	795	1.0000000
C3	32828502	32829515	BolC3t17576H	0	-	232	788	1013	0.7778875
C3	32841032	32841719	BolC3t17577H	0	+	362	687	687	1.0000000
C3	32861953	32864232	BolC3t17578H	0	+	738	1619	2279	0.7103993
C3	32874493	32875549	BolC3t17579H	0	+	474	1015	1056	0.9611742
C3	32885377	32885479	BolC3t17580H	0	+	141	102	102	1.0000000
C3	32901977	32905592	BolC3t17581H	0	+	1175	3154	3615	0.8724758
C3	32923350	32923599	BolC3t17582H	0	+	344	240	249	0.9638554
C3	32924779	32925139	BolC3t17583H	0	-	47	280	360	0.7777778
C3	32929006	32935312	BolC3t17584H	0	+	1455	5313	6306	0.8425309
C3	32936246	32936699	BolC3t17585H	0	+	226	453	453	1.0000000
C3	32946684	32946786	BolC3t17586H	0	+	118	102	102	1.0000000
C3	33003693	33004966	BolC3t17587H	0	-	20	455	1273	0.3574234
C3	33006541	33006664	BolC3t17588H	0	+	2	98	123	0.7967480
C3	33009341	33014028	BolC3t17589H	0	+	2261	4632	4687	0.9882654
C3	33015849	33018343	BolC3t17590H	0	-	862	2229	2494	0.8937450
C3	33019791	33020962	BolC3t17591H	0	-	1042	1171	1171	1.0000000
C3	33039221	33039602	BolC3t17592H	0	+	122	381	381	1.0000000
C3	33049053	33050421	BolC3t17593H	0	+	166	1221	1368	0.8925439
C3	33057625	33059247	BolC3t17594H	0	+	58	411	1622	0.2533909
C3	33061949	33063257	BolC3t17595H	0	+	426	1173	1308	0.8967890
C3	33070080	33073611	BolC3t17596H	0	-	1450	3482	3531	0.9861229
C3	33074503	33076259	BolC3t17597H	0	-	1041	1756	1756	1.0000000
C3	33098205	33099666	BolC3t17598H	0	-	192	1081	1461	0.7399042
C3	33113905	33116379	BolC3t17599H	0	+	1047	2472	2474	0.9991916
C3	33119384	33120469	BolC3t17600H	0	+	314	1085	1085	1.0000000
C3	33125354	33127237	BolC3t17601H	0	-	1120	1847	1883	0.9808816
C3	33150472	33151051	BolC3t17602H	0	+	33	340	579	0.5872194
C3	33162278	33164468	BolC3t17603H	0	+	2010	2190	2190	1.0000000
C3	33165607	33169165	BolC3t17604H	0	-	3179	3558	3558	1.0000000
C3	33183695	33184164	BolC3t17605H	0	+	385	469	469	1.0000000
C3	33186591	33186984	BolC3t17606H	0	+	123	393	393	1.0000000
C3	33187563	33190835	BolC3t17607H	0	-	1598	3194	3272	0.9761614
C3	33207962	33212658	BolC3t17608H	0	+	1413	4057	4696	0.8639268
C3	33237351	33237503	BolC3t17609H	0	-	213	152	152	1.0000000
C3	33237593	33237946	BolC3t17610H	0	-	407	353	353	1.0000000
C3	33247131	33249552	BolC3t17611H	0	-	1553	2421	2421	1.0000000
C3	33257596	33258502	BolC3t17612H	0	+	6	441	906	0.4867550
C3	33267162	33268627	BolC3t17613H	0	+	1130	1465	1465	1.0000000
C3	33272222	33272682	BolC3t17614H	0	+	836	460	460	1.0000000
C3	33278044	33278425	BolC3t17615H	0	-	48	263	381	0.6902887
C3	33280046	33284907	BolC3t17616H	0	+	2961	4318	4861	0.8882946
C3	33287130	33287508	BolC3t17617H	0	-	54	217	378	0.5740741
C3	33303986	33304280	BolC3t17618H	0	+	209	294	294	1.0000000
C3	33324141	33325644	BolC3t17619H	0	-	54	988	1503	0.6573520
C3	33329271	33330673	BolC3t17620H	0	-	1344	1402	1402	1.0000000
C3	33333943	33334868	BolC3t17621H	0	-	120	925	925	1.0000000
C3	33360947	33363147	BolC3t17622H	0	+	774	2074	2200	0.9427273
C3	33363484	33365288	BolC3t17623H	0	-	978	1804	1804	1.0000000
C3	33371244	33372022	BolC3t17624H	0	-	449	778	778	1.0000000
C3	33372959	33376423	BolC3t17625H	0	+	1599	3464	3464	1.0000000
C3	33380547	33383738	BolC3t17626H	0	-	1472	2978	3191	0.9332498
C3	33392218	33393578	BolC3t17627H	0	-	692	1360	1360	1.0000000
C3	33410554	33411217	BolC3t17628H	0	+	528	663	663	1.0000000
C3	33420052	33420673	BolC3t17629H	0	+	409	621	621	1.0000000
C3	33435429	33436437	BolC3t17630H	0	+	225	1008	1008	1.0000000
C3	33450687	33455172	BolC3t17631H	0	-	2127	4355	4485	0.9710145
C3	33456945	33461187	BolC3t17632H	0	-	746	2775	4242	0.6541725
C3	33477007	33478877	BolC3t17633H	0	+	1016	1870	1870	1.0000000
C3	33479395	33482091	BolC3t17634H	0	-	850	2696	2696	1.0000000
C3	33487884	33489170	BolC3t17635H	0	+	161	926	1286	0.7200622
C3	33490681	33492137	BolC3t17636H	0	-	305	1229	1456	0.8440934
C3	33504313	33504841	BolC3t17637H	0	+	26	337	528	0.6382576
C3	33505120	33506874	BolC3t17638H	0	+	152	1594	1754	0.9087799
C3	33508379	33510728	BolC3t17639H	0	-	1497	2265	2349	0.9642401
C3	33526003	33526423	BolC3t17640H	0	-	238	420	420	1.0000000
C3	33529058	33529523	BolC3t17641H	0	-	283	465	465	1.0000000
C3	33529666	33531032	BolC3t17642H	0	-	716	1366	1366	1.0000000
C3	33531271	33531557	BolC3t17643H	0	-	178	286	286	1.0000000
C3	33535047	33537294	BolC3t17644H	0	-	8641	2106	2247	0.9372497
C3	33549626	33550607	BolC3t17645H	0	+	906	981	981	1.0000000
C3	33551647	33555383	BolC3t17646H	0	-	820	2992	3736	0.8008565
C3	33585994	33586752	BolC3t17647H	0	+	158	758	758	1.0000000
C3	33598950	33599312	BolC3t17648H	0	+	210	357	362	0.9861878
C3	33599471	33619309	BolC3t17649H	0	-	2883	11981	19838	0.6039419
C3	33606573	33606922	BolC3t17650H	0	+	8	150	349	0.4297994
C3	33613633	33613987	BolC3t17651H	0	+	30	245	354	0.6920904
C3	33624322	33624682	BolC3t17652H	0	+	136	360	360	1.0000000
C3	33624838	33626737	BolC3t17653H	0	-	1067	1899	1899	1.0000000
C3	33637089	33637275	BolC3t17654H	0	-	52	186	186	1.0000000
C3	33652964	33653465	BolC3t17655H	0	+	346	501	501	1.0000000
C3	33657025	33658659	BolC3t17656H	0	+	0	0	1634	0.0000000
C3	33665365	33666159	BolC3t17657H	0	-	1	45	794	0.0566751
C3	33669215	33670307	BolC3t17658H	0	-	229	927	1092	0.8489011
C3	33671080	33678803	BolC3t17659H	0	-	2439	6293	7723	0.8148388
C3	33679437	33680289	BolC3t17660H	0	-	617	852	852	1.0000000
C3	33697965	33699213	BolC3t17661H	0	+	1063	1081	1248	0.8661859
C3	33742227	33754577	BolC3t17662H	0	+	1127	5216	12350	0.4223482
C3	33770215	33774587	BolC3t17663H	0	+	238	1841	4372	0.4210888
C3	33781574	33782411	BolC3t17664H	0	+	150	646	837	0.7718040
C3	33788561	33789337	BolC3t17665H	0	-	45	476	776	0.6134021
C3	33807520	33808673	BolC3t17666H	0	+	488	667	1153	0.5784909
C3	33811389	33811592	BolC3t17667H	0	-	40	188	203	0.9261084
C3	33813824	33814337	BolC3t17668H	0	-	180	367	513	0.7153996
C3	33817430	33817799	BolC3t17669H	0	-	90	369	369	1.0000000
C3	33817830	33818373	BolC3t17670H	0	-	260	521	543	0.9594843
C3	33826577	33827405	BolC3t17671H	0	+	11	327	828	0.3949275
C3	33847943	33848171	BolC3t17672H	0	-	0	0	228	0.0000000
C3	33850038	33858033	BolC3t17673H	0	-	518	5595	7995	0.6998124
C3	33864263	33867602	BolC3t17674H	0	-	593	2583	3339	0.7735849
C3	33868867	33870211	BolC3t17675H	0	-	150	379	1344	0.2819940
C3	33870798	33871109	BolC3t17676H	0	-	2	21	311	0.0675241
C3	33876577	33877354	BolC3t17677H	0	+	2	19	777	0.0244530
C3	33891837	33891981	BolC3t17678H	0	+	5	66	144	0.4583333
C3	33941598	33942049	BolC3t17679H	0	+	594	451	451	1.0000000
C3	33944402	33964609	BolC3t17680H	0	+	6890	13864	20207	0.6860989
C3	33990430	33990655	BolC3t17681H	0	+	0	0	225	0.0000000
C3	33999684	34000340	BolC3t17682H	0	+	26	355	656	0.5411586
C3	34013007	34014006	BolC3t17683H	0	-	71	760	999	0.7607608
C3	34021841	34022899	BolC3t17684H	0	-	0	0	1058	0.0000000
C3	34029754	34030356	BolC3t17685H	0	-	2	20	602	0.0332226
C3	34035696	34036024	BolC3t17686H	0	+	203	328	328	1.0000000
C3	34037254	34037635	BolC3t17687H	0	-	265	363	381	0.9527559
C3	34053976	34054785	BolC3t17688H	0	+	6	38	809	0.0469716
C3	34055705	34056918	BolC3t17689H	0	+	1	74	1213	0.0610058
C3	34056947	34060669	BolC3t17690H	0	+	2	19	3722	0.0051048
C3	34057291	34059345	BolC3t17691H	0	+	2	19	2054	0.0092502
C3	34064558	34065970	BolC3t17692H	0	-	45	393	1412	0.2783286
C3	34086134	34086999	BolC3t17693H	0	+	461	829	865	0.9583815
C3	34087188	34088583	BolC3t17694H	0	+	884	1362	1395	0.9763441
C3	34089618	34094804	BolC3t17695H	0	-	1220	4820	5186	0.9294254
C3	34113958	34115182	BolC3t17696H	0	+	29	377	1224	0.3080065
C3	34116435	34116660	BolC3t17697H	0	+	159	225	225	1.0000000
C3	34120421	34121369	BolC3t17698H	0	+	486	940	948	0.9915612
C3	34143639	34145991	BolC3t17699H	0	+	951	1813	2352	0.7708333
C3	34160255	34161325	BolC3t17700H	0	-	793	1070	1070	1.0000000
C3	34165262	34166050	BolC3t17701H	0	-	337	788	788	1.0000000
C3	34178959	34179846	BolC3t17702H	0	+	824	887	887	1.0000000
C3	34185447	34186073	BolC3t17703H	0	-	41	225	626	0.3594249
C3	34191059	34191332	BolC3t17704H	0	+	0	0	273	0.0000000
C3	34196886	34198380	BolC3t17705H	0	-	934	1493	1494	0.9993306
C3	34200163	34202924	BolC3t17706H	0	-	560	2070	2761	0.7497284
C3	34240050	34242863	BolC3t17707H	0	+	830	2182	2813	0.7756843
C3	34263501	34265750	BolC3t17708H	0	+	902	2066	2249	0.9186305
C3	34268244	34269051	BolC3t17709H	0	-	1077	807	807	1.0000000
C3	34271060	34271665	BolC3t17710H	0	+	2	57	605	0.0942149
C3	34285569	34287572	BolC3t17711H	0	+	38	150	2003	0.0748877
C3	34295164	34298871	BolC3t17712H	0	+	820	3185	3707	0.8591853
C3	34299077	34299787	BolC3t17713H	0	-	717	710	710	1.0000000
C3	34308395	34308692	BolC3t17714H	0	+	0	0	297	0.0000000
C3	34314168	34316001	BolC3t17715H	0	+	804	1820	1833	0.9929078
C3	34338963	34339913	BolC3t17716H	0	+	505	950	950	1.0000000
C3	34342030	34343531	BolC3t17717H	0	+	638	1392	1501	0.9273818
C3	34344698	34353385	BolC3t17718H	0	-	2275	6116	8687	0.7040405
C3	34354910	34355048	BolC3t17719H	0	-	0	0	138	0.0000000
C3	34367731	34369063	BolC3t17720H	0	+	976	1332	1332	1.0000000
C3	34370617	34370824	BolC3t17721H	0	-	208	207	207	1.0000000
C3	34379605	34380612	BolC3t17722H	0	-	56	800	1007	0.7944389
C3	34383710	34385513	BolC3t17723H	0	+	861	1781	1803	0.9877981
C3	34390067	34392265	BolC3t17724H	0	-	2286	2198	2198	1.0000000
C3	34392324	34393672	BolC3t17725H	0	-	324	1220	1348	0.9050445
C3	34403964	34405104	BolC3t17726H	0	+	319	1102	1140	0.9666666
C3	34414355	34415939	BolC3t17727H	0	-	1425	1584	1584	1.0000000
C3	34428521	34430300	BolC3t17728H	0	+	905	1779	1779	1.0000000
C3	34431252	34431763	BolC3t17729H	0	+	304	511	511	1.0000000
C3	34441741	34443088	BolC3t17730H	0	-	1061	1347	1347	1.0000000
C3	34445370	34446919	BolC3t17731H	0	-	205	1505	1549	0.9715946
C3	34448840	34450803	BolC3t17732H	0	+	539	1749	1963	0.8909832
C3	34451251	34452622	BolC3t17733H	0	-	373	1253	1371	0.9139314
C3	34463842	34466162	BolC3t17734H	0	-	719	1437	2320	0.6193966
C3	34468770	34468959	BolC3t17735H	0	-	33	189	189	1.0000000
C3	34483847	34485014	BolC3t17736H	0	+	80	779	1167	0.6675236
C3	34499903	34501226	BolC3t17737H	0	+	1549	1323	1323	1.0000000
C3	34508102	34510897	BolC3t17738H	0	+	773	2760	2795	0.9874777
C3	34511624	34512461	BolC3t17739H	0	+	632	837	837	1.0000000
C3	34513755	34516648	BolC3t17740H	0	+	1242	2658	2893	0.9187694
C3	34519583	34520719	BolC3t17741H	0	+	470	1050	1136	0.9242958
C3	34529475	34535529	BolC3t17742H	0	-	3661	6054	6054	1.0000000
C3	34535779	34537283	BolC3t17743H	0	-	763	1127	1504	0.7493351
C3	34538489	34540384	BolC3t17744H	0	+	1054	1863	1895	0.9831135
C3	34540877	34541846	BolC3t17745H	0	-	520	969	969	1.0000000
C3	34561523	34564984	BolC3t17746H	0	-	995	2965	3461	0.8566888
C3	34586027	34587914	BolC3t17747H	0	+	797	1887	1887	1.0000000
C3	34588369	34595499	BolC3t17748H	0	-	4077	6799	7130	0.9535764
C3	34604314	34608563	BolC3t17749H	0	-	776	3417	4249	0.8041892
C3	34669783	34670725	BolC3t17750H	0	+	0	0	942	0.0000000
C3	34728146	34728391	BolC3t17751H	0	-	30	92	245	0.3755102
C3	34730171	34734863	BolC3t17752H	0	+	78	1496	4692	0.3188406
C3	34751410	34752158	BolC3t17753H	0	-	186	748	748	1.0000000
C3	34754924	34761172	BolC3t17754H	0	-	1334	5321	6248	0.8516325
C3	34762189	34762351	BolC3t17755H	0	+	39	162	162	1.0000000
C3	34766752	34767085	BolC3t17756H	0	-	52	333	333	1.0000000
C3	34769303	34769729	BolC3t17757H	0	-	376	426	426	1.0000000
C3	34785729	34786074	BolC3t17758H	0	-	75	252	345	0.7304348
C3	34795688	34798823	BolC3t17759H	0	+	355	2080	3135	0.6634769
C3	34799301	34801565	BolC3t17760H	0	+	998	2176	2264	0.9611307
C3	34802016	34802317	BolC3t17761H	0	-	51	166	301	0.5514950
C3	34818457	34819616	BolC3t17762H	0	-	266	1069	1159	0.9223468
C3	34826963	34827309	BolC3t17763H	0	-	7	223	346	0.6445087
C3	34839530	34842291	BolC3t17764H	0	+	210	1292	2761	0.4679464
C3	34846023	34846550	BolC3t17765H	0	+	16	326	527	0.6185958
C3	34850402	34850982	BolC3t17766H	0	+	46	161	580	0.2775862
C3	34851806	34852446	BolC3t17767H	0	-	312	640	640	1.0000000
C3	34856439	34857669	BolC3t17768H	0	+	212	1038	1230	0.8439025
C3	34881707	34881995	BolC3t17769H	0	+	116	263	288	0.9131944
C3	34882769	34883667	BolC3t17770H	0	+	102	537	898	0.5979955
C3	34891479	34892136	BolC3t17771H	0	+	197	657	657	1.0000000
C3	34892419	34892857	BolC3t17772H	0	-	83	331	438	0.7557077
C3	34895018	34896530	BolC3t17773H	0	+	528	1512	1512	1.0000000
C3	34896676	34899805	BolC3t17774H	0	-	1076	3129	3129	1.0000000
C3	34900265	34900440	BolC3t17775H	0	+	13	175	175	1.0000000
C3	34902160	34903734	BolC3t17776H	0	+	421	1454	1574	0.9237611
C3	34905783	34907363	BolC3t17777H	0	+	169	1230	1580	0.7784810
C3	34923040	34928397	BolC3t17778H	0	+	2485	5212	5357	0.9729326
C3	34929771	34932220	BolC3t17779H	0	+	811	2326	2449	0.9497754
C3	34951715	34952489	BolC3t17780H	0	+	75	674	774	0.8708010
C3	34954267	34955070	BolC3t17781H	0	+	363	690	803	0.8592777
C3	34955922	34975245	BolC3t17782H	0	-	5811	16156	19323	0.8361021
C3	34992240	34993866	BolC3t17783H	0	+	1577	1626	1626	1.0000000
C3	34993970	34994821	BolC3t17784H	0	+	390	794	851	0.9330200
C3	34996591	34996762	BolC3t17785H	0	-	0	0	171	0.0000000
C3	34998006	35001418	BolC3t17786H	0	-	212	875	3412	0.2564478
C3	34999751	35000099	BolC3t17787H	0	-	163	348	348	1.0000000
C3	35001735	35002082	BolC3t17788H	0	-	31	347	347	1.0000000
C3	35003604	35003775	BolC3t17789H	0	-	0	0	171	0.0000000
C3	35005017	35006409	BolC3t17790H	0	-	12	339	1392	0.2435345
C3	35006763	35007111	BolC3t17791H	0	-	49	348	348	1.0000000
C3	35008713	35009060	BolC3t17792H	0	-	123	347	347	1.0000000
C3	35010669	35011018	BolC3t17793H	0	-	99	349	349	1.0000000
C3	35012614	35012962	BolC3t17794H	0	-	155	348	348	1.0000000
C3	35014570	35014918	BolC3t17795H	0	-	232	348	348	1.0000000
C3	35016635	35016866	BolC3t17796H	0	-	116	231	231	1.0000000
C3	35025546	35026856	BolC3t17797H	0	+	1136	1310	1310	1.0000000
C3	35031944	35033877	BolC3t17798H	0	-	509	1659	1933	0.8582515
C3	35040344	35041529	BolC3t17799H	0	-	1205	982	1185	0.8286920
C3	35050898	35053853	BolC3t17800H	0	-	774	2609	2955	0.8829103
C3	35055216	35057289	BolC3t17801H	0	-	1343	2044	2073	0.9860106
C3	35059264	35061340	BolC3t17802H	0	-	937	2076	2076	1.0000000
C3	35062153	35064760	BolC3t17803H	0	+	444	2051	2607	0.7867280
C3	35067942	35069728	BolC3t17804H	0	+	1179	1786	1786	1.0000000
C3	35070423	35075464	BolC3t17805H	0	-	1819	5041	5041	1.0000000
C3	35078788	35081676	BolC3t17806H	0	-	2255	2888	2888	1.0000000
C3	35089535	35090519	BolC3t17807H	0	+	226	861	984	0.8750000
C3	35096790	35097682	BolC3t17808H	0	-	72	837	892	0.9383408
C3	35098543	35103225	BolC3t17809H	0	-	1345	4076	4682	0.8705682
C3	35111860	35114080	BolC3t17810H	0	+	631	1763	2220	0.7941442
C3	35122490	35122895	BolC3t17811H	0	-	2	86	405	0.2123457
C3	35125064	35125298	BolC3t17812H	0	-	3	166	234	0.7094017
C3	35130371	35131489	BolC3t17813H	0	-	30	537	1118	0.4803220
C3	35139484	35140624	BolC3t17814H	0	-	198	506	1140	0.4438596
C3	35153306	35155379	BolC3t17815H	0	-	241	1543	2073	0.7443319
C3	35190955	35192078	BolC3t17816H	0	-	648	1123	1123	1.0000000
C3	35193738	35194125	BolC3t17817H	0	-	58	324	387	0.8372093
C3	35207155	35207311	BolC3t17818H	0	+	1	24	156	0.1538462
C3	35242466	35243729	BolC3t17819H	0	+	857	1261	1263	0.9984165
C3	35253056	35253775	BolC3t17820H	0	+	231	719	719	1.0000000
C3	35256804	35257657	BolC3t17821H	0	-	106	608	853	0.7127784
C3	35261836	35270843	BolC3t17822H	0	+	3053	8787	9007	0.9755746
C3	35275760	35276251	BolC3t17823H	0	-	173	491	491	1.0000000
C3	35286718	35286916	BolC3t17824H	0	+	257	198	198	1.0000000
C3	35290835	35292867	BolC3t17825H	0	+	1525	2032	2032	1.0000000
C3	35293257	35293752	BolC3t17826H	0	-	162	495	495	1.0000000
C3	35294253	35295423	BolC3t17827H	0	-	992	1170	1170	1.0000000
C3	35298386	35306612	BolC3t17828H	0	+	1506	6563	8226	0.7978361
C3	35307605	35310484	BolC3t17829H	0	+	815	2575	2879	0.8944078
C3	35311847	35316102	BolC3t17830H	0	-	335	3016	4255	0.7088132
C3	35321634	35321832	BolC3t17831H	0	+	68	198	198	1.0000000
C3	35328180	35328552	BolC3t17832H	0	-	131	372	372	1.0000000
C3	35340518	35344285	BolC3t17833H	0	+	1095	3400	3767	0.9025750
C3	35345874	35349423	BolC3t17834H	0	-	437	2688	3549	0.7573965
C3	35357188	35361965	BolC3t17835H	0	-	1213	3513	4777	0.7353988
C3	35365432	35368602	BolC3t17836H	0	+	1117	3097	3170	0.9769716
C3	35369714	35370902	BolC3t17837H	0	-	1357	1188	1188	1.0000000
C3	35394265	35396029	BolC3t17838H	0	-	81	1285	1764	0.7284580
C3	35415338	35416666	BolC3t17839H	0	+	629	1204	1328	0.9066265
C3	35421211	35427784	BolC3t17840H	0	+	2216	5625	6573	0.8557736
C3	35428698	35433978	BolC3t17841H	0	+	2564	5083	5280	0.9626894
C3	35434536	35436384	BolC3t17842H	0	-	894	1842	1848	0.9967533
C3	35440297	35440525	BolC3t17843H	0	-	33	228	228	1.0000000
C3	35442262	35444402	BolC3t17844H	0	+	491	1961	2140	0.9163551
C3	35444578	35444812	BolC3t17845H	0	-	56	234	234	1.0000000
C3	35448679	35450185	BolC3t17846H	0	+	276	801	1506	0.5318725
C3	35450611	35454213	BolC3t17847H	0	+	82	1252	3602	0.3475847
C3	35456115	35456590	BolC3t17848H	0	+	305	475	475	1.0000000
C3	35456765	35457563	BolC3t17849H	0	+	612	798	798	1.0000000
C3	35458536	35458731	BolC3t17850H	0	-	36	195	195	1.0000000
C3	35461861	35463497	BolC3t17851H	0	+	949	1588	1636	0.9706602
C3	35464775	35465387	BolC3t17852H	0	+	540	612	612	1.0000000
C3	35466657	35467847	BolC3t17853H	0	-	505	1190	1190	1.0000000
C3	35477163	35480439	BolC3t17854H	0	-	1123	3090	3276	0.9432234
C3	35482749	35484056	BolC3t17855H	0	-	274	776	1307	0.5937261
C3	35486788	35487605	BolC3t17856H	0	+	10	177	817	0.2166463
C3	35488117	35490409	BolC3t17857H	0	-	646	2112	2292	0.9214660
C3	35498145	35499441	BolC3t17858H	0	+	924	1296	1296	1.0000000
C3	35501778	35504374	BolC3t17859H	0	+	1682	2585	2596	0.9957627
C3	35510223	35511791	BolC3t17860H	0	+	562	1149	1568	0.7327806
C3	35519178	35520727	BolC3t17861H	0	+	155	1106	1549	0.7140090
C3	35521653	35522874	BolC3t17862H	0	-	14	582	1221	0.4766585
C3	35523545	35528542	BolC3t17863H	0	-	2100	4956	4997	0.9917951
C3	35529609	35535024	BolC3t17864H	0	-	3218	4667	5415	0.8618652
C3	35541857	35543832	BolC3t17865H	0	-	787	1800	1975	0.9113924
C3	35559384	35560008	BolC3t17866H	0	-	83	234	624	0.3750000
C3	35564648	35566739	BolC3t17867H	0	+	473	2034	2091	0.9727403
C3	35567154	35569053	BolC3t17868H	0	-	514	1886	1899	0.9931543
C3	35572490	35572793	BolC3t17869H	0	-	171	303	303	1.0000000
C3	35582114	35583197	BolC3t17870H	0	-	53	805	1083	0.7433056
C3	35591060	35592851	BolC3t17871H	0	-	778	1534	1791	0.8565047
C3	35594916	35595078	BolC3t17872H	0	+	24	162	162	1.0000000
C3	35605471	35605816	BolC3t17873H	0	-	310	345	345	1.0000000
C3	35609284	35609395	BolC3t17874H	0	-	35	111	111	1.0000000
C3	35619720	35623645	BolC3t17875H	0	+	452	2759	3925	0.7029299
C3	35628005	35630883	BolC3t17876H	0	-	474	2418	2878	0.8401668
C3	35632147	35632332	BolC3t17877H	0	-	9	179	185	0.9675676
C3	35634191	35635644	BolC3t17878H	0	-	478	1108	1453	0.7625602
C3	35639432	35652115	BolC3t17879H	0	-	1598	5497	12683	0.4334148
C3	35654948	35656902	BolC3t17880H	0	-	985	1891	1954	0.9677584
C3	35657761	35658644	BolC3t17881H	0	+	522	883	883	1.0000000
C3	35668419	35668995	BolC3t17882H	0	+	478	542	576	0.9409722
C3	35695646	35699663	BolC3t17883H	0	+	1451	3502	4017	0.8717949
C3	35702359	35705529	BolC3t17884H	0	-	1208	3057	3170	0.9643533
C3	35706008	35706269	BolC3t17885H	0	-	147	261	261	1.0000000
C3	35733452	35735047	BolC3t17886H	0	-	1056	1595	1595	1.0000000
C3	35736154	35736765	BolC3t17887H	0	+	84	438	611	0.7168576
C3	35743072	35744350	BolC3t17888H	0	+	402	1250	1278	0.9780908
C3	35745013	35745478	BolC3t17889H	0	+	402	465	465	1.0000000
C3	35767051	35768666	BolC3t17890H	0	+	330	1160	1615	0.7182662
C3	35769822	35771897	BolC3t17891H	0	+	1737	2075	2075	1.0000000
C3	35773043	35782451	BolC3t17892H	0	-	4017	9336	9408	0.9923469
C3	35787981	35790896	BolC3t17893H	0	+	125	1977	2915	0.6782161
C3	35795561	35796044	BolC3t17894H	0	-	87	261	483	0.5403727
C3	35809089	35809578	BolC3t17895H	0	-	518	489	489	1.0000000
C3	35842183	35844673	BolC3t17896H	0	-	1355	2490	2490	1.0000000
C3	35847645	35849610	BolC3t17897H	0	-	1117	1965	1965	1.0000000
C3	35859737	35863193	BolC3t17898H	0	+	2491	3446	3456	0.9971065
C3	35863825	35865258	BolC3t17899H	0	+	697	1388	1433	0.9685974
C3	35872060	35872297	BolC3t17900H	0	-	4	131	237	0.5527426
C3	35872394	35874094	BolC3t17901H	0	-	23	377	1700	0.2217647
C3	35883996	35884179	BolC3t17902H	0	+	37	177	183	0.9672131
C3	35885118	35887192	BolC3t17903H	0	+	490	1813	2074	0.8741562
C3	35888164	35889348	BolC3t17904H	0	+	580	1184	1184	1.0000000
C3	35890194	35890817	BolC3t17905H	0	+	340	623	623	1.0000000
C3	35892620	35894655	BolC3t17906H	0	+	1100	1931	2035	0.9488943
C3	35902349	35908994	BolC3t17907H	0	+	1512	4935	6645	0.7426637
C3	35922506	35923773	BolC3t17908H	0	+	528	1267	1267	1.0000000
C3	35932537	35934536	BolC3t17909H	0	+	4836	1995	1999	0.9979990
C3	35935615	35936116	BolC3t17910H	0	+	265	501	501	1.0000000
C3	35936844	35938465	BolC3t17911H	0	-	1006	1621	1621	1.0000000
C3	35941535	35943309	BolC3t17912H	0	-	808	1774	1774	1.0000000
C3	35954017	35954555	BolC3t17913H	0	-	11	337	538	0.6263940
C3	35957843	35958235	BolC3t17914H	0	-	474	392	392	1.0000000
C3	35960015	35960306	BolC3t17915H	0	-	171	291	291	1.0000000
C3	35974689	35974881	BolC3t17916H	0	-	47	192	192	1.0000000
C3	35974933	35975189	BolC3t17917H	0	-	72	256	256	1.0000000
C3	35981581	35983990	BolC3t17918H	0	+	5	285	2409	0.1183064
C3	35986466	35988041	BolC3t17919H	0	-	81	889	1575	0.5644444
C3	35995339	35995778	BolC3t17920H	0	-	4	107	439	0.2437358
C3	36001723	36004183	BolC3t17921H	0	+	1038	2460	2460	1.0000000
C3	36005179	36007075	BolC3t17922H	0	+	1229	1896	1896	1.0000000
C3	36013940	36014618	BolC3t17923H	0	+	240	640	678	0.9439528
C3	36019797	36022153	BolC3t17924H	0	-	894	2084	2356	0.8845501
C3	36023357	36025019	BolC3t17925H	0	+	1304	1662	1662	1.0000000
C3	36040494	36041061	BolC3t17926H	0	+	67	453	567	0.7989418
C3	36048127	36048988	BolC3t17927H	0	+	671	861	861	1.0000000
C3	36054269	36055265	BolC3t17928H	0	-	94	911	996	0.9146586
C3	36059514	36060515	BolC3t17929H	0	+	467	967	1001	0.9660340
C3	36061716	36063330	BolC3t17930H	0	+	257	1396	1614	0.8649318
C3	36092428	36095571	BolC3t17931H	0	+	1745	3143	3143	1.0000000
C3	36099782	36099884	BolC3t17932H	0	+	137	102	102	1.0000000
C3	36107662	36108077	BolC3t17933H	0	+	56	238	415	0.5734940
C3	36109063	36110847	BolC3t17934H	0	-	38	766	1784	0.4293722
C3	36110971	36111214	BolC3t17935H	0	-	136	243	243	1.0000000
C3	36116357	36116459	BolC3t17936H	0	+	48	102	102	1.0000000
C3	36122513	36122869	BolC3t17937H	0	+	197	356	356	1.0000000
C3	36133678	36134440	BolC3t17938H	0	+	325	762	762	1.0000000
C3	36138325	36139267	BolC3t17939H	0	-	890	942	942	1.0000000
C3	36146436	36148525	BolC3t17940H	0	+	3238	2089	2089	1.0000000
C3	36151235	36152756	BolC3t17941H	0	-	391	1284	1521	0.8441815
C3	36160833	36162924	BolC3t17942H	0	-	815	2014	2091	0.9631755
C3	36163607	36166596	BolC3t17943H	0	-	1934	2989	2989	1.0000000
C3	36173654	36175796	BolC3t17944H	0	+	1889	2142	2142	1.0000000
C3	36198971	36199784	BolC3t17945H	0	+	323	813	813	1.0000000
C3	36200231	36201730	BolC3t17946H	0	+	1568	1499	1499	1.0000000
C3	36220068	36228547	BolC3t17947H	0	+	974	3646	8479	0.4300035
C3	36233805	36236627	BolC3t17948H	0	+	43	975	2822	0.3454996
C3	36249018	36249216	BolC3t17949H	0	+	29	129	198	0.6515151
C3	36262528	36265329	BolC3t17950H	0	-	1231	2471	2801	0.8821849
C3	36269747	36271401	BolC3t17951H	0	+	1178	1654	1654	1.0000000
C3	36272085	36274704	BolC3t17952H	0	-	5197	2619	2619	1.0000000
C3	36275119	36276102	BolC3t17953H	0	-	506	983	983	1.0000000
C3	36280178	36281240	BolC3t17954H	0	-	197	452	1062	0.4256121
C3	36281944	36284438	BolC3t17955H	0	-	1409	2351	2494	0.9426624
C3	36298135	36298360	BolC3t17956H	0	+	457	225	225	1.0000000
C3	36302566	36302819	BolC3t17957H	0	+	225	253	253	1.0000000
C3	36307698	36308559	BolC3t17958H	0	+	267	840	861	0.9756098
C3	36310965	36312051	BolC3t17959H	0	-	153	970	1086	0.8931860
C3	36325297	36325519	BolC3t17960H	0	-	412	222	222	1.0000000
C3	36335635	36336738	BolC3t17961H	0	-	676	1103	1103	1.0000000
C3	36340766	36341202	BolC3t17962H	0	-	2	29	436	0.0665138
C3	36341716	36344974	BolC3t17963H	0	-	19	189	3258	0.0580111
C3	36345754	36347623	BolC3t17964H	0	+	673	1782	1869	0.9534510
C3	36346188	36346629	BolC3t17965H	0	+	219	441	441	1.0000000
C3	36347402	36347855	BolC3t17966H	0	+	133	419	453	0.9249448
C3	36349583	36350250	BolC3t17967H	0	+	0	0	667	0.0000000
C3	36359440	36362528	BolC3t17968H	0	-	1506	2969	3088	0.9614637
C3	36364016	36366995	BolC3t17969H	0	-	733	1420	2979	0.4766700
C3	36386265	36387243	BolC3t17970H	0	+	0	0	978	0.0000000
C3	36389449	36390841	BolC3t17971H	0	+	1567	1392	1392	1.0000000
C3	36392637	36394430	BolC3t17972H	0	-	1265	1793	1793	1.0000000
C3	36405330	36406687	BolC3t17973H	0	+	1455	1357	1357	1.0000000
C3	36407077	36410460	BolC3t17974H	0	-	2393	3346	3383	0.9890630
C3	36421332	36421631	BolC3t17975H	0	+	0	0	299	0.0000000
C3	36424936	36431706	BolC3t17976H	0	+	632	2639	6770	0.3898080
C3	36437009	36438185	BolC3t17977H	0	-	1499	1176	1176	1.0000000
C3	36438922	36439966	BolC3t17978H	0	-	3905	1044	1044	1.0000000
C3	36454782	36469638	BolC3t17979H	0	+	7028	13352	14856	0.8987615
C3	36470014	36471604	BolC3t17980H	0	-	437	1562	1590	0.9823899
C3	36482587	36482899	BolC3t17981H	0	-	307	312	312	1.0000000
C3	36483012	36485226	BolC3t17982H	0	-	1361	2214	2214	1.0000000
C3	36490797	36491031	BolC3t17983H	0	-	259	234	234	1.0000000
C3	36509308	36510103	BolC3t17984H	0	+	916	795	795	1.0000000
C3	36510394	36510699	BolC3t17985H	0	+	388	305	305	1.0000000
C3	36510791	36510908	BolC3t17986H	0	+	318	117	117	1.0000000
C3	36513128	36516448	BolC3t17987H	0	-	525	3117	3320	0.9388554
C3	36519152	36522107	BolC3t17988H	0	+	1379	2949	2955	0.9979696
C3	36526347	36529071	BolC3t17989H	0	+	4307	2676	2724	0.9823788
C3	36530861	36532672	BolC3t17990H	0	-	959	1642	1811	0.9066814
C3	36540023	36540621	BolC3t17991H	0	-	189	598	598	1.0000000
C3	36559277	36560300	BolC3t17992H	0	+	483	929	1023	0.9081134
C3	36564588	36565630	BolC3t17993H	0	+	367	798	1042	0.7658349
C3	36569889	36571066	BolC3t17994H	0	-	961	1177	1177	1.0000000
C3	36576584	36578617	BolC3t17995H	0	+	2739	2000	2033	0.9837678
C3	36611250	36613317	BolC3t17996H	0	-	337	1965	2067	0.9506531
C3	36622146	36626145	BolC3t17997H	0	-	325	2170	3999	0.5426357
C3	36627098	36627395	BolC3t17998H	0	-	153	297	297	1.0000000
C3	36631280	36632185	BolC3t17999H	0	-	605	905	905	1.0000000
C3	36633719	36635112	BolC3t18000H	0	+	1246	1393	1393	1.0000000
C3	36638873	36640713	BolC3t18001H	0	-	1893	1840	1840	1.0000000
C3	36656462	36657906	BolC3t18002H	0	-	1439	1444	1444	1.0000000
C3	36664433	36664760	BolC3t18003H	0	-	112	285	327	0.8715596
C3	36675853	36676185	BolC3t18004H	0	-	0	0	332	0.0000000
C3	36690798	36694985	BolC3t18005H	0	-	1337	4092	4187	0.9773107
C3	36706010	36706880	BolC3t18006H	0	-	595	870	870	1.0000000
C3	36709252	36711530	BolC3t18007H	0	-	1730	2278	2278	1.0000000
C3	36729836	36729959	BolC3t18008H	0	+	234	123	123	1.0000000
C3	36739196	36741720	BolC3t18009H	0	+	10	532	2524	0.2107766
C3	36750083	36750800	BolC3t18010H	0	-	18	144	717	0.2008368
C3	36779187	36779935	BolC3t18011H	0	+	262	748	748	1.0000000
C3	36784338	36785704	BolC3t18012H	0	+	587	1366	1366	1.0000000
C3	36786603	36786945	BolC3t18013H	0	-	136	342	342	1.0000000
C3	36797773	36798394	BolC3t18014H	0	-	437	621	621	1.0000000
C3	36800990	36803991	BolC3t18015H	0	+	857	2044	3001	0.6811063
C3	36814563	36814911	BolC3t18016H	0	-	285	348	348	1.0000000
C3	36829024	36830100	BolC3t18017H	0	+	423	1076	1076	1.0000000
C3	36838432	36839056	BolC3t18018H	0	-	425	624	624	1.0000000
C3	36843566	36844525	BolC3t18019H	0	-	92	648	959	0.6757039
C3	36856809	36859241	BolC3t18020H	0	-	1280	2432	2432	1.0000000
C3	36860427	36864506	BolC3t18021H	0	-	455	2329	4079	0.5709733
C3	36870182	36871664	BolC3t18022H	0	+	842	1482	1482	1.0000000
C3	36872399	36872885	BolC3t18023H	0	+	249	486	486	1.0000000
C3	36882101	36883273	BolC3t18024H	0	+	757	1172	1172	1.0000000
C3	36889194	36889998	BolC3t18025H	0	+	334	728	804	0.9054726
C3	36898030	36898867	BolC3t18026H	0	+	855	837	837	1.0000000
C3	36899393	36900011	BolC3t18027H	0	-	269	618	618	1.0000000
C3	36905907	36906039	BolC3t18028H	0	-	19	132	132	1.0000000
C3	36908149	36908446	BolC3t18029H	0	+	48	297	297	1.0000000
C3	36910017	36910602	BolC3t18030H	0	+	83	523	585	0.8940171
C3	36914284	36915096	BolC3t18031H	0	-	15	160	812	0.1970443
C3	36915541	36917804	BolC3t18032H	0	+	614	2063	2263	0.9116217
C3	36924475	36924691	BolC3t18033H	0	-	159	216	216	1.0000000
C3	36943492	36947044	BolC3t18034H	0	+	2442	3552	3552	1.0000000
C3	36959300	36960730	BolC3t18035H	0	-	828	1430	1430	1.0000000
C3	36972587	36974927	BolC3t18036H	0	+	394	2000	2340	0.8547009
C3	36975430	36983068	BolC3t18037H	0	-	2662	6302	7638	0.8250851
C3	37003719	37005184	BolC3t18038H	0	+	201	464	1465	0.3167236
C3	37007402	37007823	BolC3t18039H	0	-	2	72	421	0.1710214
C3	37012139	37013222	BolC3t18040H	0	-	138	1056	1083	0.9750692
C3	37017259	37017541	BolC3t18041H	0	+	136	282	282	1.0000000
C3	37044155	37054831	BolC3t18042H	0	-	1078	5020	10676	0.4702136
C3	37070024	37072454	BolC3t18043H	0	-	374	1662	2430	0.6839506
C3	37090509	37092102	BolC3t18044H	0	+	617	1453	1593	0.9121155
C3	37104551	37119765	BolC3t18045H	0	+	3267	9318	15214	0.6124622
C3	37138891	37139107	BolC3t18046H	0	-	83	216	216	1.0000000
C3	37146014	37146787	BolC3t18047H	0	-	79	773	773	1.0000000
C3	37151248	37154228	BolC3t18048H	0	-	46	1483	2980	0.4976510
C3	37155559	37156368	BolC3t18049H	0	+	116	796	809	0.9839308
C3	37163224	37176201	BolC3t18050H	0	+	5915	7524	12977	0.5797950
C3	37186607	37186799	BolC3t18051H	0	+	310	192	192	1.0000000
C3	37187566	37194619	BolC3t18052H	0	-	1508	5343	7053	0.7575500
C3	37196567	37198076	BolC3t18053H	0	+	659	1503	1509	0.9960238
C3	37199575	37201047	BolC3t18054H	0	+	629	1388	1472	0.9429348
C3	37201547	37203944	BolC3t18055H	0	-	0	0	2397	0.0000000
C3	37209491	37209719	BolC3t18056H	0	-	1	128	228	0.5614035
C3	37220721	37221731	BolC3t18057H	0	+	62	657	1010	0.6504951
C3	37222574	37222988	BolC3t18058H	0	+	307	414	414	1.0000000
C3	37224685	37225477	BolC3t18059H	0	+	630	792	792	1.0000000
C3	37226815	37227589	BolC3t18060H	0	+	33	403	774	0.5206718
C3	37258355	37259231	BolC3t18061H	0	+	1032	876	876	1.0000000
C3	37262156	37263724	BolC3t18062H	0	-	1746	1568	1568	1.0000000
C3	37284379	37298468	BolC3t18063H	0	-	9628	14089	14089	1.0000000
C3	37329721	37330652	BolC3t18064H	0	+	0	0	931	0.0000000
C3	37333201	37336080	BolC3t18065H	0	-	663	2575	2879	0.8944078
C3	37337203	37337653	BolC3t18066H	0	+	431	450	450	1.0000000
C3	37345081	37350007	BolC3t18067H	0	+	2630	4926	4926	1.0000000
C3	37397100	37397856	BolC3t18068H	0	-	423	756	756	1.0000000
C3	37398652	37401006	BolC3t18069H	0	-	572	2297	2354	0.9757859
C3	37416240	37418703	BolC3t18070H	0	+	1037	2244	2463	0.9110841
C3	37422333	37424976	BolC3t18071H	0	-	1711	2624	2643	0.9928112
C3	37429715	37431015	BolC3t18072H	0	+	581	1285	1300	0.9884616
C3	37431487	37431715	BolC3t18073H	0	+	221	228	228	1.0000000
C3	37432683	37432797	BolC3t18074H	0	+	21	102	114	0.8947368
C3	37434322	37434634	BolC3t18075H	0	+	11	312	312	1.0000000
C3	37436657	37437623	BolC3t18076H	0	-	42	825	966	0.8540373
C3	37438771	37440453	BolC3t18077H	0	+	1188	1682	1682	1.0000000
C3	37447246	37450711	BolC3t18078H	0	-	1643	3309	3465	0.9549783
C3	37467983	37470856	BolC3t18079H	0	-	2191	2873	2873	1.0000000
C3	37475043	37476179	BolC3t18080H	0	+	1616	1136	1136	1.0000000
C3	37484047	37485163	BolC3t18081H	0	+	325	1116	1116	1.0000000
C3	37487911	37490064	BolC3t18082H	0	+	1029	2001	2153	0.9294009
C3	37491595	37493865	BolC3t18083H	0	+	893	1922	2270	0.8466960
C3	37496287	37496575	BolC3t18084H	0	-	215	288	288	1.0000000
C3	37513709	37514945	BolC3t18085H	0	+	852	1236	1236	1.0000000
C3	37520415	37521105	BolC3t18086H	0	+	543	690	690	1.0000000
C3	37527502	37529863	BolC3t18087H	0	-	2338	2361	2361	1.0000000
C3	37530989	37531428	BolC3t18088H	0	-	402	439	439	1.0000000
C3	37539611	37541440	BolC3t18089H	0	+	1	141	1829	0.0770913
C3	37541865	37542682	BolC3t18090H	0	+	89	616	817	0.7539780
C3	37563202	37563904	BolC3t18091H	0	+	473	702	702	1.0000000
C3	37566965	37567427	BolC3t18092H	0	+	286	462	462	1.0000000
C3	37583913	37584278	BolC3t18093H	0	-	324	365	365	1.0000000
C3	37591059	37591344	BolC3t18094H	0	+	16	196	285	0.6877193
C3	37591711	37592671	BolC3t18095H	0	+	15	344	960	0.3583333
C3	37600727	37605989	BolC3t18096H	0	-	4283	5262	5262	1.0000000
C3	37619495	37621549	BolC3t18097H	0	+	979	2044	2054	0.9951314
C3	37622774	37623079	BolC3t18098H	0	-	74	305	305	1.0000000
C3	37632830	37634578	BolC3t18099H	0	+	289	1447	1748	0.8278032
C3	37634988	37635778	BolC3t18100H	0	-	331	790	790	1.0000000
C3	37638846	37639410	BolC3t18101H	0	-	3	17	564	0.0301418
C3	37688119	37688275	BolC3t18102H	0	-	3	156	156	1.0000000
C3	37697127	37700567	BolC3t18103H	0	+	1555	3396	3440	0.9872093
C3	37716345	37716915	BolC3t18104H	0	+	470	570	570	1.0000000
C3	37722374	37722871	BolC3t18105H	0	+	343	497	497	1.0000000
C3	37743130	37743934	BolC3t18106H	0	-	439	750	804	0.9328358
C3	37760035	37762126	BolC3t18107H	0	-	0	0	2091	0.0000000
C3	37764924	37765385	BolC3t18108H	0	-	2	19	461	0.0412147
C3	37773255	37773710	BolC3t18109H	0	+	0	0	455	0.0000000
C3	37804232	37804580	BolC3t18110H	0	+	1014	348	348	1.0000000
C3	37807479	37810367	BolC3t18111H	0	+	1592	2837	2888	0.9823407
C3	37810868	37811234	BolC3t18112H	0	+	23	341	366	0.9316940
C3	37812051	37815198	BolC3t18113H	0	+	901	3137	3147	0.9968224
C3	37834830	37835511	BolC3t18114H	0	+	234	337	681	0.4948605
C3	37860467	37862387	BolC3t18115H	0	+	895	1879	1920	0.9786459
C3	37862901	37864918	BolC3t18116H	0	+	1182	2017	2017	1.0000000
C3	37865442	37865701	BolC3t18117H	0	+	229	259	259	1.0000000
C3	37878446	37880478	BolC3t18118H	0	-	669	1987	2032	0.9778543
C3	37883533	37883743	BolC3t18119H	0	+	107	210	210	1.0000000
C3	37891985	37893188	BolC3t18120H	0	-	602	1203	1203	1.0000000
C3	37894253	37895044	BolC3t18121H	0	-	129	462	791	0.5840708
C3	37895879	37899112	BolC3t18122H	0	-	1636	3233	3233	1.0000000
C3	37911665	37912741	BolC3t18123H	0	+	217	1003	1076	0.9321561
C3	37917555	37919986	BolC3t18124H	0	+	159	1328	2431	0.5462772
C3	37924349	37925099	BolC3t18125H	0	+	212	716	750	0.9546667
C3	37927459	37929072	BolC3t18126H	0	+	338	1471	1613	0.9119653
C3	37936690	37947014	BolC3t18127H	0	-	5949	10172	10324	0.9852770
C3	37942824	37943762	BolC3t18128H	0	+	596	907	938	0.9669510
C3	37947686	37949080	BolC3t18129H	0	+	741	1394	1394	1.0000000
C3	37952758	37953040	BolC3t18130H	0	-	9	133	282	0.4716312
C3	37958138	37960979	BolC3t18131H	0	+	2050	2826	2841	0.9947202
C3	37963214	37970804	BolC3t18132H	0	-	3020	4311	7590	0.5679842
C3	37983188	37984541	BolC3t18133H	0	+	795	1353	1353	1.0000000
C3	37986352	37988196	BolC3t18134H	0	-	548	1674	1844	0.9078091
C3	38002174	38003023	BolC3t18135H	0	+	210	781	849	0.9199058
C3	38003210	38004002	BolC3t18136H	0	-	583	718	792	0.9065657
C3	38006704	38006997	BolC3t18137H	0	+	10	229	293	0.7815700
C3	38006996	38010145	BolC3t18138H	0	+	318	978	3149	0.3105748
C3	38013939	38014595	BolC3t18139H	0	+	55	398	656	0.6067073
C3	38016636	38017125	BolC3t18140H	0	-	300	489	489	1.0000000
C3	38034759	38035614	BolC3t18141H	0	-	130	828	855	0.9684210
C3	38036832	38040000	BolC3t18142H	0	-	515	2815	3168	0.8885732
C3	38041232	38057264	BolC3t18143H	0	-	2238	9139	16032	0.5700474
C3	38061277	38062922	BolC3t18144H	0	-	42	728	1645	0.4425532
C3	38092364	38092649	BolC3t18145H	0	+	749	285	285	1.0000000
C3	38104806	38105689	BolC3t18146H	0	-	849	883	883	1.0000000
C3	38108896	38110267	BolC3t18147H	0	+	301	1291	1371	0.9416484
C3	38121182	38121846	BolC3t18148H	0	+	16	378	664	0.5692771
C3	38122900	38123404	BolC3t18149H	0	-	0	0	504	0.0000000
C3	38123800	38124653	BolC3t18150H	0	+	183	846	853	0.9917937
C3	38128480	38129342	BolC3t18151H	0	+	575	862	862	1.0000000
C3	38158878	38159443	BolC3t18152H	0	-	323	481	565	0.8513274
C3	38173058	38174012	BolC3t18153H	0	+	86	928	954	0.9727463
C3	38180688	38181252	BolC3t18154H	0	+	127	564	564	1.0000000
C3	38184867	38185401	BolC3t18155H	0	-	666	534	534	1.0000000
C3	38185393	38185652	BolC3t18156H	0	+	165	259	259	1.0000000
C3	38187668	38190225	BolC3t18157H	0	-	532	1414	2557	0.5529918
C3	38198217	38198913	BolC3t18158H	0	+	88	419	696	0.6020115
C3	38210926	38211598	BolC3t18159H	0	+	320	672	672	1.0000000
C3	38237721	38238234	BolC3t18160H	0	-	9	208	513	0.4054581
C3	38238390	38238516	BolC3t18161H	0	-	26	126	126	1.0000000
C3	38265909	38267439	BolC3t18162H	0	-	330	1416	1530	0.9254902
C3	38271675	38272007	BolC3t18163H	0	-	142	269	332	0.8102410
C3	38301567	38302635	BolC3t18164H	0	+	708	1068	1068	1.0000000
C3	38320697	38321575	BolC3t18165H	0	-	681	849	878	0.9669704
C3	38324338	38325800	BolC3t18166H	0	+	600	1367	1462	0.9350205
C3	38326550	38327411	BolC3t18167H	0	+	252	822	861	0.9547038
C3	38328334	38329887	BolC3t18168H	0	-	1358	1553	1553	1.0000000
C3	38347976	38349425	BolC3t18169H	0	-	235	1361	1449	0.9392685
C3	38358907	38359228	BolC3t18170H	0	-	289	321	321	1.0000000
C3	38365409	38367223	BolC3t18171H	0	+	292	1511	1814	0.8329659
C3	38375570	38375912	BolC3t18172H	0	-	409	342	342	1.0000000
C3	38385262	38385517	BolC3t18173H	0	+	53	248	255	0.9725490
C3	38387160	38387525	BolC3t18174H	0	+	22	179	365	0.4904110
C3	38396463	38399129	BolC3t18175H	0	+	2062	2666	2666	1.0000000
C3	38399716	38402814	BolC3t18176H	0	-	1216	2859	3098	0.9228535
C3	38405277	38406275	BolC3t18177H	0	+	492	994	998	0.9959920
C3	38406641	38406950	BolC3t18178H	0	-	319	309	309	1.0000000
C3	38407403	38407592	BolC3t18179H	0	+	195	189	189	1.0000000
C3	38411035	38411335	BolC3t18180H	0	-	90	300	300	1.0000000
C3	38412474	38420464	BolC3t18181H	0	-	3740	7757	7990	0.9708385
C3	38420708	38422211	BolC3t18182H	0	+	270	1162	1503	0.7731204
C3	38434297	38435059	BolC3t18183H	0	+	92	762	762	1.0000000
C3	38439485	38441203	BolC3t18184H	0	+	18	653	1718	0.3800931
C3	38443715	38445573	BolC3t18185H	0	+	541	1250	1858	0.6727664
C3	38447769	38450091	BolC3t18186H	0	+	149	1448	2322	0.6236004
C3	38469849	38470056	BolC3t18187H	0	+	244	207	207	1.0000000
C3	38475612	38476551	BolC3t18188H	0	+	422	939	939	1.0000000
C3	38477646	38477922	BolC3t18189H	0	+	210	276	276	1.0000000
C3	38478901	38481420	BolC3t18190H	0	-	885	1954	2519	0.7757046
C3	38524750	38533328	BolC3t18191H	0	+	1845	5026	8578	0.5859175
C3	38534899	38536264	BolC3t18192H	0	-	271	1235	1365	0.9047619
C3	38543756	38544146	BolC3t18193H	0	-	7	246	390	0.6307693
C3	38554204	38554402	BolC3t18194H	0	+	3	43	198	0.2171717
C3	38577221	38577424	BolC3t18195H	0	-	102	203	203	1.0000000
C3	38577331	38577943	BolC3t18196H	0	-	287	612	612	1.0000000
C3	38578190	38580349	BolC3t18197H	0	-	642	2051	2159	0.9499769
C3	38582216	38583194	BolC3t18198H	0	+	592	978	978	1.0000000
C3	38586720	38587911	BolC3t18199H	0	+	871	1191	1191	1.0000000
C3	38589339	38592123	BolC3t18200H	0	+	1667	2784	2784	1.0000000
C3	38595208	38596605	BolC3t18201H	0	+	424	1300	1397	0.9305655
C3	38598988	38599751	BolC3t18202H	0	-	549	763	763	1.0000000
C3	38600248	38602705	BolC3t18203H	0	-	539	2303	2457	0.9373220
C3	38608254	38614779	BolC3t18204H	0	+	1748	5338	6525	0.8180843
C3	38615882	38616347	BolC3t18205H	0	-	25	148	465	0.3182796
C3	38617232	38617697	BolC3t18206H	0	-	322	448	465	0.9634408
C3	38625359	38628898	BolC3t18207H	0	+	1057	3038	3539	0.8584346
C3	38630725	38632942	BolC3t18208H	0	-	685	1401	2217	0.6319351
C3	38692129	38699273	BolC3t18209H	0	+	2795	6893	7144	0.9648656
C3	38700579	38700828	BolC3t18210H	0	+	165	249	249	1.0000000
C3	38705704	38705860	BolC3t18211H	0	-	139	156	156	1.0000000
C3	38711124	38711415	BolC3t18212H	0	-	381	291	291	1.0000000
C3	38713377	38718875	BolC3t18213H	0	+	2013	5054	5498	0.9192433
C3	38724741	38725467	BolC3t18214H	0	-	220	715	726	0.9848485
C3	38726646	38727102	BolC3t18215H	0	+	13	146	456	0.3201754
C3	38728043	38728151	BolC3t18216H	0	-	29	108	108	1.0000000
C3	38732229	38735636	BolC3t18217H	0	+	913	2890	3407	0.8482536
C3	38736615	38738016	BolC3t18218H	0	-	229	1232	1401	0.8793719
C3	38739842	38740172	BolC3t18219H	0	-	324	330	330	1.0000000
C3	38740505	38742064	BolC3t18220H	0	+	1130	1520	1559	0.9749840
C3	38742827	38744103	BolC3t18221H	0	+	797	1248	1276	0.9780564
C3	38744555	38747246	BolC3t18222H	0	+	884	2657	2691	0.9873653
C3	38750876	38752516	BolC3t18223H	0	-	793	1594	1640	0.9719512
C3	38754070	38755486	BolC3t18224H	0	+	702	1416	1416	1.0000000
C3	38759260	38760663	BolC3t18225H	0	-	1044	1189	1403	0.8474697
C3	38761912	38763070	BolC3t18226H	0	+	887	1158	1158	1.0000000
C3	38763497	38763948	BolC3t18227H	0	-	74	381	451	0.8447894
C3	38764795	38767188	BolC3t18228H	0	-	1037	2301	2393	0.9615545
C3	38768648	38769562	BolC3t18229H	0	-	129	885	914	0.9682713
C3	38770659	38772241	BolC3t18230H	0	-	226	1257	1582	0.7945638
C3	38773012	38774842	BolC3t18231H	0	+	1415	1830	1830	1.0000000
C3	38775687	38777964	BolC3t18232H	0	-	1265	2277	2277	1.0000000
C3	38781504	38783355	BolC3t18233H	0	-	1412	1851	1851	1.0000000
C3	38786305	38792115	BolC3t18234H	0	+	2492	5784	5810	0.9955249
C3	38803967	38805330	BolC3t18235H	0	+	514	1363	1363	1.0000000
C3	38805695	38808359	BolC3t18236H	0	-	1279	2635	2664	0.9891141
C3	38810043	38810199	BolC3t18237H	0	-	124	156	156	1.0000000
C3	38817749	38819628	BolC3t18238H	0	-	527	1514	1879	0.8057477
C3	38829147	38829612	BolC3t18239H	0	-	14	299	465	0.6430107
C3	38834294	38834758	BolC3t18240H	0	-	92	387	464	0.8340517
C3	38835936	38836398	BolC3t18241H	0	-	26	394	462	0.8528138
C3	38851616	38853258	BolC3t18242H	0	+	85	798	1642	0.4859927
C3	38853374	38853539	BolC3t18243H	0	+	4	110	165	0.6666667
C3	38863213	38863720	BolC3t18244H	0	+	304	507	507	1.0000000
C3	38870233	38870554	BolC3t18245H	0	+	152	321	321	1.0000000
C3	38874308	38875958	BolC3t18246H	0	-	399	1584	1650	0.9600000
C3	38878229	38879264	BolC3t18247H	0	+	390	890	1035	0.8599034
C3	38882267	38884157	BolC3t18248H	0	+	630	1858	1890	0.9830688
C3	38884841	38886110	BolC3t18249H	0	+	48	826	1269	0.6509062
C3	38890007	38891048	BolC3t18250H	0	+	0	0	1041	0.0000000
C3	38902777	38904400	BolC3t18251H	0	+	130	1265	1623	0.7794209
C3	38920618	38921575	BolC3t18252H	0	-	107	716	957	0.7481714
C3	38929392	38930750	BolC3t18253H	0	-	35	413	1358	0.3041237
C3	38947603	38951608	BolC3t18254H	0	-	2305	4005	4005	1.0000000
C3	38952344	38955052	BolC3t18255H	0	-	1920	2708	2708	1.0000000
C3	38956413	38960009	BolC3t18256H	0	-	512	3197	3596	0.8890434
C3	38960688	38962375	BolC3t18257H	0	+	1027	1683	1687	0.9976289
C3	38963457	38964671	BolC3t18258H	0	-	208	1127	1214	0.9283361
C3	38969404	38969822	BolC3t18259H	0	-	518	418	418	1.0000000
C3	38981151	38984227	BolC3t18260H	0	-	261	1811	3076	0.5887516
C3	38995340	38999112	BolC3t18261H	0	+	3910	3772	3772	1.0000000
C3	39010656	39011641	BolC3t18262H	0	+	835	985	985	1.0000000
C3	39026317	39026968	BolC3t18263H	0	+	932	651	651	1.0000000
C3	39032137	39034667	BolC3t18264H	0	+	2164	2530	2530	1.0000000
C3	39035428	39038228	BolC3t18265H	0	-	394	2657	2800	0.9489286
C3	39056915	39059144	BolC3t18266H	0	-	222	1968	2229	0.8829072
C3	39062459	39063425	BolC3t18267H	0	+	123	760	966	0.7867495
C3	39063640	39063793	BolC3t18268H	0	+	2	104	153	0.6797386
C3	39082268	39082796	BolC3t18269H	0	+	135	528	528	1.0000000
C3	39084806	39085269	BolC3t18270H	0	-	78	358	463	0.7732182
C3	39086589	39088617	BolC3t18271H	0	+	168	1494	2028	0.7366864
C3	39089498	39090942	BolC3t18272H	0	-	1048	1444	1444	1.0000000
C3	39115515	39116175	BolC3t18273H	0	+	158	660	660	1.0000000
C3	39130334	39132052	BolC3t18274H	0	-	42	1086	1718	0.6321304
C3	39178951	39180427	BolC3t18275H	0	+	129	705	1476	0.4776423
C3	39225104	39226889	BolC3t18276H	0	+	754	1649	1785	0.9238095
C3	39227262	39231236	BolC3t18277H	0	-	1280	3200	3974	0.8052340
C3	39232254	39232602	BolC3t18278H	0	+	138	348	348	1.0000000
C3	39233353	39233744	BolC3t18279H	0	+	234	391	391	1.0000000
C3	39235362	39237354	BolC3t18280H	0	+	465	1823	1992	0.9151607
C3	39241778	39242699	BolC3t18281H	0	+	70	778	921	0.8447340
C3	39248765	39250916	BolC3t18282H	0	-	370	1660	2151	0.7717341
C3	39251173	39253894	BolC3t18283H	0	+	1159	2721	2721	1.0000000
C3	39254082	39255553	BolC3t18284H	0	-	806	1471	1471	1.0000000
C3	39272763	39273568	BolC3t18285H	0	+	387	805	805	1.0000000
C3	39273564	39274200	BolC3t18286H	0	-	133	636	636	1.0000000
C3	39274295	39275572	BolC3t18287H	0	-	683	1277	1277	1.0000000
C3	39282034	39282599	BolC3t18288H	0	-	188	565	565	1.0000000
C3	39283510	39287146	BolC3t18289H	0	-	1562	3636	3636	1.0000000
C3	39290305	39290623	BolC3t18290H	0	-	106	318	318	1.0000000
C3	39292477	39292609	BolC3t18291H	0	+	297	132	132	1.0000000
C3	39296207	39297401	BolC3t18292H	0	+	267	732	1194	0.6130653
C3	39298247	39300801	BolC3t18293H	0	+	25	208	2554	0.0814409
C3	39302454	39302811	BolC3t18294H	0	-	27	128	357	0.3585434
C3	39304951	39305521	BolC3t18295H	0	-	0	0	570	0.0000000
C3	39311503	39314062	BolC3t18296H	0	+	0	0	2559	0.0000000
C3	39315707	39315932	BolC3t18297H	0	+	0	0	225	0.0000000
C3	39316127	39316352	BolC3t18298H	0	-	3	25	225	0.1111111
C3	39317981	39319428	BolC3t18299H	0	-	0	0	1447	0.0000000
C3	39321196	39321796	BolC3t18300H	0	-	0	0	600	0.0000000
C3	39332214	39332597	BolC3t18301H	0	+	559	383	383	1.0000000
C3	39332781	39334101	BolC3t18302H	0	+	1053	1298	1320	0.9833333
C3	39340080	39340983	BolC3t18303H	0	-	452	881	903	0.9756368
C3	39341038	39341857	BolC3t18304H	0	+	297	819	819	1.0000000
C3	39342076	39344525	BolC3t18305H	0	-	1835	2447	2449	0.9991834
C3	39347126	39349352	BolC3t18306H	0	+	1020	2212	2226	0.9937107
C3	39349850	39352946	BolC3t18307H	0	-	2342	3096	3096	1.0000000
C3	39363012	39364217	BolC3t18308H	0	-	2	101	1205	0.0838174
C3	39366123	39369078	BolC3t18309H	0	+	481	2700	2955	0.9137056
C3	39369258	39369546	BolC3t18310H	0	-	22	227	288	0.7881944
C3	39379359	39381036	BolC3t18311H	0	+	109	1010	1677	0.6022660
C3	39390978	39393162	BolC3t18312H	0	+	769	2141	2184	0.9803113
C3	39393745	39394344	BolC3t18313H	0	-	164	523	599	0.8731219
C3	39400829	39403584	BolC3t18314H	0	-	875	2346	2755	0.8515427
C3	39412691	39413698	BolC3t18315H	0	-	767	1007	1007	1.0000000
C3	39414058	39414478	BolC3t18316H	0	-	347	420	420	1.0000000
C3	39416519	39422706	BolC3t18317H	0	+	3700	5676	6187	0.9174075
C3	39423080	39426352	BolC3t18318H	0	-	871	2345	3272	0.7166870
C3	39427158	39431967	BolC3t18319H	0	-	1329	4350	4809	0.9045539
C3	39433958	39435562	BolC3t18320H	0	+	706	1595	1604	0.9943891
C3	39437956	39440027	BolC3t18321H	0	+	759	2071	2071	1.0000000
C3	39443553	39444326	BolC3t18322H	0	-	1088	773	773	1.0000000
C3	39448629	39449496	BolC3t18323H	0	-	113	700	867	0.8073817
C3	39457321	39459099	BolC3t18324H	0	+	46	893	1778	0.5022497
C3	39459512	39459715	BolC3t18325H	0	+	19	203	203	1.0000000
C3	39479159	39479429	BolC3t18326H	0	+	51	224	270	0.8296296
C3	39487486	39488765	BolC3t18327H	0	-	305	774	1279	0.6051603
C3	39502977	39505963	BolC3t18328H	0	+	474	1754	2986	0.5874079
C3	39519188	39561662	BolC3t18329H	0	+	17382	29930	42474	0.7046664
C3	39557672	39558502	BolC3t18330H	0	-	26	419	830	0.5048193
C3	39569382	39569508	BolC3t18331H	0	+	203	126	126	1.0000000
C3	39575859	39575988	BolC3t18332H	0	+	148	129	129	1.0000000
C3	39596804	39597263	BolC3t18333H	0	+	219	459	459	1.0000000
C3	39606846	39607008	BolC3t18334H	0	+	67	162	162	1.0000000
C3	39611259	39611571	BolC3t18335H	0	+	50	278	312	0.8910257
C3	39620585	39622047	BolC3t18336H	0	+	291	1338	1462	0.9151847
C3	39672631	39673048	BolC3t18337H	0	+	211	417	417	1.0000000
C3	39673613	39677785	BolC3t18338H	0	-	2594	4130	4172	0.9899329
C3	39682263	39692034	BolC3t18339H	0	+	3300	8744	9771	0.8948931
C3	39686639	39687491	BolC3t18340H	0	-	373	852	852	1.0000000
C3	39693108	39696386	BolC3t18341H	0	+	877	3051	3278	0.9307504
C3	39696664	39697751	BolC3t18342H	0	-	425	1076	1087	0.9898804
C3	39707043	39707938	BolC3t18343H	0	-	775	895	895	1.0000000
C3	39720049	39721464	BolC3t18344H	0	-	48	696	1415	0.4918728
C3	39722089	39723967	BolC3t18345H	0	-	602	1708	1878	0.9094782
C3	39734804	39736159	BolC3t18346H	0	+	811	1355	1355	1.0000000
C3	39746747	39746927	BolC3t18347H	0	-	1	32	180	0.1777778
C3	39758772	39758991	BolC3t18348H	0	+	23	194	219	0.8858448
C3	39759353	39760359	BolC3t18349H	0	+	207	1006	1006	1.0000000
C3	39760743	39761653	BolC3t18350H	0	+	34	767	910	0.8428571
C3	39775370	39776444	BolC3t18351H	0	-	103	991	1074	0.9227188
C3	39816713	39816989	BolC3t18352H	0	-	262	276	276	1.0000000
C3	39817539	39818173	BolC3t18353H	0	+	441	634	634	1.0000000
C3	39836143	39836437	BolC3t18354H	0	-	0	0	294	0.0000000
C3	39842086	39844309	BolC3t18355H	0	+	472	2040	2223	0.9176788
C3	39845692	39854788	BolC3t18356H	0	+	2898	7356	9096	0.8087071
C3	39872326	39872626	BolC3t18357H	0	-	128	300	300	1.0000000
C3	39872746	39874714	BolC3t18358H	0	-	1193	1968	1968	1.0000000
C3	39874766	39875117	BolC3t18359H	0	-	327	351	351	1.0000000
C3	39878453	39880870	BolC3t18360H	0	+	270	1682	2417	0.6959040
C3	39889399	39890248	BolC3t18361H	0	-	472	849	849	1.0000000
C3	39908072	39908288	BolC3t18362H	0	-	41	216	216	1.0000000
C3	39926599	39927853	BolC3t18363H	0	-	134	1069	1254	0.8524721
C3	39928611	39931367	BolC3t18364H	0	+	629	2607	2756	0.9459361
C3	39947391	39948852	BolC3t18365H	0	+	303	1283	1461	0.8781657
C3	39949021	39951671	BolC3t18366H	0	-	618	2448	2650	0.9237736
C3	39952436	39954754	BolC3t18367H	0	+	984	2311	2318	0.9969801
C3	39955644	39965726	BolC3t18368H	0	-	6764	10048	10082	0.9966276
C3	39957862	39958442	BolC3t18369H	0	-	400	580	580	1.0000000
C3	39969332	40006880	BolC3t18370H	0	-	12528	28465	37548	0.7580963
C3	39971219	39971725	BolC3t18371H	0	+	323	506	506	1.0000000
C3	40014799	40014955	BolC3t18372H	0	+	313	156	156	1.0000000
C3	40017336	40019919	BolC3t18373H	0	-	922	2324	2583	0.8997290
C3	40020005	40020956	BolC3t18374H	0	+	105	935	951	0.9831756
C3	40021261	40022352	BolC3t18375H	0	+	120	872	1091	0.7992668
C3	40032428	40033028	BolC3t18376H	0	+	234	600	600	1.0000000
C3	40033150	40034950	BolC3t18377H	0	-	725	1653	1800	0.9183334
C3	40039862	40042564	BolC3t18378H	0	-	768	2544	2702	0.9415248
C3	40043350	40044958	BolC3t18379H	0	+	880	1602	1608	0.9962686
C3	40050113	40050227	BolC3t18380H	0	-	69	114	114	1.0000000
C3	40061119	40062675	BolC3t18381H	0	+	513	1498	1556	0.9627249
C3	40071706	40076160	BolC3t18382H	0	-	3261	4419	4454	0.9921419
C3	40076957	40077149	BolC3t18383H	0	-	238	192	192	1.0000000
C3	40077995	40078235	BolC3t18384H	0	+	72	206	240	0.8583333
C3	40091825	40096277	BolC3t18385H	0	-	2559	4175	4452	0.9377808
C3	40099022	40102961	BolC3t18386H	0	-	1764	3876	3939	0.9840061
C3	40118380	40120675	BolC3t18387H	0	+	1104	1801	2295	0.7847494
C3	40121427	40121700	BolC3t18388H	0	-	241	273	273	1.0000000
C3	40137362	40138038	BolC3t18389H	0	-	468	676	676	1.0000000
C3	40144941	40146408	BolC3t18390H	0	-	1195	1467	1467	1.0000000
C3	40147609	40149248	BolC3t18391H	0	+	168	1241	1639	0.7571690
C3	40152070	40153214	BolC3t18392H	0	-	489	1125	1144	0.9833916
C3	40167142	40168598	BolC3t18393H	0	+	1100	1456	1456	1.0000000
C3	40168987	40169498	BolC3t18394H	0	+	548	511	511	1.0000000
C3	40169634	40170018	BolC3t18395H	0	-	61	359	384	0.9348958
C3	40170864	40172876	BolC3t18396H	0	-	898	1908	2012	0.9483101
C3	40176523	40177736	BolC3t18397H	0	-	126	1019	1213	0.8400660
C3	40187879	40188200	BolC3t18398H	0	-	58	321	321	1.0000000
C3	40191513	40192770	BolC3t18399H	0	+	691	1257	1257	1.0000000
C3	40199166	40199439	BolC3t18400H	0	+	121	273	273	1.0000000
C3	40216271	40218636	BolC3t18401H	0	-	795	2349	2365	0.9932347
C3	40239995	40240590	BolC3t18402H	0	+	296	595	595	1.0000000
C3	40254862	40259741	BolC3t18403H	0	-	1318	4090	4879	0.8382865
C3	40287694	40289484	BolC3t18404H	0	-	653	1728	1790	0.9653631
C3	40304035	40306222	BolC3t18405H	0	+	520	1979	2187	0.9048926
C3	40306589	40306848	BolC3t18406H	0	-	265	259	259	1.0000000
C3	40309653	40309851	BolC3t18407H	0	-	65	198	198	1.0000000
C3	40309932	40310409	BolC3t18408H	0	+	329	477	477	1.0000000
C3	40314124	40314500	BolC3t18409H	0	-	296	376	376	1.0000000
C3	40314951	40316167	BolC3t18410H	0	+	295	1181	1216	0.9712171
C3	40317848	40318106	BolC3t18411H	0	-	0	0	258	0.0000000
C3	40334511	40335411	BolC3t18412H	0	+	538	825	900	0.9166667
C3	40342668	40343928	BolC3t18413H	0	+	53	607	1260	0.4817460
C3	40361171	40361342	BolC3t18414H	0	+	91	171	171	1.0000000
C3	40361703	40363398	BolC3t18415H	0	-	416	1348	1695	0.7952802
C3	40364172	40367003	BolC3t18416H	0	-	2249	2790	2831	0.9855175
C3	40367778	40368318	BolC3t18417H	0	-	158	540	540	1.0000000
C3	40382227	40382530	BolC3t18418H	0	-	0	0	303	0.0000000
C3	40383881	40384088	BolC3t18419H	0	+	2	20	207	0.0966184
C3	40415729	40415933	BolC3t18420H	0	-	112	203	204	0.9950981
C3	40422429	40423821	BolC3t18421H	0	+	15	246	1392	0.1767241
C3	40423937	40424752	BolC3t18422H	0	+	2	19	815	0.0233129
C3	40424782	40425887	BolC3t18423H	0	+	12	22	1105	0.0199095
C3	40426371	40426976	BolC3t18424H	0	-	0	0	605	0.0000000
C3	40427029	40429224	BolC3t18425H	0	-	32	375	2195	0.1708428
C3	40433014	40433454	BolC3t18426H	0	-	4	21	440	0.0477273
C3	40447431	40449800	BolC3t18427H	0	+	384	631	2369	0.2663571
C3	40463161	40463572	BolC3t18428H	0	-	124	122	411	0.2968370
C3	40471230	40475042	BolC3t18429H	0	+	1719	3645	3812	0.9561910
C3	40479304	40482363	BolC3t18430H	0	+	494	2439	3059	0.7973194
C3	40492066	40494138	BolC3t18431H	0	+	1283	2072	2072	1.0000000
C3	40503062	40504874	BolC3t18432H	0	+	408	1666	1812	0.9194260
C3	40506726	40509229	BolC3t18433H	0	+	1220	1945	2503	0.7770675
C3	40511204	40512799	BolC3t18434H	0	-	215	892	1595	0.5592477
C3	40542853	40544817	BolC3t18435H	0	-	642	1753	1964	0.8925662
C3	40545424	40548443	BolC3t18436H	0	-	1020	3002	3019	0.9943690
C3	40549136	40549727	BolC3t18437H	0	-	214	591	591	1.0000000
C3	40554147	40556617	BolC3t18438H	0	-	936	2300	2470	0.9311741
C3	40557644	40559551	BolC3t18439H	0	+	959	1756	1907	0.9208180
C3	40560140	40563192	BolC3t18440H	0	-	494	2310	3052	0.7568808
C3	40571156	40573221	BolC3t18441H	0	-	1563	2065	2065	1.0000000
C3	40579796	40579974	BolC3t18442H	0	+	377	178	178	1.0000000
C3	40580589	40584964	BolC3t18443H	0	-	1982	4236	4375	0.9682286
C3	40588190	40588961	BolC3t18444H	0	+	69	634	771	0.8223087
C3	40595992	40597450	BolC3t18445H	0	+	451	1448	1458	0.9931413
C3	40599145	40603742	BolC3t18446H	0	-	877	2978	4597	0.6478138
C3	40604465	40605190	BolC3t18447H	0	-	649	725	725	1.0000000
C3	40607220	40611207	BolC3t18448H	0	-	322	3189	3987	0.7998495
C3	40621509	40623680	BolC3t18449H	0	-	1499	2076	2171	0.9562414
C3	40623877	40625542	BolC3t18450H	0	-	361	1557	1665	0.9351351
C3	40626032	40627577	BolC3t18451H	0	+	565	1445	1545	0.9352751
C3	40627663	40630835	BolC3t18452H	0	+	866	2381	3172	0.7506305
C3	40631371	40632449	BolC3t18453H	0	+	530	1078	1078	1.0000000
C3	40634972	40636412	BolC3t18454H	0	+	368	1339	1440	0.9298611
C3	40637643	40641054	BolC3t18455H	0	-	517	2357	3411	0.6909997
C3	40643573	40643948	BolC3t18456H	0	-	162	375	375	1.0000000
C3	40649176	40651457	BolC3t18457H	0	-	682	2100	2281	0.9206488
C3	40654066	40656423	BolC3t18458H	0	+	252	2015	2357	0.8549003
C3	40656780	40660630	BolC3t18459H	0	-	933	2437	3850	0.6329870
C3	40665359	40665587	BolC3t18460H	0	-	146	228	228	1.0000000
C3	40671226	40671547	BolC3t18461H	0	+	250	321	321	1.0000000
C3	40681760	40682675	BolC3t18462H	0	-	199	915	915	1.0000000
C3	40700348	40701972	BolC3t18463H	0	+	1205	1624	1624	1.0000000
C3	40702513	40704227	BolC3t18464H	0	-	1334	1714	1714	1.0000000
C3	40705257	40708133	BolC3t18465H	0	+	294	847	2876	0.2945063
C3	40709836	40711462	BolC3t18466H	0	+	994	1626	1626	1.0000000
C3	40712255	40714164	BolC3t18467H	0	-	583	1842	1909	0.9649031
C3	40715958	40716915	BolC3t18468H	0	-	92	783	957	0.8181818
C3	40718057	40721127	BolC3t18469H	0	+	1680	3061	3070	0.9970684
C3	40721541	40722884	BolC3t18470H	0	-	751	1343	1343	1.0000000
C3	40723084	40724487	BolC3t18471H	0	+	951	1403	1403	1.0000000
C3	40724551	40725370	BolC3t18472H	0	+	405	804	819	0.9816850
C3	40727280	40728197	BolC3t18473H	0	+	1056	917	917	1.0000000
C3	40740628	40742749	BolC3t18474H	0	+	678	1498	2121	0.7062706
C3	40758412	40759951	BolC3t18475H	0	+	405	1330	1539	0.8641976
C3	40761438	40762179	BolC3t18476H	0	-	10	235	741	0.3171390
C3	40762506	40763537	BolC3t18477H	0	+	312	836	1031	0.8108633
C3	40767491	40768671	BolC3t18478H	0	+	99	762	1180	0.6457627
C3	40776180	40776336	BolC3t18479H	0	-	184	156	156	1.0000000
C3	40777407	40777776	BolC3t18480H	0	+	523	369	369	1.0000000
C3	40778298	40778750	BolC3t18481H	0	-	661	452	452	1.0000000
C3	40781814	40782940	BolC3t18482H	0	+	407	1091	1126	0.9689165
C3	40784396	40796009	BolC3t18483H	0	+	1075	5755	11613	0.4955653
C3	40798593	40799923	BolC3t18484H	0	+	258	1149	1330	0.8639098
C3	40801883	40804598	BolC3t18485H	0	+	1360	2605	2715	0.9594843
C3	40821228	40821943	BolC3t18486H	0	+	426	715	715	1.0000000
C3	40828688	40829692	BolC3t18487H	0	+	59	1004	1004	1.0000000
C3	40834346	40835331	BolC3t18488H	0	+	43	912	985	0.9258883
C3	40839483	40839639	BolC3t18489H	0	+	0	0	156	0.0000000
C3	40847228	40848244	BolC3t18490H	0	+	17	162	1016	0.1594488
C3	40854100	40854813	BolC3t18491H	0	+	327	713	713	1.0000000
C3	40855211	40858829	BolC3t18492H	0	-	365	3079	3618	0.8510227
C3	40868485	40869957	BolC3t18493H	0	+	578	1472	1472	1.0000000
C3	40870769	40871777	BolC3t18494H	0	+	151	906	1008	0.8988096
C3	40872337	40873748	BolC3t18495H	0	+	1163	1411	1411	1.0000000
C3	40874014	40882557	BolC3t18496H	0	-	4841	8493	8543	0.9941472
C3	40883412	40885270	BolC3t18497H	0	+	1074	1858	1858	1.0000000
C3	40885464	40892469	BolC3t18498H	0	-	486	3912	7005	0.5584583
C3	40898386	40904883	BolC3t18499H	0	+	3011	5966	6497	0.9182700
C3	40915768	40916296	BolC3t18500H	0	+	386	528	528	1.0000000
C3	40917773	40918243	BolC3t18501H	0	-	425	470	470	1.0000000
C3	40934418	40937306	BolC3t18502H	0	-	715	2460	2888	0.8518006
C3	40944601	40944826	BolC3t18503H	0	-	226	225	225	1.0000000
C3	40945457	40946903	BolC3t18504H	0	+	1966	1446	1446	1.0000000
C3	40949279	40950471	BolC3t18505H	0	-	667	1192	1192	1.0000000
C3	40950530	40951044	BolC3t18506H	0	-	1209	514	514	1.0000000
C3	40953514	40955568	BolC3t18507H	0	+	837	1909	2054	0.9294060
C3	40955812	40957192	BolC3t18508H	0	-	375	1109	1380	0.8036232
C3	40965117	40965735	BolC3t18509H	0	+	802	618	618	1.0000000
C3	40966120	40966661	BolC3t18510H	0	-	234	541	541	1.0000000
C3	40966997	40967368	BolC3t18511H	0	+	154	347	371	0.9353099
C3	40970963	40973501	BolC3t18512H	0	+	2456	2538	2538	1.0000000
C3	40973823	40975042	BolC3t18513H	0	-	1081	1219	1219	1.0000000
C3	40984273	40991032	BolC3t18514H	0	+	2083	6738	6759	0.9968930
C3	40991499	40992421	BolC3t18515H	0	+	587	922	922	1.0000000
C3	41003011	41006133	BolC3t18516H	0	+	2685	3119	3122	0.9990391
C3	41007051	41009463	BolC3t18517H	0	-	147	1362	2412	0.5646766
C3	41012057	41015960	BolC3t18518H	0	-	215	2784	3903	0.7132975
C3	41016160	41017384	BolC3t18519H	0	+	414	1150	1224	0.9395425
C3	41017589	41021423	BolC3t18520H	0	-	862	3481	3834	0.9079291
C3	41023157	41029450	BolC3t18521H	0	-	1866	4538	6293	0.7211187
C3	41039158	41039296	BolC3t18522H	0	+	212	138	138	1.0000000
C3	41039417	41040340	BolC3t18523H	0	+	534	904	923	0.9794149
C3	41040749	41041958	BolC3t18524H	0	-	187	902	1209	0.7460712
C3	41044928	41048164	BolC3t18525H	0	-	1807	3155	3236	0.9749691
C3	41049468	41055600	BolC3t18526H	0	+	3638	5853	6132	0.9545010
C3	41055782	41057309	BolC3t18527H	0	-	916	1527	1527	1.0000000
C3	41073972	41076645	BolC3t18528H	0	-	1266	2595	2673	0.9708193
C3	41080848	41081268	BolC3t18529H	0	+	51	294	420	0.7000000
C3	41081800	41082511	BolC3t18530H	0	-	27	457	711	0.6427567
C3	41083231	41085232	BolC3t18531H	0	-	575	1939	2001	0.9690155
C3	41088579	41090508	BolC3t18532H	0	+	738	1821	1929	0.9440125
C3	41093548	41095142	BolC3t18533H	0	+	528	1545	1594	0.9692597
C3	41095890	41098062	BolC3t18534H	0	-	1388	2172	2172	1.0000000
C3	41100024	41102901	BolC3t18535H	0	+	851	2676	2877	0.9301355
C3	41103501	41105492	BolC3t18536H	0	+	1202	1969	1991	0.9889503
C3	41130598	41130817	BolC3t18537H	0	+	54	111	219	0.5068493
C3	41149323	41151167	BolC3t18538H	0	+	336	1446	1844	0.7841648
C3	41180677	41183145	BolC3t18539H	0	-	1348	2295	2468	0.9299027
C3	41181275	41182081	BolC3t18540H	0	-	573	806	806	1.0000000
C3	41185882	41187682	BolC3t18541H	0	-	327	1619	1800	0.8994445
C3	41188733	41189045	BolC3t18542H	0	+	244	312	312	1.0000000
C3	41193464	41195249	BolC3t18543H	0	-	305	1396	1785	0.7820728
C3	41197763	41200779	BolC3t18544H	0	-	863	2771	3016	0.9187666
C3	41228339	41230679	BolC3t18545H	0	-	317	1464	2340	0.6256410
C3	41255294	41258038	BolC3t18546H	0	+	421	2092	2744	0.7623907
C3	41258358	41259291	BolC3t18547H	0	-	135	785	933	0.8413719
C3	41259740	41259950	BolC3t18548H	0	-	14	129	210	0.6142857
C3	41260678	41264070	BolC3t18549H	0	+	1601	3356	3392	0.9893868
C3	41264322	41265278	BolC3t18550H	0	-	694	956	956	1.0000000
C3	41265924	41266904	BolC3t18551H	0	+	107	737	980	0.7520408
C3	41290583	41290880	BolC3t18552H	0	+	4	82	297	0.2760943
C3	41295341	41295686	BolC3t18553H	0	+	188	345	345	1.0000000
C3	41307857	41309764	BolC3t18554H	0	+	18	598	1907	0.3135816
C3	41314295	41315149	BolC3t18555H	0	-	1513	854	854	1.0000000
C3	41316557	41316986	BolC3t18556H	0	+	23	356	429	0.8298368
C3	41324834	41326151	BolC3t18557H	0	-	393	1317	1317	1.0000000
C3	41336189	41336324	BolC3t18558H	0	+	112	135	135	1.0000000
C3	41340609	41341903	BolC3t18559H	0	-	23	438	1294	0.3384853
C3	41358595	41358730	BolC3t18560H	0	-	42	135	135	1.0000000
C3	41370626	41370773	BolC3t18561H	0	-	25	147	147	1.0000000
C3	41377795	41377930	BolC3t18562H	0	+	24	135	135	1.0000000
C3	41379929	41380307	BolC3t18563H	0	+	12	121	378	0.3201058
C3	41382519	41382972	BolC3t18564H	0	-	0	0	453	0.0000000
C3	41399548	41399704	BolC3t18565H	0	-	0	0	156	0.0000000
C3	41419426	41419935	BolC3t18566H	0	-	52	401	509	0.7878193
C3	41420976	41421462	BolC3t18567H	0	-	432	466	486	0.9588478
C3	41423520	41423751	BolC3t18568H	0	+	218	231	231	1.0000000
C3	41432666	41434545	BolC3t18569H	0	+	426	1818	1879	0.9675359
C3	41443674	41443809	BolC3t18570H	0	+	193	135	135	1.0000000
C3	41444886	41451664	BolC3t18571H	0	-	3470	6564	6778	0.9684272
C3	41452168	41453839	BolC3t18572H	0	+	287	1574	1671	0.9419509
C3	41454404	41456389	BolC3t18573H	0	+	399	1662	1985	0.8372796
C3	41459791	41460225	BolC3t18574H	0	-	14	131	434	0.3018433
C3	41485795	41486020	BolC3t18575H	0	-	182	225	225	1.0000000
C3	41490667	41491027	BolC3t18576H	0	-	3	206	360	0.5722222
C3	41497718	41498606	BolC3t18577H	0	+	132	819	888	0.9222973
C3	41501968	41504224	BolC3t18578H	0	+	908	2181	2256	0.9667553
C3	41602199	41602991	BolC3t18579H	0	-	719	792	792	1.0000000
C3	41607507	41608571	BolC3t18580H	0	-	1056	1064	1064	1.0000000
C3	41609046	41609505	BolC3t18581H	0	-	274	389	459	0.8474945
C3	41611456	41611807	BolC3t18582H	0	+	15	230	351	0.6552706
C3	41615787	41619475	BolC3t18583H	0	+	2154	3688	3688	1.0000000
C3	41620142	41621701	BolC3t18584H	0	+	782	1559	1559	1.0000000
C3	41622301	41622871	BolC3t18585H	0	+	289	560	570	0.9824561
C3	41623706	41626407	BolC3t18586H	0	-	1869	2701	2701	1.0000000
C3	41651263	41651694	BolC3t18587H	0	-	2	50	431	0.1160093
C3	41653104	41653446	BolC3t18588H	0	+	50	154	342	0.4502924
C3	41658894	41659206	BolC3t18589H	0	+	765	312	312	1.0000000
C3	41659933	41660287	BolC3t18590H	0	+	866	354	354	1.0000000
C3	41660361	41660623	BolC3t18591H	0	+	737	262	262	1.0000000
C3	41661860	41667745	BolC3t18592H	0	-	2528	3287	5885	0.5585387
C3	41670182	41670707	BolC3t18593H	0	+	8	151	525	0.2876191
C3	41673400	41675367	BolC3t18594H	0	+	1507	1967	1967	1.0000000
C3	41675820	41677167	BolC3t18595H	0	+	108	769	1347	0.5708983
C3	41677561	41680547	BolC3t18596H	0	-	953	2250	2986	0.7535164
C3	41682597	41684848	BolC3t18597H	0	+	1214	2101	2251	0.9333630
C3	41685135	41687651	BolC3t18598H	0	-	1006	2435	2516	0.9678060
C3	41694099	41695751	BolC3t18599H	0	+	265	1469	1652	0.8892252
C3	41709655	41711491	BolC3t18600H	0	-	882	1836	1836	1.0000000
C3	41713436	41713736	BolC3t18601H	0	-	42	249	300	0.8300000
C3	41715477	41717303	BolC3t18602H	0	-	387	1591	1826	0.8713034
C3	41723887	41724857	BolC3t18603H	0	+	45	408	970	0.4206186
C3	41726327	41726492	BolC3t18604H	0	-	172	165	165	1.0000000
C3	41726599	41727311	BolC3t18605H	0	-	31	180	712	0.2528090
C3	41734998	41736494	BolC3t18606H	0	+	16	102	1496	0.0681818
C3	41737160	41738278	BolC3t18607H	0	+	145	462	1118	0.4132379
C3	41739584	41739761	BolC3t18608H	0	-	0	0	177	0.0000000
C3	41739868	41740579	BolC3t18609H	0	-	30	292	711	0.4106892
C3	41748269	41750743	BolC3t18610H	0	+	354	926	2474	0.3742926
C3	41757601	41758147	BolC3t18611H	0	+	11	170	546	0.3113553
C3	41765797	41768516	BolC3t18612H	0	-	771	2518	2719	0.9260758
C3	41769741	41771067	BolC3t18613H	0	-	57	535	1326	0.4034691
C3	41772608	41773889	BolC3t18614H	0	-	99	904	1281	0.7056987
C3	41773959	41774220	BolC3t18615H	0	-	4	122	261	0.4674329
C3	41793521	41794279	BolC3t18616H	0	-	233	758	758	1.0000000
C3	41795109	41796086	BolC3t18617H	0	+	488	977	977	1.0000000
C3	41796805	41797900	BolC3t18618H	0	-	932	1095	1095	1.0000000
C3	41799913	41801121	BolC3t18619H	0	+	983	1177	1208	0.9743378
C3	41801459	41802017	BolC3t18620H	0	-	513	558	558	1.0000000
C3	41827813	41828389	BolC3t18621H	0	+	343	576	576	1.0000000
C3	41828619	41832377	BolC3t18622H	0	+	2679	3758	3758	1.0000000
C3	41842607	41844269	BolC3t18623H	0	-	249	1478	1662	0.8892900
C3	41848153	41849629	BolC3t18624H	0	+	615	1350	1476	0.9146342
C3	41851278	41852274	BolC3t18625H	0	+	550	996	996	1.0000000
C3	41869790	41870365	BolC3t18626H	0	+	733	575	575	1.0000000
C3	41874280	41875253	BolC3t18627H	0	+	92	694	973	0.7132580
C3	41895794	41895941	BolC3t18628H	0	+	8	37	147	0.2517007
C3	41914695	41914836	BolC3t18629H	0	+	0	0	141	0.0000000
C3	41920159	41924677	BolC3t18630H	0	-	2517	4206	4518	0.9309429
C3	41932579	41933161	BolC3t18631H	0	-	1108	582	582	1.0000000
C3	41936873	41938095	BolC3t18632H	0	+	537	1222	1222	1.0000000
C3	41944505	41944871	BolC3t18633H	0	+	70	270	366	0.7377049
C3	41946710	41948144	BolC3t18634H	0	+	1	92	1434	0.0641562
C3	41965511	41966945	BolC3t18635H	0	+	261	1075	1434	0.7496513
C3	41967718	41969168	BolC3t18636H	0	+	195	1246	1450	0.8593103
C3	41969621	41970984	BolC3t18637H	0	-	477	1313	1363	0.9633162
C3	41972550	41973374	BolC3t18638H	0	-	347	800	824	0.9708738
C3	41975072	41978503	BolC3t18639H	0	-	1914	3410	3431	0.9938793
C3	41991651	41993386	BolC3t18640H	0	-	1596	1735	1735	1.0000000
C3	42000353	42000830	BolC3t18641H	0	-	437	477	477	1.0000000
C3	42003176	42039700	BolC3t18642H	0	-	11769	26198	36524	0.7172818
C3	42060202	42060455	BolC3t18643H	0	+	2	1	253	0.0039526
C3	42062272	42063462	BolC3t18644H	0	+	927	1190	1190	1.0000000
C3	42064028	42065722	BolC3t18645H	0	+	2011	1694	1694	1.0000000
C3	42069025	42070074	BolC3t18646H	0	+	194	964	1049	0.9189705
C3	42070389	42073780	BolC3t18647H	0	-	1295	3386	3391	0.9985255
C3	42074689	42077502	BolC3t18648H	0	+	841	2603	2813	0.9253466
C3	42087631	42088512	BolC3t18649H	0	-	233	693	881	0.7866061
C3	42098316	42103726	BolC3t18650H	0	+	1519	4806	5410	0.8883549
C3	42110281	42116226	BolC3t18651H	0	-	936	5316	5945	0.8941968
C3	42116967	42118165	BolC3t18652H	0	-	370	1198	1198	1.0000000
C3	42119639	42122175	BolC3t18653H	0	+	136	1654	2536	0.6522082
C3	42125721	42126479	BolC3t18654H	0	+	303	758	758	1.0000000
C3	42134369	42136728	BolC3t18655H	0	-	385	2116	2359	0.8969902
C3	42139392	42142542	BolC3t18656H	0	-	791	2647	3150	0.8403175
C3	42143972	42146781	BolC3t18657H	0	-	1075	2750	2809	0.9789961
C3	42148070	42150109	BolC3t18658H	0	-	998	1857	2039	0.9107406
C3	42167535	42167685	BolC3t18659H	0	+	3	95	150	0.6333333
C3	42174555	42174864	BolC3t18660H	0	+	160	309	309	1.0000000
C3	42186181	42186466	BolC3t18661H	0	+	226	285	285	1.0000000
C3	42188481	42188604	BolC3t18662H	0	-	136	123	123	1.0000000
C3	42200728	42201499	BolC3t18663H	0	-	324	771	771	1.0000000
C3	42209026	42209491	BolC3t18664H	0	+	140	461	465	0.9913979
C3	42215546	42216838	BolC3t18665H	0	+	37	647	1292	0.5007740
C3	42224838	42227233	BolC3t18666H	0	+	196	1675	2395	0.6993737
C3	42230576	42233601	BolC3t18667H	0	+	805	2418	3025	0.7993388
C3	42245037	42247725	BolC3t18668H	0	+	1426	2565	2688	0.9542411
C3	42262120	42264707	BolC3t18669H	0	+	339	1921	2587	0.7425590
C3	42266237	42266696	BolC3t18670H	0	-	315	459	459	1.0000000
C3	42270585	42270903	BolC3t18671H	0	+	156	318	318	1.0000000
C3	42273198	42273603	BolC3t18672H	0	+	375	405	405	1.0000000
C3	42275154	42276434	BolC3t18673H	0	-	355	1193	1280	0.9320313
C3	42281618	42284063	BolC3t18674H	0	-	621	2211	2445	0.9042945
C3	42291409	42292072	BolC3t18675H	0	+	537	663	663	1.0000000
C3	42300434	42300680	BolC3t18676H	0	+	3	176	246	0.7154471
C3	42304895	42305132	BolC3t18677H	0	+	12	213	237	0.8987342
C3	42316935	42324927	BolC3t18678H	0	+	980	4899	7992	0.6129880
C3	42326609	42328596	BolC3t18679H	0	-	1345	1767	1987	0.8892803
C3	42331534	42334177	BolC3t18680H	0	-	888	2526	2643	0.9557321
C3	42341950	42342235	BolC3t18681H	0	-	363	285	285	1.0000000
C3	42342107	42342820	BolC3t18682H	0	+	1078	713	713	1.0000000
C3	42381311	42383094	BolC3t18683H	0	+	860	1780	1783	0.9983174
C3	42386394	42389562	BolC3t18684H	0	+	1645	3139	3168	0.9908460
C3	42390107	42391258	BolC3t18685H	0	-	320	1151	1151	1.0000000
C3	42397663	42398696	BolC3t18686H	0	-	746	1033	1033	1.0000000
C3	42399034	42399175	BolC3t18687H	0	-	188	141	141	1.0000000
C3	42406010	42407843	BolC3t18688H	0	-	1002	1833	1833	1.0000000
C3	42410394	42410655	BolC3t18689H	0	+	76	261	261	1.0000000
C3	42427877	42428822	BolC3t18690H	0	-	538	945	945	1.0000000
C3	42429497	42429921	BolC3t18691H	0	+	141	401	424	0.9457547
C3	42430413	42431715	BolC3t18692H	0	-	829	1302	1302	1.0000000
C3	42480360	42480858	BolC3t18693H	0	-	50	438	498	0.8795181
C3	42507914	42508412	BolC3t18694H	0	-	1	25	498	0.0502008
C3	42513918	42514761	BolC3t18695H	0	+	0	0	843	0.0000000
C3	42519738	42521159	BolC3t18696H	0	+	256	1293	1421	0.9099226
C3	42528416	42529896	BolC3t18697H	0	-	495	1443	1480	0.9750000
C3	42534099	42534932	BolC3t18698H	0	+	2	98	833	0.1176471
C3	42535133	42535632	BolC3t18699H	0	+	1	128	499	0.2565130
C3	42550137	42551166	BolC3t18700H	0	+	301	925	1029	0.8989310
C3	42560349	42561749	BolC3t18701H	0	+	711	1350	1400	0.9642857
C3	42592185	42593724	BolC3t18702H	0	-	22	520	1539	0.3378817
C3	42604491	42610654	BolC3t18703H	0	-	1303	3880	6163	0.6295635
C3	42611243	42611979	BolC3t18704H	0	-	326	736	736	1.0000000
C3	42626556	42628172	BolC3t18705H	0	+	1249	1616	1616	1.0000000
C3	42628751	42629908	BolC3t18706H	0	-	1559	1157	1157	1.0000000
C3	42649641	42652623	BolC3t18707H	0	+	785	1458	2982	0.4889336
C3	42657652	42662403	BolC3t18708H	0	-	3362	4369	4751	0.9195959
C3	42665026	42666500	BolC3t18709H	0	+	883	927	1474	0.6289009
C3	42667468	42667756	BolC3t18710H	0	+	106	288	288	1.0000000
C3	42671529	42671748	BolC3t18711H	0	-	93	199	219	0.9086758
C3	42672389	42675767	BolC3t18712H	0	-	4056	2274	3378	0.6731794
C3	42679686	42680834	BolC3t18713H	0	-	63	800	1148	0.6968641
C3	42695782	42696741	BolC3t18714H	0	+	5	153	959	0.1595412
C3	42697533	42702382	BolC3t18715H	0	-	2055	4381	4849	0.9034852
C3	42703320	42704593	BolC3t18716H	0	-	1443	1273	1273	1.0000000
C3	42705997	42706756	BolC3t18717H	0	-	7	199	759	0.2621871
C3	42719693	42721194	BolC3t18718H	0	-	474	1411	1501	0.9400400
C3	42722252	42724227	BolC3t18719H	0	-	967	1975	1975	1.0000000
C3	42725514	42727783	BolC3t18720H	0	-	762	2139	2269	0.9427060
C3	42728623	42730659	BolC3t18721H	0	+	1282	1971	2036	0.9680747
C3	42731100	42736466	BolC3t18722H	0	-	2995	5208	5366	0.9705554
C3	42742913	42743894	BolC3t18723H	0	-	235	851	981	0.8674822
C3	42767081	42768668	BolC3t18724H	0	+	124	682	1587	0.4297417
C3	42793526	42793991	BolC3t18725H	0	-	342	465	465	1.0000000
C3	42795109	42796019	BolC3t18726H	0	+	689	910	910	1.0000000
C3	42798064	42798226	BolC3t18727H	0	+	198	162	162	1.0000000
C3	42801383	42802722	BolC3t18728H	0	+	979	1339	1339	1.0000000
C3	42809480	42810334	BolC3t18729H	0	+	744	854	854	1.0000000
C3	42810445	42811084	BolC3t18730H	0	+	854	639	639	1.0000000
C3	42820395	42823946	BolC3t18731H	0	-	534	3196	3551	0.9000282
C3	42824006	42824977	BolC3t18732H	0	-	300	971	971	1.0000000
C3	42834270	42834888	BolC3t18733H	0	-	96	157	618	0.2540453
C3	42839211	42840056	BolC3t18734H	0	+	599	845	845	1.0000000
C3	42857749	42858122	BolC3t18735H	0	+	213	373	373	1.0000000
C3	42872676	42875051	BolC3t18736H	0	+	686	2267	2375	0.9545263
C3	42879307	42880237	BolC3t18737H	0	-	358	930	930	1.0000000
C3	42925979	42926111	BolC3t18738H	0	-	149	132	132	1.0000000
C3	42926998	42927498	BolC3t18739H	0	+	55	467	500	0.9340000
C3	42935434	42936079	BolC3t18740H	0	+	8	333	645	0.5162790
C3	42961071	42962313	BolC3t18741H	0	-	68	837	1242	0.6739131
C3	42987376	42987685	BolC3t18742H	0	-	276	309	309	1.0000000
C3	42993740	43001475	BolC3t18743H	0	+	4916	7165	7735	0.9263090
C3	43004402	43004683	BolC3t18744H	0	+	170	281	281	1.0000000
C3	43005661	43007701	BolC3t18745H	0	+	768	1849	2040	0.9063725
C3	43015411	43019356	BolC3t18746H	0	+	3285	3945	3945	1.0000000
C3	43024060	43024266	BolC3t18747H	0	+	0	0	206	0.0000000
C3	43048470	43049001	BolC3t18748H	0	+	3	111	531	0.2090396
C3	43055080	43055569	BolC3t18749H	0	+	3	77	489	0.1574642
C3	43066009	43068505	BolC3t18750H	0	+	444	2417	2496	0.9683493
C3	43068684	43069227	BolC3t18751H	0	-	432	543	543	1.0000000
C3	43070091	43073763	BolC3t18752H	0	+	1220	3581	3672	0.9752179
C3	43074165	43075107	BolC3t18753H	0	-	190	864	942	0.9171975
C3	43081684	43087122	BolC3t18754H	0	+	3733	5438	5438	1.0000000
C3	43113214	43113801	BolC3t18755H	0	-	346	587	587	1.0000000
C3	43114799	43115048	BolC3t18756H	0	-	108	249	249	1.0000000
C3	43122263	43123487	BolC3t18757H	0	-	16	623	1224	0.5089869
C3	43123904	43124424	BolC3t18758H	0	-	15	81	520	0.1557692
C3	43130911	43135471	BolC3t18759H	0	+	454	3084	4560	0.6763158
C3	43140168	43140805	BolC3t18760H	0	-	8	20	637	0.0313972
C3	43144024	43145380	BolC3t18761H	0	-	290	1272	1356	0.9380531
C3	43165210	43166204	BolC3t18762H	0	-	101	815	994	0.8199195
C3	43169793	43173515	BolC3t18763H	0	-	721	3183	3722	0.8551854
C3	43188445	43188779	BolC3t18764H	0	+	102	334	334	1.0000000
C3	43197513	43200447	BolC3t18765H	0	+	230	1414	2934	0.4819359
C3	43201421	43211449	BolC3t18766H	0	-	3619	9850	10028	0.9822497
C3	43212481	43216445	BolC3t18767H	0	-	662	3477	3964	0.8771443
C3	43226387	43230987	BolC3t18768H	0	+	317	3064	4600	0.6660870
C3	43233643	43234732	BolC3t18769H	0	+	1058	1089	1089	1.0000000
C3	43234863	43235616	BolC3t18770H	0	-	292	744	753	0.9880478
C3	43236523	43236982	BolC3t18771H	0	+	680	459	459	1.0000000
C3	43239176	43242487	BolC3t18772H	0	+	2151	3258	3311	0.9839928
C3	43243654	43244526	BolC3t18773H	0	-	727	872	872	1.0000000
C3	43256252	43258020	BolC3t18774H	0	-	1244	1768	1768	1.0000000
C3	43258450	43258741	BolC3t18775H	0	+	125	291	291	1.0000000
C3	43275107	43276174	BolC3t18776H	0	+	990	1051	1067	0.9850047
C3	43283638	43284115	BolC3t18777H	0	-	205	477	477	1.0000000
C3	43287095	43290738	BolC3t18778H	0	-	1450	3044	3643	0.8355751
C3	43292901	43295402	BolC3t18779H	0	-	1216	2294	2501	0.9172331
C3	43299412	43301316	BolC3t18780H	0	+	514	1621	1904	0.8513656
C3	43301499	43302778	BolC3t18781H	0	-	357	1279	1279	1.0000000
C3	43305523	43307223	BolC3t18782H	0	+	1101	1700	1700	1.0000000
C3	43318429	43319044	BolC3t18783H	0	-	1868	615	615	1.0000000
C3	43321049	43321235	BolC3t18784H	0	+	67	186	186	1.0000000
C3	43324317	43325146	BolC3t18785H	0	-	1830	829	829	1.0000000
C3	43329411	43330715	BolC3t18786H	0	-	1878	1304	1304	1.0000000
C3	43353644	43355004	BolC3t18787H	0	-	890	1038	1360	0.7632353
C3	43360228	43360678	BolC3t18788H	0	+	315	450	450	1.0000000
C3	43360723	43369882	BolC3t18789H	0	+	758	2385	9159	0.2603996
C3	43376519	43379928	BolC3t18790H	0	+	539	2985	3409	0.8756233
C3	43390045	43392413	BolC3t18791H	0	+	396	1664	2368	0.7027027
C3	43421082	43422648	BolC3t18792H	0	-	261	1334	1566	0.8518519
C3	43434725	43435380	BolC3t18793H	0	-	337	655	655	1.0000000
C3	43440261	43441421	BolC3t18794H	0	-	879	1160	1160	1.0000000
C3	43454013	43457948	BolC3t18795H	0	+	843	3601	3935	0.9151207
C3	43459451	43460838	BolC3t18796H	0	+	1311	1387	1387	1.0000000
C3	43463496	43463911	BolC3t18797H	0	+	413	415	415	1.0000000
C3	43464664	43465469	BolC3t18798H	0	+	771	805	805	1.0000000
C3	43470374	43471938	BolC3t18799H	0	-	877	1564	1564	1.0000000
C3	43476655	43479314	BolC3t18800H	0	+	203	2165	2659	0.8142159
C3	43488385	43490909	BolC3t18801H	0	+	909	2524	2524	1.0000000
C3	43491418	43492499	BolC3t18802H	0	+	129	930	1081	0.8603145
C3	43514761	43514989	BolC3t18803H	0	-	9	227	228	0.9956141
C3	43558332	43558749	BolC3t18804H	0	+	194	417	417	1.0000000
C3	43569581	43570001	BolC3t18805H	0	-	30	288	420	0.6857143
C3	43576775	43578183	BolC3t18806H	0	+	1449	1398	1408	0.9928977
C3	43580235	43580540	BolC3t18807H	0	+	104	305	305	1.0000000
C3	43580632	43580749	BolC3t18808H	0	+	223	117	117	1.0000000
C3	43584955	43585799	BolC3t18809H	0	-	0	0	844	0.0000000
C3	43588313	43590073	BolC3t18810H	0	+	879	1760	1760	1.0000000
C3	43592147	43595470	BolC3t18811H	0	+	2344	3275	3323	0.9855552
C3	43616051	43617053	BolC3t18812H	0	+	994	1002	1002	1.0000000
C3	43617812	43619575	BolC3t18813H	0	-	1011	1763	1763	1.0000000
C3	43628314	43628613	BolC3t18814H	0	+	186	299	299	1.0000000
C3	43652044	43652765	BolC3t18815H	0	-	33	721	721	1.0000000
C3	43656962	43659381	BolC3t18816H	0	+	910	2396	2419	0.9904919
C3	43661913	43665633	BolC3t18817H	0	+	681	2657	3720	0.7142473
C3	43697240	43698670	BolC3t18818H	0	+	79	837	1430	0.5853147
C3	43702621	43707647	BolC3t18819H	0	+	1650	4438	5026	0.8830084
C3	43711664	43713729	BolC3t18820H	0	+	366	1305	2065	0.6319613
C3	43715743	43718386	BolC3t18821H	0	+	2057	2643	2643	1.0000000
C3	43721243	43722216	BolC3t18822H	0	-	1158	973	973	1.0000000
C3	43731706	43735923	BolC3t18823H	0	-	856	3064	4217	0.7265829
C3	43768942	43770800	BolC3t18824H	0	+	359	1760	1858	0.9472551
C3	43771516	43773286	BolC3t18825H	0	-	346	1627	1770	0.9192091
C3	43811014	43812834	BolC3t18826H	0	-	1399	1820	1820	1.0000000
C3	43839325	43843804	BolC3t18827H	0	-	556	3443	4479	0.7686984
C3	43893050	43904417	BolC3t18828H	0	+	2978	9559	11367	0.8409431
C3	43914154	43914559	BolC3t18829H	0	-	199	405	405	1.0000000
C3	43928220	43939672	BolC3t18830H	0	+	1447	6278	11452	0.5482012
C3	43937766	43938345	BolC3t18831H	0	-	0	0	579	0.0000000
C3	43951114	43951703	BolC3t18832H	0	-	603	589	589	1.0000000
C3	43956583	43957615	BolC3t18833H	0	+	612	1032	1032	1.0000000
C3	43964716	43965209	BolC3t18834H	0	-	180	493	493	1.0000000
C3	43966305	43966644	BolC3t18835H	0	-	195	339	339	1.0000000
C3	43984143	43984854	BolC3t18836H	0	+	407	711	711	1.0000000
C3	43996503	43996950	BolC3t18837H	0	+	51	232	447	0.5190157
C3	44009441	44009826	BolC3t18838H	0	-	355	385	385	1.0000000
C3	44012342	44013465	BolC3t18839H	0	-	542	1123	1123	1.0000000
C3	44014041	44014797	BolC3t18840H	0	+	1108	756	756	1.0000000
C3	44014160	44014571	BolC3t18841H	0	-	712	411	411	1.0000000
C3	44023340	44024708	BolC3t18842H	0	+	417	1359	1368	0.9934211
C3	44029452	44033777	BolC3t18843H	0	+	1185	4037	4325	0.9334104
C3	44057724	44058628	BolC3t18844H	0	+	363	904	904	1.0000000
C3	44060277	44062947	BolC3t18845H	0	-	1682	2670	2670	1.0000000
C3	44083378	44083947	BolC3t18846H	0	+	359	569	569	1.0000000
C3	44086711	44087920	BolC3t18847H	0	+	68	844	1209	0.6980976
C3	44088750	44089871	BolC3t18848H	0	-	472	1047	1121	0.9339875
C3	44102418	44104666	BolC3t18849H	0	+	384	1952	2248	0.8683274
C3	44108385	44110044	BolC3t18850H	0	+	339	1349	1659	0.8131405
C3	44114404	44117310	BolC3t18851H	0	+	289	1884	2906	0.6483138
C3	44124242	44124638	BolC3t18852H	0	+	420	396	396	1.0000000
C3	44125551	44134338	BolC3t18853H	0	-	5627	7390	8787	0.8410152
C3	44139302	44141969	BolC3t18854H	0	-	1261	2191	2667	0.8215223
C3	44147617	44147830	BolC3t18855H	0	-	254	213	213	1.0000000
C3	44148576	44148723	BolC3t18856H	0	+	76	147	147	1.0000000
C3	44159311	44159658	BolC3t18857H	0	+	8	167	347	0.4812680
C3	44175141	44177352	BolC3t18858H	0	+	4306	2131	2211	0.9638173
C3	44179822	44181016	BolC3t18859H	0	+	1584	1152	1194	0.9648241
C3	44183553	44183790	BolC3t18860H	0	-	159	237	237	1.0000000
C3	44186398	44186935	BolC3t18861H	0	-	78	142	537	0.2644320
C3	44203781	44203967	BolC3t18862H	0	+	0	0	186	0.0000000
C3	44204697	44204799	BolC3t18863H	0	-	120	102	102	1.0000000
C3	44210920	44211073	BolC3t18864H	0	-	183	153	153	1.0000000
C3	44211139	44248366	BolC3t18865H	0	-	13742	31689	37227	0.8512370
C3	44228167	44228809	BolC3t18866H	0	+	10	270	642	0.4205607
C3	44233855	44234933	BolC3t18867H	0	-	324	1078	1078	1.0000000
C3	44236158	44237946	BolC3t18868H	0	-	5	242	1788	0.1353468
C3	44248813	44248996	BolC3t18869H	0	-	225	183	183	1.0000000
C3	44258671	44258851	BolC3t18870H	0	+	101	180	180	1.0000000
C3	44261644	44263563	BolC3t18871H	0	-	538	1456	1919	0.7587285
C3	44283223	44285330	BolC3t18872H	0	-	1426	2107	2107	1.0000000
C3	44285672	44285843	BolC3t18873H	0	+	110	171	171	1.0000000
C3	44297558	44297808	BolC3t18874H	0	-	157	250	250	1.0000000
C3	44348273	44349116	BolC3t18875H	0	+	69	800	843	0.9489917
C3	44399662	44400106	BolC3t18876H	0	+	10	343	444	0.7725225
C3	44407772	44409278	BolC3t18877H	0	+	56	955	1506	0.6341301
C3	44465845	44466205	BolC3t18878H	0	+	353	360	360	1.0000000
C3	44466629	44467124	BolC3t18879H	0	-	426	495	495	1.0000000
C3	44482101	44482392	BolC3t18880H	0	+	228	291	291	1.0000000
C3	44489534	44492125	BolC3t18881H	0	-	1382	2483	2591	0.9583173
C3	44520632	44523155	BolC3t18882H	0	+	560	2187	2523	0.8668252
C3	44535072	44535636	BolC3t18883H	0	+	156	564	564	1.0000000
C3	44544141	44544273	BolC3t18884H	0	+	190	132	132	1.0000000
C3	44545793	44546195	BolC3t18885H	0	+	506	402	402	1.0000000
C3	44546819	44547131	BolC3t18886H	0	-	222	312	312	1.0000000
C3	44548682	44549003	BolC3t18887H	0	-	189	321	321	1.0000000
C3	44552884	44553509	BolC3t18888H	0	-	64	590	625	0.9440000
C3	44554382	44557042	BolC3t18889H	0	-	1107	2168	2660	0.8150376
C3	44578123	44584275	BolC3t18890H	0	+	1211	3920	6152	0.6371912
C3	44606885	44609216	BolC3t18891H	0	-	419	2069	2331	0.8876019
C3	44616645	44616855	BolC3t18892H	0	-	6	104	210	0.4952381
C3	44621750	44623445	BolC3t18893H	0	+	74	838	1695	0.4943953
C3	44645416	44646358	BolC3t18894H	0	+	1162	942	942	1.0000000
C3	44650372	44651263	BolC3t18895H	0	-	78	292	891	0.3277217
C3	44734369	44735524	BolC3t18896H	0	+	413	1130	1155	0.9783550
C3	44737251	44738940	BolC3t18897H	0	+	271	917	1689	0.5429248
C3	44768811	44770758	BolC3t18898H	0	-	4424	1947	1947	1.0000000
C3	44787423	44788613	BolC3t18899H	0	+	834	1190	1190	1.0000000
C3	44794409	44795834	BolC3t18900H	0	-	222	851	1425	0.5971930
C3	44805670	44806699	BolC3t18901H	0	-	7	270	1029	0.2623907
C3	44806570	44807147	BolC3t18902H	0	-	2	225	577	0.3899480
C3	44809867	44812465	BolC3t18903H	0	+	584	2424	2598	0.9330254
C3	44820021	44821535	BolC3t18904H	0	+	294	1176	1514	0.7767503
C3	44822145	44826668	BolC3t18905H	0	-	1311	4216	4523	0.9321247
C3	44837075	44837386	BolC3t18906H	0	+	202	311	311	1.0000000
C3	44837855	44838092	BolC3t18907H	0	+	233	237	237	1.0000000
C3	44844773	44846139	BolC3t18908H	0	-	118	1059	1366	0.7752562
C3	44852627	44853535	BolC3t18909H	0	+	297	700	908	0.7709251
C3	44858474	44859652	BolC3t18910H	0	-	121	935	1178	0.7937182
C3	44860676	44863600	BolC3t18911H	0	-	2221	2632	2924	0.9001368
C3	44865867	44872681	BolC3t18912H	0	+	3201	6281	6814	0.9217787
C3	44887984	44889744	BolC3t18913H	0	-	2006	1760	1760	1.0000000
C3	44911145	44911298	BolC3t18914H	0	-	159	153	153	1.0000000
C3	44959398	44961188	BolC3t18915H	0	+	523	1502	1790	0.8391061
C3	44968620	44969504	BolC3t18916H	0	-	884	884	884	1.0000000
C3	44980806	44981169	BolC3t18917H	0	-	414	363	363	1.0000000
C3	45015204	45015609	BolC3t18918H	0	-	333	405	405	1.0000000
C3	45016855	45017232	BolC3t18919H	0	-	364	377	377	1.0000000
C3	45017588	45018817	BolC3t18920H	0	+	554	1170	1229	0.9519935
C3	45020445	45021267	BolC3t18921H	0	-	164	786	822	0.9562044
C3	45041739	45044701	BolC3t18922H	0	+	879	2838	2962	0.9581364
C3	45056116	45056455	BolC3t18923H	0	-	157	339	339	1.0000000
C3	45067885	45069709	BolC3t18924H	0	+	429	1121	1824	0.6145833
C3	45091632	45094461	BolC3t18925H	0	-	328	2330	2829	0.8236126
C3	45097288	45097507	BolC3t18926H	0	-	33	200	219	0.9132420
C3	45098193	45098414	BolC3t18927H	0	-	207	221	221	1.0000000
C3	45131759	45131984	BolC3t18928H	0	-	234	225	225	1.0000000
C3	45138858	45139323	BolC3t18929H	0	-	29	418	465	0.8989247
C3	45149479	45149997	BolC3t18930H	0	+	506	518	518	1.0000000
C3	45150420	45151978	BolC3t18931H	0	-	1079	1557	1558	0.9993582
C3	45157256	45157468	BolC3t18932H	0	-	15	29	212	0.1367925
C3	45160082	45160292	BolC3t18933H	0	-	2	69	210	0.3285714
C3	45178752	45182308	BolC3t18934H	0	+	69	860	3556	0.2418448
C3	45226388	45227071	BolC3t18935H	0	-	2	96	683	0.1405564
C3	45249983	45250178	BolC3t18936H	0	-	0	0	195	0.0000000
C3	45257171	45259058	BolC3t18937H	0	-	11	327	1887	0.1732909
C3	45259162	45283270	BolC3t18938H	0	-	928	9457	24108	0.3922764
C3	45294444	45294690	BolC3t18939H	0	+	73	239	246	0.9715447
C3	45306573	45307489	BolC3t18940H	0	+	6	72	916	0.0786026
C3	45307733	45309499	BolC3t18941H	0	+	2	41	1766	0.0232163
C3	45330644	45337058	BolC3t18942H	0	+	358	2538	6414	0.3956969
C3	45344445	45344694	BolC3t18943H	0	+	10	195	249	0.7831326
C3	45352750	45353433	BolC3t18944H	0	-	3	141	683	0.2064422
C3	45385856	45387557	BolC3t18945H	0	+	159	1388	1701	0.8159906
C3	45401316	45401690	BolC3t18946H	0	+	172	374	374	1.0000000
C3	45402223	45402457	BolC3t18947H	0	-	58	170	234	0.7264957
C3	45453929	45454225	BolC3t18948H	0	-	363	296	296	1.0000000
C3	45456493	45457570	BolC3t18949H	0	+	1150	1077	1077	1.0000000
C3	45457689	45458619	BolC3t18950H	0	+	1306	930	930	1.0000000
C3	45460383	45461289	BolC3t18951H	0	-	1439	906	906	1.0000000
C3	45465558	45467135	BolC3t18952H	0	-	2604	1577	1577	1.0000000
C3	45468785	45471682	BolC3t18953H	0	+	873	2711	2897	0.9357957
C3	45472309	45472474	BolC3t18954H	0	-	284	165	165	1.0000000
C3	45489417	45489732	BolC3t18955H	0	+	483	315	315	1.0000000
C3	45507385	45507749	BolC3t18956H	0	-	561	364	364	1.0000000
C3	45508727	45509270	BolC3t18957H	0	-	503	543	543	1.0000000
C3	45527799	45529341	BolC3t18958H	0	+	335	1520	1542	0.9857328
C3	45529634	45530032	BolC3t18959H	0	+	199	398	398	1.0000000
C3	45532054	45532210	BolC3t18960H	0	+	114	156	156	1.0000000
C3	45537026	45539805	BolC3t18961H	0	+	216	1645	2779	0.5919396
C3	45552900	45553101	BolC3t18962H	0	-	325	201	201	1.0000000
C3	45554354	45555573	BolC3t18963H	0	+	482	1163	1219	0.9540607
C3	45557965	45558139	BolC3t18964H	0	-	173	174	174	1.0000000
C3	45572876	45579839	BolC3t18965H	0	-	2686	6345	6963	0.9112452
C3	45599519	45601051	BolC3t18966H	0	+	11	115	1532	0.0750653
C3	45604104	45604614	BolC3t18967H	0	+	119	510	510	1.0000000
C3	45655431	45655602	BolC3t18968H	0	+	183	171	171	1.0000000
C3	45656192	45656903	BolC3t18969H	0	-	531	711	711	1.0000000
C3	45669501	45670493	BolC3t18970H	0	+	329	977	992	0.9848790
C3	45670935	45675352	BolC3t18971H	0	-	792	3520	4417	0.7969210
C3	45679724	45679907	BolC3t18972H	0	-	35	132	183	0.7213115
C3	45680038	45680494	BolC3t18973H	0	-	79	402	456	0.8815789
C3	45683491	45686938	BolC3t18974H	0	-	819	2351	3447	0.6820424
C3	45692513	45692675	BolC3t18975H	0	+	36	162	162	1.0000000
C3	45720948	45721603	BolC3t18976H	0	-	338	655	655	1.0000000
C3	45722020	45723042	BolC3t18977H	0	-	125	836	1022	0.8180039
C3	45793946	45795294	BolC3t18978H	0	+	1919	1348	1348	1.0000000
C3	45797454	45798191	BolC3t18979H	0	-	14	336	737	0.4559023
C3	45804498	45805200	BolC3t18980H	0	-	555	702	702	1.0000000
C3	45807761	45809537	BolC3t18981H	0	-	674	1710	1776	0.9628378
C3	45821873	45823643	BolC3t18982H	0	+	181	1149	1770	0.6491525
C3	45823806	45825908	BolC3t18983H	0	-	1886	2102	2102	1.0000000
C3	45833708	45835639	BolC3t18984H	0	-	1575	1931	1931	1.0000000
C3	45840020	45840473	BolC3t18985H	0	-	365	453	453	1.0000000
C3	45841830	45842568	BolC3t18986H	0	-	1294	738	738	1.0000000
C3	45844002	45844137	BolC3t18987H	0	-	112	135	135	1.0000000
C3	45845540	45845843	BolC3t18988H	0	-	265	303	303	1.0000000
C3	45865567	45865963	BolC3t18989H	0	-	210	396	396	1.0000000
C3	45866692	45889535	BolC3t18990H	0	-	8872	22769	22843	0.9967605
C3	45914637	45915190	BolC3t18991H	0	+	650	553	553	1.0000000
C3	45930907	45931198	BolC3t18992H	0	-	159	291	291	1.0000000
C3	45998036	45998360	BolC3t18993H	0	-	175	324	324	1.0000000
C3	46071402	46071672	BolC3t18994H	0	-	197	270	270	1.0000000
C3	46079520	46088152	BolC3t18995H	0	+	1964	7132	8632	0.8262280
C3	46097951	46098095	BolC3t18996H	0	+	257	144	144	1.0000000
C3	46106108	46109747	BolC3t18997H	0	-	1208	3606	3639	0.9909316
C3	46112964	46114961	BolC3t18998H	0	+	198	1307	1997	0.6544817
C3	46119036	46119447	BolC3t18999H	0	-	3	213	411	0.5182482
C3	46119829	46121403	BolC3t19000H	0	+	1583	1574	1574	1.0000000
C3	46128267	46128839	BolC3t19001H	0	-	292	572	572	1.0000000
C3	46257121	46258306	BolC3t19002H	0	-	285	1122	1185	0.9468355
C3	46302627	46303399	BolC3t19003H	0	+	540	772	772	1.0000000
C3	46303966	46304377	BolC3t19004H	0	+	256	411	411	1.0000000
C3	46342335	46343723	BolC3t19005H	0	-	338	1388	1388	1.0000000
C3	46346811	46349165	BolC3t19006H	0	-	316	1790	2354	0.7604078
C3	46396867	46397182	BolC3t19007H	0	+	110	315	315	1.0000000
C3	46425722	46436686	BolC3t19008H	0	-	3484	10710	10964	0.9768333
C3	46440849	46441143	BolC3t19009H	0	-	151	294	294	1.0000000
C3	46442578	46443382	BolC3t19010H	0	+	22	317	804	0.3942786
C3	47410360	47410672	BolC3t19011H	0	+	39	303	312	0.9711539
C3	47418284	47420260	BolC3t19012H	0	+	254	1424	1976	0.7206478
C3	47422290	47423669	BolC3t19013H	0	+	276	983	1379	0.7128354
C3	47500699	47502023	BolC3t19014H	0	+	278	1203	1324	0.9086103
C3	48318982	48319261	BolC3t19015H	0	-	491	279	279	1.0000000
C3	48319338	48319719	BolC3t19016H	0	-	635	381	381	1.0000000
C3	48325119	48325344	BolC3t19017H	0	-	106	225	225	1.0000000
C3	48325828	48327210	BolC3t19018H	0	+	137	671	1382	0.4855282
C3	48495924	48496446	BolC3t19019H	0	+	196	484	522	0.9272031
C3	48521099	48523214	BolC3t19020H	0	+	20	552	2115	0.2609929
C3	48537679	48539865	BolC3t19021H	0	-	1122	2186	2186	1.0000000
C3	48540210	48540831	BolC3t19022H	0	-	353	621	621	1.0000000
C3	48542375	48542561	BolC3t19023H	0	-	89	186	186	1.0000000
C3	48561653	48561914	BolC3t19024H	0	+	169	261	261	1.0000000
C3	48580140	48580654	BolC3t19025H	0	-	11	312	514	0.6070039
C3	48581556	48581718	BolC3t19026H	0	+	0	0	162	0.0000000
C3	48598152	48601523	BolC3t19027H	0	-	2360	3371	3371	1.0000000
C3	48602376	48604571	BolC3t19028H	0	-	841	2163	2195	0.9854214
C3	48617316	48620113	BolC3t19029H	0	-	118	1537	2797	0.5495173
C3	48623226	48624121	BolC3t19030H	0	-	635	895	895	1.0000000
C3	48644153	48645044	BolC3t19031H	0	-	655	891	891	1.0000000
C3	48658090	48660245	BolC3t19032H	0	+	4171	2155	2155	1.0000000
C3	48675758	48675992	BolC3t19033H	0	+	110	234	234	1.0000000
C3	48676993	48678644	BolC3t19034H	0	+	870	1580	1651	0.9569958
C3	48709028	48711160	BolC3t19035H	0	+	68	772	2132	0.3621013
C3	48728186	48730237	BolC3t19036H	0	+	36	608	2051	0.2964408
C3	48845165	48848583	BolC3t19037H	0	+	1269	3418	3418	1.0000000
C3	48862650	48862890	BolC3t19038H	0	-	316	240	240	1.0000000
C3	48897157	48897537	BolC3t19039H	0	+	283	380	380	1.0000000
C3	48903399	48907376	BolC3t19040H	0	+	168	2935	3977	0.7379935
C3	48947905	48948313	BolC3t19041H	0	+	278	408	408	1.0000000
C3	48951503	48962086	BolC3t19042H	0	+	3652	10573	10583	0.9990551
C3	48963544	48963757	BolC3t19043H	0	-	147	213	213	1.0000000
C3	48964126	48964806	BolC3t19044H	0	+	119	633	680	0.9308823
C3	48965128	48965557	BolC3t19045H	0	+	0	0	429	0.0000000
C3	48965863	48966208	BolC3t19046H	0	+	0	0	345	0.0000000
C3	49011545	49011860	BolC3t19047H	0	+	545	315	315	1.0000000
C3	49011950	49012076	BolC3t19048H	0	+	259	126	126	1.0000000
C3	49016154	49016675	BolC3t19049H	0	+	177	521	521	1.0000000
C3	49016690	49017398	BolC3t19050H	0	+	479	708	708	1.0000000
C3	49021615	49023429	BolC3t19051H	0	-	544	1814	1814	1.0000000
C3	49023604	49023709	BolC3t19052H	0	-	8	105	105	1.0000000
C3	49039114	49039414	BolC3t19053H	0	-	100	300	300	1.0000000
C3	49050119	49050479	BolC3t19054H	0	+	34	130	360	0.3611111
C3	49069965	49070270	BolC3t19055H	0	-	181	305	305	1.0000000
C3	49074800	49075202	BolC3t19056H	0	+	231	402	402	1.0000000
C3	49156382	49156577	BolC3t19057H	0	+	135	195	195	1.0000000
C3	49189905	49190199	BolC3t19058H	0	+	317	294	294	1.0000000
C3	49195368	49198107	BolC3t19059H	0	-	54	931	2739	0.3399051
C3	49231267	49234333	BolC3t19060H	0	+	1510	3007	3066	0.9807567
C3	49237664	49237895	BolC3t19061H	0	+	183	231	231	1.0000000
C3	49238523	49238904	BolC3t19062H	0	+	103	381	381	1.0000000
C3	49253380	49262126	BolC3t19063H	0	+	2104	8087	8746	0.9246513
C3	49262407	49262863	BolC3t19064H	0	+	37	204	456	0.4473684
C3	49298221	49298716	BolC3t19065H	0	+	481	495	495	1.0000000
C3	49301373	49302379	BolC3t19066H	0	-	357	1006	1006	1.0000000
C3	49309716	49310079	BolC3t19067H	0	+	272	363	363	1.0000000
C3	49320699	49321448	BolC3t19068H	0	+	426	749	749	1.0000000
C3	49550331	49552386	BolC3t19069H	0	+	55	951	2055	0.4627737
C3	49726600	49727258	BolC3t19070H	0	+	1100	658	658	1.0000000
C3	49730372	49734225	BolC3t19071H	0	-	73	682	3853	0.1770049
C3	49782371	49782527	BolC3t19072H	0	-	132	156	156	1.0000000
C3	49803283	49809091	BolC3t19073H	0	-	4136	5212	5808	0.8973829
C3	49822649	49824312	BolC3t19074H	0	-	1119	1663	1663	1.0000000
C3	49847040	49847439	BolC3t19075H	0	+	11	84	399	0.2105263
C3	49901847	49902477	BolC3t19076H	0	-	269	630	630	1.0000000
C3	49913668	49915386	BolC3t19077H	0	-	537	1712	1718	0.9965076
C3	49915822	49920330	BolC3t19078H	0	+	948	4336	4508	0.9618456
C3	49932677	49934029	BolC3t19079H	0	-	430	1223	1352	0.9045858
C3	49945196	49945496	BolC3t19080H	0	+	0	0	300	0.0000000
C3	49946230	49946819	BolC3t19081H	0	+	2	19	589	0.0322581
C3	49950085	49950670	BolC3t19082H	0	+	20	478	585	0.8170940
C3	49997962	50007477	BolC3t19083H	0	+	415	3555	9515	0.3736206
C3	50009748	50010144	BolC3t19084H	0	+	2	187	396	0.4722222
C3	50022102	50022946	BolC3t19085H	0	+	0	0	844	0.0000000
C3	50053471	50055467	BolC3t19086H	0	+	6	257	1996	0.1287575
C3	50058837	50059407	BolC3t19087H	0	+	49	570	570	1.0000000
C3	50059995	50060165	BolC3t19088H	0	-	1208	170	170	1.0000000
C3	50060306	50063723	BolC3t19089H	0	-	2707	3297	3417	0.9648815
C3	50086384	50087136	BolC3t19090H	0	+	0	0	752	0.0000000
C3	50114166	50114904	BolC3t19091H	0	+	0	0	738	0.0000000
C3	50124277	50128577	BolC3t19092H	0	-	696	1651	4300	0.3839535
C3	50129837	50130029	BolC3t19093H	0	+	68	192	192	1.0000000
C3	50130171	50130977	BolC3t19094H	0	+	559	806	806	1.0000000
C3	50138809	50139198	BolC3t19095H	0	-	4	211	389	0.5424165
C3	50141990	50142545	BolC3t19096H	0	-	29	476	555	0.8576577
C3	50157936	50160030	BolC3t19097H	0	-	218	1721	2094	0.8218720
C3	50171923	50172634	BolC3t19098H	0	+	0	0	711	0.0000000
C3	50173114	50177419	BolC3t19099H	0	+	33	543	4305	0.1261324
C3	50174581	50175758	BolC3t19100H	0	-	0	0	1177	0.0000000
C3	50186843	50192478	BolC3t19101H	0	-	648	3346	5635	0.5937888
C3	50203674	50204454	BolC3t19102H	0	+	244	780	780	1.0000000
C3	50233658	50234105	BolC3t19103H	0	-	261	447	447	1.0000000
C3	50239405	50239651	BolC3t19104H	0	+	415	246	246	1.0000000
C3	50243530	50244064	BolC3t19105H	0	+	2612	534	534	1.0000000
C3	50260770	50261197	BolC3t19106H	0	+	224	427	427	1.0000000
C3	50261347	50261464	BolC3t19107H	0	+	116	117	117	1.0000000
C3	50267476	50268187	BolC3t19108H	0	-	478	711	711	1.0000000
C3	50345426	50346332	BolC3t19109H	0	+	53	618	906	0.6821192
C3	50365956	50366241	BolC3t19110H	0	+	208	285	285	1.0000000
C3	50375898	50378565	BolC3t19111H	0	+	2369	2667	2667	1.0000000
C3	50378114	50378420	BolC3t19112H	0	+	469	306	306	1.0000000
C3	50390489	50391029	BolC3t19113H	0	-	246	540	540	1.0000000
C3	50397465	50399475	BolC3t19114H	0	+	56	969	2010	0.4820895
C3	50410220	50410487	BolC3t19115H	0	-	18	60	267	0.2247191
C3	50413762	50416982	BolC3t19116H	0	-	2788	3195	3220	0.9922360
C3	50418528	50420856	BolC3t19117H	0	+	614	2084	2328	0.8951890
C3	50422439	50422577	BolC3t19118H	0	-	225	138	138	1.0000000
C3	50426591	50431154	BolC3t19119H	0	-	4931	4436	4563	0.9721674
C3	50434535	50435995	BolC3t19120H	0	+	711	1460	1460	1.0000000
C3	50436824	50437211	BolC3t19121H	0	-	235	387	387	1.0000000
C3	50452770	50454175	BolC3t19122H	0	-	573	1110	1405	0.7900356
C3	50503180	50503531	BolC3t19123H	0	-	0	0	351	0.0000000
C3	50508986	50510360	BolC3t19124H	0	-	2268	1374	1374	1.0000000
C3	50513406	50513661	BolC3t19125H	0	-	179	255	255	1.0000000
C3	50530444	50532960	BolC3t19126H	0	+	1866	2493	2516	0.9908585
C3	50636445	50636967	BolC3t19127H	0	+	234	522	522	1.0000000
C3	50644266	50644958	BolC3t19128H	0	-	189	589	692	0.8511561
C3	50645160	50646085	BolC3t19129H	0	+	261	914	925	0.9881081
C3	50663125	50663449	BolC3t19130H	0	+	330	324	324	1.0000000
C3	50724009	50729399	BolC3t19131H	0	+	1370	4568	5390	0.8474954
C3	50729808	50730685	BolC3t19132H	0	-	258	860	877	0.9806157
C3	50742585	50743665	BolC3t19133H	0	+	575	1080	1080	1.0000000
C3	50746366	50747242	BolC3t19134H	0	-	0	0	876	0.0000000
C3	50750198	50750861	BolC3t19135H	0	+	270	663	663	1.0000000
C3	50759282	50760654	BolC3t19136H	0	-	128	1045	1372	0.7616618
C3	50765798	50765978	BolC3t19137H	0	+	200	180	180	1.0000000
C3	50770917	50771904	BolC3t19138H	0	-	140	886	987	0.8976697
C3	50773575	50774945	BolC3t19139H	0	+	527	1365	1370	0.9963503
C3	50775594	50777714	BolC3t19140H	0	-	307	1958	2120	0.9235849
C3	50794340	50803805	BolC3t19141H	0	+	2935	5429	9465	0.5735869
C3	50809883	50810638	BolC3t19142H	0	+	668	755	755	1.0000000
C3	50812152	50812626	BolC3t19143H	0	+	29	269	474	0.5675105
C3	50814372	50815498	BolC3t19144H	0	+	492	1126	1126	1.0000000
C3	50853838	50854206	BolC3t19145H	0	-	158	285	368	0.7744565
C3	50854967	50856170	BolC3t19146H	0	-	913	1203	1203	1.0000000
C3	50862089	50862476	BolC3t19147H	0	+	86	374	387	0.9664083
C3	50888678	50890104	BolC3t19148H	0	-	258	999	1426	0.7005610
C3	50903519	50905623	BolC3t19149H	0	+	12	166	2104	0.0788973
C3	50905630	50906837	BolC3t19150H	0	+	0	0	1207	0.0000000
C3	50908138	50908526	BolC3t19151H	0	+	0	0	388	0.0000000
C3	50953636	50954294	BolC3t19152H	0	+	94	638	658	0.9696048
C3	50978821	50980106	BolC3t19153H	0	-	912	1285	1285	1.0000000
C3	50990027	50990180	BolC3t19154H	0	+	37	123	153	0.8039216
C3	50991738	50992014	BolC3t19155H	0	+	254	276	276	1.0000000
C3	50997295	50997768	BolC3t19156H	0	+	350	473	473	1.0000000
C3	50999670	50999971	BolC3t19157H	0	-	7	151	301	0.5016611
C3	51021826	51023021	BolC3t19158H	0	-	980	1129	1195	0.9447699
C3	51023061	51026813	BolC3t19159H	0	+	1273	2794	3752	0.7446695
C3	51047505	51047859	BolC3t19160H	0	-	302	354	354	1.0000000
C3	51048489	51051787	BolC3t19161H	0	+	460	2445	3298	0.7413584
C3	51067297	51070859	BolC3t19162H	0	-	1035	2618	3562	0.7349803
C3	51078891	51079308	BolC3t19163H	0	-	274	417	417	1.0000000
C3	51086607	51086880	BolC3t19164H	0	+	13	273	273	1.0000000
C3	51125023	51126180	BolC3t19165H	0	-	736	1157	1157	1.0000000
C3	51129975	51134406	BolC3t19166H	0	-	1228	3868	4431	0.8729407
C3	51156535	51157373	BolC3t19167H	0	+	839	838	838	1.0000000
C3	51173289	51174787	BolC3t19168H	0	+	1119	1498	1498	1.0000000
C3	51178037	51181864	BolC3t19169H	0	+	1488	3377	3827	0.8824144
C3	51194127	51194403	BolC3t19170H	0	+	228	276	276	1.0000000
C3	51251212	51252803	BolC3t19171H	0	+	494	1063	1591	0.6681333
C3	51293784	51293961	BolC3t19172H	0	+	262	177	177	1.0000000
C3	51343098	51343659	BolC3t19173H	0	+	94	404	561	0.7201426
C3	51407153	51410721	BolC3t19174H	0	+	1711	3390	3568	0.9501121
C3	51427382	51428329	BolC3t19175H	0	+	566	947	947	1.0000000
C3	51428773	51428959	BolC3t19176H	0	+	134	186	186	1.0000000
C3	51536310	51537054	BolC3t19177H	0	+	378	742	744	0.9973118
C3	51537068	51537541	BolC3t19178H	0	+	3850	473	473	1.0000000
C3	51630945	51633109	BolC3t19179H	0	+	1482	2023	2164	0.9348429
C3	51638569	51640074	BolC3t19180H	0	+	374	1505	1505	1.0000000
C3	51645532	51648030	BolC3t19181H	0	+	941	2248	2498	0.8999199
C3	51648403	51648922	BolC3t19182H	0	+	298	519	519	1.0000000
C3	51649767	51649965	BolC3t19183H	0	-	204	198	198	1.0000000
C3	51650868	51651066	BolC3t19184H	0	+	158	198	198	1.0000000
C3	51657631	51658267	BolC3t19185H	0	-	70	590	636	0.9276730
C3	51663574	51663881	BolC3t19186H	0	-	426	307	307	1.0000000
C3	51664807	51665205	BolC3t19187H	0	-	523	398	398	1.0000000
C3	51708312	51708662	BolC3t19188H	0	+	160	350	350	1.0000000
C3	51709045	51709309	BolC3t19189H	0	+	118	264	264	1.0000000
C3	51711925	51718707	BolC3t19190H	0	+	1313	5888	6782	0.8681805
C3	51730379	51734197	BolC3t19191H	0	+	3680	3462	3818	0.9067575
C3	51735693	51736049	BolC3t19192H	0	-	99	350	356	0.9831461
C3	51760945	51761632	BolC3t19193H	0	+	1	44	687	0.0640466
C3	51762805	51764488	BolC3t19194H	0	+	303	1640	1683	0.9744504
C3	51765692	51767343	BolC3t19195H	0	-	434	1543	1651	0.9345851
C3	51768467	51768989	BolC3t19196H	0	+	399	522	522	1.0000000
C3	51781702	51781954	BolC3t19197H	0	-	200	252	252	1.0000000
C3	51784047	51784287	BolC3t19198H	0	-	197	240	240	1.0000000
C3	51801386	51803460	BolC3t19199H	0	+	574	1939	2074	0.9349084
C3	51825979	51826819	BolC3t19200H	0	+	155	722	840	0.8595238
C3	51890923	51892044	BolC3t19201H	0	-	69	779	1121	0.6949152
C3	51915684	51919985	BolC3t19202H	0	-	473	3034	4301	0.7054173
C3	51924892	51925033	BolC3t19203H	0	-	333	141	141	1.0000000
C3	51964016	51964262	BolC3t19204H	0	-	45	246	246	1.0000000
C3	52036983	52039734	BolC3t19205H	0	-	1088	2712	2751	0.9858233
C3	52045394	52045607	BolC3t19206H	0	-	212	213	213	1.0000000
C3	52060884	52062033	BolC3t19207H	0	+	58	739	1149	0.6431680
C3	52063088	52064379	BolC3t19208H	0	+	220	1187	1291	0.9194423
C3	52093430	52094086	BolC3t19209H	0	+	156	632	656	0.9634146
C3	52094834	52096394	BolC3t19210H	0	-	717	1339	1560	0.8583333
C3	52096860	52096989	BolC3t19211H	0	+	30	129	129	1.0000000
C3	52097155	52097379	BolC3t19212H	0	-	17	224	224	1.0000000
C3	52119166	52120701	BolC3t19213H	0	+	60	447	1535	0.2912052
C3	52154857	52156456	BolC3t19214H	0	+	129	819	1599	0.5121951
C3	52156803	52157286	BolC3t19215H	0	+	246	483	483	1.0000000
C3	52158924	52159227	BolC3t19216H	0	+	277	303	303	1.0000000
C3	52159491	52159610	BolC3t19217H	0	+	53	119	119	1.0000000
C3	52188912	52189941	BolC3t19218H	0	+	887	1029	1029	1.0000000
C3	52197575	52199707	BolC3t19219H	0	-	1185	1959	2132	0.9188555
C3	52239842	52246887	BolC3t19220H	0	+	4539	7045	7045	1.0000000
C3	52247003	52247405	BolC3t19221H	0	+	351	402	402	1.0000000
C3	52262912	52265426	BolC3t19222H	0	+	272	1892	2514	0.7525855
C3	52265698	52266106	BolC3t19223H	0	-	55	362	408	0.8872549
C3	52272800	52274114	BolC3t19224H	0	-	172	1297	1314	0.9870624
C3	52367353	52367959	BolC3t19225H	0	+	7	252	606	0.4158416
C3	52373688	52374234	BolC3t19226H	0	-	162	546	546	1.0000000
C3	52379802	52390027	BolC3t19227H	0	-	4201	8617	10225	0.8427384
C3	52382846	52383341	BolC3t19228H	0	-	1086	495	495	1.0000000
C3	52409162	52410287	BolC3t19229H	0	-	521	1125	1125	1.0000000
C3	52413634	52414393	BolC3t19230H	0	+	221	682	759	0.8985507
C3	52486399	52486738	BolC3t19231H	0	+	289	339	339	1.0000000
C3	52487219	52488495	BolC3t19232H	0	-	214	1133	1276	0.8879310
C3	52501327	52501735	BolC3t19233H	0	+	346	408	408	1.0000000
C3	52502317	52502572	BolC3t19234H	0	-	47	255	255	1.0000000
C3	52509245	52509672	BolC3t19235H	0	+	0	0	427	0.0000000
C3	52509824	52510747	BolC3t19236H	0	+	40	572	923	0.6197183
C3	52513741	52513885	BolC3t19237H	0	-	0	0	144	0.0000000
C3	52602120	52602770	BolC3t19238H	0	+	560	650	650	1.0000000
C3	52603945	52604597	BolC3t19239H	0	-	567	652	652	1.0000000
C3	52632806	52636336	BolC3t19240H	0	-	745	2284	3530	0.6470255
C3	52647784	52648976	BolC3t19241H	0	-	142	701	1192	0.5880873
C3	52659575	52665140	BolC3t19242H	0	-	1221	4270	5565	0.7672956
C3	52690617	52699904	BolC3t19243H	0	-	1229	7808	9287	0.8407452
C3	52840818	52840998	BolC3t19244H	0	+	123	180	180	1.0000000
C3	52841074	52841176	BolC3t19245H	0	+	122	102	102	1.0000000
C3	52847032	52847542	BolC3t19246H	0	+	425	500	510	0.9803922
C3	52893060	52893874	BolC3t19247H	0	-	294	598	814	0.7346438
C3	52913852	52915441	BolC3t19248H	0	-	242	1443	1589	0.9081183
C3	52944848	52945380	BolC3t19249H	0	-	56	456	532	0.8571429
C3	52945650	52947359	BolC3t19250H	0	-	273	1662	1709	0.9724985
C3	52951284	52959900	BolC3t19251H	0	-	2180	6895	8616	0.8002554
C3	52984435	52986484	BolC3t19252H	0	-	20	494	2049	0.2410932
C3	53004086	53005645	BolC3t19253H	0	+	283	1160	1559	0.7440667
C3	53016839	53018921	BolC3t19254H	0	-	283	1547	2082	0.7430356
C3	53019710	53021801	BolC3t19255H	0	-	323	1504	2091	0.7192731
C3	53030658	53032686	BolC3t19256H	0	-	2175	1986	2028	0.9792899
C3	53037852	53040134	BolC3t19257H	0	-	534	2028	2282	0.8886941
C3	53042007	53042563	BolC3t19258H	0	-	632	556	556	1.0000000
C3	53043153	53058623	BolC3t19259H	0	-	8304	14596	15470	0.9435036
C3	53054433	53054693	BolC3t19260H	0	-	293	260	260	1.0000000
C3	53055679	53055950	BolC3t19261H	0	-	175	271	271	1.0000000
C3	53084100	53085672	BolC3t19262H	0	-	203	822	1572	0.5229008
C3	53101403	53101769	BolC3t19263H	0	-	156	366	366	1.0000000
C3	53109535	53110723	BolC3t19264H	0	+	117	1188	1188	1.0000000
C3	53129863	53131883	BolC3t19265H	0	+	547	1744	2020	0.8633664
C3	53137650	53141770	BolC3t19266H	0	-	711	2815	4120	0.6832525
C3	53145391	53145689	BolC3t19267H	0	+	30	298	298	1.0000000
C3	53150543	53152076	BolC3t19268H	0	+	278	1292	1533	0.8427919
C3	53152816	53154951	BolC3t19269H	0	+	221	1205	2135	0.5644028
C3	53175032	53176679	BolC3t19270H	0	+	90	1009	1647	0.6126290
C3	53200447	53202807	BolC3t19271H	0	-	506	2253	2360	0.9546610
C3	53204106	53204811	BolC3t19272H	0	+	274	705	705	1.0000000
C3	53205585	53207915	BolC3t19273H	0	+	1370	2261	2330	0.9703863
C3	53209201	53211564	BolC3t19274H	0	-	944	2363	2363	1.0000000
C3	53251015	53252455	BolC3t19275H	0	+	6	203	1440	0.1409722
C3	53253797	53253914	BolC3t19276H	0	+	308	117	117	1.0000000
C3	53253806	53269518	BolC3t19277H	0	-	2880	5653	15712	0.3597887
C3	53292963	53298831	BolC3t19278H	0	-	599	4055	5868	0.6910361
C3	53300014	53300386	BolC3t19279H	0	+	371	372	372	1.0000000
C3	53331970	53335231	BolC3t19280H	0	+	113	1104	3261	0.3385465
C3	53350575	53351983	BolC3t19281H	0	+	5	503	1408	0.3572443
C3	53352520	53352853	BolC3t19282H	0	+	6	46	333	0.1381381
C3	53353286	53353478	BolC3t19283H	0	-	18	192	192	1.0000000
C3	53364339	53365014	BolC3t19284H	0	-	89	329	675	0.4874074
C3	53365823	53374111	BolC3t19285H	0	+	482	4179	8288	0.5042230
C3	53374647	53381099	BolC3t19286H	0	-	1373	6026	6452	0.9339740
C3	53378074	53378292	BolC3t19287H	0	-	9	185	218	0.8486239
C3	53384680	53386474	BolC3t19288H	0	+	66	844	1794	0.4704571
C3	53387269	53388713	BolC3t19289H	0	-	937	1444	1444	1.0000000
C3	53388868	53391251	BolC3t19290H	0	+	1249	2347	2383	0.9848930
C3	53391530	53392950	BolC3t19291H	0	-	374	1197	1420	0.8429577
C3	53423487	53423799	BolC3t19292H	0	+	77	281	312	0.9006410
C3	53425347	53425746	BolC3t19293H	0	-	405	399	399	1.0000000
C3	53426530	53427639	BolC3t19294H	0	-	276	1055	1109	0.9513075
C3	53439947	53440139	BolC3t19295H	0	+	98	192	192	1.0000000
C3	53454041	53454892	BolC3t19296H	0	+	355	839	851	0.9858990
C3	53470391	53471006	BolC3t19297H	0	-	145	615	615	1.0000000
C3	53471923	53472052	BolC3t19298H	0	-	143	129	129	1.0000000
C3	53538498	53538633	BolC3t19299H	0	+	52	135	135	1.0000000
C3	53540883	53541018	BolC3t19300H	0	+	716	135	135	1.0000000
C3	53555505	53556516	BolC3t19301H	0	+	27	466	1011	0.4609298
C3	53574049	53574653	BolC3t19302H	0	-	270	604	604	1.0000000
C3	53575916	53578892	BolC3t19303H	0	-	365	1211	2976	0.4069220
C3	53582669	53585035	BolC3t19304H	0	-	582	1661	2366	0.7020288
C3	53606720	53606920	BolC3t19305H	0	-	280	200	200	1.0000000
C3	53625487	53670132	BolC3t19306H	0	+	13365	42568	44645	0.9534774
C3	53688091	53688525	BolC3t19307H	0	-	197	434	434	1.0000000
C3	53694087	53702355	BolC3t19308H	0	+	1348	2388	8268	0.2888244
C3	53702667	53703192	BolC3t19309H	0	+	0	0	525	0.0000000
C3	53712697	53713941	BolC3t19310H	0	+	9	64	1244	0.0514469
C3	53714204	53715653	BolC3t19311H	0	-	1	32	1449	0.0220842
C3	53740206	53740653	BolC3t19312H	0	-	117	447	447	1.0000000
C3	53747907	53750108	BolC3t19313H	0	+	233	1818	2201	0.8259882
C3	53751734	53756960	BolC3t19314H	0	-	2992	4539	5226	0.8685419
C3	53757106	53758268	BolC3t19315H	0	-	50	533	1162	0.4586919
C3	53761562	53765929	BolC3t19316H	0	+	872	4028	4367	0.9223723
C3	53767431	53767845	BolC3t19317H	0	+	29	42	414	0.1014493
C3	53775075	53775492	BolC3t19318H	0	+	157	416	417	0.9976019
C3	53776340	53778845	BolC3t19319H	0	-	405	1923	2505	0.7676647
C3	53786222	53788583	BolC3t19320H	0	-	0	0	2361	0.0000000
C3	53791919	53792787	BolC3t19321H	0	-	820	868	868	1.0000000
C3	53820544	53823597	BolC3t19322H	0	+	1191	2438	3053	0.7985588
C3	53826710	53827523	BolC3t19323H	0	-	0	0	813	0.0000000
C3	53828242	53835693	BolC3t19324H	0	+	5075	6570	7451	0.8817608
C3	53835909	53836814	BolC3t19325H	0	+	102	821	905	0.9071823
C3	53838460	53839412	BolC3t19326H	0	-	125	457	952	0.4800420
C3	53852857	53853160	BolC3t19327H	0	+	99	303	303	1.0000000
C3	53853251	53854237	BolC3t19328H	0	+	499	986	986	1.0000000
C3	53854512	53856201	BolC3t19329H	0	+	712	1689	1689	1.0000000
C3	53864014	53864510	BolC3t19330H	0	+	312	496	496	1.0000000
C3	53872010	53872323	BolC3t19331H	0	-	190	313	313	1.0000000
C3	53880598	53880799	BolC3t19332H	0	+	161	201	201	1.0000000
C3	53885956	53886430	BolC3t19333H	0	+	3	187	474	0.3945148
C3	53886749	53891361	BolC3t19334H	0	-	365	2866	4612	0.6214224
C3	53891927	53893420	BolC3t19335H	0	+	649	1493	1493	1.0000000
C3	53893779	53895502	BolC3t19336H	0	-	1071	1723	1723	1.0000000
C3	53899579	53901979	BolC3t19337H	0	-	2013	2400	2400	1.0000000
C3	53907628	53907880	BolC3t19338H	0	-	238	252	252	1.0000000
C3	53909960	53910484	BolC3t19339H	0	-	0	0	524	0.0000000
C3	53910796	53911450	BolC3t19340H	0	-	20	250	654	0.3822630
C3	53911466	53911952	BolC3t19341H	0	-	5	241	486	0.4958848
C3	53938700	53938814	BolC3t19342H	0	-	52	114	114	1.0000000
C3	53941106	53941334	BolC3t19343H	0	+	165	228	228	1.0000000
C3	53957325	53957643	BolC3t19344H	0	+	0	0	318	0.0000000
C3	53969085	53970357	BolC3t19345H	0	-	58	248	1272	0.1949686
C3	54091148	54091319	BolC3t19346H	0	-	120	171	171	1.0000000
C3	54092798	54093056	BolC3t19347H	0	+	182	258	258	1.0000000
C3	54128323	54128530	BolC3t19348H	0	+	73	207	207	1.0000000
C3	54132887	54133403	BolC3t19349H	0	-	822	516	516	1.0000000
C3	54144660	54145746	BolC3t19350H	0	-	196	948	1086	0.8729282
C3	54148521	54148900	BolC3t19351H	0	+	152	379	379	1.0000000
C3	54161262	54161472	BolC3t19352H	0	-	2935	210	210	1.0000000
C3	54168141	54168541	BolC3t19353H	0	-	188	400	400	1.0000000
C3	54169441	54170410	BolC3t19354H	0	+	92	947	969	0.9772962
C3	54173602	54179633	BolC3t19355H	0	-	2238	5693	6031	0.9439563
C3	54175039	54175272	BolC3t19356H	0	-	25	233	233	1.0000000
C3	54193591	54202359	BolC3t19357H	0	+	2213	8306	8768	0.9473084
C3	54203933	54205721	BolC3t19358H	0	-	306	1788	1788	1.0000000
C3	54209984	54210508	BolC3t19359H	0	-	7	320	524	0.6106870
C3	54226596	54230802	BolC3t19360H	0	-	1819	3893	4206	0.9255825
C3	54247275	54254740	BolC3t19361H	0	-	3662	6460	7465	0.8653718
C3	54256064	54256310	BolC3t19362H	0	-	169	246	246	1.0000000
C3	54273161	54273437	BolC3t19363H	0	-	146	276	276	1.0000000
C3	54273755	54273980	BolC3t19364H	0	-	150	225	225	1.0000000
C3	54278007	54278634	BolC3t19365H	0	-	251	620	627	0.9888358
C3	54279745	54282923	BolC3t19366H	0	-	1030	3053	3178	0.9606671
C3	54284252	54285810	BolC3t19367H	0	+	238	1110	1558	0.7124519
C3	54290326	54290906	BolC3t19368H	0	+	14	293	580	0.5051724
C3	54292250	54293782	BolC3t19369H	0	+	284	981	1532	0.6403394
C3	54301379	54302101	BolC3t19370H	0	+	98	479	722	0.6634349
C3	54302220	54302596	BolC3t19371H	0	+	8	154	376	0.4095745
C3	54302993	54303503	BolC3t19372H	0	+	53	331	510	0.6490196
C3	54308261	54309606	BolC3t19373H	0	+	79	443	1345	0.3293680
C3	54320274	54320688	BolC3t19374H	0	-	9	288	414	0.6956522
C3	54322444	54324152	BolC3t19375H	0	-	119	1153	1708	0.6750585
C3	54337794	54338544	BolC3t19376H	0	+	533	750	750	1.0000000
C3	54340021	54341206	BolC3t19377H	0	-	355	986	1185	0.8320675
C3	54361480	54378130	BolC3t19378H	0	+	4414	11332	16650	0.6806006
C3	54375698	54375960	BolC3t19379H	0	-	1289	262	262	1.0000000
C3	54378193	54382362	BolC3t19380H	0	+	1420	4006	4169	0.9609019
C3	54388359	54388656	BolC3t19381H	0	-	236	297	297	1.0000000
C3	54389718	54389892	BolC3t19382H	0	-	142	174	174	1.0000000
C3	54407931	54421733	BolC3t19383H	0	+	2094	5522	13802	0.4000869
C3	54440221	54441325	BolC3t19384H	0	+	514	1048	1104	0.9492754
C3	54442742	54443742	BolC3t19385H	0	+	803	1000	1000	1.0000000
C3	54464570	54465188	BolC3t19386H	0	+	115	618	618	1.0000000
C3	54465320	54467604	BolC3t19387H	0	+	380	2159	2284	0.9452714
C3	54471839	54472127	BolC3t19388H	0	+	48	251	288	0.8715278
C3	54472905	54473577	BolC3t19389H	0	-	95	656	672	0.9761904
C3	54476828	54477990	BolC3t19390H	0	-	92	666	1162	0.5731497
C3	54479841	54480303	BolC3t19391H	0	+	89	390	462	0.8441558
C3	54490105	54492057	BolC3t19392H	0	-	314	1732	1952	0.8872951
C3	54493673	54494377	BolC3t19393H	0	-	814	704	704	1.0000000
C3	54499798	54500769	BolC3t19394H	0	-	321	971	971	1.0000000
C3	54502213	54503857	BolC3t19395H	0	+	443	1562	1644	0.9501216
C3	54504202	54504811	BolC3t19396H	0	-	250	609	609	1.0000000
C3	54505014	54506352	BolC3t19397H	0	+	155	861	1338	0.6434978
C3	54506707	54513438	BolC3t19398H	0	-	1080	3512	6731	0.5217650
C3	54513896	54514133	BolC3t19399H	0	+	165	237	237	1.0000000
C3	54513925	54520499	BolC3t19400H	0	+	3551	6552	6574	0.9966535
C3	54520882	54525167	BolC3t19401H	0	-	587	2615	4285	0.6102684
C3	54528231	54529079	BolC3t19402H	0	-	113	836	848	0.9858491
C3	54587046	54588606	BolC3t19403H	0	+	188	1270	1560	0.8141026
C3	54589553	54592201	BolC3t19404H	0	-	625	1945	2648	0.7345166
C3	54594862	54596226	BolC3t19405H	0	-	198	1022	1364	0.7492669
C3	54621200	54623689	BolC3t19406H	0	-	749	2349	2489	0.9437525
C3	54634207	54634936	BolC3t19407H	0	-	478	729	729	1.0000000
C3	54659573	54659771	BolC3t19408H	0	-	0	0	198	0.0000000
C3	54660026	54660554	BolC3t19409H	0	-	0	0	528	0.0000000
C3	54665512	54668174	BolC3t19410H	0	-	419	2365	2662	0.8884298
C3	54723530	54725928	BolC3t19411H	0	-	258	1624	2398	0.6772310
C3	54735123	54735931	BolC3t19412H	0	-	25	239	808	0.2957921
C3	54736017	54737198	BolC3t19413H	0	-	0	0	1181	0.0000000
C3	54739308	54742811	BolC3t19414H	0	+	1427	3428	3503	0.9785898
C3	54743343	54743721	BolC3t19415H	0	-	96	328	378	0.8677249
C3	54748588	54749524	BolC3t19416H	0	-	30	546	936	0.5833333
C3	54751103	54753241	BolC3t19417H	0	-	1187	2138	2138	1.0000000
C3	54761126	54762651	BolC3t19418H	0	-	2491	1525	1525	1.0000000
C3	54767222	54767432	BolC3t19419H	0	+	0	0	210	0.0000000
C3	54780205	54781210	BolC3t19420H	0	-	390	1005	1005	1.0000000
C3	54781324	54784771	BolC3t19421H	0	-	1391	3269	3447	0.9483609
C3	54795183	54798345	BolC3t19422H	0	-	869	2431	3162	0.7688172
C3	54799259	54800461	BolC3t19423H	0	-	592	1163	1202	0.9675541
C3	54802842	54804472	BolC3t19424H	0	-	408	1566	1630	0.9607362
C3	54829651	54830001	BolC3t19425H	0	+	20	334	350	0.9542857
C3	54836931	54840285	BolC3t19426H	0	-	1291	2167	3354	0.6460942
C3	54855251	54855383	BolC3t19427H	0	+	0	0	132	0.0000000
C3	54883962	54886167	BolC3t19428H	0	-	205	772	2205	0.3501134
C3	54899874	54900431	BolC3t19429H	0	-	238	557	557	1.0000000
C3	55011983	55012406	BolC3t19430H	0	+	429	423	423	1.0000000
C3	55026364	55042016	BolC3t19431H	0	+	11565	9404	15652	0.6008178
C3	55034829	55035824	BolC3t19432H	0	-	2	145	995	0.1457286
C3	55038804	55039101	BolC3t19433H	0	-	1238	297	297	1.0000000
C3	55040881	55043355	BolC3t19434H	0	+	731	1025	2474	0.4143088
C3	55073581	55073903	BolC3t19435H	0	-	0	0	322	0.0000000
C3	55074114	55074357	BolC3t19436H	0	+	122	102	243	0.4197531
C3	55075139	55075748	BolC3t19437H	0	+	38	350	609	0.5747126
C3	55083169	55085607	BolC3t19438H	0	+	385	2008	2438	0.8236259
C3	55088541	55090709	BolC3t19439H	0	+	723	2073	2168	0.9561808
C3	55091896	55092586	BolC3t19440H	0	-	377	690	690	1.0000000
C3	55106058	55106753	BolC3t19441H	0	-	67	685	695	0.9856115
C3	55112134	55112392	BolC3t19442H	0	-	11	258	258	1.0000000
C3	55114173	55115175	BolC3t19443H	0	+	209	638	1002	0.6367266
C3	55118509	55118962	BolC3t19444H	0	+	17	177	453	0.3907285
C3	55141133	55141544	BolC3t19445H	0	-	84	252	411	0.6131387
C3	55143128	55144795	BolC3t19446H	0	-	261	1339	1667	0.8032393
C3	55173428	55174520	BolC3t19447H	0	+	1535	1092	1092	1.0000000
C3	55180647	55181583	BolC3t19448H	0	+	94	738	936	0.7884616
C3	55182229	55183181	BolC3t19449H	0	+	189	931	952	0.9779412
C3	55183387	55186238	BolC3t19450H	0	-	1358	2522	2851	0.8846019
C3	55188437	55195009	BolC3t19451H	0	+	665	4945	6572	0.7524346
C3	55195436	55196668	BolC3t19452H	0	-	148	674	1232	0.5470779
C3	55204413	55204965	BolC3t19453H	0	-	2	50	552	0.0905797
C3	55212402	55212840	BolC3t19454H	0	-	43	229	438	0.5228310
C3	55263327	55265003	BolC3t19455H	0	+	3367	1676	1676	1.0000000
C3	55270791	55272315	BolC3t19456H	0	+	425	1470	1524	0.9645669
C3	55275359	55275857	BolC3t19457H	0	+	143	498	498	1.0000000
C3	55291398	55291554	BolC3t19458H	0	-	9	96	156	0.6153846
C3	55301390	55301525	BolC3t19459H	0	-	281	135	135	1.0000000
C3	55318988	55319159	BolC3t19460H	0	+	113	171	171	1.0000000
C3	55328715	55329311	BolC3t19461H	0	+	38	505	596	0.8473154
C3	55342577	55345908	BolC3t19462H	0	+	760	2768	3331	0.8309817
C3	55348315	55350029	BolC3t19463H	0	+	1384	1714	1714	1.0000000
C3	55360869	55361344	BolC3t19464H	0	-	396	475	475	1.0000000
C3	55361784	55362741	BolC3t19465H	0	-	25	268	957	0.2800418
C3	55371061	55373079	BolC3t19466H	0	-	573	1893	2018	0.9380575
C3	55377735	55386060	BolC3t19467H	0	-	4395	7080	8325	0.8504505
C3	55380948	55381585	BolC3t19468H	0	-	205	278	637	0.4364207
C3	55386856	55389970	BolC3t19469H	0	+	1380	2833	3114	0.9097624
C3	55392093	55394136	BolC3t19470H	0	+	618	1748	2043	0.8556045
C3	55429919	55431341	BolC3t19471H	0	+	351	1171	1422	0.8234881
C3	55432710	55432965	BolC3t19472H	0	-	90	255	255	1.0000000
C3	55434107	55434362	BolC3t19473H	0	-	95	255	255	1.0000000
C3	55454202	55456046	BolC3t19474H	0	-	1355	1844	1844	1.0000000
C3	55488586	55488769	BolC3t19475H	0	-	259	183	183	1.0000000
C3	55489321	55492278	BolC3t19476H	0	-	683	2912	2957	0.9847819
C3	55507079	55507455	BolC3t19477H	0	-	21	294	376	0.7819149
C3	55507374	55517664	BolC3t19478H	0	-	1449	6655	10290	0.6467444
C3	55526845	55530398	BolC3t19479H	0	+	880	3553	3553	1.0000000
C3	55535521	55535839	BolC3t19480H	0	+	288	318	318	1.0000000
C3	55537443	55538205	BolC3t19481H	0	-	456	712	762	0.9343832
C3	55544929	55545518	BolC3t19482H	0	+	36	492	589	0.8353141
C3	55546534	55548143	BolC3t19483H	0	+	89	1338	1609	0.8315724
C3	55548186	55549525	BolC3t19484H	0	-	22	804	1339	0.6004481
C3	55551600	55552260	BolC3t19485H	0	-	63	633	660	0.9590909
C3	55552868	55553431	BolC3t19486H	0	-	62	539	563	0.9573712
C3	55554473	55554740	BolC3t19487H	0	+	13	146	267	0.5468165
C3	55559491	55561462	BolC3t19488H	0	+	682	1754	1971	0.8899036
C3	55579677	55584526	BolC3t19489H	0	+	2234	4833	4849	0.9967003
C3	55585748	55588370	BolC3t19490H	0	-	378	2208	2622	0.8421053
C3	55613515	55614290	BolC3t19491H	0	+	245	775	775	1.0000000
C3	55620865	55625180	BolC3t19492H	0	-	1303	3805	4315	0.8818076
C3	55627122	55627368	BolC3t19493H	0	-	430	246	246	1.0000000
C3	55636797	55641527	BolC3t19494H	0	+	782	4015	4730	0.8488372
C3	55642139	55646527	BolC3t19495H	0	+	459	2904	4388	0.6618049
C3	55648886	55653319	BolC3t19496H	0	+	1515	4192	4433	0.9456350
C3	55658802	55661393	BolC3t19497H	0	+	558	1959	2591	0.7560787
C3	55661503	55667750	BolC3t19498H	0	-	3016	5887	6247	0.9423723
C3	55668920	55670081	BolC3t19499H	0	-	926	1111	1161	0.9569337
C3	55671186	55671414	BolC3t19500H	0	+	0	0	228	0.0000000
C3	55675041	55675959	BolC3t19501H	0	+	685	918	918	1.0000000
C3	55705677	55706292	BolC3t19502H	0	+	5	256	615	0.4162602
C3	55730489	55732100	BolC3t19503H	0	+	308	1115	1611	0.6921167
C3	55734797	55735592	BolC3t19504H	0	+	637	795	795	1.0000000
C3	55736140	55736965	BolC3t19505H	0	-	427	825	825	1.0000000
C3	55737459	55738940	BolC3t19506H	0	-	642	1388	1481	0.9372046
C3	55747794	55750332	BolC3t19507H	0	+	512	1826	2538	0.7194641
C3	55750894	55752023	BolC3t19508H	0	-	123	751	1129	0.6651905
C3	55754719	55755795	BolC3t19509H	0	-	32	416	1076	0.3866171
C3	55760516	55761011	BolC3t19510H	0	-	10	39	495	0.0787879
C3	55786427	55787953	BolC3t19511H	0	+	707	1294	1526	0.8479685
C3	55788723	55791317	BolC3t19512H	0	-	594	2293	2594	0.8839630
C3	55814862	55816851	BolC3t19513H	0	-	489	1977	1989	0.9939668
C3	55818886	55820179	BolC3t19514H	0	-	39	498	1293	0.3851508
C3	55821123	55827391	BolC3t19515H	0	+	58	1204	6268	0.1920868
C3	55829570	55830647	BolC3t19516H	0	-	478	1077	1077	1.0000000
C3	55833559	55834339	BolC3t19517H	0	-	586	780	780	1.0000000
C3	55864631	55865216	BolC3t19518H	0	+	31	292	585	0.4991453
C3	55871310	55874015	BolC3t19519H	0	+	1545	2705	2705	1.0000000
C3	55878520	55878913	BolC3t19520H	0	+	293	393	393	1.0000000
C3	55934946	55935282	BolC3t19521H	0	+	136	336	336	1.0000000
C3	55940232	55942739	BolC3t19522H	0	+	3557	2507	2507	1.0000000
C3	55953198	55954238	BolC3t19523H	0	+	680	1040	1040	1.0000000
C3	55955158	55956169	BolC3t19524H	0	-	461	1011	1011	1.0000000
C3	55958905	55960868	BolC3t19525H	0	+	1547	1963	1963	1.0000000
C3	55961352	55961751	BolC3t19526H	0	-	150	399	399	1.0000000
C3	55964449	55964917	BolC3t19527H	0	-	286	468	468	1.0000000
C3	55972723	55975374	BolC3t19528H	0	-	1652	2651	2651	1.0000000
C3	55982303	55987785	BolC3t19529H	0	-	2267	4609	5482	0.8407515
C3	55989194	55989386	BolC3t19530H	0	-	163	192	192	1.0000000
C3	55991973	55993055	BolC3t19531H	0	+	464	1082	1082	1.0000000
C3	56003558	56011385	BolC3t19532H	0	-	4142	7827	7827	1.0000000
C3	56015013	56015353	BolC3t19533H	0	-	266	340	340	1.0000000
C3	56015493	56015772	BolC3t19534H	0	+	136	279	279	1.0000000
C3	56016104	56016371	BolC3t19535H	0	+	117	267	267	1.0000000
C3	56017681	56019380	BolC3t19536H	0	-	261	1569	1699	0.9234844
C3	56024628	56027382	BolC3t19537H	0	+	1692	2654	2754	0.9636892
C3	56028163	56029735	BolC3t19538H	0	+	137	724	1572	0.4605598
C3	56032814	56034395	BolC3t19539H	0	+	75	385	1581	0.2435168
C3	56035095	56036490	BolC3t19540H	0	+	1169	1395	1395	1.0000000
C3	56041162	56042259	BolC3t19541H	0	+	598	1097	1097	1.0000000
C3	56050814	56051651	BolC3t19542H	0	-	455	837	837	1.0000000
C3	56063411	56063816	BolC3t19543H	0	-	231	405	405	1.0000000
C3	56065057	56070300	BolC3t19544H	0	+	837	3339	5243	0.6368491
C3	56087664	56089260	BolC3t19545H	0	+	4	68	1596	0.0426065
C3	56098783	56100990	BolC3t19546H	0	-	163	1381	2207	0.6257363
C3	56111769	56112357	BolC3t19547H	0	+	3	34	588	0.0578231
C3	56122239	56122865	BolC3t19548H	0	-	335	626	626	1.0000000
C3	56126476	56129736	BolC3t19549H	0	+	397	1833	3260	0.5622699
C3	56136266	56140937	BolC3t19550H	0	+	806	3264	4671	0.6987797
C3	56149598	56153222	BolC3t19551H	0	+	85	1151	3624	0.3176049
C3	56165416	56167273	BolC3t19552H	0	+	361	1599	1857	0.8610662
C3	56180137	56218821	BolC3t19553H	0	-	26722	28312	38684	0.7318788
C3	56200506	56200830	BolC3t19554H	0	-	109	324	324	1.0000000
C3	56231287	56232841	BolC3t19555H	0	-	37187	1492	1554	0.9601030
C3	56241096	56241675	BolC3t19556H	0	-	146	569	579	0.9827288
C3	56244175	56244592	BolC3t19557H	0	-	175	417	417	1.0000000
C3	56247352	56248826	BolC3t19558H	0	+	492	1442	1474	0.9782904
C3	56251870	56252487	BolC3t19559H	0	+	483	617	617	1.0000000
C3	56266992	56268489	BolC3t19560H	0	+	167	1053	1497	0.7034068
C3	56273521	56273755	BolC3t19561H	0	-	4	222	234	0.9487180
C3	56274946	56285081	BolC3t19562H	0	-	1619	5132	10135	0.5063641
C3	56289552	56290517	BolC3t19563H	0	+	447	891	965	0.9233161
C3	56296756	56300121	BolC3t19564H	0	+	1006	3355	3365	0.9970282
C3	56300489	56302085	BolC3t19565H	0	-	1044	1596	1596	1.0000000
C3	56303402	56304207	BolC3t19566H	0	+	522	805	805	1.0000000
C3	56313995	56316168	BolC3t19567H	0	+	1247	2159	2173	0.9935573
C3	56317056	56317416	BolC3t19568H	0	+	125	325	360	0.9027778
C3	56319179	56321503	BolC3t19569H	0	+	628	1914	2324	0.8235800
C3	56322403	56325181	BolC3t19570H	0	+	465	1888	2778	0.6796256
C3	56325636	56326983	BolC3t19571H	0	+	489	1331	1347	0.9881217
C3	56327050	56328979	BolC3t19572H	0	-	472	1821	1929	0.9440125
C3	56329975	56331394	BolC3t19573H	0	+	697	1419	1419	1.0000000
C3	56331684	56333511	BolC3t19574H	0	-	622	1685	1827	0.9222770
C3	56355600	56357834	BolC3t19575H	0	-	434	1761	2234	0.7882721
C3	56367582	56367744	BolC3t19576H	0	-	123	162	162	1.0000000
C3	56371360	56373232	BolC3t19577H	0	-	75	908	1872	0.4850427
C3	56376191	56376380	BolC3t19578H	0	-	269	189	189	1.0000000
C3	56377325	56380567	BolC3t19579H	0	-	311	1124	3242	0.3466996
C3	56380587	56381263	BolC3t19580H	0	-	42	73	676	0.1079882
C3	56410821	56411880	BolC3t19581H	0	+	206	899	1059	0.8489141
C3	56418458	56422288	BolC3t19582H	0	+	1713	3705	3830	0.9673629
C3	56426600	56430535	BolC3t19583H	0	+	3047	3812	3935	0.9687421
C3	56431309	56433188	BolC3t19584H	0	-	1414	1879	1879	1.0000000
C3	56434710	56436159	BolC3t19585H	0	+	113	1190	1449	0.8212560
C3	56438681	56440890	BolC3t19586H	0	+	759	1851	2209	0.8379357
C3	56442115	56443218	BolC3t19587H	0	-	1	47	1103	0.0426111
C3	56453979	56456948	BolC3t19588H	0	-	1618	2969	2969	1.0000000
C3	56459875	56462124	BolC3t19589H	0	-	938	2031	2249	0.9030680
C3	56473046	56473746	BolC3t19590H	0	+	476	700	700	1.0000000
C3	56476960	56478475	BolC3t19591H	0	+	132	660	1515	0.4356436
C3	56478854	56479136	BolC3t19592H	0	-	24	249	282	0.8829787
C3	56481902	56483444	BolC3t19593H	0	-	637	1460	1542	0.9468223
C3	56486072	56496031	BolC3t19594H	0	-	1217	7159	9959	0.7188473
C3	56516451	56518812	BolC3t19595H	0	+	326	2158	2361	0.9140195
C3	56520206	56521980	BolC3t19596H	0	-	71	628	1774	0.3540023
C3	56533867	56534734	BolC3t19597H	0	-	900	841	867	0.9700115
C3	56542974	56545442	BolC3t19598H	0	+	1168	2039	2468	0.8261750
C3	56547528	56548823	BolC3t19599H	0	+	866	980	1295	0.7567568
C3	56550725	56551502	BolC3t19600H	0	-	543	777	777	1.0000000
C3	56552818	56553517	BolC3t19601H	0	+	0	0	699	0.0000000
C3	56553886	56554333	BolC3t19602H	0	-	4	183	447	0.4093960
C3	56565048	56572275	BolC3t19603H	0	-	1532	4743	7227	0.6562889
C3	56573156	56574805	BolC3t19604H	0	-	648	1649	1649	1.0000000
C3	56576548	56576986	BolC3t19605H	0	-	261	438	438	1.0000000
C3	56580197	56582117	BolC3t19606H	0	-	582	1799	1920	0.9369792
C3	56585515	56586124	BolC3t19607H	0	-	167	598	609	0.9819376
C3	56615919	56617239	BolC3t19608H	0	-	22	103	1320	0.0780303
C3	56620644	56621589	BolC3t19609H	0	+	434	945	945	1.0000000
C3	56629082	56630597	BolC3t19610H	0	+	863	1515	1515	1.0000000
C3	56634152	56636271	BolC3t19611H	0	-	790	1550	2119	0.7314771
C3	56641595	56641736	BolC3t19612H	0	-	170	141	141	1.0000000
C3	56643527	56644473	BolC3t19613H	0	+	1641	946	946	1.0000000
C3	56645821	56646407	BolC3t19614H	0	+	871	586	586	1.0000000
C3	56653199	56655123	BolC3t19615H	0	+	1590	1924	1924	1.0000000
C3	56655878	56657864	BolC3t19616H	0	-	1086	1986	1986	1.0000000
C3	56661176	56661449	BolC3t19617H	0	+	18	128	273	0.4688645
C3	56671876	56672529	BolC3t19618H	0	-	529	653	653	1.0000000
C3	56679067	56680375	BolC3t19619H	0	-	289	1222	1308	0.9342508
C3	56688847	56696875	BolC3t19620H	0	+	1828	7613	8028	0.9483059
C3	56697676	56699445	BolC3t19621H	0	-	220	1382	1769	0.7812324
C3	56716317	56728806	BolC3t19622H	0	-	2333	9721	12489	0.7783650
C3	56745165	56745801	BolC3t19623H	0	+	64	279	636	0.4386792
C3	56761284	56761992	BolC3t19624H	0	+	0	0	708	0.0000000
C3	56767883	56768666	BolC3t19625H	0	+	760	783	783	1.0000000
C3	56777109	56779697	BolC3t19626H	0	+	1755	2585	2588	0.9988408
C3	56833081	56833818	BolC3t19627H	0	-	203	737	737	1.0000000
C3	56890554	56891454	BolC3t19628H	0	+	526	900	900	1.0000000
C3	56893833	56894088	BolC3t19629H	0	+	8	113	255	0.4431373
C3	56895592	56895850	BolC3t19630H	0	+	90	255	258	0.9883721
C3	56898212	56899057	BolC3t19631H	0	+	109	845	845	1.0000000
C3	56900640	56901060	BolC3t19632H	0	-	301	412	420	0.9809524
C3	56901794	56905027	BolC3t19633H	0	-	1609	2874	3233	0.8889576
C3	56916894	56918163	BolC3t19634H	0	-	214	1188	1269	0.9361702
C3	56927616	56928733	BolC3t19635H	0	-	13	479	1117	0.4288272
C3	56940070	56940424	BolC3t19636H	0	-	11	169	354	0.4774011
C3	56958100	56962150	BolC3t19637H	0	+	950	3515	4050	0.8679012
C3	56968663	56972512	BolC3t19638H	0	+	1067	3597	3849	0.9345285
C3	56975181	56975376	BolC3t19639H	0	+	305	195	195	1.0000000
C3	56976512	56979977	BolC3t19640H	0	+	1017	3219	3465	0.9290043
C3	56980631	56987032	BolC3t19641H	0	-	1903	6158	6401	0.9620372
C3	56995863	56997102	BolC3t19642H	0	-	884	1239	1239	1.0000000
C3	56999041	57001880	BolC3t19643H	0	-	2201	2839	2839	1.0000000
C3	57002886	57003808	BolC3t19644H	0	+	100	842	922	0.9132321
C3	57013949	57015074	BolC3t19645H	0	+	900	1125	1125	1.0000000
C3	57015799	57018840	BolC3t19646H	0	-	2078	2831	3041	0.9309438
C3	57019730	57021695	BolC3t19647H	0	-	1093	1965	1965	1.0000000
C3	57027776	57028734	BolC3t19648H	0	-	445	945	958	0.9864300
C3	57029537	57030984	BolC3t19649H	0	-	462	1447	1447	1.0000000
C3	57032331	57033564	BolC3t19650H	0	-	384	1028	1233	0.8337389
C3	57038548	57041124	BolC3t19651H	0	-	471	2413	2576	0.9367236
C3	57050405	57051041	BolC3t19652H	0	+	250	636	636	1.0000000
C3	57052345	57055099	BolC3t19653H	0	+	1234	2572	2754	0.9339143
C3	57063345	57064081	BolC3t19654H	0	-	366	632	736	0.8586956
C3	57070340	57072428	BolC3t19655H	0	+	1066	2035	2088	0.9746169
C3	57073628	57075171	BolC3t19656H	0	+	1148	1543	1543	1.0000000
C3	57076618	57077733	BolC3t19657H	0	-	686	954	1115	0.8556054
C3	57077854	57078912	BolC3t19658H	0	+	647	1049	1058	0.9914934
C3	57080547	57100216	BolC3t19659H	0	-	1450	11798	19669	0.5998271
C3	57085990	57087448	BolC3t19660H	0	+	56	972	1458	0.6666667
C3	57095295	57095558	BolC3t19661H	0	-	34	237	263	0.9011407
C3	57101455	57102836	BolC3t19662H	0	-	226	1209	1381	0.8754526
C3	57105275	57106478	BolC3t19663H	0	-	740	1203	1203	1.0000000
C3	57108455	57109522	BolC3t19664H	0	-	468	1067	1067	1.0000000
C3	57110024	57110561	BolC3t19665H	0	-	390	537	537	1.0000000
C3	57110838	57112437	BolC3t19666H	0	+	972	1599	1599	1.0000000
C3	57113731	57114022	BolC3t19667H	0	-	25	289	291	0.9931272
C3	57114320	57115572	BolC3t19668H	0	+	640	1228	1252	0.9808307
C3	57116203	57116691	BolC3t19669H	0	-	209	488	488	1.0000000
C3	57138089	57140145	BolC3t19670H	0	-	997	2056	2056	1.0000000
C3	57141760	57143539	BolC3t19671H	0	+	623	1225	1779	0.6885891
C3	57144531	57146965	BolC3t19672H	0	+	526	1928	2434	0.7921118
C3	57147585	57147960	BolC3t19673H	0	-	89	364	375	0.9706666
C3	57148745	57149536	BolC3t19674H	0	+	458	791	791	1.0000000
C3	57166051	57168724	BolC3t19675H	0	+	8249	2673	2673	1.0000000
C3	57170482	57173875	BolC3t19676H	0	-	5885	3393	3393	1.0000000
C3	57173995	57191374	BolC3t19677H	0	-	8522	14254	17379	0.8201853
C3	57174211	57174721	BolC3t19678H	0	-	990	510	510	1.0000000
C3	57192249	57195402	BolC3t19679H	0	-	1757	3153	3153	1.0000000
C3	57197420	57198601	BolC3t19680H	0	-	530	1181	1181	1.0000000
C3	57199194	57200274	BolC3t19681H	0	+	16	83	1080	0.0768519
C3	57200326	57201715	BolC3t19682H	0	-	0	0	1389	0.0000000
C3	57204077	57249679	BolC3t19683H	0	+	15941	37619	45602	0.8249419
C3	57218278	57262297	BolC3t19684H	0	-	13720	33603	44019	0.7633749
C3	57230774	57232067	BolC3t19685H	0	+	583	1293	1293	1.0000000
C3	57233773	57234979	BolC3t19686H	0	-	929	1206	1206	1.0000000
C3	57250623	57251502	BolC3t19687H	0	-	1028	879	879	1.0000000
C3	57269015	57269476	BolC3t19688H	0	-	91	461	461	1.0000000
C3	57271713	57271972	BolC3t19689H	0	+	220	259	259	1.0000000
C3	57274134	57274596	BolC3t19690H	0	-	479	462	462	1.0000000
C3	57279718	57281489	BolC3t19691H	0	-	508	1697	1771	0.9582157
C3	57292856	57294931	BolC3t19692H	0	+	849	1712	2075	0.8250602
C3	57301309	57303296	BolC3t19693H	0	+	1253	1987	1987	1.0000000
C3	57305220	57306093	BolC3t19694H	0	+	806	873	873	1.0000000
C3	57312900	57317034	BolC3t19695H	0	+	710	3158	4134	0.7639090
C3	57349629	57350880	BolC3t19696H	0	+	1311	1251	1251	1.0000000
C3	57359325	57362615	BolC3t19697H	0	+	1288	2755	3290	0.8373860
C3	57362932	57364240	BolC3t19698H	0	-	534	1308	1308	1.0000000
C3	57366012	57366417	BolC3t19699H	0	+	461	405	405	1.0000000
C3	57369925	57370627	BolC3t19700H	0	-	199	592	702	0.8433049
C3	57374788	57377053	BolC3t19701H	0	+	1388	2265	2265	1.0000000
C3	57377468	57381433	BolC3t19702H	0	-	2554	3965	3965	1.0000000
C3	57386904	57390032	BolC3t19703H	0	-	911	2363	3128	0.7554348
C3	57387234	57388119	BolC3t19704H	0	+	283	755	885	0.8531073
C3	57394556	57395641	BolC3t19705H	0	+	574	1085	1085	1.0000000
C3	57397892	57402547	BolC3t19706H	0	+	1465	4171	4655	0.8960258
C3	57406555	57407844	BolC3t19707H	0	-	4	20	1289	0.0155159
C3	57413935	57416055	BolC3t19708H	0	+	384	1453	2120	0.6853774
C3	57416780	57421301	BolC3t19709H	0	-	1070	3188	4521	0.7051537
C3	57425526	57429486	BolC3t19710H	0	+	990	3596	3960	0.9080808
C3	57429889	57433978	BolC3t19711H	0	-	998	3842	4089	0.9395940
C3	57440708	57440920	BolC3t19712H	0	+	172	212	212	1.0000000
C3	57441119	57444399	BolC3t19713H	0	-	995	3246	3280	0.9896342
C3	57462145	57465064	BolC3t19714H	0	+	1284	2631	2919	0.9013361
C3	57465425	57468532	BolC3t19715H	0	-	2066	3101	3107	0.9980689
C3	57471971	57472639	BolC3t19716H	0	+	472	668	668	1.0000000
C3	57473258	57476799	BolC3t19717H	0	+	788	3183	3541	0.8988986
C3	57477399	57483938	BolC3t19718H	0	-	1065	1833	6539	0.2803181
C3	57484988	57488307	BolC3t19719H	0	+	637	2904	3319	0.8749623
C3	57489372	57490294	BolC3t19720H	0	+	392	922	922	1.0000000
C3	57494589	57495168	BolC3t19721H	0	+	0	0	579	0.0000000
C3	57506655	57508407	BolC3t19722H	0	+	445	1513	1752	0.8635845
C3	57511710	57512013	BolC3t19723H	0	-	216	303	303	1.0000000
C3	57513021	57515609	BolC3t19724H	0	-	799	2405	2588	0.9292890
C3	57535762	57537409	BolC3t19725H	0	-	629	1552	1647	0.9423194
C3	57546997	57547402	BolC3t19726H	0	+	157	405	405	1.0000000
C3	57548737	57549160	BolC3t19727H	0	+	128	350	423	0.8274232
C3	57551283	57552569	BolC3t19728H	0	+	894	1286	1286	1.0000000
C3	57554616	57554982	BolC3t19729H	0	-	5	85	366	0.2322404
C3	57554930	57555750	BolC3t19730H	0	-	0	0	820	0.0000000
C3	57563581	57564388	BolC3t19731H	0	-	273	807	807	1.0000000
C3	57573441	57574824	BolC3t19732H	0	-	1039	1383	1383	1.0000000
C3	57579718	57580915	BolC3t19733H	0	+	774	1197	1197	1.0000000
C3	57581915	57582421	BolC3t19734H	0	-	405	506	506	1.0000000
C3	57605612	57606106	BolC3t19735H	0	+	98	275	494	0.5566801
C3	57607176	57607619	BolC3t19736H	0	+	6	21	443	0.0474041
C3	57612697	57613140	BolC3t19737H	0	+	0	0	443	0.0000000
C3	57618498	57619023	BolC3t19738H	0	-	105	506	525	0.9638095
C3	57633157	57634234	BolC3t19739H	0	+	337	1077	1077	1.0000000
C3	57634777	57635302	BolC3t19740H	0	-	137	525	525	1.0000000
C3	57637827	57638127	BolC3t19741H	0	-	300	300	300	1.0000000
C3	57641804	57642344	BolC3t19742H	0	-	29	453	540	0.8388889
C3	57643668	57648455	BolC3t19743H	0	+	2531	4585	4787	0.9578024
C3	57650709	57652336	BolC3t19744H	0	-	369	1368	1627	0.8408113
C3	57655640	57656493	BolC3t19745H	0	-	208	853	853	1.0000000
C3	57683116	57684712	BolC3t19746H	0	-	282	1362	1596	0.8533835
C3	57689506	57692201	BolC3t19747H	0	-	991	2104	2695	0.7807050
C3	57695047	57695545	BolC3t19748H	0	+	492	498	498	1.0000000
C3	57696034	57698884	BolC3t19749H	0	-	1616	2850	2850	1.0000000
C3	57710336	57710672	BolC3t19750H	0	+	0	0	336	0.0000000
C3	57713494	57714196	BolC3t19751H	0	-	311	702	702	1.0000000
C3	57728179	57729333	BolC3t19752H	0	-	27	312	1154	0.2703640
C3	57748572	57748839	BolC3t19753H	0	-	253	267	267	1.0000000
C3	57749469	57760286	BolC3t19754H	0	+	2700	8354	10817	0.7723029
C3	57762259	57762690	BolC3t19755H	0	+	126	420	431	0.9744779
C3	57762689	57764526	BolC3t19756H	0	+	1400	1837	1837	1.0000000
C3	57768980	57769538	BolC3t19757H	0	+	183	504	558	0.9032258
C3	57772408	57773118	BolC3t19758H	0	-	246	710	710	1.0000000
C3	57772626	57773118	BolC3t19759H	0	-	191	492	492	1.0000000
C3	57774751	57774862	BolC3t19760H	0	+	3	80	111	0.7207207
C3	57780466	57780985	BolC3t19761H	0	-	51	422	519	0.8131021
C3	57781906	57782182	BolC3t19762H	0	-	69	276	276	1.0000000
C3	57790311	57790953	BolC3t19763H	0	+	612	642	642	1.0000000
C3	57793147	57793456	BolC3t19764H	0	+	56	303	309	0.9805825
C3	57813540	57816088	BolC3t19765H	0	+	832	2489	2548	0.9768446
C3	57822796	57824185	BolC3t19766H	0	-	24	621	1389	0.4470842
C3	57825686	57826787	BolC3t19767H	0	-	638	1101	1101	1.0000000
C3	57834755	57835070	BolC3t19768H	0	+	47	315	315	1.0000000
C3	57835154	57835713	BolC3t19769H	0	+	177	547	559	0.9785331
C3	57838756	57839098	BolC3t19770H	0	-	120	323	342	0.9444444
C3	57849157	57849985	BolC3t19771H	0	-	191	751	828	0.9070048
C3	57858205	57858556	BolC3t19772H	0	-	60	266	351	0.7578347
C3	57865374	57866436	BolC3t19773H	0	-	988	1048	1062	0.9868173
C3	57869511	57870648	BolC3t19774H	0	+	10	351	1137	0.3087071
C3	57903172	57904170	BolC3t19775H	0	-	864	998	998	1.0000000
C3	57911314	57911698	BolC3t19776H	0	-	5	51	384	0.1328125
C3	57913845	57914118	BolC3t19777H	0	-	0	0	273	0.0000000
C3	57920409	57921515	BolC3t19778H	0	+	322	213	1106	0.1925859
C3	57923063	57937156	BolC3t19779H	0	+	809	4793	14093	0.3400979
C3	57941299	57941749	BolC3t19780H	0	-	323	450	450	1.0000000
C3	57947684	57948018	BolC3t19781H	0	-	132	334	334	1.0000000
C3	57960911	57961444	BolC3t19782H	0	+	69	220	533	0.4127580
C3	57970898	57972106	BolC3t19783H	0	+	147	1037	1208	0.8584437
C3	57979119	57985396	BolC3t19784H	0	+	3619	6201	6277	0.9878923
C3	57987758	57987914	BolC3t19785H	0	-	5	156	156	1.0000000
C3	57988304	57988475	BolC3t19786H	0	-	0	0	171	0.0000000
C3	57989239	57990939	BolC3t19787H	0	+	1	147	1700	0.0864706
C3	57993493	57993782	BolC3t19788H	0	+	711	289	289	1.0000000
C3	58006984	58008039	BolC3t19789H	0	-	27	344	1055	0.3260663
C3	58010197	58013265	BolC3t19790H	0	+	1098	3068	3068	1.0000000
C3	58016344	58019285	BolC3t19791H	0	+	2775	2941	2941	1.0000000
C3	58020702	58022269	BolC3t19792H	0	+	638	1567	1567	1.0000000
C3	58022681	58025567	BolC3t19793H	0	-	1669	2886	2886	1.0000000
C3	58025947	58026683	BolC3t19794H	0	+	384	736	736	1.0000000
C3	58026867	58027587	BolC3t19795H	0	-	272	633	720	0.8791667
C3	58027984	58030248	BolC3t19796H	0	-	1640	2240	2264	0.9893993
C3	58067425	58067593	BolC3t19797H	0	+	4	85	168	0.5059524
C3	58085573	58087190	BolC3t19798H	0	-	1259	1617	1617	1.0000000
C3	58089438	58097601	BolC3t19799H	0	-	824	4706	8163	0.5765038
C3	58105447	58106980	BolC3t19800H	0	-	501	1507	1533	0.9830398
C3	58107836	58108411	BolC3t19801H	0	-	146	556	575	0.9669565
C3	58108696	58109717	BolC3t19802H	0	+	167	934	1021	0.9147894
C3	58111178	58111730	BolC3t19803H	0	+	166	552	552	1.0000000
C3	58121767	58122215	BolC3t19804H	0	+	126	404	448	0.9017857
C3	58124388	58125998	BolC3t19805H	0	-	898	1610	1610	1.0000000
C3	58126556	58127992	BolC3t19806H	0	+	1049	1337	1436	0.9310585
C3	58128377	58129209	BolC3t19807H	0	+	767	832	832	1.0000000
C3	58130782	58133689	BolC3t19808H	0	+	777	2785	2907	0.9580323
C3	58134638	58135693	BolC3t19809H	0	+	820	1051	1055	0.9962085
C3	58137454	58138358	BolC3t19810H	0	+	211	783	904	0.8661504
C3	58140047	58141307	BolC3t19811H	0	+	523	1260	1260	1.0000000
C3	58143494	58144019	BolC3t19812H	0	-	89	524	525	0.9980952
C3	58176520	58180614	BolC3t19813H	0	-	1037	3575	4094	0.8732291
C3	58182822	58184200	BolC3t19814H	0	+	562	1360	1378	0.9869376
C3	58186559	58187087	BolC3t19815H	0	+	35	405	528	0.7670454
C3	58196717	58197671	BolC3t19816H	0	-	66	701	954	0.7348008
C3	58197948	58198966	BolC3t19817H	0	+	318	1018	1018	1.0000000
C3	58211757	58213451	BolC3t19818H	0	+	501	1676	1694	0.9893743
C3	58214277	58215825	BolC3t19819H	0	-	353	1281	1548	0.8275194
C3	58229479	58230045	BolC3t19820H	0	-	8	138	566	0.2438163
C3	58241955	58243873	BolC3t19821H	0	+	856	1918	1918	1.0000000
C3	58252517	58255679	BolC3t19822H	0	+	2156	3162	3162	1.0000000
C3	58256108	58257377	BolC3t19823H	0	+	499	1266	1269	0.9976360
C3	58261714	58262641	BolC3t19824H	0	+	10	106	927	0.1143474
C3	58267776	58268597	BolC3t19825H	0	-	70	732	821	0.8915956
C3	58270171	58271587	BolC3t19826H	0	-	10	21	1416	0.0148305
C3	58286432	58286606	BolC3t19827H	0	+	190	174	174	1.0000000
C3	58291818	58292201	BolC3t19828H	0	-	652	383	383	1.0000000
C3	58293818	58296788	BolC3t19829H	0	+	199	1841	2970	0.6198653
C3	58304903	58305224	BolC3t19830H	0	+	11	225	321	0.7009346
C3	58313010	58314116	BolC3t19831H	0	-	721	1106	1106	1.0000000
C3	58315738	58317497	BolC3t19832H	0	-	59	851	1759	0.4837976
C3	58320860	58322279	BolC3t19833H	0	-	187	1356	1419	0.9556025
C3	58326441	58326663	BolC3t19834H	0	+	50	215	222	0.9684685
C3	58334335	58336566	BolC3t19835H	0	+	871	2230	2231	0.9995518
C3	58336902	58338900	BolC3t19836H	0	-	807	1950	1998	0.9759760
C3	58371233	58373393	BolC3t19837H	0	+	530	1865	2160	0.8634259
C3	58378479	58378620	BolC3t19838H	0	-	29	141	141	1.0000000
C3	58379572	58383264	BolC3t19839H	0	-	769	3389	3692	0.9179307
C3	58385422	58387280	BolC3t19840H	0	+	689	1782	1858	0.9590958
C3	58389918	58392824	BolC3t19841H	0	-	703	2831	2906	0.9741913
C3	58401228	58401525	BolC3t19842H	0	+	197	297	297	1.0000000
C3	58422176	58423082	BolC3t19843H	0	+	287	906	906	1.0000000
C3	58427328	58427763	BolC3t19844H	0	+	341	435	435	1.0000000
C3	58434395	58434926	BolC3t19845H	0	+	121	531	531	1.0000000
C3	58435855	58436272	BolC3t19846H	0	+	465	417	417	1.0000000
C3	58438993	58439419	BolC3t19847H	0	+	179	426	426	1.0000000
C3	58439914	58440663	BolC3t19848H	0	+	39	544	749	0.7263017
C3	58441749	58442821	BolC3t19849H	0	-	1310	1072	1072	1.0000000
C3	58455449	58455833	BolC3t19850H	0	+	109	384	384	1.0000000
C3	58457165	58457417	BolC3t19851H	0	-	71	252	252	1.0000000
C3	58473269	58473683	BolC3t19852H	0	-	71	414	414	1.0000000
C3	58477510	58478070	BolC3t19853H	0	-	0	0	560	0.0000000
C3	58479571	58480228	BolC3t19854H	0	+	29	495	657	0.7534246
C3	58533487	58534174	BolC3t19855H	0	-	625	687	687	1.0000000
C3	58534588	58536294	BolC3t19856H	0	-	511	1600	1706	0.9378663
C3	58537892	58540370	BolC3t19857H	0	+	896	2382	2478	0.9612591
C3	58544326	58545902	BolC3t19858H	0	+	431	1353	1576	0.8585026
C3	58546990	58549734	BolC3t19859H	0	-	813	2619	2744	0.9544461
C3	58553212	58554830	BolC3t19860H	0	-	1053	1439	1618	0.8893696
C3	58559343	58619099	BolC3t19861H	0	-	15960	38500	59756	0.6442868
C3	58565453	58566161	BolC3t19862H	0	+	85	708	708	1.0000000
C3	58566380	58566995	BolC3t19863H	0	+	202	615	615	1.0000000
C3	58594272	58595160	BolC3t19864H	0	+	0	0	888	0.0000000
C3	58613057	58613270	BolC3t19865H	0	+	117	213	213	1.0000000
C3	58625100	58625869	BolC3t19866H	0	-	497	769	769	1.0000000
C3	58648814	58649081	BolC3t19867H	0	+	17	267	267	1.0000000
C3	58649181	58649322	BolC3t19868H	0	+	21	141	141	1.0000000
C3	58650253	58651291	BolC3t19869H	0	-	176	621	1038	0.5982659
C3	58665592	58667187	BolC3t19870H	0	-	79	1076	1595	0.6746082
C3	58682027	58687689	BolC3t19871H	0	-	2041	5320	5662	0.9395973
C3	58689259	58690871	BolC3t19872H	0	+	665	1562	1612	0.9689826
C3	58691490	58692345	BolC3t19873H	0	+	325	855	855	1.0000000
C3	58693596	58694310	BolC3t19874H	0	+	89	317	714	0.4439776
C3	58694610	58695665	BolC3t19875H	0	-	588	866	1055	0.8208531
C3	58699473	58700031	BolC3t19876H	0	-	150	538	558	0.9641577
C3	58703641	58704051	BolC3t19877H	0	+	132	410	410	1.0000000
C3	58707984	58709106	BolC3t19878H	0	+	155	1111	1122	0.9901960
C3	58710510	58710884	BolC3t19879H	0	-	31	317	374	0.8475936
C3	58712765	58714834	BolC3t19880H	0	+	732	2063	2069	0.9971001
C3	58715132	58716533	BolC3t19881H	0	+	1057	1401	1401	1.0000000
C3	58717745	58718549	BolC3t19882H	0	+	47	566	804	0.7039801
C3	58740911	58741244	BolC3t19883H	0	+	610	333	333	1.0000000
C3	58741583	58742327	BolC3t19884H	0	+	141	672	744	0.9032258
C3	58743219	58743983	BolC3t19885H	0	-	399	763	764	0.9986911
C3	58754840	58757220	BolC3t19886H	0	-	810	2373	2380	0.9970588
C3	58758269	58758692	BolC3t19887H	0	-	126	176	423	0.4160756
C3	58791729	58792451	BolC3t19888H	0	+	259	722	722	1.0000000
C3	58793484	58793709	BolC3t19889H	0	+	171	225	225	1.0000000
C3	58805243	58807162	BolC3t19890H	0	+	662	1628	1919	0.8483585
C3	58816135	58817254	BolC3t19891H	0	+	15	510	1119	0.4557641
C3	58845417	58847251	BolC3t19892H	0	-	77	454	1834	0.2475463
C3	58866603	58868430	BolC3t19893H	0	+	0	0	1827	0.0000000
C3	58881809	58883093	BolC3t19894H	0	+	220	998	1284	0.7772586
C3	58883541	58885759	BolC3t19895H	0	-	855	2005	2218	0.9039676
C3	58887489	58888982	BolC3t19896H	0	+	321	1389	1493	0.9303416
C3	58902532	58903153	BolC3t19897H	0	+	41	428	621	0.6892110
C3	58903912	58904380	BolC3t19898H	0	-	6	68	468	0.1452992
C3	58912876	58914274	BolC3t19899H	0	-	153	1138	1398	0.8140200
C3	58917833	58918286	BolC3t19900H	0	-	574	453	453	1.0000000
C3	58943559	58943667	BolC3t19901H	0	-	18	92	108	0.8518519
C3	58950290	58951821	BolC3t19902H	0	-	297	1489	1531	0.9725670
C3	58960478	58961426	BolC3t19903H	0	-	477	948	948	1.0000000
C3	58965229	58967802	BolC3t19904H	0	-	793	2302	2573	0.8946755
C3	58970147	58971544	BolC3t19905H	0	+	107	212	1397	0.1517538
C3	58975152	58976184	BolC3t19906H	0	+	429	909	1032	0.8808140
C3	58977254	58980931	BolC3t19907H	0	-	472	2870	3677	0.7805276
C3	58985041	58985863	BolC3t19908H	0	-	26	565	822	0.6873479
C3	59011187	59012402	BolC3t19909H	0	+	307	932	1215	0.7670782
C3	59014698	59014875	BolC3t19910H	0	-	15	177	177	1.0000000
C3	59018557	59022836	BolC3t19911H	0	+	76	1136	4279	0.2654826
C3	59022894	59072706	BolC3t19912H	0	+	3635	13967	49812	0.2803943
C3	59032449	59036480	BolC3t19913H	0	+	107	1102	4031	0.2733813
C3	59046302	59046743	BolC3t19914H	0	+	0	0	441	0.0000000
C3	59056352	59056529	BolC3t19915H	0	-	33	177	177	1.0000000
C3	59071680	59121838	BolC3t19916H	0	+	8945	27972	50158	0.5576777
C3	59082854	59085477	BolC3t19917H	0	+	66	667	2623	0.2542890
C3	59091433	59091736	BolC3t19918H	0	+	210	303	303	1.0000000
C3	59100488	59101568	BolC3t19919H	0	-	234	903	1080	0.8361111
C3	59101759	59103122	BolC3t19920H	0	-	149	1063	1363	0.7798973
C3	59140042	59141710	BolC3t19921H	0	-	247	1422	1668	0.8525180
C3	59155105	59157041	BolC3t19922H	0	+	918	1757	1936	0.9075413
C3	59161597	59164402	BolC3t19923H	0	+	627	2543	2805	0.9065953
C3	59179781	59183937	BolC3t19924H	0	-	974	3582	4156	0.8618864
C3	59210068	59211340	BolC3t19925H	0	+	622	1272	1272	1.0000000
C3	59229999	59233514	BolC3t19926H	0	+	1166	3307	3515	0.9408250
C3	59234366	59235076	BolC3t19927H	0	+	84	596	710	0.8394366
C3	59249959	59250368	BolC3t19928H	0	+	0	0	409	0.0000000
C3	59258060	59266929	BolC3t19929H	0	+	3176	8522	8869	0.9608750
C3	59281049	59289786	BolC3t19930H	0	+	2234	7225	8737	0.8269429
C3	59290300	59294295	BolC3t19931H	0	-	2303	3417	3995	0.8553191
C3	59295974	59301648	BolC3t19932H	0	+	780	3712	5674	0.6542122
C3	59302109	59303283	BolC3t19933H	0	-	499	1174	1174	1.0000000
C3	59303746	59305630	BolC3t19934H	0	+	1062	1848	1884	0.9808917
C3	59320510	59328063	BolC3t19935H	0	+	1122	4822	7553	0.6384218
C3	59328210	59330641	BolC3t19936H	0	+	1456	2431	2431	1.0000000
C3	59331316	59334251	BolC3t19937H	0	-	1162	2461	2935	0.8385009
C3	59347008	59347575	BolC3t19938H	0	-	37	239	567	0.4215167
C3	59360431	59361500	BolC3t19939H	0	+	779	991	1069	0.9270346
C3	59362668	59362851	BolC3t19940H	0	-	93	183	183	1.0000000
C3	59363430	59366401	BolC3t19941H	0	+	863	2771	2971	0.9326826
C3	59370107	59370536	BolC3t19942H	0	+	289	415	429	0.9673660
C3	59371217	59372712	BolC3t19943H	0	-	269	1318	1495	0.8816053
C3	59375663	59379336	BolC3t19944H	0	+	2705	3673	3673	1.0000000
C3	59388823	59390814	BolC3t19945H	0	+	201	1859	1991	0.9337016
C3	59393095	59393488	BolC3t19946H	0	-	44	241	393	0.6132315
C3	59394444	59396014	BolC3t19947H	0	-	879	1483	1570	0.9445860
C3	59397708	59408885	BolC3t19948H	0	+	1251	6312	11177	0.5647311
C3	59410116	59413050	BolC3t19949H	0	+	1593	2887	2934	0.9839809
C3	59448264	59450916	BolC3t19950H	0	-	356	2164	2652	0.8159879
C3	59463331	59470206	BolC3t19951H	0	+	4330	6875	6875	1.0000000
C3	59471272	59473247	BolC3t19952H	0	+	92	1349	1975	0.6830380
C3	59478015	59491727	BolC3t19953H	0	+	9790	13712	13712	1.0000000
C3	59495216	59495492	BolC3t19954H	0	+	62	276	276	1.0000000
C3	59508574	59510887	BolC3t19955H	0	+	363	2127	2313	0.9195849
C3	59516790	59521348	BolC3t19956H	0	-	156	2193	4558	0.4811321
C3	59522038	59522140	BolC3t19957H	0	-	4	56	102	0.5490196
C3	59522543	59522828	BolC3t19958H	0	+	329	285	285	1.0000000
C3	59523014	59523440	BolC3t19959H	0	+	647	426	426	1.0000000
C3	59524486	59532615	BolC3t19960H	0	-	3026	7820	8129	0.9619880
C3	59533382	59537960	BolC3t19961H	0	-	1517	4450	4578	0.9720402
C3	59547354	59550825	BolC3t19962H	0	+	1992	3471	3471	1.0000000
C3	59551842	59553978	BolC3t19963H	0	+	588	1997	2136	0.9349251
C3	59560643	59561460	BolC3t19964H	0	+	466	817	817	1.0000000
C3	59563186	59564845	BolC3t19965H	0	-	577	1598	1659	0.9632308
C3	59571776	59577785	BolC3t19966H	0	+	1501	5678	6009	0.9449160
C3	59578008	59579301	BolC3t19967H	0	-	289	1134	1293	0.8770301
C3	59580900	59582098	BolC3t19968H	0	+	87	845	1198	0.7053422
C3	59583022	59590913	BolC3t19969H	0	-	887	4494	7891	0.5695096
C3	59593824	59594551	BolC3t19970H	0	-	18	65	727	0.0894085
C3	59598941	59599088	BolC3t19971H	0	-	6	147	147	1.0000000
C3	59605612	59606673	BolC3t19972H	0	+	236	487	1061	0.4590009
C3	59608457	59608940	BolC3t19973H	0	-	3	121	483	0.2505176
C3	59609845	59611895	BolC3t19974H	0	-	1087	1963	2050	0.9575610
C3	59624443	59626240	BolC3t19975H	0	-	916	1782	1797	0.9916527
C3	59627235	59629771	BolC3t19976H	0	+	1308	2507	2536	0.9885647
C3	59630488	59630590	BolC3t19977H	0	-	148	102	102	1.0000000
C3	59638761	59639718	BolC3t19978H	0	-	118	730	957	0.7628004
C3	59641055	59642750	BolC3t19979H	0	-	937	1619	1695	0.9551622
C3	59644180	59646037	BolC3t19980H	0	-	917	1786	1857	0.9617663
C3	59649145	59649828	BolC3t19981H	0	+	40	639	683	0.9355783
C3	59656260	59656779	BolC3t19982H	0	-	234	519	519	1.0000000
C3	59660026	59660410	BolC3t19983H	0	+	197	384	384	1.0000000
C3	59668462	59670027	BolC3t19984H	0	-	284	1442	1565	0.9214057
C3	59684472	59685850	BolC3t19985H	0	+	599	1372	1378	0.9956459
C3	59686199	59687737	BolC3t19986H	0	-	933	1436	1538	0.9336801
C3	59690790	59691638	BolC3t19987H	0	+	918	848	848	1.0000000
C3	59696429	59699382	BolC3t19988H	0	+	1430	2386	2953	0.8079919
C3	59701407	59702496	BolC3t19989H	0	-	378	1089	1089	1.0000000
C3	59734761	59735315	BolC3t19990H	0	+	11	132	554	0.2382672
C3	59739385	59739658	BolC3t19991H	0	+	843	273	273	1.0000000
C3	59742127	59743081	BolC3t19992H	0	-	2784	948	954	0.9937107
C3	59746967	59747369	BolC3t19993H	0	-	144	402	402	1.0000000
C3	59747945	59749434	BolC3t19994H	0	-	1772	1396	1489	0.9375420
C3	59752389	59752932	BolC3t19995H	0	-	194	543	543	1.0000000
C3	59753283	59754214	BolC3t19996H	0	-	225	761	931	0.8174006
C3	59755170	59755869	BolC3t19997H	0	+	220	433	699	0.6194564
C3	59760178	59761608	BolC3t19998H	0	+	569	1427	1430	0.9979021
C3	59764135	59765965	BolC3t19999H	0	-	580	1830	1830	1.0000000
C3	59767070	59767865	BolC3t20000H	0	-	99	753	795	0.9471698
C3	59769897	59770089	BolC3t20001H	0	+	280	192	192	1.0000000
C3	59775327	59776128	BolC3t20002H	0	-	378	776	801	0.9687890
C3	59782562	59782883	BolC3t20003H	0	+	123	321	321	1.0000000
C3	59785993	59786424	BolC3t20004H	0	+	350	431	431	1.0000000
C3	59786669	59786912	BolC3t20005H	0	+	328	243	243	1.0000000
C3	59803050	59803688	BolC3t20006H	0	+	577	638	638	1.0000000
C3	59819300	59819441	BolC3t20007H	0	+	15	130	141	0.9219858
C3	59829553	59829700	BolC3t20008H	0	-	189	147	147	1.0000000
C3	59857841	59860137	BolC3t20009H	0	+	1691	2296	2296	1.0000000
C3	59861668	59861896	BolC3t20010H	0	-	283	228	228	1.0000000
C3	59866466	59872932	BolC3t20011H	0	+	2186	5295	6466	0.8188989
C3	59873831	59875134	BolC3t20012H	0	-	831	1303	1303	1.0000000
C3	59884380	59889305	BolC3t20013H	0	+	878	2927	4925	0.5943147
C3	59900186	59901533	BolC3t20014H	0	-	971	1346	1347	0.9992576
C3	59902627	59902804	BolC3t20015H	0	-	65	150	177	0.8474576
C3	59908879	59911373	BolC3t20016H	0	-	508	1676	2494	0.6720128
C3	59912755	59920266	BolC3t20017H	0	-	2981	7374	7511	0.9817601
C3	59921322	59923962	BolC3t20018H	0	-	353	2188	2640	0.8287879
C3	59924404	59926750	BolC3t20019H	0	-	1233	2346	2346	1.0000000
C3	59927668	59929208	BolC3t20020H	0	-	454	1540	1540	1.0000000
C3	59931063	59933891	BolC3t20021H	0	+	2003	2827	2828	0.9996464
C3	59936052	59938846	BolC3t20022H	0	+	1242	2695	2794	0.9645669
C3	59939336	59941716	BolC3t20023H	0	-	568	1852	2380	0.7781513
C3	59943295	59944523	BolC3t20024H	0	-	73	771	1228	0.6278502
C3	59952975	59953519	BolC3t20025H	0	-	5	256	544	0.4705882
C3	59954303	59955044	BolC3t20026H	0	-	206	741	741	1.0000000
C3	59962560	59963293	BolC3t20027H	0	+	330	733	733	1.0000000
C3	59963996	59965769	BolC3t20028H	0	+	481	1636	1773	0.9227298
C3	59966267	59967621	BolC3t20029H	0	-	224	1277	1354	0.9431314
C3	59968166	59968671	BolC3t20030H	0	+	35	323	505	0.6396040
C3	59970458	59971220	BolC3t20031H	0	-	578	762	762	1.0000000
C3	59973440	59974078	BolC3t20032H	0	+	412	638	638	1.0000000
C3	59976044	59977714	BolC3t20033H	0	+	1043	1670	1670	1.0000000
C3	60019087	60019450	BolC3t20034H	0	+	434	363	363	1.0000000
C3	60024995	60028960	BolC3t20035H	0	+	438	3056	3965	0.7707440
C3	60031386	60031617	BolC3t20036H	0	-	265	231	231	1.0000000
C3	60033825	60035932	BolC3t20037H	0	+	1809	2107	2107	1.0000000
C3	60039670	60042442	BolC3t20038H	0	-	1733	2772	2772	1.0000000
C3	60044469	60045763	BolC3t20039H	0	+	166	1030	1294	0.7959815
C3	60053189	60056795	BolC3t20040H	0	+	352	3226	3606	0.8946201
C3	60066505	60068851	BolC3t20041H	0	-	402	1966	2346	0.8380222
C3	60069185	60070260	BolC3t20042H	0	-	31	361	1075	0.3358139
C3	60076590	60083786	BolC3t20043H	0	+	2502	7051	7196	0.9798499
C3	60085173	60085536	BolC3t20044H	0	-	95	363	363	1.0000000
C3	60088261	60088746	BolC3t20045H	0	-	295	485	485	1.0000000
C3	60111651	60113422	BolC3t20046H	0	-	1203	1609	1771	0.9085262
C3	60118601	60120379	BolC3t20047H	0	-	5731	1776	1778	0.9988751
C3	60126943	60129482	BolC3t20048H	0	-	918	2261	2539	0.8905081
C3	60133071	60136039	BolC3t20049H	0	-	1190	2968	2968	1.0000000
C3	60160260	60160692	BolC3t20050H	0	-	343	432	432	1.0000000
C3	60165159	60165797	BolC3t20051H	0	-	243	638	638	1.0000000
C3	60167410	60167924	BolC3t20052H	0	+	74	488	514	0.9494163
C3	60171195	60171834	BolC3t20053H	0	-	81	580	639	0.9076682
C3	60173068	60173571	BolC3t20054H	0	-	425	503	503	1.0000000
C3	60173618	60174467	BolC3t20055H	0	-	491	849	849	1.0000000
C3	60190080	60192669	BolC3t20056H	0	-	1467	2589	2589	1.0000000
C3	60201150	60202007	BolC3t20057H	0	-	460	857	857	1.0000000
C3	60215673	60216210	BolC3t20058H	0	+	406	537	537	1.0000000
C3	60218182	60218487	BolC3t20059H	0	+	127	305	305	1.0000000
C3	60234914	60235236	BolC3t20060H	0	+	1	125	322	0.3881988
C3	60235480	60237020	BolC3t20061H	0	-	24	854	1540	0.5545455
C3	60239151	60240006	BolC3t20062H	0	-	168	793	855	0.9274854
C3	60242631	60246725	BolC3t20063H	0	+	474	2937	4094	0.7173913
C3	60248297	60248769	BolC3t20064H	0	+	447	472	472	1.0000000
C3	60249144	60249939	BolC3t20065H	0	-	31	332	795	0.4176100
C3	60254242	60257221	BolC3t20066H	0	+	949	2167	2979	0.7274253
C3	60263796	60264421	BolC3t20067H	0	+	234	625	625	1.0000000
C3	60275243	60275595	BolC3t20068H	0	-	58	352	352	1.0000000
C3	60278916	60280039	BolC3t20069H	0	+	777	1123	1123	1.0000000
C3	60280123	60281119	BolC3t20070H	0	+	756	996	996	1.0000000
C3	60288789	60289260	BolC3t20071H	0	-	590	471	471	1.0000000
C3	60290027	60290481	BolC3t20072H	0	+	105	454	454	1.0000000
C3	60291386	60291638	BolC3t20073H	0	+	332	252	252	1.0000000
C3	60297925	60298147	BolC3t20074H	0	+	28	157	222	0.7072072
C3	60298640	60300734	BolC3t20075H	0	-	389	1695	2094	0.8094556
C3	60301511	60305341	BolC3t20076H	0	+	1491	3268	3830	0.8532637
C3	60307136	60308682	BolC3t20077H	0	-	613	1211	1546	0.7833118
C3	60312359	60312972	BolC3t20078H	0	+	270	613	613	1.0000000
C3	60315342	60316420	BolC3t20079H	0	+	55	854	1078	0.7922078
C3	60320968	60331221	BolC3t20080H	0	-	4390	8971	10253	0.8749634
C3	60358177	60359635	BolC3t20081H	0	-	796	1458	1458	1.0000000
C3	60365867	60367031	BolC3t20082H	0	-	36	501	1164	0.4304124
C3	60368807	60369944	BolC3t20083H	0	+	62	828	1137	0.7282322
C3	60371556	60372849	BolC3t20084H	0	-	31	467	1293	0.3611756
C3	60374022	60376410	BolC3t20085H	0	+	770	1983	2388	0.8304020
C3	60381788	60382555	BolC3t20086H	0	-	2	122	767	0.1590613
C3	60387277	60387472	BolC3t20087H	0	-	0	0	195	0.0000000
C3	60404463	60404763	BolC3t20088H	0	-	154	300	300	1.0000000
C3	60423784	60424424	BolC3t20089H	0	+	422	640	640	1.0000000
C3	60428349	60429014	BolC3t20090H	0	+	0	0	665	0.0000000
C3	60441482	60443541	BolC3t20091H	0	-	266	1482	2059	0.7197669
C3	60457274	60458084	BolC3t20092H	0	-	70	718	810	0.8864198
C3	60469399	60471238	BolC3t20093H	0	-	548	1591	1839	0.8651441
C3	60471918	60473127	BolC3t20094H	0	-	506	1177	1209	0.9735318
C3	60477379	60478729	BolC3t20095H	0	+	295	1085	1350	0.8037037
C3	60498677	60499140	BolC3t20096H	0	+	294	463	463	1.0000000
C3	60499505	60506978	BolC3t20097H	0	+	3013	7326	7473	0.9803292
C3	60507336	60508491	BolC3t20098H	0	+	156	802	1155	0.6943723
C3	60518573	60520256	BolC3t20099H	0	-	727	1683	1683	1.0000000
C3	60538175	60539529	BolC3t20100H	0	+	490	1354	1354	1.0000000
C3	60578483	60580187	BolC3t20101H	0	-	341	1704	1704	1.0000000
C3	60581927	60584099	BolC3t20102H	0	-	1166	2100	2172	0.9668508
C3	60590231	60590648	BolC3t20103H	0	+	525	417	417	1.0000000
C3	60591989	60592307	BolC3t20104H	0	+	512	318	318	1.0000000
C3	60595545	60595926	BolC3t20105H	0	+	185	381	381	1.0000000
C3	60596709	60597689	BolC3t20106H	0	+	642	980	980	1.0000000
C3	60598695	60599885	BolC3t20107H	0	+	211	1144	1190	0.9613445
C3	60615580	60618880	BolC3t20108H	0	-	3118	3286	3300	0.9957576
C3	60620752	60623268	BolC3t20109H	0	+	715	2515	2516	0.9996026
C3	60636514	60638193	BolC3t20110H	0	-	207	1507	1679	0.8975581
C3	60653563	60654558	BolC3t20111H	0	-	385	982	995	0.9869347
C3	60656447	60657380	BolC3t20112H	0	+	156	808	933	0.8660236
C3	60663731	60666661	BolC3t20113H	0	+	601	2585	2930	0.8822526
C3	60674954	60675806	BolC3t20114H	0	-	433	852	852	1.0000000
C3	60682893	60684091	BolC3t20115H	0	+	405	1198	1198	1.0000000
C3	60684696	60685134	BolC3t20116H	0	-	16	331	438	0.7557077
C3	60686219	60686615	BolC3t20117H	0	-	9	254	396	0.6414142
C3	60692671	60695490	BolC3t20118H	0	+	752	2247	2819	0.7970912
C3	60700638	60701667	BolC3t20119H	0	+	542	1029	1029	1.0000000
C3	60702858	60713979	BolC3t20120H	0	-	2803	9002	11121	0.8094596
C3	60703645	60704079	BolC3t20121H	0	+	22	373	434	0.8594470
C3	60704577	60705214	BolC3t20122H	0	+	15	287	637	0.4505495
C3	60705464	60705798	BolC3t20123H	0	+	4	109	334	0.3263473
C3	60717176	60717840	BolC3t20124H	0	+	698	664	664	1.0000000
C3	60718708	60720557	BolC3t20125H	0	-	530	1838	1849	0.9940509
C3	60725153	60733226	BolC3t20126H	0	+	200	2309	8073	0.2860151
C3	60733535	60735194	BolC3t20127H	0	+	398	1298	1659	0.7823991
C3	60741779	60745288	BolC3t20128H	0	-	1702	2776	3509	0.7911085
C3	60746764	60753858	BolC3t20129H	0	-	1279	5267	7094	0.7424584
C3	60757808	60759102	BolC3t20130H	0	+	0	0	1294	0.0000000
C3	60780860	60783103	BolC3t20131H	0	-	37	892	2243	0.3976817
C3	60787534	60798770	BolC3t20132H	0	-	1599	6781	11236	0.6035066
C3	60812057	60813121	BolC3t20133H	0	-	309	1064	1064	1.0000000
C3	60847665	60850841	BolC3t20134H	0	+	439	1680	3176	0.5289673
C3	60852161	60855000	BolC3t20135H	0	+	828	2681	2839	0.9443466
C3	60855313	60856527	BolC3t20136H	0	+	423	1110	1214	0.9143328
C3	60856946	60859421	BolC3t20137H	0	+	411	2302	2475	0.9301010
C3	60864477	60867101	BolC3t20138H	0	+	1566	2624	2624	1.0000000
C3	60867582	60868716	BolC3t20139H	0	-	695	1015	1134	0.8950617
C3	60871554	60872713	BolC3t20140H	0	+	216	1095	1159	0.9447800
C3	60873319	60873863	BolC3t20141H	0	-	431	544	544	1.0000000
C3	60879532	60881910	BolC3t20142H	0	+	977	2253	2378	0.9474348
C3	60883663	60884512	BolC3t20143H	0	+	1053	849	849	1.0000000
C3	60884922	60886449	BolC3t20144H	0	-	1373	1527	1527	1.0000000
C3	60897976	60898542	BolC3t20145H	0	-	12	340	566	0.6007067
C3	60901672	60902601	BolC3t20146H	0	-	1534	895	929	0.9634015
C3	60920255	60921256	BolC3t20147H	0	-	129	928	1001	0.9270729
C3	60932209	60932654	BolC3t20148H	0	+	19	215	445	0.4831461
C3	60962799	60963697	BolC3t20149H	0	+	392	898	898	1.0000000
C3	60966985	60968963	BolC3t20150H	0	+	108	751	1978	0.3796764
C3	60974311	60974536	BolC3t20151H	0	-	92	225	225	1.0000000
C3	60975202	60975331	BolC3t20152H	0	-	40	129	129	1.0000000
C3	60978994	60980854	BolC3t20153H	0	-	332	1328	1860	0.7139785
C3	60993226	60994635	BolC3t20154H	0	-	2490	1409	1409	1.0000000
C3	60999538	61001664	BolC3t20155H	0	+	589	2074	2126	0.9755409
C3	61003759	61004827	BolC3t20156H	0	+	531	1051	1068	0.9840824
C3	61007056	61007284	BolC3t20157H	0	+	52	228	228	1.0000000
C3	61007276	61008608	BolC3t20158H	0	+	702	1332	1332	1.0000000
C3	61009449	61011819	BolC3t20159H	0	-	167	1456	2370	0.6143460
C3	61038946	61049810	BolC3t20160H	0	+	2706	10685	10864	0.9835235
C3	61046014	61047064	BolC3t20161H	0	+	300	1002	1050	0.9542857
C3	61058708	61059137	BolC3t20162H	0	-	23	405	429	0.9440559
C3	61060152	61061793	BolC3t20163H	0	-	307	1641	1641	1.0000000
C3	61064127	61064496	BolC3t20164H	0	-	18	95	369	0.2574526
C3	61066738	61067305	BolC3t20165H	0	+	514	567	567	1.0000000
C3	61078755	61079178	BolC3t20166H	0	+	10	338	423	0.7990544
C3	61079789	61080299	BolC3t20167H	0	-	185	510	510	1.0000000
C3	61089771	61091370	BolC3t20168H	0	-	245	1232	1599	0.7704815
C3	61106477	61111096	BolC3t20169H	0	+	1160	4534	4619	0.9815977
C3	61111561	61112095	BolC3t20170H	0	-	432	534	534	1.0000000
C3	61117508	61120337	BolC3t20171H	0	+	1119	2761	2829	0.9759632
C3	61141777	61143395	BolC3t20172H	0	-	167	1244	1618	0.7688504
C3	61162132	61162282	BolC3t20173H	0	-	19	150	150	1.0000000
C3	61164520	61164996	BolC3t20174H	0	-	85	476	476	1.0000000
C3	61187924	61190512	BolC3t20175H	0	-	1350	2588	2588	1.0000000
C3	61191997	61193352	BolC3t20176H	0	+	389	1161	1355	0.8568265
C3	61194856	61196636	BolC3t20177H	0	-	1036	1736	1780	0.9752809
C3	61203844	61205032	BolC3t20178H	0	+	90	1048	1188	0.8821549
C3	61220911	61221205	BolC3t20179H	0	+	192	294	294	1.0000000
C3	61227641	61229506	BolC3t20180H	0	-	20	285	1865	0.1528150
C3	61232853	61233189	BolC3t20181H	0	-	8	77	336	0.2291667
C3	61233562	61233898	BolC3t20182H	0	+	0	0	336	0.0000000
C3	61245207	61246264	BolC3t20183H	0	+	1340	1057	1057	1.0000000
C3	61250887	61251046	BolC3t20184H	0	-	168	159	159	1.0000000
C3	61274807	61276665	BolC3t20185H	0	-	12	134	1858	0.0721206
C3	61300980	61301341	BolC3t20186H	0	-	0	0	361	0.0000000
C3	61316413	61316913	BolC3t20187H	0	-	6	151	500	0.3020000
C3	61319953	61320361	BolC3t20188H	0	+	268	408	408	1.0000000
C3	61319985	61320380	BolC3t20189H	0	-	265	395	395	1.0000000
C3	61323885	61324781	BolC3t20190H	0	-	434	896	896	1.0000000
C3	61329768	61332120	BolC3t20191H	0	-	744	2135	2352	0.9077381
C3	61382934	61385129	BolC3t20192H	0	+	1823	2195	2195	1.0000000
C3	61387574	61388647	BolC3t20193H	0	+	751	1073	1073	1.0000000
C3	61391595	61391856	BolC3t20194H	0	-	33	261	261	1.0000000
C3	61396009	61397082	BolC3t20195H	0	+	1608	1073	1073	1.0000000
C3	61404150	61404540	BolC3t20196H	0	-	292	348	390	0.8923077
C3	61408728	61408947	BolC3t20197H	0	+	149	219	219	1.0000000
C3	61421723	61422593	BolC3t20198H	0	-	514	870	870	1.0000000
C3	61440633	61440891	BolC3t20199H	0	-	99	258	258	1.0000000
C3	61446931	61447300	BolC3t20200H	0	+	514	369	369	1.0000000
C3	61447606	61448521	BolC3t20201H	0	-	726	915	915	1.0000000
C3	61465960	61467728	BolC3t20202H	0	-	176	1047	1768	0.5921946
C3	61468184	61468647	BolC3t20203H	0	-	138	463	463	1.0000000
C3	61468662	61469158	BolC3t20204H	0	-	64	496	496	1.0000000
C3	61485813	61486237	BolC3t20205H	0	-	422	424	424	1.0000000
C3	61501778	61502054	BolC3t20206H	0	+	40	276	276	1.0000000
C3	61521840	61523582	BolC3t20207H	0	+	1485	1742	1742	1.0000000
C3	61524563	61542038	BolC3t20208H	0	-	8018	17314	17475	0.9907869
C3	61524744	61525053	BolC3t20209H	0	-	306	309	309	1.0000000
C3	61533232	61533578	BolC3t20210H	0	-	131	346	346	1.0000000
C3	61533897	61534390	BolC3t20211H	0	+	16	419	493	0.8498986
C3	61540645	61549489	BolC3t20212H	0	-	4339	8474	8844	0.9581637
C3	61549538	61559097	BolC3t20213H	0	-	2138	7495	9559	0.7840778
C3	61564899	61565833	BolC3t20214H	0	-	320	829	934	0.8875803
C3	61568863	61570069	BolC3t20215H	0	+	539	1175	1206	0.9742952
C3	61571749	61584215	BolC3t20216H	0	+	2452	7603	12466	0.6098989
C3	61575955	61577132	BolC3t20217H	0	-	72	514	1177	0.4367035
C3	61579551	61580059	BolC3t20218H	0	-	73	472	508	0.9291338
C3	61585857	61586493	BolC3t20219H	0	-	80	630	636	0.9905660
C3	61602851	61605396	BolC3t20220H	0	+	569	2281	2545	0.8962672
C3	61606512	61607530	BolC3t20221H	0	+	1045	1018	1018	1.0000000
C3	61607760	61609615	BolC3t20222H	0	+	1573	1847	1855	0.9956873
C3	61615489	61617721	BolC3t20223H	0	+	631	2034	2232	0.9112903
C3	61620684	61622704	BolC3t20224H	0	+	630	1897	2020	0.9391089
C3	61623375	61624401	BolC3t20225H	0	+	212	987	1026	0.9619883
C3	61628343	61628505	BolC3t20226H	0	-	98	162	162	1.0000000
C3	61666412	61666934	BolC3t20227H	0	+	108	388	522	0.7432950
C3	61667776	61668060	BolC3t20228H	0	+	19	139	284	0.4894366
C3	61668490	61668897	BolC3t20229H	0	-	73	406	407	0.9975430
C3	61674214	61678748	BolC3t20230H	0	-	480	2520	4534	0.5558006
C3	61688045	61688324	BolC3t20231H	0	+	466	279	279	1.0000000
C3	61690534	61692122	BolC3t20232H	0	+	782	1515	1588	0.9540302
C3	61696689	61700189	BolC3t20233H	0	-	835	1110	3500	0.3171428
C3	61739116	61739432	BolC3t20234H	0	-	0	0	316	0.0000000
C3	61739795	61740485	BolC3t20235H	0	+	0	0	690	0.0000000
C3	61741732	61741996	BolC3t20236H	0	+	0	0	264	0.0000000
C3	61744244	61745191	BolC3t20237H	0	+	673	947	947	1.0000000
C3	61745543	61749019	BolC3t20238H	0	-	2032	3454	3476	0.9936709
C3	61750792	61751669	BolC3t20239H	0	+	317	872	877	0.9942988
C3	61752098	61752618	BolC3t20240H	0	+	250	520	520	1.0000000
C3	61761960	61762685	BolC3t20241H	0	+	2	151	725	0.2082759
C3	61771300	61772517	BolC3t20242H	0	-	1249	1217	1217	1.0000000
C3	61773239	61774013	BolC3t20243H	0	+	7	213	774	0.2751938
C3	61776332	61777506	BolC3t20244H	0	+	392	1135	1174	0.9667802
C3	61786199	61787891	BolC3t20245H	0	+	1280	1588	1692	0.9385343
C3	61788085	61789691	BolC3t20246H	0	-	475	1601	1606	0.9968867
C3	61790879	61793664	BolC3t20247H	0	+	1696	2589	2785	0.9296230
C3	61797678	61800996	BolC3t20248H	0	+	2182	3297	3318	0.9936709
C3	61803743	61804967	BolC3t20249H	0	+	181	1190	1224	0.9722222
C3	61806560	61808416	BolC3t20250H	0	+	198	1856	1856	1.0000000
C3	61813268	61815169	BolC3t20251H	0	+	437	1791	1901	0.9421357
C3	61819250	61822890	BolC3t20252H	0	-	797	3427	3640	0.9414835
C3	61823451	61823706	BolC3t20253H	0	-	248	255	255	1.0000000
C3	61835147	61836385	BolC3t20254H	0	+	175	956	1238	0.7722132
C3	61838509	61840080	BolC3t20255H	0	-	58	816	1571	0.5194144
C3	61842260	61844096	BolC3t20256H	0	+	1821	1836	1836	1.0000000
C3	61844386	61846390	BolC3t20257H	0	+	1234	2004	2004	1.0000000
C3	61846525	61846931	BolC3t20258H	0	+	109	406	406	1.0000000
C3	61847207	61852693	BolC3t20259H	0	-	4501	5486	5486	1.0000000
C3	61853674	61853854	BolC3t20260H	0	-	25	180	180	1.0000000
C3	61868287	61869077	BolC3t20261H	0	+	515	790	790	1.0000000
C3	61870491	61870946	BolC3t20262H	0	+	144	455	455	1.0000000
C3	61875585	61877643	BolC3t20263H	0	+	941	2004	2058	0.9737610
C3	61879187	61880809	BolC3t20264H	0	-	399	1498	1622	0.9235511
C3	61907807	61908047	BolC3t20265H	0	-	1	13	240	0.0541667
C3	61910295	61911598	BolC3t20266H	0	-	211	905	1303	0.6945511
C3	61912499	61912852	BolC3t20267H	0	+	271	353	353	1.0000000
C3	61916631	61919246	BolC3t20268H	0	+	1019	2610	2615	0.9980879
C3	61919714	61920969	BolC3t20269H	0	-	216	1139	1255	0.9075697
C3	61922773	61923046	BolC3t20270H	0	+	54	273	273	1.0000000
C3	61923893	61924262	BolC3t20271H	0	+	4	200	369	0.5420054
C3	61924638	61930151	BolC3t20272H	0	-	1588	4737	5513	0.8592418
C3	61937231	61949811	BolC3t20273H	0	+	1028	6125	12580	0.4868839
C3	61950898	61952795	BolC3t20274H	0	+	201	1456	1897	0.7675277
C3	61953181	61955583	BolC3t20275H	0	-	491	2206	2402	0.9184014
C3	61957235	61957388	BolC3t20276H	0	-	106	153	153	1.0000000
C3	61965401	61967498	BolC3t20277H	0	+	383	2003	2097	0.9551740
C3	61970273	61970984	BolC3t20278H	0	-	80	662	711	0.9310830
C3	61972938	61976604	BolC3t20279H	0	-	846	3417	3666	0.9320785
C3	61978482	61985630	BolC3t20280H	0	+	1336	6332	7148	0.8858422
C3	61986533	61987566	BolC3t20281H	0	-	425	1011	1033	0.9787028
C3	61988540	61991055	BolC3t20282H	0	-	826	2151	2515	0.8552684
C3	62015042	62015231	BolC3t20283H	0	+	0	0	189	0.0000000
C3	62025521	62026522	BolC3t20284H	0	-	584	1001	1001	1.0000000
C3	62028007	62028601	BolC3t20285H	0	+	360	584	594	0.9831650
C3	62029328	62029664	BolC3t20286H	0	-	148	336	336	1.0000000
C3	62043430	62045080	BolC3t20287H	0	+	694	1632	1650	0.9890909
C3	62045975	62046472	BolC3t20288H	0	+	149	473	497	0.9517103
C3	62068515	62071909	BolC3t20289H	0	+	1078	2991	3394	0.8812611
C3	62076331	62077986	BolC3t20290H	0	-	0	0	1655	0.0000000
C3	62092921	62093342	BolC3t20291H	0	-	113	421	421	1.0000000
C3	62094910	62095468	BolC3t20292H	0	+	9	171	558	0.3064516
C3	62105779	62106651	BolC3t20293H	0	-	546	872	872	1.0000000
C3	62113289	62125200	BolC3t20294H	0	+	2061	8291	11911	0.6960793
C3	62135734	62135881	BolC3t20295H	0	-	50	147	147	1.0000000
C3	62140197	62155657	BolC3t20296H	0	+	7715	9538	15460	0.6169469
C3	62158769	62159955	BolC3t20297H	0	-	1100	1186	1186	1.0000000
C3	62163892	62165417	BolC3t20298H	0	+	736	1466	1525	0.9613115
C3	62168658	62178587	BolC3t20299H	0	-	4695	9414	9929	0.9481317
C3	62180552	62180777	BolC3t20300H	0	+	9	225	225	1.0000000
C3	62183261	62183708	BolC3t20301H	0	-	65	447	447	1.0000000
C3	62186319	62187926	BolC3t20302H	0	+	503	1607	1607	1.0000000
C3	62202070	62202534	BolC3t20303H	0	-	59	404	464	0.8706896
C3	62203811	62204520	BolC3t20304H	0	-	189	575	709	0.8110014
C3	62207011	62207839	BolC3t20305H	0	+	815	828	828	1.0000000
C3	62209770	62210134	BolC3t20306H	0	-	316	364	364	1.0000000
C3	62217699	62220219	BolC3t20307H	0	+	2281	2520	2520	1.0000000
C3	62220460	62221863	BolC3t20308H	0	-	1096	1267	1403	0.9030648
C3	62222601	62222945	BolC3t20309H	0	+	184	344	344	1.0000000
C3	62223184	62225030	BolC3t20310H	0	+	1164	1846	1846	1.0000000
C3	62225472	62227739	BolC3t20311H	0	+	498	1951	2267	0.8606088
C3	62230366	62230619	BolC3t20312H	0	-	3	118	253	0.4664032
C3	62239724	62239838	BolC3t20313H	0	-	111	114	114	1.0000000
C3	62243723	62244305	BolC3t20314H	0	-	16	419	582	0.7199312
C3	62247365	62250282	BolC3t20315H	0	+	2344	2917	2917	1.0000000
C3	62250239	62250614	BolC3t20316H	0	+	493	375	375	1.0000000
C3	62251041	62251793	BolC3t20317H	0	-	237	684	752	0.9095744
C3	62254086	62254321	BolC3t20318H	0	+	8	235	235	1.0000000
C3	62255363	62255895	BolC3t20319H	0	-	112	532	532	1.0000000
C3	62256093	62256328	BolC3t20320H	0	-	17	235	235	1.0000000
C3	62260449	62261283	BolC3t20321H	0	+	6	91	834	0.1091127
C3	62263281	62264020	BolC3t20322H	0	+	0	0	739	0.0000000
C3	62267721	62268179	BolC3t20323H	0	-	0	0	458	0.0000000
C3	62269699	62269882	BolC3t20324H	0	-	13	183	183	1.0000000
C3	62275493	62276369	BolC3t20325H	0	-	5	238	876	0.2716895
C3	62276736	62277611	BolC3t20326H	0	-	3	37	875	0.0422857
C3	62279294	62279636	BolC3t20327H	0	+	0	0	342	0.0000000
C3	62280893	62281185	BolC3t20328H	0	+	0	0	292	0.0000000
C3	62289492	62289675	BolC3t20329H	0	-	16	183	183	1.0000000
C3	62315357	62318133	BolC3t20330H	0	+	1685	2559	2776	0.9218300
C3	62324747	62325320	BolC3t20331H	0	+	611	573	573	1.0000000
C3	62330262	62330964	BolC3t20332H	0	+	176	702	702	1.0000000
C3	62331086	62331462	BolC3t20333H	0	+	242	376	376	1.0000000
C3	62341744	62343043	BolC3t20334H	0	+	215	1131	1299	0.8706697
C3	62344791	62346527	BolC3t20335H	0	+	907	1732	1736	0.9976959
C3	62352085	62355426	BolC3t20336H	0	+	2003	3064	3341	0.9170907
C3	62361856	62362240	BolC3t20337H	0	-	434	384	384	1.0000000
C3	62363340	62365255	BolC3t20338H	0	+	984	1718	1915	0.8971279
C3	62367166	62368255	BolC3t20339H	0	+	501	1040	1089	0.9550046
C3	62369485	62373231	BolC3t20340H	0	+	2312	3427	3746	0.9148425
C3	62373595	62374384	BolC3t20341H	0	-	136	697	789	0.8833967
C3	62375053	62376619	BolC3t20342H	0	-	290	1553	1566	0.9916986
C3	62378741	62404578	BolC3t20343H	0	-	8480	19967	25837	0.7728065
C3	62387233	62389029	BolC3t20344H	0	+	984	1796	1796	1.0000000
C3	62390910	62391330	BolC3t20345H	0	+	9	20	420	0.0476190
C3	62421649	62422135	BolC3t20346H	0	+	201	459	486	0.9444444
C3	62422912	62426531	BolC3t20347H	0	-	587	2376	3619	0.6565350
C3	62433680	62439558	BolC3t20348H	0	-	1158	4126	5878	0.7019395
C3	62443051	62443324	BolC3t20349H	0	-	114	273	273	1.0000000
C3	62460372	62467268	BolC3t20350H	0	-	80	1507	6896	0.2185325
C3	62470109	62470947	BolC3t20351H	0	+	132	838	838	1.0000000
C3	62478536	62480357	BolC3t20352H	0	+	1694	1821	1821	1.0000000
C3	62480890	62486012	BolC3t20353H	0	-	933	4412	5122	0.8613822
C3	62500675	62503105	BolC3t20354H	0	+	298	1669	2430	0.6868313
C3	62505586	62508242	BolC3t20355H	0	+	861	1972	2656	0.7424699
C3	62513065	62514449	BolC3t20356H	0	+	1057	1384	1384	1.0000000
C3	62516676	62518559	BolC3t20357H	0	-	258	1571	1883	0.8343070
C3	62532743	62533226	BolC3t20358H	0	-	129	483	483	1.0000000
C3	62538997	62539399	BolC3t20359H	0	+	21	182	402	0.4527363
C3	62539477	62541929	BolC3t20360H	0	+	1051	2452	2452	1.0000000
C3	62542855	62543368	BolC3t20361H	0	+	121	513	513	1.0000000
C3	62543970	62544327	BolC3t20362H	0	-	113	357	357	1.0000000
C3	62545912	62546346	BolC3t20363H	0	-	244	434	434	1.0000000
C3	62550656	62550764	BolC3t20364H	0	-	15	108	108	1.0000000
C3	62554101	62555193	BolC3t20365H	0	-	26	808	1092	0.7399268
C3	62598956	62599453	BolC3t20366H	0	+	471	497	497	1.0000000
C3	62604878	62605433	BolC3t20367H	0	+	285	341	555	0.6144144
C3	62614055	62614505	BolC3t20368H	0	+	92	440	450	0.9777778
C3	62626901	62627258	BolC3t20369H	0	-	247	357	357	1.0000000
C3	62627591	62627834	BolC3t20370H	0	+	326	243	243	1.0000000
C3	62640695	62643273	BolC3t20371H	0	+	1070	2494	2578	0.9674166
C3	62646497	62646683	BolC3t20372H	0	-	124	186	186	1.0000000
C3	62647662	62648191	BolC3t20373H	0	-	431	529	529	1.0000000
C3	62650315	62652274	BolC3t20374H	0	-	411	1396	1959	0.7126085
C3	62655406	62657217	BolC3t20375H	0	-	1214	1805	1811	0.9966869
C3	62663620	62664636	BolC3t20376H	0	-	151	587	1016	0.5777559
C3	62672377	62673211	BolC3t20377H	0	-	351	834	834	1.0000000
C3	62675278	62678658	BolC3t20378H	0	+	819	2681	3380	0.7931952
C3	62679231	62679564	BolC3t20379H	0	-	65	333	333	1.0000000
C3	62683921	62684182	BolC3t20380H	0	+	53	254	261	0.9731801
C3	62692894	62693233	BolC3t20381H	0	+	61	229	339	0.6755162
C3	62699010	62700210	BolC3t20382H	0	-	183	1144	1200	0.9533333
C3	62714867	62715134	BolC3t20383H	0	-	9	50	267	0.1872659
C3	62719447	62719726	BolC3t20384H	0	+	61	279	279	1.0000000
C3	62731647	62731965	BolC3t20385H	0	+	208	318	318	1.0000000
C3	62742790	62743435	BolC3t20386H	0	-	140	240	645	0.3720930
C3	62751109	62751996	BolC3t20387H	0	-	519	864	887	0.9740699
C3	62756133	62758385	BolC3t20388H	0	-	455	2131	2252	0.9462700
C3	62773945	62774086	BolC3t20389H	0	+	114	141	141	1.0000000
C3	62777840	62778080	BolC3t20390H	0	+	2	70	240	0.2916667
C3	62781988	62782559	BolC3t20391H	0	-	256	571	571	1.0000000
C3	62800922	62802014	BolC3t20392H	0	+	24	725	1092	0.6639194
C3	62821096	62822261	BolC3t20393H	0	+	35	325	1165	0.2789699
C3	62837483	62838987	BolC3t20394H	0	-	79	792	1504	0.5265958
C3	62850723	62853657	BolC3t20395H	0	-	860	2295	2934	0.7822086
C3	62875430	62876117	BolC3t20396H	0	-	746	681	687	0.9912664
C3	62876715	62877223	BolC3t20397H	0	-	62	508	508	1.0000000
C3	62890631	62893630	BolC3t20398H	0	+	1571	2999	2999	1.0000000
C3	62905869	62906151	BolC3t20399H	0	+	8	179	282	0.6347518
C3	62913795	62917053	BolC3t20400H	0	+	2922	3258	3258	1.0000000
C3	62917364	62918533	BolC3t20401H	0	+	41	519	1169	0.4439692
C3	62937605	62938187	BolC3t20402H	0	+	21	254	582	0.4364261
C3	62943760	62944384	BolC3t20403H	0	-	229	624	624	1.0000000
C3	62945263	62949320	BolC3t20404H	0	+	1581	2793	4057	0.6884397
C3	62965681	62968030	BolC3t20405H	0	+	269	1299	2349	0.5530013
C3	62976275	62977253	BolC3t20406H	0	+	0	0	978	0.0000000
C3	62978329	62978602	BolC3t20407H	0	+	0	0	273	0.0000000
C3	62979094	62979220	BolC3t20408H	0	-	0	0	126	0.0000000
C3	62983978	62984341	BolC3t20409H	0	+	61	301	363	0.8292011
C3	62988342	62989233	BolC3t20410H	0	+	54	504	891	0.5656565
C3	62990147	62990507	BolC3t20411H	0	-	59	360	360	1.0000000
C3	62991562	62993407	BolC3t20412H	0	+	1102	1845	1845	1.0000000
C3	63002641	63004111	BolC3t20413H	0	-	164	1151	1470	0.7829932
C3	63009535	63009784	BolC3t20414H	0	+	414	249	249	1.0000000
C3	63024168	63025799	BolC3t20415H	0	+	472	1511	1631	0.9264255
C3	63028351	63029653	BolC3t20416H	0	-	298	1302	1302	1.0000000
C3	63064195	63066515	BolC3t20417H	0	+	447	2170	2320	0.9353448
C3	63067754	63068921	BolC3t20418H	0	-	592	1115	1167	0.9554413
C3	63087515	63088380	BolC3t20419H	0	-	361	865	865	1.0000000
C3	63088767	63090255	BolC3t20420H	0	+	12	487	1488	0.3272849
C3	63095564	63096042	BolC3t20421H	0	+	15	93	478	0.1945607
C3	63096191	63097586	BolC3t20422H	0	-	248	1337	1395	0.9584230
C3	63108558	63109521	BolC3t20423H	0	+	143	866	963	0.8992731
C3	63110396	63111575	BolC3t20424H	0	-	189	1133	1179	0.9609839
C3	63123613	63131658	BolC3t20425H	0	+	4476	8044	8045	0.9998757
C3	63135070	63137860	BolC3t20426H	0	+	761	2305	2790	0.8261649
C3	63138718	63154358	BolC3t20427H	0	+	6070	12109	15640	0.7742327
C3	63164198	63166120	BolC3t20428H	0	+	383	1580	1922	0.8220603
C3	63169275	63169866	BolC3t20429H	0	+	153	589	591	0.9966159
C3	63170130	63171657	BolC3t20430H	0	-	333	1047	1527	0.6856582
C3	63184067	63186775	BolC3t20431H	0	+	201	1415	2708	0.5225258
C3	63195098	63197407	BolC3t20432H	0	+	806	2309	2309	1.0000000
C3	63205792	63210039	BolC3t20433H	0	+	3299	4247	4247	1.0000000
C3	63233673	63243304	BolC3t20434H	0	-	491	4466	9631	0.4637109
C3	63243381	63244053	BolC3t20435H	0	-	35	421	672	0.6264881
C3	63249126	63249459	BolC3t20436H	0	+	45	308	333	0.9249249
C3	63251831	63253617	BolC3t20437H	0	-	758	1636	1786	0.9160134
C3	63254045	63254261	BolC3t20438H	0	+	186	216	216	1.0000000
C3	63269513	63269979	BolC3t20439H	0	+	471	466	466	1.0000000
C3	63273231	63274659	BolC3t20440H	0	-	474	1428	1428	1.0000000
C3	63280791	63281628	BolC3t20441H	0	+	425	837	837	1.0000000
C3	63282027	63284523	BolC3t20442H	0	-	221	2086	2496	0.8357372
C3	63285371	63285539	BolC3t20443H	0	-	119	168	168	1.0000000
C3	63296520	63297945	BolC3t20444H	0	+	521	1268	1425	0.8898246
C3	63298765	63301572	BolC3t20445H	0	-	1051	2506	2807	0.8927681
C3	63308810	63309971	BolC3t20446H	0	-	329	1096	1161	0.9440138
C3	63320958	63321262	BolC3t20447H	0	+	139	304	304	1.0000000
C3	63321493	63321956	BolC3t20448H	0	+	399	463	463	1.0000000
C3	63321734	63322219	BolC3t20449H	0	+	305	485	485	1.0000000
C3	63323387	63324108	BolC3t20450H	0	-	698	721	721	1.0000000
C3	63325483	63326262	BolC3t20451H	0	-	8	247	779	0.3170732
C3	63326335	63326443	BolC3t20452H	0	-	22	108	108	1.0000000
C3	63336273	63336417	BolC3t20453H	0	+	4	144	144	1.0000000
C3	63336835	63337063	BolC3t20454H	0	+	23	228	228	1.0000000
C3	63343612	63344041	BolC3t20455H	0	-	233	429	429	1.0000000
C3	63360182	63361359	BolC3t20456H	0	-	674	1177	1177	1.0000000
C3	63361525	63363563	BolC3t20457H	0	+	925	1876	2038	0.9205103
C3	63370499	63379872	BolC3t20458H	0	+	3529	7782	9373	0.8302571
C3	63395063	63395727	BolC3t20459H	0	+	96	664	664	1.0000000
C3	63396520	63398648	BolC3t20460H	0	-	1647	2128	2128	1.0000000
C3	63399112	63401080	BolC3t20461H	0	+	358	1798	1968	0.9136179
C3	63409117	63410147	BolC3t20462H	0	+	342	1019	1030	0.9893204
C3	63410535	63410685	BolC3t20463H	0	-	40	150	150	1.0000000
C3	63412925	63415627	BolC3t20464H	0	+	376	1860	2702	0.6883790
C3	63420746	63421772	BolC3t20465H	0	+	124	855	1026	0.8333333
C3	63423043	63423747	BolC3t20466H	0	+	68	618	704	0.8778409
C3	63430457	63441631	BolC3t20467H	0	+	3917	11172	11174	0.9998210
C3	63443562	63446258	BolC3t20468H	0	-	35	1303	2696	0.4833086
C3	63460904	63461451	BolC3t20469H	0	-	153	547	547	1.0000000
C3	63464628	63467172	BolC3t20470H	0	-	84	1008	2544	0.3962264
C3	63479574	63479994	BolC3t20471H	0	-	11	114	420	0.2714286
C3	63490984	63491170	BolC3t20472H	0	+	69	186	186	1.0000000
C3	63515445	63537710	BolC3t20473H	0	-	7634	16719	22265	0.7509095
C3	63522255	63523011	BolC3t20474H	0	-	52	661	756	0.8743386
C3	63532824	63534042	BolC3t20475H	0	+	132	1194	1218	0.9802955
C3	63546970	63548407	BolC3t20476H	0	+	2	72	1437	0.0501044
C3	63564049	63564570	BolC3t20477H	0	+	101	521	521	1.0000000
C3	63566235	63577804	BolC3t20478H	0	-	2473	5339	11569	0.4614919
C3	63585965	63587925	BolC3t20479H	0	+	1255	1960	1960	1.0000000
C3	63604896	63605592	BolC3t20480H	0	-	465	696	696	1.0000000
C3	63605638	63606306	BolC3t20481H	0	-	398	668	668	1.0000000
C3	63607486	63608595	BolC3t20482H	0	+	949	1109	1109	1.0000000
C3	63608591	63611225	BolC3t20483H	0	+	289	1859	2634	0.7057707
C3	63613014	63616992	BolC3t20484H	0	+	284	2193	3978	0.5512820
C3	63633458	63634003	BolC3t20485H	0	+	429	494	545	0.9064220
C3	63635126	63635336	BolC3t20486H	0	-	433	210	210	1.0000000
C3	63636751	63638264	BolC3t20487H	0	+	364	1261	1513	0.8334435
C3	63638547	63639180	BolC3t20488H	0	-	336	633	633	1.0000000
C3	63662029	63664791	BolC3t20489H	0	-	23	43	2762	0.0155684
C3	63666120	63668143	BolC3t20490H	0	-	24	567	2023	0.2802768
C3	63673956	63674172	BolC3t20491H	0	+	36	216	216	1.0000000
C3	63675459	63675939	BolC3t20492H	0	+	0	0	480	0.0000000
C3	63677152	63677632	BolC3t20493H	0	+	0	0	480	0.0000000
C3	63678852	63682364	BolC3t20494H	0	+	1876	2974	3512	0.8468109
C3	63684482	63685103	BolC3t20495H	0	+	41	429	621	0.6908212
C3	63700506	63701604	BolC3t20496H	0	+	390	1098	1098	1.0000000
C3	63707782	63708520	BolC3t20497H	0	+	88	718	738	0.9728997
C3	63710998	63713822	BolC3t20498H	0	+	1473	2499	2824	0.8849150
C3	63714512	63734272	BolC3t20499H	0	-	8634	15932	19760	0.8062753
C3	63723397	63724561	BolC3t20500H	0	+	194	1164	1164	1.0000000
C3	63734386	63735184	BolC3t20501H	0	-	175	471	798	0.5902256
C3	63754485	63757875	BolC3t20502H	0	-	1810	3390	3390	1.0000000
C3	63761533	63762600	BolC3t20503H	0	-	648	1067	1067	1.0000000
C3	63781112	63782472	BolC3t20504H	0	-	402	1031	1360	0.7580882
C3	63786828	63787741	BolC3t20505H	0	+	52	753	913	0.8247536
C3	63807072	63807754	BolC3t20506H	0	+	46	677	682	0.9926686
C3	63816360	63816618	BolC3t20507H	0	+	0	0	258	0.0000000
C3	63825299	63826113	BolC3t20508H	0	+	493	814	814	1.0000000
C3	63834892	63835357	BolC3t20509H	0	-	795	465	465	1.0000000
C3	63845326	63846031	BolC3t20510H	0	-	512	705	705	1.0000000
C3	63882792	63883490	BolC3t20511H	0	+	0	0	698	0.0000000
C3	63884517	63884829	BolC3t20512H	0	-	1	78	312	0.2500000
C3	63899482	63900745	BolC3t20513H	0	+	11	405	1263	0.3206651
C3	63901787	63902099	BolC3t20514H	0	-	19	312	312	1.0000000
C3	63911136	63911561	BolC3t20515H	0	+	246	425	425	1.0000000
C3	63913516	63915245	BolC3t20516H	0	-	93	1095	1729	0.6333141
C3	63918111	63918345	BolC3t20517H	0	+	99	234	234	1.0000000
C3	63926781	63928313	BolC3t20518H	0	-	267	1365	1532	0.8909922
C3	63931103	63932283	BolC3t20519H	0	+	25	534	1180	0.4525424
C3	63934416	63935217	BolC3t20520H	0	+	17	176	801	0.2197253
C3	63949259	63949796	BolC3t20521H	0	-	499	537	537	1.0000000
C3	63959457	63959790	BolC3t20522H	0	-	13	178	333	0.5345345
C3	63960336	63960651	BolC3t20523H	0	-	18	291	315	0.9238095
C3	63973892	63974166	BolC3t20524H	0	-	178	274	274	1.0000000
C3	63977226	63979041	BolC3t20525H	0	-	652	1601	1815	0.8820937
C3	63992676	63992892	BolC3t20526H	0	-	21	168	216	0.7777778
C3	63997685	64009020	BolC3t20527H	0	-	1274	4888	11335	0.4312307
C3	64010857	64011826	BolC3t20528H	0	-	584	969	969	1.0000000
C3	64013359	64013823	BolC3t20529H	0	+	195	464	464	1.0000000
C3	64014780	64016203	BolC3t20530H	0	+	767	1423	1423	1.0000000
C3	64017229	64018209	BolC3t20531H	0	-	803	980	980	1.0000000
C3	64020510	64020963	BolC3t20532H	0	-	212	453	453	1.0000000
C3	64030674	64030995	BolC3t20533H	0	+	16	242	321	0.7538941
C3	64052965	64053374	BolC3t20534H	0	+	50	394	409	0.9633252
C3	64058426	64060227	BolC3t20535H	0	+	267	1689	1801	0.9378123
C3	64064342	64065074	BolC3t20536H	0	-	282	732	732	1.0000000
C3	64076193	64076645	BolC3t20537H	0	-	479	452	452	1.0000000
C3	64079869	64082056	BolC3t20538H	0	-	31	1028	2187	0.4700503
C3	64087965	64088850	BolC3t20539H	0	+	166	873	885	0.9864407
C3	64092261	64093146	BolC3t20540H	0	+	102	885	885	1.0000000
C3	64094839	64095694	BolC3t20541H	0	+	0	0	855	0.0000000
C3	64101033	64101855	BolC3t20542H	0	+	282	822	822	1.0000000
C3	64106234	64107425	BolC3t20543H	0	-	8	94	1191	0.0789253
C3	64120251	64120703	BolC3t20544H	0	-	325	452	452	1.0000000
C3	64121622	64121883	BolC3t20545H	0	-	22	208	261	0.7969348
C3	64131042	64134127	BolC3t20546H	0	+	1769	3076	3085	0.9970827
C3	64146515	64146896	BolC3t20547H	0	-	329	381	381	1.0000000
C3	64182192	64182654	BolC3t20548H	0	-	210	462	462	1.0000000
C3	64233102	64233705	BolC3t20549H	0	+	372	603	603	1.0000000
C3	64247919	64248135	BolC3t20550H	0	-	138	216	216	1.0000000
C3	64256093	64256683	BolC3t20551H	0	-	475	590	590	1.0000000
C3	64256853	64257036	BolC3t20552H	0	-	176	183	183	1.0000000
C3	64281302	64281775	BolC3t20553H	0	-	436	473	473	1.0000000
C3	64291024	64291320	BolC3t20554H	0	-	362	296	296	1.0000000
C3	64292190	64292550	BolC3t20555H	0	-	246	360	360	1.0000000
C3	64293332	64294492	BolC3t20556H	0	-	612	1160	1160	1.0000000
C3	64301214	64303480	BolC3t20557H	0	-	1201	2266	2266	1.0000000
C3	64303920	64304106	BolC3t20558H	0	-	45	186	186	1.0000000
C3	64319817	64319961	BolC3t20559H	0	-	143	144	144	1.0000000
C3	64321604	64322843	BolC3t20560H	0	+	931	1239	1239	1.0000000
C3	64325869	64328246	BolC3t20561H	0	+	1199	2371	2377	0.9974758
C3	64329624	64329944	BolC3t20562H	0	-	195	320	320	1.0000000
C3	64346091	64347941	BolC3t20563H	0	+	654	1580	1850	0.8540540
C3	64355588	64356755	BolC3t20564H	0	-	144	678	1167	0.5809768
C3	64357597	64358236	BolC3t20565H	0	-	157	636	639	0.9953052
C3	64367483	64367855	BolC3t20566H	0	-	73	372	372	1.0000000
C3	64375547	64375856	BolC3t20567H	0	-	38	309	309	1.0000000
C3	64429950	64433379	BolC3t20568H	0	+	778	2910	3429	0.8486439
C3	64436861	64466422	BolC3t20569H	0	+	6517	25549	29561	0.8642806
C3	64467545	64468979	BolC3t20570H	0	+	331	1286	1434	0.8967922
C3	64472246	64472910	BolC3t20571H	0	-	0	0	664	0.0000000
C3	64473145	64475217	BolC3t20572H	0	-	979	1814	2072	0.8754826
C3	64476192	64477124	BolC3t20573H	0	+	375	932	932	1.0000000
C3	64477716	64478498	BolC3t20574H	0	+	177	724	782	0.9258312
C3	64481691	64482126	BolC3t20575H	0	-	33	400	435	0.9195402
C3	64482177	64482309	BolC3t20576H	0	+	28	29	132	0.2196970
C3	64488286	64488688	BolC3t20577H	0	+	429	402	402	1.0000000
C3	64489988	64490750	BolC3t20578H	0	-	372	762	762	1.0000000
C3	64491476	64509058	BolC3t20579H	0	-	10625	16177	17582	0.9200887
C3	64517166	64519016	BolC3t20580H	0	-	108	869	1850	0.4697297
C3	64521514	64522069	BolC3t20581H	0	-	41	284	555	0.5117117
C3	64532199	64532378	BolC3t20582H	0	+	1	36	179	0.2011173
C3	64538338	64539934	BolC3t20583H	0	+	432	1323	1596	0.8289474
C3	64547760	64548849	BolC3t20584H	0	-	455	1089	1089	1.0000000
C3	64555209	64558571	BolC3t20585H	0	+	232	2007	3362	0.5969661
C3	64562240	64564309	BolC3t20586H	0	+	371	1745	2069	0.8434026
C3	64566227	64566377	BolC3t20587H	0	-	141	150	150	1.0000000
C3	64571997	64577976	BolC3t20588H	0	+	868	4484	5979	0.7499582
C3	64580753	64581044	BolC3t20589H	0	-	0	0	291	0.0000000
C3	64583904	64584465	BolC3t20590H	0	-	545	561	561	1.0000000
C3	64590807	64592349	BolC3t20591H	0	-	584	1460	1542	0.9468223
C3	64607500	64609528	BolC3t20592H	0	-	459	1667	2028	0.8219921
C3	64622708	64623405	BolC3t20593H	0	-	505	697	697	1.0000000
C3	64641850	64642201	BolC3t20594H	0	-	369	351	351	1.0000000
C3	64644917	64645244	BolC3t20595H	0	+	136	327	327	1.0000000
C3	64645867	64650248	BolC3t20596H	0	-	1352	3634	4381	0.8294910
C3	64659842	64664389	BolC3t20597H	0	+	1327	3941	4547	0.8667253
C3	64665180	64665576	BolC3t20598H	0	-	38	396	396	1.0000000
C3	64668559	64670244	BolC3t20599H	0	-	498	1253	1685	0.7436202
C3	64682887	64684024	BolC3t20600H	0	-	803	1137	1137	1.0000000
C3	64690781	64691175	BolC3t20601H	0	+	27	371	394	0.9416243
C3	64698528	64700499	BolC3t20602H	0	-	65	916	1971	0.4647387
C3	64724843	64727059	BolC3t20603H	0	-	1453	2216	2216	1.0000000
C3	64730522	64732502	BolC3t20604H	0	-	154	1230	1980	0.6212121
C3	64750979	64752491	BolC3t20605H	0	-	45	313	1512	0.2070106
C3	64754834	64755044	BolC3t20606H	0	+	161	210	210	1.0000000
C3	64757478	64758108	BolC3t20607H	0	+	272	630	630	1.0000000
C3	64758594	64761153	BolC3t20608H	0	-	1438	2446	2559	0.9558421
C3	64764126	64764340	BolC3t20609H	0	+	304	214	214	1.0000000
C3	64766691	64766974	BolC3t20610H	0	-	366	283	283	1.0000000
C3	64767627	64769615	BolC3t20611H	0	-	829	1759	1988	0.8848088
C3	64789850	64791062	BolC3t20612H	0	+	1346	1212	1212	1.0000000
C3	64794673	64798721	BolC3t20613H	0	-	1785	3086	4048	0.7623518
C3	64817195	64817399	BolC3t20614H	0	+	181	204	204	1.0000000
C3	64819373	64824516	BolC3t20615H	0	+	2165	4265	5143	0.8292825
C3	64825250	64826078	BolC3t20616H	0	-	493	828	828	1.0000000
C3	64835029	64836758	BolC3t20617H	0	+	7	108	1729	0.0624639
C3	64851334	64852624	BolC3t20618H	0	-	1651	1290	1290	1.0000000
C3	64852660	64853440	BolC3t20619H	0	-	1265	780	780	1.0000000
C3	64854166	64854442	BolC3t20620H	0	-	547	276	276	1.0000000
C3	64858996	64859216	BolC3t20621H	0	+	316	220	220	1.0000000
C3	64873151	64875875	BolC3t20622H	0	+	1184	2614	2724	0.9596182
C3	64877987	64889491	BolC3t20623H	0	-	2667	7844	11504	0.6818498
C3	64886891	64887618	BolC3t20624H	0	+	122	702	727	0.9656121
C3	64902689	64902944	BolC3t20625H	0	+	65	255	255	1.0000000
C3	64902953	64903169	BolC3t20626H	0	-	124	216	216	1.0000000
C3	64912027	64912660	BolC3t20627H	0	-	668	633	633	1.0000000
C3	64914097	64916513	BolC3t20628H	0	-	1258	2416	2416	1.0000000
C3	64916779	64921717	BolC3t20629H	0	-	2694	4933	4938	0.9989874
C3	64922832	64926169	BolC3t20630H	0	-	689	2629	3337	0.7878334
C3	64936126	64937492	BolC3t20631H	0	-	867	1366	1366	1.0000000
C3	64937843	64938303	BolC3t20632H	0	-	337	460	460	1.0000000
C3	64938588	64945225	BolC3t20633H	0	+	2977	6241	6637	0.9403345
C3	64948194	64949725	BolC3t20634H	0	+	1064	1531	1531	1.0000000
C3	64950734	64954947	BolC3t20635H	0	-	2653	3989	4213	0.9468312
C3	64957396	64958161	BolC3t20636H	0	-	22	480	765	0.6274510
C3	64962006	64962240	BolC3t20637H	0	-	11	132	234	0.5641026
C3	64976604	64977423	BolC3t20638H	0	-	596	819	819	1.0000000
C3	64980320	64989047	BolC3t20639H	0	-	3989	8705	8727	0.9974791
C3	64986372	64987137	BolC3t20640H	0	-	286	765	765	1.0000000
C3	65004224	65004425	BolC3t20641H	0	-	7	30	201	0.1492537
C3	65013678	65014166	BolC3t20642H	0	-	160	446	488	0.9139344
C3	65014637	65016186	BolC3t20643H	0	-	130	1184	1549	0.7643641
C3	65016769	65017949	BolC3t20644H	0	-	289	1053	1180	0.8923729
C3	65020883	65022635	BolC3t20645H	0	-	481	1495	1752	0.8533105
C3	65023617	65027737	BolC3t20646H	0	-	809	3447	4120	0.8366505
C3	65029775	65031924	BolC3t20647H	0	+	1343	2078	2149	0.9669614
C3	65039888	65045925	BolC3t20648H	0	-	289	4297	6037	0.7117774
C3	65055581	65055971	BolC3t20649H	0	-	75	390	390	1.0000000
C3	65071900	65072202	BolC3t20650H	0	-	10	146	302	0.4834437
C3	65090794	65094830	BolC3t20651H	0	+	473	3401	4036	0.8426660
C3	65097888	65099318	BolC3t20652H	0	+	997	1430	1430	1.0000000
C3	65099736	65101217	BolC3t20653H	0	-	384	1481	1481	1.0000000
C3	65112032	65152584	BolC3t20654H	0	+	15957	30975	40552	0.7638341
C3	65125168	65125804	BolC3t20655H	0	-	8	291	636	0.4575472
C3	65147351	65148001	BolC3t20656H	0	-	980	650	650	1.0000000
C3	65153071	65155317	BolC3t20657H	0	+	915	1760	2246	0.7836153
C3	65159996	65162928	BolC3t20658H	0	+	1264	2709	2932	0.9239427
C3	65166346	65166841	BolC3t20659H	0	-	0	0	495	0.0000000
C3	65168037	65168856	BolC3t20660H	0	-	27	492	819	0.6007326
C3	65171227	65172577	BolC3t20661H	0	-	21	327	1350	0.2422222
C3	65197781	65199048	BolC3t20662H	0	+	497	1267	1267	1.0000000
C3	65211744	65215706	BolC3t20663H	0	-	1079	2937	3962	0.7412923
C3	65220729	65221382	BolC3t20664H	0	-	144	490	653	0.7503828
C3	65224346	65228688	BolC3t20665H	0	-	1331	3450	4342	0.7945647
C3	65247714	65251722	BolC3t20666H	0	-	2576	4008	4008	1.0000000
C3	65259441	65260667	BolC3t20667H	0	+	287	1168	1226	0.9526917
C3	65261463	65261928	BolC3t20668H	0	-	3	61	465	0.1311828
C3	65265536	65266492	BolC3t20669H	0	+	34	126	956	0.1317992
C3	65267015	65267486	BolC3t20670H	0	-	162	86	471	0.1825902
C3	65274320	65275754	BolC3t20671H	0	-	1089	1434	1434	1.0000000
C3	65280778	65281535	BolC3t20672H	0	-	76	674	757	0.8903567
C3	65281602	65281866	BolC3t20673H	0	-	14	182	264	0.6893939
C3	65282753	65296192	BolC3t20674H	0	-	2879	9326	13439	0.6939504
C3	65305217	65305673	BolC3t20675H	0	+	31	333	456	0.7302632
C3	65315494	65317258	BolC3t20676H	0	-	160	1077	1764	0.6105442
C3	65319564	65325614	BolC3t20677H	0	-	1929	4087	6050	0.6755372
C3	65323916	65324509	BolC3t20678H	0	+	20	54	593	0.0910624
C3	65326081	65326495	BolC3t20679H	0	-	166	356	414	0.8599034
C3	65365161	65383332	BolC3t20680H	0	+	3498	7137	18171	0.3927687
C3	65385267	65385405	BolC3t20681H	0	+	15	91	138	0.6594203
C3	65394699	65395449	BolC3t20682H	0	+	712	750	750	1.0000000
C3	65401029	65403906	BolC3t20683H	0	-	1296	2825	2877	0.9819256
C3	65409766	65412956	BolC3t20684H	0	+	1191	2980	3190	0.9341693
C3	65414044	65415446	BolC3t20685H	0	-	334	1365	1402	0.9736091
C3	65421661	65422890	BolC3t20686H	0	-	731	1229	1229	1.0000000
C3	65424944	65426387	BolC3t20687H	0	+	979	1388	1443	0.9618850
C3	65432835	65433561	BolC3t20688H	0	-	126	717	726	0.9876033
C3	65443484	65460179	BolC3t20689H	0	-	3932	13931	16695	0.8344414
C3	65444586	65444901	BolC3t20690H	0	-	82	297	315	0.9428571
C3	65454636	65456032	BolC3t20691H	0	+	861	1396	1396	1.0000000
C3	65457043	65458528	BolC3t20692H	0	+	378	1345	1485	0.9057239
C3	65463338	65464516	BolC3t20693H	0	-	845	1178	1178	1.0000000
C3	65481776	65482116	BolC3t20694H	0	-	323	340	340	1.0000000
C3	65487009	65488312	BolC3t20695H	0	-	151	949	1303	0.7283193
C3	65493309	65493626	BolC3t20696H	0	-	190	317	317	1.0000000
C3	65508115	65508961	BolC3t20697H	0	-	1367	846	846	1.0000000
C3	65519107	65519537	BolC3t20698H	0	-	0	0	430	0.0000000
C3	65519637	65520071	BolC3t20699H	0	-	136	307	434	0.7073733
C3	65526484	65526769	BolC3t20700H	0	+	394	285	285	1.0000000
C3	65533967	65536280	BolC3t20701H	0	+	1805	2313	2313	1.0000000
C3	65537413	65542887	BolC3t20702H	0	-	1616	4961	5474	0.9062843
C3	65546171	65546360	BolC3t20703H	0	+	12	189	189	1.0000000
C3	65572649	65573661	BolC3t20704H	0	-	1564	963	1012	0.9515810
C3	65579408	65579882	BolC3t20705H	0	-	1278	474	474	1.0000000
C3	65580674	65582309	BolC3t20706H	0	-	2734	1635	1635	1.0000000
C3	65590525	65591263	BolC3t20707H	0	-	978	738	738	1.0000000
C3	65606878	65607655	BolC3t20708H	0	+	66	531	777	0.6833977
C3	65612632	65633825	BolC3t20709H	0	-	12737	19004	21193	0.8967112
C3	65659034	65659271	BolC3t20710H	0	+	277	237	237	1.0000000
C3	65692722	65697962	BolC3t20711H	0	+	402	1242	5240	0.2370229
C3	65700425	65700623	BolC3t20712H	0	+	115	198	198	1.0000000
C3	65705093	65706002	BolC3t20713H	0	-	35	766	909	0.8426843
C3	65706499	65706728	BolC3t20714H	0	-	2	98	229	0.4279476
C3	65709031	65715128	BolC3t20715H	0	+	466	1806	6097	0.2962112
C3	65713809	65714112	BolC3t20716H	0	-	0	0	303	0.0000000
C3	65716792	65718455	BolC3t20717H	0	+	1090	1663	1663	1.0000000
C3	65725470	65726130	BolC3t20718H	0	+	58	392	660	0.5939394
C3	65726865	65727522	BolC3t20719H	0	+	11	241	657	0.3668189
C3	65730867	65733072	BolC3t20720H	0	+	1228	2115	2205	0.9591837
C3	65736935	65738389	BolC3t20721H	0	-	108	899	1454	0.6182944
C3	65765871	65767518	BolC3t20722H	0	+	304	1328	1647	0.8063145
C3	65795265	65795890	BolC3t20723H	0	+	19	389	625	0.6224000
C3	65808521	65809316	BolC3t20724H	0	+	13	377	795	0.4742138
C3	65815118	65831373	BolC3t20725H	0	+	2732	11686	16255	0.7189173
C3	65847021	65848216	BolC3t20726H	0	-	483	1144	1195	0.9573222
C3	65850584	65850722	BolC3t20727H	0	+	397	138	138	1.0000000
C3	65856501	65857895	BolC3t20728H	0	+	29	324	1394	0.2324247
C3	65862489	65864095	BolC3t20729H	0	-	26	829	1606	0.5161893
C3	65864070	65864746	BolC3t20730H	0	-	45	526	676	0.7781065
C3	65865237	65865972	BolC3t20731H	0	-	74	727	735	0.9891157
C3	65878522	65878868	BolC3t20732H	0	+	15	213	346	0.6156070
C3	65881729	65882198	BolC3t20733H	0	+	16	66	469	0.1407249
C3	65883935	65887214	BolC3t20734H	0	+	623	2863	3279	0.8731321
C3	65892697	65893715	BolC3t20735H	0	-	418	965	1018	0.9479371
C3	65895045	65901171	BolC3t20736H	0	-	2712	5959	6126	0.9727392
C3	65914738	65917371	BolC3t20737H	0	+	1703	2587	2633	0.9825295
C3	65918592	65927040	BolC3t20738H	0	-	2874	7987	8448	0.9454309
C3	65974832	65975009	BolC3t20739H	0	-	165	177	177	1.0000000
C3	65982044	65985183	BolC3t20740H	0	-	1631	2949	3139	0.9394712
C3	66021025	66021371	BolC3t20741H	0	+	244	346	346	1.0000000
C3	66028297	66029968	BolC3t20742H	0	-	149	876	1671	0.5242370
C3	66045652	66046462	BolC3t20743H	0	-	448	810	810	1.0000000
C3	66091063	66092316	BolC3t20744H	0	-	751	1253	1253	1.0000000
C3	66098310	66098697	BolC3t20745H	0	-	875	387	387	1.0000000
C3	66100975	66101188	BolC3t20746H	0	+	64	213	213	1.0000000
C3	66108855	66111140	BolC3t20747H	0	+	681	2149	2285	0.9404814
C3	66111519	66114374	BolC3t20748H	0	-	1947	2855	2855	1.0000000
C3	66117420	66118158	BolC3t20749H	0	+	590	738	738	1.0000000
C3	66146008	66147712	BolC3t20750H	0	+	1307	1704	1704	1.0000000
C3	66148508	66151146	BolC3t20751H	0	-	1847	2638	2638	1.0000000
C3	66161446	66189058	BolC3t20752H	0	-	8474	21011	27612	0.7609373
C3	66189136	66204713	BolC3t20753H	0	-	6011	14472	15577	0.9290621
C3	66207512	66209529	BolC3t20754H	0	+	141	1333	2017	0.6608825
C3	66210110	66210461	BolC3t20755H	0	-	47	282	351	0.8034188
C3	66211875	66212271	BolC3t20756H	0	-	10	122	396	0.3080808
C3	66230971	66231379	BolC3t20757H	0	-	64	408	408	1.0000000
C3	66234703	66235291	BolC3t20758H	0	+	415	588	588	1.0000000
C3	66254079	66255060	BolC3t20759H	0	+	27	126	981	0.1284404
C3	66259126	66260218	BolC3t20760H	0	+	177	898	1092	0.8223443
C3	66315447	66316964	BolC3t20761H	0	+	136	1305	1517	0.8602505
C3	66329333	66329750	BolC3t20762H	0	-	54	417	417	1.0000000
C3	66331026	66331215	BolC3t20763H	0	+	181	189	189	1.0000000
C3	66337474	66339398	BolC3t20764H	0	+	788	1924	1924	1.0000000
C3	66344577	66345409	BolC3t20765H	0	+	294	816	832	0.9807692
C3	66345483	66346032	BolC3t20766H	0	+	94	549	549	1.0000000
C3	66347029	66347152	BolC3t20767H	0	-	45	123	123	1.0000000
C3	66350645	66350816	BolC3t20768H	0	-	76	171	171	1.0000000
C3	66361294	66363213	BolC3t20769H	0	+	83	715	1919	0.3725899
C3	66373539	66373653	BolC3t20770H	0	-	11	53	114	0.4649123
C3	66380687	66382604	BolC3t20771H	0	+	182	1316	1917	0.6864893
C3	66409861	66411721	BolC3t20772H	0	+	98	770	1860	0.4139785
C3	66412541	66413452	BolC3t20773H	0	-	0	0	911	0.0000000
C3	66415050	66417549	BolC3t20774H	0	-	108	822	2499	0.3289316
C3	66421182	66421701	BolC3t20775H	0	+	1	7	519	0.0134875
C3	66432883	66434240	BolC3t20776H	0	+	5	167	1357	0.1230656
C3	66435563	66440354	BolC3t20777H	0	-	43	445	4791	0.0928825
C3	66444196	66444715	BolC3t20778H	0	+	0	0	519	0.0000000
C3	66467902	66468121	BolC3t20779H	0	-	338	219	219	1.0000000
C3	66470456	66470895	BolC3t20780H	0	-	335	439	439	1.0000000
C3	66492393	66494589	BolC3t20781H	0	+	1464	2196	2196	1.0000000
C3	66501023	66502493	BolC3t20782H	0	+	629	1470	1470	1.0000000
C3	66510595	66511279	BolC3t20783H	0	-	345	684	684	1.0000000
C3	66514338	66516119	BolC3t20784H	0	+	690	1715	1781	0.9629422
C3	66520484	66522480	BolC3t20785H	0	+	233	1194	1996	0.5981964
C3	66537595	66540169	BolC3t20786H	0	+	662	2408	2574	0.9355089
C3	66548433	66550801	BolC3t20787H	0	+	386	1872	2368	0.7905405
C3	66555667	66556426	BolC3t20788H	0	-	0	0	759	0.0000000
C3	66557435	66558083	BolC3t20789H	0	-	24	314	648	0.4845679
C3	66560182	66560946	BolC3t20790H	0	-	399	764	764	1.0000000
C3	66562129	66563147	BolC3t20791H	0	-	214	803	1018	0.7888016
C3	66566297	66566588	BolC3t20792H	0	+	0	0	291	0.0000000
C3	66570638	66572671	BolC3t20793H	0	+	834	2021	2033	0.9940974
C3	66598336	66598813	BolC3t20794H	0	+	92	440	477	0.9224319
C3	66610469	66612947	BolC3t20795H	0	+	860	1944	2478	0.7845036
C3	66628936	66629635	BolC3t20796H	0	-	70	506	699	0.7238913
C3	66634971	66637943	BolC3t20797H	0	-	366	2358	2972	0.7934051
C3	66655659	66657553	BolC3t20798H	0	+	195	685	1894	0.3616684
C3	66664197	66664521	BolC3t20799H	0	-	4	225	324	0.6944444
C3	66665930	66666185	BolC3t20800H	0	+	2	49	255	0.1921569
C3	66669744	66671501	BolC3t20801H	0	+	1471	1757	1757	1.0000000
C3	66683390	66687411	BolC3t20802H	0	+	1089	3043	4021	0.7567769
C3	66692205	66693161	BolC3t20803H	0	+	0	0	956	0.0000000
C3	66706129	66714069	BolC3t20804H	0	+	1520	5709	7940	0.7190176
C3	66728551	66729868	BolC3t20805H	0	+	97	874	1317	0.6636295
C3	66741568	66742999	BolC3t20806H	0	-	306	1329	1431	0.9287212
C3	66751056	66753072	BolC3t20807H	0	+	63	1001	2016	0.4965278
C3	66757494	66757738	BolC3t20808H	0	-	184	244	244	1.0000000
C3	66758051	66758210	BolC3t20809H	0	-	95	159	159	1.0000000
C3	66766884	66767718	BolC3t20810H	0	-	80	622	834	0.7458034
C3	66820387	66820645	BolC3t20811H	0	-	102	258	258	1.0000000
C3	66829098	66829634	BolC3t20812H	0	+	1738	468	536	0.8731343
C3	66834493	66835033	BolC3t20813H	0	+	68	264	540	0.4888889
C3	66837989	66839056	BolC3t20814H	0	-	1	76	1067	0.0712277
C3	66845723	66846592	BolC3t20815H	0	-	191	838	869	0.9643268
C3	66859323	66859753	BolC3t20816H	0	-	304	430	430	1.0000000
C3	66859891	66861570	BolC3t20817H	0	-	184	1041	1679	0.6200119
C3	66873890	66874529	BolC3t20818H	0	+	0	0	639	0.0000000
C3	66887328	66889735	BolC3t20819H	0	+	472	1926	2407	0.8001662
C3	66895641	66897615	BolC3t20820H	0	-	49	869	1974	0.4402229
C3	66900808	66916666	BolC3t20821H	0	-	4202	10461	15858	0.6596671
C3	66922455	66923412	BolC3t20822H	0	-	26	633	957	0.6614420
C3	66928328	66931321	BolC3t20823H	0	-	370	2371	2993	0.7921817
C3	66932634	66934512	BolC3t20824H	0	+	589	1645	1878	0.8759319
C3	66934818	66936156	BolC3t20825H	0	-	92	863	1338	0.6449925
C3	66936704	66938190	BolC3t20826H	0	-	343	1305	1486	0.8781965
C3	66942842	66943034	BolC3t20827H	0	-	154	192	192	1.0000000
C3	66947182	66947948	BolC3t20828H	0	+	2	20	766	0.0261097
C3	66956527	66957049	BolC3t20829H	0	+	417	522	522	1.0000000
C3	66965990	66967482	BolC3t20830H	0	-	957	1481	1492	0.9926273
C3	66972221	67000691	BolC3t20831H	0	+	11231	23696	28470	0.8323147
C3	66975915	66976539	BolC3t20832H	0	+	139	624	624	1.0000000
C3	66976841	66982691	BolC3t20833H	0	-	4287	5512	5850	0.9422222
C3	67010560	67010776	BolC3t20834H	0	-	71	216	216	1.0000000
C3	67020697	67021256	BolC3t20835H	0	-	200	559	559	1.0000000
C3	67061898	67062222	BolC3t20836H	0	+	3	36	324	0.1111111
C3	67095969	67097306	BolC3t20837H	0	+	459	1138	1337	0.8511593
C3	67107361	67108642	BolC3t20838H	0	+	381	1260	1281	0.9836066
C3	67116636	67118700	BolC3t20839H	0	+	254	1799	2064	0.8716086
C3	67120421	67122204	BolC3t20840H	0	-	807	1783	1783	1.0000000
C3	67126235	67137507	BolC3t20841H	0	+	1018	3726	11272	0.3305536
C3	67142608	67143103	BolC3t20842H	0	-	196	495	495	1.0000000
C3	67147724	67147922	BolC3t20843H	0	+	0	0	198	0.0000000
C3	67158160	67159243	BolC3t20844H	0	-	205	677	1083	0.6251154
C3	67159904	67160488	BolC3t20845H	0	+	223	584	584	1.0000000
C3	67162197	67162825	BolC3t20846H	0	-	489	628	628	1.0000000
C3	67164161	67165027	BolC3t20847H	0	-	126	734	866	0.8475751
C3	67174298	67175593	BolC3t20848H	0	-	406	1255	1295	0.9691120
C3	67180185	67182532	BolC3t20849H	0	+	1121	2347	2347	1.0000000
C3	67183219	67186151	BolC3t20850H	0	-	1508	2859	2932	0.9751023
C3	67195135	67195781	BolC3t20851H	0	-	88	404	646	0.6253870
C3	67215270	67215699	BolC3t20852H	0	-	35	317	429	0.7389277
C3	67223500	67226856	BolC3t20853H	0	-	1749	2746	3356	0.8182360
C3	67233607	67234697	BolC3t20854H	0	-	217	949	1090	0.8706422
C3	67240779	67241974	BolC3t20855H	0	-	428	942	1195	0.7882845
C3	67246022	67246611	BolC3t20856H	0	+	231	589	589	1.0000000
C3	67250006	67250462	BolC3t20857H	0	+	11	282	456	0.6184211
C3	67251495	67253016	BolC3t20858H	0	-	86	441	1521	0.2899408
C3	67267620	67269045	BolC3t20859H	0	-	183	1222	1425	0.8575439
C3	67269696	67272470	BolC3t20860H	0	-	135	1859	2774	0.6701514
C3	67273148	67273307	BolC3t20861H	0	-	1	105	159	0.6603774
C3	67277523	67279929	BolC3t20862H	0	+	975	2310	2406	0.9600998
C3	67285240	67285761	BolC3t20863H	0	-	3	135	521	0.2591171
C3	67285306	67285708	BolC3t20864H	0	-	3	76	402	0.1890547
C3	67285829	67286044	BolC3t20865H	0	-	0	0	215	0.0000000
C3	67288003	67289933	BolC3t20866H	0	+	685	1919	1930	0.9943005
C3	67290353	67295197	BolC3t20867H	0	-	1273	4213	4844	0.8697358
C3	67306699	67309401	BolC3t20868H	0	-	432	2267	2702	0.8390082
C3	67317562	67321360	BolC3t20869H	0	-	883	2501	3798	0.6585045
C3	67323348	67323729	BolC3t20870H	0	-	69	294	381	0.7716535
C3	67338369	67339152	BolC3t20871H	0	-	368	783	783	1.0000000
C3	67350731	67355783	BolC3t20872H	0	-	2239	4878	5052	0.9655582
C3	67357524	67358994	BolC3t20873H	0	-	2	137	1470	0.0931973
C3	67361618	67362148	BolC3t20874H	0	-	143	530	530	1.0000000
C3	67366075	67376054	BolC3t20875H	0	-	20	272	9979	0.0272572
C3	67376922	67377141	BolC3t20876H	0	+	17	199	219	0.9086758
C3	67381433	67381658	BolC3t20877H	0	+	146	225	225	1.0000000
C3	67386406	67386773	BolC3t20878H	0	+	562	367	367	1.0000000
C3	67388634	67390327	BolC3t20879H	0	-	261	1199	1693	0.7082103
C3	67394391	67394639	BolC3t20880H	0	+	216	248	248	1.0000000
C3	67407926	67408700	BolC3t20881H	0	-	274	749	774	0.9677002
C3	67409321	67425282	BolC3t20882H	0	-	2389	9350	15961	0.5858029
C3	67457266	67459326	BolC3t20883H	0	+	346	1462	2060	0.7097088
C3	67460024	67460132	BolC3t20884H	0	-	70	108	108	1.0000000
C3	67464769	67465396	BolC3t20885H	0	-	716	627	627	1.0000000
C3	67469342	67469495	BolC3t20886H	0	-	55	153	153	1.0000000
C3	67472343	67473112	BolC3t20887H	0	+	40	530	769	0.6892068
C3	67489820	67491152	BolC3t20888H	0	-	120	918	1332	0.6891892
C3	67492088	67494067	BolC3t20889H	0	-	1088	1896	1979	0.9580596
C3	67527193	67528833	BolC3t20890H	0	+	85	821	1640	0.5006098
C3	67534641	67536093	BolC3t20891H	0	+	204	1109	1452	0.7637741
C3	67537041	67538576	BolC3t20892H	0	+	22	196	1535	0.1276873
C3	67538956	67540876	BolC3t20893H	0	-	351	1493	1920	0.7776042
C3	67542981	67543605	BolC3t20894H	0	+	0	0	624	0.0000000
C3	67546897	67551377	BolC3t20895H	0	-	2	93	4480	0.0207589
C3	67576442	67578036	BolC3t20896H	0	-	882	1397	1594	0.8764116
C3	67578792	67579254	BolC3t20897H	0	-	340	462	462	1.0000000
C3	67580563	67583327	BolC3t20898H	0	-	1093	2652	2764	0.9594790
C3	67588880	67592095	BolC3t20899H	0	-	2199	3215	3215	1.0000000
C3	67611218	67611950	BolC3t20900H	0	+	193	545	732	0.7445355
C3	67612284	67615653	BolC3t20901H	0	-	2180	3369	3369	1.0000000
C3	67618804	67620061	BolC3t20902H	0	-	188	961	1257	0.7645187
C3	67623554	67626274	BolC3t20903H	0	-	1919	2717	2720	0.9988971
C3	67628156	67629508	BolC3t20904H	0	+	689	1352	1352	1.0000000
C3	67649135	67649452	BolC3t20905H	0	+	210	317	317	1.0000000
C3	67672865	67673400	BolC3t20906H	0	+	77	517	535	0.9663551
C3	67674635	67676398	BolC3t20907H	0	+	1290	1763	1763	1.0000000
C3	67677320	67679465	BolC3t20908H	0	+	711	2063	2145	0.9617715
C3	67686473	67686851	BolC3t20909H	0	+	112	378	378	1.0000000
C3	67688111	67689497	BolC3t20910H	0	+	2846	1386	1386	1.0000000
C3	67690044	67690524	BolC3t20911H	0	+	81	457	480	0.9520833
C3	67692572	67692982	BolC3t20912H	0	+	2	117	410	0.2853658
C3	67698859	67698988	BolC3t20913H	0	+	86	129	129	1.0000000
C3	67706864	67707056	BolC3t20914H	0	-	77	192	192	1.0000000
C3	67736339	67739519	BolC3t20915H	0	-	1477	3180	3180	1.0000000
C3	67742833	67743187	BolC3t20916H	0	-	241	354	354	1.0000000
C3	67752947	67754510	BolC3t20917H	0	-	212	1347	1563	0.8618042
C3	67760626	67762393	BolC3t20918H	0	+	664	1767	1767	1.0000000
C3	67763693	67764313	BolC3t20919H	0	-	727	620	620	1.0000000
C3	67770685	67771013	BolC3t20920H	0	+	77	328	328	1.0000000
C3	67788759	67789393	BolC3t20921H	0	-	1417	634	634	1.0000000
C3	67789661	67789790	BolC3t20922H	0	-	162	129	129	1.0000000
C3	67820161	67820706	BolC3t20923H	0	-	177	545	545	1.0000000
C3	67823837	67825332	BolC3t20924H	0	+	149	1251	1495	0.8367893
C3	67827469	67828494	BolC3t20925H	0	+	1016	1025	1025	1.0000000
C3	67832457	67833047	BolC3t20926H	0	+	445	590	590	1.0000000
C3	67834271	67834803	BolC3t20927H	0	-	33	493	532	0.9266917
C3	67856253	67859061	BolC3t20928H	0	+	480	1888	2808	0.6723647
C3	67861585	67866430	BolC3t20929H	0	+	2006	3840	4845	0.7925696
C3	67885233	67888274	BolC3t20930H	0	+	239	1930	3041	0.6346596
C3	67916948	67917735	BolC3t20931H	0	+	493	787	787	1.0000000
C3	67921364	67929108	BolC3t20932H	0	+	3204	6975	7744	0.9006973
C3	67935169	67935477	BolC3t20933H	0	+	6	227	308	0.7370130
C3	67938331	67944606	BolC3t20934H	0	-	151	2274	6275	0.3623904
C3	67950006	67952718	BolC3t20935H	0	+	508	2272	2712	0.8377581
C3	67954443	67958054	BolC3t20936H	0	+	1603	3475	3611	0.9623373
C3	67962474	67962850	BolC3t20937H	0	-	69	376	376	1.0000000
C3	67963660	67963942	BolC3t20938H	0	-	174	282	282	1.0000000
C3	67967284	67971944	BolC3t20939H	0	+	2763	4660	4660	1.0000000
C3	67972410	67977672	BolC3t20940H	0	-	513	4237	5262	0.8052071
C3	67978855	67982236	BolC3t20941H	0	-	1505	3230	3381	0.9553387
C3	67983902	67984340	BolC3t20942H	0	+	450	438	438	1.0000000
C3	67990691	67992089	BolC3t20943H	0	+	602	1392	1398	0.9957082
C3	67994176	67994608	BolC3t20944H	0	-	20	402	432	0.9305556
C3	67996546	67997923	BolC3t20945H	0	+	806	1339	1377	0.9724038
C3	67998240	67998627	BolC3t20946H	0	+	663	387	387	1.0000000
C3	68001993	68004053	BolC3t20947H	0	-	1190	2060	2060	1.0000000
C3	68004287	68006258	BolC3t20948H	0	-	952	1864	1971	0.9457129
C3	68010396	68010681	BolC3t20949H	0	-	108	255	285	0.8947368
C3	68012996	68016414	BolC3t20950H	0	-	1941	3173	3418	0.9283206
C3	68024282	68025391	BolC3t20951H	0	-	962	1109	1109	1.0000000
C3	68029879	68030740	BolC3t20952H	0	+	39	342	861	0.3972125
C3	68032494	68036206	BolC3t20953H	0	+	1303	3225	3712	0.8688039
C3	68037334	68039026	BolC3t20954H	0	+	43	1019	1692	0.6022459
C3	68040283	68041207	BolC3t20955H	0	+	111	910	924	0.9848485
C3	68042353	68043938	BolC3t20956H	0	-	50	603	1585	0.3804416
C3	68052698	68053074	BolC3t20957H	0	-	414	376	376	1.0000000
C3	68056322	68057063	BolC3t20958H	0	+	46	563	741	0.7597841
C3	68057726	68058296	BolC3t20959H	0	-	305	570	570	1.0000000
C3	68060291	68060788	BolC3t20960H	0	+	308	497	497	1.0000000
C3	68065285	68065771	BolC3t20961H	0	-	405	486	486	1.0000000
C3	68065946	68066643	BolC3t20962H	0	-	493	697	697	1.0000000
C3	68068267	68068550	BolC3t20963H	0	-	229	283	283	1.0000000
C3	68070337	68080275	BolC3t20964H	0	+	438	4454	9938	0.4481787
C3	68073533	68075546	BolC3t20965H	0	-	66	1092	2013	0.5424739
C3	68076508	68085808	BolC3t20966H	0	-	629	5014	9300	0.5391398
C3	68081028	68083056	BolC3t20967H	0	-	111	1411	2028	0.6957594
C3	68101065	68104286	BolC3t20968H	0	+	2404	2604	3221	0.8084446
C3	68110687	68113646	BolC3t20969H	0	+	602	2183	2959	0.7377492
C3	68115257	68115525	BolC3t20970H	0	+	10	251	268	0.9365672
C3	68116364	68120736	BolC3t20971H	0	+	942	2892	4372	0.6614822
C3	68133186	68138407	BolC3t20972H	0	-	582	3841	5221	0.7356828
C3	68144896	68149231	BolC3t20973H	0	+	821	3781	4335	0.8722030
C3	68162763	68167277	BolC3t20974H	0	+	997	4356	4514	0.9649978
C3	68167921	68170876	BolC3t20975H	0	+	343	2510	2955	0.8494078
C3	68171277	68171866	BolC3t20976H	0	-	135	589	589	1.0000000
C3	68172585	68177760	BolC3t20977H	0	+	2258	4185	5175	0.8086957
C3	68180159	68183178	BolC3t20978H	0	+	1415	2782	3019	0.9214972
C3	68201328	68201763	BolC3t20979H	0	+	78	329	435	0.7563218
C3	68211485	68211590	BolC3t20980H	0	+	65	105	105	1.0000000
C3	68211991	68213389	BolC3t20981H	0	-	607	1379	1398	0.9864091
C3	68227905	68228736	BolC3t20982H	0	+	128	744	831	0.8953069
C3	68232176	68235230	BolC3t20983H	0	+	1245	2748	3054	0.8998035
C3	68236885	68237941	BolC3t20984H	0	-	826	1056	1056	1.0000000
C3	68247226	68247418	BolC3t20985H	0	+	7	179	192	0.9322917
C3	68248661	68251320	BolC3t20986H	0	-	216	1901	2659	0.7149304
C3	68251350	68251458	BolC3t20987H	0	-	0	0	108	0.0000000
C3	68264748	68264940	BolC3t20988H	0	+	1	2	192	0.0104167
C3	68266180	68270483	BolC3t20989H	0	-	230	1855	4303	0.4310946
C3	68267234	68267532	BolC3t20990H	0	-	0	0	298	0.0000000
C3	68270723	68270831	BolC3t20991H	0	-	59	108	108	1.0000000
C3	68287972	68292775	BolC3t20992H	0	+	203	2737	4803	0.5698522
C3	68295355	68295847	BolC3t20993H	0	-	19	139	492	0.2825203
C3	68310525	68311104	BolC3t20994H	0	+	7	227	579	0.3920553
C3	68319592	68321265	BolC3t20995H	0	-	521	1631	1673	0.9748954
C3	68346920	68347180	BolC3t20996H	0	+	85	260	260	1.0000000
C3	68349037	68349730	BolC3t20997H	0	-	30	109	693	0.1572872
C3	68374371	68374623	BolC3t20998H	0	+	0	0	252	0.0000000
C3	68376013	68378167	BolC3t20999H	0	-	1037	1923	2154	0.8927577
C3	68388753	68392480	BolC3t21000H	0	-	1313	3706	3727	0.9943655
C3	68400523	68402269	BolC3t21001H	0	+	1668	1741	1746	0.9971363
C3	68402784	68406935	BolC3t21002H	0	-	780	3365	4151	0.8106480
C3	68411954	68414529	BolC3t21003H	0	-	1177	2435	2575	0.9456311
C3	68415375	68416345	BolC3t21004H	0	+	100	944	970	0.9731959
C3	68416535	68417029	BolC3t21005H	0	-	104	494	494	1.0000000
C3	68417553	68422195	BolC3t21006H	0	-	654	3563	4642	0.7675571
C3	68418045	68419443	BolC3t21007H	0	+	94	1059	1398	0.7575107
C3	68427749	68428667	BolC3t21008H	0	+	124	878	918	0.9564270
C3	68430376	68430676	BolC3t21009H	0	+	0	0	300	0.0000000
C3	68431997	68432294	BolC3t21010H	0	+	83	297	297	1.0000000
C3	68446841	68447162	BolC3t21011H	0	+	145	321	321	1.0000000
C3	68448504	68450043	BolC3t21012H	0	+	760	1495	1539	0.9714100
C3	68451533	68451854	BolC3t21013H	0	+	775	321	321	1.0000000
C3	68453228	68453549	BolC3t21014H	0	+	6	234	321	0.7289720
C3	68454939	68455260	BolC3t21015H	0	+	1271	321	321	1.0000000
C3	68456630	68456951	BolC3t21016H	0	+	608	321	321	1.0000000
C3	68471678	68473171	BolC3t21017H	0	+	295	1298	1493	0.8693905
C3	68473980	68485052	BolC3t21018H	0	-	2629	7424	11072	0.6705202
C3	68486531	68489795	BolC3t21019H	0	-	1119	2641	3264	0.8091299
C3	68493149	68494362	BolC3t21020H	0	+	1057	1213	1213	1.0000000
C3	68494607	68496149	BolC3t21021H	0	-	874	1542	1542	1.0000000
C3	68506712	68507005	BolC3t21022H	0	+	601	293	293	1.0000000
C3	68511537	68513742	BolC3t21023H	0	-	704	1485	2205	0.6734694
C3	68516594	68517897	BolC3t21024H	0	+	342	1236	1303	0.9485802
C3	68517962	68518925	BolC3t21025H	0	+	936	963	963	1.0000000
C3	68519433	68520886	BolC3t21026H	0	-	882	1453	1453	1.0000000
C3	68527416	68529484	BolC3t21027H	0	+	834	2039	2068	0.9859768
C3	68530324	68535215	BolC3t21028H	0	-	3055	4853	4891	0.9922307
C3	68547998	68548211	BolC3t21029H	0	-	0	0	213	0.0000000
C3	68568593	68570424	BolC3t21030H	0	-	195	1053	1831	0.5750956
C3	68597321	68598684	BolC3t21031H	0	+	1223	1363	1363	1.0000000
C3	68599180	68602037	BolC3t21032H	0	+	1024	2857	2857	1.0000000
C3	68602485	68603283	BolC3t21033H	0	+	414	714	798	0.8947368
C3	68604573	68606336	BolC3t21034H	0	-	534	1697	1763	0.9625638
C3	68608595	68609215	BolC3t21035H	0	-	744	620	620	1.0000000
C3	68619427	68619908	BolC3t21036H	0	+	271	481	481	1.0000000
C3	68637100	68637744	BolC3t21037H	0	+	368	644	644	1.0000000
C3	68644073	68644811	BolC3t21038H	0	+	1481	549	738	0.7439024
C3	68648141	68649169	BolC3t21039H	0	+	351	616	1028	0.5992218
C3	68649447	68649720	BolC3t21040H	0	+	129	273	273	1.0000000
C3	68650836	68651133	BolC3t21041H	0	+	150	297	297	1.0000000
C3	68651160	68651882	BolC3t21042H	0	+	578	722	722	1.0000000
C3	68661007	68665460	BolC3t21043H	0	-	1319	3925	4453	0.8814282
C3	68669389	68670808	BolC3t21044H	0	+	759	1419	1419	1.0000000
C3	68673675	68674542	BolC3t21045H	0	+	236	867	867	1.0000000
C3	68682786	68684664	BolC3t21046H	0	+	2425	1878	1878	1.0000000
C3	68690703	68692606	BolC3t21047H	0	-	793	1751	1903	0.9201261
C3	68702589	68705082	BolC3t21048H	0	-	606	1704	2493	0.6835138
C3	68735394	68737137	BolC3t21049H	0	+	1254	1743	1743	1.0000000
C3	68738022	68741190	BolC3t21050H	0	+	1461	3075	3168	0.9706439
C3	68741931	68745143	BolC3t21051H	0	+	985	2885	3212	0.8981943
C3	68753357	68756068	BolC3t21052H	0	-	576	1601	2711	0.5905570
C3	68766300	68767825	BolC3t21053H	0	-	305	1219	1525	0.7993442
C3	68778302	68778576	BolC3t21054H	0	-	0	0	274	0.0000000
C3	68778869	68779456	BolC3t21055H	0	-	25	103	587	0.1754685
C3	68794273	68799816	BolC3t21056H	0	+	3141	5122	5543	0.9240484
C3	68800281	68802018	BolC3t21057H	0	-	1815	1737	1737	1.0000000
C3	68815819	68816966	BolC3t21058H	0	+	572	1147	1147	1.0000000
C3	68819201	68830135	BolC3t21059H	0	+	4517	5147	10934	0.4707335
C3	68833473	68835471	BolC3t21060H	0	-	971	1929	1998	0.9654655
C3	68836787	68837078	BolC3t21061H	0	-	503	291	291	1.0000000
C3	68840110	68840945	BolC3t21062H	0	+	493	835	835	1.0000000
C3	68848652	68849718	BolC3t21063H	0	+	409	863	1066	0.8095685
C3	68858588	68860878	BolC3t21064H	0	-	369	1141	2290	0.4982533
C3	68873894	68875980	BolC3t21065H	0	+	212	1290	2086	0.6184084
C3	68884747	68884932	BolC3t21066H	0	-	0	0	185	0.0000000
C3	68897639	68898481	BolC3t21067H	0	+	769	842	842	1.0000000
C3	68898901	68899510	BolC3t21068H	0	-	202	602	609	0.9885057
C3	68900417	68900720	BolC3t21069H	0	+	136	303	303	1.0000000
C3	68910537	68913184	BolC3t21070H	0	+	1054	2647	2647	1.0000000
C3	68914613	68916446	BolC3t21071H	0	-	604	1227	1833	0.6693944
C3	68920176	68920452	BolC3t21072H	0	-	117	245	276	0.8876812
C3	68928173	68928398	BolC3t21073H	0	-	220	225	225	1.0000000
C3	68931457	68931697	BolC3t21074H	0	+	253	240	240	1.0000000
C3	68946551	68948566	BolC3t21075H	0	+	2190	2015	2015	1.0000000
C3	68949890	68953561	BolC3t21076H	0	+	1770	3663	3671	0.9978207
C3	68953820	68955231	BolC3t21077H	0	-	837	1411	1411	1.0000000
C3	68955307	68956688	BolC3t21078H	0	+	724	1381	1381	1.0000000
C3	68958561	68959558	BolC3t21079H	0	-	718	997	997	1.0000000
C3	68965664	68965970	BolC3t21080H	0	+	0	0	306	0.0000000
C3	68966370	68967673	BolC3t21081H	0	+	170	180	1303	0.1381427
C3	68968367	68969692	BolC3t21082H	0	+	671	1281	1325	0.9667925
C3	68972143	69002745	BolC3t21083H	0	+	21145	29416	30602	0.9612443
C3	68978886	68980905	BolC3t21084H	0	+	2908	2019	2019	1.0000000
C3	69023663	69024491	BolC3t21085H	0	-	441	828	828	1.0000000
C3	69032417	69033338	BolC3t21086H	0	+	1005	921	921	1.0000000
C3	69036952	69037470	BolC3t21087H	0	+	345	518	518	1.0000000
C3	69040363	69040621	BolC3t21088H	0	+	233	258	258	1.0000000
C3	69046571	69047756	BolC3t21089H	0	+	776	1181	1185	0.9966245
C3	69048200	69050163	BolC3t21090H	0	-	1443	1963	1963	1.0000000
C3	69050932	69052575	BolC3t21091H	0	+	1379	1569	1643	0.9549605
C3	69055492	69056343	BolC3t21092H	0	+	4	231	851	0.2714454
C3	69058719	69059011	BolC3t21093H	0	-	6	222	292	0.7602740
C3	69060269	69060560	BolC3t21094H	0	-	2	150	291	0.5154639
C3	69063073	69063334	BolC3t21095H	0	-	86	261	261	1.0000000
C3	69067285	69067828	BolC3t21096H	0	+	420	543	543	1.0000000
C3	69067891	69068390	BolC3t21097H	0	+	434	499	499	1.0000000
C3	69105963	69107384	BolC3t21098H	0	+	239	1172	1421	0.8247713
C3	69116177	69116576	BolC3t21099H	0	-	1	128	399	0.3208020
C3	69116894	69117146	BolC3t21100H	0	-	10	165	252	0.6547619
C3	69122384	69124409	BolC3t21101H	0	+	539	1997	2025	0.9861729
C3	69126298	69127052	BolC3t21102H	0	+	314	621	754	0.8236074
C3	69135360	69138617	BolC3t21103H	0	-	498	2810	3257	0.8627571
C3	69143319	69143598	BolC3t21104H	0	+	207	279	279	1.0000000
C3	69143930	69144416	BolC3t21105H	0	-	70	486	486	1.0000000
C3	69149081	69149324	BolC3t21106H	0	-	225	243	243	1.0000000
C3	69153016	69154265	BolC3t21107H	0	+	1001	1249	1249	1.0000000
C3	69155026	69156118	BolC3t21108H	0	-	710	1064	1092	0.9743590
C3	69157433	69161014	BolC3t21109H	0	-	2014	3415	3581	0.9536442
C3	69170802	69171791	BolC3t21110H	0	-	112	797	989	0.8058645
C3	69172937	69174439	BolC3t21111H	0	-	978	1279	1502	0.8515313
C3	69176305	69177682	BolC3t21112H	0	+	92	1117	1377	0.8111838
C3	69188363	69188738	BolC3t21113H	0	-	130	347	375	0.9253333
C3	69193208	69194042	BolC3t21114H	0	+	36	604	834	0.7242206
C3	69194626	69195746	BolC3t21115H	0	-	916	1120	1120	1.0000000
C3	69208334	69233987	BolC3t21116H	0	-	1627	10308	25653	0.4018244
C3	69264486	69266148	BolC3t21117H	0	-	61	644	1662	0.3874850
C3	69271956	69272508	BolC3t21118H	0	+	287	552	552	1.0000000
C3	69279164	69281145	BolC3t21119H	0	-	691	1731	1981	0.8738011
C3	69282614	69283966	BolC3t21120H	0	-	587	1245	1352	0.9208580
C3	69286432	69287592	BolC3t21121H	0	+	339	1160	1160	1.0000000
C3	69289142	69290444	BolC3t21122H	0	+	193	1215	1302	0.9331797
C3	69290911	69297686	BolC3t21123H	0	-	1091	3268	6775	0.4823616
C3	69298455	69299995	BolC3t21124H	0	+	1440	1540	1540	1.0000000
C3	69301075	69301591	BolC3t21125H	0	+	601	516	516	1.0000000
C3	69302792	69303215	BolC3t21126H	0	-	271	423	423	1.0000000
C3	69305396	69305879	BolC3t21127H	0	+	2	20	483	0.0414079
C3	69314402	69314786	BolC3t21128H	0	-	288	384	384	1.0000000
C3	69315766	69317539	BolC3t21129H	0	-	492	1463	1773	0.8251551
C3	69322523	69323031	BolC3t21130H	0	-	194	508	508	1.0000000
C3	69326436	69327564	BolC3t21131H	0	+	680	976	1128	0.8652482
C3	69345534	69345872	BolC3t21132H	0	+	491	338	338	1.0000000
C3	69370531	69371689	BolC3t21133H	0	+	167	1158	1158	1.0000000
C3	69373459	69373911	BolC3t21134H	0	-	37	385	452	0.8517699
C3	69375961	69376321	BolC3t21135H	0	+	231	360	360	1.0000000
C3	69385875	69396046	BolC3t21136H	0	+	1479	4425	10171	0.4350605
C3	69391286	69392888	BolC3t21137H	0	-	26	469	1602	0.2927591
C3	69396710	69398750	BolC3t21138H	0	-	1876	1975	2040	0.9681373
C3	69399720	69400251	BolC3t21139H	0	-	123	346	531	0.6516008
C3	69401254	69401682	BolC3t21140H	0	-	655	428	428	1.0000000
C3	69403584	69404538	BolC3t21141H	0	+	624	920	954	0.9643606
C3	69406627	69407846	BolC3t21142H	0	+	466	1210	1219	0.9926169
C3	69408522	69409762	BolC3t21143H	0	-	76	971	1240	0.7830645
C3	69410785	69411970	BolC3t21144H	0	+	966	1185	1185	1.0000000
C3	69419807	69420155	BolC3t21145H	0	-	6	257	348	0.7385057
C3	69420226	69420574	BolC3t21146H	0	-	54	348	348	1.0000000
C3	69424367	69425112	BolC3t21147H	0	-	282	637	745	0.8550336
C3	69446417	69447725	BolC3t21148H	0	-	140	1177	1308	0.8998471
C3	69469375	69469669	BolC3t21149H	0	+	37	292	294	0.9931973
C3	69470462	69472706	BolC3t21150H	0	+	1245	2127	2244	0.9478610
C3	69496426	69496741	BolC3t21151H	0	+	129	315	315	1.0000000
C3	69518421	69520467	BolC3t21152H	0	+	134	258	2046	0.1260997
C3	69521815	69523181	BolC3t21153H	0	+	998	1366	1366	1.0000000
C3	69524733	69526869	BolC3t21154H	0	+	450	1717	2136	0.8038390
C3	69531115	69531445	BolC3t21155H	0	-	31	281	330	0.8515152
C3	69532149	69534668	BolC3t21156H	0	-	354	2363	2519	0.9380707
C3	69535286	69536332	BolC3t21157H	0	-	918	1046	1046	1.0000000
C3	69537700	69538110	BolC3t21158H	0	-	599	410	410	1.0000000
C3	69537844	69538066	BolC3t21159H	0	+	383	222	222	1.0000000
C3	69542043	69542502	BolC3t21160H	0	-	67	267	459	0.5816994
C3	69545103	69547160	BolC3t21161H	0	+	619	2031	2057	0.9873602
C3	69547628	69551781	BolC3t21162H	0	-	825	3861	4153	0.9296894
C3	69559879	69562211	BolC3t21163H	0	+	1112	1937	2332	0.8306175
C3	69565483	69567788	BolC3t21164H	0	+	811	2138	2305	0.9275488
C3	69568951	69569550	BolC3t21165H	0	-	731	599	599	1.0000000
C3	69573311	69573690	BolC3t21166H	0	+	115	367	379	0.9683377
C3	69586552	69588227	BolC3t21167H	0	-	145	1260	1675	0.7522388
C3	69592675	69594768	BolC3t21168H	0	+	538	1472	2093	0.7032967
C3	69596249	69597275	BolC3t21169H	0	+	247	908	1026	0.8849903
C3	69597412	69599826	BolC3t21170H	0	+	1434	2403	2414	0.9954432
C3	69600038	69601563	BolC3t21171H	0	-	590	1494	1525	0.9796721
C3	69602739	69604465	BolC3t21172H	0	-	141	1040	1726	0.6025493
C3	69633377	69634406	BolC3t21173H	0	+	1244	1029	1029	1.0000000
C3	69638760	69639798	BolC3t21174H	0	+	1750	1038	1038	1.0000000
C3	69643609	69644725	BolC3t21175H	0	+	1307	1111	1116	0.9955197
C3	69649187	69649538	BolC3t21176H	0	+	72	319	351	0.9088319
C3	69654079	69654262	BolC3t21177H	0	+	2	40	183	0.2185792
C3	69658952	69660145	BolC3t21178H	0	+	2712	1027	1193	0.8608550
C3	69677054	69677486	BolC3t21179H	0	-	0	0	432	0.0000000
C3	69678172	69678963	BolC3t21180H	0	-	2	19	791	0.0240202
C3	69720241	69722633	BolC3t21181H	0	-	20	123	2392	0.0514214
C3	69724091	69726007	BolC3t21182H	0	-	515	1699	1916	0.8867432
C3	69750966	69751509	BolC3t21183H	0	+	68	543	543	1.0000000
C3	69759697	69759961	BolC3t21184H	0	+	16	137	264	0.5189394
C3	69763277	69763727	BolC3t21185H	0	+	87	410	450	0.9111111
C3	69764948	69765986	BolC3t21186H	0	+	301	992	1038	0.9556840
C3	69770736	69771891	BolC3t21187H	0	+	2	219	1155	0.1896104
C3	69776168	69777731	BolC3t21188H	0	+	101	769	1563	0.4920025
C3	69780463	69782278	BolC3t21189H	0	+	638	1152	1815	0.6347107
C3	69783208	69784395	BolC3t21190H	0	+	268	1055	1187	0.8887953
C3	69785177	69789014	BolC3t21191H	0	+	3016	3837	3837	1.0000000
C3	69797395	69797515	BolC3t21192H	0	-	32	120	120	1.0000000
C3	69809241	69812695	BolC3t21193H	0	-	1078	3224	3454	0.9334105
C3	69831652	69833608	BolC3t21194H	0	+	393	1601	1956	0.8185071
C3	69855915	69863939	BolC3t21195H	0	+	860	4028	8024	0.5019940
C3	69869663	69870146	BolC3t21196H	0	-	26	158	483	0.3271222
C3	69879093	69883817	BolC3t21197H	0	-	1284	4397	4724	0.9307790
C3	69891869	69892064	BolC3t21198H	0	+	0	0	195	0.0000000
C3	69897103	69897619	BolC3t21199H	0	+	62	320	516	0.6201550
C3	69898910	69901500	BolC3t21200H	0	+	522	2118	2590	0.8177606
C3	69903920	69906085	BolC3t21201H	0	+	852	2105	2165	0.9722864
C3	69912018	69912645	BolC3t21202H	0	-	37	590	627	0.9409888
C3	69924978	69925143	BolC3t21203H	0	-	184	165	165	1.0000000
C3	69952348	69957741	BolC3t21204H	0	-	3540	5054	5393	0.9371408
C3	69961960	69964014	BolC3t21205H	0	+	139	1528	2054	0.7439143
C3	69965993	69966266	BolC3t21206H	0	-	40	187	273	0.6849817
C3	69969057	69970593	BolC3t21207H	0	+	462	1522	1536	0.9908854
C3	69970797	69974370	BolC3t21208H	0	-	699	2407	3573	0.6736636
C3	69972359	69973092	BolC3t21209H	0	-	25	44	733	0.0600273
C3	69974715	69978039	BolC3t21210H	0	+	507	2044	3324	0.6149218
C3	69992299	69992578	BolC3t21211H	0	+	16	177	279	0.6344086
C3	70014663	70017860	BolC3t21212H	0	+	224	1020	3197	0.3190491
C3	70042140	70042344	BolC3t21213H	0	+	251	204	204	1.0000000
C3	70050529	70051251	BolC3t21214H	0	+	506	722	722	1.0000000
C3	70052031	70052592	BolC3t21215H	0	+	536	561	561	1.0000000
C3	70056947	70057547	BolC3t21216H	0	-	304	600	600	1.0000000
C3	70065091	70065487	BolC3t21217H	0	-	0	0	396	0.0000000
C3	70069968	70070867	BolC3t21218H	0	-	92	221	899	0.2458287
C3	70071402	70071638	BolC3t21219H	0	-	0	0	236	0.0000000
C3	70077139	70078711	BolC3t21220H	0	+	301	1571	1572	0.9993638
C3	70078857	70080497	BolC3t21221H	0	-	293	1313	1640	0.8006098
C3	70094510	70098252	BolC3t21222H	0	-	6	256	3742	0.0684126
C3	70111822	70115564	BolC3t21223H	0	-	44	375	3742	0.1002138
C3	70130466	70131780	BolC3t21224H	0	+	1005	1314	1314	1.0000000
C3	70151288	70153227	BolC3t21225H	0	-	1622	1939	1939	1.0000000
C3	70155793	70156221	BolC3t21226H	0	-	22	395	428	0.9228972
C3	70164121	70164652	BolC3t21227H	0	+	339	531	531	1.0000000
C3	70168656	70170839	BolC3t21228H	0	+	112	1091	2183	0.4997710
C3	70186998	70188348	BolC3t21229H	0	+	230	637	1350	0.4718519
C3	70193890	70195231	BolC3t21230H	0	-	142	1168	1341	0.8709918
C3	70195521	70197106	BolC3t21231H	0	+	816	1585	1585	1.0000000
C3	70197895	70199705	BolC3t21232H	0	-	805	1622	1810	0.8961326
C3	70211447	70212278	BolC3t21233H	0	+	349	831	831	1.0000000
C3	70215136	70216649	BolC3t21234H	0	+	508	1499	1513	0.9907469
C3	70216909	70218599	BolC3t21235H	0	-	1011	1582	1690	0.9360947
C3	70220031	70220569	BolC3t21236H	0	+	375	538	538	1.0000000
C3	70221120	70222087	BolC3t21237H	0	+	129	845	967	0.8738366
C3	70235880	70237279	BolC3t21238H	0	-	700	1399	1399	1.0000000
C3	70237547	70238750	BolC3t21239H	0	+	835	1193	1203	0.9916875
C3	70249070	70250234	BolC3t21240H	0	+	969	1164	1164	1.0000000
C3	70251507	70255750	BolC3t21241H	0	+	1826	3343	4243	0.7878859
C3	70256409	70257363	BolC3t21242H	0	-	249	856	954	0.8972746
C3	70285217	70286775	BolC3t21243H	0	+	945	1558	1558	1.0000000
C3	70310462	70312137	BolC3t21244H	0	+	275	1394	1675	0.8322388
C3	70353516	70354110	BolC3t21245H	0	-	0	0	594	0.0000000
C3	70357781	70358228	BolC3t21246H	0	-	13	41	447	0.0917226
C3	70359707	70359985	BolC3t21247H	0	+	1	16	278	0.0575540
C3	70372851	70373865	BolC3t21248H	0	+	729	1014	1014	1.0000000
C3	70374665	70376379	BolC3t21249H	0	+	987	1679	1714	0.9795799
C3	70393707	70396790	BolC3t21250H	0	+	1554	3066	3083	0.9944859
C3	70398275	70399625	BolC3t21251H	0	-	717	1350	1350	1.0000000
C3	70409299	70411673	BolC3t21252H	0	+	1996	2374	2374	1.0000000
C3	70412139	70413523	BolC3t21253H	0	-	988	1354	1384	0.9783237
C3	70417582	70420500	BolC3t21254H	0	+	979	2711	2918	0.9290610
C3	70420713	70423227	BolC3t21255H	0	-	1649	2513	2514	0.9996022
C3	70428175	70430160	BolC3t21256H	0	+	574	1661	1985	0.8367758
C3	70430713	70431844	BolC3t21257H	0	-	519	1073	1131	0.9487180
C3	70440106	70440866	BolC3t21258H	0	-	50	370	760	0.4868421
C3	70441760	70444523	BolC3t21259H	0	-	146	1151	2763	0.4165762
C3	70455027	70455719	BolC3t21260H	0	-	96	692	692	1.0000000
C3	70457731	70458284	BolC3t21261H	0	+	1077	553	553	1.0000000
C3	70461838	70465375	BolC3t21262H	0	+	202	1911	3537	0.5402884
C3	70475581	70479632	BolC3t21263H	0	+	2958	4005	4051	0.9886448
C3	70497769	70505272	BolC3t21264H	0	-	1869	6604	7503	0.8801813
C3	70507022	70508628	BolC3t21265H	0	+	1205	1606	1606	1.0000000
C3	70509321	70512829	BolC3t21266H	0	+	998	3167	3508	0.9027936
C3	70515991	70523032	BolC3t21267H	0	-	5285	6828	7041	0.9697486
C3	70531709	70538763	BolC3t21268H	0	+	1582	4293	7054	0.6085908
C3	70542077	70542197	BolC3t21269H	0	-	0	0	120	0.0000000
C3	70544682	70547177	BolC3t21270H	0	-	495	1917	2495	0.7683367
C3	70562821	70565212	BolC3t21271H	0	+	1744	2391	2391	1.0000000
C3	70566649	70569631	BolC3t21272H	0	-	1077	2777	2982	0.9312542
C3	70585003	70601158	BolC3t21273H	0	+	4549	10820	16155	0.6697617
C3	70607810	70611669	BolC3t21274H	0	+	1015	3501	3859	0.9072298
C3	70612076	70613044	BolC3t21275H	0	-	887	968	968	1.0000000
C3	70617121	70617343	BolC3t21276H	0	-	3	188	222	0.8468468
C3	70618025	70618328	BolC3t21277H	0	-	13	303	303	1.0000000
C3	70622680	70623637	BolC3t21278H	0	-	0	0	957	0.0000000
C3	70624479	70625820	BolC3t21279H	0	-	84	980	1341	0.7307979
C3	70630611	70633765	BolC3t21280H	0	-	512	2568	3154	0.8142042
C3	70635553	70635790	BolC3t21281H	0	-	0	0	237	0.0000000
C3	70639950	70640079	BolC3t21282H	0	-	58	129	129	1.0000000
C3	70640962	70644030	BolC3t21283H	0	+	408	2120	3068	0.6910039
C3	70645178	70645849	BolC3t21284H	0	-	240	671	671	1.0000000
C3	70646423	70653497	BolC3t21285H	0	-	5163	7052	7074	0.9968900
C3	70657792	70660047	BolC3t21286H	0	+	98	371	2255	0.1645233
C3	70671206	70671353	BolC3t21287H	0	-	1	62	147	0.4217687
C3	70709644	70709791	BolC3t21288H	0	+	1021	147	147	1.0000000
C3	70739163	70739611	BolC3t21289H	0	+	127	390	448	0.8705357
C3	70739897	70740167	BolC3t21290H	0	+	28	236	270	0.8740741
C3	70747552	70747666	BolC3t21291H	0	+	0	0	114	0.0000000
C3	70753156	70753564	BolC3t21292H	0	+	0	0	408	0.0000000
C3	70762055	70762292	BolC3t21293H	0	+	0	0	237	0.0000000
C3	70764158	70765969	BolC3t21294H	0	-	118	721	1811	0.3981226
C3	70766506	70768465	BolC3t21295H	0	-	671	1679	1959	0.8570699
C3	70788918	70790853	BolC3t21296H	0	+	46	398	1935	0.2056848
C3	70792178	70793660	BolC3t21297H	0	-	283	1226	1482	0.8272604
C3	70794376	70795985	BolC3t21298H	0	-	176	1198	1609	0.7445619
C3	70797840	70798065	BolC3t21299H	0	+	311	225	225	1.0000000
C3	70798975	70799296	BolC3t21300H	0	-	243	321	321	1.0000000
C3	70806502	70808591	BolC3t21301H	0	+	319	1505	2089	0.7204404
C3	70809725	70811066	BolC3t21302H	0	-	647	1253	1341	0.9343773
C3	70811603	70811756	BolC3t21303H	0	-	53	153	153	1.0000000
C3	70814612	70816689	BolC3t21304H	0	-	380	1904	2077	0.9167068
C3	70828629	70829235	BolC3t21305H	0	-	361	606	606	1.0000000
C3	70833008	70833356	BolC3t21306H	0	-	7	230	348	0.6609195
C3	70835165	70835513	BolC3t21307H	0	-	18	257	348	0.7385057
C3	70837259	70837523	BolC3t21308H	0	-	4	168	264	0.6363636
C3	70843680	70846023	BolC3t21309H	0	-	1297	2204	2343	0.9406744
C3	70850099	70852820	BolC3t21310H	0	-	1405	2721	2721	1.0000000
C3	70868035	70870444	BolC3t21311H	0	+	1311	2409	2409	1.0000000
C3	70874711	70876807	BolC3t21312H	0	+	1140	1988	2096	0.9484733
C3	70879502	70881717	BolC3t21313H	0	+	2730	2215	2215	1.0000000
C3	70881789	70882869	BolC3t21314H	0	+	1554	1080	1080	1.0000000
C3	70886010	70893944	BolC3t21315H	0	+	5972	7592	7934	0.9568944
C3	70895403	70897001	BolC3t21316H	0	-	323	1424	1598	0.8911139
C3	70901552	70903508	BolC3t21317H	0	-	13	335	1956	0.1712679
C3	70907411	70908995	BolC3t21318H	0	+	40	511	1584	0.3226010
C3	70934045	70934972	BolC3t21319H	0	-	248	924	927	0.9967638
C3	70937622	70942051	BolC3t21320H	0	+	1163	3092	4429	0.6981260
C3	70942975	70943509	BolC3t21321H	0	-	162	448	534	0.8389513
C3	70947232	70947900	BolC3t21322H	0	-	275	668	668	1.0000000
C3	70951804	70953444	BolC3t21323H	0	-	956	1550	1640	0.9451219
C3	70955098	70955455	BolC3t21324H	0	-	100	357	357	1.0000000
C3	70964026	70965112	BolC3t21325H	0	+	42	409	1086	0.3766114
C3	70967693	70968704	BolC3t21326H	0	-	17	379	1011	0.3748764
C3	70971855	70972359	BolC3t21327H	0	+	14	231	504	0.4583333
C3	70976588	70977206	BolC3t21328H	0	-	521	443	618	0.7168285
C3	70985063	70985852	BolC3t21329H	0	+	325	786	789	0.9961977
C3	70988622	70990398	BolC3t21330H	0	-	821	1776	1776	1.0000000
C3	71019171	71020550	BolC3t21331H	0	-	70	825	1379	0.5982596
C3	71026807	71027761	BolC3t21332H	0	-	107	854	954	0.8951782
C3	71031299	71032258	BolC3t21333H	0	-	31	502	959	0.5234619
C3	71033066	71038923	BolC3t21334H	0	-	47	1478	5857	0.2523476
C3	71040964	71042093	BolC3t21335H	0	-	23	588	1129	0.5208149
C3	71045669	71046626	BolC3t21336H	0	-	20	181	957	0.1891327
C3	71054512	71054878	BolC3t21337H	0	-	122	366	366	1.0000000
C3	71142842	71144078	BolC3t21338H	0	-	273	1181	1236	0.9555016
C3	71145194	71147384	BolC3t21339H	0	+	1551	2110	2190	0.9634703
C3	71149410	71151702	BolC3t21340H	0	+	386	1553	2292	0.6775742
C3	71151875	71155349	BolC3t21341H	0	-	665	2758	3474	0.7938975
C3	71156392	71157912	BolC3t21342H	0	+	585	1354	1520	0.8907894
C3	71159982	71161755	BolC3t21343H	0	-	754	1604	1773	0.9046813
C3	71164461	71164665	BolC3t21344H	0	-	254	204	204	1.0000000
C3	71172810	71173872	BolC3t21345H	0	+	508	1062	1062	1.0000000
C3	71177056	71180444	BolC3t21346H	0	+	1659	3291	3388	0.9713696
C3	71184245	71184830	BolC3t21347H	0	+	335	585	585	1.0000000
C3	71186487	71190141	BolC3t21348H	0	-	2272	3654	3654	1.0000000
C3	71193084	71196368	BolC3t21349H	0	+	895	3247	3284	0.9887332
C3	71196898	71198598	BolC3t21350H	0	-	1257	1657	1700	0.9747059
C3	71200350	71200767	BolC3t21351H	0	+	135	417	417	1.0000000
C3	71202909	71205241	BolC3t21352H	0	-	811	2245	2332	0.9626930
C3	71218699	71222003	BolC3t21353H	0	-	1864	3074	3304	0.9303874
C3	71237746	71238920	BolC3t21354H	0	-	37	308	1174	0.2623509
C3	71240929	71242355	BolC3t21355H	0	+	494	1390	1426	0.9747546
C3	71243985	71245067	BolC3t21356H	0	+	198	713	1082	0.6589649
C3	71261327	71264538	BolC3t21357H	0	-	1241	1862	3211	0.5798817
C3	71277395	71278793	BolC3t21358H	0	-	195	1092	1398	0.7811159
C3	71284989	71290989	BolC3t21359H	0	+	2837	5364	6000	0.8940000
C3	71294850	71295733	BolC3t21360H	0	-	61	876	883	0.9920725
C3	71295933	71299460	BolC3t21361H	0	-	499	3038	3527	0.8613552
C3	71317203	71366576	BolC3t21362H	0	-	13340	34724	49373	0.7032994
C3	71383412	71387332	BolC3t21363H	0	-	2037	3704	3920	0.9448979
C3	71415765	71418375	BolC3t21364H	0	+	685	2374	2610	0.9095786
C3	71437306	71437921	BolC3t21365H	0	-	27	306	615	0.4975610
C3	71444104	71445292	BolC3t21366H	0	-	754	1188	1188	1.0000000
C3	71445702	71451297	BolC3t21367H	0	-	232	2251	5595	0.4023235
C3	71452058	71454074	BolC3t21368H	0	-	1514	2016	2016	1.0000000
C3	71464647	71467710	BolC3t21369H	0	+	387	2612	3063	0.8527587
C3	71478214	71481996	BolC3t21370H	0	-	1071	3159	3782	0.8352724
C3	71496196	71496349	BolC3t21371H	0	-	24	152	153	0.9934641
C3	71497100	71499231	BolC3t21372H	0	-	219	1380	2131	0.6475833
C3	71501812	71502520	BolC3t21373H	0	-	6	299	708	0.4223164
C3	71511396	71511988	BolC3t21374H	0	+	367	592	592	1.0000000
C3	71512827	71513369	BolC3t21375H	0	-	185	384	542	0.7084871
C3	71514688	71517556	BolC3t21376H	0	+	1313	2849	2868	0.9933752
C3	71517733	71519203	BolC3t21377H	0	-	654	1468	1470	0.9986395
C3	71520295	71522841	BolC3t21378H	0	-	87	1451	2546	0.5699136
C3	71525218	71526301	BolC3t21379H	0	-	679	1067	1083	0.9852262
C3	71528503	71530768	BolC3t21380H	0	+	245	1528	2265	0.6746137
C3	71543591	71544518	BolC3t21381H	0	-	273	804	927	0.8673139
C3	71544566	71546781	BolC3t21382H	0	-	495	1191	2215	0.5376975
C3	71548064	71548229	BolC3t21383H	0	-	14	158	165	0.9575757
C3	71554129	71554369	BolC3t21384H	0	-	13	89	240	0.3708333
C3	71555863	71556067	BolC3t21385H	0	-	0	0	204	0.0000000
C3	71560218	71567586	BolC3t21386H	0	+	3239	6494	7368	0.8813789
C3	71569524	71571406	BolC3t21387H	0	-	190	1040	1882	0.5526036
C3	71577525	71578412	BolC3t21388H	0	-	696	887	887	1.0000000
C3	71591399	71591516	BolC3t21389H	0	-	2	53	117	0.4529915
C3	71593547	71594662	BolC3t21390H	0	-	189	1055	1115	0.9461883
C3	71594936	71597609	BolC3t21391H	0	+	1751	2526	2673	0.9450056
C3	71598122	71599861	BolC3t21392H	0	+	162	992	1739	0.5704428
C3	71604774	71614703	BolC3t21393H	0	-	11856	9079	9929	0.9143922
C3	71609006	71610564	BolC3t21394H	0	+	2861	1164	1558	0.7471117
C3	71613196	71614889	BolC3t21395H	0	-	1668	1693	1693	1.0000000
C3	71623854	71624372	BolC3t21396H	0	+	1	77	518	0.1486486
C3	71625121	71625327	BolC3t21397H	0	-	32	204	206	0.9902912
C3	71629378	71629893	BolC3t21398H	0	+	28	304	515	0.5902913
C3	71630812	71637964	BolC3t21399H	0	-	1859	6297	7152	0.8804530
C3	71636549	71637351	BolC3t21400H	0	+	13	641	802	0.7992519
C3	71671761	71679713	BolC3t21401H	0	-	696	5207	7952	0.6548038
C3	71680535	71685247	BolC3t21402H	0	-	1513	4581	4712	0.9721987
C3	71686930	71687443	BolC3t21403H	0	+	461	513	513	1.0000000
C3	71703244	71703466	BolC3t21404H	0	-	5	119	222	0.5360360
C3	71719277	71719816	BolC3t21405H	0	-	22	400	539	0.7421150
C3	71720750	71721595	BolC3t21406H	0	-	618	769	845	0.9100592
C3	71722349	71723175	BolC3t21407H	0	+	183	800	826	0.9685230
C3	71723930	71724791	BolC3t21408H	0	+	461	861	861	1.0000000
C3	71743562	71745775	BolC3t21409H	0	+	328	784	2213	0.3542702
C3	71757061	71757790	BolC3t21410H	0	+	7	139	729	0.1906722
C3	71760556	71761271	BolC3t21411H	0	-	0	0	715	0.0000000
C3	71773754	71775390	BolC3t21412H	0	+	209	1386	1636	0.8471882
C3	71779464	71779943	BolC3t21413H	0	-	193	219	479	0.4572025
C3	71781388	71781773	BolC3t21414H	0	-	16	179	385	0.4649351
C3	71790578	71790910	BolC3t21415H	0	-	12	262	332	0.7891566
C3	71793594	71794080	BolC3t21416H	0	-	0	0	486	0.0000000
C3	71794781	71795171	BolC3t21417H	0	-	0	0	390	0.0000000
C3	71795347	71795488	BolC3t21418H	0	-	0	0	141	0.0000000
C3	71809809	71811937	BolC3t21419H	0	-	103	1461	2128	0.6865602
C3	71814867	71815834	BolC3t21420H	0	+	16	393	967	0.4064116
C3	71820949	71823733	BolC3t21421H	0	-	173	1695	2784	0.6088362
C3	71856788	71857579	BolC3t21422H	0	-	203	761	791	0.9620733
C3	71858545	71859517	BolC3t21423H	0	+	394	803	972	0.8261317
C3	71868442	71868559	BolC3t21424H	0	-	1	51	117	0.4358974
C3	71874002	71876445	BolC3t21425H	0	-	93	1097	2443	0.4490381
C3	71882931	71883206	BolC3t21426H	0	-	193	275	275	1.0000000
C3	71884551	71884808	BolC3t21427H	0	+	255	257	257	1.0000000
C3	71900794	71903337	BolC3t21428H	0	+	619	2166	2543	0.8517499
C3	71906643	71907272	BolC3t21429H	0	-	48	424	629	0.6740859
C3	71934749	71936620	BolC3t21430H	0	+	485	1636	1871	0.8743987
C3	71950160	71950513	BolC3t21431H	0	+	237	353	353	1.0000000
C3	71952598	71954026	BolC3t21432H	0	+	820	1407	1428	0.9852941
C3	71966404	71966965	BolC3t21433H	0	-	52	427	561	0.7611408
C3	71997722	71999023	BolC3t21434H	0	+	59	730	1301	0.5611069
C3	72008020	72008125	BolC3t21435H	0	+	16	93	105	0.8857143
C3	72010355	72011506	BolC3t21436H	0	+	1072	1151	1151	1.0000000
C3	72014051	72014889	BolC3t21437H	0	+	754	838	838	1.0000000
C3	72017093	72020306	BolC3t21438H	0	-	1310	3213	3213	1.0000000
C3	72017833	72018100	BolC3t21439H	0	-	91	267	267	1.0000000
C3	72029937	72030719	BolC3t21440H	0	-	472	782	782	1.0000000
C3	72031863	72034781	BolC3t21441H	0	+	1080	2887	2918	0.9893763
C3	72082115	72082253	BolC3t21442H	0	+	98	138	138	1.0000000
C3	72090040	72091101	BolC3t21443H	0	-	409	1061	1061	1.0000000
C3	72106728	72108361	BolC3t21444H	0	-	1178	1633	1633	1.0000000
C3	72111502	72112871	BolC3t21445H	0	+	1080	1369	1369	1.0000000
C3	72123705	72125472	BolC3t21446H	0	+	185	1553	1767	0.8788908
C3	72125665	72128050	BolC3t21447H	0	-	1331	2022	2385	0.8477988
C3	72133911	72134097	BolC3t21448H	0	+	186	186	186	1.0000000
C3	72137224	72137782	BolC3t21449H	0	+	340	558	558	1.0000000
C3	72149645	72149900	BolC3t21450H	0	-	302	255	255	1.0000000
C3	72150761	72151741	BolC3t21451H	0	+	786	980	980	1.0000000
C3	72152860	72153403	BolC3t21452H	0	-	515	543	543	1.0000000
C3	72156613	72157086	BolC3t21453H	0	-	411	473	473	1.0000000
C3	72172327	72172801	BolC3t21454H	0	-	0	0	474	0.0000000
C3	72184296	72186447	BolC3t21455H	0	+	9	284	2151	0.1320316
C3	72189206	72189332	BolC3t21456H	0	+	67	126	126	1.0000000
C3	72190689	72190951	BolC3t21457H	0	+	5	208	262	0.7938932
C3	72192273	72193732	BolC3t21458H	0	+	290	1450	1459	0.9938314
C3	72203623	72204103	BolC3t21459H	0	-	679	480	480	1.0000000
C3	72227635	72229227	BolC3t21460H	0	+	870	1526	1592	0.9585427
C3	72231514	72235780	BolC3t21461H	0	-	2173	4228	4266	0.9910924
C3	72248143	72250531	BolC3t21462H	0	-	1189	2349	2388	0.9836683
C3	72252201	72254921	BolC3t21463H	0	+	2151	2715	2720	0.9981618
C3	72255198	72256314	BolC3t21464H	0	-	835	1116	1116	1.0000000
C3	72257997	72258711	BolC3t21465H	0	-	1055	714	714	1.0000000
C3	72261018	72261785	BolC3t21466H	0	-	661	767	767	1.0000000
C3	72265114	72265630	BolC3t21467H	0	+	438	516	516	1.0000000
C3	72272800	72274129	BolC3t21468H	0	-	277	1329	1329	1.0000000
C3	72285119	72286238	BolC3t21469H	0	-	113	830	1119	0.7417337
C3	72290957	72292634	BolC3t21470H	0	-	1727	1677	1677	1.0000000
C3	72296298	72299835	BolC3t21471H	0	+	232	2572	3537	0.7271699
C3	72301268	72302903	BolC3t21472H	0	+	1184	1629	1635	0.9963303
C3	72303328	72304048	BolC3t21473H	0	-	328	720	720	1.0000000
C3	72311419	72312156	BolC3t21474H	0	+	145	737	737	1.0000000
C3	72317913	72318146	BolC3t21475H	0	+	73	233	233	1.0000000
C3	72318225	72318435	BolC3t21476H	0	+	1	74	210	0.3523810
C3	72319687	72321437	BolC3t21477H	0	-	377	1254	1750	0.7165715
C3	72325580	72329187	BolC3t21478H	0	-	598	2029	3607	0.5625173
C3	72341356	72342202	BolC3t21479H	0	+	144	704	846	0.8321513
C3	72347587	72349515	BolC3t21480H	0	-	1532	1928	1928	1.0000000
C3	72372307	72372805	BolC3t21481H	0	+	1330	498	498	1.0000000
C3	72378132	72384841	BolC3t21482H	0	+	6204	6703	6709	0.9991057
C3	72385022	72385415	BolC3t21483H	0	-	122	393	393	1.0000000
C3	72398391	72398670	BolC3t21484H	0	-	0	0	279	0.0000000
C3	72401689	72402019	BolC3t21485H	0	-	118	330	330	1.0000000
C3	72408314	72408623	BolC3t21486H	0	+	363	309	309	1.0000000
C3	72412795	72413125	BolC3t21487H	0	-	23	177	330	0.5363637
C3	72416542	72421337	BolC3t21488H	0	-	3161	4642	4795	0.9680918
C3	72418884	72419196	BolC3t21489H	0	-	316	312	312	1.0000000
C3	72443323	72443891	BolC3t21490H	0	-	316	567	568	0.9982395
C3	72447123	72450448	BolC3t21491H	0	-	53	520	3325	0.1563910
C3	72454261	72454417	BolC3t21492H	0	+	0	0	156	0.0000000
C3	72457681	72460093	BolC3t21493H	0	+	588	2105	2412	0.8727197
C3	72462819	72462966	BolC3t21494H	0	+	88	147	147	1.0000000
C3	72463540	72468836	BolC3t21495H	0	-	2169	3632	5296	0.6858006
C3	72476989	72480484	BolC3t21496H	0	+	1910	3413	3495	0.9765379
C3	72481026	72483411	BolC3t21497H	0	-	1216	2218	2385	0.9299790
C3	72488040	72488990	BolC3t21498H	0	+	233	945	950	0.9947369
C3	72494178	72496253	BolC3t21499H	0	-	1983	1967	2075	0.9479518
C3	72501440	72501911	BolC3t21500H	0	+	272	471	471	1.0000000
C3	72510288	72511996	BolC3t21501H	0	+	1017	1324	1708	0.7751756
C3	72513536	72516968	BolC3t21502H	0	+	1361	2863	3432	0.8342075
C3	72527373	72529276	BolC3t21503H	0	+	198	1185	1903	0.6227010
C3	72530263	72533586	BolC3t21504H	0	+	2471	2586	3323	0.7782125
C3	72538499	72542380	BolC3t21505H	0	-	1550	3777	3881	0.9732028
C3	72552340	72552743	BolC3t21506H	0	+	384	403	403	1.0000000
C3	72559711	72560044	BolC3t21507H	0	+	575	333	333	1.0000000
C3	72571378	72572142	BolC3t21508H	0	-	150	641	764	0.8390052
C3	72579194	72581877	BolC3t21509H	0	-	521	2268	2683	0.8453224
C3	72615663	72617351	BolC3t21510H	0	+	211	1495	1688	0.8856635
C3	72630502	72630882	BolC3t21511H	0	+	0	0	380	0.0000000
C3	72631474	72632048	BolC3t21512H	0	+	0	0	574	0.0000000
C3	72634261	72635032	BolC3t21513H	0	-	538	771	771	1.0000000
C3	72636342	72637248	BolC3t21514H	0	+	740	906	906	1.0000000
C3	72638215	72640623	BolC3t21515H	0	-	1141	2368	2408	0.9833887
C3	72643344	72645246	BolC3t21516H	0	+	313	1749	1902	0.9195583
C3	72646204	72649360	BolC3t21517H	0	-	2106	3124	3156	0.9898606
C3	72650687	72652529	BolC3t21518H	0	+	710	1825	1842	0.9907709
C3	72662666	72663041	BolC3t21519H	0	+	36	187	375	0.4986667
C3	72665777	72666626	BolC3t21520H	0	-	135	741	849	0.8727915
C3	72667940	72669875	BolC3t21521H	0	+	1116	1678	1935	0.8671834
C3	72670054	72670981	BolC3t21522H	0	-	508	927	927	1.0000000
C3	72681978	72683444	BolC3t21523H	0	+	183	609	1466	0.4154161
C3	72714820	72715834	BolC3t21524H	0	+	482	1014	1014	1.0000000
C3	72725736	72725979	BolC3t21525H	0	-	0	0	243	0.0000000
C3	72744566	72748062	BolC3t21526H	0	+	1888	3294	3496	0.9422197
C3	72751875	72764823	BolC3t21527H	0	+	410	3709	12948	0.2864535
C3	72766233	72769057	BolC3t21528H	0	-	1977	2811	2824	0.9953966
C3	72770144	72770500	BolC3t21529H	0	+	36	266	356	0.7471910
C3	72776566	72777979	BolC3t21530H	0	+	365	1061	1413	0.7508847
C3	72783107	72783266	BolC3t21531H	0	-	45	159	159	1.0000000
C3	72796869	72800921	BolC3t21532H	0	-	1073	3306	4052	0.8158934
C3	72802647	72803165	BolC3t21533H	0	+	148	518	518	1.0000000
C3	72809698	72810730	BolC3t21534H	0	-	344	1021	1032	0.9893411
C3	72813106	72817594	BolC3t21535H	0	-	1980	4373	4488	0.9743761
C3	72822057	72823113	BolC3t21536H	0	-	262	927	1056	0.8778409
C3	72823970	72828324	BolC3t21537H	0	+	2110	3770	4354	0.8658705
C3	72829755	72830162	BolC3t21538H	0	+	457	407	407	1.0000000
C3	72843432	72843973	BolC3t21539H	0	-	108	115	541	0.2125693
C3	72854963	72856941	BolC3t21540H	0	-	975	1375	1978	0.6951466
C3	72867643	72869781	BolC3t21541H	0	-	1292	1800	2138	0.8419083
C3	72870085	72873258	BolC3t21542H	0	+	2101	2938	3173	0.9259376
C3	72874177	72875462	BolC3t21543H	0	+	470	1261	1285	0.9813229
C3	72903437	72904021	BolC3t21544H	0	+	303	584	584	1.0000000
C3	72913293	72914271	BolC3t21545H	0	-	768	978	978	1.0000000
C3	72926088	72926658	BolC3t21546H	0	+	141	318	570	0.5578948
C3	72927298	72929724	BolC3t21547H	0	-	1274	2057	2426	0.8478978
C3	72936472	72936983	BolC3t21548H	0	+	161	511	511	1.0000000
C3	72939112	72939682	BolC3t21549H	0	-	13	214	570	0.3754386
C3	72944709	72945900	BolC3t21550H	0	+	1212	1191	1191	1.0000000
C3	72954945	72955353	BolC3t21551H	0	-	224	408	408	1.0000000
C3	72954957	72955602	BolC3t21552H	0	+	329	645	645	1.0000000
C3	72956153	72956723	BolC3t21553H	0	-	91	334	570	0.5859649
C3	72967422	72968462	BolC3t21554H	0	-	871	753	1040	0.7240385
C3	72971389	72971788	BolC3t21555H	0	+	75	399	399	1.0000000
C3	72982436	72983468	BolC3t21556H	0	-	165	1032	1032	1.0000000
C3	72991538	72991778	BolC3t21557H	0	-	1	84	240	0.3500000
C3	72991823	72992024	BolC3t21558H	0	-	33	182	201	0.9054726
C3	72992712	72994590	BolC3t21559H	0	+	755	1612	1878	0.8583599
C3	73012083	73012410	BolC3t21560H	0	+	0	0	327	0.0000000
C3	73014425	73016261	BolC3t21561H	0	+	416	1110	1836	0.6045752
C3	73033844	73034561	BolC3t21562H	0	+	122	650	717	0.9065551
C3	73038346	73039086	BolC3t21563H	0	+	497	740	740	1.0000000
C3	73050708	73051188	BolC3t21564H	0	+	35	446	480	0.9291667
C3	73058872	73059426	BolC3t21565H	0	-	6	63	554	0.1137184
C3	73062972	73065014	BolC3t21566H	0	-	16	562	2042	0.2752204
C3	73072765	73073089	BolC3t21567H	0	+	31	200	324	0.6172839
C3	73091709	73093154	BolC3t21568H	0	+	17	162	1445	0.1121107
C3	73130574	73135147	BolC3t21569H	0	+	2337	3614	4573	0.7902908
C3	73147704	73149055	BolC3t21570H	0	+	581	1130	1351	0.8364175
C3	73153239	73153371	BolC3t21571H	0	-	78	132	132	1.0000000
C3	73156102	73157598	BolC3t21572H	0	-	833	1496	1496	1.0000000
C3	73160862	73161078	BolC3t21573H	0	-	0	0	216	0.0000000
C3	73164702	73165569	BolC3t21574H	0	+	576	818	867	0.9434833
C3	73166087	73169108	BolC3t21575H	0	+	2207	3006	3021	0.9950348
C3	73170040	73172321	BolC3t21576H	0	+	829	2194	2281	0.9618588
C3	73173586	73173763	BolC3t21577H	0	-	10	61	177	0.3446328
C3	73173896	73179639	BolC3t21578H	0	+	4175	5372	5743	0.9353996
C3	73185733	73187659	BolC3t21579H	0	-	1357	1911	1926	0.9922118
C3	73192638	73192863	BolC3t21580H	0	-	240	225	225	1.0000000
C3	73199835	73201344	BolC3t21581H	0	-	1143	1501	1509	0.9946985
C3	73252414	73288005	BolC3t21582H	0	-	2965	18795	35591	0.5280830
C3	73278181	73278589	BolC3t21583H	0	-	4	282	408	0.6911765
C3	73279703	73280088	BolC3t21584H	0	+	3	156	385	0.4051948
C3	73286227	73292809	BolC3t21585H	0	-	269	2977	6582	0.4522941
C3	73317827	73318390	BolC3t21586H	0	+	21	283	563	0.5026643
C3	73319780	73324105	BolC3t21587H	0	-	1279	3360	4325	0.7768786
C3	73330901	73332817	BolC3t21588H	0	+	1258	1916	1916	1.0000000
C3	73333520	73334841	BolC3t21589H	0	-	536	1288	1321	0.9750189
C3	73336403	73337315	BolC3t21590H	0	-	919	912	912	1.0000000
C3	73338192	73340079	BolC3t21591H	0	-	1744	1887	1887	1.0000000
C3	73341000	73342610	BolC3t21592H	0	-	454	1428	1610	0.8869565
C3	73343224	73351505	BolC3t21593H	0	-	2152	5570	8281	0.6726241
C3	73368104	73372129	BolC3t21594H	0	+	1381	3372	4025	0.8377640
C3	73372854	73374472	BolC3t21595H	0	+	240	1211	1618	0.7484549
C3	73379013	73381452	BolC3t21596H	0	-	95	804	2439	0.3296433
C3	73387129	73389629	BolC3t21597H	0	+	368	1201	2500	0.4804000
C3	73401738	73402540	BolC3t21598H	0	-	46	583	802	0.7269326
C3	73432574	73433547	BolC3t21599H	0	-	76	763	973	0.7841727
C3	73441066	73443659	BolC3t21600H	0	-	570	2033	2593	0.7840340
C3	73452931	73456417	BolC3t21601H	0	-	280	1947	3486	0.5585198
C3	73460906	73475059	BolC3t21602H	0	-	2018	6273	14153	0.4432276
C3	73476404	73476947	BolC3t21603H	0	+	325	543	543	1.0000000
C3	73478602	73479317	BolC3t21604H	0	-	320	697	715	0.9748252
C3	73481836	73482322	BolC3t21605H	0	-	102	294	486	0.6049383
C3	73483157	73486216	BolC3t21606H	0	-	2720	3059	3059	1.0000000
C3	73487521	73490597	BolC3t21607H	0	-	1296	2899	3076	0.9424577
C3	73500719	73502934	BolC3t21608H	0	-	639	2084	2215	0.9408578
C3	73504437	73507718	BolC3t21609H	0	-	1049	2997	3281	0.9134410
C3	73512459	73514498	BolC3t21610H	0	+	97	1221	2039	0.5988230
C3	73514484	73515138	BolC3t21611H	0	+	1	49	654	0.0749235
C3	73518304	73519929	BolC3t21612H	0	-	461	1283	1625	0.7895384
C3	73521568	73529321	BolC3t21613H	0	+	136	2088	7753	0.2693151
C3	73525972	73526746	BolC3t21614H	0	-	0	0	774	0.0000000
C3	73532469	73532676	BolC3t21615H	0	+	42	159	207	0.7681159
C3	73536763	73538082	BolC3t21616H	0	+	225	1101	1319	0.8347233
C3	73543132	73544448	BolC3t21617H	0	-	186	1082	1316	0.8221884
C3	73547050	73547572	BolC3t21618H	0	-	699	522	522	1.0000000
C3	73555358	73555866	BolC3t21619H	0	-	156	504	508	0.9921260
C3	73556986	73558541	BolC3t21620H	0	-	1071	1447	1555	0.9305466
C3	73559176	73559656	BolC3t21621H	0	-	142	480	480	1.0000000
C3	73560746	73563248	BolC3t21622H	0	+	1143	2223	2502	0.8884892
C3	73565465	73567497	BolC3t21623H	0	+	483	1864	2032	0.9173228
C3	73568327	73570941	BolC3t21624H	0	+	385	2504	2614	0.9579189
C3	73577053	73579072	BolC3t21625H	0	-	1182	1889	2019	0.9356117
C3	73583436	73584162	BolC3t21626H	0	+	477	726	726	1.0000000
C3	73585880	73587960	BolC3t21627H	0	+	1042	2080	2080	1.0000000
C3	73588624	73589683	BolC3t21628H	0	+	160	1008	1059	0.9518414
C3	73593080	73593963	BolC3t21629H	0	+	642	828	883	0.9377124
C3	73594116	73595976	BolC3t21630H	0	-	567	1836	1860	0.9870968
C3	73596137	73597884	BolC3t21631H	0	+	127	1044	1747	0.5975959
C3	73598394	73602384	BolC3t21632H	0	-	1346	3490	3990	0.8746867
C3	73611535	73612507	BolC3t21633H	0	+	271	914	972	0.9403292
C3	73616776	73619722	BolC3t21634H	0	-	743	2539	2946	0.8618466
C3	73633993	73634722	BolC3t21635H	0	-	138	620	729	0.8504801
C3	73636455	73641118	BolC3t21636H	0	+	1516	4231	4663	0.9073558
C3	73642096	73643044	BolC3t21637H	0	-	455	948	948	1.0000000
C3	73643502	73645770	BolC3t21638H	0	-	840	2268	2268	1.0000000
C3	73648626	73653895	BolC3t21639H	0	-	500	2366	5269	0.4490416
C3	73659696	73665270	BolC3t21640H	0	-	2127	5281	5574	0.9474345
C3	73680237	73680482	BolC3t21641H	0	+	136	245	245	1.0000000
C3	73680594	73681672	BolC3t21642H	0	+	10	253	1078	0.2346939
C3	73686759	73688405	BolC3t21643H	0	-	232	1619	1646	0.9835966
C3	73688557	73693641	BolC3t21644H	0	+	714	2486	5084	0.4889851
C3	73694211	73696124	BolC3t21645H	0	-	87	485	1913	0.2535285
C3	73696861	73697686	BolC3t21646H	0	-	241	736	825	0.8921212
C3	73699599	73701842	BolC3t21647H	0	+	34	549	2243	0.2447615
C4	119408	128306	BolC4t21648H	0	-	2622	5942	8898	0.6677905
C4	129642	130068	BolC4t21649H	0	+	106	386	426	0.9061033
C4	130587	131673	BolC4t21650H	0	-	96	549	1086	0.5055249
C4	132764	134192	BolC4t21651H	0	-	182	1342	1428	0.9397759
C4	135145	136608	BolC4t21652H	0	-	64	1006	1463	0.6876281
C4	138307	138616	BolC4t21653H	0	-	3	41	309	0.1326861
C4	140229	140541	BolC4t21654H	0	-	42	135	312	0.4326923
C4	143229	145183	BolC4t21655H	0	-	400	1789	1954	0.9155578
C4	152945	153413	BolC4t21656H	0	+	53	320	468	0.6837607
C4	155474	156226	BolC4t21657H	0	-	115	561	752	0.7460107
C4	156795	157344	BolC4t21658H	0	-	213	549	549	1.0000000
C4	157645	157762	BolC4t21659H	0	+	90	117	117	1.0000000
C4	160282	160586	BolC4t21660H	0	+	1	65	304	0.2138158
C4	163051	165738	BolC4t21661H	0	+	647	1943	2687	0.7231113
C4	167080	167903	BolC4t21662H	0	-	506	823	823	1.0000000
C4	169023	169972	BolC4t21663H	0	+	247	943	949	0.9936776
C4	170554	172512	BolC4t21664H	0	+	1129	1958	1958	1.0000000
C4	173016	173802	BolC4t21665H	0	-	514	786	786	1.0000000
C4	174180	179578	BolC4t21666H	0	+	1378	3881	5398	0.7189700
C4	182855	183476	BolC4t21667H	0	+	18	119	621	0.1916264
C4	228184	230419	BolC4t21668H	0	+	412	957	2235	0.4281879
C4	230928	232544	BolC4t21669H	0	-	714	1516	1616	0.9381188
C4	236363	237895	BolC4t21670H	0	-	841	1532	1532	1.0000000
C4	240715	241411	BolC4t21671H	0	+	247	590	696	0.8477011
C4	242828	245342	BolC4t21672H	0	-	130	1322	2514	0.5258552
C4	248676	249382	BolC4t21673H	0	-	274	549	706	0.7776204
C4	250714	252934	BolC4t21674H	0	-	465	2034	2220	0.9162162
C4	254649	257540	BolC4t21675H	0	-	1011	2838	2891	0.9816672
C4	260051	282677	BolC4t21676H	0	-	4779	15668	22626	0.6924777
C4	270558	272335	BolC4t21677H	0	+	156	1138	1777	0.6404052
C4	272369	273443	BolC4t21678H	0	+	719	833	1074	0.7756052
C4	282737	284240	BolC4t21679H	0	-	245	611	1503	0.4065203
C4	285438	304051	BolC4t21680H	0	-	3840	14176	18613	0.7616182
C4	307290	309471	BolC4t21681H	0	+	1055	2181	2181	1.0000000
C4	310236	320604	BolC4t21682H	0	-	1786	8430	10368	0.8130787
C4	325180	326774	BolC4t21683H	0	-	1177	1594	1594	1.0000000
C4	328879	329305	BolC4t21684H	0	-	86	249	426	0.5845070
C4	330955	331306	BolC4t21685H	0	+	130	275	351	0.7834758
C4	332396	334688	BolC4t21686H	0	-	1618	2292	2292	1.0000000
C4	503229	504137	BolC4t21687H	0	+	557	908	908	1.0000000
C4	505145	508560	BolC4t21688H	0	-	863	3186	3415	0.9329429
C4	509181	511093	BolC4t21689H	0	-	1611	1424	1912	0.7447699
C4	511483	511678	BolC4t21690H	0	-	185	195	195	1.0000000
C4	512905	514092	BolC4t21691H	0	+	277	1019	1187	0.8584667
C4	514283	515195	BolC4t21692H	0	-	157	637	912	0.6984649
C4	515931	517915	BolC4t21693H	0	-	950	1984	1984	1.0000000
C4	518984	521692	BolC4t21694H	0	+	820	2651	2708	0.9789513
C4	526474	526783	BolC4t21695H	0	+	55	309	309	1.0000000
C4	533428	534945	BolC4t21696H	0	+	95	1356	1517	0.8938695
C4	538482	544357	BolC4t21697H	0	-	3249	5875	5875	1.0000000
C4	610602	614466	BolC4t21698H	0	-	424	2624	3864	0.6790890
C4	619208	620855	BolC4t21699H	0	-	670	1647	1647	1.0000000
C4	622776	626672	BolC4t21700H	0	-	899	3307	3896	0.8488193
C4	627501	629065	BolC4t21701H	0	+	21	557	1564	0.3561381
C4	640165	641769	BolC4t21702H	0	-	235	794	1604	0.4950125
C4	643641	645226	BolC4t21703H	0	-	0	0	1585	0.0000000
C4	660712	661243	BolC4t21704H	0	-	0	0	531	0.0000000
C4	661785	664715	BolC4t21705H	0	-	598	2089	2930	0.7129693
C4	665705	665918	BolC4t21706H	0	+	128	213	213	1.0000000
C4	666647	667656	BolC4t21707H	0	-	47	416	1009	0.4122894
C4	677899	678737	BolC4t21708H	0	+	179	834	838	0.9952267
C4	698681	701486	BolC4t21709H	0	+	980	2635	2805	0.9393939
C4	704350	705456	BolC4t21710H	0	+	146	1018	1106	0.9204340
C4	715576	716697	BolC4t21711H	0	+	429	846	1121	0.7546833
C4	722583	724061	BolC4t21712H	0	+	1003	1478	1478	1.0000000
C4	726666	727656	BolC4t21713H	0	+	425	804	990	0.8121212
C4	729971	732640	BolC4t21714H	0	+	592	2082	2669	0.7800674
C4	755289	756918	BolC4t21715H	0	-	4	330	1629	0.2025783
C4	757818	759096	BolC4t21716H	0	+	12	20	1278	0.0156495
C4	761161	762222	BolC4t21717H	0	-	17	372	1061	0.3506126
C4	782052	782436	BolC4t21718H	0	-	40	351	384	0.9140625
C4	782501	788060	BolC4t21719H	0	-	52	769	5559	0.1383342
C4	788419	790682	BolC4t21720H	0	-	0	0	2263	0.0000000
C4	804995	805489	BolC4t21721H	0	-	1	35	494	0.0708502
C4	807855	808149	BolC4t21722H	0	-	0	0	294	0.0000000
C4	825419	826694	BolC4t21723H	0	+	55	1003	1275	0.7866667
C4	862239	863379	BolC4t21724H	0	+	112	700	1140	0.6140351
C4	864043	864553	BolC4t21725H	0	-	0	0	510	0.0000000
C4	897602	898769	BolC4t21726H	0	+	44	270	1167	0.2313625
C4	899534	902927	BolC4t21727H	0	-	415	2614	3393	0.7704096
C4	905625	907217	BolC4t21728H	0	+	80	1296	1592	0.8140703
C4	908578	909229	BolC4t21729H	0	+	326	633	651	0.9723502
C4	911579	912037	BolC4t21730H	0	-	418	458	458	1.0000000
C4	913614	915646	BolC4t21731H	0	+	54	731	2032	0.3597441
C4	916119	918162	BolC4t21732H	0	+	912	2043	2043	1.0000000
C4	919001	921010	BolC4t21733H	0	-	700	1723	2009	0.8576406
C4	926113	931163	BolC4t21734H	0	+	1562	4373	5050	0.8659406
C4	935208	935586	BolC4t21735H	0	+	1	102	378	0.2698413
C4	944961	950827	BolC4t21736H	0	-	247	473	5866	0.0806342
C4	961749	963030	BolC4t21737H	0	-	0	0	1281	0.0000000
C4	964333	965578	BolC4t21738H	0	+	198	1088	1245	0.8738956
C4	973900	974364	BolC4t21739H	0	-	0	0	464	0.0000000
C4	974514	975634	BolC4t21740H	0	-	8	96	1120	0.0857143
C4	999317	1001555	BolC4t21741H	0	+	21	243	2238	0.1085791
C4	1003161	1003287	BolC4t21742H	0	+	134	126	126	1.0000000
C4	1003455	1003563	BolC4t21743H	0	+	61	108	108	1.0000000
C4	1052627	1053554	BolC4t21744H	0	+	0	0	927	0.0000000
C4	1054658	1054919	BolC4t21745H	0	-	0	0	261	0.0000000
C4	1058681	1058801	BolC4t21746H	0	-	0	0	120	0.0000000
C4	1061515	1061719	BolC4t21747H	0	+	2	92	204	0.4509804
C4	1064767	1064947	BolC4t21748H	0	+	7	3	180	0.0166667
C4	1065325	1065585	BolC4t21749H	0	+	9	221	260	0.8500000
C4	1066311	1067178	BolC4t21750H	0	+	8	45	867	0.0519031
C4	1068502	1078040	BolC4t21751H	0	+	1146	4838	9538	0.5072342
C4	1080032	1080511	BolC4t21752H	0	+	0	0	479	0.0000000
C4	1081358	1082333	BolC4t21753H	0	-	771	975	975	1.0000000
C4	1086615	1087938	BolC4t21754H	0	+	268	1077	1323	0.8140590
C4	1126954	1127110	BolC4t21755H	0	+	11	85	156	0.5448718
C4	1133065	1134985	BolC4t21756H	0	+	739	1830	1920	0.9531250
C4	1137284	1138004	BolC4t21757H	0	+	237	613	720	0.8513889
C4	1157460	1159727	BolC4t21758H	0	-	1050	2267	2267	1.0000000
C4	1164529	1167300	BolC4t21759H	0	+	268	1916	2771	0.6914471
C4	1168147	1171800	BolC4t21760H	0	+	2385	3653	3653	1.0000000
C4	1173854	1176019	BolC4t21761H	0	-	739	1799	2165	0.8309469
C4	1176865	1180261	BolC4t21762H	0	+	420	2733	3396	0.8047703
C4	1182146	1183040	BolC4t21763H	0	-	110	434	894	0.4854586
C4	1196587	1201981	BolC4t21764H	0	-	3145	5334	5394	0.9888765
C4	1203285	1204456	BolC4t21765H	0	-	886	1171	1171	1.0000000
C4	1206143	1207516	BolC4t21766H	0	-	339	1329	1373	0.9679534
C4	1209162	1210308	BolC4t21767H	0	-	799	1146	1146	1.0000000
C4	1210282	1210955	BolC4t21768H	0	-	807	673	673	1.0000000
C4	1211931	1213434	BolC4t21769H	0	-	465	1503	1503	1.0000000
C4	1223600	1224990	BolC4t21770H	0	-	203	1313	1390	0.9446043
C4	1228915	1229300	BolC4t21771H	0	-	0	0	385	0.0000000
C4	1246372	1248586	BolC4t21772H	0	+	968	2154	2214	0.9728997
C4	1266142	1266427	BolC4t21773H	0	+	64	285	285	1.0000000
C4	1267564	1273598	BolC4t21774H	0	+	1493	4551	6034	0.7542260
C4	1278560	1279280	BolC4t21775H	0	+	132	610	720	0.8472222
C4	1283678	1285826	BolC4t21776H	0	-	399	1734	2148	0.8072626
C4	1319660	1323928	BolC4t21777H	0	-	1593	3839	4268	0.8994845
C4	1328525	1329503	BolC4t21778H	0	+	48	740	978	0.7566462
C4	1333811	1334180	BolC4t21779H	0	-	0	0	369	0.0000000
C4	1353136	1354131	BolC4t21780H	0	+	23	547	995	0.5497487
C4	1371306	1371435	BolC4t21781H	0	-	86	129	129	1.0000000
C4	1385394	1387204	BolC4t21782H	0	+	106	1110	1810	0.6132597
C4	1389204	1389777	BolC4t21783H	0	-	15	157	573	0.2739965
C4	1391086	1392951	BolC4t21784H	0	-	805	1852	1865	0.9930295
C4	1394834	1395986	BolC4t21785H	0	-	151	910	1152	0.7899306
C4	1405384	1409012	BolC4t21786H	0	+	1847	3628	3628	1.0000000
C4	1409170	1409611	BolC4t21787H	0	-	636	441	441	1.0000000
C4	1412702	1414410	BolC4t21788H	0	-	937	1338	1708	0.7833723
C4	1463649	1473346	BolC4t21789H	0	+	852	4988	9697	0.5143859
C4	1475536	1476709	BolC4t21790H	0	+	493	1166	1173	0.9940324
C4	1477480	1478317	BolC4t21791H	0	+	562	775	837	0.9259259
C4	1478722	1479315	BolC4t21792H	0	-	193	404	593	0.6812816
C4	1480896	1483535	BolC4t21793H	0	-	805	2618	2639	0.9920424
C4	1483595	1484788	BolC4t21794H	0	-	209	1115	1193	0.9346186
C4	1493717	1496633	BolC4t21795H	0	-	192	1583	2916	0.5428669
C4	1501764	1503279	BolC4t21796H	0	+	702	1515	1515	1.0000000
C4	1504205	1507272	BolC4t21797H	0	+	1664	3060	3067	0.9977176
C4	1508778	1509168	BolC4t21798H	0	-	56	314	390	0.8051282
C4	1509782	1512544	BolC4t21799H	0	+	1390	2481	2762	0.8982621
C4	1512998	1513220	BolC4t21800H	0	-	202	222	222	1.0000000
C4	1521628	1522087	BolC4t21801H	0	+	353	459	459	1.0000000
C4	1525163	1572850	BolC4t21802H	0	+	25566	39893	47687	0.8365592
C4	1573183	1576156	BolC4t21803H	0	-	2018	2484	2973	0.8355197
C4	1577572	1579300	BolC4t21804H	0	-	423	1707	1728	0.9878472
C4	1588354	1588997	BolC4t21805H	0	+	22	440	643	0.6842924
C4	1592825	1593895	BolC4t21806H	0	+	355	1021	1070	0.9542056
C4	1594380	1594726	BolC4t21807H	0	+	236	346	346	1.0000000
C4	1594970	1597241	BolC4t21808H	0	-	1058	2254	2271	0.9925143
C4	1598572	1598818	BolC4t21809H	0	+	79	246	246	1.0000000
C4	1599721	1600096	BolC4t21810H	0	-	15	188	375	0.5013334
C4	1604593	1607216	BolC4t21811H	0	-	848	2405	2623	0.9168891
C4	1619735	1620017	BolC4t21812H	0	-	0	0	282	0.0000000
C4	1622548	1623712	BolC4t21813H	0	+	266	973	1164	0.8359107
C4	1632379	1632773	BolC4t21814H	0	+	0	0	394	0.0000000
C4	1636382	1638370	BolC4t21815H	0	+	1010	1864	1988	0.9376258
C4	1638436	1639485	BolC4t21816H	0	+	196	706	1049	0.6730219
C4	1643680	1644031	BolC4t21817H	0	+	81	351	351	1.0000000
C4	1644840	1646825	BolC4t21818H	0	-	674	1893	1985	0.9536524
C4	1647112	1647529	BolC4t21819H	0	+	20	258	417	0.6187050
C4	1649178	1649805	BolC4t21820H	0	-	352	627	627	1.0000000
C4	1651402	1652224	BolC4t21821H	0	-	380	788	822	0.9586375
C4	1734664	1735432	BolC4t21822H	0	-	79	613	768	0.7981771
C4	1736701	1737676	BolC4t21823H	0	-	401	934	975	0.9579487
C4	1739927	1742530	BolC4t21824H	0	-	1673	2563	2603	0.9846331
C4	1748399	1750478	BolC4t21825H	0	-	977	2079	2079	1.0000000
C4	1757154	1763523	BolC4t21826H	0	-	71	872	6369	0.1369132
C4	1782110	1782251	BolC4t21827H	0	+	163	141	141	1.0000000
C4	1784999	1785905	BolC4t21828H	0	+	3	193	906	0.2130243
C4	1789751	1794394	BolC4t21829H	0	+	27	455	4643	0.0979970
C4	1843443	1847893	BolC4t21830H	0	+	322	2916	4450	0.6552809
C4	1860814	1861132	BolC4t21831H	0	+	0	0	318	0.0000000
C4	1872793	1873123	BolC4t21832H	0	+	24	255	330	0.7727273
C4	1877751	1878594	BolC4t21833H	0	-	0	0	843	0.0000000
C4	1892104	1892691	BolC4t21834H	0	+	58	511	587	0.8705281
C4	1897570	1898592	BolC4t21835H	0	-	0	0	1022	0.0000000
C4	1909171	1909717	BolC4t21836H	0	-	0	0	546	0.0000000
C4	1923955	1924979	BolC4t21837H	0	-	0	0	1024	0.0000000
C4	1950329	1951351	BolC4t21838H	0	-	0	0	1022	0.0000000
C4	1959241	1960143	BolC4t21839H	0	-	0	0	902	0.0000000
C4	1961575	1962646	BolC4t21840H	0	-	2	218	1071	0.2035481
C4	1963013	1964946	BolC4t21841H	0	-	11	44	1933	0.0227625
C4	1966834	1967992	BolC4t21842H	0	-	42	485	1158	0.4188256
C4	2106376	2108066	BolC4t21843H	0	+	19	94	1690	0.0556213
C4	2118372	2120210	BolC4t21844H	0	-	443	1662	1838	0.9042438
C4	2126089	2127499	BolC4t21845H	0	+	1071	1410	1410	1.0000000
C4	2132366	2133107	BolC4t21846H	0	-	173	527	741	0.7112011
C4	2140886	2141087	BolC4t21847H	0	-	1	116	201	0.5771144
C4	2143429	2144131	BolC4t21848H	0	-	124	364	702	0.5185185
C4	2145898	2149952	BolC4t21849H	0	+	543	2727	4054	0.6726690
C4	2151148	2151984	BolC4t21850H	0	-	19	251	836	0.3002392
C4	2153563	2153715	BolC4t21851H	0	+	56	152	152	1.0000000
C4	2155382	2155904	BolC4t21852H	0	-	0	0	522	0.0000000
C4	2157869	2159007	BolC4t21853H	0	+	1108	1138	1138	1.0000000
C4	2169185	2176762	BolC4t21854H	0	+	3780	6436	7577	0.8494127
C4	2179592	2181681	BolC4t21855H	0	+	256	1103	2089	0.5280038
C4	2188357	2188663	BolC4t21856H	0	+	112	304	306	0.9934641
C4	2200346	2205317	BolC4t21857H	0	+	2337	4954	4971	0.9965802
C4	2206420	2207152	BolC4t21858H	0	-	22	459	732	0.6270492
C4	2208222	2209413	BolC4t21859H	0	-	897	1136	1191	0.9538203
C4	2211280	2212757	BolC4t21860H	0	-	541	1420	1477	0.9614083
C4	2214848	2217002	BolC4t21861H	0	-	1061	1980	2154	0.9192200
C4	2220463	2222596	BolC4t21862H	0	+	1527	2133	2133	1.0000000
C4	2223017	2223491	BolC4t21863H	0	-	297	448	474	0.9451477
C4	2224807	2228597	BolC4t21864H	0	+	1971	3781	3790	0.9976254
C4	2229615	2230399	BolC4t21865H	0	-	155	573	784	0.7308673
C4	2236206	2236691	BolC4t21866H	0	-	19	265	485	0.5463917
C4	2244737	2244923	BolC4t21867H	0	-	16	129	186	0.6935484
C4	2246805	2248470	BolC4t21868H	0	-	196	1385	1665	0.8318318
C4	2256683	2257229	BolC4t21869H	0	+	380	546	546	1.0000000
C4	2257558	2258441	BolC4t21870H	0	+	87	234	883	0.2650056
C4	2258784	2260582	BolC4t21871H	0	-	418	1782	1798	0.9911012
C4	2269254	2272225	BolC4t21872H	0	-	456	2293	2971	0.7717940
C4	2299928	2300852	BolC4t21873H	0	+	416	924	924	1.0000000
C4	2301503	2306378	BolC4t21874H	0	+	2154	4835	4875	0.9917949
C4	2306890	2311222	BolC4t21875H	0	-	2169	4118	4332	0.9506002
C4	2316051	2316597	BolC4t21876H	0	-	130	546	546	1.0000000
C4	2331858	2333853	BolC4t21877H	0	-	471	1914	1995	0.9593985
C4	2337037	2338755	BolC4t21878H	0	+	213	1692	1718	0.9848661
C4	2345363	2346564	BolC4t21879H	0	-	853	1201	1201	1.0000000
C4	2347800	2348519	BolC4t21880H	0	+	526	719	719	1.0000000
C4	2348765	2350929	BolC4t21881H	0	-	1465	2164	2164	1.0000000
C4	2356629	2357376	BolC4t21882H	0	-	478	747	747	1.0000000
C4	2362552	2364616	BolC4t21883H	0	+	586	1985	2064	0.9617248
C4	2365629	2367570	BolC4t21884H	0	-	388	1832	1941	0.9438434
C4	2369858	2371679	BolC4t21885H	0	-	622	1747	1821	0.9593630
C4	2379614	2380650	BolC4t21886H	0	+	67	646	1036	0.6235521
C4	2394111	2396055	BolC4t21887H	0	+	711	1842	1944	0.9475309
C4	2397683	2399014	BolC4t21888H	0	+	115	938	1331	0.7047333
C4	2405612	2408764	BolC4t21889H	0	+	1144	3010	3152	0.9549493
C4	2410903	2412526	BolC4t21890H	0	+	782	1474	1623	0.9081947
C4	2413128	2415247	BolC4t21891H	0	-	1167	1926	2119	0.9089193
C4	2418613	2420583	BolC4t21892H	0	-	595	1639	1970	0.8319797
C4	2434379	2434805	BolC4t21893H	0	+	29	299	426	0.7018780
C4	2437177	2440097	BolC4t21894H	0	-	1167	2578	2920	0.8828767
C4	2441618	2442623	BolC4t21895H	0	+	570	1005	1005	1.0000000
C4	2443278	2446262	BolC4t21896H	0	+	706	2174	2984	0.7285523
C4	2457558	2457747	BolC4t21897H	0	+	531	189	189	1.0000000
C4	2459776	2459968	BolC4t21898H	0	-	32	104	192	0.5416667
C4	2464324	2464636	BolC4t21899H	0	+	47	295	312	0.9455128
C4	2469890	2470937	BolC4t21900H	0	+	315	1046	1047	0.9990449
C4	2472618	2472783	BolC4t21901H	0	-	134	165	165	1.0000000
C4	2483520	2486452	BolC4t21902H	0	+	325	1673	2932	0.5706003
C4	2487108	2494538	BolC4t21903H	0	-	474	2934	7430	0.3948856
C4	2504412	2506529	BolC4t21904H	0	-	251	1379	2117	0.6513935
C4	2511349	2511643	BolC4t21905H	0	-	306	294	294	1.0000000
C4	2513285	2514259	BolC4t21906H	0	+	185	806	974	0.8275154
C4	2534879	2536912	BolC4t21907H	0	-	500	1825	2033	0.8976882
C4	2566446	2566705	BolC4t21908H	0	-	8	101	259	0.3899614
C4	2571911	2572553	BolC4t21909H	0	-	127	626	642	0.9750779
C4	2574527	2574785	BolC4t21910H	0	+	377	258	258	1.0000000
C4	2575468	2576235	BolC4t21911H	0	-	1021	767	767	1.0000000
C4	2578155	2578430	BolC4t21912H	0	-	339	275	275	1.0000000
C4	2578493	2581333	BolC4t21913H	0	+	1913	2840	2840	1.0000000
C4	2581892	2582928	BolC4t21914H	0	-	374	1036	1036	1.0000000
C4	2584174	2586950	BolC4t21915H	0	+	1841	2776	2776	1.0000000
C4	2587236	2588974	BolC4t21916H	0	-	291	1503	1738	0.8647871
C4	2597758	2599778	BolC4t21917H	0	+	565	2006	2020	0.9930693
C4	2600601	2604766	BolC4t21918H	0	+	1782	4072	4165	0.9776711
C4	2605107	2606530	BolC4t21919H	0	-	549	1386	1423	0.9739986
C4	2608316	2610631	BolC4t21920H	0	+	435	1585	2315	0.6846652
C4	2612218	2614132	BolC4t21921H	0	-	383	1675	1914	0.8751306
C4	2623271	2625196	BolC4t21922H	0	+	596	1800	1925	0.9350649
C4	2638941	2641268	BolC4t21923H	0	+	2523	2327	2327	1.0000000
C4	2644455	2645334	BolC4t21924H	0	+	34	608	879	0.6916951
C4	2650034	2651970	BolC4t21925H	0	+	352	1681	1936	0.8682851
C4	2652121	2655356	BolC4t21926H	0	-	1135	3166	3235	0.9786708
C4	2657601	2659475	BolC4t21927H	0	+	459	1610	1874	0.8591248
C4	2659745	2662088	BolC4t21928H	0	-	1417	2343	2343	1.0000000
C4	2662803	2666112	BolC4t21929H	0	-	1470	3294	3309	0.9954669
C4	2678887	2680979	BolC4t21930H	0	-	224	963	2092	0.4603251
C4	2682909	2685387	BolC4t21931H	0	+	301	2032	2478	0.8200161
C4	2687312	2687831	BolC4t21932H	0	+	55	375	519	0.7225434
C4	2688921	2689314	BolC4t21933H	0	+	143	393	393	1.0000000
C4	2692752	2693145	BolC4t21934H	0	+	129	376	393	0.9567430
C4	2695587	2695980	BolC4t21935H	0	+	619	393	393	1.0000000
C4	2697624	2703172	BolC4t21936H	0	-	1577	5445	5548	0.9814348
C4	2726895	2730840	BolC4t21937H	0	-	588	3445	3945	0.8732573
C4	2733664	2734864	BolC4t21938H	0	-	481	1121	1200	0.9341667
C4	2782392	2788007	BolC4t21939H	0	-	3457	5615	5615	1.0000000
C4	2799956	2800337	BolC4t21940H	0	-	9	265	381	0.6955380
C4	2809012	2809294	BolC4t21941H	0	+	192	282	282	1.0000000
C4	2810794	2815469	BolC4t21942H	0	-	1538	4120	4675	0.8812834
C4	2823839	2826583	BolC4t21943H	0	+	423	2427	2744	0.8844752
C4	2826966	2831346	BolC4t21944H	0	-	1171	2269	4380	0.5180365
C4	2832261	2833366	BolC4t21945H	0	-	284	1105	1105	1.0000000
C4	2834226	2836417	BolC4t21946H	0	-	389	1999	2191	0.9123688
C4	2842413	2843397	BolC4t21947H	0	+	201	810	984	0.8231707
C4	2854281	2856003	BolC4t21948H	0	-	246	1342	1722	0.7793264
C4	2859058	2862898	BolC4t21949H	0	-	2194	3383	3840	0.8809896
C4	2865459	2866108	BolC4t21950H	0	+	315	649	649	1.0000000
C4	2878975	2896948	BolC4t21951H	0	-	6012	14032	17973	0.7807267
C4	2897838	2899179	BolC4t21952H	0	-	3	112	1341	0.0835198
C4	2901298	2904129	BolC4t21953H	0	+	219	2109	2831	0.7449664
C4	2905960	2906971	BolC4t21954H	0	+	167	780	1011	0.7715133
C4	2918371	2919793	BolC4t21955H	0	+	210	1365	1422	0.9599156
C4	2921854	2922707	BolC4t21956H	0	+	491	853	853	1.0000000
C4	2927177	2932382	BolC4t21957H	0	-	497	3555	5205	0.6829971
C4	2934019	2935998	BolC4t21958H	0	-	803	1949	1979	0.9848408
C4	2937421	2938585	BolC4t21959H	0	-	176	1060	1164	0.9106529
C4	2943229	2944873	BolC4t21960H	0	+	315	1392	1644	0.8467153
C4	2945387	2946138	BolC4t21961H	0	+	153	508	751	0.6764314
C4	2947606	2948723	BolC4t21962H	0	-	274	1058	1117	0.9471800
C4	2949587	2952012	BolC4t21963H	0	-	1058	2342	2425	0.9657732
C4	2954190	2954703	BolC4t21964H	0	-	124	513	513	1.0000000
C4	2955379	2955795	BolC4t21965H	0	-	259	416	416	1.0000000
C4	2956064	2956226	BolC4t21966H	0	-	71	101	162	0.6234568
C4	2956874	2958480	BolC4t21967H	0	+	739	1514	1606	0.9427148
C4	2983453	2997134	BolC4t21968H	0	-	3136	5028	13681	0.3675170
C4	3001761	3002745	BolC4t21969H	0	-	648	920	984	0.9349594
C4	3004537	3006080	BolC4t21970H	0	-	168	999	1543	0.6474401
C4	3077060	3077555	BolC4t21971H	0	-	3	94	495	0.1898990
C4	3083221	3083641	BolC4t21972H	0	+	201	403	420	0.9595238
C4	3088610	3090554	BolC4t21973H	0	+	222	1487	1944	0.7649177
C4	3097301	3097751	BolC4t21974H	0	+	178	450	450	1.0000000
C4	3098455	3101626	BolC4t21975H	0	-	2061	2933	3171	0.9249448
C4	3102176	3102935	BolC4t21976H	0	-	361	757	759	0.9973649
C4	3104801	3105040	BolC4t21977H	0	+	141	239	239	1.0000000
C4	3109844	3111309	BolC4t21978H	0	+	310	1440	1465	0.9829351
C4	3112393	3115210	BolC4t21979H	0	+	2518	2817	2817	1.0000000
C4	3115659	3116007	BolC4t21980H	0	+	170	348	348	1.0000000
C4	3117961	3121459	BolC4t21981H	0	+	3049	3333	3498	0.9528302
C4	3121680	3122674	BolC4t21982H	0	-	1000	994	994	1.0000000
C4	3123326	3123820	BolC4t21983H	0	+	156	494	494	1.0000000
C4	3125427	3125589	BolC4t21984H	0	-	128	162	162	1.0000000
C4	3128924	3129572	BolC4t21985H	0	+	73	592	648	0.9135802
C4	3131469	3132308	BolC4t21986H	0	+	542	839	839	1.0000000
C4	3132753	3133152	BolC4t21987H	0	+	322	399	399	1.0000000
C4	3144660	3145377	BolC4t21988H	0	+	148	717	717	1.0000000
C4	3145556	3146432	BolC4t21989H	0	-	448	876	876	1.0000000
C4	3148425	3149888	BolC4t21990H	0	-	330	1013	1463	0.6924129
C4	3151700	3152681	BolC4t21991H	0	-	265	863	981	0.8797145
C4	3153137	3154904	BolC4t21992H	0	-	581	1659	1767	0.9388794
C4	3157390	3158014	BolC4t21993H	0	+	106	521	624	0.8349359
C4	3162629	3163707	BolC4t21994H	0	+	294	1057	1078	0.9805195
C4	3166224	3168806	BolC4t21995H	0	-	1605	2547	2582	0.9864446
C4	3171831	3173557	BolC4t21996H	0	-	673	1685	1726	0.9762456
C4	3174511	3176623	BolC4t21997H	0	-	833	1451	2112	0.6870265
C4	3177669	3178548	BolC4t21998H	0	-	258	879	879	1.0000000
C4	3186492	3187587	BolC4t21999H	0	-	542	1095	1095	1.0000000
C4	3189953	3196057	BolC4t22000H	0	-	1948	4884	6104	0.8001311
C4	3199894	3200368	BolC4t22001H	0	-	291	474	474	1.0000000
C4	3208526	3208838	BolC4t22002H	0	+	31	234	312	0.7500000
C4	3267735	3267978	BolC4t22003H	0	-	35	243	243	1.0000000
C4	3268464	3271423	BolC4t22004H	0	-	1230	2801	2959	0.9466036
C4	3271874	3274486	BolC4t22005H	0	+	1908	2612	2612	1.0000000
C4	3275141	3276011	BolC4t22006H	0	+	356	870	870	1.0000000
C4	3276447	3280419	BolC4t22007H	0	-	1106	3556	3972	0.8952669
C4	3300528	3303382	BolC4t22008H	0	+	702	2398	2854	0.8402243
C4	3306291	3307777	BolC4t22009H	0	+	436	1469	1486	0.9885599
C4	3308028	3312776	BolC4t22010H	0	-	1526	4552	4748	0.9587194
C4	3347311	3347467	BolC4t22011H	0	+	0	0	156	0.0000000
C4	3349862	3350399	BolC4t22012H	0	+	2	62	537	0.1154562
C4	3352067	3352256	BolC4t22013H	0	-	208	189	189	1.0000000
C4	3353908	3355096	BolC4t22014H	0	+	55	771	1188	0.6489899
C4	3359573	3360560	BolC4t22015H	0	-	88	887	987	0.8986829
C4	3362715	3363072	BolC4t22016H	0	+	200	357	357	1.0000000
C4	3365914	3366265	BolC4t22017H	0	+	67	146	351	0.4159544
C4	3373844	3374768	BolC4t22018H	0	+	31	637	924	0.6893939
C4	3375224	3378189	BolC4t22019H	0	-	899	2099	2965	0.7079258
C4	3391348	3392728	BolC4t22020H	0	+	573	1202	1380	0.8710145
C4	3395076	3398249	BolC4t22021H	0	-	591	2501	3173	0.7882131
C4	3400733	3401568	BolC4t22022H	0	+	3	199	835	0.2383234
C4	3404669	3407466	BolC4t22023H	0	+	806	2682	2797	0.9588845
C4	3410493	3411858	BolC4t22024H	0	+	365	1365	1365	1.0000000
C4	3416455	3419265	BolC4t22025H	0	+	574	2191	2810	0.7797153
C4	3419738	3421387	BolC4t22026H	0	-	617	1522	1649	0.9229836
C4	3422166	3424561	BolC4t22027H	0	-	1493	2361	2395	0.9858038
C4	3426403	3430784	BolC4t22028H	0	-	2395	4357	4381	0.9945218
C4	3432169	3433985	BolC4t22029H	0	+	345	1465	1816	0.8067181
C4	3434265	3435277	BolC4t22030H	0	-	729	884	1012	0.8735178
C4	3436202	3437901	BolC4t22031H	0	+	341	1441	1699	0.8481460
C4	3438307	3444977	BolC4t22032H	0	-	734	2045	6670	0.3065967
C4	3456778	3457018	BolC4t22033H	0	-	103	240	240	1.0000000
C4	3458635	3463034	BolC4t22034H	0	-	1708	4288	4399	0.9747670
C4	3472528	3476585	BolC4t22035H	0	+	451	2410	4057	0.5940350
C4	3476920	3477691	BolC4t22036H	0	+	80	550	771	0.7133593
C4	3478795	3480158	BolC4t22037H	0	+	0	0	1363	0.0000000
C4	3498071	3499030	BolC4t22038H	0	+	67	475	959	0.4953076
C4	3499502	3500007	BolC4t22039H	0	+	0	0	505	0.0000000
C4	3502461	3502632	BolC4t22040H	0	+	32	136	171	0.7953216
C4	3504199	3505944	BolC4t22041H	0	+	110	970	1745	0.5558739
C4	3597713	3599360	BolC4t22042H	0	+	505	1493	1647	0.9064966
C4	3599609	3600392	BolC4t22043H	0	-	329	763	783	0.9744572
C4	3601322	3603313	BolC4t22044H	0	-	749	1446	1991	0.7262682
C4	3606128	3607691	BolC4t22045H	0	-	355	1153	1563	0.7376840
C4	3610605	3611750	BolC4t22046H	0	+	689	1063	1145	0.9283843
C4	3612241	3614329	BolC4t22047H	0	-	971	1919	2088	0.9190613
C4	3623912	3626711	BolC4t22048H	0	+	1315	2747	2799	0.9814219
C4	3627265	3630133	BolC4t22049H	0	-	1074	2606	2868	0.9086471
C4	3639131	3641153	BolC4t22050H	0	+	585	1917	2022	0.9480712
C4	3648089	3648563	BolC4t22051H	0	+	44	306	474	0.6455696
C4	3650146	3652951	BolC4t22052H	0	-	1615	2805	2805	1.0000000
C4	3653688	3656305	BolC4t22053H	0	+	1396	2570	2617	0.9820405
C4	3656747	3657515	BolC4t22054H	0	+	335	768	768	1.0000000
C4	3658478	3659255	BolC4t22055H	0	+	295	777	777	1.0000000
C4	3686107	3687624	BolC4t22056H	0	+	0	0	1517	0.0000000
C4	3770876	3773125	BolC4t22057H	0	+	1543	2249	2249	1.0000000
C4	3777066	3778677	BolC4t22058H	0	+	594	1587	1611	0.9851024
C4	3779833	3780756	BolC4t22059H	0	-	144	867	923	0.9393283
C4	3781991	3785698	BolC4t22060H	0	-	801	3106	3707	0.8378743
C4	3804763	3808418	BolC4t22061H	0	+	4584	2861	3655	0.7827634
C4	3810722	3815174	BolC4t22062H	0	+	972	3853	4452	0.8654537
C4	3816256	3817709	BolC4t22063H	0	+	549	1448	1453	0.9965588
C4	3818754	3820398	BolC4t22064H	0	+	853	1465	1644	0.8911192
C4	3821794	3822986	BolC4t22065H	0	+	276	961	1192	0.8062081
C4	3823981	3827700	BolC4t22066H	0	+	630	3011	3719	0.8096262
C4	3831188	3831497	BolC4t22067H	0	-	277	309	309	1.0000000
C4	3833742	3834321	BolC4t22068H	0	-	17	203	579	0.3506045
C4	3835398	3836785	BolC4t22069H	0	+	114	719	1387	0.5183850
C4	3843727	3844045	BolC4t22070H	0	+	91	318	318	1.0000000
C4	3844374	3844695	BolC4t22071H	0	-	25	311	321	0.9688473
C4	3847655	3849032	BolC4t22072H	0	+	496	1046	1377	0.7596224
C4	3851404	3853331	BolC4t22073H	0	+	262	1499	1927	0.7778931
C4	3858323	3858955	BolC4t22074H	0	+	303	600	632	0.9493671
C4	3859946	3861849	BolC4t22075H	0	-	577	1903	1903	1.0000000
C4	3865605	3867007	BolC4t22076H	0	+	811	1402	1402	1.0000000
C4	3870350	3873652	BolC4t22077H	0	+	1983	3302	3302	1.0000000
C4	3874315	3877971	BolC4t22078H	0	+	1463	3555	3656	0.9723742
C4	3879563	3890740	BolC4t22079H	0	-	4994	10839	11177	0.9697593
C4	3902010	3904921	BolC4t22080H	0	-	3430	2911	2911	1.0000000
C4	3905357	3906453	BolC4t22081H	0	-	1105	1096	1096	1.0000000
C4	3911491	3912996	BolC4t22082H	0	-	474	1418	1505	0.9421927
C4	3920343	3923281	BolC4t22083H	0	-	2293	2938	2938	1.0000000
C4	3926393	3929191	BolC4t22084H	0	+	1693	2796	2798	0.9992852
C4	3929787	3929952	BolC4t22085H	0	+	18	117	165	0.7090909
C4	3974420	3975031	BolC4t22086H	0	-	207	611	611	1.0000000
C4	3977830	3979077	BolC4t22087H	0	+	1042	1247	1247	1.0000000
C4	4006248	4006671	BolC4t22088H	0	-	302	423	423	1.0000000
C4	4006898	4007316	BolC4t22089H	0	+	22	403	418	0.9641148
C4	4008710	4009190	BolC4t22090H	0	+	51	187	480	0.3895833
C4	4011302	4012624	BolC4t22091H	0	-	767	1322	1322	1.0000000
C4	4017821	4018940	BolC4t22092H	0	-	262	958	1119	0.8561215
C4	4020701	4021139	BolC4t22093H	0	+	231	438	438	1.0000000
C4	4021377	4023514	BolC4t22094H	0	-	1090	2080	2137	0.9733271
C4	4026388	4028704	BolC4t22095H	0	+	955	2277	2316	0.9831606
C4	4029129	4029597	BolC4t22096H	0	+	36	468	468	1.0000000
C4	4031926	4033703	BolC4t22097H	0	+	1255	1777	1777	1.0000000
C4	4072906	4073569	BolC4t22098H	0	+	197	663	663	1.0000000
C4	4078630	4080863	BolC4t22099H	0	+	1658	2196	2233	0.9834304
C4	4083302	4083920	BolC4t22100H	0	-	1235	584	618	0.9449838
C4	4084981	4087256	BolC4t22101H	0	-	740	2073	2275	0.9112088
C4	4088111	4088657	BolC4t22102H	0	+	454	546	546	1.0000000
C4	4088777	4091048	BolC4t22103H	0	-	1235	2253	2271	0.9920740
C4	4093113	4094987	BolC4t22104H	0	+	675	1872	1874	0.9989328
C4	4095290	4096708	BolC4t22105H	0	-	508	1292	1418	0.9111425
C4	4106751	4109564	BolC4t22106H	0	+	964	2778	2813	0.9875578
C4	4111907	4113522	BolC4t22107H	0	+	688	1538	1615	0.9523220
C4	4115184	4116677	BolC4t22108H	0	+	190	1281	1493	0.8580040
C4	4123119	4124578	BolC4t22109H	0	+	143	915	1459	0.6271419
C4	4125481	4128921	BolC4t22110H	0	+	1901	3440	3440	1.0000000
C4	4136210	4136769	BolC4t22111H	0	-	197	540	559	0.9660107
C4	4139629	4141102	BolC4t22112H	0	+	400	1358	1473	0.9219280
C4	4144331	4145853	BolC4t22113H	0	+	133	800	1522	0.5256242
C4	4147064	4148273	BolC4t22114H	0	-	640	1209	1209	1.0000000
C4	4148622	4148856	BolC4t22115H	0	-	135	234	234	1.0000000
C4	4154641	4157261	BolC4t22116H	0	-	1490	2620	2620	1.0000000
C4	4158938	4160281	BolC4t22117H	0	-	1735	1343	1343	1.0000000
C4	4161359	4162899	BolC4t22118H	0	-	651	1495	1540	0.9707792
C4	4164151	4166574	BolC4t22119H	0	-	847	2402	2423	0.9913331
C4	4166946	4169673	BolC4t22120H	0	-	1620	2618	2727	0.9600294
C4	4169989	4171501	BolC4t22121H	0	+	975	1512	1512	1.0000000
C4	4172634	4173231	BolC4t22122H	0	+	316	597	597	1.0000000
C4	4174897	4175200	BolC4t22123H	0	+	126	265	303	0.8745875
C4	4175652	4175796	BolC4t22124H	0	+	400	144	144	1.0000000
C4	4176331	4177828	BolC4t22125H	0	-	430	1345	1497	0.8984636
C4	4185309	4186918	BolC4t22126H	0	+	1220	1530	1609	0.9509012
C4	4197742	4198072	BolC4t22127H	0	+	24	179	330	0.5424243
C4	4199293	4201397	BolC4t22128H	0	-	715	2074	2104	0.9857414
C4	4202609	4203144	BolC4t22129H	0	-	258	535	535	1.0000000
C4	4210347	4211823	BolC4t22130H	0	-	299	1055	1476	0.7147697
C4	4215558	4218281	BolC4t22131H	0	+	1234	2723	2723	1.0000000
C4	4219164	4220223	BolC4t22132H	0	-	410	1059	1059	1.0000000
C4	4223788	4224152	BolC4t22133H	0	-	112	364	364	1.0000000
C4	4243644	4244482	BolC4t22134H	0	-	257	838	838	1.0000000
C4	4251654	4252935	BolC4t22135H	0	+	751	1281	1281	1.0000000
C4	4253102	4254622	BolC4t22136H	0	-	495	1397	1520	0.9190789
C4	4258632	4260633	BolC4t22137H	0	+	764	1970	2001	0.9845077
C4	4261467	4264024	BolC4t22138H	0	+	773	2557	2557	1.0000000
C4	4264620	4266537	BolC4t22139H	0	+	593	1917	1917	1.0000000
C4	4267939	4268475	BolC4t22140H	0	+	16	270	536	0.5037314
C4	4278370	4280200	BolC4t22141H	0	+	618	1796	1830	0.9814208
C4	4282912	4285047	BolC4t22142H	0	+	136	1130	2135	0.5292740
C4	4302737	4308317	BolC4t22143H	0	+	2257	5580	5580	1.0000000
C4	4318919	4319867	BolC4t22144H	0	+	17	91	948	0.0959916
C4	4323011	4325163	BolC4t22145H	0	+	406	1441	2152	0.6696097
C4	4357624	4358818	BolC4t22146H	0	-	128	920	1194	0.7705193
C4	4358925	4362331	BolC4t22147H	0	-	1668	3019	3406	0.8863770
C4	4362766	4365426	BolC4t22148H	0	+	259	977	2660	0.3672932
C4	4365779	4366200	BolC4t22149H	0	+	0	0	421	0.0000000
C4	4368598	4375134	BolC4t22150H	0	+	557	3260	6536	0.4987760
C4	4392123	4393438	BolC4t22151H	0	+	208	718	1315	0.5460076
C4	4399601	4399893	BolC4t22152H	0	+	0	0	292	0.0000000
C4	4403291	4403825	BolC4t22153H	0	-	123	520	534	0.9737828
C4	4405986	4406112	BolC4t22154H	0	+	153	126	126	1.0000000
C4	4421132	4423368	BolC4t22155H	0	+	80	1078	2236	0.4821109
C4	4442203	4444269	BolC4t22156H	0	+	284	1597	2066	0.7729913
C4	4445390	4446027	BolC4t22157H	0	+	665	637	637	1.0000000
C4	4448150	4450330	BolC4t22158H	0	-	1420	2180	2180	1.0000000
C4	4451100	4453615	BolC4t22159H	0	-	687	2231	2515	0.8870775
C4	4454978	4456140	BolC4t22160H	0	-	597	1095	1162	0.9423408
C4	4458241	4458825	BolC4t22161H	0	+	0	0	584	0.0000000
C4	4468328	4468871	BolC4t22162H	0	+	45	202	543	0.3720074
C4	4471081	4471762	BolC4t22163H	0	+	191	576	681	0.8458150
C4	4472399	4473483	BolC4t22164H	0	+	7	144	1084	0.1328413
C4	4492361	4493226	BolC4t22165H	0	-	646	865	865	1.0000000
C4	4497242	4497800	BolC4t22166H	0	+	252	558	558	1.0000000
C4	4501044	4501710	BolC4t22167H	0	-	12	298	666	0.4474474
C4	4502581	4511650	BolC4t22168H	0	-	2502	8877	9069	0.9788290
C4	4515898	4517116	BolC4t22169H	0	+	210	1173	1218	0.9630542
C4	4517549	4519290	BolC4t22170H	0	+	1887	1741	1741	1.0000000
C4	4521068	4523273	BolC4t22171H	0	+	617	2080	2205	0.9433107
C4	4523824	4525656	BolC4t22172H	0	-	443	1796	1832	0.9803494
C4	4558513	4562243	BolC4t22173H	0	+	525	2512	3730	0.6734585
C4	4564527	4584238	BolC4t22174H	0	+	4700	15360	19711	0.7792603
C4	4590755	4600822	BolC4t22175H	0	+	4242	7963	10067	0.7910003
C4	4605103	4605619	BolC4t22176H	0	+	101	474	516	0.9186047
C4	4605798	4679254	BolC4t22177H	0	+	32737	70196	73456	0.9556197
C4	4685858	4688880	BolC4t22178H	0	+	786	2300	3022	0.7610854
C4	4696779	4696965	BolC4t22179H	0	+	39	186	186	1.0000000
C4	4704915	4706865	BolC4t22180H	0	+	706	1910	1950	0.9794872
C4	4731680	4733866	BolC4t22181H	0	+	1541	2186	2186	1.0000000
C4	4734720	4735863	BolC4t22182H	0	+	619	1143	1143	1.0000000
C4	4736531	4742007	BolC4t22183H	0	-	1259	4580	5476	0.8363769
C4	4748479	4748917	BolC4t22184H	0	-	225	438	438	1.0000000
C4	4750096	4751731	BolC4t22185H	0	-	738	1635	1635	1.0000000
C4	4754200	4755040	BolC4t22186H	0	+	213	783	840	0.9321429
C4	4757991	4760356	BolC4t22187H	0	-	931	2309	2365	0.9763213
C4	4760814	4761393	BolC4t22188H	0	+	235	579	579	1.0000000
C4	4767129	4769553	BolC4t22189H	0	+	1015	2404	2424	0.9917492
C4	4769746	4770695	BolC4t22190H	0	-	223	895	949	0.9430980
C4	4783751	4785437	BolC4t22191H	0	+	753	1683	1686	0.9982206
C4	4785781	4787551	BolC4t22192H	0	-	612	1631	1770	0.9214689
C4	4788997	4789357	BolC4t22193H	0	+	228	360	360	1.0000000
C4	4796340	4796715	BolC4t22194H	0	+	140	375	375	1.0000000
C4	4797792	4799488	BolC4t22195H	0	-	533	1689	1696	0.9958726
C4	4801012	4802248	BolC4t22196H	0	+	293	1236	1236	1.0000000
C4	4802940	4806553	BolC4t22197H	0	+	1076	3103	3613	0.8588431
C4	4807727	4808207	BolC4t22198H	0	-	1	70	480	0.1458333
C4	4809960	4810899	BolC4t22199H	0	-	125	803	939	0.8551651
C4	4811780	4812419	BolC4t22200H	0	+	626	639	639	1.0000000
C4	4816667	4817447	BolC4t22201H	0	+	831	780	780	1.0000000
C4	4818264	4819889	BolC4t22202H	0	+	381	1369	1625	0.8424615
C4	4820477	4821722	BolC4t22203H	0	-	619	1245	1245	1.0000000
C4	4843048	4844547	BolC4t22204H	0	-	227	1271	1499	0.8478986
C4	4846886	4848735	BolC4t22205H	0	-	1359	1849	1849	1.0000000
C4	4850276	4851296	BolC4t22206H	0	-	338	1020	1020	1.0000000
C4	4854930	4861183	BolC4t22207H	0	+	1405	5507	6253	0.8806973
C4	4865873	4866896	BolC4t22208H	0	-	42	595	1023	0.5816227
C4	4875788	4876031	BolC4t22209H	0	+	19	223	243	0.9176955
C4	4885041	4886382	BolC4t22210H	0	+	237	1085	1341	0.8090977
C4	4911513	4912379	BolC4t22211H	0	+	918	866	866	1.0000000
C4	4923650	4926316	BolC4t22212H	0	+	514	2461	2666	0.9231058
C4	4929529	4930237	BolC4t22213H	0	+	67	544	708	0.7683616
C4	4931947	4932259	BolC4t22214H	0	+	628	312	312	1.0000000
C4	4932599	4934232	BolC4t22215H	0	-	457	1601	1633	0.9804041
C4	4966481	4966955	BolC4t22216H	0	+	252	474	474	1.0000000
C4	4968087	4969673	BolC4t22217H	0	+	1394	1586	1586	1.0000000
C4	4970464	4971287	BolC4t22218H	0	+	104	557	823	0.6767922
C4	4977878	4979246	BolC4t22219H	0	-	110	888	1368	0.6491228
C4	4979717	4981289	BolC4t22220H	0	-	1436	1572	1572	1.0000000
C4	5003845	5004052	BolC4t22221H	0	+	430	207	207	1.0000000
C4	5010109	5010961	BolC4t22222H	0	+	55	503	852	0.5903756
C4	5026368	5030694	BolC4t22223H	0	-	2427	4292	4326	0.9921405
C4	5031418	5033924	BolC4t22224H	0	-	1342	2385	2506	0.9517159
C4	5034264	5038416	BolC4t22225H	0	-	1591	3912	4152	0.9421965
C4	5038755	5041841	BolC4t22226H	0	+	1089	3000	3086	0.9721322
C4	5042301	5043719	BolC4t22227H	0	+	1003	1418	1418	1.0000000
C4	5046145	5051059	BolC4t22228H	0	+	758	3363	4914	0.6843712
C4	5052679	5053699	BolC4t22229H	0	+	465	1020	1020	1.0000000
C4	5062137	5062392	BolC4t22230H	0	-	165	255	255	1.0000000
C4	5067130	5067898	BolC4t22231H	0	+	7	245	768	0.3190104
C4	5072110	5073201	BolC4t22232H	0	+	60	861	1091	0.7891842
C4	5074165	5074499	BolC4t22233H	0	+	0	0	334	0.0000000
C4	5074829	5075308	BolC4t22234H	0	+	0	0	479	0.0000000
C4	5088635	5092011	BolC4t22235H	0	+	1570	2693	3376	0.7976896
C4	5093240	5096629	BolC4t22236H	0	-	1290	3368	3389	0.9938035
C4	5104812	5107017	BolC4t22237H	0	-	131	1050	2205	0.4761905
C4	5122198	5122957	BolC4t22238H	0	+	18	305	759	0.4018445
C4	5126572	5133808	BolC4t22239H	0	+	960	2537	7236	0.3506081
C4	5136478	5138179	BolC4t22240H	0	+	46	406	1701	0.2386831
C4	5138365	5138569	BolC4t22241H	0	-	310	204	204	1.0000000
C4	5139192	5140479	BolC4t22242H	0	-	321	1200	1287	0.9324009
C4	5141055	5143644	BolC4t22243H	0	+	1293	2489	2589	0.9613751
C4	5145420	5146928	BolC4t22244H	0	+	815	1508	1508	1.0000000
C4	5148051	5148728	BolC4t22245H	0	+	541	676	677	0.9985229
C4	5148799	5156349	BolC4t22246H	0	+	2652	6661	7550	0.8822517
C4	5151013	5153818	BolC4t22247H	0	+	641	2373	2805	0.8459893
C4	5163373	5169025	BolC4t22248H	0	+	1950	5508	5652	0.9745223
C4	5165212	5166308	BolC4t22249H	0	-	124	1016	1096	0.9270073
C4	5172280	5173187	BolC4t22250H	0	-	448	844	907	0.9305403
C4	5178199	5178871	BolC4t22251H	0	-	33	464	672	0.6904762
C4	5179590	5180877	BolC4t22252H	0	+	147	1113	1287	0.8648019
C4	5183350	5185974	BolC4t22253H	0	+	608	2113	2624	0.8052592
C4	5186170	5187997	BolC4t22254H	0	-	821	1728	1827	0.9458128
C4	5190919	5191727	BolC4t22255H	0	+	235	808	808	1.0000000
C4	5191913	5193125	BolC4t22256H	0	-	736	1212	1212	1.0000000
C4	5193772	5195208	BolC4t22257H	0	-	629	1370	1436	0.9540390
C4	5195745	5198184	BolC4t22258H	0	-	457	2045	2439	0.8384584
C4	5202225	5202528	BolC4t22259H	0	+	1	108	303	0.3564357
C4	5209886	5212151	BolC4t22260H	0	-	785	2021	2265	0.8922737
C4	5213146	5213804	BolC4t22261H	0	-	480	658	658	1.0000000
C4	5219644	5221367	BolC4t22262H	0	+	599	1687	1723	0.9791062
C4	5240978	5241905	BolC4t22263H	0	+	20	167	927	0.1801510
C4	5244329	5245608	BolC4t22264H	0	+	631	1161	1279	0.9077404
C4	5246294	5246765	BolC4t22265H	0	-	107	374	471	0.7940552
C4	5249550	5253885	BolC4t22266H	0	-	1322	4008	4335	0.9245675
C4	5255520	5256771	BolC4t22267H	0	-	88	893	1251	0.7138289
C4	5258351	5259781	BolC4t22268H	0	-	597	1410	1430	0.9860140
C4	5269294	5271798	BolC4t22269H	0	-	1891	2504	2504	1.0000000
C4	5273040	5274884	BolC4t22270H	0	+	590	1799	1844	0.9755965
C4	5275237	5276207	BolC4t22271H	0	-	337	846	970	0.8721650
C4	5277302	5291126	BolC4t22272H	0	-	3018	10573	13824	0.7648293
C4	5292746	5295671	BolC4t22273H	0	-	1255	2730	2925	0.9333333
C4	5304061	5304517	BolC4t22274H	0	-	381	456	456	1.0000000
C4	5304586	5306148	BolC4t22275H	0	-	431	1431	1562	0.9161332
C4	5306451	5306913	BolC4t22276H	0	+	7	284	462	0.6147186
C4	5313682	5314459	BolC4t22277H	0	+	63	162	777	0.2084942
C4	5321445	5322429	BolC4t22278H	0	+	37	402	984	0.4085366
C4	5323409	5324384	BolC4t22279H	0	+	108	713	975	0.7312821
C4	5325177	5326488	BolC4t22280H	0	-	1182	1311	1311	1.0000000
C4	5342137	5344593	BolC4t22281H	0	-	916	2275	2456	0.9263029
C4	5364812	5365811	BolC4t22282H	0	-	335	872	999	0.8728729
C4	5367971	5370123	BolC4t22283H	0	-	469	2014	2152	0.9358736
C4	5370316	5371100	BolC4t22284H	0	+	749	784	784	1.0000000
C4	5374515	5376132	BolC4t22285H	0	+	773	1511	1617	0.9344465
C4	5382869	5383218	BolC4t22286H	0	-	245	349	349	1.0000000
C4	5383765	5384994	BolC4t22287H	0	+	780	1229	1229	1.0000000
C4	5385872	5388695	BolC4t22288H	0	+	1021	2634	2823	0.9330499
C4	5390617	5394307	BolC4t22289H	0	+	926	3506	3690	0.9501355
C4	5400514	5402048	BolC4t22290H	0	+	1754	1534	1534	1.0000000
C4	5406511	5407117	BolC4t22291H	0	-	368	606	606	1.0000000
C4	5416653	5418859	BolC4t22292H	0	+	1360	2206	2206	1.0000000
C4	5419606	5421473	BolC4t22293H	0	+	1236	1784	1867	0.9555436
C4	5421813	5422565	BolC4t22294H	0	-	418	752	752	1.0000000
C4	5425871	5427609	BolC4t22295H	0	-	1155	1678	1738	0.9654776
C4	5431846	5433788	BolC4t22296H	0	+	780	1627	1942	0.8377961
C4	5439216	5440572	BolC4t22297H	0	+	677	1155	1356	0.8517699
C4	5439851	5440191	BolC4t22298H	0	+	183	340	340	1.0000000
C4	5440711	5441055	BolC4t22299H	0	+	169	211	344	0.6133721
C4	5445835	5446287	BolC4t22300H	0	-	434	452	452	1.0000000
C4	5446838	5450147	BolC4t22301H	0	-	845	2966	3309	0.8963433
C4	5451683	5454094	BolC4t22302H	0	+	971	2014	2411	0.8353381
C4	5454546	5457062	BolC4t22303H	0	-	678	2292	2516	0.9109698
C4	5462187	5465907	BolC4t22304H	0	+	2210	3720	3720	1.0000000
C4	5466776	5468079	BolC4t22305H	0	+	1101	1303	1303	1.0000000
C4	5468722	5470854	BolC4t22306H	0	-	1944	2132	2132	1.0000000
C4	5474294	5475697	BolC4t22307H	0	+	491	1388	1403	0.9893086
C4	5476437	5478063	BolC4t22308H	0	-	455	1604	1626	0.9864699
C4	5481204	5481624	BolC4t22309H	0	-	479	420	420	1.0000000
C4	5489092	5489443	BolC4t22310H	0	-	68	287	351	0.8176638
C4	5498733	5499587	BolC4t22311H	0	-	852	854	854	1.0000000
C4	5500277	5501817	BolC4t22312H	0	+	2136	1540	1540	1.0000000
C4	5501926	5502808	BolC4t22313H	0	-	689	882	882	1.0000000
C4	5504489	5506240	BolC4t22314H	0	-	980	1669	1751	0.9531696
C4	5514835	5516506	BolC4t22315H	0	+	1278	1671	1671	1.0000000
C4	5516831	5520250	BolC4t22316H	0	-	4063	3386	3419	0.9903480
C4	5521223	5522802	BolC4t22317H	0	-	1918	1579	1579	1.0000000
C4	5523496	5524546	BolC4t22318H	0	-	855	1050	1050	1.0000000
C4	5525477	5529384	BolC4t22319H	0	+	4389	3907	3907	1.0000000
C4	5529977	5531464	BolC4t22320H	0	-	1227	1483	1487	0.9973100
C4	5534341	5536341	BolC4t22321H	0	-	1025	1953	2000	0.9765000
C4	5546839	5547855	BolC4t22322H	0	-	66	723	1016	0.7116142
C4	5551739	5552369	BolC4t22323H	0	+	239	588	630	0.9333333
C4	5562824	5565215	BolC4t22324H	0	+	721	1832	2391	0.7662066
C4	5568379	5569248	BolC4t22325H	0	+	785	869	869	1.0000000
C4	5570664	5571189	BolC4t22326H	0	+	451	525	525	1.0000000
C4	5573056	5573401	BolC4t22327H	0	+	157	345	345	1.0000000
C4	5579082	5579721	BolC4t22328H	0	+	142	602	639	0.9420970
C4	5587612	5587741	BolC4t22329H	0	-	187	129	129	1.0000000
C4	5590372	5592114	BolC4t22330H	0	-	800	1742	1742	1.0000000
C4	5593618	5595118	BolC4t22331H	0	-	1495	1500	1500	1.0000000
C4	5596057	5598160	BolC4t22332H	0	-	1252	2062	2103	0.9805040
C4	5600014	5602009	BolC4t22333H	0	+	1159	1540	1995	0.7719298
C4	5605265	5605682	BolC4t22334H	0	+	315	417	417	1.0000000
C4	5606147	5606888	BolC4t22335H	0	+	309	741	741	1.0000000
C4	5611728	5613363	BolC4t22336H	0	+	440	1238	1635	0.7571865
C4	5614096	5614950	BolC4t22337H	0	+	371	854	854	1.0000000
C4	5619796	5625495	BolC4t22338H	0	-	3385	5683	5699	0.9971925
C4	5639782	5640397	BolC4t22339H	0	+	8	403	615	0.6552845
C4	5646668	5647961	BolC4t22340H	0	+	464	1292	1293	0.9992266
C4	5668482	5669388	BolC4t22341H	0	+	744	898	906	0.9911700
C4	5669629	5670731	BolC4t22342H	0	+	999	1091	1102	0.9900181
C4	5671625	5674044	BolC4t22343H	0	-	2558	2419	2419	1.0000000
C4	5676521	5678494	BolC4t22344H	0	-	1479	1878	1973	0.9518500
C4	5679542	5681374	BolC4t22345H	0	-	728	1831	1832	0.9994541
C4	5681990	5684433	BolC4t22346H	0	+	4108	2443	2443	1.0000000
C4	5696197	5696567	BolC4t22347H	0	+	211	370	370	1.0000000
C4	5699549	5701178	BolC4t22348H	0	-	798	1587	1629	0.9742173
C4	5706071	5709712	BolC4t22349H	0	-	1345	3501	3641	0.9615490
C4	5740967	5743256	BolC4t22350H	0	+	879	1214	2289	0.5303626
C4	5744982	5745639	BolC4t22351H	0	-	17	327	657	0.4977169
C4	5750703	5770570	BolC4t22352H	0	+	4968	13747	19867	0.6919515
C4	5751959	5765739	BolC4t22353H	0	-	3527	10753	13780	0.7803338
C4	5770982	5773719	BolC4t22354H	0	-	362	2214	2737	0.8089149
C4	5774915	5775509	BolC4t22355H	0	-	14	217	594	0.3653199
C4	5776097	5778054	BolC4t22356H	0	-	903	1957	1957	1.0000000
C4	5780246	5808790	BolC4t22357H	0	+	9424	21459	28544	0.7517867
C4	5796132	5796474	BolC4t22358H	0	+	51	342	342	1.0000000
C4	5800735	5805632	BolC4t22359H	0	+	466	3374	4897	0.6889933
C4	5810472	5810814	BolC4t22360H	0	+	86	252	342	0.7368421
C4	5811913	5812521	BolC4t22361H	0	-	0	0	608	0.0000000
C4	5818303	5820825	BolC4t22362H	0	+	1279	2436	2522	0.9659001
C4	5821141	5849399	BolC4t22363H	0	-	14681	28073	28258	0.9934532
C4	5822589	5823510	BolC4t22364H	0	-	660	921	921	1.0000000
C4	5841850	5842444	BolC4t22365H	0	+	230	594	594	1.0000000
C4	5862819	5864082	BolC4t22366H	0	+	541	1151	1263	0.9113222
C4	5865857	5866064	BolC4t22367H	0	-	51	207	207	1.0000000
C4	5868881	5870395	BolC4t22368H	0	+	1164	1514	1514	1.0000000
C4	5902677	5904120	BolC4t22369H	0	+	384	1339	1443	0.9279279
C4	5913706	5915745	BolC4t22370H	0	+	1382	2039	2039	1.0000000
C4	5929608	5931126	BolC4t22371H	0	+	1197	1518	1518	1.0000000
C4	5932308	5935769	BolC4t22372H	0	+	3140	3461	3461	1.0000000
C4	5937432	5940369	BolC4t22373H	0	+	1123	2769	2937	0.9427988
C4	5942170	5947695	BolC4t22374H	0	-	4268	5478	5525	0.9914932
C4	5949878	5950928	BolC4t22375H	0	+	280	849	1050	0.8085715
C4	5951487	5952380	BolC4t22376H	0	-	320	893	893	1.0000000
C4	5955131	5957650	BolC4t22377H	0	-	844	2198	2519	0.8725685
C4	5958611	5961610	BolC4t22378H	0	-	1280	2796	2999	0.9323108
C4	5988238	5989958	BolC4t22379H	0	+	817	1633	1720	0.9494186
C4	5995934	5996988	BolC4t22380H	0	-	775	1054	1054	1.0000000
C4	6001611	6002552	BolC4t22381H	0	-	11	277	941	0.2943677
C4	6010313	6011893	BolC4t22382H	0	-	340	1495	1580	0.9462025
C4	6014402	6015053	BolC4t22383H	0	+	26	104	651	0.1597542
C4	6018364	6022302	BolC4t22384H	0	+	2494	3819	3938	0.9697816
C4	6023514	6024788	BolC4t22385H	0	-	827	958	1274	0.7519623
C4	6025995	6027284	BolC4t22386H	0	-	907	1222	1289	0.9480217
C4	6040385	6043939	BolC4t22387H	0	+	1142	3473	3554	0.9772088
C4	6044868	6046435	BolC4t22388H	0	-	1033	1567	1567	1.0000000
C4	6054316	6055969	BolC4t22389H	0	-	1470	1600	1653	0.9679371
C4	6060967	6061546	BolC4t22390H	0	-	103	579	579	1.0000000
C4	6061600	6061946	BolC4t22391H	0	-	9	100	346	0.2890173
C4	6062030	6062483	BolC4t22392H	0	-	3	124	453	0.2737307
C4	6065540	6066443	BolC4t22393H	0	+	735	903	903	1.0000000
C4	6069817	6070666	BolC4t22394H	0	+	955	849	849	1.0000000
C4	6071622	6072396	BolC4t22395H	0	+	411	681	774	0.8798450
C4	6074735	6078022	BolC4t22396H	0	+	1871	3076	3287	0.9358077
C4	6079401	6081837	BolC4t22397H	0	+	789	2278	2436	0.9351396
C4	6083728	6084733	BolC4t22398H	0	+	386	984	1005	0.9791045
C4	6088911	6090240	BolC4t22399H	0	+	176	912	1329	0.6862302
C4	6092188	6092523	BolC4t22400H	0	+	3	194	335	0.5791045
C4	6094900	6095304	BolC4t22401H	0	-	0	0	404	0.0000000
C4	6105374	6105665	BolC4t22402H	0	-	19	85	291	0.2920962
C4	6107764	6108288	BolC4t22403H	0	-	300	524	524	1.0000000
C4	6123442	6125800	BolC4t22404H	0	-	200	1857	2358	0.7875318
C4	6127894	6128185	BolC4t22405H	0	+	198	291	291	1.0000000
C4	6130107	6132465	BolC4t22406H	0	+	1121	1718	2358	0.7285836
C4	6141944	6142328	BolC4t22407H	0	+	88	384	384	1.0000000
C4	6150688	6151349	BolC4t22408H	0	+	167	661	661	1.0000000
C4	6153195	6155573	BolC4t22409H	0	-	968	2247	2378	0.9449117
C4	6157749	6158606	BolC4t22410H	0	+	0	0	857	0.0000000
C4	6161022	6162595	BolC4t22411H	0	-	782	1573	1573	1.0000000
C4	6167814	6167919	BolC4t22412H	0	+	133	105	105	1.0000000
C4	6170834	6171077	BolC4t22413H	0	+	170	243	243	1.0000000
C4	6180919	6182898	BolC4t22414H	0	+	231	1171	1979	0.5917130
C4	6187296	6187715	BolC4t22415H	0	+	293	419	419	1.0000000
C4	6193437	6195873	BolC4t22416H	0	+	1737	2436	2436	1.0000000
C4	6198957	6199665	BolC4t22417H	0	+	70	584	708	0.8248588
C4	6210711	6211003	BolC4t22418H	0	+	224	292	292	1.0000000
C4	6211058	6212798	BolC4t22419H	0	+	827	1740	1740	1.0000000
C4	6226212	6226557	BolC4t22420H	0	-	252	345	345	1.0000000
C4	6229208	6231414	BolC4t22421H	0	-	1912	2206	2206	1.0000000
C4	6237195	6238198	BolC4t22422H	0	+	452	989	1003	0.9860419
C4	6241100	6241397	BolC4t22423H	0	+	275	297	297	1.0000000
C4	6273232	6274951	BolC4t22424H	0	+	360	1438	1719	0.8365329
C4	6276543	6276820	BolC4t22425H	0	-	108	277	277	1.0000000
C4	6278179	6279575	BolC4t22426H	0	+	445	1358	1396	0.9727794
C4	6283245	6289667	BolC4t22427H	0	+	1772	6063	6422	0.9440984
C4	6290216	6291548	BolC4t22428H	0	-	1133	1267	1332	0.9512012
C4	6291913	6292873	BolC4t22429H	0	-	393	960	960	1.0000000
C4	6293384	6295224	BolC4t22430H	0	+	871	1805	1840	0.9809783
C4	6302417	6303063	BolC4t22431H	0	+	655	646	646	1.0000000
C4	6322217	6323047	BolC4t22432H	0	+	325	830	830	1.0000000
C4	6323700	6324633	BolC4t22433H	0	-	403	910	933	0.9753484
C4	6332191	6334132	BolC4t22434H	0	+	507	1840	1941	0.9479650
C4	6342911	6343977	BolC4t22435H	0	+	375	1066	1066	1.0000000
C4	6344408	6344725	BolC4t22436H	0	+	287	317	317	1.0000000
C4	6352903	6354835	BolC4t22437H	0	+	290	1877	1932	0.9715321
C4	6415675	6416839	BolC4t22438H	0	+	0	0	1164	0.0000000
C4	6445608	6453483	BolC4t22439H	0	+	2404	7262	7875	0.9221587
C4	6458832	6460824	BolC4t22440H	0	+	315	1621	1992	0.8137550
C4	6462650	6463580	BolC4t22441H	0	+	233	791	930	0.8505377
C4	6480623	6482864	BolC4t22442H	0	+	147	1696	2241	0.7568050
C4	6483203	6487956	BolC4t22443H	0	-	1855	4639	4753	0.9760152
C4	6490653	6491399	BolC4t22444H	0	+	80	641	746	0.8592494
C4	6492999	6494844	BolC4t22445H	0	+	598	1688	1845	0.9149051
C4	6507573	6508571	BolC4t22446H	0	+	248	996	998	0.9979960
C4	6509032	6512123	BolC4t22447H	0	+	993	2511	3091	0.8123584
C4	6513300	6516136	BolC4t22448H	0	+	1407	2783	2836	0.9813117
C4	6516625	6517755	BolC4t22449H	0	-	433	1101	1130	0.9743363
C4	6522599	6524261	BolC4t22450H	0	+	349	1355	1662	0.8152828
C4	6527492	6529598	BolC4t22451H	0	+	294	1654	2106	0.7853751
C4	6558489	6561231	BolC4t22452H	0	-	965	2385	2742	0.8698031
C4	6589658	6593594	BolC4t22453H	0	+	1116	3323	3936	0.8442581
C4	6594425	6596208	BolC4t22454H	0	-	601	1561	1783	0.8754907
C4	6597939	6604593	BolC4t22455H	0	+	4503	6193	6654	0.9307184
C4	6607603	6607844	BolC4t22456H	0	-	290	241	241	1.0000000
C4	6631099	6631366	BolC4t22457H	0	+	15	169	267	0.6329588
C4	6635154	6635617	BolC4t22458H	0	+	54	442	463	0.9546436
C4	6677075	6677420	BolC4t22459H	0	+	1	36	345	0.1043478
C4	6681067	6682220	BolC4t22460H	0	+	682	1115	1153	0.9670425
C4	6700655	6704210	BolC4t22461H	0	-	848	3183	3555	0.8953586
C4	6710246	6712866	BolC4t22462H	0	-	603	2091	2620	0.7980916
C4	6714010	6719824	BolC4t22463H	0	-	2670	5811	5814	0.9994840
C4	6719923	6721525	BolC4t22464H	0	-	111	1285	1602	0.8021224
C4	6732474	6734079	BolC4t22465H	0	-	6	379	1605	0.2361371
C4	6745418	6746672	BolC4t22466H	0	-	17	259	1254	0.2065391
C4	6771551	6773490	BolC4t22467H	0	-	1102	1804	1939	0.9303765
C4	6774395	6774503	BolC4t22468H	0	+	0	0	108	0.0000000
C4	6781016	6781811	BolC4t22469H	0	+	112	634	795	0.7974843
C4	6785872	6792898	BolC4t22470H	0	+	857	6480	7026	0.9222887
C4	6793308	6793635	BolC4t22471H	0	+	35	84	327	0.2568807
C4	6794116	6795730	BolC4t22472H	0	-	693	1476	1614	0.9144982
C4	6806196	6806790	BolC4t22473H	0	+	115	381	594	0.6414142
C4	6823705	6824836	BolC4t22474H	0	-	131	980	1131	0.8664898
C4	6826478	6832924	BolC4t22475H	0	+	932	4409	6446	0.6839901
C4	6833582	6835999	BolC4t22476H	0	-	814	2276	2417	0.9416632
C4	6843698	6845267	BolC4t22477H	0	+	1569	1569	1569	1.0000000
C4	6849574	6850166	BolC4t22478H	0	+	976	592	592	1.0000000
C4	6850795	6853750	BolC4t22479H	0	-	906	2749	2955	0.9302877
C4	6856485	6857363	BolC4t22480H	0	-	611	878	878	1.0000000
C4	6858932	6861892	BolC4t22481H	0	+	1167	2718	2960	0.9182432
C4	6865573	6866322	BolC4t22482H	0	+	63	444	749	0.5927904
C4	6868987	6869492	BolC4t22483H	0	-	236	505	505	1.0000000
C4	6873395	6875490	BolC4t22484H	0	+	1485	2095	2095	1.0000000
C4	6876195	6877123	BolC4t22485H	0	-	442	858	928	0.9245690
C4	6884501	6885856	BolC4t22486H	0	-	524	1125	1355	0.8302583
C4	6887002	6890343	BolC4t22487H	0	+	1080	3087	3341	0.9239749
C4	6890942	6892950	BolC4t22488H	0	-	2014	2008	2008	1.0000000
C4	6909372	6911522	BolC4t22489H	0	-	1185	2150	2150	1.0000000
C4	6913556	6914016	BolC4t22490H	0	-	104	460	460	1.0000000
C4	6916091	6916496	BolC4t22491H	0	-	93	405	405	1.0000000
C4	6919898	6921338	BolC4t22492H	0	-	259	1089	1440	0.7562500
C4	6951948	6953172	BolC4t22493H	0	+	790	1224	1224	1.0000000
C4	6962052	6963336	BolC4t22494H	0	+	277	1202	1284	0.9361371
C4	6964155	6966286	BolC4t22495H	0	-	296	2030	2131	0.9526044
C4	6967055	6967732	BolC4t22496H	0	+	31	309	677	0.4564254
C4	6968570	6978828	BolC4t22497H	0	-	1931	7168	10258	0.6987717
C4	6982185	6982623	BolC4t22498H	0	+	0	0	438	0.0000000
C4	6990298	6990568	BolC4t22499H	0	-	0	0	270	0.0000000
C4	6993948	6994467	BolC4t22500H	0	+	0	0	519	0.0000000
C4	7001703	7002236	BolC4t22501H	0	+	13	371	533	0.6960601
C4	7003444	7004513	BolC4t22502H	0	+	87	573	1069	0.5360150
C4	7008956	7010081	BolC4t22503H	0	+	56	723	1125	0.6426666
C4	7017120	7017384	BolC4t22504H	0	+	2	19	264	0.0719697
C4	7019404	7028246	BolC4t22505H	0	-	163	2825	8842	0.3194979
C4	7028283	7028666	BolC4t22506H	0	-	1	67	383	0.1749347
C4	7030583	7031120	BolC4t22507H	0	-	17	437	537	0.8137802
C4	7032593	7032779	BolC4t22508H	0	+	0	0	186	0.0000000
C4	7050093	7050532	BolC4t22509H	0	+	451	439	439	1.0000000
C4	7054026	7054583	BolC4t22510H	0	+	308	557	557	1.0000000
C4	7064085	7065130	BolC4t22511H	0	+	120	327	1045	0.3129187
C4	7070093	7070854	BolC4t22512H	0	+	68	399	761	0.5243101
C4	7075795	7076192	BolC4t22513H	0	-	3	89	397	0.2241814
C4	7093401	7094493	BolC4t22514H	0	+	12	329	1092	0.3012820
C4	7100900	7102134	BolC4t22515H	0	+	8	343	1234	0.2779579
C4	7102765	7103012	BolC4t22516H	0	+	0	0	247	0.0000000
C4	7111020	7112150	BolC4t22517H	0	-	4	104	1130	0.0920354
C4	7112180	7112862	BolC4t22518H	0	-	0	0	682	0.0000000
C4	7150204	7150497	BolC4t22519H	0	+	232	293	293	1.0000000
C4	7151040	7154701	BolC4t22520H	0	+	1114	3392	3661	0.9265228
C4	7155959	7156985	BolC4t22521H	0	-	32	382	1026	0.3723197
C4	7159544	7160227	BolC4t22522H	0	-	122	579	683	0.8477306
C4	7165373	7170710	BolC4t22523H	0	-	607	2246	5337	0.4208357
C4	7172173	7173760	BolC4t22524H	0	+	2129	1587	1587	1.0000000
C4	7175194	7176565	BolC4t22525H	0	-	561	1284	1371	0.9365427
C4	7181494	7185026	BolC4t22526H	0	+	937	2755	3532	0.7800113
C4	7185713	7187874	BolC4t22527H	0	-	1041	2087	2161	0.9657566
C4	7193824	7194205	BolC4t22528H	0	+	552	381	381	1.0000000
C4	7196934	7197351	BolC4t22529H	0	+	109	413	417	0.9904076
C4	7223222	7223486	BolC4t22530H	0	-	10	140	264	0.5303030
C4	7234563	7235659	BolC4t22531H	0	-	16	481	1096	0.4388686
C4	7237415	7237658	BolC4t22532H	0	+	2	19	243	0.0781893
C4	7238168	7239203	BolC4t22533H	0	-	804	948	1035	0.9159420
C4	7240248	7281464	BolC4t22534H	0	-	5749	17953	41216	0.4355833
C4	7253206	7253921	BolC4t22535H	0	+	873	715	715	1.0000000
C4	7274088	7274802	BolC4t22536H	0	+	146	614	714	0.8599440
C4	7297522	7297645	BolC4t22537H	0	-	0	0	123	0.0000000
C4	7298295	7299300	BolC4t22538H	0	-	0	0	1005	0.0000000
C4	7323464	7324088	BolC4t22539H	0	-	135	624	624	1.0000000
C4	7326066	7327060	BolC4t22540H	0	+	367	823	994	0.8279678
C4	7327682	7327832	BolC4t22541H	0	-	190	150	150	1.0000000
C4	7328976	7329739	BolC4t22542H	0	+	734	763	763	1.0000000
C4	7335430	7335676	BolC4t22543H	0	-	260	246	246	1.0000000
C4	7339448	7342664	BolC4t22544H	0	+	291	2108	3216	0.6554726
C4	7344834	7355675	BolC4t22545H	0	+	4317	9788	10841	0.9028687
C4	7357573	7360930	BolC4t22546H	0	-	1028	3188	3357	0.9496574
C4	7367687	7369213	BolC4t22547H	0	+	163	1329	1526	0.8709043
C4	7371551	7371689	BolC4t22548H	0	-	0	0	138	0.0000000
C4	7372226	7372412	BolC4t22549H	0	-	0	0	186	0.0000000
C4	7376294	7378904	BolC4t22550H	0	+	679	2101	2610	0.8049808
C4	7380302	7384782	BolC4t22551H	0	+	1643	4480	4480	1.0000000
C4	7386442	7387536	BolC4t22552H	0	-	455	1094	1094	1.0000000
C4	7389358	7389746	BolC4t22553H	0	-	380	388	388	1.0000000
C4	7414319	7414487	BolC4t22554H	0	+	23	103	168	0.6130952
C4	7416537	7418657	BolC4t22555H	0	-	699	1822	2120	0.8594339
C4	7446062	7447818	BolC4t22556H	0	-	983	1720	1756	0.9794989
C4	7465190	7468581	BolC4t22557H	0	+	898	2592	3391	0.7643763
C4	7470544	7471735	BolC4t22558H	0	+	553	1191	1191	1.0000000
C4	7472448	7473651	BolC4t22559H	0	+	575	1203	1203	1.0000000
C4	7473949	7474462	BolC4t22560H	0	-	275	513	513	1.0000000
C4	7475025	7476082	BolC4t22561H	0	+	592	1052	1057	0.9952697
C4	7479408	7482868	BolC4t22562H	0	-	129	1798	3460	0.5196532
C4	7529365	7529482	BolC4t22563H	0	-	8	117	117	1.0000000
C4	7530173	7530790	BolC4t22564H	0	-	54	498	617	0.8071313
C4	7541550	7544271	BolC4t22565H	0	+	412	1409	2721	0.5178244
C4	7547526	7549569	BolC4t22566H	0	+	383	946	2043	0.4630446
C4	7551859	7553461	BolC4t22567H	0	-	359	1011	1602	0.6310862
C4	7573657	7576562	BolC4t22568H	0	-	335	1707	2905	0.5876076
C4	7581906	7585176	BolC4t22569H	0	-	698	3114	3270	0.9522936
C4	7586106	7586412	BolC4t22570H	0	+	312	306	306	1.0000000
C4	7597987	7599034	BolC4t22571H	0	+	168	843	1047	0.8051576
C4	7599289	7602660	BolC4t22572H	0	-	717	3169	3371	0.9400771
C4	7605497	7607570	BolC4t22573H	0	+	720	1895	2073	0.9141341
C4	7608225	7609875	BolC4t22574H	0	-	523	1631	1650	0.9884849
C4	7610051	7610338	BolC4t22575H	0	+	267	287	287	1.0000000
C4	7611037	7611736	BolC4t22576H	0	-	191	662	699	0.9470673
C4	7613495	7615106	BolC4t22577H	0	+	1204	1611	1611	1.0000000
C4	7615446	7616592	BolC4t22578H	0	+	490	1033	1146	0.9013962
C4	7616947	7617628	BolC4t22579H	0	+	30	392	681	0.5756241
C4	7632580	7633030	BolC4t22580H	0	+	135	450	450	1.0000000
C4	7633080	7633275	BolC4t22581H	0	+	103	195	195	1.0000000
C4	7634389	7634719	BolC4t22582H	0	-	46	330	330	1.0000000
C4	7635939	7636467	BolC4t22583H	0	+	157	528	528	1.0000000
C4	7638270	7638918	BolC4t22584H	0	+	13	391	648	0.6033950
C4	7642215	7642663	BolC4t22585H	0	-	12	265	448	0.5915179
C4	7649523	7650456	BolC4t22586H	0	-	4	305	933	0.3269025
C4	7653449	7654453	BolC4t22587H	0	-	528	940	1004	0.9362550
C4	7665266	7670461	BolC4t22588H	0	+	5125	5195	5195	1.0000000
C4	7675647	7680565	BolC4t22589H	0	+	1999	4852	4918	0.9865799
C4	7681959	7685313	BolC4t22590H	0	+	552	3309	3354	0.9865832
C4	7686985	7687447	BolC4t22591H	0	-	227	462	462	1.0000000
C4	7687530	7688271	BolC4t22592H	0	+	252	741	741	1.0000000
C4	7689385	7689833	BolC4t22593H	0	-	232	448	448	1.0000000
C4	7690738	7691224	BolC4t22594H	0	+	362	486	486	1.0000000
C4	7694851	7695106	BolC4t22595H	0	-	67	255	255	1.0000000
C4	7695215	7695341	BolC4t22596H	0	-	82	126	126	1.0000000
C4	7701978	7702973	BolC4t22597H	0	+	218	665	995	0.6683417
C4	7703325	7705262	BolC4t22598H	0	-	1807	1891	1937	0.9762520
C4	7714600	7714732	BolC4t22599H	0	+	0	0	132	0.0000000
C4	7717366	7718695	BolC4t22600H	0	-	1667	1329	1329	1.0000000
C4	7724738	7725188	BolC4t22601H	0	+	7	142	450	0.3155555
C4	7731365	7733091	BolC4t22602H	0	+	66	811	1726	0.4698725
C4	7741587	7744291	BolC4t22603H	0	+	393	2000	2704	0.7396449
C4	7744907	7745162	BolC4t22604H	0	-	136	254	255	0.9960784
C4	7746191	7746542	BolC4t22605H	0	-	209	333	351	0.9487180
C4	7746919	7748597	BolC4t22606H	0	-	1849	1678	1678	1.0000000
C4	7752462	7752853	BolC4t22607H	0	+	15	268	391	0.6854220
C4	7758373	7758709	BolC4t22608H	0	+	348	336	336	1.0000000
C4	7759489	7760624	BolC4t22609H	0	-	20	146	1135	0.1286344
C4	7792261	7793167	BolC4t22610H	0	+	32	439	906	0.4845475
C4	7796332	7830882	BolC4t22611H	0	-	71548	24845	34550	0.7191027
C4	7796772	7798715	BolC4t22612H	0	-	293	1612	1943	0.8296449
C4	7833148	7833817	BolC4t22613H	0	+	151	667	669	0.9970105
C4	7834693	7847898	BolC4t22614H	0	-	5556	9286	13205	0.7032185
C4	7851325	7852954	BolC4t22615H	0	-	3606	1629	1629	1.0000000
C4	7855720	7857238	BolC4t22616H	0	-	380	1329	1518	0.8754941
C4	7858585	7858846	BolC4t22617H	0	-	23	258	261	0.9885057
C4	7862463	7863339	BolC4t22618H	0	+	36	675	876	0.7705479
C4	7874564	7874864	BolC4t22619H	0	+	52	300	300	1.0000000
C4	7881089	7881878	BolC4t22620H	0	+	39	476	789	0.6032953
C4	7882810	7886067	BolC4t22621H	0	+	1235	2930	3257	0.8996009
C4	7897690	7901539	BolC4t22622H	0	+	1223	3501	3849	0.9095869
C4	7902384	7903495	BolC4t22623H	0	-	1414	1111	1111	1.0000000
C4	7910552	7911715	BolC4t22624H	0	+	487	1163	1163	1.0000000
C4	7914778	7916257	BolC4t22625H	0	+	1031	1366	1479	0.9235970
C4	7917152	7918731	BolC4t22626H	0	+	1887	1579	1579	1.0000000
C4	7922180	7922444	BolC4t22627H	0	+	209	264	264	1.0000000
C4	7926582	7927005	BolC4t22628H	0	+	189	423	423	1.0000000
C4	7945917	7948179	BolC4t22629H	0	+	1050	2213	2262	0.9783378
C4	7958991	7959818	BolC4t22630H	0	-	328	827	827	1.0000000
C4	7978033	7979107	BolC4t22631H	0	+	592	1074	1074	1.0000000
C4	7979554	7981328	BolC4t22632H	0	-	342	1364	1774	0.7688839
C4	7991129	7991989	BolC4t22633H	0	+	92	674	860	0.7837209
C4	7997112	7997792	BolC4t22634H	0	+	231	680	680	1.0000000
C4	8008328	8009486	BolC4t22635H	0	-	112	1015	1158	0.8765112
C4	8013342	8015137	BolC4t22636H	0	-	922	1739	1795	0.9688022
C4	8016253	8017735	BolC4t22637H	0	+	621	1482	1482	1.0000000
C4	8020034	8021582	BolC4t22638H	0	-	723	1492	1548	0.9638243
C4	8022384	8022696	BolC4t22639H	0	+	429	312	312	1.0000000
C4	8032754	8035597	BolC4t22640H	0	+	1895	2799	2843	0.9845234
C4	8037873	8038152	BolC4t22641H	0	+	216	279	279	1.0000000
C4	8041195	8043255	BolC4t22642H	0	+	2496	2060	2060	1.0000000
C4	8047870	8051792	BolC4t22643H	0	+	1310	3444	3922	0.8781234
C4	8070021	8070129	BolC4t22644H	0	+	493	108	108	1.0000000
C4	8087625	8088469	BolC4t22645H	0	+	1024	844	844	1.0000000
C4	8088779	8091265	BolC4t22646H	0	+	2207	2486	2486	1.0000000
C4	8091522	8092177	BolC4t22647H	0	-	807	655	655	1.0000000
C4	8103006	8105189	BolC4t22648H	0	+	424	1460	2183	0.6688044
C4	8105864	8107451	BolC4t22649H	0	-	1153	1587	1587	1.0000000
C4	8108651	8111359	BolC4t22650H	0	-	605	2462	2708	0.9091581
C4	8123180	8123723	BolC4t22651H	0	-	56	324	543	0.5966851
C4	8126261	8128008	BolC4t22652H	0	-	422	1747	1747	1.0000000
C4	8128661	8129701	BolC4t22653H	0	+	576	1040	1040	1.0000000
C4	8130419	8132784	BolC4t22654H	0	+	699	2207	2365	0.9331924
C4	8132996	8134248	BolC4t22655H	0	-	278	1173	1252	0.9369010
C4	8138996	8139308	BolC4t22656H	0	-	9	79	312	0.2532051
C4	8140302	8140590	BolC4t22657H	0	-	165	288	288	1.0000000
C4	8156428	8157373	BolC4t22658H	0	-	332	945	945	1.0000000
C4	8162785	8163082	BolC4t22659H	0	+	283	297	297	1.0000000
C4	8168047	8172254	BolC4t22660H	0	-	1687	4136	4207	0.9831234
C4	8174265	8175656	BolC4t22661H	0	-	347	1312	1391	0.9432063
C4	8176577	8178023	BolC4t22662H	0	-	795	1410	1446	0.9751037
C4	8179759	8180056	BolC4t22663H	0	+	284	297	297	1.0000000
C4	8182978	8188040	BolC4t22664H	0	+	1861	4521	5062	0.8931252
C4	8188567	8194294	BolC4t22665H	0	-	1620	5442	5727	0.9502357
C4	8194679	8203751	BolC4t22666H	0	-	4125	8729	9072	0.9621913
C4	8211656	8212747	BolC4t22667H	0	+	617	1091	1091	1.0000000
C4	8213999	8215462	BolC4t22668H	0	-	315	1395	1463	0.9535202
C4	8222567	8222897	BolC4t22669H	0	-	308	330	330	1.0000000
C4	8223365	8224761	BolC4t22670H	0	+	267	1392	1396	0.9971347
C4	8225946	8227251	BolC4t22671H	0	+	1096	1279	1305	0.9800766
C4	8229562	8229993	BolC4t22672H	0	-	154	431	431	1.0000000
C4	8239972	8242598	BolC4t22673H	0	+	1130	2395	2626	0.9120335
C4	8254923	8255202	BolC4t22674H	0	+	320	279	279	1.0000000
C4	8258356	8258831	BolC4t22675H	0	-	369	475	475	1.0000000
C4	8259836	8260964	BolC4t22676H	0	-	755	1128	1128	1.0000000
C4	8263897	8265040	BolC4t22677H	0	+	180	1046	1143	0.9151356
C4	8266709	8267567	BolC4t22678H	0	-	169	858	858	1.0000000
C4	8272004	8273442	BolC4t22679H	0	+	230	1083	1438	0.7531294
C4	8277663	8280077	BolC4t22680H	0	+	1040	2227	2414	0.9225352
C4	8280730	8285020	BolC4t22681H	0	-	502	3538	4290	0.8247086
C4	8296105	8297373	BolC4t22682H	0	-	83	926	1268	0.7302839
C4	8308703	8311480	BolC4t22683H	0	+	338	2139	2777	0.7702557
C4	8322195	8322408	BolC4t22684H	0	+	444	213	213	1.0000000
C4	8325047	8326427	BolC4t22685H	0	+	533	1380	1380	1.0000000
C4	8327036	8327414	BolC4t22686H	0	-	162	318	378	0.8412699
C4	8332780	8337417	BolC4t22687H	0	-	1100	3654	4637	0.7880095
C4	8341404	8342306	BolC4t22688H	0	+	205	902	902	1.0000000
C4	8341758	8342427	BolC4t22689H	0	-	290	669	669	1.0000000
C4	8355445	8355607	BolC4t22690H	0	+	188	162	162	1.0000000
C4	8358231	8358899	BolC4t22691H	0	-	250	408	668	0.6107785
C4	8359121	8359768	BolC4t22692H	0	-	633	647	647	1.0000000
C4	8360424	8360691	BolC4t22693H	0	-	210	267	267	1.0000000
C4	8368034	8369894	BolC4t22694H	0	-	234	791	1860	0.4252688
C4	8376080	8376812	BolC4t22695H	0	-	0	0	732	0.0000000
C4	8379454	8380524	BolC4t22696H	0	+	3	45	1070	0.0420561
C4	8385192	8385669	BolC4t22697H	0	-	98	460	477	0.9643606
C4	8396117	8396903	BolC4t22698H	0	+	0	0	786	0.0000000
C4	8397481	8398479	BolC4t22699H	0	-	0	0	998	0.0000000
C4	8408545	8409020	BolC4t22700H	0	-	10	367	475	0.7726316
C4	8409995	8411610	BolC4t22701H	0	-	0	0	1615	0.0000000
C4	8421671	8422156	BolC4t22702H	0	-	15	86	485	0.1773196
C4	8428034	8428414	BolC4t22703H	0	-	1	31	380	0.0815789
C4	8436169	8436775	BolC4t22704H	0	-	2	95	606	0.1567657
C4	8450269	8451001	BolC4t22705H	0	-	0	0	732	0.0000000
C4	8458529	8459934	BolC4t22706H	0	+	0	0	1405	0.0000000
C4	8460348	8460774	BolC4t22707H	0	-	1	39	426	0.0915493
C4	8464725	8466000	BolC4t22708H	0	-	628	1223	1275	0.9592157
C4	8468288	8472097	BolC4t22709H	0	+	43	651	3809	0.1709110
C4	8488619	8489094	BolC4t22710H	0	-	0	0	475	0.0000000
C4	8490264	8491822	BolC4t22711H	0	-	0	0	1558	0.0000000
C4	8509489	8509994	BolC4t22712H	0	-	0	0	505	0.0000000
C4	8510003	8510147	BolC4t22713H	0	+	0	0	144	0.0000000
C4	8511316	8512351	BolC4t22714H	0	-	2	35	1035	0.0338164
C4	8519034	8519668	BolC4t22715H	0	-	0	0	634	0.0000000
C4	8520870	8536531	BolC4t22716H	0	+	25	559	15661	0.0356938
C4	8526270	8527294	BolC4t22717H	0	-	0	0	1024	0.0000000
C4	8533307	8534598	BolC4t22718H	0	-	0	0	1291	0.0000000
C4	8539331	8539837	BolC4t22719H	0	-	0	0	506	0.0000000
C4	8539846	8540098	BolC4t22720H	0	+	0	0	252	0.0000000
C4	8540909	8541391	BolC4t22721H	0	-	0	0	482	0.0000000
C4	8547802	8549097	BolC4t22722H	0	-	0	0	1295	0.0000000
C4	8550549	8550999	BolC4t22723H	0	+	18	448	450	0.9955556
C4	8553792	8555859	BolC4t22724H	0	-	88	713	2067	0.3449444
C4	8556096	8557179	BolC4t22725H	0	-	0	0	1083	0.0000000
C4	8557440	8557962	BolC4t22726H	0	-	0	0	522	0.0000000
C4	8560291	8561179	BolC4t22727H	0	-	8	277	888	0.3119369
C4	8564944	8565523	BolC4t22728H	0	-	79	426	579	0.7357513
C4	8572518	8573096	BolC4t22729H	0	+	4	20	578	0.0346021
C4	8573473	8574184	BolC4t22730H	0	-	479	589	711	0.8284107
C4	8575390	8576389	BolC4t22731H	0	-	0	0	999	0.0000000
C4	8579061	8580511	BolC4t22732H	0	+	12	29	1450	0.0200000
C4	8594681	8595956	BolC4t22733H	0	-	248	806	1275	0.6321568
C4	8597606	8602364	BolC4t22734H	0	+	182	1791	4758	0.3764187
C4	8602944	8604299	BolC4t22735H	0	-	0	0	1355	0.0000000
C4	8609575	8610031	BolC4t22736H	0	-	0	0	456	0.0000000
C4	8618794	8620434	BolC4t22737H	0	-	0	0	1640	0.0000000
C4	8630263	8630743	BolC4t22738H	0	-	16	241	480	0.5020834
C4	8637760	8638237	BolC4t22739H	0	-	0	0	477	0.0000000
C4	8639323	8640187	BolC4t22740H	0	+	19	609	864	0.7048611
C4	8642975	8649799	BolC4t22741H	0	-	1461	4613	6824	0.6759965
C4	8650949	8652377	BolC4t22742H	0	-	0	0	1428	0.0000000
C4	8653451	8655151	BolC4t22743H	0	-	48	793	1700	0.4664706
C4	8658568	8658835	BolC4t22744H	0	+	23	223	267	0.8352060
C4	8662232	8663857	BolC4t22745H	0	-	7	171	1625	0.1052308
C4	8664536	8666378	BolC4t22746H	0	-	6	303	1842	0.1644951
C4	8667503	8673236	BolC4t22747H	0	-	992	4133	5733	0.7209140
C4	8676393	8679808	BolC4t22748H	0	-	721	3006	3415	0.8802342
C4	8705058	8722766	BolC4t22749H	0	-	1994	4090	17708	0.2309691
C4	8717173	8719509	BolC4t22750H	0	-	1296	1629	2336	0.6973459
C4	8733578	8733713	BolC4t22751H	0	-	128	135	135	1.0000000
C4	8734334	8736672	BolC4t22752H	0	-	583	1287	2338	0.5504705
C4	8738483	8739937	BolC4t22753H	0	-	50	242	1454	0.1664374
C4	8743346	8744017	BolC4t22754H	0	+	319	671	671	1.0000000
C4	8745619	8746580	BolC4t22755H	0	+	414	961	961	1.0000000
C4	8749972	8751546	BolC4t22756H	0	-	731	1513	1574	0.9612452
C4	8755152	8756378	BolC4t22757H	0	+	881	1226	1226	1.0000000
C4	8757498	8758671	BolC4t22758H	0	+	983	1173	1173	1.0000000
C4	8761234	8762095	BolC4t22759H	0	+	706	861	861	1.0000000
C4	8762594	8762765	BolC4t22760H	0	-	503	171	171	1.0000000
C4	8762764	8763464	BolC4t22761H	0	-	791	700	700	1.0000000
C4	8792177	8793893	BolC4t22762H	0	+	920	1624	1716	0.9463869
C4	8801821	8815670	BolC4t22763H	0	+	1808	10615	13849	0.7664813
C4	8816923	8817211	BolC4t22764H	0	-	882	288	288	1.0000000
C4	8821593	8822623	BolC4t22765H	0	+	647	1030	1030	1.0000000
C4	8859586	8860254	BolC4t22766H	0	+	0	0	668	0.0000000
C4	8865641	8867743	BolC4t22767H	0	+	55	755	2102	0.3591817
C4	8870329	8871838	BolC4t22768H	0	-	36	443	1509	0.2935719
C4	8873645	8874066	BolC4t22769H	0	-	65	192	421	0.4560570
C4	8885692	8887048	BolC4t22770H	0	+	2	19	1356	0.0140118
C4	8888304	8890009	BolC4t22771H	0	-	20	198	1705	0.1161290
C4	8890059	8890465	BolC4t22772H	0	-	12	153	406	0.3768473
C4	8891888	8895314	BolC4t22773H	0	-	111	1168	3426	0.3409224
C4	8906425	8907981	BolC4t22774H	0	+	428	1414	1556	0.9087403
C4	8908858	8909933	BolC4t22775H	0	+	105	365	1075	0.3395349
C4	8910759	8912853	BolC4t22776H	0	-	81	605	2094	0.2889207
C4	8915099	8916724	BolC4t22777H	0	+	145	1362	1625	0.8381538
C4	8918025	8920133	BolC4t22778H	0	+	275	1947	2108	0.9236243
C4	8933991	8935482	BolC4t22779H	0	+	7	255	1491	0.1710262
C4	8937444	8937670	BolC4t22780H	0	+	0	0	226	0.0000000
C4	8939415	8939778	BolC4t22781H	0	+	3	35	363	0.0964187
C4	8942186	8942348	BolC4t22782H	0	+	0	0	162	0.0000000
C4	8943507	8945607	BolC4t22783H	0	+	109	884	2100	0.4209524
C4	8952002	8953332	BolC4t22784H	0	-	14	190	1330	0.1428571
C4	8954310	8955819	BolC4t22785H	0	-	116	1064	1509	0.7051027
C4	8958971	8961877	BolC4t22786H	0	-	767	1691	2906	0.5818995
C4	8964212	8965804	BolC4t22787H	0	+	692	1592	1592	1.0000000
C4	8968161	8969561	BolC4t22788H	0	+	870	1400	1400	1.0000000
C4	8970002	8971086	BolC4t22789H	0	+	857	1084	1084	1.0000000
C4	8976002	8976506	BolC4t22790H	0	-	323	504	504	1.0000000
C4	8980125	8980404	BolC4t22791H	0	-	282	279	279	1.0000000
C4	9001641	9002806	BolC4t22792H	0	+	201	1118	1165	0.9596567
C4	9011618	9013830	BolC4t22793H	0	-	670	1957	2212	0.8847197
C4	9022827	9026235	BolC4t22794H	0	+	1374	3012	3408	0.8838028
C4	9032438	9034301	BolC4t22795H	0	+	241	1578	1863	0.8470209
C4	9035590	9037916	BolC4t22796H	0	+	293	1540	2326	0.6620808
C4	9048111	9048426	BolC4t22797H	0	-	2	138	315	0.4380952
C4	9055959	9056412	BolC4t22798H	0	-	47	440	453	0.9713024
C4	9066190	9067455	BolC4t22799H	0	-	1035	1265	1265	1.0000000
C4	9071884	9073218	BolC4t22800H	0	+	993	1334	1334	1.0000000
C4	9075088	9077466	BolC4t22801H	0	+	761	2063	2378	0.8675358
C4	9079205	9079929	BolC4t22802H	0	+	257	684	724	0.9447514
C4	9080286	9081051	BolC4t22803H	0	-	416	733	765	0.9581699
C4	9105571	9106789	BolC4t22804H	0	-	341	1098	1218	0.9014778
C4	9107612	9110204	BolC4t22805H	0	+	631	1962	2592	0.7569444
C4	9116403	9119096	BolC4t22806H	0	+	157	1740	2693	0.6461196
C4	9119648	9121954	BolC4t22807H	0	-	386	2087	2306	0.9050304
C4	9151407	9162093	BolC4t22808H	0	+	3640	9736	10686	0.9110987
C4	9164374	9165760	BolC4t22809H	0	+	536	1327	1386	0.9574314
C4	9173171	9173453	BolC4t22810H	0	+	137	282	282	1.0000000
C4	9176651	9176996	BolC4t22811H	0	+	362	345	345	1.0000000
C4	9189420	9189669	BolC4t22812H	0	-	364	249	249	1.0000000
C4	9191681	9193046	BolC4t22813H	0	-	92	622	1365	0.4556777
C4	9194650	9197103	BolC4t22814H	0	-	796	2384	2453	0.9718712
C4	9231221	9231362	BolC4t22815H	0	+	0	0	141	0.0000000
C4	9234968	9235291	BolC4t22816H	0	+	360	323	323	1.0000000
C4	9240635	9243128	BolC4t22817H	0	+	74	864	2493	0.3465704
C4	9243428	9248981	BolC4t22818H	0	-	1840	5012	5553	0.9025752
C4	9263270	9263474	BolC4t22819H	0	+	6	116	204	0.5686275
C4	9264109	9264250	BolC4t22820H	0	-	17	114	141	0.8085107
C4	9265766	9270394	BolC4t22821H	0	+	2697	4411	4628	0.9531115
C4	9273006	9276440	BolC4t22822H	0	+	494	3121	3434	0.9088526
C4	9276853	9280035	BolC4t22823H	0	-	900	2472	3182	0.7768699
C4	9282571	9283625	BolC4t22824H	0	-	227	1054	1054	1.0000000
C4	9285328	9285529	BolC4t22825H	0	-	0	0	201	0.0000000
C4	9288972	9289602	BolC4t22826H	0	-	413	630	630	1.0000000
C4	9295936	9296386	BolC4t22827H	0	-	288	450	450	1.0000000
C4	9316845	9318674	BolC4t22828H	0	+	637	1671	1829	0.9136140
C4	9321977	9322580	BolC4t22829H	0	-	4	75	603	0.1243781
C4	9332615	9332831	BolC4t22830H	0	+	33	192	216	0.8888889
C4	9334069	9334996	BolC4t22831H	0	+	221	865	927	0.9331176
C4	9342128	9345929	BolC4t22832H	0	+	563	2916	3801	0.7671666
C4	9343136	9343813	BolC4t22833H	0	-	28	219	677	0.3234860
C4	9348056	9349606	BolC4t22834H	0	+	632	1550	1550	1.0000000
C4	9350984	9351699	BolC4t22835H	0	-	443	715	715	1.0000000
C4	9358222	9358804	BolC4t22836H	0	-	406	582	582	1.0000000
C4	9359926	9360055	BolC4t22837H	0	-	180	129	129	1.0000000
C4	9365105	9366614	BolC4t22838H	0	-	933	1507	1509	0.9986746
C4	9368624	9370125	BolC4t22839H	0	+	684	1466	1501	0.9766822
C4	9371178	9371949	BolC4t22840H	0	-	67	571	771	0.7405967
C4	9407077	9407470	BolC4t22841H	0	+	20	167	393	0.4249364
C4	9414577	9420064	BolC4t22842H	0	+	2317	4718	5487	0.8598506
C4	9426106	9426328	BolC4t22843H	0	+	219	222	222	1.0000000
C4	9426923	9427844	BolC4t22844H	0	-	693	921	921	1.0000000
C4	9428950	9429719	BolC4t22845H	0	-	411	742	769	0.9648895
C4	9430930	9432194	BolC4t22846H	0	-	597	1189	1264	0.9406645
C4	9461445	9461915	BolC4t22847H	0	+	0	0	470	0.0000000
C4	9464939	9465860	BolC4t22848H	0	-	560	921	921	1.0000000
C4	9487901	9488827	BolC4t22849H	0	+	633	926	926	1.0000000
C4	9490274	9491149	BolC4t22850H	0	+	997	875	875	1.0000000
C4	9491309	9492242	BolC4t22851H	0	-	180	817	933	0.8756699
C4	9548408	9548669	BolC4t22852H	0	-	2	138	261	0.5287356
C4	9552042	9552870	BolC4t22853H	0	+	268	683	828	0.8248792
C4	9569132	9572287	BolC4t22854H	0	+	1327	3061	3155	0.9702060
C4	9575021	9575572	BolC4t22855H	0	-	0	0	551	0.0000000
C4	9590830	9591743	BolC4t22856H	0	+	398	913	913	1.0000000
C4	9599565	9608711	BolC4t22857H	0	-	415	4135	9146	0.4521102
C4	9623956	9624784	BolC4t22858H	0	+	214	798	828	0.9637681
C4	9638794	9639367	BolC4t22859H	0	-	337	573	573	1.0000000
C4	9641248	9642825	BolC4t22860H	0	+	813	1507	1577	0.9556119
C4	9643299	9646343	BolC4t22861H	0	-	1586	2903	3044	0.9536794
C4	9649172	9651523	BolC4t22862H	0	-	1131	2217	2351	0.9430030
C4	9655629	9658057	BolC4t22863H	0	+	51	1287	2428	0.5300659
C4	9660719	9661253	BolC4t22864H	0	+	0	0	534	0.0000000
C4	9674782	9675412	BolC4t22865H	0	-	82	475	630	0.7539682
C4	9697356	9697695	BolC4t22866H	0	-	0	0	339	0.0000000
C4	9728878	9730099	BolC4t22867H	0	-	38	782	1221	0.6404586
C4	9731796	9734074	BolC4t22868H	0	+	213	747	2278	0.3279192
C4	9733919	9737599	BolC4t22869H	0	+	954	3514	3680	0.9548913
C4	9740458	9743277	BolC4t22870H	0	-	1285	2629	2819	0.9326002
C4	9747419	9750508	BolC4t22871H	0	-	459	2148	3089	0.6953707
C4	9782798	9783374	BolC4t22872H	0	+	613	576	576	1.0000000
C4	9791380	9791896	BolC4t22873H	0	+	2	117	516	0.2267442
C4	9795563	9798598	BolC4t22874H	0	+	860	2643	3035	0.8708402
C4	9801575	9802153	BolC4t22875H	0	-	117	533	578	0.9221453
C4	9826742	9827335	BolC4t22876H	0	-	254	593	593	1.0000000
C4	9827212	9828095	BolC4t22877H	0	-	399	883	883	1.0000000
C4	9838632	9839247	BolC4t22878H	0	-	27	353	615	0.5739837
C4	9843759	9844272	BolC4t22879H	0	+	457	513	513	1.0000000
C4	9844803	9844947	BolC4t22880H	0	+	167	144	144	1.0000000
C4	9847272	9848716	BolC4t22881H	0	+	885	1444	1444	1.0000000
C4	9849090	9851771	BolC4t22882H	0	-	366	1832	2681	0.6833271
C4	9857822	9867462	BolC4t22883H	0	+	3568	5336	9640	0.5535270
C4	9904457	9905955	BolC4t22884H	0	-	1011	1498	1498	1.0000000
C4	9909193	9911166	BolC4t22885H	0	-	1276	1924	1973	0.9751647
C4	9914008	9914425	BolC4t22886H	0	+	56	417	417	1.0000000
C4	9918846	9919094	BolC4t22887H	0	+	0	0	248	0.0000000
C4	9920126	9920873	BolC4t22888H	0	-	352	747	747	1.0000000
C4	9921571	9934567	BolC4t22889H	0	-	1405	7112	12996	0.5472453
C4	9953771	9954347	BolC4t22890H	0	-	16	348	576	0.6041667
C4	9954561	9955644	BolC4t22891H	0	+	679	1083	1083	1.0000000
C4	9957697	9958271	BolC4t22892H	0	-	137	227	574	0.3954704
C4	9960979	9964293	BolC4t22893H	0	+	1920	3288	3314	0.9921545
C4	9964594	9965941	BolC4t22894H	0	-	851	1344	1347	0.9977728
C4	9966785	9968630	BolC4t22895H	0	-	572	1524	1845	0.8260162
C4	9976855	9978043	BolC4t22896H	0	-	0	0	1188	0.0000000
C4	9979364	9979625	BolC4t22897H	0	+	191	261	261	1.0000000
C4	9994973	9998572	BolC4t22898H	0	+	1571	3272	3599	0.9091414
C4	10001778	10004145	BolC4t22899H	0	+	476	1652	2367	0.6979299
C4	10007222	10009005	BolC4t22900H	0	-	360	1621	1783	0.9091419
C4	10010066	10011439	BolC4t22901H	0	+	595	1273	1373	0.9271668
C4	10013393	10035077	BolC4t22902H	0	-	5092	20082	21684	0.9261206
C4	10039868	10042125	BolC4t22903H	0	+	1749	2257	2257	1.0000000
C4	10043138	10046068	BolC4t22904H	0	+	1521	2850	2930	0.9726962
C4	10046269	10047823	BolC4t22905H	0	-	1015	1554	1554	1.0000000
C4	10054929	10056759	BolC4t22906H	0	+	1833	1830	1830	1.0000000
C4	10066595	10071862	BolC4t22907H	0	+	436	3035	5267	0.5762293
C4	10067421	10067844	BolC4t22908H	0	+	8	19	423	0.0449173
C4	10074613	10074739	BolC4t22909H	0	+	75	126	126	1.0000000
C4	10091330	10092457	BolC4t22910H	0	+	118	991	1127	0.8793256
C4	10092517	10092973	BolC4t22911H	0	+	154	456	456	1.0000000
C4	10118071	10118903	BolC4t22912H	0	+	355	832	832	1.0000000
C4	10128619	10129468	BolC4t22913H	0	-	77	694	849	0.8174323
C4	10148300	10152011	BolC4t22914H	0	+	2523	3711	3711	1.0000000
C4	10157346	10159845	BolC4t22915H	0	+	1637	2499	2499	1.0000000
C4	10160635	10162504	BolC4t22916H	0	+	214	1228	1869	0.6570358
C4	10170816	10172375	BolC4t22917H	0	+	969	1558	1559	0.9993585
C4	10172908	10173696	BolC4t22918H	0	-	782	788	788	1.0000000
C4	10174318	10174973	BolC4t22919H	0	+	533	655	655	1.0000000
C4	10181694	10182396	BolC4t22920H	0	-	201	626	702	0.8917379
C4	10183234	10185282	BolC4t22921H	0	+	1705	2048	2048	1.0000000
C4	10186538	10188688	BolC4t22922H	0	+	454	1590	2150	0.7395349
C4	10189928	10192381	BolC4t22923H	0	+	1430	2429	2453	0.9902161
C4	10194004	10195120	BolC4t22924H	0	+	716	1116	1116	1.0000000
C4	10199628	10200228	BolC4t22925H	0	-	438	600	600	1.0000000
C4	10201602	10202782	BolC4t22926H	0	-	313	835	1180	0.7076271
C4	10203279	10204037	BolC4t22927H	0	-	342	711	758	0.9379947
C4	10205731	10207091	BolC4t22928H	0	+	1019	1360	1360	1.0000000
C4	10222434	10224919	BolC4t22929H	0	+	618	2009	2485	0.8084507
C4	10229221	10230007	BolC4t22930H	0	-	247	786	786	1.0000000
C4	10231064	10232927	BolC4t22931H	0	-	398	1752	1863	0.9404187
C4	10234203	10234500	BolC4t22932H	0	+	49	165	297	0.5555556
C4	10236401	10236692	BolC4t22933H	0	+	4	261	291	0.8969072
C4	10241972	10242341	BolC4t22934H	0	+	84	310	369	0.8401084
C4	10245201	10246044	BolC4t22935H	0	-	209	706	843	0.8374852
C4	10251158	10253081	BolC4t22936H	0	-	873	1923	1923	1.0000000
C4	10258567	10259628	BolC4t22937H	0	+	510	1061	1061	1.0000000
C4	10266822	10267977	BolC4t22938H	0	-	588	1155	1155	1.0000000
C4	10271499	10271820	BolC4t22939H	0	-	1	86	321	0.2679128
C4	10289259	10289463	BolC4t22940H	0	-	0	0	204	0.0000000
C4	10309075	10309946	BolC4t22941H	0	+	761	871	871	1.0000000
C4	10313383	10321442	BolC4t22942H	0	-	3215	5640	8059	0.6998387
C4	10338496	10340062	BolC4t22943H	0	+	73	771	1566	0.4923372
C4	10340155	10340709	BolC4t22944H	0	+	206	554	554	1.0000000
C4	10346345	10346630	BolC4t22945H	0	-	92	194	285	0.6807017
C4	10348964	10349246	BolC4t22946H	0	-	67	282	282	1.0000000
C4	10360790	10361900	BolC4t22947H	0	+	1393	1076	1110	0.9693694
C4	10368624	10369068	BolC4t22948H	0	-	117	444	444	1.0000000
C4	10380954	10381275	BolC4t22949H	0	-	14	72	321	0.2242991
C4	10383900	10385175	BolC4t22950H	0	-	19	548	1275	0.4298039
C4	10385245	10386600	BolC4t22951H	0	-	411	1355	1355	1.0000000
C4	10393403	10393538	BolC4t22952H	0	+	1204	135	135	1.0000000
C4	10395492	10395825	BolC4t22953H	0	+	162	333	333	1.0000000
C4	10398976	10400775	BolC4t22954H	0	-	1111	1762	1799	0.9794330
C4	10402764	10406100	BolC4t22955H	0	+	2053	3336	3336	1.0000000
C4	10412452	10414618	BolC4t22956H	0	-	451	1918	2166	0.8855032
C4	10427153	10430178	BolC4t22957H	0	+	1582	3025	3025	1.0000000
C4	10431473	10432439	BolC4t22958H	0	+	427	966	966	1.0000000
C4	10432908	10435262	BolC4t22959H	0	-	111	1042	2354	0.4426508
C4	10437324	10440832	BolC4t22960H	0	+	1056	3309	3508	0.9432725
C4	10441075	10442189	BolC4t22961H	0	+	331	944	1114	0.8473968
C4	10444200	10451732	BolC4t22962H	0	+	1447	5490	7532	0.7288901
C4	10452876	10456225	BolC4t22963H	0	-	66	1345	3349	0.4016124
C4	10456933	10458461	BolC4t22964H	0	+	403	1515	1528	0.9914922
C4	10469160	10472382	BolC4t22965H	0	+	832	2724	3222	0.8454376
C4	10473808	10478635	BolC4t22966H	0	+	2423	4490	4827	0.9301844
C4	10487056	10488940	BolC4t22967H	0	+	695	1844	1884	0.9787686
C4	10492193	10495725	BolC4t22968H	0	-	1116	3191	3532	0.9034541
C4	10498327	10499434	BolC4t22969H	0	+	182	707	1107	0.6386631
C4	10503095	10504037	BolC4t22970H	0	+	309	853	942	0.9055201
C4	10504861	10505791	BolC4t22971H	0	-	262	893	930	0.9602150
C4	10506564	10508742	BolC4t22972H	0	-	612	2073	2178	0.9517906
C4	10510215	10512942	BolC4t22973H	0	+	781	2532	2727	0.9284928
C4	10517153	10517420	BolC4t22974H	0	-	223	267	267	1.0000000
C4	10527497	10530069	BolC4t22975H	0	+	664	2414	2572	0.9385692
C4	10530549	10531437	BolC4t22976H	0	-	431	729	888	0.8209459
C4	10532376	10534555	BolC4t22977H	0	+	1025	2139	2179	0.9816430
C4	10546335	10549724	BolC4t22978H	0	+	2369	3256	3389	0.9607554
C4	10550499	10550811	BolC4t22979H	0	-	337	312	312	1.0000000
C4	10552966	10554098	BolC4t22980H	0	-	896	1132	1132	1.0000000
C4	10573936	10574095	BolC4t22981H	0	+	135	159	159	1.0000000
C4	10586735	10589404	BolC4t22982H	0	+	411	2326	2669	0.8714874
C4	10598365	10599356	BolC4t22983H	0	-	390	960	991	0.9687185
C4	10609183	10610812	BolC4t22984H	0	-	169	1208	1629	0.7415593
C4	10623231	10624639	BolC4t22985H	0	-	1447	1408	1408	1.0000000
C4	10628464	10631027	BolC4t22986H	0	+	750	2358	2563	0.9200156
C4	10631414	10636307	BolC4t22987H	0	-	2508	4658	4893	0.9519722
C4	10637699	10640056	BolC4t22988H	0	-	1329	1967	2357	0.8345354
C4	10643869	10644424	BolC4t22989H	0	+	41	521	555	0.9387388
C4	10646854	10649043	BolC4t22990H	0	+	1198	2166	2189	0.9894929
C4	10650185	10653150	BolC4t22991H	0	+	2285	2965	2965	1.0000000
C4	10654396	10655647	BolC4t22992H	0	+	570	1195	1251	0.9552358
C4	10670579	10670870	BolC4t22993H	0	+	212	291	291	1.0000000
C4	10679314	10683716	BolC4t22994H	0	+	1798	4062	4402	0.9227624
C4	10684967	10686292	BolC4t22995H	0	+	1448	1323	1325	0.9984906
C4	10695970	10697771	BolC4t22996H	0	-	1023	1659	1801	0.9211549
C4	10704509	10705125	BolC4t22997H	0	-	540	616	616	1.0000000
C4	10706725	10707163	BolC4t22998H	0	-	394	438	438	1.0000000
C4	10710244	10718110	BolC4t22999H	0	-	4578	7604	7866	0.9666921
C4	10725499	10727617	BolC4t23000H	0	+	902	1984	2118	0.9367328
C4	10741161	10742779	BolC4t23001H	0	+	209	1547	1618	0.9561186
C4	10761128	10763279	BolC4t23002H	0	+	677	2083	2151	0.9683868
C4	10766486	10766621	BolC4t23003H	0	-	220	135	135	1.0000000
C4	10767602	10768657	BolC4t23004H	0	-	854	1055	1055	1.0000000
C4	10782072	10783937	BolC4t23005H	0	+	430	1865	1865	1.0000000
C4	10784489	10785311	BolC4t23006H	0	-	259	822	822	1.0000000
C4	10797755	10798319	BolC4t23007H	0	+	9	271	564	0.4804965
C4	10798603	10799056	BolC4t23008H	0	+	1	63	453	0.1390729
C4	10803475	10804032	BolC4t23009H	0	-	41	286	557	0.5134650
C4	10818241	10818650	BolC4t23010H	0	+	280	409	409	1.0000000
C4	10821187	10822416	BolC4t23011H	0	+	79	711	1229	0.5785191
C4	10828511	10829465	BolC4t23012H	0	-	288	935	954	0.9800839
C4	10839133	10839793	BolC4t23013H	0	-	367	660	660	1.0000000
C4	10850981	10853919	BolC4t23014H	0	-	714	2651	2938	0.9023145
C4	10854038	10854653	BolC4t23015H	0	-	519	615	615	1.0000000
C4	10864932	10865286	BolC4t23016H	0	-	76	354	354	1.0000000
C4	10867999	10870449	BolC4t23017H	0	+	907	2298	2450	0.9379592
C4	10871482	10873937	BolC4t23018H	0	+	1430	2455	2455	1.0000000
C4	10877475	10878044	BolC4t23019H	0	+	81	466	569	0.8189807
C4	10878832	10879084	BolC4t23020H	0	-	117	252	252	1.0000000
C4	10880762	10883108	BolC4t23021H	0	+	1629	2346	2346	1.0000000
C4	10883512	10889575	BolC4t23022H	0	-	2625	4668	6063	0.7699159
C4	10885406	10885950	BolC4t23023H	0	-	203	544	544	1.0000000
C4	10886310	10916238	BolC4t23024H	0	+	7018	21218	29928	0.7089682
C4	10918157	10918526	BolC4t23025H	0	-	710	369	369	1.0000000
C4	10927854	10928931	BolC4t23026H	0	-	499	1077	1077	1.0000000
C4	10954896	10955216	BolC4t23027H	0	-	105	320	320	1.0000000
C4	10959438	10959798	BolC4t23028H	0	-	357	360	360	1.0000000
C4	10969550	10975994	BolC4t23029H	0	+	4016	6368	6444	0.9882061
C4	10976342	10978645	BolC4t23030H	0	-	1207	2303	2303	1.0000000
C4	10991032	10993510	BolC4t23031H	0	-	1401	2478	2478	1.0000000
C4	11015349	11016953	BolC4t23032H	0	-	456	1488	1604	0.9276808
C4	11019518	11020650	BolC4t23033H	0	+	94	342	1132	0.3021201
C4	11021523	11021991	BolC4t23034H	0	+	519	468	468	1.0000000
C4	11024829	11025703	BolC4t23035H	0	+	579	812	874	0.9290618
C4	11033294	11034806	BolC4t23036H	0	+	647	1512	1512	1.0000000
C4	11038127	11039458	BolC4t23037H	0	-	655	1331	1331	1.0000000
C4	11040175	11041806	BolC4t23038H	0	-	1106	1631	1631	1.0000000
C4	11042427	11043228	BolC4t23039H	0	+	151	801	801	1.0000000
C4	11043884	11045148	BolC4t23040H	0	-	967	1264	1264	1.0000000
C4	11045223	11046164	BolC4t23041H	0	-	967	941	941	1.0000000
C4	11046911	11048836	BolC4t23042H	0	-	558	1925	1925	1.0000000
C4	11051763	11053090	BolC4t23043H	0	+	295	1304	1327	0.9826677
C4	11053920	11054388	BolC4t23044H	0	+	56	375	468	0.8012820
C4	11057001	11058128	BolC4t23045H	0	+	419	1099	1127	0.9751553
C4	11062105	11069281	BolC4t23046H	0	-	3979	7149	7176	0.9962375
C4	11072322	11078043	BolC4t23047H	0	-	2900	5648	5721	0.9872400
C4	11090980	11093037	BolC4t23048H	0	-	406	1748	2057	0.8497812
C4	11110660	11111044	BolC4t23049H	0	+	148	370	384	0.9635417
C4	11114182	11114380	BolC4t23050H	0	+	376	198	198	1.0000000
C4	11116360	11119111	BolC4t23051H	0	+	902	2682	2751	0.9749182
C4	11124226	11124418	BolC4t23052H	0	-	126	192	192	1.0000000
C4	11126670	11128419	BolC4t23053H	0	+	638	1720	1749	0.9834191
C4	11131294	11131480	BolC4t23054H	0	+	139	186	186	1.0000000
C4	11135602	11135930	BolC4t23055H	0	-	1	108	328	0.3292683
C4	11137015	11138771	BolC4t23056H	0	+	219	1703	1756	0.9698178
C4	11142523	11142851	BolC4t23057H	0	-	1	51	328	0.1554878
C4	11155601	11156484	BolC4t23058H	0	+	675	883	883	1.0000000
C4	11168656	11170961	BolC4t23059H	0	-	1890	2305	2305	1.0000000
C4	11171338	11172535	BolC4t23060H	0	+	640	1197	1197	1.0000000
C4	11173361	11175208	BolC4t23061H	0	-	576	1736	1847	0.9399025
C4	11179141	11179378	BolC4t23062H	0	-	10	204	237	0.8607595
C4	11190690	11190915	BolC4t23063H	0	-	13	67	225	0.2977778
C4	11191567	11199606	BolC4t23064H	0	-	4565	7376	8039	0.9175271
C4	11200983	11215607	BolC4t23065H	0	-	5022	11552	14624	0.7899343
C4	11204531	11205674	BolC4t23066H	0	+	444	1039	1143	0.9090114
C4	11222126	11224587	BolC4t23067H	0	-	2065	2461	2461	1.0000000
C4	11238833	11240294	BolC4t23068H	0	+	242	830	1461	0.5681040
C4	11245261	11245450	BolC4t23069H	0	+	118	178	189	0.9417989
C4	11245872	11246449	BolC4t23070H	0	-	279	577	577	1.0000000
C4	11261625	11263101	BolC4t23071H	0	+	302	1301	1476	0.8814363
C4	11263680	11265441	BolC4t23072H	0	-	1231	1761	1761	1.0000000
C4	11266548	11267420	BolC4t23073H	0	-	540	872	872	1.0000000
C4	11271566	11276166	BolC4t23074H	0	+	1850	4404	4600	0.9573913
C4	11276663	11277670	BolC4t23075H	0	-	716	961	1007	0.9543198
C4	11287467	11288683	BolC4t23076H	0	-	188	459	1216	0.3774671
C4	11291173	11293322	BolC4t23077H	0	+	864	2039	2149	0.9488134
C4	11296785	11299309	BolC4t23078H	0	+	1286	2524	2524	1.0000000
C4	11302545	11303861	BolC4t23079H	0	+	318	899	1316	0.6831307
C4	11312472	11315180	BolC4t23080H	0	+	1024	2564	2708	0.9468243
C4	11315856	11317802	BolC4t23081H	0	-	1461	1851	1946	0.9511819
C4	11320093	11321341	BolC4t23082H	0	+	1020	1248	1248	1.0000000
C4	11322573	11326633	BolC4t23083H	0	+	2182	3760	4060	0.9261084
C4	11335600	11343477	BolC4t23084H	0	-	2865	7203	7877	0.9144344
C4	11351576	11352730	BolC4t23085H	0	+	26	726	1154	0.6291161
C4	11353317	11360992	BolC4t23086H	0	+	1937	6323	7675	0.8238437
C4	11365411	11376222	BolC4t23087H	0	+	2777	6740	10811	0.6234391
C4	11376439	11376667	BolC4t23088H	0	+	105	228	228	1.0000000
C4	11386871	11388449	BolC4t23089H	0	+	497	1327	1578	0.8409379
C4	11430819	11433455	BolC4t23090H	0	+	782	2150	2636	0.8156297
C4	11460074	11460915	BolC4t23091H	0	+	566	805	841	0.9571938
C4	11461601	11462337	BolC4t23092H	0	-	95	736	736	1.0000000
C4	11463265	11466406	BolC4t23093H	0	+	769	2387	3141	0.7599491
C4	11468339	11468877	BolC4t23094H	0	+	296	537	538	0.9981413
C4	11471307	11471834	BolC4t23095H	0	-	570	527	527	1.0000000
C4	11483942	11484767	BolC4t23096H	0	-	1108	825	825	1.0000000
C4	11489607	11491075	BolC4t23097H	0	+	60	841	1468	0.5728883
C4	11506653	11506854	BolC4t23098H	0	-	171	201	201	1.0000000
C4	11508803	11509400	BolC4t23099H	0	-	1	93	597	0.1557789
C4	11509395	11510547	BolC4t23100H	0	-	195	442	1152	0.3836806
C4	11510741	11512490	BolC4t23101H	0	-	429	1749	1749	1.0000000
C4	11516017	11519018	BolC4t23102H	0	+	42	958	3001	0.3192269
C4	11532304	11535681	BolC4t23103H	0	-	2052	3093	3377	0.9159017
C4	11536719	11536929	BolC4t23104H	0	-	3	42	210	0.2000000
C4	11540354	11542040	BolC4t23105H	0	-	1	143	1686	0.0848161
C4	11542386	11544871	BolC4t23106H	0	-	1641	2433	2485	0.9790744
C4	11549504	11550309	BolC4t23107H	0	+	372	805	805	1.0000000
C4	11557812	11558415	BolC4t23108H	0	+	8	540	603	0.8955224
C4	11566881	11567214	BolC4t23109H	0	-	64	236	333	0.7087087
C4	11580233	11582418	BolC4t23110H	0	-	21	692	2185	0.3167048
C4	11582491	11582732	BolC4t23111H	0	-	5	95	241	0.3941909
C4	11599841	11600228	BolC4t23112H	0	-	14	294	387	0.7596899
C4	11602066	11603174	BolC4t23113H	0	+	586	1095	1108	0.9882671
C4	11603381	11604730	BolC4t23114H	0	-	650	1325	1349	0.9822090
C4	11604990	11605725	BolC4t23115H	0	+	593	735	735	1.0000000
C4	11606237	11606804	BolC4t23116H	0	-	122	523	567	0.9223986
C4	11607468	11610055	BolC4t23117H	0	+	1540	2587	2587	1.0000000
C4	11617646	11618985	BolC4t23118H	0	+	362	1246	1339	0.9305452
C4	11620323	11621721	BolC4t23119H	0	-	408	1283	1398	0.9177396
C4	11626200	11629119	BolC4t23120H	0	-	770	2822	2919	0.9667695
C4	11641654	11643206	BolC4t23121H	0	+	1342	1552	1552	1.0000000
C4	11644134	11645705	BolC4t23122H	0	-	604	1554	1571	0.9891789
C4	11649273	11651278	BolC4t23123H	0	+	1594	2005	2005	1.0000000
C4	11652707	11654187	BolC4t23124H	0	+	483	1374	1480	0.9283784
C4	11662615	11667071	BolC4t23125H	0	+	794	2725	4456	0.6115350
C4	11679313	11679759	BolC4t23126H	0	-	3	231	446	0.5179372
C4	11681771	11684181	BolC4t23127H	0	+	706	2162	2410	0.8970954
C4	11684768	11685544	BolC4t23128H	0	-	942	776	776	1.0000000
C4	11686697	11687849	BolC4t23129H	0	-	736	1117	1152	0.9696181
C4	11701874	11705492	BolC4t23130H	0	-	1386	3521	3618	0.9731896
C4	11707408	11708340	BolC4t23131H	0	-	14	310	932	0.3326180
C4	11715524	11716749	BolC4t23132H	0	+	418	1051	1225	0.8579592
C4	11718141	11719050	BolC4t23133H	0	+	439	909	909	1.0000000
C4	11719253	11720345	BolC4t23134H	0	-	485	1022	1092	0.9358974
C4	11720950	11722484	BolC4t23135H	0	-	932	1441	1534	0.9393742
C4	11723158	11724422	BolC4t23136H	0	-	397	1217	1264	0.9628165
C4	11727062	11728061	BolC4t23137H	0	+	499	999	999	1.0000000
C4	11728582	11729418	BolC4t23138H	0	-	212	836	836	1.0000000
C4	11739449	11742049	BolC4t23139H	0	+	270	1957	2600	0.7526923
C4	11763083	11764614	BolC4t23140H	0	+	550	1531	1531	1.0000000
C4	11765044	11766711	BolC4t23141H	0	-	539	1667	1667	1.0000000
C4	11770156	11770261	BolC4t23142H	0	-	14	69	105	0.6571429
C4	11780105	11795082	BolC4t23143H	0	-	12040	14858	14977	0.9920545
C4	11797658	11797823	BolC4t23144H	0	-	490	165	165	1.0000000
C4	11809771	11814397	BolC4t23145H	0	+	1491	3785	4626	0.8182015
C4	11820135	11821744	BolC4t23146H	0	+	451	1316	1609	0.8178993
C4	11831187	11831615	BolC4t23147H	0	+	422	428	428	1.0000000
C4	11831622	11832921	BolC4t23148H	0	+	758	1299	1299	1.0000000
C4	11836219	11836506	BolC4t23149H	0	+	1	110	287	0.3832753
C4	11840302	11841844	BolC4t23150H	0	-	37	875	1542	0.5674449
C4	11882115	11884779	BolC4t23151H	0	+	126	1072	2664	0.4024024
C4	11889072	11890767	BolC4t23152H	0	-	753	1332	1695	0.7858407
C4	11899792	11901400	BolC4t23153H	0	+	733	1571	1608	0.9769900
C4	11903641	11913061	BolC4t23154H	0	+	4689	9321	9420	0.9894904
C4	11916523	11917209	BolC4t23155H	0	+	1	44	686	0.0641399
C4	11917584	11918220	BolC4t23156H	0	+	149	357	636	0.5613208
C4	11960171	11960372	BolC4t23157H	0	+	251	180	201	0.8955224
C4	11962527	11965876	BolC4t23158H	0	+	761	2986	3349	0.8916094
C4	11966441	11967560	BolC4t23159H	0	-	45	508	1119	0.4539768
C4	11984337	12006800	BolC4t23160H	0	-	4664	14378	22463	0.6400748
C4	12012020	12012374	BolC4t23161H	0	+	189	354	354	1.0000000
C4	12015848	12016417	BolC4t23162H	0	-	7	269	569	0.4727592
C4	12017074	12021873	BolC4t23163H	0	-	316	3208	4799	0.6684726
C4	12034914	12037597	BolC4t23164H	0	+	1420	2223	2683	0.8285502
C4	12051036	12053037	BolC4t23165H	0	-	215	1582	2001	0.7906047
C4	12142620	12143064	BolC4t23166H	0	-	299	444	444	1.0000000
C4	12147134	12177970	BolC4t23167H	0	-	14112	30176	30836	0.9785964
C4	12159078	12159526	BolC4t23168H	0	+	312	448	448	1.0000000
C4	12160684	12161202	BolC4t23169H	0	+	197	518	518	1.0000000
C4	12163001	12163635	BolC4t23170H	0	+	290	634	634	1.0000000
C4	12164902	12165265	BolC4t23171H	0	-	347	363	363	1.0000000
C4	12166398	12168923	BolC4t23172H	0	-	1029	2427	2525	0.9611881
C4	12169868	12170178	BolC4t23173H	0	-	217	310	310	1.0000000
C4	12178741	12179042	BolC4t23174H	0	-	330	301	301	1.0000000
C4	12191812	12192099	BolC4t23175H	0	+	63	287	287	1.0000000
C4	12192259	12192472	BolC4t23176H	0	+	40	209	213	0.9812207
C4	12196824	12197128	BolC4t23177H	0	-	207	304	304	1.0000000
C4	12201716	12204547	BolC4t23178H	0	-	1655	2830	2831	0.9996468
C4	12208722	12210089	BolC4t23179H	0	+	870	1367	1367	1.0000000
C4	12210434	12212185	BolC4t23180H	0	-	1453	1751	1751	1.0000000
C4	12218111	12219368	BolC4t23181H	0	-	72	1097	1257	0.8727128
C4	12233644	12234061	BolC4t23182H	0	+	265	417	417	1.0000000
C4	12235394	12235981	BolC4t23183H	0	+	106	587	587	1.0000000
C4	12240919	12246983	BolC4t23184H	0	+	1356	4097	6064	0.6756266
C4	12252264	12252533	BolC4t23185H	0	+	0	0	269	0.0000000
C4	12254998	12256317	BolC4t23186H	0	+	764	1319	1319	1.0000000
C4	12257025	12260921	BolC4t23187H	0	+	539	3326	3896	0.8536961
C4	12266602	12277484	BolC4t23188H	0	-	4155	8546	10882	0.7853336
C4	12294073	12296006	BolC4t23189H	0	-	586	1932	1933	0.9994827
C4	12307661	12309886	BolC4t23190H	0	-	633	1376	2225	0.6184270
C4	12314881	12317299	BolC4t23191H	0	-	1009	2189	2418	0.9052936
C4	12320069	12324106	BolC4t23192H	0	-	548	2625	4037	0.6502353
C4	12324209	12374001	BolC4t23193H	0	-	10570	32312	49792	0.6489396
C4	12358785	12359898	BolC4t23194H	0	+	1	23	1113	0.0206649
C4	12376854	12378842	BolC4t23195H	0	+	299	1484	1988	0.7464789
C4	12379269	12380860	BolC4t23196H	0	-	501	1553	1591	0.9761156
C4	12379269	12386793	BolC4t23197H	0	-	2110	4562	7524	0.6063264
C4	12388106	12397568	BolC4t23198H	0	+	3556	6169	9462	0.6519763
C4	12407840	12410665	BolC4t23199H	0	-	1509	2665	2825	0.9433628
C4	12411449	12414476	BolC4t23200H	0	-	1146	2693	3027	0.8896597
C4	12425773	12427811	BolC4t23201H	0	+	1344	2033	2038	0.9975466
C4	12428014	12428813	BolC4t23202H	0	-	573	750	799	0.9386733
C4	12430207	12430393	BolC4t23203H	0	+	4	186	186	1.0000000
C4	12430933	12431071	BolC4t23204H	0	+	0	0	138	0.0000000
C4	12431324	12431843	BolC4t23205H	0	+	0	0	519	0.0000000
C4	12444774	12445313	BolC4t23206H	0	+	156	354	539	0.6567718
C4	12446183	12449270	BolC4t23207H	0	+	1156	2382	3087	0.7716230
C4	12450228	12453167	BolC4t23208H	0	-	1975	2425	2939	0.8251106
C4	12456264	12456517	BolC4t23209H	0	+	16	125	253	0.4940712
C4	12460289	12460711	BolC4t23210H	0	+	336	422	422	1.0000000
C4	12474729	12478719	BolC4t23211H	0	-	2013	3630	3990	0.9097744
C4	12479307	12480302	BolC4t23212H	0	+	664	995	995	1.0000000
C4	12495049	12497468	BolC4t23213H	0	+	1736	2419	2419	1.0000000
C4	12503453	12506121	BolC4t23214H	0	+	1835	2668	2668	1.0000000
C4	12506871	12510451	BolC4t23215H	0	-	1952	3377	3580	0.9432961
C4	12511493	12511724	BolC4t23216H	0	+	125	212	231	0.9177489
C4	12512627	12518908	BolC4t23217H	0	-	1268	4711	6281	0.7500398
C4	12528334	12544518	BolC4t23218H	0	-	647	6393	16184	0.3950198
C4	12530786	12531748	BolC4t23219H	0	-	0	0	962	0.0000000
C4	12536408	12538022	BolC4t23220H	0	+	132	821	1614	0.5086741
C4	12558356	12600078	BolC4t23221H	0	+	3713	21957	41722	0.5262691
C4	12564988	12566494	BolC4t23222H	0	-	133	1217	1506	0.8081009
C4	12595022	12596084	BolC4t23223H	0	-	1	104	1062	0.0979284
C4	12611536	12612694	BolC4t23224H	0	-	46	472	1158	0.4075993
C4	12619479	12622709	BolC4t23225H	0	-	1006	3014	3230	0.9331269
C4	12623610	12623958	BolC4t23226H	0	-	77	348	348	1.0000000
C4	12625115	12625463	BolC4t23227H	0	-	7	137	348	0.3936782
C4	12625679	12625871	BolC4t23228H	0	-	73	192	192	1.0000000
C4	12631552	12632474	BolC4t23229H	0	-	10	329	922	0.3568330
C4	12632582	12632741	BolC4t23230H	0	-	0	0	159	0.0000000
C4	12634127	12634862	BolC4t23231H	0	-	15	424	735	0.5768707
C4	12639803	12640075	BolC4t23232H	0	+	346	272	272	1.0000000
C4	12642474	12643109	BolC4t23233H	0	-	264	628	635	0.9889764
C4	12644055	12645892	BolC4t23234H	0	+	54	828	1837	0.4507349
C4	12646064	12646579	BolC4t23235H	0	+	12	170	515	0.3300971
C4	12649632	12650608	BolC4t23236H	0	+	632	976	976	1.0000000
C4	12651334	12651580	BolC4t23237H	0	+	102	246	246	1.0000000
C4	12655397	12656909	BolC4t23238H	0	-	520	1479	1512	0.9781746
C4	12667441	12668381	BolC4t23239H	0	-	32	676	940	0.7191489
C4	12671044	12677457	BolC4t23240H	0	-	2464	5172	6413	0.8064868
C4	12690035	12691605	BolC4t23241H	0	-	53	1106	1570	0.7044586
C4	12693527	12695647	BolC4t23242H	0	-	45	439	2120	0.2070755
C4	12706260	12706883	BolC4t23243H	0	-	27	312	623	0.5008026
C4	12719033	12719592	BolC4t23244H	0	-	881	559	559	1.0000000
C4	12725043	12725550	BolC4t23245H	0	+	121	485	507	0.9566075
C4	12727001	12731899	BolC4t23246H	0	-	1986	4622	4898	0.9436505
C4	12734757	12735786	BolC4t23247H	0	-	0	0	1029	0.0000000
C4	12736950	12747121	BolC4t23248H	0	+	3196	8108	10171	0.7971684
C4	12737501	12740677	BolC4t23249H	0	-	909	2840	3176	0.8942065
C4	12742419	12743362	BolC4t23250H	0	-	2	37	943	0.0392365
C4	12748638	12750134	BolC4t23251H	0	-	1341	1496	1496	1.0000000
C4	12756024	12759925	BolC4t23252H	0	-	1435	3762	3901	0.9643681
C4	12771231	12773877	BolC4t23253H	0	+	2812	2646	2646	1.0000000
C4	12774391	12776106	BolC4t23254H	0	-	1328	1638	1715	0.9551020
C4	12785923	12786094	BolC4t23255H	0	-	85	171	171	1.0000000
C4	12787249	12787663	BolC4t23256H	0	-	141	414	414	1.0000000
C4	12788399	12788534	BolC4t23257H	0	+	292	135	135	1.0000000
C4	12789060	12790068	BolC4t23258H	0	-	137	948	1008	0.9404762
C4	12806895	12808532	BolC4t23259H	0	+	2011	1637	1637	1.0000000
C4	12809100	12812817	BolC4t23260H	0	+	1978	3405	3717	0.9160613
C4	12813023	12814323	BolC4t23261H	0	-	1312	1300	1300	1.0000000
C4	12815765	12816121	BolC4t23262H	0	+	18	293	356	0.8230337
C4	12817549	12820856	BolC4t23263H	0	-	1713	3057	3307	0.9244028
C4	12855807	12858496	BolC4t23264H	0	-	4035	2689	2689	1.0000000
C4	12860020	12862307	BolC4t23265H	0	+	966	2287	2287	1.0000000
C4	12869757	12870855	BolC4t23266H	0	+	406	1098	1098	1.0000000
C4	12873124	12874456	BolC4t23267H	0	+	273	913	1332	0.6854354
C4	12879906	12880818	BolC4t23268H	0	-	1177	912	912	1.0000000
C4	12889293	12889458	BolC4t23269H	0	+	304	165	165	1.0000000
C4	12899949	12901924	BolC4t23270H	0	+	635	1561	1975	0.7903798
C4	12904382	12905295	BolC4t23271H	0	-	967	913	913	1.0000000
C4	12906826	12908954	BolC4t23272H	0	-	1367	1944	2128	0.9135338
C4	12913209	12915682	BolC4t23273H	0	-	1299	2473	2473	1.0000000
C4	12922488	12923918	BolC4t23274H	0	-	386	1249	1430	0.8734266
C4	12943438	12946661	BolC4t23275H	0	+	2676	3223	3223	1.0000000
C4	12947102	12950431	BolC4t23276H	0	-	2375	3329	3329	1.0000000
C4	12958534	12966416	BolC4t23277H	0	+	2831	7328	7882	0.9297132
C4	12967168	12967282	BolC4t23278H	0	-	118	114	114	1.0000000
C4	12967389	12970883	BolC4t23279H	0	-	1680	3235	3494	0.9258729
C4	12983487	12984282	BolC4t23280H	0	-	70	325	795	0.4088050
C4	12985105	12986831	BolC4t23281H	0	-	1132	1726	1726	1.0000000
C4	12989220	12990019	BolC4t23282H	0	-	835	799	799	1.0000000
C4	12997667	12998636	BolC4t23283H	0	+	434	955	969	0.9855521
C4	13012150	13014544	BolC4t23284H	0	+	535	2330	2394	0.9732665
C4	13015606	13016331	BolC4t23285H	0	-	97	725	725	1.0000000
C4	13041534	13043673	BolC4t23286H	0	-	779	1610	2139	0.7526882
C4	13051740	13054119	BolC4t23287H	0	-	2106	2379	2379	1.0000000
C4	13055029	13058617	BolC4t23288H	0	-	1905	3567	3588	0.9941472
C4	13059419	13062374	BolC4t23289H	0	+	2330	2939	2955	0.9945855
C4	13065574	13072138	BolC4t23290H	0	+	2199	6316	6564	0.9622182
C4	13073062	13075246	BolC4t23291H	0	+	1204	2169	2184	0.9931319
C4	13075859	13076211	BolC4t23292H	0	-	265	352	352	1.0000000
C4	13087505	13087850	BolC4t23293H	0	+	98	345	345	1.0000000
C4	13088484	13089291	BolC4t23294H	0	+	706	807	807	1.0000000
C4	13101311	13101416	BolC4t23295H	0	+	164	105	105	1.0000000
C4	13119196	13119741	BolC4t23296H	0	+	0	0	545	0.0000000
C4	13135896	13137366	BolC4t23297H	0	-	497	1309	1470	0.8904762
C4	13156161	13157853	BolC4t23298H	0	+	156	1516	1692	0.8959811
C4	13165853	13166564	BolC4t23299H	0	-	278	677	711	0.9521800
C4	13169387	13170352	BolC4t23300H	0	-	754	965	965	1.0000000
C4	13171396	13172888	BolC4t23301H	0	+	700	1492	1492	1.0000000
C4	13173954	13174785	BolC4t23302H	0	+	114	425	831	0.5114320
C4	13179724	13182017	BolC4t23303H	0	-	841	2293	2293	1.0000000
C4	13187518	13190348	BolC4t23304H	0	+	1731	2694	2830	0.9519435
C4	13192149	13194419	BolC4t23305H	0	-	1146	2270	2270	1.0000000
C4	13199924	13200479	BolC4t23306H	0	+	150	555	555	1.0000000
C4	13201077	13213304	BolC4t23307H	0	-	1234	6279	12227	0.5135356
C4	13218608	13219461	BolC4t23308H	0	-	1250	853	853	1.0000000
C4	13244874	13245597	BolC4t23309H	0	-	88	723	723	1.0000000
C4	13262281	13267704	BolC4t23310H	0	+	3176	5131	5423	0.9461553
C4	13267926	13271908	BolC4t23311H	0	-	3092	3982	3982	1.0000000
C4	13275201	13276712	BolC4t23312H	0	+	3760	1511	1511	1.0000000
C4	13279704	13280338	BolC4t23313H	0	+	669	634	634	1.0000000
C4	13281703	13283606	BolC4t23314H	0	-	1454	1740	1903	0.9143457
C4	13284237	13294163	BolC4t23315H	0	-	6475	9684	9926	0.9756196
C4	13308258	13308744	BolC4t23316H	0	+	222	486	486	1.0000000
C4	13309351	13309645	BolC4t23317H	0	-	38	163	294	0.5544218
C4	13323772	13324290	BolC4t23318H	0	-	280	401	518	0.7741313
C4	13325012	13325318	BolC4t23319H	0	-	33	228	306	0.7450981
C4	13327202	13329249	BolC4t23320H	0	-	1033	2047	2047	1.0000000
C4	13333496	13333841	BolC4t23321H	0	-	61	332	345	0.9623188
C4	13337843	13338583	BolC4t23322H	0	+	13	208	740	0.2810811
C4	13350737	13351467	BolC4t23323H	0	-	706	730	730	1.0000000
C4	13353442	13354657	BolC4t23324H	0	+	2	21	1215	0.0172840
C4	13360860	13364069	BolC4t23325H	0	+	205	703	3209	0.2190714
C4	13376066	13376240	BolC4t23326H	0	+	53	174	174	1.0000000
C4	13377910	13379181	BolC4t23327H	0	-	1707	1271	1271	1.0000000
C4	13390473	13393875	BolC4t23328H	0	+	1397	3215	3402	0.9450324
C4	13425791	13428480	BolC4t23329H	0	-	2798	2689	2689	1.0000000
C4	13457340	13457700	BolC4t23330H	0	-	422	360	360	1.0000000
C4	13476771	13477203	BolC4t23331H	0	-	746	432	432	1.0000000
C4	13481750	13481960	BolC4t23332H	0	+	0	0	210	0.0000000
C4	13482928	13483618	BolC4t23333H	0	+	104	665	690	0.9637681
C4	13484444	13484809	BolC4t23334H	0	+	651	365	365	1.0000000
C4	13488610	13490122	BolC4t23335H	0	+	503	1512	1512	1.0000000
C4	13492124	13494376	BolC4t23336H	0	+	1947	2252	2252	1.0000000
C4	13494922	13495897	BolC4t23337H	0	-	288	975	975	1.0000000
C4	13504840	13525492	BolC4t23338H	0	+	7258	16403	20652	0.7942572
C4	13505708	13506419	BolC4t23339H	0	-	506	711	711	1.0000000
C4	13528048	13530189	BolC4t23340H	0	+	1313	2141	2141	1.0000000
C4	13530984	13533482	BolC4t23341H	0	-	908	2484	2498	0.9943955
C4	13534070	13539611	BolC4t23342H	0	+	2859	5468	5541	0.9868255
C4	13540137	13544696	BolC4t23343H	0	+	980	4395	4559	0.9640272
C4	13545037	13547153	BolC4t23344H	0	-	370	1974	2116	0.9328923
C4	13549985	13553615	BolC4t23345H	0	-	1702	3382	3630	0.9316804
C4	13568425	13571713	BolC4t23346H	0	-	1971	3202	3288	0.9738443
C4	13575139	13577122	BolC4t23347H	0	-	1690	1915	1983	0.9657085
C4	13579163	13581440	BolC4t23348H	0	+	719	2277	2277	1.0000000
C4	13582372	13583379	BolC4t23349H	0	+	89	933	1007	0.9265144
C4	13588983	13589094	BolC4t23350H	0	-	10	99	111	0.8918919
C4	13590549	13594250	BolC4t23351H	0	+	2172	3658	3701	0.9883815
C4	13604644	13605432	BolC4t23352H	0	+	769	788	788	1.0000000
C4	13605912	13606746	BolC4t23353H	0	+	412	834	834	1.0000000
C4	13607908	13608349	BolC4t23354H	0	-	461	441	441	1.0000000
C4	13609107	13609716	BolC4t23355H	0	+	432	609	609	1.0000000
C4	13612667	13613479	BolC4t23356H	0	-	408	812	812	1.0000000
C4	13618192	13618438	BolC4t23357H	0	-	79	246	246	1.0000000
C4	13623177	13623294	BolC4t23358H	0	+	51	117	117	1.0000000
C4	13642211	13642415	BolC4t23359H	0	+	131	204	204	1.0000000
C4	13658124	13658307	BolC4t23360H	0	-	396	183	183	1.0000000
C4	13687563	13687898	BolC4t23361H	0	+	108	254	335	0.7582089
C4	13688838	13689180	BolC4t23362H	0	-	269	342	342	1.0000000
C4	13690990	13692160	BolC4t23363H	0	+	524	1170	1170	1.0000000
C4	13691419	13691869	BolC4t23364H	0	+	187	450	450	1.0000000
C4	13708208	13708601	BolC4t23365H	0	+	265	393	393	1.0000000
C4	13711707	13712826	BolC4t23366H	0	-	667	1119	1119	1.0000000
C4	13727482	13728584	BolC4t23367H	0	-	459	1102	1102	1.0000000
C4	13729097	13729778	BolC4t23368H	0	-	207	681	681	1.0000000
C4	13729960	13730370	BolC4t23369H	0	-	112	410	410	1.0000000
C4	13738817	13739577	BolC4t23370H	0	-	231	760	760	1.0000000
C4	13739786	13740619	BolC4t23371H	0	-	860	833	833	1.0000000
C4	13742013	13742995	BolC4t23372H	0	-	728	982	982	1.0000000
C4	13746187	13747297	BolC4t23373H	0	+	796	1078	1110	0.9711712
C4	13748133	13749620	BolC4t23374H	0	+	1749	1487	1487	1.0000000
C4	13765047	13765347	BolC4t23375H	0	+	3	138	300	0.4600000
C4	13767943	13769392	BolC4t23376H	0	+	1115	1376	1449	0.9496204
C4	13782026	13785899	BolC4t23377H	0	+	1403	3288	3873	0.8489543
C4	13787814	13793163	BolC4t23378H	0	+	2493	5349	5349	1.0000000
C4	13796415	13803102	BolC4t23379H	0	-	3570	6265	6687	0.9368924
C4	13806327	13807446	BolC4t23380H	0	+	462	1119	1119	1.0000000
C4	13809591	13810080	BolC4t23381H	0	-	20	167	489	0.3415133
C4	13825093	13825291	BolC4t23382H	0	-	22	113	198	0.5707071
C4	13825700	13826415	BolC4t23383H	0	+	722	715	715	1.0000000
C4	13827239	13830712	BolC4t23384H	0	-	3970	3473	3473	1.0000000
C4	13836728	13846324	BolC4t23385H	0	-	5232	7699	9596	0.8023134
C4	13860578	13860773	BolC4t23386H	0	-	1406	195	195	1.0000000
C4	13879339	13879645	BolC4t23387H	0	-	138	306	306	1.0000000
C4	13880424	13880817	BolC4t23388H	0	-	79	393	393	1.0000000
C4	13882362	13883631	BolC4t23389H	0	+	359	1237	1269	0.9747833
C4	13884612	13885656	BolC4t23390H	0	-	756	1044	1044	1.0000000
C4	13900242	13901633	BolC4t23391H	0	+	49	728	1391	0.5233645
C4	13932124	13932283	BolC4t23392H	0	+	45	159	159	1.0000000
C4	13942689	13969673	BolC4t23393H	0	-	2440	11020	26984	0.4083902
C4	13970886	13988609	BolC4t23394H	0	+	6302	14039	17723	0.7921345
C4	13985114	13987400	BolC4t23395H	0	-	535	2250	2286	0.9842520
C4	13989471	13991747	BolC4t23396H	0	-	675	2276	2276	1.0000000
C4	14013892	14014711	BolC4t23397H	0	-	532	819	819	1.0000000
C4	14015775	14019482	BolC4t23398H	0	+	966	3366	3707	0.9080119
C4	14020054	14028403	BolC4t23399H	0	+	759	3752	8349	0.4493951
C4	14020267	14021053	BolC4t23400H	0	+	181	495	786	0.6297710
C4	14020304	14048103	BolC4t23401H	0	+	4777	13943	27799	0.5015648
C4	14032049	14033415	BolC4t23402H	0	-	1421	1073	1366	0.7855051
C4	14047035	14047587	BolC4t23403H	0	+	191	516	552	0.9347826
C4	14051720	14052876	BolC4t23404H	0	+	191	1109	1156	0.9593425
C4	14054037	14054871	BolC4t23405H	0	-	38	464	834	0.5563549
C4	14062888	14064320	BolC4t23406H	0	+	275	1424	1432	0.9944134
C4	14067976	14068141	BolC4t23407H	0	+	0	0	165	0.0000000
C4	14069180	14070170	BolC4t23408H	0	+	1	125	990	0.1262626
C4	14097403	14097904	BolC4t23409H	0	-	5	197	501	0.3932136
C4	14103060	14103462	BolC4t23410H	0	-	96	395	402	0.9825870
C4	14124015	14124180	BolC4t23411H	0	+	4	53	165	0.3212121
C4	14125217	14126204	BolC4t23412H	0	+	0	0	987	0.0000000
C4	14136216	14137536	BolC4t23413H	0	+	27	424	1320	0.3212121
C4	14153776	14153902	BolC4t23414H	0	+	30	56	126	0.4444444
C4	14154090	14154603	BolC4t23415H	0	+	32	208	513	0.4054581
C4	14160188	14160434	BolC4t23416H	0	+	0	0	246	0.0000000
C4	14178487	14179416	BolC4t23417H	0	+	464	929	929	1.0000000
C4	14183865	14184591	BolC4t23418H	0	-	29	325	726	0.4476584
C4	14185960	14193613	BolC4t23419H	0	+	340	2502	7653	0.3269306
C4	14194403	14195021	BolC4t23420H	0	+	8	295	618	0.4773463
C4	14195899	14196064	BolC4t23421H	0	+	133	145	165	0.8787879
C4	14197182	14199759	BolC4t23422H	0	+	328	1015	2577	0.3938688
C4	14206061	14208828	BolC4t23423H	0	+	1465	2767	2767	1.0000000
C4	14212809	14215724	BolC4t23424H	0	+	722	2714	2915	0.9310463
C4	14215970	14216996	BolC4t23425H	0	-	505	1026	1026	1.0000000
C4	14217896	14219291	BolC4t23426H	0	-	687	1395	1395	1.0000000
C4	14221847	14223990	BolC4t23427H	0	-	137	1438	2143	0.6710219
C4	14231988	14233417	BolC4t23428H	0	+	430	1254	1429	0.8775367
C4	14236929	14238842	BolC4t23429H	0	-	1095	1910	1913	0.9984318
C4	14242450	14242872	BolC4t23430H	0	-	139	422	422	1.0000000
C4	14245245	14245810	BolC4t23431H	0	-	4	191	565	0.3380531
C4	14245929	14246375	BolC4t23432H	0	-	0	0	446	0.0000000
C4	14292437	14292689	BolC4t23433H	0	+	82	252	252	1.0000000
C4	14296960	14297306	BolC4t23434H	0	-	80	346	346	1.0000000
C4	14299390	14300996	BolC4t23435H	0	-	13	532	1606	0.3312578
C4	14308470	14313738	BolC4t23436H	0	+	2388	5077	5268	0.9637433
C4	14314081	14314736	BolC4t23437H	0	-	432	554	655	0.8458015
C4	14316243	14316811	BolC4t23438H	0	-	262	568	568	1.0000000
C4	14316845	14318992	BolC4t23439H	0	-	1149	2147	2147	1.0000000
C4	14331569	14331905	BolC4t23440H	0	+	489	336	336	1.0000000
C4	14332822	14338237	BolC4t23441H	0	-	623	2059	5415	0.3802401
C4	14346798	14346969	BolC4t23442H	0	+	72	171	171	1.0000000
C4	14375709	14376005	BolC4t23443H	0	+	209	296	296	1.0000000
C4	14382160	14382808	BolC4t23444H	0	+	110	539	648	0.8317901
C4	14405445	14407865	BolC4t23445H	0	-	1219	2365	2420	0.9772727
C4	14408227	14410041	BolC4t23446H	0	+	1074	1793	1814	0.9884233
C4	14413728	14415065	BolC4t23447H	0	+	11	380	1337	0.2842184
C4	14416041	14418814	BolC4t23448H	0	-	380	2480	2773	0.8943383
C4	14429041	14429206	BolC4t23449H	0	+	37	165	165	1.0000000
C4	14431672	14433129	BolC4t23450H	0	+	691	1286	1457	0.8826355
C4	14438411	14439199	BolC4t23451H	0	+	240	788	788	1.0000000
C4	14445906	14447377	BolC4t23452H	0	+	1482	1471	1471	1.0000000
C4	14449849	14450041	BolC4t23453H	0	+	229	192	192	1.0000000
C4	14460259	14460982	BolC4t23454H	0	-	4	85	723	0.1175657
C4	14476100	14476889	BolC4t23455H	0	+	134	760	789	0.9632446
C4	14529230	14530516	BolC4t23456H	0	-	1745	1286	1286	1.0000000
C4	14545298	14547829	BolC4t23457H	0	+	1107	2525	2531	0.9976294
C4	14558425	14561070	BolC4t23458H	0	+	1617	2258	2645	0.8536862
C4	14564742	14565123	BolC4t23459H	0	+	0	0	381	0.0000000
C4	14577839	14578441	BolC4t23460H	0	+	963	602	602	1.0000000
C4	14583253	14585702	BolC4t23461H	0	-	2217	2449	2449	1.0000000
C4	14586826	14587961	BolC4t23462H	0	+	942	1135	1135	1.0000000
C4	14599764	14600502	BolC4t23463H	0	+	295	738	738	1.0000000
C4	14627490	14627595	BolC4t23464H	0	+	49	105	105	1.0000000
C4	14627792	14630961	BolC4t23465H	0	+	1345	3140	3169	0.9908488
C4	14632215	14633379	BolC4t23466H	0	+	471	1047	1164	0.8994845
C4	14635477	14637014	BolC4t23467H	0	+	1075	1537	1537	1.0000000
C4	14642255	14642655	BolC4t23468H	0	+	129	362	400	0.9050000
C4	14643248	14644756	BolC4t23469H	0	+	63	730	1508	0.4840849
C4	14645576	14650175	BolC4t23470H	0	+	6166	4364	4599	0.9489020
C4	14651074	14651356	BolC4t23471H	0	-	641	282	282	1.0000000
C4	14651807	14653368	BolC4t23472H	0	-	2987	1561	1561	1.0000000
C4	14658608	14658857	BolC4t23473H	0	-	5	95	249	0.3815261
C4	14725281	14725947	BolC4t23474H	0	+	173	666	666	1.0000000
C4	14733188	14733920	BolC4t23475H	0	+	163	732	732	1.0000000
C4	14745400	14748380	BolC4t23476H	0	-	1859	2843	2980	0.9540268
C4	14760053	14760389	BolC4t23477H	0	-	0	0	336	0.0000000
C4	14762706	14763702	BolC4t23478H	0	-	10	416	996	0.4176707
C4	14764435	14764741	BolC4t23479H	0	-	7	74	306	0.2418301
C4	14795088	14795691	BolC4t23480H	0	-	148	548	603	0.9087894
C4	14801118	14802641	BolC4t23481H	0	+	619	1479	1523	0.9711096
C4	14803171	14803372	BolC4t23482H	0	+	163	201	201	1.0000000
C4	14814651	14827526	BolC4t23483H	0	+	4643	12686	12875	0.9853204
C4	14830470	14830876	BolC4t23484H	0	-	386	406	406	1.0000000
C4	14842912	14844067	BolC4t23485H	0	+	1096	1155	1155	1.0000000
C4	14844395	14846848	BolC4t23486H	0	-	375	2170	2453	0.8846310
C4	14847977	14849880	BolC4t23487H	0	-	596	1681	1903	0.8833421
C4	14850868	14851171	BolC4t23488H	0	-	187	303	303	1.0000000
C4	14852100	14852265	BolC4t23489H	0	+	130	165	165	1.0000000
C4	14855591	14855943	BolC4t23490H	0	-	45	352	352	1.0000000
C4	14857449	14862794	BolC4t23491H	0	-	8451	4388	5345	0.8209541
C4	14864572	14865272	BolC4t23492H	0	-	176	641	700	0.9157143
C4	14865682	14866090	BolC4t23493H	0	-	624	308	408	0.7549019
C4	14866656	14867183	BolC4t23494H	0	-	967	527	527	1.0000000
C4	14868645	14869398	BolC4t23495H	0	-	224	634	753	0.8419655
C4	14869852	14870296	BolC4t23496H	0	+	7	169	444	0.3806306
C4	14870398	14870752	BolC4t23497H	0	-	140	288	354	0.8135593
C4	14871099	14871646	BolC4t23498H	0	+	845	547	547	1.0000000
C4	14872532	14874056	BolC4t23499H	0	+	9254	1524	1524	1.0000000
C4	14882018	14882426	BolC4t23500H	0	+	4637	408	408	1.0000000
C4	14882470	14883409	BolC4t23501H	0	+	11302	939	939	1.0000000
C4	14885422	14886432	BolC4t23502H	0	+	10749	1010	1010	1.0000000
C4	14886844	14887430	BolC4t23503H	0	+	1493	563	586	0.9607509
C4	14892821	14893442	BolC4t23504H	0	-	788	621	621	1.0000000
C4	14912789	14914291	BolC4t23505H	0	+	760	1502	1502	1.0000000
C4	14926456	14927276	BolC4t23506H	0	-	116	476	820	0.5804878
C4	14942544	14945539	BolC4t23507H	0	+	2404	2995	2995	1.0000000
C4	14950813	14951652	BolC4t23508H	0	+	388	701	839	0.8355185
C4	14954201	14957282	BolC4t23509H	0	-	3270	3081	3081	1.0000000
C4	14969484	14971684	BolC4t23510H	0	+	1293	2200	2200	1.0000000
C4	14974435	14975512	BolC4t23511H	0	-	1254	1077	1077	1.0000000
C4	14980790	14980997	BolC4t23512H	0	+	12	128	207	0.6183575
C4	14999467	15003017	BolC4t23513H	0	+	3308	3357	3550	0.9456338
C4	15004510	15005552	BolC4t23514H	0	-	638	1042	1042	1.0000000
C4	15010662	15010803	BolC4t23515H	0	-	141	141	141	1.0000000
C4	15017779	15017971	BolC4t23516H	0	+	0	0	192	0.0000000
C4	15018130	15019494	BolC4t23517H	0	-	377	826	1364	0.6055719
C4	15025177	15026918	BolC4t23518H	0	-	1593	1741	1741	1.0000000
C4	15028521	15030225	BolC4t23519H	0	-	531	1470	1704	0.8626761
C4	15032310	15034707	BolC4t23520H	0	-	1387	2254	2397	0.9403421
C4	15035147	15035937	BolC4t23521H	0	-	494	790	790	1.0000000
C4	15037652	15038553	BolC4t23522H	0	-	152	716	901	0.7946726
C4	15050731	15050983	BolC4t23523H	0	-	137	252	252	1.0000000
C4	15059077	15060406	BolC4t23524H	0	+	674	1329	1329	1.0000000
C4	15060810	15063152	BolC4t23525H	0	+	528	1824	2342	0.7788215
C4	15064102	15064971	BolC4t23526H	0	-	334	869	869	1.0000000
C4	15073030	15073408	BolC4t23527H	0	+	458	378	378	1.0000000
C4	15094892	15096133	BolC4t23528H	0	-	436	1161	1241	0.9355358
C4	15099097	15102751	BolC4t23529H	0	-	1985	3150	3654	0.8620690
C4	15104873	15105268	BolC4t23530H	0	-	70	313	395	0.7924051
C4	15105614	15105978	BolC4t23531H	0	-	1	73	364	0.2005495
C4	15106702	15107148	BolC4t23532H	0	-	9	310	446	0.6950673
C4	15111350	15112046	BolC4t23533H	0	+	104	485	696	0.6968391
C4	15112332	15112506	BolC4t23534H	0	-	113	174	174	1.0000000
C4	15116374	15116653	BolC4t23535H	0	-	139	279	279	1.0000000
C4	15118884	15119193	BolC4t23536H	0	+	110	309	309	1.0000000
C4	15128843	15129885	BolC4t23537H	0	-	51	148	1042	0.1420345
C4	15131752	15145368	BolC4t23538H	0	-	1492	5350	13616	0.3929201
C4	15150977	15153671	BolC4t23539H	0	+	758	2646	2694	0.9821826
C4	15154684	15155587	BolC4t23540H	0	+	201	799	903	0.8848283
C4	15156671	15157045	BolC4t23541H	0	-	320	374	374	1.0000000
C4	15174486	15174618	BolC4t23542H	0	+	139	132	132	1.0000000
C4	15177936	15178167	BolC4t23543H	0	+	68	231	231	1.0000000
C4	15191880	15193848	BolC4t23544H	0	+	241	1591	1968	0.8084350
C4	15194500	15197039	BolC4t23545H	0	+	885	2003	2539	0.7888933
C4	15197284	15198908	BolC4t23546H	0	+	49	738	1624	0.4544335
C4	15206956	15210100	BolC4t23547H	0	+	1084	3104	3144	0.9872773
C4	15211486	15213042	BolC4t23548H	0	+	1683	1556	1556	1.0000000
C4	15213488	15214115	BolC4t23549H	0	-	558	627	627	1.0000000
C4	15228377	15229316	BolC4t23550H	0	-	419	791	939	0.8423855
C4	15230634	15232500	BolC4t23551H	0	+	1427	1859	1866	0.9962487
C4	15233039	15234260	BolC4t23552H	0	-	710	1221	1221	1.0000000
C4	15255264	15256596	BolC4t23553H	0	+	142	849	1332	0.6373874
C4	15294546	15296710	BolC4t23554H	0	+	342	1584	2164	0.7319778
C4	15300292	15305496	BolC4t23555H	0	-	1083	4012	5204	0.7709454
C4	15315805	15316156	BolC4t23556H	0	+	153	349	351	0.9943020
C4	15333069	15343328	BolC4t23557H	0	-	2155	2378	10259	0.2317965
C4	15352150	15353140	BolC4t23558H	0	-	67	233	990	0.2353535
C4	15355838	15357070	BolC4t23559H	0	+	60	742	1232	0.6022727
C4	15368398	15370220	BolC4t23560H	0	-	132	1436	1822	0.7881449
C4	15376316	15377092	BolC4t23561H	0	+	342	776	776	1.0000000
C4	15383458	15385251	BolC4t23562H	0	+	609	1757	1793	0.9799219
C4	15389315	15390608	BolC4t23563H	0	+	970	1293	1293	1.0000000
C4	15391285	15392817	BolC4t23564H	0	+	568	1321	1532	0.8622715
C4	15399327	15410320	BolC4t23565H	0	+	1474	3379	10993	0.3073774
C4	15416421	15416961	BolC4t23566H	0	-	8	228	540	0.4222222
C4	15446094	15448150	BolC4t23567H	0	+	147	1691	2056	0.8224708
C4	15449598	15451823	BolC4t23568H	0	+	1254	2225	2225	1.0000000
C4	15456705	15465017	BolC4t23569H	0	+	2344	6975	8312	0.8391482
C4	15465436	15466902	BolC4t23570H	0	-	817	1447	1466	0.9870396
C4	15482479	15484539	BolC4t23571H	0	-	290	863	2060	0.4189321
C4	15532841	15534362	BolC4t23572H	0	-	602	1332	1521	0.8757396
C4	15548393	15549175	BolC4t23573H	0	-	52	545	782	0.6969309
C4	15563305	15563759	BolC4t23574H	0	+	32	285	454	0.6277533
C4	15566414	15567034	BolC4t23575H	0	+	4	35	620	0.0564516
C4	15570923	15571079	BolC4t23576H	0	-	3	83	156	0.5320513
C4	15585059	15588699	BolC4t23577H	0	-	1157	3574	3640	0.9818681
C4	15590901	15592252	BolC4t23578H	0	+	505	1351	1351	1.0000000
C4	15597294	15598426	BolC4t23579H	0	-	300	958	1132	0.8462898
C4	15602672	15602972	BolC4t23580H	0	+	242	300	300	1.0000000
C4	15603087	15603339	BolC4t23581H	0	+	271	252	252	1.0000000
C4	15604181	15605769	BolC4t23582H	0	+	2453	1588	1588	1.0000000
C4	15611973	15612468	BolC4t23583H	0	-	180	474	495	0.9575757
C4	15614305	15618594	BolC4t23584H	0	+	403	3024	4289	0.7050595
C4	15619402	15620444	BolC4t23585H	0	-	907	1042	1042	1.0000000
C4	15652478	15652820	BolC4t23586H	0	-	415	342	342	1.0000000
C4	15658135	15660224	BolC4t23587H	0	-	741	2089	2089	1.0000000
C4	15662011	15663581	BolC4t23588H	0	-	980	1283	1570	0.8171974
C4	15674784	15676518	BolC4t23589H	0	+	740	1243	1734	0.7168397
C4	15678751	15678889	BolC4t23590H	0	+	149	138	138	1.0000000
C4	15688731	15689563	BolC4t23591H	0	+	602	832	832	1.0000000
C4	15693468	15693699	BolC4t23592H	0	+	106	231	231	1.0000000
C4	15697403	15697797	BolC4t23593H	0	+	7	163	394	0.4137056
C4	15702673	15704023	BolC4t23594H	0	+	545	1314	1350	0.9733334
C4	15732584	15736641	BolC4t23595H	0	-	1391	3947	4057	0.9728864
C4	15737690	15737939	BolC4t23596H	0	+	152	249	249	1.0000000
C4	15740917	15742408	BolC4t23597H	0	-	684	1491	1491	1.0000000
C4	15761693	15762944	BolC4t23598H	0	-	1017	1251	1251	1.0000000
C4	15766918	15770540	BolC4t23599H	0	-	1018	3115	3622	0.8600221
C4	15784309	15791181	BolC4t23600H	0	+	6070	6635	6872	0.9655122
C4	15796813	15797426	BolC4t23601H	0	-	171	613	613	1.0000000
C4	15800290	15800892	BolC4t23602H	0	+	7	123	602	0.2043189
C4	15822752	15823041	BolC4t23603H	0	+	0	0	289	0.0000000
C4	15824140	15824326	BolC4t23604H	0	+	140	186	186	1.0000000
C4	15835001	15837654	BolC4t23605H	0	+	273	1987	2653	0.7489634
C4	15848742	15848940	BolC4t23606H	0	+	19	198	198	1.0000000
C4	15856346	15860774	BolC4t23607H	0	+	1111	3492	4428	0.7886179
C4	15872784	15872961	BolC4t23608H	0	-	50	177	177	1.0000000
C4	15873132	15874721	BolC4t23609H	0	+	708	1278	1589	0.8042794
C4	15894703	15898215	BolC4t23610H	0	-	623	2481	3512	0.7064351
C4	15913483	15914709	BolC4t23611H	0	+	788	1087	1226	0.8866231
C4	15933409	15936090	BolC4t23612H	0	+	1161	2173	2681	0.8105184
C4	15941387	15942333	BolC4t23613H	0	-	263	888	946	0.9386892
C4	15948835	15951017	BolC4t23614H	0	+	20	323	2182	0.1480293
C4	15951660	15952921	BolC4t23615H	0	+	0	0	1261	0.0000000
C4	15953975	15954764	BolC4t23616H	0	+	0	0	789	0.0000000
C4	15965163	15967239	BolC4t23617H	0	-	92	1711	2076	0.8241811
C4	15967545	15968352	BolC4t23618H	0	-	184	782	807	0.9690211
C4	15968664	15969217	BolC4t23619H	0	-	69	541	553	0.9783002
C4	15978817	15986860	BolC4t23620H	0	+	205	788	8043	0.0979734
C4	15979722	15980898	BolC4t23621H	0	-	104	401	1176	0.3409864
C4	15987323	15988490	BolC4t23622H	0	-	0	0	1167	0.0000000
C4	16017376	16018264	BolC4t23623H	0	-	2196	888	888	1.0000000
C4	16017560	16018055	BolC4t23624H	0	-	1198	495	495	1.0000000
C4	16026007	16028775	BolC4t23625H	0	+	1207	2768	2768	1.0000000
C4	16038867	16039365	BolC4t23626H	0	-	333	498	498	1.0000000
C4	16044173	16049019	BolC4t23627H	0	-	345	2834	4846	0.5848122
C4	16050562	16052782	BolC4t23628H	0	-	146	563	2220	0.2536036
C4	16053864	16056573	BolC4t23629H	0	-	949	2673	2709	0.9867110
C4	16057459	16058726	BolC4t23630H	0	-	579	1267	1267	1.0000000
C4	16062623	16064140	BolC4t23631H	0	-	0	0	1517	0.0000000
C4	16083303	16084026	BolC4t23632H	0	-	415	723	723	1.0000000
C4	16088320	16089457	BolC4t23633H	0	+	68	985	1137	0.8663149
C4	16090705	16091614	BolC4t23634H	0	-	184	468	909	0.5148515
C4	16095635	16097030	BolC4t23635H	0	-	206	1329	1395	0.9526882
C4	16097848	16098286	BolC4t23636H	0	-	407	438	438	1.0000000
C4	16106926	16107132	BolC4t23637H	0	+	248	206	206	1.0000000
C4	16136721	16137549	BolC4t23638H	0	+	593	828	828	1.0000000
C4	16144018	16145977	BolC4t23639H	0	-	194	1256	1959	0.6411434
C4	16147960	16148098	BolC4t23640H	0	+	16	78	138	0.5652174
C4	16151630	16153105	BolC4t23641H	0	-	2	21	1475	0.0142373
C4	16158377	16160817	BolC4t23642H	0	+	694	2382	2440	0.9762295
C4	16161199	16164017	BolC4t23643H	0	-	1192	2725	2818	0.9669979
C4	16166768	16167057	BolC4t23644H	0	-	257	288	289	0.9965398
C4	16178566	16179407	BolC4t23645H	0	-	275	835	841	0.9928656
C4	16183292	16185749	BolC4t23646H	0	-	315	1703	2457	0.6931217
C4	16194496	16194790	BolC4t23647H	0	+	0	0	294	0.0000000
C4	16218463	16221165	BolC4t23648H	0	+	2288	2702	2702	1.0000000
C4	16233999	16234798	BolC4t23649H	0	+	520	799	799	1.0000000
C4	16235085	16235337	BolC4t23650H	0	-	100	252	252	1.0000000
C4	16236701	16237100	BolC4t23651H	0	-	235	399	399	1.0000000
C4	16240012	16240177	BolC4t23652H	0	+	22	150	165	0.9090909
C4	16242451	16244308	BolC4t23653H	0	-	504	1054	1857	0.5675821
C4	16244638	16244867	BolC4t23654H	0	-	1	9	229	0.0393013
C4	16246813	16247362	BolC4t23655H	0	+	54	453	549	0.8251366
C4	16252909	16254087	BolC4t23656H	0	+	487	1178	1178	1.0000000
C4	16254450	16257401	BolC4t23657H	0	-	895	2832	2951	0.9596747
C4	16258079	16260109	BolC4t23658H	0	+	851	1816	2030	0.8945813
C4	16260927	16261803	BolC4t23659H	0	-	760	876	876	1.0000000
C4	16262256	16263402	BolC4t23660H	0	+	531	1026	1146	0.8952879
C4	16267325	16270291	BolC4t23661H	0	-	1476	2591	2966	0.8735671
C4	16271102	16271573	BolC4t23662H	0	+	123	434	471	0.9214438
C4	16272896	16273367	BolC4t23663H	0	+	173	452	471	0.9596603
C4	16281595	16282365	BolC4t23664H	0	+	99	685	770	0.8896104
C4	16300192	16300790	BolC4t23665H	0	+	344	598	598	1.0000000
C4	16321493	16322212	BolC4t23666H	0	+	128	228	719	0.3171071
C4	16323479	16324244	BolC4t23667H	0	-	191	744	765	0.9725490
C4	16325385	16326761	BolC4t23668H	0	+	0	0	1376	0.0000000
C4	16345326	16347626	BolC4t23669H	0	-	1721	2300	2300	1.0000000
C4	16347690	16348634	BolC4t23670H	0	-	633	944	944	1.0000000
C4	16349597	16352580	BolC4t23671H	0	+	95	1477	2983	0.4951391
C4	16376653	16380134	BolC4t23672H	0	+	435	1449	3481	0.4162597
C4	16377062	16377797	BolC4t23673H	0	-	42	338	735	0.4598639
C4	16386175	16387715	BolC4t23674H	0	-	902	1540	1540	1.0000000
C4	16405644	16406447	BolC4t23675H	0	+	39	271	803	0.3374844
C4	16418961	16419729	BolC4t23676H	0	+	4	258	768	0.3359375
C4	16421687	16457233	BolC4t23677H	0	-	3848	17869	35546	0.5027007
C4	16470150	16537461	BolC4t23678H	0	+	11631	36714	67311	0.5454383
C4	16476605	16478783	BolC4t23679H	0	+	1222	2178	2178	1.0000000
C4	16482829	16483588	BolC4t23680H	0	+	211	759	759	1.0000000
C4	16486886	16487226	BolC4t23681H	0	-	240	340	340	1.0000000
C4	16493399	16541362	BolC4t23682H	0	-	4752	20738	47963	0.4323750
C4	16543198	16543884	BolC4t23683H	0	+	203	686	686	1.0000000
C4	16545680	16546130	BolC4t23684H	0	-	360	450	450	1.0000000
C4	16574688	16576211	BolC4t23685H	0	+	1168	1523	1523	1.0000000
C4	16578408	16579880	BolC4t23686H	0	+	421	1433	1472	0.9735054
C4	16582309	16583982	BolC4t23687H	0	-	428	1161	1673	0.6939629
C4	16599901	16601044	BolC4t23688H	0	-	129	856	1143	0.7489064
C4	16602186	16635270	BolC4t23689H	0	-	14870	32286	33084	0.9758795
C4	16607022	16607340	BolC4t23690H	0	-	331	318	318	1.0000000
C4	16640545	16641643	BolC4t23691H	0	-	141	621	1098	0.5655738
C4	16661618	16662588	BolC4t23692H	0	-	447	970	970	1.0000000
C4	16663424	16664520	BolC4t23693H	0	-	46	391	1096	0.3567518
C4	16666040	16667933	BolC4t23694H	0	+	593	1867	1893	0.9862652
C4	16673881	16674746	BolC4t23695H	0	-	191	865	865	1.0000000
C4	16676592	16677422	BolC4t23696H	0	+	29	63	830	0.0759036
C4	16678612	16680280	BolC4t23697H	0	-	24	861	1668	0.5161871
C4	16700580	16700881	BolC4t23698H	0	-	0	0	301	0.0000000
C4	16705220	16706352	BolC4t23699H	0	+	13	606	1132	0.5353357
C4	16708083	16708308	BolC4t23700H	0	-	0	0	225	0.0000000
C4	16722807	16726140	BolC4t23701H	0	-	886	3304	3333	0.9912992
C4	16732390	16734647	BolC4t23702H	0	+	489	1980	2257	0.8772707
C4	16756096	16756306	BolC4t23703H	0	-	17	191	210	0.9095238
C4	16771736	16776362	BolC4t23704H	0	+	1945	4388	4626	0.9485517
C4	16792038	16796592	BolC4t23705H	0	+	3068	4554	4554	1.0000000
C4	16804782	16808437	BolC4t23706H	0	+	1896	3435	3655	0.9398085
C4	16809340	16811200	BolC4t23707H	0	-	929	1796	1860	0.9655914
C4	16819914	16822005	BolC4t23708H	0	-	726	1936	2091	0.9258728
C4	16825826	16826192	BolC4t23709H	0	+	30	235	366	0.6420765
C4	16833346	16834927	BolC4t23710H	0	-	1451	1581	1581	1.0000000
C4	16848209	16848359	BolC4t23711H	0	+	47	150	150	1.0000000
C4	16848526	16848847	BolC4t23712H	0	+	40	259	321	0.8068536
C4	16853726	16856958	BolC4t23713H	0	+	760	3140	3232	0.9715347
C4	16858063	16859215	BolC4t23714H	0	-	923	1152	1152	1.0000000
C4	16869330	16873101	BolC4t23715H	0	-	1859	3739	3771	0.9915142
C4	16874187	16898889	BolC4t23716H	0	-	10082	19556	24702	0.7916768
C4	16890664	16891277	BolC4t23717H	0	-	498	613	613	1.0000000
C4	16896093	16896468	BolC4t23718H	0	-	533	375	375	1.0000000
C4	16924811	16924982	BolC4t23719H	0	+	0	0	171	0.0000000
C4	16930406	16931235	BolC4t23720H	0	+	602	829	829	1.0000000
C4	16944922	16945417	BolC4t23721H	0	+	262	495	495	1.0000000
C4	16949810	16950881	BolC4t23722H	0	+	567	1071	1071	1.0000000
C4	16964721	16964919	BolC4t23723H	0	+	55	198	198	1.0000000
C4	16971713	16973639	BolC4t23724H	0	+	1629	1926	1926	1.0000000
C4	16990458	16990878	BolC4t23725H	0	+	97	420	420	1.0000000
C4	16991364	16992470	BolC4t23726H	0	+	415	1043	1106	0.9430380
C4	16993307	16994902	BolC4t23727H	0	-	567	1523	1595	0.9548590
C4	17007915	17008177	BolC4t23728H	0	+	131	262	262	1.0000000
C4	17008502	17008705	BolC4t23729H	0	+	16	203	203	1.0000000
C4	17011484	17012453	BolC4t23730H	0	+	664	969	969	1.0000000
C4	17013007	17013924	BolC4t23731H	0	+	187	842	917	0.9182116
C4	17049271	17051572	BolC4t23732H	0	+	252	1675	2301	0.7279444
C4	17069295	17070614	BolC4t23733H	0	-	1270	1319	1319	1.0000000
C4	17076597	17080701	BolC4t23734H	0	+	2959	4073	4104	0.9924464
C4	17101625	17102018	BolC4t23735H	0	+	142	389	393	0.9898219
C4	17104785	17104980	BolC4t23736H	0	+	186	195	195	1.0000000
C4	17112418	17112910	BolC4t23737H	0	-	30	365	492	0.7418699
C4	17116419	17117231	BolC4t23738H	0	+	32	449	812	0.5529557
C4	17138823	17139568	BolC4t23739H	0	-	52	536	745	0.7194631
C4	17146359	17146850	BolC4t23740H	0	+	698	491	491	1.0000000
C4	17151182	17151821	BolC4t23741H	0	+	3	278	639	0.4350548
C4	17158886	17159642	BolC4t23742H	0	+	217	756	756	1.0000000
C4	17179093	17182435	BolC4t23743H	0	+	495	2404	3342	0.7193297
C4	17211293	17211663	BolC4t23744H	0	-	125	370	370	1.0000000
C4	17219554	17229883	BolC4t23745H	0	+	2915	7158	10329	0.6930003
C4	17220250	17221018	BolC4t23746H	0	-	187	693	768	0.9023438
C4	17237615	17238062	BolC4t23747H	0	-	94	422	447	0.9440716
C4	17251587	17252040	BolC4t23748H	0	-	11	57	453	0.1258278
C4	17264110	17264861	BolC4t23749H	0	+	148	722	751	0.9613848
C4	17265587	17277402	BolC4t23750H	0	+	502	4163	11815	0.3523487
C4	17309220	17309640	BolC4t23751H	0	+	68	420	420	1.0000000
C4	17309712	17310363	BolC4t23752H	0	-	53	596	651	0.9155146
C4	17310541	17310859	BolC4t23753H	0	-	4	164	318	0.5157233
C4	17315435	17315767	BolC4t23754H	0	+	1	125	332	0.3765060
C4	17316788	17317902	BolC4t23755H	0	-	291	770	1114	0.6912029
C4	17343065	17344504	BolC4t23756H	0	+	112	1103	1439	0.7665045
C4	17353203	17354506	BolC4t23757H	0	+	88	919	1303	0.7052954
C4	17355477	17356641	BolC4t23758H	0	+	488	916	1164	0.7869416
C4	17358694	17359269	BolC4t23759H	0	-	169	573	575	0.9965217
C4	17380705	17381407	BolC4t23760H	0	+	23	435	702	0.6196581
C4	17386821	17388561	BolC4t23761H	0	+	329	1733	1740	0.9959770
C4	17393299	17394278	BolC4t23762H	0	-	994	979	979	1.0000000
C4	17395421	17395754	BolC4t23763H	0	+	82	333	333	1.0000000
C4	17397641	17399204	BolC4t23764H	0	+	69	870	1563	0.5566219
C4	17405512	17407024	BolC4t23765H	0	+	118	1121	1512	0.7414021
C4	17445597	17447428	BolC4t23766H	0	+	326	1307	1831	0.7138176
C4	17459502	17461000	BolC4t23767H	0	-	723	1498	1498	1.0000000
C4	17462194	17463709	BolC4t23768H	0	-	687	1458	1515	0.9623762
C4	17486463	17487232	BolC4t23769H	0	-	48	413	769	0.5370611
C4	17493752	17494652	BolC4t23770H	0	-	73	671	900	0.7455556
C4	17509190	17511443	BolC4t23771H	0	+	485	1773	2253	0.7869507
C4	17522114	17522519	BolC4t23772H	0	+	15	272	405	0.6716049
C4	17522618	17522855	BolC4t23773H	0	+	11	237	237	1.0000000
C4	17523339	17523576	BolC4t23774H	0	-	94	237	237	1.0000000
C4	17524374	17528993	BolC4t23775H	0	-	2172	4408	4619	0.9543191
C4	17549690	17555228	BolC4t23776H	0	-	2861	5343	5538	0.9647887
C4	17556247	17557246	BolC4t23777H	0	-	1	52	999	0.0520521
C4	17614253	17615699	BolC4t23778H	0	+	207	1131	1446	0.7821577
C4	17631190	17631605	BolC4t23779H	0	-	658	415	415	1.0000000
C4	17638038	17638272	BolC4t23780H	0	+	0	0	234	0.0000000
C4	17641081	17641462	BolC4t23781H	0	-	1033	381	381	1.0000000
C4	17653884	17655938	BolC4t23782H	0	+	1048	2026	2054	0.9863681
C4	17656375	17658664	BolC4t23783H	0	-	136	1399	2289	0.6111839
C4	17664997	17666975	BolC4t23784H	0	+	932	1978	1978	1.0000000
C4	17668344	17668737	BolC4t23785H	0	-	272	393	393	1.0000000
C4	17678686	17682241	BolC4t23786H	0	+	2125	3555	3555	1.0000000
C4	17688235	17691841	BolC4t23787H	0	+	1984	3606	3606	1.0000000
C4	17691994	17692654	BolC4t23788H	0	-	507	660	660	1.0000000
C4	17695978	17696609	BolC4t23789H	0	+	536	631	631	1.0000000
C4	17697462	17698020	BolC4t23790H	0	-	328	558	558	1.0000000
C4	17698611	17698959	BolC4t23791H	0	-	133	348	348	1.0000000
C4	17709338	17709703	BolC4t23792H	0	+	73	365	365	1.0000000
C4	17710354	17718121	BolC4t23793H	0	+	1045	5436	7767	0.6998841
C4	17724730	17725515	BolC4t23794H	0	+	846	785	785	1.0000000
C4	17730096	17730340	BolC4t23795H	0	-	49	244	244	1.0000000
C4	17736070	17736331	BolC4t23796H	0	-	0	0	261	0.0000000
C4	17764194	17764338	BolC4t23797H	0	-	310	144	144	1.0000000
C4	17768032	17768597	BolC4t23798H	0	-	474	565	565	1.0000000
C4	17786901	17787240	BolC4t23799H	0	+	102	339	339	1.0000000
C4	17794586	17794927	BolC4t23800H	0	-	347	341	341	1.0000000
C4	17798378	17798990	BolC4t23801H	0	-	442	612	612	1.0000000
C4	17811760	17815139	BolC4t23802H	0	+	2549	3365	3379	0.9958568
C4	17830882	17831029	BolC4t23803H	0	+	0	0	147	0.0000000
C4	17834917	17836414	BolC4t23804H	0	+	1506	1497	1497	1.0000000
C4	17837412	17837610	BolC4t23805H	0	-	234	198	198	1.0000000
C4	17839585	17839987	BolC4t23806H	0	+	383	402	402	1.0000000
C4	17855792	17858176	BolC4t23807H	0	-	305	1980	2384	0.8305369
C4	17872129	17872561	BolC4t23808H	0	+	0	0	432	0.0000000
C4	17873675	17875856	BolC4t23809H	0	-	286	1404	2181	0.6437414
C4	17882589	17883059	BolC4t23810H	0	+	0	0	470	0.0000000
C4	17883653	17884371	BolC4t23811H	0	+	0	0	718	0.0000000
C4	17927204	17929184	BolC4t23812H	0	-	1125	1813	1980	0.9156566
C4	17944145	17945012	BolC4t23813H	0	+	493	867	867	1.0000000
C4	17950935	17951331	BolC4t23814H	0	+	230	396	396	1.0000000
C4	17954871	17955210	BolC4t23815H	0	+	264	339	339	1.0000000
C4	17955983	17960087	BolC4t23816H	0	-	2203	3940	4104	0.9600390
C4	17984287	17985920	BolC4t23817H	0	-	540	1521	1633	0.9314146
C4	17986855	17989042	BolC4t23818H	0	-	1129	2187	2187	1.0000000
C4	17993760	17995502	BolC4t23819H	0	+	10	460	1742	0.2640643
C4	17995505	17996322	BolC4t23820H	0	+	1	4	817	0.0048960
C4	18001129	18001591	BolC4t23821H	0	-	0	0	462	0.0000000
C4	18002540	18002735	BolC4t23822H	0	+	0	0	195	0.0000000
C4	18006281	18006698	BolC4t23823H	0	-	0	0	417	0.0000000
C4	18007821	18008349	BolC4t23824H	0	+	0	0	528	0.0000000
C4	18010290	18010899	BolC4t23825H	0	+	0	0	609	0.0000000
C4	18026767	18030839	BolC4t23826H	0	-	971	3417	4072	0.8391454
C4	18061779	18061887	BolC4t23827H	0	-	0	0	108	0.0000000
C4	18105684	18108803	BolC4t23828H	0	-	292	1648	3119	0.5283745
C4	18125347	18127603	BolC4t23829H	0	-	839	2227	2256	0.9871454
C4	18132270	18134201	BolC4t23830H	0	-	1402	1931	1931	1.0000000
C4	18135609	18136436	BolC4t23831H	0	+	710	827	827	1.0000000
C4	18138008	18139615	BolC4t23832H	0	-	170	1331	1607	0.8282514
C4	18161502	18162384	BolC4t23833H	0	-	32	499	882	0.5657597
C4	18172509	18172734	BolC4t23834H	0	+	122	225	225	1.0000000
C4	18215487	18216531	BolC4t23835H	0	+	14	35	1044	0.0335249
C4	18217374	18217804	BolC4t23836H	0	+	2	79	430	0.1837209
C4	18221184	18222793	BolC4t23837H	0	-	463	1244	1609	0.7731510
C4	18227574	18229497	BolC4t23838H	0	-	699	1809	1923	0.9407176
C4	18235062	18235805	BolC4t23839H	0	-	94	244	743	0.3283984
C4	18238791	18241152	BolC4t23840H	0	-	1474	2311	2361	0.9788225
C4	18258439	18260158	BolC4t23841H	0	-	162	1446	1719	0.8411868
C4	18262096	18262207	BolC4t23842H	0	+	152	111	111	1.0000000
C4	18270487	18272731	BolC4t23843H	0	+	711	2159	2244	0.9621212
C4	18289934	18290630	BolC4t23844H	0	+	662	696	696	1.0000000
C4	18294931	18295042	BolC4t23845H	0	-	2	111	111	1.0000000
C4	18300462	18300840	BolC4t23846H	0	+	17	283	378	0.7486773
C4	18317016	18317737	BolC4t23847H	0	-	660	721	721	1.0000000
C4	18317824	18320636	BolC4t23848H	0	+	159	2151	2812	0.7649360
C4	18320858	18321326	BolC4t23849H	0	-	513	468	468	1.0000000
C4	18326337	18327987	BolC4t23850H	0	+	1027	1650	1650	1.0000000
C4	18343620	18347188	BolC4t23851H	0	-	1878	3557	3568	0.9969171
C4	18349613	18349790	BolC4t23852H	0	-	5	3	177	0.0169492
C4	18355453	18355893	BolC4t23853H	0	+	351	440	440	1.0000000
C4	18367918	18368607	BolC4t23854H	0	-	3	34	689	0.0493469
C4	18384036	18386609	BolC4t23855H	0	+	1030	2401	2573	0.9331520
C4	18387944	18388292	BolC4t23856H	0	-	95	311	348	0.8936782
C4	18400792	18402997	BolC4t23857H	0	-	975	2205	2205	1.0000000
C4	18409607	18417388	BolC4t23858H	0	+	3655	7471	7781	0.9601594
C4	18429687	18431632	BolC4t23859H	0	-	152	1519	1945	0.7809769
C4	18434422	18434918	BolC4t23860H	0	-	2091	496	496	1.0000000
C4	18444255	18472896	BolC4t23861H	0	+	5225	17982	28641	0.6278412
C4	18476185	18476359	BolC4t23862H	0	+	167	174	174	1.0000000
C4	18476634	18476763	BolC4t23863H	0	+	136	104	129	0.8062016
C4	18485662	18486396	BolC4t23864H	0	-	33	566	734	0.7711172
C4	18493221	18494655	BolC4t23865H	0	+	352	1186	1434	0.8270572
C4	18512282	18515385	BolC4t23866H	0	+	842	3102	3103	0.9996777
C4	18517036	18517877	BolC4t23867H	0	-	752	841	841	1.0000000
C4	18517176	18517503	BolC4t23868H	0	-	413	327	327	1.0000000
C4	18529298	18529604	BolC4t23869H	0	+	339	306	306	1.0000000
C4	18538660	18538966	BolC4t23870H	0	+	0	0	306	0.0000000
C4	18543114	18544130	BolC4t23871H	0	-	577	1016	1016	1.0000000
C4	18558727	18563505	BolC4t23872H	0	-	186	2834	4778	0.5931352
C4	18580707	18581007	BolC4t23873H	0	-	0	0	300	0.0000000
C4	18604086	18604760	BolC4t23874H	0	-	321	672	674	0.9970326
C4	18622963	18624390	BolC4t23875H	0	-	908	1427	1427	1.0000000
C4	18627610	18628563	BolC4t23876H	0	+	657	953	953	1.0000000
C4	18632962	18633783	BolC4t23877H	0	-	659	821	821	1.0000000
C4	18642049	18643364	BolC4t23878H	0	-	548	1315	1315	1.0000000
C4	18643713	18645063	BolC4t23879H	0	+	1523	1350	1350	1.0000000
C4	18650626	18651248	BolC4t23880H	0	+	715	622	622	1.0000000
C4	18658504	18659547	BolC4t23881H	0	-	432	993	1043	0.9520614
C4	18660201	18661061	BolC4t23882H	0	-	322	860	860	1.0000000
C4	18668542	18669064	BolC4t23883H	0	+	2458	522	522	1.0000000
C4	18676146	18676341	BolC4t23884H	0	-	233	195	195	1.0000000
C4	18677535	18678305	BolC4t23885H	0	-	692	770	770	1.0000000
C4	18687380	18688245	BolC4t23886H	0	+	859	865	865	1.0000000
C4	18688941	18689676	BolC4t23887H	0	-	474	735	735	1.0000000
C4	18690873	18692969	BolC4t23888H	0	+	586	1973	2096	0.9413168
C4	18739573	18741055	BolC4t23889H	0	+	93	588	1482	0.3967611
C4	18764453	18764666	BolC4t23890H	0	-	138	213	213	1.0000000
C4	18774014	18774185	BolC4t23891H	0	-	6	137	171	0.8011696
C4	18782077	18782783	BolC4t23892H	0	-	17	229	706	0.3243626
C4	18783889	18785878	BolC4t23893H	0	+	500	1586	1989	0.7973856
C4	18787161	18788378	BolC4t23894H	0	-	623	1217	1217	1.0000000
C4	18788985	18789357	BolC4t23895H	0	-	323	372	372	1.0000000
C4	18791228	18791679	BolC4t23896H	0	+	671	451	451	1.0000000
C4	18797495	18799302	BolC4t23897H	0	-	1371	1807	1807	1.0000000
C4	18804315	18805863	BolC4t23898H	0	-	974	1518	1548	0.9806201
C4	18810398	18811895	BolC4t23899H	0	+	341	1397	1497	0.9331997
C4	18812629	18813485	BolC4t23900H	0	-	86	823	856	0.9614486
C4	18823507	18824467	BolC4t23901H	0	-	783	960	960	1.0000000
C4	18824945	18825892	BolC4t23902H	0	+	714	947	947	1.0000000
C4	18833697	18834156	BolC4t23903H	0	+	356	459	459	1.0000000
C4	18835870	18837516	BolC4t23904H	0	+	93	1515	1646	0.9204131
C4	18838145	18838382	BolC4t23905H	0	+	0	0	237	0.0000000
C4	18850843	18851161	BolC4t23906H	0	-	4	32	318	0.1006289
C4	18858288	18858719	BolC4t23907H	0	-	158	431	431	1.0000000
C4	18858857	18859139	BolC4t23908H	0	-	27	282	282	1.0000000
C4	18859731	18862232	BolC4t23909H	0	+	720	2501	2501	1.0000000
C4	18875352	18876354	BolC4t23910H	0	+	675	1002	1002	1.0000000
C4	18876657	18880518	BolC4t23911H	0	-	1712	3674	3861	0.9515669
C4	18883264	18887085	BolC4t23912H	0	+	3251	3820	3821	0.9997383
C4	18887476	18887635	BolC4t23913H	0	-	309	159	159	1.0000000
C4	18897259	18901222	BolC4t23914H	0	+	2510	3517	3963	0.8874590
C4	18917402	18917612	BolC4t23915H	0	-	254	210	210	1.0000000
C4	18920273	18920903	BolC4t23916H	0	-	1718	630	630	1.0000000
C4	18929444	18930031	BolC4t23917H	0	-	15	241	587	0.4105622
C4	18953776	18955516	BolC4t23918H	0	+	815	1573	1740	0.9040230
C4	18961083	18979791	BolC4t23919H	0	+	6713	17141	18708	0.9162390
C4	19010687	19011351	BolC4t23920H	0	+	100	661	664	0.9954819
C4	19022902	19023064	BolC4t23921H	0	-	1	20	162	0.1234568
C4	19029901	19032163	BolC4t23922H	0	+	733	1809	2262	0.7997348
C4	19032909	19033429	BolC4t23923H	0	+	0	0	520	0.0000000
C4	19034136	19034385	BolC4t23924H	0	-	2	18	249	0.0722892
C4	19037039	19038354	BolC4t23925H	0	+	157	1027	1315	0.7809886
C4	19044584	19044791	BolC4t23926H	0	+	0	0	207	0.0000000
C4	19047094	19049746	BolC4t23927H	0	+	503	1849	2652	0.6972097
C4	19072102	19072354	BolC4t23928H	0	-	185	252	252	1.0000000
C4	19074209	19074917	BolC4t23929H	0	-	327	708	708	1.0000000
C4	19078331	19079775	BolC4t23930H	0	-	200	1188	1444	0.8227147
C4	19098790	19099478	BolC4t23931H	0	+	1231	688	688	1.0000000
C4	19102431	19104930	BolC4t23932H	0	-	704	2334	2499	0.9339736
C4	19120382	19141031	BolC4t23933H	0	-	3855	12637	20649	0.6119909
C4	19142887	19145064	BolC4t23934H	0	-	810	1797	2177	0.8254479
C4	19155982	19156435	BolC4t23935H	0	-	249	453	453	1.0000000
C4	19159627	19170847	BolC4t23936H	0	-	792	4076	11220	0.3632798
C4	19174210	19177576	BolC4t23937H	0	-	844	2949	3366	0.8761141
C4	19180384	19182891	BolC4t23938H	0	+	215	1825	2507	0.7279617
C4	19183376	19186469	BolC4t23939H	0	-	420	3003	3093	0.9709020
C4	19194775	19195059	BolC4t23940H	0	+	0	0	284	0.0000000
C4	19207698	19208449	BolC4t23941H	0	+	621	751	751	1.0000000
C4	19233013	19233506	BolC4t23942H	0	+	7	366	493	0.7423935
C4	19234860	19235172	BolC4t23943H	0	+	0	0	312	0.0000000
C4	19235518	19236270	BolC4t23944H	0	+	2	70	752	0.0930851
C4	19237005	19237356	BolC4t23945H	0	+	0	0	351	0.0000000
C4	19237548	19238094	BolC4t23946H	0	+	15	449	546	0.8223443
C4	19241301	19245923	BolC4t23947H	0	+	952	4320	4622	0.9346603
C4	19247255	19247855	BolC4t23948H	0	-	96	543	600	0.9050000
C4	19270435	19272141	BolC4t23949H	0	+	310	1641	1706	0.9618992
C4	19276605	19278850	BolC4t23950H	0	-	413	1967	2245	0.8761693
C4	19278989	19280956	BolC4t23951H	0	+	500	1687	1967	0.8576512
C4	19286963	19287065	BolC4t23952H	0	-	53	102	102	1.0000000
C4	19293925	19294204	BolC4t23953H	0	+	1	12	279	0.0430108
C4	19304847	19305042	BolC4t23954H	0	+	1	72	195	0.3692308
C4	19305212	19305533	BolC4t23955H	0	+	1	63	321	0.1962617
C4	19308247	19308988	BolC4t23956H	0	+	4	139	741	0.1875843
C4	19316843	19317989	BolC4t23957H	0	+	254	1015	1146	0.8856894
C4	19326584	19327334	BolC4t23958H	0	+	274	750	750	1.0000000
C4	19335359	19335770	BolC4t23959H	0	-	685	411	411	1.0000000
C4	19354302	19356358	BolC4t23960H	0	+	1620	2056	2056	1.0000000
C4	19357768	19368507	BolC4t23961H	0	+	915	5547	10739	0.5165285
C4	19369508	19370620	BolC4t23962H	0	+	990	1112	1112	1.0000000
C4	19374127	19376524	BolC4t23963H	0	+	1695	2294	2397	0.9570296
C4	19406949	19409039	BolC4t23964H	0	+	1494	2090	2090	1.0000000
C4	19409139	19410474	BolC4t23965H	0	+	1461	1335	1335	1.0000000
C4	19436852	19437113	BolC4t23966H	0	-	191	261	261	1.0000000
C4	19445837	19446624	BolC4t23967H	0	-	254	787	787	1.0000000
C4	19481135	19485340	BolC4t23968H	0	-	1226	3651	4205	0.8682521
C4	19486556	19486979	BolC4t23969H	0	-	450	423	423	1.0000000
C4	19558498	19558990	BolC4t23970H	0	-	52	126	492	0.2560976
C4	19650013	19650790	BolC4t23971H	0	-	557	777	777	1.0000000
C4	19654418	19656734	BolC4t23972H	0	-	1761	2314	2316	0.9991364
C4	19709202	19714617	BolC4t23973H	0	+	2262	4358	5415	0.8048015
C4	19737012	19737548	BolC4t23974H	0	+	94	536	536	1.0000000
C4	19747899	19748364	BolC4t23975H	0	+	267	465	465	1.0000000
C4	19748453	19749233	BolC4t23976H	0	+	621	780	780	1.0000000
C4	19756916	19758825	BolC4t23977H	0	-	703	1722	1909	0.9020429
C4	19775610	19778792	BolC4t23978H	0	-	2218	3182	3182	1.0000000
C4	19779277	19779490	BolC4t23979H	0	-	92	213	213	1.0000000
C4	19782146	19783601	BolC4t23980H	0	+	65	910	1455	0.6254296
C4	19787091	19787743	BolC4t23981H	0	-	447	652	652	1.0000000
C4	19793998	19796345	BolC4t23982H	0	-	1846	2329	2347	0.9923306
C4	19837015	19838097	BolC4t23983H	0	-	1131	1082	1082	1.0000000
C4	19839649	19840212	BolC4t23984H	0	-	424	563	563	1.0000000
C4	19865354	19865675	BolC4t23985H	0	-	33	228	321	0.7102804
C4	19866382	19866634	BolC4t23986H	0	+	282	252	252	1.0000000
C4	19892044	19892467	BolC4t23987H	0	-	394	423	423	1.0000000
C4	19999073	19999184	BolC4t23988H	0	+	0	0	111	0.0000000
C4	20009142	20009669	BolC4t23989H	0	-	64	448	527	0.8500949
C4	20021559	20021802	BolC4t23990H	0	-	200	243	243	1.0000000
C4	20172698	20173863	BolC4t23991H	0	+	228	901	1165	0.7733905
C4	20185552	20185858	BolC4t23992H	0	+	298	306	306	1.0000000
C4	20196472	20198102	BolC4t23993H	0	+	1794	1630	1630	1.0000000
C4	20215021	20216556	BolC4t23994H	0	-	517	1535	1535	1.0000000
C4	20220374	20221699	BolC4t23995H	0	-	778	1325	1325	1.0000000
C4	20222435	20224535	BolC4t23996H	0	+	1067	2100	2100	1.0000000
C4	20233322	20241227	BolC4t23997H	0	+	6300	7082	7905	0.8958887
C4	20241896	20242361	BolC4t23998H	0	+	234	465	465	1.0000000
C4	20244771	20245277	BolC4t23999H	0	-	295	506	506	1.0000000
C4	20250385	20251533	BolC4t24000H	0	-	432	1127	1148	0.9817073
C4	20259480	20259972	BolC4t24001H	0	-	378	492	492	1.0000000
C4	20261319	20265084	BolC4t24002H	0	-	2312	3765	3765	1.0000000
C4	20288571	20290838	BolC4t24003H	0	+	1058	2184	2267	0.9633877
C4	20298960	20299125	BolC4t24004H	0	+	169	165	165	1.0000000
C4	20326113	20327188	BolC4t24005H	0	+	1066	1075	1075	1.0000000
C4	20329722	20331353	BolC4t24006H	0	+	1275	1631	1631	1.0000000
C4	20332073	20335274	BolC4t24007H	0	-	1607	2976	3201	0.9297095
C4	20339845	20340175	BolC4t24008H	0	+	322	330	330	1.0000000
C4	20360142	20363325	BolC4t24009H	0	-	1875	3183	3183	1.0000000
C4	20385275	20385617	BolC4t24010H	0	-	172	342	342	1.0000000
C4	20410261	20410369	BolC4t24011H	0	+	38	108	108	1.0000000
C4	20419764	20419983	BolC4t24012H	0	+	137	219	219	1.0000000
C4	20468840	20471099	BolC4t24013H	0	-	2359	2259	2259	1.0000000
C4	20486657	20487747	BolC4t24014H	0	+	1246	1090	1090	1.0000000
C4	20488181	20490842	BolC4t24015H	0	-	2924	2661	2661	1.0000000
C4	20499660	20501880	BolC4t24016H	0	-	723	2062	2220	0.9288288
C4	20504525	20504949	BolC4t24017H	0	+	707	424	424	1.0000000
C4	20513960	20516389	BolC4t24018H	0	-	831	1955	2429	0.8048580
C4	20567532	20568625	BolC4t24019H	0	-	148	949	1093	0.8682525
C4	20600104	20600356	BolC4t24020H	0	+	299	252	252	1.0000000
C4	20613705	20615819	BolC4t24021H	0	-	1711	2114	2114	1.0000000
C4	20647712	20648301	BolC4t24022H	0	-	515	589	589	1.0000000
C4	20648899	20649333	BolC4t24023H	0	-	285	434	434	1.0000000
C4	20657623	20657962	BolC4t24024H	0	+	254	339	339	1.0000000
C4	20661908	20663527	BolC4t24025H	0	-	841	1569	1619	0.9691167
C4	20717835	20719971	BolC4t24026H	0	-	76	958	2136	0.4485019
C4	20764998	20765594	BolC4t24027H	0	+	125	585	596	0.9815436
C4	20771673	20775341	BolC4t24028H	0	-	1502	3402	3668	0.9274809
C4	20776728	20777439	BolC4t24029H	0	-	16	230	711	0.3234881
C4	20783671	20783839	BolC4t24030H	0	-	179	168	168	1.0000000
C4	20785482	20786112	BolC4t24031H	0	-	603	630	630	1.0000000
C4	20792828	20796772	BolC4t24032H	0	-	2332	3785	3944	0.9596856
C4	20803144	20803318	BolC4t24033H	0	+	203	174	174	1.0000000
C4	20811984	20812332	BolC4t24034H	0	+	515	348	348	1.0000000
C4	20812967	20813977	BolC4t24035H	0	-	684	1010	1010	1.0000000
C4	20842463	20843739	BolC4t24036H	0	-	1638	1276	1276	1.0000000
C4	20850317	20850485	BolC4t24037H	0	-	74	168	168	1.0000000
C4	20856310	20856517	BolC4t24038H	0	+	128	207	207	1.0000000
C4	20857800	20857992	BolC4t24039H	0	+	112	192	192	1.0000000
C4	20892978	20898423	BolC4t24040H	0	-	4651	5408	5445	0.9932048
C4	20908292	20908859	BolC4t24041H	0	+	509	567	567	1.0000000
C4	20909500	20912437	BolC4t24042H	0	-	876	2536	2937	0.8634661
C4	20940199	20941181	BolC4t24043H	0	-	422	982	982	1.0000000
C4	20950856	20953590	BolC4t24044H	0	-	1771	2734	2734	1.0000000
C4	20969932	20971224	BolC4t24045H	0	-	872	1292	1292	1.0000000
C4	20979044	20979251	BolC4t24046H	0	-	97	207	207	1.0000000
C4	20982709	20983650	BolC4t24047H	0	+	631	941	941	1.0000000
C4	20993319	20993514	BolC4t24048H	0	-	196	195	195	1.0000000
C4	20995729	20998056	BolC4t24049H	0	-	575	2112	2327	0.9076064
C4	21047948	21048269	BolC4t24050H	0	+	183	321	321	1.0000000
C4	21050760	21061658	BolC4t24051H	0	-	7885	10898	10898	1.0000000
C4	21147722	21148289	BolC4t24052H	0	-	261	567	567	1.0000000
C4	21150472	21151028	BolC4t24053H	0	-	277	556	556	1.0000000
C4	21157340	21157490	BolC4t24054H	0	-	83	150	150	1.0000000
C4	21176691	21177003	BolC4t24055H	0	+	56	312	312	1.0000000
C4	21177050	21177748	BolC4t24056H	0	+	125	698	698	1.0000000
C4	21177924	21178278	BolC4t24057H	0	+	89	354	354	1.0000000
C4	21179044	21179312	BolC4t24058H	0	+	268	268	268	1.0000000
C4	21183645	21184204	BolC4t24059H	0	+	422	559	559	1.0000000
C4	21190795	21192266	BolC4t24060H	0	+	321	1222	1471	0.8307274
C4	21212088	21212337	BolC4t24061H	0	+	104	249	249	1.0000000
C4	21293358	21296216	BolC4t24062H	0	+	1022	2855	2858	0.9989503
C4	21298493	21299126	BolC4t24063H	0	-	493	633	633	1.0000000
C4	21299177	21299492	BolC4t24064H	0	-	366	315	315	1.0000000
C4	21300310	21300751	BolC4t24065H	0	+	221	441	441	1.0000000
C4	21302358	21302661	BolC4t24066H	0	+	33	260	303	0.8580858
C4	21318739	21323312	BolC4t24067H	0	-	1581	4552	4573	0.9954078
C4	21328034	21328693	BolC4t24068H	0	+	181	510	659	0.7738999
C4	21332445	21332574	BolC4t24069H	0	+	21	129	129	1.0000000
C4	21338143	21352453	BolC4t24070H	0	+	10426	11516	14310	0.8047519
C4	21439870	21441212	BolC4t24071H	0	+	856	1342	1342	1.0000000
C4	21441279	21443536	BolC4t24072H	0	+	1153	2190	2257	0.9703146
C4	21444959	21445091	BolC4t24073H	0	-	156	132	132	1.0000000
C4	22781521	22782575	BolC4t24074H	0	-	393	1021	1054	0.9686907
C4	22782894	22784941	BolC4t24075H	0	+	589	2026	2047	0.9897411
C4	22805660	22806577	BolC4t24076H	0	-	684	917	917	1.0000000
C4	22832261	22832858	BolC4t24077H	0	+	757	597	597	1.0000000
C4	22900275	22900675	BolC4t24078H	0	+	236	400	400	1.0000000
C4	22918732	22919343	BolC4t24079H	0	-	399	611	611	1.0000000
C4	22925612	22926167	BolC4t24080H	0	+	199	555	555	1.0000000
C4	22926163	22926825	BolC4t24081H	0	+	229	662	662	1.0000000
C4	22946176	22946302	BolC4t24082H	0	+	92	126	126	1.0000000
C4	22948816	22949065	BolC4t24083H	0	-	142	249	249	1.0000000
C4	22958011	22960388	BolC4t24084H	0	-	1650	2377	2377	1.0000000
C4	22960757	22962479	BolC4t24085H	0	+	1786	1722	1722	1.0000000
C4	22966824	22967217	BolC4t24086H	0	+	309	393	393	1.0000000
C4	22981307	22981511	BolC4t24087H	0	+	176	204	204	1.0000000
C4	22987598	22988036	BolC4t24088H	0	-	624	438	438	1.0000000
C4	23169730	23169991	BolC4t24089H	0	+	242	261	261	1.0000000
C4	23170159	23170903	BolC4t24090H	0	+	428	744	744	1.0000000
C4	23196238	23198879	BolC4t24091H	0	+	816	2267	2641	0.8583870
C4	23204379	23204814	BolC4t24092H	0	-	213	435	435	1.0000000
C4	23234132	23234780	BolC4t24093H	0	+	478	648	648	1.0000000
C4	23289095	23289895	BolC4t24094H	0	-	603	800	800	1.0000000
C4	23397556	23397865	BolC4t24095H	0	+	283	309	309	1.0000000
C4	23401363	23401615	BolC4t24096H	0	+	119	252	252	1.0000000
C4	23403694	23404679	BolC4t24097H	0	-	579	985	985	1.0000000
C4	23415883	23418039	BolC4t24098H	0	-	1388	2156	2156	1.0000000
C4	23423108	23424188	BolC4t24099H	0	+	754	1080	1080	1.0000000
C4	23425639	23425801	BolC4t24100H	0	-	197	162	162	1.0000000
C4	23430586	23431437	BolC4t24101H	0	+	542	851	851	1.0000000
C4	23434612	23435667	BolC4t24102H	0	-	637	1055	1055	1.0000000
C4	23456731	23458014	BolC4t24103H	0	-	878	1283	1283	1.0000000
C4	23458740	23459624	BolC4t24104H	0	+	976	884	884	1.0000000
C4	23462645	23463008	BolC4t24105H	0	+	442	363	363	1.0000000
C4	23464035	23464379	BolC4t24106H	0	+	135	344	344	1.0000000
C4	23464595	23467640	BolC4t24107H	0	-	2784	3045	3045	1.0000000
C4	23468854	23470707	BolC4t24108H	0	+	530	1853	1853	1.0000000
C4	23491615	23491927	BolC4t24109H	0	-	621	312	312	1.0000000
C4	23495388	23495946	BolC4t24110H	0	+	261	427	558	0.7652330
C4	23513794	23513991	BolC4t24111H	0	-	4	130	197	0.6598985
C4	23525097	23525448	BolC4t24112H	0	-	400	351	351	1.0000000
C4	23531373	23531925	BolC4t24113H	0	-	492	552	552	1.0000000
C4	23549521	23551341	BolC4t24114H	0	+	637	1820	1820	1.0000000
C4	23554233	23554425	BolC4t24115H	0	+	33	192	192	1.0000000
C4	23560445	23560823	BolC4t24116H	0	-	363	378	378	1.0000000
C4	23561064	23574532	BolC4t24117H	0	+	13678	12725	13468	0.9448322
C4	23570344	23572045	BolC4t24118H	0	-	1372	1321	1701	0.7766020
C4	23572475	23575087	BolC4t24119H	0	+	2204	2382	2612	0.9119449
C4	23650253	23650868	BolC4t24120H	0	-	86	615	615	1.0000000
C4	23652012	23653216	BolC4t24121H	0	+	391	1204	1204	1.0000000
C4	23654926	23655259	BolC4t24122H	0	-	335	333	333	1.0000000
C4	23672749	23673544	BolC4t24123H	0	-	67	510	795	0.6415094
C4	23691794	23693134	BolC4t24124H	0	-	914	1340	1340	1.0000000
C4	23703735	23708016	BolC4t24125H	0	-	2384	4281	4281	1.0000000
C4	23759723	23760158	BolC4t24126H	0	+	358	435	435	1.0000000
C4	23771978	23773739	BolC4t24127H	0	+	739	1761	1761	1.0000000
C4	23806650	23816680	BolC4t24128H	0	+	3466	8317	10030	0.8292124
C4	23818384	23819337	BolC4t24129H	0	+	223	748	953	0.7848898
C4	23819823	23819979	BolC4t24130H	0	+	63	156	156	1.0000000
C4	23825890	23826118	BolC4t24131H	0	-	210	228	228	1.0000000
C4	23854536	23854719	BolC4t24132H	0	-	163	183	183	1.0000000
C4	23856350	23856920	BolC4t24133H	0	-	282	570	570	1.0000000
C4	23857651	23858062	BolC4t24134H	0	-	403	411	411	1.0000000
C4	23858261	23858903	BolC4t24135H	0	-	323	642	642	1.0000000
C4	23861111	23861647	BolC4t24136H	0	-	0	0	536	0.0000000
C4	23885885	23889964	BolC4t24137H	0	+	2609	4079	4079	1.0000000
C4	23891496	23891731	BolC4t24138H	0	+	75	235	235	1.0000000
C4	23892686	23907731	BolC4t24139H	0	-	5571	14606	15045	0.9708208
C4	23909222	23913097	BolC4t24140H	0	+	1044	2865	3875	0.7393548
C4	23927708	23929941	BolC4t24141H	0	-	1109	2233	2233	1.0000000
C4	23964202	23965998	BolC4t24142H	0	+	11	455	1796	0.2533408
C4	24021321	24024071	BolC4t24143H	0	+	1111	2597	2750	0.9443637
C4	24028526	24031739	BolC4t24144H	0	+	1696	3213	3213	1.0000000
C4	24047900	24049629	BolC4t24145H	0	+	1063	1729	1729	1.0000000
C4	24057645	24058213	BolC4t24146H	0	+	312	568	568	1.0000000
C4	24102616	24105049	BolC4t24147H	0	+	2624	2414	2433	0.9921907
C4	24105547	24117284	BolC4t24148H	0	-	2675	5376	11737	0.4580387
C4	24121351	24126734	BolC4t24149H	0	-	3552	5376	5383	0.9986996
C4	24129124	24133041	BolC4t24150H	0	-	1752	3874	3917	0.9890222
C4	24133791	24134694	BolC4t24151H	0	-	91	809	903	0.8959026
C4	24146527	24147423	BolC4t24152H	0	+	586	896	896	1.0000000
C4	24147471	24147942	BolC4t24153H	0	+	305	471	471	1.0000000
C4	24225380	24233747	BolC4t24154H	0	-	1505	4411	8367	0.5271901
C4	24234363	24234807	BolC4t24155H	0	-	6	66	444	0.1486486
C4	24236381	24236546	BolC4t24156H	0	+	8	165	165	1.0000000
C4	24238466	24238914	BolC4t24157H	0	-	72	448	448	1.0000000
C4	24239844	24240429	BolC4t24158H	0	-	8	407	585	0.6957265
C4	24240569	24240957	BolC4t24159H	0	-	21	272	388	0.7010309
C4	24241547	24242713	BolC4t24160H	0	-	169	1055	1166	0.9048027
C4	24251177	24251821	BolC4t24161H	0	+	1018	644	644	1.0000000
C4	24253990	24254491	BolC4t24162H	0	+	456	501	501	1.0000000
C4	24256284	24256745	BolC4t24163H	0	+	387	461	461	1.0000000
C4	24304659	24305969	BolC4t24164H	0	-	245	1069	1310	0.8160306
C4	24308994	24309159	BolC4t24165H	0	+	3	160	165	0.9696970
C4	24311073	24311344	BolC4t24166H	0	-	79	271	271	1.0000000
C4	24313566	24314127	BolC4t24167H	0	+	367	561	561	1.0000000
C4	24314895	24316769	BolC4t24168H	0	-	234	1525	1874	0.8137673
C4	24325545	24326793	BolC4t24169H	0	-	63	877	1248	0.7027243
C4	24365526	24365769	BolC4t24170H	0	+	155	243	243	1.0000000
C4	24368633	24371267	BolC4t24171H	0	-	2080	2634	2634	1.0000000
C4	24371459	24371723	BolC4t24172H	0	-	307	264	264	1.0000000
C4	24381922	24382087	BolC4t24173H	0	+	161	165	165	1.0000000
C4	24385814	24386750	BolC4t24174H	0	-	157	867	936	0.9262820
C4	24394253	24398152	BolC4t24175H	0	+	2459	3899	3899	1.0000000
C4	24434025	24442434	BolC4t24176H	0	-	2348	7126	8409	0.8474254
C4	24451236	24451902	BolC4t24177H	0	+	457	666	666	1.0000000
C4	24452934	24453631	BolC4t24178H	0	+	499	697	697	1.0000000
C4	24454052	24457655	BolC4t24179H	0	-	2363	3603	3603	1.0000000
C4	24523375	24523974	BolC4t24180H	0	-	315	599	599	1.0000000
C4	24535805	24535964	BolC4t24181H	0	-	180	159	159	1.0000000
C4	24545781	24549227	BolC4t24182H	0	+	2195	3446	3446	1.0000000
C4	24557080	24558014	BolC4t24183H	0	+	421	934	934	1.0000000
C4	24558393	24559176	BolC4t24184H	0	+	484	783	783	1.0000000
C4	24559420	24559729	BolC4t24185H	0	+	144	309	309	1.0000000
C4	24564280	24568007	BolC4t24186H	0	-	2231	3645	3727	0.9779984
C4	24582182	24588119	BolC4t24187H	0	-	4736	5787	5937	0.9747347
C4	24597921	24605370	BolC4t24188H	0	-	2252	6723	7449	0.9025372
C4	24611126	24612320	BolC4t24189H	0	+	824	1194	1194	1.0000000
C4	24621972	24623481	BolC4t24190H	0	+	1308	1509	1509	1.0000000
C4	24627448	24627991	BolC4t24191H	0	-	356	543	543	1.0000000
C4	24629548	24629890	BolC4t24192H	0	-	298	342	342	1.0000000
C4	24630221	24634557	BolC4t24193H	0	-	2859	4336	4336	1.0000000
C4	24651393	24652316	BolC4t24194H	0	-	481	923	923	1.0000000
C4	24669345	24669819	BolC4t24195H	0	-	377	474	474	1.0000000
C4	24671080	24671278	BolC4t24196H	0	-	251	198	198	1.0000000
C4	24746802	24748063	BolC4t24197H	0	-	1001	1261	1261	1.0000000
C4	24764009	24767947	BolC4t24198H	0	-	1781	3916	3938	0.9944134
C4	24774154	24774472	BolC4t24199H	0	-	72	297	318	0.9339623
C4	24806441	24806603	BolC4t24200H	0	-	226	162	162	1.0000000
C4	24811366	24812497	BolC4t24201H	0	-	1249	1131	1131	1.0000000
C4	24814938	24816101	BolC4t24202H	0	-	86	1035	1163	0.8899398
C4	24855441	24855855	BolC4t24203H	0	+	310	414	414	1.0000000
C4	24861404	24861773	BolC4t24204H	0	+	251	369	369	1.0000000
C4	24875201	24875828	BolC4t24205H	0	+	351	627	627	1.0000000
C4	24882239	24883244	BolC4t24206H	0	+	140	803	1005	0.7990050
C4	24888338	24888497	BolC4t24207H	0	+	104	159	159	1.0000000
C4	24892769	24893532	BolC4t24208H	0	-	460	763	763	1.0000000
C4	24918221	24918452	BolC4t24209H	0	+	186	231	231	1.0000000
C4	24934509	24935339	BolC4t24210H	0	-	474	830	830	1.0000000
C4	24935345	24945890	BolC4t24211H	0	-	4853	6442	10545	0.6109056
C4	24946617	24948291	BolC4t24212H	0	-	1107	1674	1674	1.0000000
C4	24950524	24950813	BolC4t24213H	0	+	368	289	289	1.0000000
C4	24967730	24968260	BolC4t24214H	0	+	319	530	530	1.0000000
C4	24986629	24987143	BolC4t24215H	0	+	595	475	514	0.9241245
C4	25004645	25006065	BolC4t24216H	0	-	767	1420	1420	1.0000000
C4	25007773	25008701	BolC4t24217H	0	+	39	540	928	0.5818965
C4	25025267	25026195	BolC4t24218H	0	+	26	394	928	0.4245690
C4	25032525	25032811	BolC4t24219H	0	+	266	286	286	1.0000000
C4	25033426	25033942	BolC4t24220H	0	-	72	498	516	0.9651163
C4	25040830	25042836	BolC4t24221H	0	+	1108	2006	2006	1.0000000
C4	25078617	25081412	BolC4t24222H	0	-	1297	2795	2795	1.0000000
C4	25109245	25110586	BolC4t24223H	0	+	688	1341	1341	1.0000000
C4	25130401	25130656	BolC4t24224H	0	-	205	255	255	1.0000000
C4	25135549	25136183	BolC4t24225H	0	-	473	634	634	1.0000000
C4	25151652	25154143	BolC4t24226H	0	-	1526	2491	2491	1.0000000
C4	25159366	25160719	BolC4t24227H	0	-	1348	1353	1353	1.0000000
C4	25174929	25175843	BolC4t24228H	0	-	988	914	914	1.0000000
C4	25199248	25200471	BolC4t24229H	0	-	483	1190	1223	0.9730172
C4	25228667	25232676	BolC4t24230H	0	+	2163	3623	4009	0.9037166
C4	25233362	25233809	BolC4t24231H	0	+	115	447	447	1.0000000
C4	25244712	25247214	BolC4t24232H	0	-	1480	2502	2502	1.0000000
C4	25273092	25273497	BolC4t24233H	0	-	91	405	405	1.0000000
C4	25273985	25274399	BolC4t24234H	0	-	50	357	414	0.8623188
C4	25308474	25309564	BolC4t24235H	0	+	1348	1090	1090	1.0000000
C4	25310003	25310450	BolC4t24236H	0	+	692	447	447	1.0000000
C4	25312213	25315247	BolC4t24237H	0	-	1687	2984	3034	0.9835201
C4	25353239	25353550	BolC4t24238H	0	+	239	311	311	1.0000000
C4	25355759	25355861	BolC4t24239H	0	+	106	102	102	1.0000000
C4	25356484	25363853	BolC4t24240H	0	-	7569	7207	7369	0.9780160
C4	25384680	25386169	BolC4t24241H	0	+	389	1314	1489	0.8824714
C4	25545731	25546607	BolC4t24242H	0	-	0	0	876	0.0000000
C4	25558654	25560044	BolC4t24243H	0	-	478	1045	1390	0.7517986
C4	25569371	25573005	BolC4t24244H	0	-	1477	3597	3634	0.9898184
C4	25577320	25578603	BolC4t24245H	0	+	586	1276	1283	0.9945440
C4	25586162	25588941	BolC4t24246H	0	-	1720	2779	2779	1.0000000
C4	25597318	25598172	BolC4t24247H	0	-	591	854	854	1.0000000
C4	25598241	25601098	BolC4t24248H	0	-	2540	2857	2857	1.0000000
C4	25747007	25752348	BolC4t24249H	0	-	2941	5309	5341	0.9940086
C4	25758950	25760148	BolC4t24250H	0	+	927	1198	1198	1.0000000
C4	25797297	25798035	BolC4t24251H	0	+	626	738	738	1.0000000
C4	25805783	25805990	BolC4t24252H	0	+	161	207	207	1.0000000
C4	25819337	25831207	BolC4t24253H	0	+	7178	11847	11870	0.9980623
C4	25840303	25845421	BolC4t24254H	0	+	3094	5072	5118	0.9910121
C4	25855447	25857629	BolC4t24255H	0	+	1483	2182	2182	1.0000000
C4	25896800	25899266	BolC4t24256H	0	+	1751	2466	2466	1.0000000
C4	25914154	25915366	BolC4t24257H	0	+	1140	1212	1212	1.0000000
C4	25915760	25916306	BolC4t24258H	0	-	286	546	546	1.0000000
C4	25930091	25930304	BolC4t24259H	0	+	194	213	213	1.0000000
C4	25931290	25934272	BolC4t24260H	0	-	784	2494	2982	0.8363515
C4	25937769	25940185	BolC4t24261H	0	-	2508	2416	2416	1.0000000
C4	25941229	25941409	BolC4t24262H	0	+	125	180	180	1.0000000
C4	25954874	25955480	BolC4t24263H	0	-	452	606	606	1.0000000
C4	25964784	25967727	BolC4t24264H	0	-	2448	2943	2943	1.0000000
C4	25971243	25971896	BolC4t24265H	0	-	422	653	653	1.0000000
C4	25991858	25993501	BolC4t24266H	0	-	1566	1643	1643	1.0000000
C4	26006772	26007789	BolC4t24267H	0	+	162	973	1017	0.9567355
C4	26008092	26011299	BolC4t24268H	0	-	2348	3207	3207	1.0000000
C4	26014148	26015641	BolC4t24269H	0	-	924	1385	1493	0.9276624
C4	26019058	26030748	BolC4t24270H	0	+	372	3771	11690	0.3225834
C4	26032062	26032293	BolC4t24271H	0	+	323	231	231	1.0000000
C4	26038940	26039216	BolC4t24272H	0	-	350	276	276	1.0000000
C4	26116847	26117894	BolC4t24273H	0	+	727	1047	1047	1.0000000
C4	26191460	26198598	BolC4t24274H	0	-	1315	3947	7138	0.5529560
C4	26242224	26244845	BolC4t24275H	0	+	1392	2621	2621	1.0000000
C4	26261590	26262851	BolC4t24276H	0	+	358	1261	1261	1.0000000
C4	26285751	26286130	BolC4t24277H	0	-	548	379	379	1.0000000
C4	26301568	26301771	BolC4t24278H	0	+	225	203	203	1.0000000
C4	26302081	26302298	BolC4t24279H	0	+	355	217	217	1.0000000
C4	26312375	26313915	BolC4t24280H	0	+	553	1502	1540	0.9753247
C4	26322919	26323604	BolC4t24281H	0	+	418	685	685	1.0000000
C4	26329638	26330740	BolC4t24282H	0	+	90	934	1102	0.8475499
C4	26344392	26344868	BolC4t24283H	0	+	743	476	476	1.0000000
C4	26350149	26351034	BolC4t24284H	0	+	582	875	885	0.9887006
C4	26356983	26360086	BolC4t24285H	0	+	958	2891	3103	0.9316790
C4	26374841	26377349	BolC4t24286H	0	+	1783	2508	2508	1.0000000
C4	26410248	26410614	BolC4t24287H	0	+	305	366	366	1.0000000
C4	26416669	26419212	BolC4t24288H	0	-	962	2460	2543	0.9673614
C4	26422822	26422978	BolC4t24289H	0	+	166	156	156	1.0000000
C4	26435751	26446468	BolC4t24290H	0	+	4306	8803	10717	0.8214052
C4	26450945	26453570	BolC4t24291H	0	+	1446	2625	2625	1.0000000
C4	26451206	26452853	BolC4t24292H	0	+	902	1647	1647	1.0000000
C4	26455746	26457778	BolC4t24293H	0	-	1128	2011	2032	0.9896653
C4	26466608	26466758	BolC4t24294H	0	-	20	150	150	1.0000000
C4	26467316	26467966	BolC4t24295H	0	-	97	650	650	1.0000000
C4	26470317	26471792	BolC4t24296H	0	+	247	1162	1475	0.7877966
C4	26481199	26482044	BolC4t24297H	0	-	78	845	845	1.0000000
C4	26515574	26516956	BolC4t24298H	0	-	214	1121	1382	0.8111433
C4	26519437	26519929	BolC4t24299H	0	+	614	492	492	1.0000000
C4	26520420	26520666	BolC4t24300H	0	+	235	246	246	1.0000000
C4	26534518	26534788	BolC4t24301H	0	+	215	270	270	1.0000000
C4	26535799	26536283	BolC4t24302H	0	-	629	484	484	1.0000000
C4	26538696	26541004	BolC4t24303H	0	-	620	1527	2308	0.6616118
C4	26541515	26541758	BolC4t24304H	0	-	95	243	243	1.0000000
C4	26547939	26548266	BolC4t24305H	0	+	326	327	327	1.0000000
C4	26567679	26568236	BolC4t24306H	0	-	559	557	557	1.0000000
C4	26568248	26568503	BolC4t24307H	0	-	674	255	255	1.0000000
C4	26569309	26569584	BolC4t24308H	0	+	496	275	275	1.0000000
C4	26614474	26615243	BolC4t24309H	0	-	0	0	769	0.0000000
C4	26616006	26617406	BolC4t24310H	0	-	437	1285	1400	0.9178572
C4	26618569	26619673	BolC4t24311H	0	-	521	1104	1104	1.0000000
C4	26642581	26643103	BolC4t24312H	0	-	0	0	522	0.0000000
C4	26663172	26663466	BolC4t24313H	0	+	270	294	294	1.0000000
C4	26713137	26721711	BolC4t24314H	0	-	3147	7180	8574	0.8374155
C4	26741276	26741948	BolC4t24315H	0	-	50	608	672	0.9047619
C4	26777119	26777536	BolC4t24316H	0	+	105	417	417	1.0000000
C4	26791873	26792080	BolC4t24317H	0	+	11	71	207	0.3429952
C4	26797666	26801016	BolC4t24318H	0	+	2202	3350	3350	1.0000000
C4	26810937	26811984	BolC4t24319H	0	+	415	1047	1047	1.0000000
C4	26821606	26822359	BolC4t24320H	0	+	33	362	753	0.4807437
C4	26825202	26825597	BolC4t24321H	0	+	335	395	395	1.0000000
C4	26860592	26861857	BolC4t24322H	0	-	2435	1265	1265	1.0000000
C4	26869269	26869651	BolC4t24323H	0	+	315	382	382	1.0000000
C4	26899149	26902807	BolC4t24324H	0	+	1799	3658	3658	1.0000000
C4	27009448	27011028	BolC4t24325H	0	-	278	1340	1580	0.8481013
C4	27011811	27012366	BolC4t24326H	0	-	374	555	555	1.0000000
C4	27012584	27012824	BolC4t24327H	0	+	154	240	240	1.0000000
C4	27027792	27028011	BolC4t24328H	0	+	196	219	219	1.0000000
C4	27028554	27028821	BolC4t24329H	0	+	255	267	267	1.0000000
C4	27046143	27046709	BolC4t24330H	0	+	559	566	566	1.0000000
C4	27049698	27049959	BolC4t24331H	0	-	591	261	261	1.0000000
C4	27067515	27070226	BolC4t24332H	0	-	1666	2711	2711	1.0000000
C4	27131064	27133374	BolC4t24333H	0	+	1098	2210	2310	0.9567100
C4	27133531	27134075	BolC4t24334H	0	+	760	544	544	1.0000000
C4	27170229	27171368	BolC4t24335H	0	-	814	1139	1139	1.0000000
C4	27245919	27246792	BolC4t24336H	0	-	5729	873	873	1.0000000
C4	27300865	27302125	BolC4t24337H	0	+	748	1198	1260	0.9507936
C4	27313104	27313557	BolC4t24338H	0	+	462	453	453	1.0000000
C4	27325212	27325560	BolC4t24339H	0	-	114	348	348	1.0000000
C4	27458335	27458880	BolC4t24340H	0	-	0	0	545	0.0000000
C4	27462850	27467677	BolC4t24341H	0	+	2481	4827	4827	1.0000000
C4	27467692	27468063	BolC4t24342H	0	+	1045	371	371	1.0000000
C4	27469710	27470908	BolC4t24343H	0	+	257	1198	1198	1.0000000
C4	27478263	27478799	BolC4t24344H	0	-	71	536	536	1.0000000
C4	27484926	27485289	BolC4t24345H	0	+	569	363	363	1.0000000
C4	27485491	27491763	BolC4t24346H	0	-	3647	5729	6272	0.9134247
C4	27486530	27486939	BolC4t24347H	0	-	2	20	409	0.0488998
C4	27494268	27495179	BolC4t24348H	0	+	1161	911	911	1.0000000
C4	27496750	27498936	BolC4t24349H	0	-	969	2186	2186	1.0000000
C4	27500670	27501996	BolC4t24350H	0	-	799	1326	1326	1.0000000
C4	27502068	27504008	BolC4t24351H	0	-	1343	1940	1940	1.0000000
C4	27527433	27528209	BolC4t24352H	0	+	665	776	776	1.0000000
C4	27527870	27529913	BolC4t24353H	0	+	1757	2043	2043	1.0000000
C4	27547559	27549431	BolC4t24354H	0	-	1278	1872	1872	1.0000000
C4	27560385	27563003	BolC4t24355H	0	+	1481	2503	2618	0.9560733
C4	27571633	27573442	BolC4t24356H	0	+	529	1580	1809	0.8734107
C4	27611201	27613956	BolC4t24357H	0	-	291	1485	2755	0.5390199
C4	27618919	27619111	BolC4t24358H	0	+	22	126	192	0.6562500
C4	27660523	27660715	BolC4t24359H	0	+	5	132	192	0.6875000
C4	27695886	27696129	BolC4t24360H	0	+	16	229	243	0.9423868
C4	27696557	27698269	BolC4t24361H	0	-	139	1272	1712	0.7429907
C4	27703309	27703918	BolC4t24362H	0	+	56	415	609	0.6814450
C4	27705069	27710828	BolC4t24363H	0	-	295	2632	5759	0.4570238
C4	27710840	27711195	BolC4t24364H	0	-	2	85	355	0.2394366
C4	27712313	27712603	BolC4t24365H	0	-	66	290	290	1.0000000
C4	27724145	27724539	BolC4t24366H	0	+	23	394	394	1.0000000
C4	27811318	27811809	BolC4t24367H	0	+	646	491	491	1.0000000
C4	27831180	27832438	BolC4t24368H	0	-	963	1258	1258	1.0000000
C4	27886754	27888259	BolC4t24369H	0	+	1369	1505	1505	1.0000000
C4	27888739	27889972	BolC4t24370H	0	-	580	1232	1233	0.9991890
C4	27890810	27891065	BolC4t24371H	0	+	290	255	255	1.0000000
C4	27893652	27895780	BolC4t24372H	0	-	1098	2128	2128	1.0000000
C4	27897319	27900112	BolC4t24373H	0	-	1873	2689	2793	0.9627640
C4	27913374	27913593	BolC4t24374H	0	+	236	219	219	1.0000000
C4	27917148	27919780	BolC4t24375H	0	-	1533	2595	2632	0.9859422
C4	27923692	27925501	BolC4t24376H	0	-	1561	1809	1809	1.0000000
C4	27948709	27949852	BolC4t24377H	0	+	1504	1143	1143	1.0000000
C4	27951172	27952329	BolC4t24378H	0	+	665	1157	1157	1.0000000
C4	27973368	27975568	BolC4t24379H	0	-	1642	2133	2200	0.9695455
C4	27984085	27991388	BolC4t24380H	0	-	6135	7244	7303	0.9919211
C4	28003487	28005040	BolC4t24381H	0	-	1068	1478	1553	0.9517063
C4	28016822	28020415	BolC4t24382H	0	-	3135	3593	3593	1.0000000
C4	28022202	28022699	BolC4t24383H	0	+	43	497	497	1.0000000
C4	28026456	28027017	BolC4t24384H	0	-	1	88	561	0.1568628
C4	28027844	28029008	BolC4t24385H	0	+	951	1164	1164	1.0000000
C4	28033728	28038144	BolC4t24386H	0	-	1364	3780	4416	0.8559783
C4	28043714	28047460	BolC4t24387H	0	-	2013	3746	3746	1.0000000
C4	28054298	28055552	BolC4t24388H	0	-	329	716	1254	0.5709729
C4	28058542	28058734	BolC4t24389H	0	-	233	192	192	1.0000000
C4	28067229	28068217	BolC4t24390H	0	-	247	988	988	1.0000000
C4	28089519	28090155	BolC4t24391H	0	+	170	573	636	0.9009434
C4	28107815	28108277	BolC4t24392H	0	+	0	0	462	0.0000000
C4	28160862	28161798	BolC4t24393H	0	-	602	936	936	1.0000000
C4	28165185	28165410	BolC4t24394H	0	+	156	225	225	1.0000000
C4	28170285	28170486	BolC4t24395H	0	+	191	201	201	1.0000000
C4	28188005	28189661	BolC4t24396H	0	+	492	1599	1656	0.9655797
C4	28204534	28204927	BolC4t24397H	0	-	39	168	393	0.4274809
C4	28206814	28209484	BolC4t24398H	0	+	147	1537	2670	0.5756555
C4	28212362	28219395	BolC4t24399H	0	+	1041	3476	7033	0.4942414
C4	28225820	28226628	BolC4t24400H	0	-	134	729	808	0.9022277
C4	28261829	28262570	BolC4t24401H	0	-	1146	741	741	1.0000000
C4	28264346	28264866	BolC4t24402H	0	-	252	520	520	1.0000000
C4	28268079	28269144	BolC4t24403H	0	-	323	1056	1065	0.9915493
C4	28272501	28274200	BolC4t24404H	0	-	1141	1699	1699	1.0000000
C4	28305057	28305986	BolC4t24405H	0	-	602	929	929	1.0000000
C4	28318882	28321274	BolC4t24406H	0	-	911	2392	2392	1.0000000
C4	28357032	28357284	BolC4t24407H	0	-	160	252	252	1.0000000
C4	28369790	28383925	BolC4t24408H	0	+	505	5453	14135	0.3857800
C4	28393332	28393656	BolC4t24409H	0	+	36	309	324	0.9537037
C4	28393688	28394770	BolC4t24410H	0	+	143	959	1082	0.8863216
C4	28396850	28397154	BolC4t24411H	0	+	49	263	304	0.8651316
C4	28397359	28397515	BolC4t24412H	0	+	36	156	156	1.0000000
C4	28399858	28400170	BolC4t24413H	0	+	83	312	312	1.0000000
C4	28404218	28405535	BolC4t24414H	0	-	0	0	1317	0.0000000
C4	28457528	28457792	BolC4t24415H	0	+	203	264	264	1.0000000
C4	28475233	28475344	BolC4t24416H	0	+	173	111	111	1.0000000
C4	28483894	28487917	BolC4t24417H	0	+	699	3468	4023	0.8620433
C4	28495633	28496344	BolC4t24418H	0	+	542	711	711	1.0000000
C4	28505984	28506245	BolC4t24419H	0	+	207	261	261	1.0000000
C4	28516743	28517157	BolC4t24420H	0	-	217	399	414	0.9637681
C4	28521181	28521364	BolC4t24421H	0	+	203	183	183	1.0000000
C4	28562730	28617309	BolC4t24422H	0	+	23375	47484	54579	0.8700050
C4	28563003	28563545	BolC4t24423H	0	+	3	140	542	0.2583026
C4	28595225	28595570	BolC4t24424H	0	-	310	345	345	1.0000000
C4	28608699	28609253	BolC4t24425H	0	+	146	554	554	1.0000000
C4	28609401	28609829	BolC4t24426H	0	+	205	428	428	1.0000000
C4	28609926	28612942	BolC4t24427H	0	+	1569	3016	3016	1.0000000
C4	28617948	28619019	BolC4t24428H	0	-	217	955	1071	0.8916900
C4	28619241	28620640	BolC4t24429H	0	-	766	1399	1399	1.0000000
C4	28638557	28638782	BolC4t24430H	0	-	37	225	225	1.0000000
C4	28650672	28650930	BolC4t24431H	0	+	2	133	258	0.5155039
C4	28678482	28679472	BolC4t24432H	0	+	150	933	990	0.9424242
C4	28685838	28687642	BolC4t24433H	0	-	1164	1804	1804	1.0000000
C4	28687645	28694598	BolC4t24434H	0	-	3574	6953	6953	1.0000000
C4	28695258	28699040	BolC4t24435H	0	-	2385	3782	3782	1.0000000
C4	28725146	28725347	BolC4t24436H	0	-	0	0	201	0.0000000
C4	28772993	28773808	BolC4t24437H	0	+	15	476	815	0.5840491
C4	28811676	28812054	BolC4t24438H	0	+	54	343	378	0.9074074
C4	28814802	28815774	BolC4t24439H	0	-	404	972	972	1.0000000
C4	28868059	28868236	BolC4t24440H	0	+	31	171	177	0.9661017
C4	28891211	28891427	BolC4t24441H	0	+	189	216	216	1.0000000
C4	28900054	28900465	BolC4t24442H	0	-	350	411	411	1.0000000
C4	28902505	28902941	BolC4t24443H	0	+	437	436	436	1.0000000
C4	28995382	28995562	BolC4t24444H	0	+	147	180	180	1.0000000
C4	28998841	28999910	BolC4t24445H	0	-	78	1027	1069	0.9607109
C4	29000259	29004523	BolC4t24446H	0	+	1281	4018	4264	0.9423077
C4	29009875	29018844	BolC4t24447H	0	-	1785	7746	8969	0.8636414
C4	29012383	29013958	BolC4t24448H	0	+	205	1491	1575	0.9466667
C4	29032866	29033713	BolC4t24449H	0	+	37	465	847	0.5489964
C4	29038222	29038798	BolC4t24450H	0	+	280	576	576	1.0000000
C4	29080560	29080961	BolC4t24451H	0	-	173	401	401	1.0000000
C4	29105052	29105936	BolC4t24452H	0	+	763	884	884	1.0000000
C4	29107380	29108436	BolC4t24453H	0	+	1179	1056	1056	1.0000000
C4	29116538	29117021	BolC4t24454H	0	-	4	56	483	0.1159420
C4	29136523	29140371	BolC4t24455H	0	+	2769	3848	3848	1.0000000
C4	29142290	29142533	BolC4t24456H	0	+	286	243	243	1.0000000
C4	29149016	29149528	BolC4t24457H	0	+	544	512	512	1.0000000
C4	29152382	29152538	BolC4t24458H	0	+	4	147	156	0.9423077
C4	29153828	29154283	BolC4t24459H	0	-	87	433	455	0.9516484
C4	29156168	29156821	BolC4t24460H	0	-	521	653	653	1.0000000
C4	29157912	29158524	BolC4t24461H	0	+	440	612	612	1.0000000
C4	29164496	29170210	BolC4t24462H	0	-	3056	5616	5714	0.9828491
C4	29182677	29183154	BolC4t24463H	0	-	428	477	477	1.0000000
C4	29183176	29184248	BolC4t24464H	0	-	777	1072	1072	1.0000000
C4	29195330	29195552	BolC4t24465H	0	-	195	222	222	1.0000000
C4	29196424	29196601	BolC4t24466H	0	-	150	177	177	1.0000000
C4	29225829	29227302	BolC4t24467H	0	+	801	1416	1473	0.9613035
C4	29233386	29235030	BolC4t24468H	0	+	243	1521	1644	0.9251825
C4	29239149	29240723	BolC4t24469H	0	+	86	1018	1574	0.6467599
C4	29246492	29246660	BolC4t24470H	0	+	1	80	168	0.4761905
C4	29278058	29278919	BolC4t24471H	0	+	498	861	861	1.0000000
C4	29297165	29299541	BolC4t24472H	0	+	1609	2376	2376	1.0000000
C4	29302449	29303533	BolC4t24473H	0	+	14	519	1084	0.4787823
C4	29304969	29306271	BolC4t24474H	0	+	265	1183	1302	0.9086022
C4	29306465	29306795	BolC4t24475H	0	+	281	330	330	1.0000000
C4	29306949	29307256	BolC4t24476H	0	+	252	307	307	1.0000000
C4	29308874	29311740	BolC4t24477H	0	+	1845	2866	2866	1.0000000
C4	29312709	29312844	BolC4t24478H	0	+	172	135	135	1.0000000
C4	29315874	29316237	BolC4t24479H	0	+	384	363	363	1.0000000
C4	29331708	29349475	BolC4t24480H	0	+	8275	14547	17767	0.8187651
C4	29349540	29349849	BolC4t24481H	0	+	309	309	309	1.0000000
C4	29372779	29372893	BolC4t24482H	0	+	46	114	114	1.0000000
C4	29378762	29381003	BolC4t24483H	0	+	1115	2241	2241	1.0000000
C4	29431548	29431788	BolC4t24484H	0	+	189	240	240	1.0000000
C4	29434147	29439915	BolC4t24485H	0	+	2086	4488	5768	0.7780860
C4	29482734	29483148	BolC4t24486H	0	+	299	414	414	1.0000000
C4	29490654	29491035	BolC4t24487H	0	+	288	381	381	1.0000000
C4	29504221	29504807	BolC4t24488H	0	-	382	586	586	1.0000000
C4	29504859	29505381	BolC4t24489H	0	-	472	522	522	1.0000000
C4	29506600	29507629	BolC4t24490H	0	-	593	1029	1029	1.0000000
C4	29524036	29524705	BolC4t24491H	0	+	460	669	669	1.0000000
C4	29533154	29544393	BolC4t24492H	0	+	6212	11234	11239	0.9995551
C4	29534879	29535363	BolC4t24493H	0	-	375	484	484	1.0000000
C4	29546158	29552385	BolC4t24494H	0	-	3525	6227	6227	1.0000000
C4	29574270	29584231	BolC4t24495H	0	-	3689	8960	9961	0.8995081
C4	29587934	29588147	BolC4t24496H	0	+	293	213	213	1.0000000
C4	29600012	29600294	BolC4t24497H	0	-	40	93	282	0.3297872
C4	29601602	29601803	BolC4t24498H	0	-	97	201	201	1.0000000
C4	29602552	29602894	BolC4t24499H	0	-	40	190	342	0.5555556
C4	29602909	29603773	BolC4t24500H	0	-	327	849	864	0.9826389
C4	29612719	29613171	BolC4t24501H	0	-	314	452	452	1.0000000
C4	29614567	29614900	BolC4t24502H	0	-	308	333	333	1.0000000
C4	29621238	29622466	BolC4t24503H	0	-	2	166	1228	0.1351791
C4	29627950	29628496	BolC4t24504H	0	-	437	546	546	1.0000000
C4	29644843	29648996	BolC4t24505H	0	-	2510	4027	4153	0.9696605
C4	29657804	29658884	BolC4t24506H	0	-	596	1080	1080	1.0000000
C4	29659806	29660799	BolC4t24507H	0	-	518	993	993	1.0000000
C4	29662568	29662763	BolC4t24508H	0	-	154	195	195	1.0000000
C4	29667058	29667382	BolC4t24509H	0	+	2	19	324	0.0586420
C4	29693447	29695430	BolC4t24510H	0	+	1227	1983	1983	1.0000000
C4	29698679	29699807	BolC4t24511H	0	+	568	1128	1128	1.0000000
C4	29700226	29700643	BolC4t24512H	0	-	290	417	417	1.0000000
C4	29700775	29700901	BolC4t24513H	0	-	120	126	126	1.0000000
C4	29710580	29711823	BolC4t24514H	0	+	1178	1243	1243	1.0000000
C4	29712590	29717450	BolC4t24515H	0	-	3078	4713	4860	0.9697531
C4	29743353	29745985	BolC4t24516H	0	-	1468	2632	2632	1.0000000
C4	29764238	29770062	BolC4t24517H	0	+	3512	5819	5824	0.9991415
C4	29771376	29772283	BolC4t24518H	0	-	1008	907	907	1.0000000
C4	29772486	29775903	BolC4t24519H	0	-	2772	3417	3417	1.0000000
C4	29777176	29780278	BolC4t24520H	0	+	1545	3102	3102	1.0000000
C4	29782280	29785193	BolC4t24521H	0	-	1444	2913	2913	1.0000000
C4	29785719	29791688	BolC4t24522H	0	+	2553	5858	5969	0.9814039
C4	29793107	29794054	BolC4t24523H	0	+	422	947	947	1.0000000
C4	29794326	29796816	BolC4t24524H	0	-	1209	2490	2490	1.0000000
C4	29798626	29803518	BolC4t24525H	0	-	3177	4892	4892	1.0000000
C4	29804403	29804769	BolC4t24526H	0	+	37	295	366	0.8060109
C4	29806652	29806862	BolC4t24527H	0	-	77	210	210	1.0000000
C4	29807149	29807469	BolC4t24528H	0	-	8	183	320	0.5718750
C4	29808978	29812977	BolC4t24529H	0	+	3125	3993	3999	0.9984996
C4	29813478	29814019	BolC4t24530H	0	-	559	541	541	1.0000000
C4	29818604	29819429	BolC4t24531H	0	+	748	825	825	1.0000000
C4	29820724	29821273	BolC4t24532H	0	-	351	549	549	1.0000000
C4	29824861	29825156	BolC4t24533H	0	+	7	193	295	0.6542373
C4	29865604	29866851	BolC4t24534H	0	-	178	1050	1247	0.8420209
C4	29869028	29870239	BolC4t24535H	0	+	205	1115	1211	0.9207267
C4	29884081	29885863	BolC4t24536H	0	+	1574	1731	1782	0.9713805
C4	29890153	29894066	BolC4t24537H	0	+	2427	3754	3913	0.9593662
C4	29894366	29895502	BolC4t24538H	0	-	585	1136	1136	1.0000000
C4	29895854	29899265	BolC4t24539H	0	+	1438	3354	3411	0.9832894
C4	29899855	29902166	BolC4t24540H	0	+	1385	2264	2311	0.9796625
C4	29903602	29903950	BolC4t24541H	0	-	469	348	348	1.0000000
C4	29920814	29921228	BolC4t24542H	0	-	351	414	414	1.0000000
C4	29928975	29929980	BolC4t24543H	0	+	397	1005	1005	1.0000000
C4	29933053	29933824	BolC4t24544H	0	-	714	771	771	1.0000000
C4	29934739	29935941	BolC4t24545H	0	-	583	1202	1202	1.0000000
C4	29936595	29943342	BolC4t24546H	0	-	2484	5704	6747	0.8454128
C4	29943887	29947280	BolC4t24547H	0	+	1276	2102	3393	0.6195108
C4	29948108	29948327	BolC4t24548H	0	+	360	219	219	1.0000000
C4	29948808	29949231	BolC4t24549H	0	+	313	423	423	1.0000000
C4	29964380	29964923	BolC4t24550H	0	+	541	543	543	1.0000000
C4	29965103	29966898	BolC4t24551H	0	-	999	1677	1795	0.9342619
C4	29974417	29974753	BolC4t24552H	0	+	74	336	336	1.0000000
C4	29975922	29977176	BolC4t24553H	0	+	133	951	1254	0.7583732
C4	29990310	29992065	BolC4t24554H	0	-	890	1755	1755	1.0000000
C4	29998060	29999480	BolC4t24555H	0	-	1081	1420	1420	1.0000000
C4	30004608	30004788	BolC4t24556H	0	-	161	180	180	1.0000000
C4	30020743	30023260	BolC4t24557H	0	+	795	2322	2517	0.9225268
C4	30023715	30023877	BolC4t24558H	0	-	287	162	162	1.0000000
C4	30026738	30027047	BolC4t24559H	0	-	36	280	309	0.9061489
C4	30030735	30031047	BolC4t24560H	0	-	11	231	312	0.7403846
C4	30041531	30044318	BolC4t24561H	0	-	464	1463	2787	0.5249372
C4	30049573	30049810	BolC4t24562H	0	+	252	237	237	1.0000000
C4	30058417	30059450	BolC4t24563H	0	+	609	1033	1033	1.0000000
C4	30060508	30060817	BolC4t24564H	0	+	180	309	309	1.0000000
C4	30061128	30063415	BolC4t24565H	0	-	1429	2287	2287	1.0000000
C4	30062153	30062678	BolC4t24566H	0	+	245	525	525	1.0000000
C4	30064405	30067149	BolC4t24567H	0	+	3038	2744	2744	1.0000000
C4	30067437	30068601	BolC4t24568H	0	-	785	1164	1164	1.0000000
C4	30074948	30075952	BolC4t24569H	0	+	1063	1004	1004	1.0000000
C4	30076641	30078015	BolC4t24570H	0	+	760	1374	1374	1.0000000
C4	30078916	30079212	BolC4t24571H	0	+	8	249	296	0.8412162
C4	30079405	30079748	BolC4t24572H	0	+	8	125	343	0.3644315
C4	30081790	30099619	BolC4t24573H	0	+	3004	8968	17829	0.5030007
C4	30101828	30102492	BolC4t24574H	0	+	795	664	664	1.0000000
C4	30103043	30105606	BolC4t24575H	0	-	2416	2563	2563	1.0000000
C4	30111343	30111750	BolC4t24576H	0	-	114	398	407	0.9778870
C4	30112357	30113155	BolC4t24577H	0	+	542	779	798	0.9761904
C4	30116521	30116722	BolC4t24578H	0	-	0	0	201	0.0000000
C4	30118634	30120624	BolC4t24579H	0	+	1052	1990	1990	1.0000000
C4	30122829	30123660	BolC4t24580H	0	+	449	783	831	0.9422383
C4	30126077	30128671	BolC4t24581H	0	-	737	2477	2594	0.9548959
C4	30131026	30132397	BolC4t24582H	0	-	268	1105	1371	0.8059810
C4	30133133	30136223	BolC4t24583H	0	+	432	1878	3090	0.6077670
C4	30143789	30144170	BolC4t24584H	0	-	188	381	381	1.0000000
C4	30148604	30150743	BolC4t24585H	0	-	1487	2139	2139	1.0000000
C4	30155119	30155701	BolC4t24586H	0	-	35	529	582	0.9089347
C4	30174721	30175604	BolC4t24587H	0	-	27	305	883	0.3454134
C4	30199554	30201636	BolC4t24588H	0	+	210	1724	2082	0.8280500
C4	30209922	30210803	BolC4t24589H	0	-	5	166	881	0.1884222
C4	30257724	30260772	BolC4t24590H	0	-	2008	2932	3048	0.9619423
C4	30261348	30262296	BolC4t24591H	0	-	802	948	948	1.0000000
C4	30271554	30274611	BolC4t24592H	0	+	1254	2978	3057	0.9741577
C4	30276570	30278309	BolC4t24593H	0	+	1018	1739	1739	1.0000000
C4	30278698	30280097	BolC4t24594H	0	+	1177	1399	1399	1.0000000
C4	30280598	30281072	BolC4t24595H	0	-	67	326	474	0.6877637
C4	30305115	30305328	BolC4t24596H	0	-	42	213	213	1.0000000
C4	30306862	30308251	BolC4t24597H	0	-	1044	1389	1389	1.0000000
C4	30310891	30314244	BolC4t24598H	0	+	279	1836	3353	0.5475693
C4	30315126	30315455	BolC4t24599H	0	-	4	45	329	0.1367781
C4	30316840	30317359	BolC4t24600H	0	-	54	153	519	0.2947977
C4	30329210	30331115	BolC4t24601H	0	+	1	62	1905	0.0325459
C4	30341101	30341965	BolC4t24602H	0	-	105	682	864	0.7893519
C4	30350077	30352834	BolC4t24603H	0	-	1695	2359	2757	0.8556402
C4	30358043	30359099	BolC4t24604H	0	-	724	1056	1056	1.0000000
C4	30360455	30361277	BolC4t24605H	0	-	554	822	822	1.0000000
C4	30362157	30362753	BolC4t24606H	0	-	186	596	596	1.0000000
C4	30363156	30363471	BolC4t24607H	0	+	250	315	315	1.0000000
C4	30363631	30364922	BolC4t24608H	0	-	444	1291	1291	1.0000000
C4	30365518	30366285	BolC4t24609H	0	-	469	767	767	1.0000000
C4	30377405	30377693	BolC4t24610H	0	+	72	288	288	1.0000000
C4	30385503	30386466	BolC4t24611H	0	-	52	445	963	0.4620976
C4	30396856	30397552	BolC4t24612H	0	+	367	696	696	1.0000000
C4	30417866	30420833	BolC4t24613H	0	+	330	2471	2967	0.8328277
C4	30440534	30444671	BolC4t24614H	0	-	2547	4132	4137	0.9987914
C4	30442730	30443039	BolC4t24615H	0	+	195	309	309	1.0000000
C4	30448538	30448868	BolC4t24616H	0	-	0	0	330	0.0000000
C4	30450182	30450525	BolC4t24617H	0	+	645	343	343	1.0000000
C4	30451578	30452434	BolC4t24618H	0	+	1374	856	856	1.0000000
C4	30456154	30457044	BolC4t24619H	0	-	256	890	890	1.0000000
C4	30469573	30469833	BolC4t24620H	0	-	256	260	260	1.0000000
C4	30493508	30494257	BolC4t24621H	0	-	11	553	749	0.7383177
C4	30497374	30498140	BolC4t24622H	0	-	261	746	766	0.9738904
C4	30504888	30505749	BolC4t24623H	0	-	121	861	861	1.0000000
C4	30509195	30510191	BolC4t24624H	0	-	545	996	996	1.0000000
C4	30522696	30523024	BolC4t24625H	0	+	6	289	328	0.8810976
C4	30523538	30530586	BolC4t24626H	0	+	641	4284	7048	0.6078320
C4	30526065	30528262	BolC4t24627H	0	+	39	1210	2197	0.5507510
C4	30526572	30527172	BolC4t24628H	0	+	14	405	600	0.6750000
C4	30529085	30530143	BolC4t24629H	0	-	112	645	1058	0.6096408
C4	30536380	30536605	BolC4t24630H	0	-	183	225	225	1.0000000
C4	30542672	30542837	BolC4t24631H	0	-	126	165	165	1.0000000
C4	30588961	30589147	BolC4t24632H	0	+	0	0	186	0.0000000
C4	30594411	30597833	BolC4t24633H	0	+	217	2183	3422	0.6379310
C4	30605238	30605971	BolC4t24634H	0	-	125	389	733	0.5306958
C4	30636737	30637834	BolC4t24635H	0	+	79	886	1097	0.8076572
C4	30642053	30642669	BolC4t24636H	0	-	98	48	616	0.0779221
C4	30642916	30643570	BolC4t24637H	0	-	25	87	654	0.1330275
C4	30667489	30667780	BolC4t24638H	0	+	66	291	291	1.0000000
C4	30672339	30673513	BolC4t24639H	0	+	8	54	1174	0.0459966
C4	30683168	30684916	BolC4t24640H	0	+	132	1048	1748	0.5995423
C4	30688978	30689676	BolC4t24641H	0	-	419	698	698	1.0000000
C4	30693269	30694850	BolC4t24642H	0	-	70	333	1581	0.2106262
C4	30749491	30750943	BolC4t24643H	0	+	132	812	1452	0.5592287
C4	30778719	30778833	BolC4t24644H	0	-	0	0	114	0.0000000
C4	30781408	30782753	BolC4t24645H	0	-	85	142	1345	0.1055762
C4	30791471	30791729	BolC4t24646H	0	+	2	27	258	0.1046512
C4	30795411	30797371	BolC4t24647H	0	+	1048	1960	1960	1.0000000
C4	30797885	30798545	BolC4t24648H	0	-	247	660	660	1.0000000
C4	30802491	30803849	BolC4t24649H	0	-	304	1356	1358	0.9985272
C4	30814102	30814264	BolC4t24650H	0	-	49	125	162	0.7716050
C4	30823695	30825007	BolC4t24651H	0	+	943	1276	1312	0.9725610
C4	30839123	30840515	BolC4t24652H	0	+	121	964	1392	0.6925287
C4	30851166	30854061	BolC4t24653H	0	-	1191	2893	2895	0.9993092
C4	30857377	30857545	BolC4t24654H	0	+	0	0	168	0.0000000
C4	30871768	30873830	BolC4t24655H	0	+	347	747	2062	0.3622696
C4	30881141	30881782	BolC4t24656H	0	+	267	641	641	1.0000000
C4	30882941	30883347	BolC4t24657H	0	-	26	153	406	0.3768473
C4	30887424	30888774	BolC4t24658H	0	+	531	1187	1350	0.8792593
C4	30907652	30908870	BolC4t24659H	0	+	390	1121	1218	0.9203612
C4	30909705	30910179	BolC4t24660H	0	+	168	474	474	1.0000000
C4	30910373	30910694	BolC4t24661H	0	-	28	125	321	0.3894081
C4	30912113	30912770	BolC4t24662H	0	-	250	657	657	1.0000000
C4	30928105	30929508	BolC4t24663H	0	+	799	1403	1403	1.0000000
C4	30930013	30935954	BolC4t24664H	0	+	65	330	5941	0.0555462
C4	30930683	30931154	BolC4t24665H	0	-	0	0	471	0.0000000
C4	30931295	30933926	BolC4t24666H	0	-	48	124	2631	0.0471304
C4	30934708	30935440	BolC4t24667H	0	-	14	56	732	0.0765027
C4	30936051	30939569	BolC4t24668H	0	+	119	1674	3518	0.4758385
C4	30944131	30944502	BolC4t24669H	0	-	327	371	371	1.0000000
C4	30946048	30946853	BolC4t24670H	0	-	842	805	805	1.0000000
C4	30948935	30950775	BolC4t24671H	0	-	1451	1420	1840	0.7717391
C4	30953161	30953452	BolC4t24672H	0	-	46	239	291	0.8213059
C4	30953755	30955219	BolC4t24673H	0	-	37	668	1464	0.4562842
C4	30958023	30958522	BolC4t24674H	0	-	460	499	499	1.0000000
C4	30968150	30968528	BolC4t24675H	0	+	11	315	378	0.8333333
C4	30975024	30975596	BolC4t24676H	0	-	333	569	572	0.9947553
C4	30979952	30980567	BolC4t24677H	0	+	190	548	615	0.8910569
C4	30985456	30988021	BolC4t24678H	0	-	481	1263	2565	0.4923977
C4	31016145	31016704	BolC4t24679H	0	+	368	559	559	1.0000000
C4	31016642	31019560	BolC4t24680H	0	+	208	1714	2918	0.5873886
C4	31020682	31022265	BolC4t24681H	0	+	12	88	1583	0.0555907
C4	31024546	31026468	BolC4t24682H	0	-	630	1795	1922	0.9339230
C4	31082044	31083706	BolC4t24683H	0	-	862	1652	1662	0.9939831
C4	31084229	31085783	BolC4t24684H	0	-	1040	1501	1554	0.9658945
C4	31090227	31092819	BolC4t24685H	0	+	1062	2471	2592	0.9533179
C4	31093054	31093676	BolC4t24686H	0	-	568	622	622	1.0000000
C4	31094167	31095311	BolC4t24687H	0	+	1208	1144	1144	1.0000000
C4	31095583	31097371	BolC4t24688H	0	-	1130	1788	1788	1.0000000
C4	31102718	31104308	BolC4t24689H	0	+	959	1590	1590	1.0000000
C4	31104471	31110352	BolC4t24690H	0	-	1441	5260	5881	0.8944057
C4	31111557	31112563	BolC4t24691H	0	-	456	1006	1006	1.0000000
C4	31133404	31134865	BolC4t24692H	0	+	149	670	1461	0.4585900
C4	31142356	31143252	BolC4t24693H	0	+	583	896	896	1.0000000
C4	31143687	31144891	BolC4t24694H	0	-	308	1150	1204	0.9551495
C4	31158703	31159415	BolC4t24695H	0	+	293	712	712	1.0000000
C4	31162476	31165566	BolC4t24696H	0	+	1269	2508	3090	0.8116505
C4	31163766	31164030	BolC4t24697H	0	-	19	190	264	0.7196970
C4	31166900	31167307	BolC4t24698H	0	+	354	407	407	1.0000000
C4	31209644	31211199	BolC4t24699H	0	+	403	1555	1555	1.0000000
C4	31249016	31249562	BolC4t24700H	0	+	236	546	546	1.0000000
C4	31255532	31255757	BolC4t24701H	0	-	252	225	225	1.0000000
C4	31256083	31256413	BolC4t24702H	0	-	667	330	330	1.0000000
C4	31262668	31262929	BolC4t24703H	0	+	334	261	261	1.0000000
C4	31266105	31266855	BolC4t24704H	0	+	564	750	750	1.0000000
C4	31272081	31272535	BolC4t24705H	0	+	40	344	454	0.7577093
C4	31278981	31279553	BolC4t24706H	0	+	504	572	572	1.0000000
C4	31283615	31283999	BolC4t24707H	0	-	190	384	384	1.0000000
C4	31295110	31295547	BolC4t24708H	0	+	279	437	437	1.0000000
C4	31296289	31299386	BolC4t24709H	0	-	2296	3031	3097	0.9786891
C4	31312702	31318036	BolC4t24710H	0	+	3304	5305	5334	0.9945632
C4	31318373	31319810	BolC4t24711H	0	-	944	1302	1437	0.9060543
C4	31323432	31326225	BolC4t24712H	0	-	1245	2464	2793	0.8822055
C4	31328062	31330671	BolC4t24713H	0	+	603	1907	2609	0.7309314
C4	31334135	31352790	BolC4t24714H	0	+	6634	14278	18655	0.7653712
C4	31372091	31385004	BolC4t24715H	0	+	5573	12219	12913	0.9462557
C4	31397065	31397733	BolC4t24716H	0	+	53	112	668	0.1676647
C4	31403278	31403395	BolC4t24717H	0	+	0	0	117	0.0000000
C4	31432035	31432386	BolC4t24718H	0	-	699	351	351	1.0000000
C4	31434681	31434831	BolC4t24719H	0	+	195	150	150	1.0000000
C4	31439145	31440624	BolC4t24720H	0	-	1235	1479	1479	1.0000000
C4	31441096	31447580	BolC4t24721H	0	-	1650	5631	6484	0.8684454
C4	31455981	31459021	BolC4t24722H	0	+	1569	2919	3040	0.9601974
C4	31459452	31461247	BolC4t24723H	0	-	1501	1795	1795	1.0000000
C4	31472620	31474910	BolC4t24724H	0	+	133	1779	2290	0.7768559
C4	31475615	31482051	BolC4t24725H	0	-	81	1316	6436	0.2044748
C4	31484809	31485484	BolC4t24726H	0	-	45	549	675	0.8133333
C4	31487655	31488839	BolC4t24727H	0	+	865	1184	1184	1.0000000
C4	31490297	31491776	BolC4t24728H	0	+	972	1479	1479	1.0000000
C4	31492362	31494795	BolC4t24729H	0	-	1461	2420	2433	0.9946568
C4	31510631	31511546	BolC4t24730H	0	+	960	915	915	1.0000000
C4	31536526	31537143	BolC4t24731H	0	+	5	89	617	0.1442464
C4	31562530	31562683	BolC4t24732H	0	-	0	0	153	0.0000000
C4	31579576	31580235	BolC4t24733H	0	+	370	659	659	1.0000000
C4	31580921	31583456	BolC4t24734H	0	+	757	2535	2535	1.0000000
C4	31601268	31602427	BolC4t24735H	0	+	56	754	1159	0.6505609
C4	31629037	31629556	BolC4t24736H	0	+	3	192	519	0.3699422
C4	31633635	31635065	BolC4t24737H	0	-	3	170	1430	0.1188811
C4	31636720	31637619	BolC4t24738H	0	+	349	860	899	0.9566185
C4	31649925	31651152	BolC4t24739H	0	+	695	1100	1227	0.8964955
C4	31651817	31652300	BolC4t24740H	0	-	94	426	483	0.8819876
C4	31661864	31662902	BolC4t24741H	0	-	818	1030	1038	0.9922929
C4	31675373	31675700	BolC4t24742H	0	+	353	327	327	1.0000000
C4	31678507	31681081	BolC4t24743H	0	+	1735	2574	2574	1.0000000
C4	31696245	31699769	BolC4t24744H	0	+	854	3368	3524	0.9557321
C4	31715761	31716404	BolC4t24745H	0	-	231	643	643	1.0000000
C4	31722475	31723413	BolC4t24746H	0	+	841	938	938	1.0000000
C4	31724322	31727020	BolC4t24747H	0	-	1310	2698	2698	1.0000000
C4	31727924	31733581	BolC4t24748H	0	+	3763	5594	5657	0.9888633
C4	31744935	31746509	BolC4t24749H	0	-	203	1327	1574	0.8430750
C4	31754626	31755139	BolC4t24750H	0	-	166	513	513	1.0000000
C4	31764117	31766858	BolC4t24751H	0	-	1283	1916	2741	0.6990150
C4	31772370	31774258	BolC4t24752H	0	-	263	597	1888	0.3162076
C4	31792236	31793412	BolC4t24753H	0	+	640	1176	1176	1.0000000
C4	31794759	31795809	BolC4t24754H	0	-	602	1050	1050	1.0000000
C4	31805129	31806188	BolC4t24755H	0	-	292	904	1059	0.8536355
C4	31813886	31815581	BolC4t24756H	0	+	1100	1695	1695	1.0000000
C4	31817576	31819001	BolC4t24757H	0	-	1019	1425	1425	1.0000000
C4	31829965	31830070	BolC4t24758H	0	+	219	105	105	1.0000000
C4	31837289	31838962	BolC4t24759H	0	-	1776	1673	1673	1.0000000
C4	31839520	31840486	BolC4t24760H	0	-	736	966	966	1.0000000
C4	31851387	31852281	BolC4t24761H	0	-	682	894	894	1.0000000
C4	31854624	31856720	BolC4t24762H	0	-	1307	1903	2096	0.9079198
C4	31860879	31863155	BolC4t24763H	0	-	908	1367	2276	0.6006151
C4	31865167	31866397	BolC4t24764H	0	-	709	1230	1230	1.0000000
C4	31879438	31883549	BolC4t24765H	0	-	485	1815	4111	0.4414984
C4	31882514	31882829	BolC4t24766H	0	-	0	0	315	0.0000000
C4	31901768	31903803	BolC4t24767H	0	-	222	1880	2035	0.9238330
C4	31909003	31910646	BolC4t24768H	0	-	553	1587	1643	0.9659160
C4	31917440	31919303	BolC4t24769H	0	+	2215	1863	1863	1.0000000
C4	31919758	31919881	BolC4t24770H	0	+	232	123	123	1.0000000
C4	31920638	31922268	BolC4t24771H	0	+	956	1630	1630	1.0000000
C4	31923760	31924544	BolC4t24772H	0	+	766	784	784	1.0000000
C4	31926295	31929709	BolC4t24773H	0	+	1899	3385	3414	0.9915056
C4	31930190	31931585	BolC4t24774H	0	-	1718	1395	1395	1.0000000
C4	31931881	31932332	BolC4t24775H	0	+	523	451	451	1.0000000
C4	31932434	31932888	BolC4t24776H	0	+	333	454	454	1.0000000
C4	31933076	31937238	BolC4t24777H	0	+	1207	3318	4162	0.7972129
C4	31937510	31937837	BolC4t24778H	0	-	0	0	327	0.0000000
C4	31938114	31946097	BolC4t24779H	0	+	1209	5574	7983	0.6982337
C4	31939411	31941024	BolC4t24780H	0	+	152	1479	1613	0.9169250
C4	31955889	31961182	BolC4t24781H	0	-	1844	4102	5293	0.7749858
C4	31967736	31970576	BolC4t24782H	0	+	2762	2840	2840	1.0000000
C4	31971013	31973336	BolC4t24783H	0	-	1954	2323	2323	1.0000000
C4	31977633	31979353	BolC4t24784H	0	-	1874	1720	1720	1.0000000
C4	31980570	31982432	BolC4t24785H	0	-	643	1522	1862	0.8174006
C4	31984675	31985617	BolC4t24786H	0	+	696	942	942	1.0000000
C4	31986502	31988326	BolC4t24787H	0	-	1559	1824	1824	1.0000000
C4	31995388	31996418	BolC4t24788H	0	-	983	1030	1030	1.0000000
C4	31996861	31997907	BolC4t24789H	0	+	1004	1046	1046	1.0000000
C4	31998142	31998336	BolC4t24790H	0	-	1287	194	194	1.0000000
C4	32000708	32001125	BolC4t24791H	0	-	0	0	417	0.0000000
C4	32004078	32005671	BolC4t24792H	0	+	792	1593	1593	1.0000000
C4	32004272	32005062	BolC4t24793H	0	-	506	790	790	1.0000000
C4	32006375	32007747	BolC4t24794H	0	-	2	73	1372	0.0532070
C4	32059821	32061132	BolC4t24795H	0	+	1	113	1311	0.0861937
C4	32073916	32074579	BolC4t24796H	0	+	0	0	663	0.0000000
C4	32079044	32079675	BolC4t24797H	0	-	5	175	631	0.2773376
C4	32081700	32082096	BolC4t24798H	0	-	7	71	396	0.1792929
C4	32082267	32087704	BolC4t24799H	0	-	102	703	5437	0.1292993
C4	32090522	32091806	BolC4t24800H	0	+	35	832	1284	0.6479751
C4	32123530	32124005	BolC4t24801H	0	-	1	128	475	0.2694737
C4	32126860	32127094	BolC4t24802H	0	-	16831	234	234	1.0000000
C4	32127541	32127754	BolC4t24803H	0	-	32	147	213	0.6901408
C4	32138667	32140041	BolC4t24804H	0	+	0	0	1374	0.0000000
C4	32146354	32146856	BolC4t24805H	0	-	2	24	502	0.0478088
C4	32252981	32253623	BolC4t24806H	0	-	1	32	642	0.0498442
C4	32360314	32360594	BolC4t24807H	0	+	0	0	280	0.0000000
C4	32381075	32381427	BolC4t24808H	0	+	0	0	352	0.0000000
C4	32384198	32384975	BolC4t24809H	0	+	0	0	777	0.0000000
C4	32419969	32421376	BolC4t24810H	0	-	44	472	1407	0.3354655
C4	32422164	32422520	BolC4t24811H	0	-	0	0	356	0.0000000
C4	32455595	32456199	BolC4t24812H	0	-	0	0	604	0.0000000
C4	32483675	32484020	BolC4t24813H	0	+	598	345	345	1.0000000
C4	32487121	32493033	BolC4t24814H	0	-	1818	5174	5912	0.8751692
C4	32503085	32503955	BolC4t24815H	0	-	473	870	870	1.0000000
C4	32506330	32509927	BolC4t24816H	0	+	2847	3597	3597	1.0000000
C4	32538565	32539399	BolC4t24817H	0	+	473	834	834	1.0000000
C4	32540178	32541093	BolC4t24818H	0	-	1080	915	915	1.0000000
C4	32546246	32548662	BolC4t24819H	0	+	302	1594	2416	0.6597682
C4	32568251	32571856	BolC4t24820H	0	-	296	2327	3605	0.6454924
C4	32579825	32582358	BolC4t24821H	0	+	1187	2533	2533	1.0000000
C4	32593454	32594246	BolC4t24822H	0	-	410	792	792	1.0000000
C4	32622281	32625439	BolC4t24823H	0	+	45	1096	3158	0.3470551
C4	32627203	32630383	BolC4t24824H	0	-	479	2732	3180	0.8591195
C4	32632099	32632672	BolC4t24825H	0	-	0	0	573	0.0000000
C4	32633734	32634608	BolC4t24826H	0	-	269	874	874	1.0000000
C4	32637943	32645543	BolC4t24827H	0	-	1019	2619	7600	0.3446053
C4	32653857	32655502	BolC4t24828H	0	-	468	1626	1645	0.9884499
C4	32659886	32662309	BolC4t24829H	0	-	2505	2423	2423	1.0000000
C4	32663413	32666815	BolC4t24830H	0	-	2348	3221	3402	0.9467960
C4	32669499	32669955	BolC4t24831H	0	-	178	456	456	1.0000000
C4	32671278	32672631	BolC4t24832H	0	-	872	1353	1353	1.0000000
C4	32685176	32687365	BolC4t24833H	0	+	1382	2140	2189	0.9776154
C4	32688256	32689642	BolC4t24834H	0	+	800	1386	1386	1.0000000
C4	32698325	32705839	BolC4t24835H	0	+	4045	6558	7514	0.8727708
C4	32706094	32715981	BolC4t24836H	0	+	10589	9299	9887	0.9405280
C4	32727008	32728088	BolC4t24837H	0	+	0	0	1080	0.0000000
C4	32734004	32735984	BolC4t24838H	0	+	371	1658	1980	0.8373737
C4	32737136	32737616	BolC4t24839H	0	+	210	425	480	0.8854167
C4	32740837	32741302	BolC4t24840H	0	+	614	465	465	1.0000000
C4	32755672	32755939	BolC4t24841H	0	+	108	267	267	1.0000000
C4	32757043	32759419	BolC4t24842H	0	+	2050	2376	2376	1.0000000
C4	32759988	32782620	BolC4t24843H	0	-	10853	19239	22632	0.8500795
C4	32766781	32769424	BolC4t24844H	0	+	521	1722	2643	0.6515324
C4	32784870	32786887	BolC4t24845H	0	+	53	1510	2017	0.7486366
C4	32788741	32790850	BolC4t24846H	0	+	1034	2088	2109	0.9900427
C4	32793097	32793364	BolC4t24847H	0	-	86	267	267	1.0000000
C4	32796672	32799642	BolC4t24848H	0	-	1625	2843	2970	0.9572390
C4	32800600	32800872	BolC4t24849H	0	-	636	272	272	1.0000000
C4	32809712	32812408	BolC4t24850H	0	+	1304	2688	2696	0.9970326
C4	32831233	32832760	BolC4t24851H	0	+	178	1323	1527	0.8664047
C4	32840049	32843357	BolC4t24852H	0	+	793	2408	3308	0.7279323
C4	32843798	32844619	BolC4t24853H	0	-	846	821	821	1.0000000
C4	32845285	32846924	BolC4t24854H	0	+	959	1639	1639	1.0000000
C4	32847289	32849249	BolC4t24855H	0	-	668	1829	1960	0.9331633
C4	32888751	32888907	BolC4t24856H	0	+	357	156	156	1.0000000
C4	32896969	32897306	BolC4t24857H	0	+	300	337	337	1.0000000
C4	32898049	32899731	BolC4t24858H	0	-	631	1682	1682	1.0000000
C4	32899140	32900226	BolC4t24859H	0	+	391	1086	1086	1.0000000
C4	32907088	32907536	BolC4t24860H	0	-	215	448	448	1.0000000
C4	32915426	32915684	BolC4t24861H	0	+	33	245	258	0.9496124
C4	32917022	32917921	BolC4t24862H	0	+	915	880	899	0.9788654
C4	32920880	32923769	BolC4t24863H	0	+	1727	2709	2889	0.9376947
C4	32931200	32931716	BolC4t24864H	0	-	35	22	516	0.0426357
C4	32933164	32933502	BolC4t24865H	0	+	0	0	338	0.0000000
C4	32948666	32949006	BolC4t24866H	0	+	250	340	340	1.0000000
C4	32949746	32951239	BolC4t24867H	0	-	385	1431	1493	0.9584728
C4	32953256	32956018	BolC4t24868H	0	+	213	1810	2762	0.6553223
C4	32960534	32960867	BolC4t24869H	0	-	317	333	333	1.0000000
C4	32963987	32965964	BolC4t24870H	0	+	1280	1977	1977	1.0000000
C4	32977372	32977555	BolC4t24871H	0	+	62	183	183	1.0000000
C4	32995335	32997312	BolC4t24872H	0	-	612	1895	1977	0.9585230
C4	33001993	33002173	BolC4t24873H	0	+	247	180	180	1.0000000
C4	33002488	33003160	BolC4t24874H	0	-	618	672	672	1.0000000
C4	33023955	33024272	BolC4t24875H	0	-	147	317	317	1.0000000
C4	33036337	33041226	BolC4t24876H	0	-	3478	4889	4889	1.0000000
C4	33044209	33044697	BolC4t24877H	0	+	355	488	488	1.0000000
C4	33061370	33062336	BolC4t24878H	0	+	48	595	966	0.6159420
C4	33071837	33073973	BolC4t24879H	0	-	48	665	2136	0.3113296
C4	33090335	33090648	BolC4t24880H	0	-	225	313	313	1.0000000
C4	33090878	33092189	BolC4t24881H	0	+	273	1311	1311	1.0000000
C4	33101087	33101399	BolC4t24882H	0	-	213	312	312	1.0000000
C4	33104733	33105123	BolC4t24883H	0	-	4008	390	390	1.0000000
C4	33108073	33108364	BolC4t24884H	0	+	107	291	291	1.0000000
C4	33108563	33109136	BolC4t24885H	0	+	45	506	573	0.8830715
C4	33114066	33114450	BolC4t24886H	0	-	10	331	384	0.8619792
C4	33124893	33125085	BolC4t24887H	0	-	1	26	192	0.1354167
C4	33140203	33140599	BolC4t24888H	0	-	24	321	396	0.8106061
C4	33141512	33141809	BolC4t24889H	0	+	129	297	297	1.0000000
C4	33148573	33148928	BolC4t24890H	0	+	0	0	355	0.0000000
C4	33152300	33154773	BolC4t24891H	0	+	332	1254	2473	0.5070764
C4	33154005	33154197	BolC4t24892H	0	+	9	74	192	0.3854167
C4	33170646	33170778	BolC4t24893H	0	+	6	39	132	0.2954545
C4	33173458	33174049	BolC4t24894H	0	-	128	560	591	0.9475465
C4	33208285	33208540	BolC4t24895H	0	-	95	255	255	1.0000000
C4	33217351	33217988	BolC4t24896H	0	-	233	637	637	1.0000000
C4	33218382	33218771	BolC4t24897H	0	-	117	389	389	1.0000000
C4	33236661	33242207	BolC4t24898H	0	-	1616	4271	5546	0.7701046
C4	33242555	33243212	BolC4t24899H	0	+	317	657	657	1.0000000
C4	33244433	33251774	BolC4t24900H	0	-	2339	6783	7341	0.9239886
C4	33265013	33266267	BolC4t24901H	0	+	853	1249	1254	0.9960127
C4	33266422	33267433	BolC4t24902H	0	-	710	1011	1011	1.0000000
C4	33268217	33269621	BolC4t24903H	0	+	1110	1404	1404	1.0000000
C4	33269791	33271231	BolC4t24904H	0	-	463	1359	1440	0.9437500
C4	33273688	33276077	BolC4t24905H	0	+	1359	2389	2389	1.0000000
C4	33305754	33306093	BolC4t24906H	0	+	26	267	339	0.7876106
C4	33315479	33315680	BolC4t24907H	0	+	246	201	201	1.0000000
C4	33316530	33316935	BolC4t24908H	0	+	231	405	405	1.0000000
C4	33328969	33332529	BolC4t24909H	0	+	3970	3560	3560	1.0000000
C4	33333138	33334777	BolC4t24910H	0	-	1180	1639	1639	1.0000000
C4	33336972	33337887	BolC4t24911H	0	-	0	0	915	0.0000000
C4	33339499	33341383	BolC4t24912H	0	+	1470	1884	1884	1.0000000
C4	33414671	33416054	BolC4t24913H	0	+	441	1352	1383	0.9775850
C4	33417268	33418702	BolC4t24914H	0	+	1025	1434	1434	1.0000000
C4	33424971	33425326	BolC4t24915H	0	+	426	355	355	1.0000000
C4	33425922	33427334	BolC4t24916H	0	-	1548	1412	1412	1.0000000
C4	33434657	33436460	BolC4t24917H	0	-	1367	1803	1803	1.0000000
C4	33451847	33451988	BolC4t24918H	0	+	52	141	141	1.0000000
C4	33454459	33457208	BolC4t24919H	0	+	664	2577	2749	0.9374318
C4	33455218	33455514	BolC4t24920H	0	+	21	124	296	0.4189189
C4	33461142	33461295	BolC4t24921H	0	+	4	121	153	0.7908497
C4	33467783	33469157	BolC4t24922H	0	-	103	897	1374	0.6528384
C4	33478104	33478405	BolC4t24923H	0	-	360	301	301	1.0000000
C4	33490791	33493310	BolC4t24924H	0	+	740	2443	2519	0.9698293
C4	33493418	33494145	BolC4t24925H	0	+	102	668	727	0.9188446
C4	33518460	33518940	BolC4t24926H	0	-	185	480	480	1.0000000
C4	33522693	33523380	BolC4t24927H	0	+	382	687	687	1.0000000
C4	33545991	33549135	BolC4t24928H	0	+	2619	3144	3144	1.0000000
C4	33550442	33552266	BolC4t24929H	0	+	857	1824	1824	1.0000000
C4	33559566	33560693	BolC4t24930H	0	+	839	1127	1127	1.0000000
C4	33562089	33563236	BolC4t24931H	0	-	163	996	1147	0.8683522
C4	33563330	33563486	BolC4t24932H	0	-	107	156	156	1.0000000
C4	33582118	33588230	BolC4t24933H	0	+	2666	5975	6112	0.9775851
C4	33592312	33592516	BolC4t24934H	0	+	0	0	204	0.0000000
C4	33624241	33626622	BolC4t24935H	0	+	893	2321	2381	0.9748005
C4	33627674	33628396	BolC4t24936H	0	-	105	683	722	0.9459834
C4	33629559	33630397	BolC4t24937H	0	+	741	838	838	1.0000000
C4	33652914	33654423	BolC4t24938H	0	+	412	1477	1509	0.9787939
C4	33671132	33671483	BolC4t24939H	0	+	31	57	351	0.1623932
C4	33675945	33676835	BolC4t24940H	0	-	722	890	890	1.0000000
C4	33685327	33690579	BolC4t24941H	0	-	2353	4812	5252	0.9162224
C4	33698503	33701705	BolC4t24942H	0	-	2166	3145	3202	0.9821987
C4	33702945	33710466	BolC4t24943H	0	+	5854	6936	7521	0.9222178
C4	33712104	33712845	BolC4t24944H	0	-	163	707	741	0.9541160
C4	33714088	33714553	BolC4t24945H	0	+	288	465	465	1.0000000
C4	33717038	33717824	BolC4t24946H	0	+	329	786	786	1.0000000
C4	33722955	33724556	BolC4t24947H	0	-	552	1492	1601	0.9319175
C4	33727919	33728755	BolC4t24948H	0	-	737	836	836	1.0000000
C4	33742760	33743008	BolC4t24949H	0	-	490	248	248	1.0000000
C4	33745369	33747071	BolC4t24950H	0	+	2112	1702	1702	1.0000000
C4	33747629	33748853	BolC4t24951H	0	-	1317	1224	1224	1.0000000
C4	33750587	33753195	BolC4t24952H	0	+	1527	2608	2608	1.0000000
C4	33785020	33785314	BolC4t24953H	0	+	140	294	294	1.0000000
C4	33810453	33812361	BolC4t24954H	0	+	1384	1908	1908	1.0000000
C4	33821151	33822146	BolC4t24955H	0	-	690	995	995	1.0000000
C4	33822530	33825521	BolC4t24956H	0	-	1654	2972	2991	0.9936476
C4	33825882	33826394	BolC4t24957H	0	+	38	375	512	0.7324219
C4	33827687	33827949	BolC4t24958H	0	+	11	166	262	0.6335878
C4	33833224	33835001	BolC4t24959H	0	+	1740	1777	1777	1.0000000
C4	33835460	33837680	BolC4t24960H	0	-	2204	2220	2220	1.0000000
C4	33842480	33846183	BolC4t24961H	0	+	2550	3703	3703	1.0000000
C4	33847011	33847711	BolC4t24962H	0	+	415	700	700	1.0000000
C4	33847939	33865300	BolC4t24963H	0	-	8333	17113	17361	0.9857151
C4	33866657	33869982	BolC4t24964H	0	+	2508	3325	3325	1.0000000
C4	33873765	33874832	BolC4t24965H	0	-	233	1067	1067	1.0000000
C4	33875287	33877705	BolC4t24966H	0	-	841	2410	2418	0.9966915
C4	33880361	33881318	BolC4t24967H	0	+	1103	957	957	1.0000000
C4	33893774	33895098	BolC4t24968H	0	+	1836	1324	1324	1.0000000
C4	33897687	33898802	BolC4t24969H	0	-	201	1115	1115	1.0000000
C4	33901107	33901328	BolC4t24970H	0	+	219	221	221	1.0000000
C4	33903517	33914151	BolC4t24971H	0	+	4611	9727	10634	0.9147075
C4	33916427	33922368	BolC4t24972H	0	+	3283	5941	5941	1.0000000
C4	33934188	33965515	BolC4t24973H	0	+	16263	31288	31327	0.9987550
C4	33953991	33954562	BolC4t24974H	0	+	76	554	571	0.9702277
C4	33966064	33966596	BolC4t24975H	0	+	928	532	532	1.0000000
C4	33969044	33969239	BolC4t24976H	0	-	0	0	195	0.0000000
C4	34017285	34017910	BolC4t24977H	0	-	292	625	625	1.0000000
C4	34020911	34021310	BolC4t24978H	0	-	607	399	399	1.0000000
C4	34025814	34027362	BolC4t24979H	0	-	1512	1548	1548	1.0000000
C4	34028019	34028554	BolC4t24980H	0	-	101	385	535	0.7196262
C4	34041249	34042017	BolC4t24981H	0	+	217	571	768	0.7434896
C4	34044040	34050361	BolC4t24982H	0	-	4515	6299	6321	0.9965196
C4	34052501	34053740	BolC4t24983H	0	+	936	1239	1239	1.0000000
C4	34057133	34064466	BolC4t24984H	0	+	3846	7333	7333	1.0000000
C4	34068017	34068287	BolC4t24985H	0	+	101	270	270	1.0000000
C4	34072921	34073839	BolC4t24986H	0	-	1035	918	918	1.0000000
C4	34091260	34092382	BolC4t24987H	0	-	115	939	1122	0.8368984
C4	34095132	34095705	BolC4t24988H	0	+	315	573	573	1.0000000
C4	34099706	34100590	BolC4t24989H	0	+	635	884	884	1.0000000
C4	34108301	34110437	BolC4t24990H	0	+	2197	2136	2136	1.0000000
C4	34131191	34134586	BolC4t24991H	0	+	957	3395	3395	1.0000000
C4	34151070	34151226	BolC4t24992H	0	+	50	156	156	1.0000000
C4	34160350	34160899	BolC4t24993H	0	-	41	549	549	1.0000000
C4	34163784	34166299	BolC4t24994H	0	+	444	1909	2515	0.7590457
C4	34167390	34167537	BolC4t24995H	0	-	244	147	147	1.0000000
C4	34167588	34169314	BolC4t24996H	0	-	779	1726	1726	1.0000000
C4	34171492	34171826	BolC4t24997H	0	+	523	334	334	1.0000000
C4	34181816	34183118	BolC4t24998H	0	-	685	1302	1302	1.0000000
C4	34191385	34192928	BolC4t24999H	0	+	1099	1543	1543	1.0000000
C4	34193330	34193864	BolC4t25000H	0	-	789	534	534	1.0000000
C4	34197054	34197901	BolC4t25001H	0	+	1433	847	847	1.0000000
C4	34211810	34212866	BolC4t25002H	0	+	829	1056	1056	1.0000000
C4	34213594	34215303	BolC4t25003H	0	-	1486	1709	1709	1.0000000
C4	34222715	34222826	BolC4t25004H	0	-	3	111	111	1.0000000
C4	34230586	34230697	BolC4t25005H	0	-	0	0	111	0.0000000
C4	34240647	34260524	BolC4t25006H	0	-	8492	17628	19877	0.8868542
C4	34269776	34270172	BolC4t25007H	0	+	1	150	396	0.3787879
C4	34276267	34325214	BolC4t25008H	0	+	1420	8783	48947	0.1794390
C4	34319425	34319926	BolC4t25009H	0	+	24	340	501	0.6786427
C4	34328532	34331970	BolC4t25010H	0	-	809	3350	3438	0.9744037
C4	34333049	34333424	BolC4t25011H	0	-	0	0	375	0.0000000
C4	34356647	34359215	BolC4t25012H	0	+	1838	2568	2568	1.0000000
C4	34360122	34361811	BolC4t25013H	0	+	2739	1689	1689	1.0000000
C4	34370676	34371643	BolC4t25014H	0	-	31	210	967	0.2171665
C4	34370878	34371643	BolC4t25015H	0	-	30	194	765	0.2535948
C4	34376034	34376364	BolC4t25016H	0	+	25	289	330	0.8757576
C4	34380826	34384117	BolC4t25017H	0	+	1883	2639	3291	0.8018839
C4	34393457	34395739	BolC4t25018H	0	+	1789	2269	2282	0.9943032
C4	34405404	34407208	BolC4t25019H	0	+	172	1465	1804	0.8120843
C4	34415833	34452163	BolC4t25020H	0	+	17770	35148	36330	0.9674649
C4	34430752	34435792	BolC4t25021H	0	+	2835	5040	5040	1.0000000
C4	34463080	34464061	BolC4t25022H	0	+	134	852	981	0.8685015
C4	34464539	34469855	BolC4t25023H	0	+	3217	4814	5316	0.9055681
C4	34509011	34511866	BolC4t25024H	0	+	966	2855	2855	1.0000000
C4	34515292	34516309	BolC4t25025H	0	+	495	1017	1017	1.0000000
C4	34522134	34523096	BolC4t25026H	0	+	597	962	962	1.0000000
C4	34542572	34543115	BolC4t25027H	0	-	194	543	543	1.0000000
C4	34545071	34545257	BolC4t25028H	0	-	0	0	186	0.0000000
C4	34547217	34547487	BolC4t25029H	0	-	6	197	270	0.7296296
C4	34594300	34596377	BolC4t25030H	0	-	1054	1811	2077	0.8719307
C4	34615241	34615490	BolC4t25031H	0	-	0	0	249	0.0000000
C4	34635744	34640155	BolC4t25032H	0	-	5555	4411	4411	1.0000000
C4	34647662	34647845	BolC4t25033H	0	-	23	183	183	1.0000000
C4	34653701	34655530	BolC4t25034H	0	+	1537	1829	1829	1.0000000
C4	34656318	34657119	BolC4t25035H	0	-	605	801	801	1.0000000
C4	34659185	34660219	BolC4t25036H	0	-	871	1034	1034	1.0000000
C4	34662810	34663836	BolC4t25037H	0	+	845	1026	1026	1.0000000
C4	34665293	34679038	BolC4t25038H	0	-	4516	10287	13745	0.7484176
C4	34679922	34681086	BolC4t25039H	0	+	1355	1164	1164	1.0000000
C4	34684998	34685811	BolC4t25040H	0	-	0	0	813	0.0000000
C4	34686678	34688064	BolC4t25041H	0	-	700	1386	1386	1.0000000
C4	34688210	34689233	BolC4t25042H	0	-	661	1023	1023	1.0000000
C4	34697852	34697990	BolC4t25043H	0	+	150	138	138	1.0000000
C4	34709648	34710294	BolC4t25044H	0	-	0	0	646	0.0000000
C4	34716578	34728187	BolC4t25045H	0	+	3345	6587	11609	0.5674046
C4	34728234	34729486	BolC4t25046H	0	+	549	1252	1252	1.0000000
C4	34729548	34730370	BolC4t25047H	0	+	237	822	822	1.0000000
C4	34731723	34735486	BolC4t25048H	0	+	2143	3727	3763	0.9904332
C4	34736413	34736755	BolC4t25049H	0	-	257	342	342	1.0000000
C4	34761701	34761956	BolC4t25050H	0	-	45	255	255	1.0000000
C4	34777987	34784236	BolC4t25051H	0	+	2796	5642	6249	0.9028645
C4	34785666	34785960	BolC4t25052H	0	-	26	70	294	0.2380952
C4	34788152	34790753	BolC4t25053H	0	-	1259	2561	2601	0.9846213
C4	34790963	34791754	BolC4t25054H	0	-	605	673	791	0.8508217
C4	34791806	34792287	BolC4t25055H	0	-	136	481	481	1.0000000
C4	34799260	34799709	BolC4t25056H	0	+	237	449	449	1.0000000
C4	34825181	34826525	BolC4t25057H	0	-	977	1344	1344	1.0000000
C4	34827394	34829301	BolC4t25058H	0	-	33	547	1907	0.2868380
C4	34830330	34830531	BolC4t25059H	0	-	30	197	201	0.9800995
C4	34833315	34834929	BolC4t25060H	0	-	1368	1614	1614	1.0000000
C4	34855596	34858482	BolC4t25061H	0	+	2171	2886	2886	1.0000000
C4	34858600	34859260	BolC4t25062H	0	+	790	660	660	1.0000000
C4	34859479	34860632	BolC4t25063H	0	-	1001	1153	1153	1.0000000
C4	34865585	34869477	BolC4t25064H	0	-	2243	3892	3892	1.0000000
C4	34870449	34873193	BolC4t25065H	0	+	1927	2744	2744	1.0000000
C4	34875298	34876588	BolC4t25066H	0	-	720	1290	1290	1.0000000
C4	34887244	34887803	BolC4t25067H	0	-	215	559	559	1.0000000
C4	34891410	34891774	BolC4t25068H	0	-	8	334	364	0.9175824
C4	34922541	34923735	BolC4t25069H	0	+	681	1172	1194	0.9815745
C4	34926510	34928022	BolC4t25070H	0	+	552	1438	1512	0.9510582
C4	34928786	34930780	BolC4t25071H	0	-	231	1157	1994	0.5802407
C4	34934192	34934780	BolC4t25072H	0	+	718	588	588	1.0000000
C4	34949810	34950542	BolC4t25073H	0	+	150	732	732	1.0000000
C4	34950878	34951258	BolC4t25074H	0	+	308	380	380	1.0000000
C4	34952459	34954247	BolC4t25075H	0	-	533	1788	1788	1.0000000
C4	34955556	34957001	BolC4t25076H	0	+	45	213	1445	0.1474048
C4	34959724	34959946	BolC4t25077H	0	+	214	222	222	1.0000000
C4	34977989	34978292	BolC4t25078H	0	+	225	303	303	1.0000000
C4	34979755	34979974	BolC4t25079H	0	+	212	219	219	1.0000000
C4	34984030	34984524	BolC4t25080H	0	-	410	494	494	1.0000000
C4	35005798	35006041	BolC4t25081H	0	-	45	199	243	0.8189300
C4	35007069	35010974	BolC4t25082H	0	+	96	870	3905	0.2227913
C4	35015958	35016624	BolC4t25083H	0	-	636	666	666	1.0000000
C4	35024905	35026230	BolC4t25084H	0	+	277	1317	1325	0.9939623
C4	35040817	35040937	BolC4t25085H	0	+	357	120	120	1.0000000
C4	35051996	35052678	BolC4t25086H	0	+	414	682	682	1.0000000
C4	35058020	35058395	BolC4t25087H	0	+	430	375	375	1.0000000
C4	35059050	35061493	BolC4t25088H	0	-	2169	2443	2443	1.0000000
C4	35062964	35064029	BolC4t25089H	0	+	928	1065	1065	1.0000000
C4	35067721	35070337	BolC4t25090H	0	-	1389	2496	2616	0.9541284
C4	35095599	35096829	BolC4t25091H	0	-	977	1230	1230	1.0000000
C4	35099285	35099639	BolC4t25092H	0	+	58	354	354	1.0000000
C4	35101521	35107309	BolC4t25093H	0	+	1278	4384	5788	0.7574292
C4	35107951	35109935	BolC4t25094H	0	+	761	1984	1984	1.0000000
C4	35111048	35112157	BolC4t25095H	0	-	255	1055	1109	0.9513075
C4	35156799	35157224	BolC4t25096H	0	-	484	425	425	1.0000000
C4	35171321	35173002	BolC4t25097H	0	+	360	1652	1681	0.9827484
C4	35181687	35183354	BolC4t25098H	0	+	496	1639	1667	0.9832034
C4	35183933	35187591	BolC4t25099H	0	+	2669	3658	3658	1.0000000
C4	35199232	35201487	BolC4t25100H	0	+	984	2111	2255	0.9361419
C4	35209129	35213957	BolC4t25101H	0	+	1973	4645	4828	0.9620961
C4	35216558	35218827	BolC4t25102H	0	+	2574	2269	2269	1.0000000
C4	35219170	35220261	BolC4t25103H	0	-	508	1072	1091	0.9825848
C4	35220436	35220951	BolC4t25104H	0	-	639	515	515	1.0000000
C4	35221360	35223675	BolC4t25105H	0	-	2172	2315	2315	1.0000000
C4	35223733	35224049	BolC4t25106H	0	-	258	316	316	1.0000000
C4	35225691	35226643	BolC4t25107H	0	+	139	918	952	0.9642857
C4	35240206	35240500	BolC4t25108H	0	+	192	294	294	1.0000000
C4	35251201	35251703	BolC4t25109H	0	+	277	491	502	0.9780877
C4	35254391	35258325	BolC4t25110H	0	+	490	3661	3934	0.9306050
C4	35274141	35274276	BolC4t25111H	0	+	73	135	135	1.0000000
C4	35313578	35315359	BolC4t25112H	0	-	694	1678	1781	0.9421673
C4	35336153	35336309	BolC4t25113H	0	+	58	156	156	1.0000000
C4	35341316	35341583	BolC4t25114H	0	+	86	267	267	1.0000000
C4	35349730	35351773	BolC4t25115H	0	-	565	1960	2043	0.9593735
C4	35355168	35355390	BolC4t25116H	0	-	154	222	222	1.0000000
C4	35401263	35402276	BolC4t25117H	0	-	367	951	1013	0.9387957
C4	35406913	35407543	BolC4t25118H	0	+	0	0	630	0.0000000
C4	35409617	35410541	BolC4t25119H	0	-	57	727	924	0.7867965
C4	35410620	35414070	BolC4t25120H	0	-	1186	3120	3450	0.9043478
C4	35443926	35445243	BolC4t25121H	0	+	945	1316	1317	0.9992407
C4	35445557	35449806	BolC4t25122H	0	-	2931	4249	4249	1.0000000
C4	35469803	35472575	BolC4t25123H	0	+	218	1856	2772	0.6695527
C4	35485881	35486228	BolC4t25124H	0	+	862	347	347	1.0000000
C4	35488190	35488772	BolC4t25125H	0	+	143	582	582	1.0000000
C4	35490932	35492480	BolC4t25126H	0	-	1507	1051	1548	0.6789406
C4	35493141	35494092	BolC4t25127H	0	-	19	711	951	0.7476341
C4	35533239	35534743	BolC4t25128H	0	+	1285	1494	1504	0.9933510
C4	35546819	35547890	BolC4t25129H	0	+	672	1045	1071	0.9757236
C4	35549366	35549930	BolC4t25130H	0	+	85	564	564	1.0000000
C4	35577735	35577882	BolC4t25131H	0	+	246	147	147	1.0000000
C4	35582966	35584151	BolC4t25132H	0	+	798	1185	1185	1.0000000
C4	35586544	35590880	BolC4t25133H	0	+	2473	4294	4336	0.9903136
C4	35592394	35592908	BolC4t25134H	0	+	437	514	514	1.0000000
C4	35594020	35594383	BolC4t25135H	0	-	868	363	363	1.0000000
C4	35597582	35598066	BolC4t25136H	0	-	785	484	484	1.0000000
C4	35623621	35625130	BolC4t25137H	0	-	588	1509	1509	1.0000000
C4	35634616	35636928	BolC4t25138H	0	+	1146	2171	2312	0.9390138
C4	35637670	35640910	BolC4t25139H	0	+	2143	3240	3240	1.0000000
C4	35641887	35643807	BolC4t25140H	0	+	158	1362	1920	0.7093750
C4	35647758	35652568	BolC4t25141H	0	+	734	4155	4810	0.8638254
C4	35653279	35653684	BolC4t25142H	0	-	122	405	405	1.0000000
C4	35657163	35660500	BolC4t25143H	0	-	3431	3337	3337	1.0000000
C4	35660873	35664110	BolC4t25144H	0	-	1732	3190	3237	0.9854804
C4	35668128	35668236	BolC4t25145H	0	+	165	108	108	1.0000000
C4	35677581	35681513	BolC4t25146H	0	-	1521	3535	3932	0.8990335
C4	35751292	35751622	BolC4t25147H	0	+	4	153	330	0.4636364
C4	35756542	35763161	BolC4t25148H	0	+	2533	6605	6619	0.9978849
C4	35780715	35781487	BolC4t25149H	0	+	627	772	772	1.0000000
C4	35782781	35785144	BolC4t25150H	0	-	1696	2358	2363	0.9978840
C4	35789590	35793121	BolC4t25151H	0	-	3000	3531	3531	1.0000000
C4	35804238	35804646	BolC4t25152H	0	-	377	408	408	1.0000000
C4	35805655	35808094	BolC4t25153H	0	-	590	2398	2439	0.9831898
C4	35810279	35813403	BolC4t25154H	0	+	2104	2719	3124	0.8703585
C4	35846359	35849360	BolC4t25155H	0	-	1499	3001	3001	1.0000000
C4	35862911	35863784	BolC4t25156H	0	-	72	873	873	1.0000000
C4	35875643	35876279	BolC4t25157H	0	+	12	227	636	0.3569182
C4	35880310	35884558	BolC4t25158H	0	+	2419	3984	4248	0.9378531
C4	35883954	35884217	BolC4t25159H	0	+	199	263	263	1.0000000
C4	35884594	35885554	BolC4t25160H	0	+	365	960	960	1.0000000
C4	35886166	35886820	BolC4t25161H	0	+	294	654	654	1.0000000
C4	35887839	35888202	BolC4t25162H	0	-	178	363	363	1.0000000
C4	35891365	35891850	BolC4t25163H	0	-	204	485	485	1.0000000
C4	35904355	35910540	BolC4t25164H	0	-	3404	6109	6185	0.9877122
C4	35920397	35942008	BolC4t25165H	0	+	5844	17679	21611	0.8180556
C4	35941406	35941769	BolC4t25166H	0	+	6	224	363	0.6170799
C4	35959487	35960113	BolC4t25167H	0	+	500	626	626	1.0000000
C4	35971471	35973636	BolC4t25168H	0	-	769	2059	2165	0.9510393
C4	35979824	35980487	BolC4t25169H	0	-	13	397	663	0.5987934
C4	35982464	35982602	BolC4t25170H	0	-	5	105	138	0.7608696
C4	35983265	35984279	BolC4t25171H	0	+	115	725	1014	0.7149901
C4	35983362	35984133	BolC4t25172H	0	-	115	720	771	0.9338521
C4	36010403	36011197	BolC4t25173H	0	+	96	594	794	0.7481108
C4	36037445	36038054	BolC4t25174H	0	+	303	609	609	1.0000000
C4	36039668	36040484	BolC4t25175H	0	-	585	790	816	0.9681373
C4	36044386	36045259	BolC4t25176H	0	+	154	850	873	0.9736541
C4	36046652	36048815	BolC4t25177H	0	-	537	1687	2163	0.7799353
C4	36053786	36054659	BolC4t25178H	0	+	83	635	873	0.7273769
C4	36054906	36055083	BolC4t25179H	0	-	105	154	177	0.8700565
C4	36064331	36064565	BolC4t25180H	0	+	349	234	234	1.0000000
C4	36073555	36073993	BolC4t25181H	0	-	115	438	438	1.0000000
C4	36075416	36076289	BolC4t25182H	0	+	208	873	873	1.0000000
C4	36077670	36077829	BolC4t25183H	0	+	44	159	159	1.0000000
C4	36088557	36089459	BolC4t25184H	0	-	606	902	902	1.0000000
C4	36105029	36105623	BolC4t25185H	0	+	46	454	594	0.7643098
C4	36106151	36106328	BolC4t25186H	0	-	17	152	177	0.8587571
C4	36110649	36111468	BolC4t25187H	0	-	37	421	819	0.5140415
C4	36116017	36118207	BolC4t25188H	0	-	565	1932	2190	0.8821918
C4	36123380	36123653	BolC4t25189H	0	+	23	242	273	0.8864469
C4	36130418	36132006	BolC4t25190H	0	-	199	1495	1588	0.9414358
C4	36148181	36149473	BolC4t25191H	0	-	727	1292	1292	1.0000000
C4	36149792	36150467	BolC4t25192H	0	+	496	675	675	1.0000000
C4	36159424	36163284	BolC4t25193H	0	-	1960	3304	3860	0.8559585
C4	36172175	36172990	BolC4t25194H	0	+	409	790	815	0.9693251
C4	36182498	36183986	BolC4t25195H	0	+	424	1488	1488	1.0000000
C4	36257145	36257505	BolC4t25196H	0	+	238	360	360	1.0000000
C4	36258477	36258930	BolC4t25197H	0	+	1	8	453	0.0176600
C4	36259504	36259957	BolC4t25198H	0	+	60	201	453	0.4437086
C4	36278596	36279557	BolC4t25199H	0	-	517	961	961	1.0000000
C4	36286128	36287672	BolC4t25200H	0	+	1257	1544	1544	1.0000000
C4	36288730	36289063	BolC4t25201H	0	+	425	333	333	1.0000000
C4	36289499	36291090	BolC4t25202H	0	-	1451	1591	1591	1.0000000
C4	36291596	36293130	BolC4t25203H	0	+	1010	1534	1534	1.0000000
C4	36317065	36317515	BolC4t25204H	0	-	262	450	450	1.0000000
C4	36323389	36323737	BolC4t25205H	0	+	84	348	348	1.0000000
C4	36327829	36330165	BolC4t25206H	0	-	2025	2182	2336	0.9340754
C4	36338404	36338581	BolC4t25207H	0	-	86	177	177	1.0000000
C4	36348294	36348588	BolC4t25208H	0	-	1	74	294	0.2517007
C4	36352407	36356849	BolC4t25209H	0	+	2605	4442	4442	1.0000000
C4	36366198	36368572	BolC4t25210H	0	+	2756	2374	2374	1.0000000
C4	36369067	36369433	BolC4t25211H	0	-	136	352	366	0.9617487
C4	36370270	36370687	BolC4t25212H	0	+	923	417	417	1.0000000
C4	36374594	36376364	BolC4t25213H	0	-	61	1138	1770	0.6429378
C4	36395222	36395395	BolC4t25214H	0	+	212	173	173	1.0000000
C4	36401405	36402893	BolC4t25215H	0	+	1214	1488	1488	1.0000000
C4	36403088	36404579	BolC4t25216H	0	-	2515	1491	1491	1.0000000
C4	36406692	36407106	BolC4t25217H	0	-	43	388	414	0.9371980
C4	36409329	36410899	BolC4t25218H	0	+	1419	1570	1570	1.0000000
C4	36411331	36415302	BolC4t25219H	0	-	1510	3259	3971	0.8207000
C4	36437477	36438188	BolC4t25220H	0	-	8	315	711	0.4430380
C4	36438387	36439927	BolC4t25221H	0	-	245	1371	1540	0.8902597
C4	36453131	36453456	BolC4t25222H	0	+	76	325	325	1.0000000
C4	36464273	36465765	BolC4t25223H	0	-	89	495	1492	0.3317694
C4	36471724	36473660	BolC4t25224H	0	-	1221	1839	1936	0.9498967
C4	36471887	36472247	BolC4t25225H	0	-	301	360	360	1.0000000
C4	36478514	36478913	BolC4t25226H	0	+	2361	390	399	0.9774436
C4	36479931	36483387	BolC4t25227H	0	-	2692	3384	3456	0.9791667
C4	36493154	36493439	BolC4t25228H	0	+	260	285	285	1.0000000
C4	36494523	36494784	BolC4t25229H	0	-	411	261	261	1.0000000
C4	36502512	36506248	BolC4t25230H	0	-	1344	3495	3736	0.9354925
C4	36509551	36510660	BolC4t25231H	0	-	814	1109	1109	1.0000000
C4	36520033	36520500	BolC4t25232H	0	+	1	26	467	0.0556745
C4	36520993	36522670	BolC4t25233H	0	+	13	390	1677	0.2325581
C4	36524005	36525982	BolC4t25234H	0	-	1637	1977	1977	1.0000000
C4	36527153	36527447	BolC4t25235H	0	+	364	294	294	1.0000000
C4	36537038	36538551	BolC4t25236H	0	-	1249	1513	1513	1.0000000
C4	36538781	36540018	BolC4t25237H	0	-	1167	1237	1237	1.0000000
C4	36540919	36542861	BolC4t25238H	0	-	2479	1942	1942	1.0000000
C4	36553660	36554371	BolC4t25239H	0	+	472	711	711	1.0000000
C4	36557104	36557766	BolC4t25240H	0	-	480	662	662	1.0000000
C4	36559420	36560090	BolC4t25241H	0	-	678	670	670	1.0000000
C4	36560674	36561227	BolC4t25242H	0	+	228	495	553	0.8951175
C4	36561433	36562890	BolC4t25243H	0	-	587	1365	1457	0.9368566
C4	36565139	36565841	BolC4t25244H	0	+	268	702	702	1.0000000
C4	36567659	36569079	BolC4t25245H	0	+	14	408	1420	0.2873240
C4	36572197	36575283	BolC4t25246H	0	+	1125	2778	3086	0.9001944
C4	36575465	36576645	BolC4t25247H	0	-	302	1087	1180	0.9211864
C4	36578096	36578934	BolC4t25248H	0	-	149	680	838	0.8114558
C4	36580229	36580574	BolC4t25249H	0	-	617	345	345	1.0000000
C4	36581158	36581942	BolC4t25250H	0	-	508	784	784	1.0000000
C4	36583544	36585785	BolC4t25251H	0	-	886	1864	2241	0.8317716
C4	36603734	36604697	BolC4t25252H	0	-	843	922	963	0.9574247
C4	36619443	36620732	BolC4t25253H	0	+	477	1289	1289	1.0000000
C4	36623365	36624886	BolC4t25254H	0	-	1075	1469	1521	0.9658120
C4	36625686	36627843	BolC4t25255H	0	-	1445	2157	2157	1.0000000
C4	36636772	36638422	BolC4t25256H	0	-	661	1493	1650	0.9048485
C4	36641244	36643469	BolC4t25257H	0	-	1921	2225	2225	1.0000000
C4	36648241	36649547	BolC4t25258H	0	+	2287	1306	1306	1.0000000
C4	36659703	36661867	BolC4t25259H	0	-	1740	2159	2164	0.9976895
C4	36673001	36675071	BolC4t25260H	0	+	1244	2001	2070	0.9666666
C4	36677733	36678399	BolC4t25261H	0	-	196	666	666	1.0000000
C4	36689413	36691394	BolC4t25262H	0	+	1810	1981	1981	1.0000000
C4	36696911	36697695	BolC4t25263H	0	+	901	784	784	1.0000000
C4	36698281	36699524	BolC4t25264H	0	-	930	1243	1243	1.0000000
C4	36699478	36699871	BolC4t25265H	0	-	361	393	393	1.0000000
C4	36704640	36706176	BolC4t25266H	0	-	1227	1536	1536	1.0000000
C4	36750563	36752167	BolC4t25267H	0	-	47	874	1604	0.5448878
C4	36755582	36755702	BolC4t25268H	0	+	68	120	120	1.0000000
C4	36775080	36776259	BolC4t25269H	0	-	1002	1179	1179	1.0000000
C4	36783600	36784206	BolC4t25270H	0	-	130	578	606	0.9537954
C4	36794140	36795289	BolC4t25271H	0	+	145	1119	1149	0.9738904
C4	36807484	36808187	BolC4t25272H	0	-	450	703	703	1.0000000
C4	36816895	36817358	BolC4t25273H	0	-	108	463	463	1.0000000
C4	36827931	36828904	BolC4t25274H	0	+	715	973	973	1.0000000
C4	36831168	36832640	BolC4t25275H	0	+	817	1472	1472	1.0000000
C4	36833657	36839614	BolC4t25276H	0	+	2488	5564	5957	0.9340272
C4	36839776	36840809	BolC4t25277H	0	-	337	1033	1033	1.0000000
C4	36860388	36861283	BolC4t25278H	0	-	97	895	895	1.0000000
C4	36865908	36866570	BolC4t25279H	0	-	350	662	662	1.0000000
C4	36869494	36871936	BolC4t25280H	0	-	1570	2195	2442	0.8988534
C4	36883662	36887217	BolC4t25281H	0	-	1476	3450	3555	0.9704641
C4	36888359	36890090	BolC4t25282H	0	-	1241	1718	1731	0.9924899
C4	36915835	36916577	BolC4t25283H	0	+	932	742	742	1.0000000
C4	36926153	36927092	BolC4t25284H	0	-	553	939	939	1.0000000
C4	36929558	36932154	BolC4t25285H	0	-	1295	2479	2596	0.9549307
C4	36940366	36940745	BolC4t25286H	0	+	7	289	379	0.7625330
C4	36941980	36943882	BolC4t25287H	0	+	280	1784	1902	0.9379600
C4	36944095	36945444	BolC4t25288H	0	-	472	1303	1349	0.9659007
C4	36945570	36945855	BolC4t25289H	0	+	135	278	285	0.9754386
C4	36965795	36968099	BolC4t25290H	0	+	360	1733	2304	0.7521701
C4	36980641	36980944	BolC4t25291H	0	-	60	276	303	0.9108911
C4	36982868	36985061	BolC4t25292H	0	-	154	1468	2193	0.6694027
C4	37000080	37000290	BolC4t25293H	0	-	171	210	210	1.0000000
C4	37050364	37051284	BolC4t25294H	0	-	602	920	920	1.0000000
C4	37061450	37062521	BolC4t25295H	0	+	83	677	1071	0.6321195
C4	37071842	37073942	BolC4t25296H	0	+	221	929	2100	0.4423810
C4	37077728	37085349	BolC4t25297H	0	+	3085	5895	7621	0.7735205
C4	37080579	37081572	BolC4t25298H	0	-	10	100	993	0.1007049
C4	37086983	37089748	BolC4t25299H	0	-	1305	2658	2765	0.9613020
C4	37091368	37092614	BolC4t25300H	0	+	70	654	1246	0.5248796
C4	37094002	37095557	BolC4t25301H	0	-	401	1450	1555	0.9324759
C4	37126582	37127302	BolC4t25302H	0	-	67	412	720	0.5722222
C4	37127917	37128058	BolC4t25303H	0	+	297	141	141	1.0000000
C4	37234067	37234286	BolC4t25304H	0	+	0	0	219	0.0000000
C4	37239459	37239870	BolC4t25305H	0	-	510	411	411	1.0000000
C4	37284038	37286014	BolC4t25306H	0	-	1345	1976	1976	1.0000000
C4	37301212	37302091	BolC4t25307H	0	-	465	879	879	1.0000000
C4	37303156	37307574	BolC4t25308H	0	-	3013	4391	4418	0.9938886
C4	37315144	37315500	BolC4t25309H	0	-	373	356	356	1.0000000
C4	37327721	37328057	BolC4t25310H	0	+	3	154	336	0.4583333
C4	37328625	37330296	BolC4t25311H	0	-	321	1121	1671	0.6708558
C4	37332718	37332916	BolC4t25312H	0	-	3	146	198	0.7373737
C4	37339845	37342435	BolC4t25313H	0	+	775	2590	2590	1.0000000
C4	37342784	37343209	BolC4t25314H	0	+	241	425	425	1.0000000
C4	37350153	37358907	BolC4t25315H	0	-	321	2160	8754	0.2467443
C4	37365148	37368674	BolC4t25316H	0	+	2480	3526	3526	1.0000000
C4	37373915	37377721	BolC4t25317H	0	-	618	3241	3806	0.8515502
C4	37385680	37388080	BolC4t25318H	0	+	367	1867	2400	0.7779167
C4	37389381	37391570	BolC4t25319H	0	-	124	711	2189	0.3248059
C4	37403952	37406064	BolC4t25320H	0	+	908	1945	2112	0.9209280
C4	37419459	37421016	BolC4t25321H	0	+	821	1557	1557	1.0000000
C4	37423506	37423795	BolC4t25322H	0	+	2	115	289	0.3979239
C4	37423972	37425376	BolC4t25323H	0	+	39	571	1404	0.4066952
C4	37431466	37432847	BolC4t25324H	0	-	1203	1381	1381	1.0000000
C4	37442601	37445540	BolC4t25325H	0	+	361	2253	2939	0.7665873
C4	37445927	37449045	BolC4t25326H	0	-	345	2101	3118	0.6738294
C4	37498337	37499884	BolC4t25327H	0	+	0	0	1547	0.0000000
C4	37508367	37508826	BolC4t25328H	0	+	0	0	459	0.0000000
C4	37513913	37516673	BolC4t25329H	0	-	63	1021	2760	0.3699275
C4	37543342	37545357	BolC4t25330H	0	+	534	922	2015	0.4575682
C4	37562331	37572794	BolC4t25331H	0	-	153978	7549	10463	0.7214948
C4	37566307	37567994	BolC4t25332H	0	-	7205	1281	1687	0.7593361
C4	37581739	37583246	BolC4t25333H	0	-	15307	1425	1507	0.9455873
C4	37632622	37632844	BolC4t25334H	0	-	0	0	222	0.0000000
C4	37641412	37645011	BolC4t25335H	0	-	851	2619	3599	0.7277021
C4	37646712	37648522	BolC4t25336H	0	+	1234	1810	1810	1.0000000
C4	37658324	37658762	BolC4t25337H	0	+	188	438	438	1.0000000
C4	37663252	37663672	BolC4t25338H	0	+	167	420	420	1.0000000
C4	37663930	37664442	BolC4t25339H	0	-	75	512	512	1.0000000
C4	37667863	37668274	BolC4t25340H	0	-	60	403	411	0.9805353
C4	37669807	37670701	BolC4t25341H	0	-	136	565	894	0.6319910
C4	37671534	37671675	BolC4t25342H	0	-	9	135	141	0.9574468
C4	37680713	37681078	BolC4t25343H	0	-	37	348	365	0.9534246
C4	37685952	37686490	BolC4t25344H	0	-	232	502	538	0.9330855
C4	37691129	37707561	BolC4t25345H	0	-	5629	7684	16432	0.4676242
C4	37708638	37710793	BolC4t25346H	0	+	837	2071	2155	0.9610209
C4	37717474	37720678	BolC4t25347H	0	+	426	2693	3204	0.8405119
C4	37720940	37721366	BolC4t25348H	0	-	45	426	426	1.0000000
C4	37729255	37735303	BolC4t25349H	0	+	1484	5298	6048	0.8759921
C4	37744897	37746680	BolC4t25350H	0	+	48	617	1783	0.3460460
C4	37750944	37752454	BolC4t25351H	0	+	2618	1510	1510	1.0000000
C4	37761041	37771470	BolC4t25352H	0	+	4144	4825	10429	0.4626522
C4	37773974	37778753	BolC4t25353H	0	+	3827	4779	4779	1.0000000
C4	37780147	37781303	BolC4t25354H	0	+	1743	1156	1156	1.0000000
C4	37787939	37789917	BolC4t25355H	0	+	17	624	1978	0.3154702
C4	37790303	37792822	BolC4t25356H	0	-	780	2383	2519	0.9460104
C4	37794278	37795901	BolC4t25357H	0	+	467	1414	1623	0.8712261
C4	37796635	37797870	BolC4t25358H	0	-	558	1153	1235	0.9336032
C4	37830823	37836544	BolC4t25359H	0	-	3579	5721	5721	1.0000000
C4	37847210	37847713	BolC4t25360H	0	-	93	503	503	1.0000000
C4	37866473	37870137	BolC4t25361H	0	+	1245	3109	3664	0.8485262
C4	37871180	37871708	BolC4t25362H	0	+	24	229	528	0.4337121
C4	37871349	37871708	BolC4t25363H	0	+	2	61	359	0.1699164
C4	37877100	37877395	BolC4t25364H	0	+	75	242	295	0.8203390
C4	37880267	37883133	BolC4t25365H	0	+	910	2509	2866	0.8754361
C4	37899416	37900364	BolC4t25366H	0	+	617	948	948	1.0000000
C4	37911493	37911970	BolC4t25367H	0	-	288	477	477	1.0000000
C4	37920390	37925495	BolC4t25368H	0	+	1945	4901	5105	0.9600392
C4	37931474	37933657	BolC4t25369H	0	+	1342	2008	2183	0.9198351
C4	37934521	37938445	BolC4t25370H	0	-	1929	3877	3924	0.9880224
C4	37985829	37987648	BolC4t25371H	0	+	1266	1804	1819	0.9917537
C4	37988580	37990371	BolC4t25372H	0	-	668	1791	1791	1.0000000
C4	38011981	38013451	BolC4t25373H	0	-	180	927	1470	0.6306123
C4	38028511	38029117	BolC4t25374H	0	+	909	606	606	1.0000000
C4	38029388	38030100	BolC4t25375H	0	+	979	712	712	1.0000000
C4	38030593	38032262	BolC4t25376H	0	-	644	1491	1669	0.8933493
C4	38036497	38038914	BolC4t25377H	0	-	409	1881	2417	0.7782375
C4	38043264	38043408	BolC4t25378H	0	+	19	139	144	0.9652778
C4	38050624	38052585	BolC4t25379H	0	+	476	1911	1961	0.9745028
C4	38053241	38058665	BolC4t25380H	0	+	1272	3434	5424	0.6331121
C4	38060971	38061438	BolC4t25381H	0	+	784	467	467	1.0000000
C4	38066699	38075492	BolC4t25382H	0	+	3855	8245	8793	0.9376777
C4	38071341	38071800	BolC4t25383H	0	-	43	432	459	0.9411765
C4	38079068	38080046	BolC4t25384H	0	+	0	0	978	0.0000000
C4	38109405	38113566	BolC4t25385H	0	+	2165	3894	4161	0.9358327
C4	38124931	38127509	BolC4t25386H	0	+	1443	2578	2578	1.0000000
C4	38140223	38142139	BolC4t25387H	0	+	1218	1857	1916	0.9692067
C4	38147595	38147984	BolC4t25388H	0	+	505	389	389	1.0000000
C4	38152158	38152911	BolC4t25389H	0	+	1268	753	753	1.0000000
C4	38153199	38153352	BolC4t25390H	0	-	123	153	153	1.0000000
C4	38164924	38167292	BolC4t25391H	0	-	1217	2043	2368	0.8627534
C4	38169511	38169829	BolC4t25392H	0	-	208	318	318	1.0000000
C4	38174015	38176757	BolC4t25393H	0	+	2510	2742	2742	1.0000000
C4	38177282	38179224	BolC4t25394H	0	+	1284	1942	1942	1.0000000
C4	38187750	38190814	BolC4t25395H	0	+	3765	3064	3064	1.0000000
C4	38191402	38192703	BolC4t25396H	0	-	165	824	1301	0.6333590
C4	38207049	38207418	BolC4t25397H	0	+	165	291	369	0.7886179
C4	38207998	38208163	BolC4t25398H	0	+	1	113	165	0.6848485
C4	38214764	38215464	BolC4t25399H	0	+	281	700	700	1.0000000
C4	38225327	38228750	BolC4t25400H	0	+	1182	3034	3423	0.8863570
C4	38228746	38229358	BolC4t25401H	0	+	0	0	612	0.0000000
C4	38231404	38231677	BolC4t25402H	0	+	20	250	273	0.9157509
C4	38247828	38250457	BolC4t25403H	0	-	647	2213	2629	0.8417649
C4	38261356	38263448	BolC4t25404H	0	+	2224	1935	2092	0.9249522
C4	38289355	38289826	BolC4t25405H	0	+	147	471	471	1.0000000
C4	38294713	38296055	BolC4t25406H	0	+	867	1342	1342	1.0000000
C4	38301557	38303718	BolC4t25407H	0	+	866	2161	2161	1.0000000
C4	38304231	38306582	BolC4t25408H	0	-	1233	2351	2351	1.0000000
C4	38308910	38309021	BolC4t25409H	0	-	138	111	111	1.0000000
C4	38312955	38313586	BolC4t25410H	0	-	551	631	631	1.0000000
C4	38314242	38315955	BolC4t25411H	0	+	1145	1713	1713	1.0000000
C4	38318465	38319194	BolC4t25412H	0	-	41	698	729	0.9574760
C4	38322688	38323814	BolC4t25413H	0	-	8	235	1126	0.2087034
C4	38328050	38328203	BolC4t25414H	0	+	180	153	153	1.0000000
C4	38332479	38335126	BolC4t25415H	0	+	1466	2541	2647	0.9599547
C4	38335344	38337809	BolC4t25416H	0	-	527	2086	2465	0.8462475
C4	38344992	38347314	BolC4t25417H	0	-	917	2054	2322	0.8845823
C4	38348015	38348768	BolC4t25418H	0	-	136	753	753	1.0000000
C4	38348823	38349207	BolC4t25419H	0	+	150	384	384	1.0000000
C4	38351146	38352689	BolC4t25420H	0	+	35	767	1543	0.4970836
C4	38353332	38353560	BolC4t25421H	0	-	242	228	228	1.0000000
C4	38376482	38377821	BolC4t25422H	0	+	987	1339	1339	1.0000000
C4	38385961	38388278	BolC4t25423H	0	+	304	1842	2317	0.7949935
C4	38392501	38393265	BolC4t25424H	0	+	225	652	764	0.8534032
C4	38402287	38402756	BolC4t25425H	0	-	426	469	469	1.0000000
C4	38409661	38411476	BolC4t25426H	0	-	1814	1815	1815	1.0000000
C4	38411951	38412221	BolC4t25427H	0	-	170	270	270	1.0000000
C4	38422804	38438170	BolC4t25428H	0	+	4716	8028	15366	0.5224522
C4	38438461	38441172	BolC4t25429H	0	-	1064	2280	2711	0.8410181
C4	38462603	38469440	BolC4t25430H	0	-	4339	6657	6837	0.9736727
C4	38469791	38469950	BolC4t25431H	0	+	174	159	159	1.0000000
C4	38470127	38471644	BolC4t25432H	0	+	1144	1410	1517	0.9294661
C4	38475646	38476924	BolC4t25433H	0	-	1139	1278	1278	1.0000000
C4	38481365	38481600	BolC4t25434H	0	-	0	0	235	0.0000000
C4	38482596	38482848	BolC4t25435H	0	-	213	252	252	1.0000000
C4	38483935	38484127	BolC4t25436H	0	-	358	192	192	1.0000000
C4	38516891	38518103	BolC4t25437H	0	+	155	528	1212	0.4356436
C4	38527613	38527952	BolC4t25438H	0	+	46	258	339	0.7610620
C4	38528911	38529233	BolC4t25439H	0	-	265	322	322	1.0000000
C4	38529375	38530129	BolC4t25440H	0	-	616	754	754	1.0000000
C4	38531987	38532771	BolC4t25441H	0	+	595	784	784	1.0000000
C4	38533340	38536431	BolC4t25442H	0	+	1193	2101	3091	0.6797153
C4	38547733	38550337	BolC4t25443H	0	+	395	1478	2604	0.5675883
C4	38556188	38558288	BolC4t25444H	0	+	1499	2100	2100	1.0000000
C4	38558796	38562562	BolC4t25445H	0	-	3548	3766	3766	1.0000000
C4	38572347	38576255	BolC4t25446H	0	+	2408	3769	3908	0.9644319
C4	38580212	38580816	BolC4t25447H	0	+	706	604	604	1.0000000
C4	38581261	38583925	BolC4t25448H	0	-	2241	2635	2664	0.9891141
C4	38610012	38610432	BolC4t25449H	0	-	7	213	420	0.5071428
C4	38619862	38620218	BolC4t25450H	0	+	0	0	356	0.0000000
C4	38626677	38627061	BolC4t25451H	0	+	0	0	384	0.0000000
C4	38662297	38664182	BolC4t25452H	0	+	480	1772	1885	0.9400530
C4	38670404	38670885	BolC4t25453H	0	-	26	112	481	0.2328482
C4	38674026	38675422	BolC4t25454H	0	-	512	1248	1396	0.8939828
C4	38691452	38694740	BolC4t25455H	0	+	1592	3288	3288	1.0000000
C4	38703184	38705103	BolC4t25456H	0	+	951	1919	1919	1.0000000
C4	38705333	38707583	BolC4t25457H	0	-	659	2163	2250	0.9613333
C4	38718681	38718977	BolC4t25458H	0	-	261	296	296	1.0000000
C4	38719147	38719564	BolC4t25459H	0	-	229	417	417	1.0000000
C4	38720172	38721866	BolC4t25460H	0	-	1180	1694	1694	1.0000000
C4	38723802	38725558	BolC4t25461H	0	-	742	1544	1756	0.8792711
C4	38739105	38740885	BolC4t25462H	0	+	482	1625	1780	0.9129214
C4	38741412	38741925	BolC4t25463H	0	-	569	513	513	1.0000000
C4	38775522	38775894	BolC4t25464H	0	-	21	281	372	0.7553763
C4	38776992	38777494	BolC4t25465H	0	+	4150	502	502	1.0000000
C4	38780780	38781143	BolC4t25466H	0	+	1291	363	363	1.0000000
C4	38785997	38786294	BolC4t25467H	0	-	289	297	297	1.0000000
C4	38788685	38791149	BolC4t25468H	0	-	13019	2404	2464	0.9756494
C4	38807282	38807474	BolC4t25469H	0	+	2	184	192	0.9583333
C4	38810685	38810910	BolC4t25470H	0	+	0	0	225	0.0000000
C4	38834455	38836192	BolC4t25471H	0	-	425	1255	1737	0.7225101
C4	38857125	38857671	BolC4t25472H	0	-	273	546	546	1.0000000
C4	38857716	38857893	BolC4t25473H	0	+	67	177	177	1.0000000
C4	38863329	38867668	BolC4t25474H	0	+	3172	4297	4339	0.9903203
C4	38869843	38872262	BolC4t25475H	0	-	1110	2230	2419	0.9218686
C4	38873339	38874130	BolC4t25476H	0	-	18	321	791	0.4058154
C4	38886913	38888208	BolC4t25477H	0	+	63	717	1295	0.5536680
C4	38888756	38891535	BolC4t25478H	0	-	1459	2769	2779	0.9964016
C4	38898001	38899031	BolC4t25479H	0	-	223	675	1030	0.6553398
C4	38899124	38902811	BolC4t25480H	0	+	1369	3041	3687	0.8247898
C4	38906963	38907632	BolC4t25481H	0	-	985	669	669	1.0000000
C4	38910917	38911840	BolC4t25482H	0	-	735	923	923	1.0000000
C4	38915536	38917550	BolC4t25483H	0	+	1099	2014	2014	1.0000000
C4	38929760	38932334	BolC4t25484H	0	-	1435	2574	2574	1.0000000
C4	38932557	38933959	BolC4t25485H	0	-	699	1402	1402	1.0000000
C4	38942330	38946188	BolC4t25486H	0	+	585	2611	3858	0.6767755
C4	38950991	38951388	BolC4t25487H	0	-	636	397	397	1.0000000
C4	38951735	38952281	BolC4t25488H	0	-	241	546	546	1.0000000
C4	38955025	38955526	BolC4t25489H	0	+	140	501	501	1.0000000
C4	38957098	38958725	BolC4t25490H	0	-	1032	1627	1627	1.0000000
C4	38960814	38964301	BolC4t25491H	0	-	2083	3487	3487	1.0000000
C4	39003453	39003765	BolC4t25492H	0	+	298	312	312	1.0000000
C4	39014482	39017476	BolC4t25493H	0	+	965	2819	2994	0.9415498
C4	39019360	39019774	BolC4t25494H	0	+	363	414	414	1.0000000
C4	39043096	39045028	BolC4t25495H	0	-	2219	1932	1932	1.0000000
C4	39046261	39046761	BolC4t25496H	0	-	111	443	500	0.8860000
C4	39053854	39054274	BolC4t25497H	0	+	486	420	420	1.0000000
C4	39057763	39059003	BolC4t25498H	0	+	606	1240	1240	1.0000000
C4	39062894	39063137	BolC4t25499H	0	-	45	243	243	1.0000000
C4	39065347	39066407	BolC4t25500H	0	+	1	27	1060	0.0254717
C4	39068268	39068469	BolC4t25501H	0	-	0	0	201	0.0000000
C4	39088850	39089331	BolC4t25502H	0	-	259	481	481	1.0000000
C4	39091487	39092086	BolC4t25503H	0	-	172	574	599	0.9582638
C4	39097351	39101715	BolC4t25504H	0	+	605	3807	4364	0.8723648
C4	39102813	39103079	BolC4t25505H	0	-	56	266	266	1.0000000
C4	39110313	39110607	BolC4t25506H	0	+	0	0	294	0.0000000
C4	39121180	39128108	BolC4t25507H	0	+	5386	5223	6928	0.7538972
C4	39129980	39130631	BolC4t25508H	0	+	0	0	651	0.0000000
C4	39135705	39135924	BolC4t25509H	0	+	0	0	219	0.0000000
C4	39138568	39138820	BolC4t25510H	0	+	137	252	252	1.0000000
C4	39159083	39159340	BolC4t25511H	0	+	109	257	257	1.0000000
C4	39174650	39174935	BolC4t25512H	0	+	229	285	285	1.0000000
C4	39186383	39186551	BolC4t25513H	0	+	48	168	168	1.0000000
C4	39193090	39193267	BolC4t25514H	0	-	153	177	177	1.0000000
C4	39194472	39195577	BolC4t25515H	0	+	19	272	1105	0.2461538
C4	39198235	39200982	BolC4t25516H	0	+	72	585	2747	0.2129596
C4	39208500	39209073	BolC4t25517H	0	+	388	573	573	1.0000000
C4	39214236	39215415	BolC4t25518H	0	-	738	1179	1179	1.0000000
C4	39216829	39218084	BolC4t25519H	0	-	52	554	1255	0.4414343
C4	39232936	39233332	BolC4t25520H	0	+	7	238	396	0.6010101
C4	39240259	39240598	BolC4t25521H	0	+	4	126	339	0.3716814
C4	39249080	39249272	BolC4t25522H	0	+	101	192	192	1.0000000
C4	39249374	39249950	BolC4t25523H	0	+	484	576	576	1.0000000
C4	39254461	39255125	BolC4t25524H	0	-	2	34	664	0.0512048
C4	39255262	39255439	BolC4t25525H	0	-	0	0	177	0.0000000
C4	39260581	39274327	BolC4t25526H	0	-	6355	11447	13746	0.8327513
C4	39314980	39316120	BolC4t25527H	0	+	177	912	1140	0.8000000
C4	39316777	39317287	BolC4t25528H	0	-	3	126	510	0.2470588
C4	39334270	39334633	BolC4t25529H	0	-	17	109	363	0.3002755
C4	39335806	39336193	BolC4t25530H	0	+	274	387	387	1.0000000
C4	39342987	39345505	BolC4t25531H	0	+	8	273	2518	0.1084194
C4	39346792	39347446	BolC4t25532H	0	+	0	0	654	0.0000000
C4	39348526	39351346	BolC4t25533H	0	+	64	1032	2820	0.3659574
C4	39355377	39355629	BolC4t25534H	0	+	1	18	252	0.0714286
C4	39356585	39356777	BolC4t25535H	0	-	114	192	192	1.0000000
C4	39359334	39359562	BolC4t25536H	0	+	37	209	228	0.9166667
C4	39359649	39361400	BolC4t25537H	0	+	226	1598	1751	0.9126214
C4	39372160	39372409	BolC4t25538H	0	+	0	0	249	0.0000000
C4	39378333	39380991	BolC4t25539H	0	+	5	273	2658	0.1027088
C4	39381401	39381599	BolC4t25540H	0	-	0	0	198	0.0000000
C4	39400361	39400892	BolC4t25541H	0	-	14	281	531	0.5291902
C4	39401003	39401562	BolC4t25542H	0	-	7	205	559	0.3667263
C4	39402150	39402839	BolC4t25543H	0	+	0	0	689	0.0000000
C4	39426450	39426699	BolC4t25544H	0	+	0	0	249	0.0000000
C4	39428085	39433194	BolC4t25545H	0	-	652	3545	5109	0.6938736
C4	39434044	39434585	BolC4t25546H	0	-	9	180	541	0.3327172
C4	39443432	39444947	BolC4t25547H	0	+	68	772	1515	0.5095710
C4	39446788	39449143	BolC4t25548H	0	-	257	1558	2355	0.6615711
C4	39452555	39453713	BolC4t25549H	0	+	1015	1158	1158	1.0000000
C4	39453972	39456468	BolC4t25550H	0	-	1064	2348	2496	0.9407051
C4	39463882	39464041	BolC4t25551H	0	-	53	159	159	1.0000000
C4	39467975	39468134	BolC4t25552H	0	-	34	159	159	1.0000000
C4	39472720	39473928	BolC4t25553H	0	-	947	1208	1208	1.0000000
C4	39478835	39480365	BolC4t25554H	0	+	1049	1530	1530	1.0000000
C4	39480879	39485606	BolC4t25555H	0	-	2537	4603	4727	0.9737677
C4	39493403	39493577	BolC4t25556H	0	+	30	87	174	0.5000000
C4	39494064	39495190	BolC4t25557H	0	+	86	814	1126	0.7229130
C4	39500706	39501255	BolC4t25558H	0	-	248	397	549	0.7231330
C4	39513030	39514162	BolC4t25559H	0	+	90	909	1132	0.8030035
C4	39517677	39518101	BolC4t25560H	0	+	432	424	424	1.0000000
C4	39528347	39529363	BolC4t25561H	0	+	189	680	1016	0.6692913
C4	39529721	39531412	BolC4t25562H	0	-	320	1290	1691	0.7628622
C4	39533023	39534526	BolC4t25563H	0	+	377	1376	1503	0.9155023
C4	39539798	39554200	BolC4t25564H	0	-	1561	6568	14402	0.4560478
C4	39555293	39556319	BolC4t25565H	0	-	54	818	1026	0.7972710
C4	39564823	39565573	BolC4t25566H	0	+	231	724	750	0.9653333
C4	39569618	39571379	BolC4t25567H	0	+	749	1709	1761	0.9704713
C4	39573233	39576566	BolC4t25568H	0	-	979	2983	3333	0.8949895
C4	39586720	39587345	BolC4t25569H	0	+	1044	625	625	1.0000000
C4	39591377	39601692	BolC4t25570H	0	+	3382	8546	10315	0.8285022
C4	39602608	39603103	BolC4t25571H	0	-	141	495	495	1.0000000
C4	39603520	39604309	BolC4t25572H	0	+	1	51	789	0.0646388
C4	39606537	39609114	BolC4t25573H	0	+	2263	2577	2577	1.0000000
C4	39611910	39613460	BolC4t25574H	0	+	423	1530	1550	0.9870968
C4	39616866	39621069	BolC4t25575H	0	+	3303	3721	4203	0.8853200
C4	39621672	39622947	BolC4t25576H	0	-	826	1275	1275	1.0000000
C4	39639102	39641106	BolC4t25577H	0	-	968	1976	2004	0.9860280
C4	39648033	39648159	BolC4t25578H	0	-	83	126	126	1.0000000
C4	39697170	39697449	BolC4t25579H	0	+	179	279	279	1.0000000
C4	39740815	39741010	BolC4t25580H	0	-	272	195	195	1.0000000
C4	39743320	39743545	BolC4t25581H	0	+	37	225	225	1.0000000
C4	39783446	39783698	BolC4t25582H	0	-	161	252	252	1.0000000
C4	39784643	39787354	BolC4t25583H	0	+	931	2451	2711	0.9040945
C4	39789103	39795168	BolC4t25584H	0	-	1162	4987	6065	0.8222589
C4	39816404	39817486	BolC4t25585H	0	-	734	1082	1082	1.0000000
C4	39827475	39827967	BolC4t25586H	0	-	343	492	492	1.0000000
C4	39829136	39829698	BolC4t25587H	0	+	316	562	562	1.0000000
C4	39829798	39831045	BolC4t25588H	0	+	699	1244	1247	0.9975942
C4	39831595	39834286	BolC4t25589H	0	+	47	573	2691	0.2129320
C4	39837009	39837204	BolC4t25590H	0	+	73	195	195	1.0000000
C4	39850650	39851364	BolC4t25591H	0	+	380	714	714	1.0000000
C4	39862799	39863147	BolC4t25592H	0	+	101	310	348	0.8908046
C4	39866777	39867571	BolC4t25593H	0	+	894	794	794	1.0000000
C4	39885432	39890130	BolC4t25594H	0	-	3011	4429	4698	0.9427416
C4	39899516	39899729	BolC4t25595H	0	+	33	147	213	0.6901408
C4	39913763	39914741	BolC4t25596H	0	+	880	978	978	1.0000000
C4	39934588	39934993	BolC4t25597H	0	+	800	405	405	1.0000000
C4	39941569	39941873	BolC4t25598H	0	+	139	304	304	1.0000000
C4	39942105	39942837	BolC4t25599H	0	+	294	732	732	1.0000000
C4	39943854	39944643	BolC4t25600H	0	+	789	789	789	1.0000000
C4	39960856	39962293	BolC4t25601H	0	-	168	1066	1437	0.7418233
C4	39964925	39965582	BolC4t25602H	0	+	323	657	657	1.0000000
C4	39980919	39981111	BolC4t25603H	0	+	167	192	192	1.0000000
C4	39982321	39982766	BolC4t25604H	0	+	135	445	445	1.0000000
C4	39982816	39983002	BolC4t25605H	0	+	81	186	186	1.0000000
C4	39984214	39984367	BolC4t25606H	0	-	49	153	153	1.0000000
C4	39990283	39990487	BolC4t25607H	0	-	149	204	204	1.0000000
C4	40002136	40002844	BolC4t25608H	0	+	499	708	708	1.0000000
C4	40027563	40028442	BolC4t25609H	0	+	532	879	879	1.0000000
C4	40039692	40040112	BolC4t25610H	0	-	37	179	420	0.4261905
C4	40053971	40095386	BolC4t25611H	0	-	13723	34462	41415	0.8321140
C4	40086111	40087078	BolC4t25612H	0	-	157	714	967	0.7383661
C4	40090825	40093300	BolC4t25613H	0	-	252	2279	2475	0.9208081
C4	40100687	40101194	BolC4t25614H	0	-	16	208	507	0.4102564
C4	40106143	40106395	BolC4t25615H	0	-	222	252	252	1.0000000
C4	40107280	40111984	BolC4t25616H	0	+	4922	4102	4704	0.8720238
C4	40112638	40113435	BolC4t25617H	0	+	455	785	797	0.9849435
C4	40128199	40130816	BolC4t25618H	0	+	432	1697	2617	0.6484524
C4	40131531	40132557	BolC4t25619H	0	-	839	1026	1026	1.0000000
C4	40147300	40148170	BolC4t25620H	0	-	736	870	870	1.0000000
C4	40148971	40149172	BolC4t25621H	0	-	1	39	201	0.1940299
C4	40151025	40151324	BolC4t25622H	0	+	0	0	299	0.0000000
C4	40153566	40155124	BolC4t25623H	0	+	2	219	1558	0.1405648
C4	40157368	40158316	BolC4t25624H	0	+	0	0	948	0.0000000
C4	40159837	40162084	BolC4t25625H	0	+	0	0	2247	0.0000000
C4	40171165	40171533	BolC4t25626H	0	-	0	0	368	0.0000000
C4	40198800	40199100	BolC4t25627H	0	+	43	224	300	0.7466667
C4	40200948	40201982	BolC4t25628H	0	+	881	1034	1034	1.0000000
C4	40203279	40203663	BolC4t25629H	0	-	157	384	384	1.0000000
C4	40209253	40210675	BolC4t25630H	0	+	151	1380	1422	0.9704641
C4	40219105	40220886	BolC4t25631H	0	+	435	1781	1781	1.0000000
C4	40248178	40250941	BolC4t25632H	0	+	1178	2537	2763	0.9182048
C4	40266581	40266773	BolC4t25633H	0	+	115	192	192	1.0000000
C4	40266915	40267865	BolC4t25634H	0	+	296	950	950	1.0000000
C4	40274890	40275914	BolC4t25635H	0	-	1644	1024	1024	1.0000000
C4	40296846	40298110	BolC4t25636H	0	-	524	1171	1264	0.9264240
C4	40329626	40329857	BolC4t25637H	0	+	143	231	231	1.0000000
C4	40338460	40338752	BolC4t25638H	0	-	220	292	292	1.0000000
C4	40347709	40348984	BolC4t25639H	0	+	148	973	1275	0.7631373
C4	40382663	40383956	BolC4t25640H	0	-	120	939	1293	0.7262181
C4	40386363	40386540	BolC4t25641H	0	-	154	177	177	1.0000000
C4	40389463	40389934	BolC4t25642H	0	-	327	471	471	1.0000000
C4	40394972	40396327	BolC4t25643H	0	+	136	1144	1355	0.8442804
C4	40396754	40398740	BolC4t25644H	0	+	1463	1986	1986	1.0000000
C4	40398928	40400054	BolC4t25645H	0	-	1076	1126	1126	1.0000000
C4	40401625	40404628	BolC4t25646H	0	-	719	2814	3003	0.9370629
C4	40417105	40417447	BolC4t25647H	0	+	2	19	342	0.0555556
C4	40433661	40434024	BolC4t25648H	0	-	167	363	363	1.0000000
C4	40437388	40443155	BolC4t25649H	0	-	7071	5767	5767	1.0000000
C4	40444173	40447810	BolC4t25650H	0	-	1210	3156	3637	0.8677481
C4	40448939	40450330	BolC4t25651H	0	-	1436	1391	1391	1.0000000
C4	40451354	40453023	BolC4t25652H	0	-	422	1504	1669	0.9011384
C4	40457086	40459473	BolC4t25653H	0	+	1941	2387	2387	1.0000000
C4	40462835	40463600	BolC4t25654H	0	-	4	24	765	0.0313726
C4	40466499	40466878	BolC4t25655H	0	+	58	372	379	0.9815304
C4	40481166	40482331	BolC4t25656H	0	+	1393	1165	1165	1.0000000
C4	40494516	40500512	BolC4t25657H	0	-	2067	4645	5996	0.7746831
C4	40504200	40506452	BolC4t25658H	0	+	551	2045	2252	0.9080817
C4	40507509	40513119	BolC4t25659H	0	+	7055	5610	5610	1.0000000
C4	40513607	40513897	BolC4t25660H	0	+	551	290	290	1.0000000
C4	40514190	40515213	BolC4t25661H	0	-	1487	1023	1023	1.0000000
C4	40516092	40523491	BolC4t25662H	0	-	1647	6820	7399	0.9217462
C4	40525208	40525449	BolC4t25663H	0	-	54	185	241	0.7676349
C4	40525634	40526471	BolC4t25664H	0	-	336	837	837	1.0000000
C4	40527275	40530399	BolC4t25665H	0	-	1635	2643	3124	0.8460307
C4	40534061	40534331	BolC4t25666H	0	+	162	270	270	1.0000000
C4	40535384	40536034	BolC4t25667H	0	-	273	650	650	1.0000000
C4	40536648	40536855	BolC4t25668H	0	-	1	128	207	0.6183575
C4	40537429	40537591	BolC4t25669H	0	-	33	162	162	1.0000000
C4	40538551	40539187	BolC4t25670H	0	-	182	614	636	0.9654088
C4	40541137	40542348	BolC4t25671H	0	-	348	1152	1211	0.9512799
C4	40544830	40546394	BolC4t25672H	0	+	1589	1564	1564	1.0000000
C4	40546714	40546924	BolC4t25673H	0	-	65	210	210	1.0000000
C4	40552597	40553651	BolC4t25674H	0	+	643	1054	1054	1.0000000
C4	40553873	40556503	BolC4t25675H	0	-	203	1255	2630	0.4771863
C4	40557994	40559026	BolC4t25676H	0	+	349	991	1032	0.9602713
C4	40565795	40566853	BolC4t25677H	0	+	704	1031	1058	0.9744802
C4	40567845	40568944	BolC4t25678H	0	+	250	1062	1099	0.9663330
C4	40571912	40574001	BolC4t25679H	0	+	317	1534	2089	0.7343227
C4	40579900	40580489	BolC4t25680H	0	-	28	343	589	0.5823430
C4	40586583	40587858	BolC4t25681H	0	-	58	197	1275	0.1545098
C4	40597554	40598437	BolC4t25682H	0	+	249	883	883	1.0000000
C4	40603092	40604720	BolC4t25683H	0	-	752	1603	1628	0.9846438
C4	40604778	40613677	BolC4t25684H	0	-	2144	5712	8899	0.6418699
C4	40614849	40621665	BolC4t25685H	0	-	1070	5702	6816	0.8365610
C4	40622482	40623070	BolC4t25686H	0	+	959	588	588	1.0000000
C4	40632853	40633656	BolC4t25687H	0	-	1	62	803	0.0772105
C4	40642694	40643217	BolC4t25688H	0	-	14	270	523	0.5162524
C4	40648970	40656169	BolC4t25689H	0	+	3864	7168	7199	0.9956939
C4	40657691	40659091	BolC4t25690H	0	+	511	1230	1400	0.8785715
C4	40662730	40663132	BolC4t25691H	0	+	232	402	402	1.0000000
C4	40670336	40670632	BolC4t25692H	0	+	257	296	296	1.0000000
C4	40671703	40674075	BolC4t25693H	0	-	1248	2253	2372	0.9498314
C4	40695112	40702277	BolC4t25694H	0	+	2405	6614	7165	0.9230984
C4	40726418	40729276	BolC4t25695H	0	-	1236	2858	2858	1.0000000
C4	40740033	40740628	BolC4t25696H	0	+	508	595	595	1.0000000
C4	40744732	40747519	BolC4t25697H	0	+	1322	2653	2787	0.9519196
C4	40750987	40751548	BolC4t25698H	0	+	85	393	561	0.7005348
C4	40760989	40762823	BolC4t25699H	0	+	838	1813	1834	0.9885496
C4	40763267	40766332	BolC4t25700H	0	+	649	1778	3065	0.5800979
C4	40771182	40772227	BolC4t25701H	0	+	22	542	1045	0.5186603
C4	40863455	40864304	BolC4t25702H	0	-	93	592	849	0.6972910
C4	40868176	40870014	BolC4t25703H	0	-	238	1052	1838	0.5723613
C4	40873705	40878984	BolC4t25704H	0	-	3351	5229	5279	0.9905285
C4	40882414	40882780	BolC4t25705H	0	-	311	366	366	1.0000000
C4	40902721	40903438	BolC4t25706H	0	-	122	587	717	0.8186890
C4	40904901	40905064	BolC4t25707H	0	-	341	163	163	1.0000000
C4	40921117	40922230	BolC4t25708H	0	+	970	1113	1113	1.0000000
C4	40922903	40924281	BolC4t25709H	0	-	611	1338	1378	0.9709724
C4	40927042	40930514	BolC4t25710H	0	+	1993	3441	3472	0.9910714
C4	40933711	40934608	BolC4t25711H	0	+	161	673	897	0.7502787
C4	40957680	40958957	BolC4t25712H	0	+	1186	1277	1277	1.0000000
C4	40959701	40960319	BolC4t25713H	0	-	70	460	618	0.7443365
C4	40966560	40996942	BolC4t25714H	0	+	11821	25843	30382	0.8506023
C4	40997044	41000067	BolC4t25715H	0	+	1288	2973	3023	0.9834601
C4	41005220	41006081	BolC4t25716H	0	+	1061	861	861	1.0000000
C4	41012282	41014950	BolC4t25717H	0	+	2395	2668	2668	1.0000000
C4	41015413	41018485	BolC4t25718H	0	-	1453	3011	3072	0.9801432
C4	41018766	41019827	BolC4t25719H	0	+	1060	1061	1061	1.0000000
C4	41021698	41022157	BolC4t25720H	0	+	46	273	459	0.5947713
C4	41023254	41024079	BolC4t25721H	0	+	46	758	825	0.9187879
C4	41024162	41024327	BolC4t25722H	0	+	6	26	165	0.1575758
C4	41025995	41026175	BolC4t25723H	0	-	103	180	180	1.0000000
C4	41026894	41027344	BolC4t25724H	0	+	245	450	450	1.0000000
C4	41027554	41028220	BolC4t25725H	0	+	795	666	666	1.0000000
C4	41042054	41060541	BolC4t25726H	0	+	1012	9632	18487	0.5210148
C4	41050044	41051246	BolC4t25727H	0	-	71	775	1202	0.6447588
C4	41064191	41067700	BolC4t25728H	0	+	1538	3381	3509	0.9635224
C4	41079831	41081582	BolC4t25729H	0	-	322	1326	1751	0.7572815
C4	41088879	41089435	BolC4t25730H	0	+	2	51	556	0.0917266
C4	41092815	41096871	BolC4t25731H	0	-	1111	3743	4056	0.9228304
C4	41121901	41122906	BolC4t25732H	0	-	194	802	1005	0.7980099
C4	41131537	41132821	BolC4t25733H	0	+	113	905	1284	0.7048287
C4	41133861	41135019	BolC4t25734H	0	+	813	1158	1158	1.0000000
C4	41136152	41137377	BolC4t25735H	0	+	0	0	1225	0.0000000
C4	41137383	41138197	BolC4t25736H	0	+	0	0	814	0.0000000
C4	41138987	41139910	BolC4t25737H	0	+	2	30	923	0.0325027
C4	41155025	41156291	BolC4t25738H	0	+	845	1266	1266	1.0000000
C4	41166248	41168650	BolC4t25739H	0	+	1524	2322	2402	0.9666944
C4	41172262	41176006	BolC4t25740H	0	+	1987	3657	3744	0.9767628
C4	41180167	41182765	BolC4t25741H	0	+	2153	2598	2598	1.0000000
C4	41183215	41184304	BolC4t25742H	0	-	82	956	1089	0.8778696
C4	41185073	41185553	BolC4t25743H	0	-	136	480	480	1.0000000
C4	41186241	41189811	BolC4t25744H	0	+	2049	3390	3570	0.9495798
C4	41191151	41195705	BolC4t25745H	0	-	2335	4544	4554	0.9978041
C4	41214077	41215763	BolC4t25746H	0	+	1121	1560	1686	0.9252669
C4	41219878	41223099	BolC4t25747H	0	+	1287	3119	3221	0.9683328
C4	41223797	41225793	BolC4t25748H	0	-	2299	1982	1996	0.9929860
C4	41227397	41227628	BolC4t25749H	0	-	81	197	231	0.8528138
C4	41232148	41233816	BolC4t25750H	0	+	771	1668	1668	1.0000000
C4	41238767	41240203	BolC4t25751H	0	+	26	828	1436	0.5766017
C4	41251807	41253457	BolC4t25752H	0	+	142	1005	1650	0.6090909
C4	41255903	41260698	BolC4t25753H	0	+	2681	4044	4795	0.8433785
C4	41343067	41343656	BolC4t25754H	0	-	531	589	589	1.0000000
C4	41343806	41344121	BolC4t25755H	0	-	252	315	315	1.0000000
C4	41345828	41347385	BolC4t25756H	0	+	720	1557	1557	1.0000000
C4	41357115	41359091	BolC4t25757H	0	+	344	1935	1976	0.9792510
C4	41368964	41369435	BolC4t25758H	0	-	65	336	471	0.7133758
C4	41421522	41423853	BolC4t25759H	0	+	915	2247	2331	0.9639640
C4	41426286	41428153	BolC4t25760H	0	+	992	1492	1867	0.7991430
C4	41434732	41435086	BolC4t25761H	0	+	302	354	354	1.0000000
C4	41435637	41437192	BolC4t25762H	0	-	484	1393	1555	0.8958200
C4	41450724	41450913	BolC4t25763H	0	+	65	189	189	1.0000000
C4	41451887	41452616	BolC4t25764H	0	+	59	544	729	0.7462277
C4	41486972	41488522	BolC4t25765H	0	+	341	1220	1550	0.7870968
C4	41495801	41498759	BolC4t25766H	0	+	385	2011	2958	0.6798512
C4	41500558	41500973	BolC4t25767H	0	+	0	0	415	0.0000000
C4	41518911	41521894	BolC4t25768H	0	+	538	2416	2983	0.8099229
C4	41546387	41546591	BolC4t25769H	0	-	144	204	204	1.0000000
C4	41546627	41546783	BolC4t25770H	0	-	204	156	156	1.0000000
C4	41558436	41558802	BolC4t25771H	0	-	72	366	366	1.0000000
C4	41558690	41562211	BolC4t25772H	0	-	418	2737	3521	0.7773360
C4	41565466	41565604	BolC4t25773H	0	-	23	91	138	0.6594203
C4	41599489	41600407	BolC4t25774H	0	-	26	305	918	0.3322440
C4	41602110	41605576	BolC4t25775H	0	-	236	2473	3466	0.7135026
C4	41649654	41650572	BolC4t25776H	0	-	94	672	918	0.7320262
C4	41652327	41655836	BolC4t25777H	0	-	809	3259	3509	0.9287546
C4	41700545	41706228	BolC4t25778H	0	-	38557	2647	5683	0.4657751
C4	41705613	41706228	BolC4t25779H	0	-	961	502	615	0.8162602
C4	41716581	41726433	BolC4t25780H	0	-	10555	5565	9852	0.5648599
C4	41768276	41769915	BolC4t25781H	0	-	103	1044	1639	0.6369737
C4	41783207	41785172	BolC4t25782H	0	+	140	1486	1965	0.7562341
C4	41788098	41790128	BolC4t25783H	0	+	782	2030	2030	1.0000000
C4	41790724	41791000	BolC4t25784H	0	-	181	276	276	1.0000000
C4	41791235	41792310	BolC4t25785H	0	-	195	816	1075	0.7590697
C4	41853338	41854445	BolC4t25786H	0	+	1065	1107	1107	1.0000000
C4	41863706	41891576	BolC4t25787H	0	+	14575	20007	27870	0.7178687
C4	41893345	41894738	BolC4t25788H	0	-	628	1348	1393	0.9676956
C4	41950411	41950687	BolC4t25789H	0	+	100	276	276	1.0000000
C4	41981897	41984459	BolC4t25790H	0	+	380	1417	2562	0.5530835
C4	42000832	42005443	BolC4t25791H	0	+	1387	3443	4611	0.7466927
C4	42009915	42010488	BolC4t25792H	0	+	255	565	573	0.9860384
C4	42024327	42026230	BolC4t25793H	0	+	906	1891	1903	0.9936942
C4	42027916	42028244	BolC4t25794H	0	-	752	328	328	1.0000000
C4	42041516	42041792	BolC4t25795H	0	+	1	33	276	0.1195652
C4	42053618	42059068	BolC4t25796H	0	+	1854	4375	5450	0.8027523
C4	42061464	42063089	BolC4t25797H	0	+	141	757	1625	0.4658462
C4	42075250	42078270	BolC4t25798H	0	-	1016	2588	3020	0.8569536
C4	42085744	42087525	BolC4t25799H	0	+	943	1781	1781	1.0000000
C4	42090689	42103133	BolC4t25800H	0	-	1433	4937	12444	0.3967374
C4	42104850	42106706	BolC4t25801H	0	+	2232	1856	1856	1.0000000
C4	42124288	42125408	BolC4t25802H	0	+	1122	1120	1120	1.0000000
C4	42125798	42128058	BolC4t25803H	0	-	2173	2260	2260	1.0000000
C4	42136326	42137287	BolC4t25804H	0	+	0	0	961	0.0000000
C4	42139834	42143090	BolC4t25805H	0	+	544	2846	3256	0.8740786
C4	42153342	42155292	BolC4t25806H	0	+	1195	1950	1950	1.0000000
C4	42156444	42157494	BolC4t25807H	0	-	6	151	1050	0.1438095
C4	42161776	42162076	BolC4t25808H	0	+	272	300	300	1.0000000
C4	42162195	42162554	BolC4t25809H	0	+	184	359	359	1.0000000
C4	42179887	42182382	BolC4t25810H	0	-	485	2075	2495	0.8316633
C4	42190935	42191245	BolC4t25811H	0	-	30	289	310	0.9322581
C4	42210715	42210931	BolC4t25812H	0	+	3	14	216	0.0648148
C4	42213275	42214010	BolC4t25813H	0	-	114	646	735	0.8789116
C4	42214671	42218920	BolC4t25814H	0	-	693	1224	4249	0.2880678
C4	42231847	42232734	BolC4t25815H	0	-	0	0	887	0.0000000
C4	42234568	42235290	BolC4t25816H	0	+	1	34	722	0.0470914
C4	42254392	42255499	BolC4t25817H	0	-	1008	1107	1107	1.0000000
C4	42267667	42268450	BolC4t25818H	0	+	486	783	783	1.0000000
C4	42276170	42276381	BolC4t25819H	0	+	5	181	211	0.8578199
C4	42287496	42292580	BolC4t25820H	0	+	1698	4746	5084	0.9335169
C4	42293212	42293932	BolC4t25821H	0	-	182	665	720	0.9236111
C4	42308398	42310833	BolC4t25822H	0	+	897	2345	2435	0.9630390
C4	42315196	42316100	BolC4t25823H	0	+	189	904	904	1.0000000
C4	42324871	42328315	BolC4t25824H	0	+	1558	3409	3444	0.9898374
C4	42331708	42339117	BolC4t25825H	0	+	5329	7363	7409	0.9937913
C4	42353589	42356267	BolC4t25826H	0	+	1754	2668	2678	0.9962659
C4	42374005	42374551	BolC4t25827H	0	-	345	546	546	1.0000000
C4	42377776	42377980	BolC4t25828H	0	-	9	47	204	0.2303922
C4	42392878	42395258	BolC4t25829H	0	+	1285	2357	2380	0.9903361
C4	42395459	42397859	BolC4t25830H	0	-	167	1551	2400	0.6462500
C4	42413749	42414786	BolC4t25831H	0	+	442	931	1037	0.8977821
C4	42428526	42430046	BolC4t25832H	0	-	0	0	1520	0.0000000
C4	42464256	42468012	BolC4t25833H	0	+	1027	3061	3756	0.8149627
C4	42535967	42537876	BolC4t25834H	0	-	504	1836	1909	0.9617601
C4	42540939	42543253	BolC4t25835H	0	+	399	2146	2314	0.9273984
C4	42544253	42549859	BolC4t25836H	0	-	1461	4997	5606	0.8913664
C4	42555468	42556404	BolC4t25837H	0	+	130	810	936	0.8653846
C4	42556601	42557030	BolC4t25838H	0	+	405	429	429	1.0000000
C4	42565105	42566817	BolC4t25839H	0	+	155	1502	1712	0.8773364
C4	42571619	42571920	BolC4t25840H	0	+	6	237	301	0.7873754
C4	42576211	42576394	BolC4t25841H	0	+	97	180	183	0.9836066
C4	42577937	42578729	BolC4t25842H	0	+	38	385	792	0.4861111
C4	42580197	42580983	BolC4t25843H	0	-	309	768	786	0.9770992
C4	42585407	42585597	BolC4t25844H	0	+	897	190	190	1.0000000
C4	42599224	42599359	BolC4t25845H	0	+	37	135	135	1.0000000
C4	42600164	42602018	BolC4t25846H	0	+	358	1803	1854	0.9724919
C4	42602379	42603594	BolC4t25847H	0	-	544	1215	1215	1.0000000
C4	42607662	42615931	BolC4t25848H	0	+	2082	7210	8269	0.8719313
C4	42636599	42637661	BolC4t25849H	0	-	180	876	1062	0.8248588
C4	42642005	42642501	BolC4t25850H	0	-	433	496	496	1.0000000
C4	42643192	42643330	BolC4t25851H	0	-	159	138	138	1.0000000
C4	42657547	42659289	BolC4t25852H	0	-	615	1719	1742	0.9867968
C4	42664837	42666307	BolC4t25853H	0	-	1373	1461	1470	0.9938775
C4	42668666	42668879	BolC4t25854H	0	-	447	213	213	1.0000000
C4	42675339	42675914	BolC4t25855H	0	-	10	107	575	0.1860870
C4	42676817	42677006	BolC4t25856H	0	-	0	0	189	0.0000000
C4	42680734	42680917	BolC4t25857H	0	-	5	173	183	0.9453552
C4	42697065	42698314	BolC4t25858H	0	+	621	1249	1249	1.0000000
C4	42711154	42712213	BolC4t25859H	0	-	286	1016	1059	0.9593956
C4	42725215	42726423	BolC4t25860H	0	-	209	533	1208	0.4412252
C4	42742991	42743180	BolC4t25861H	0	-	161	189	189	1.0000000
C4	42747339	42747622	BolC4t25862H	0	+	211	283	283	1.0000000
C4	42748459	42752075	BolC4t25863H	0	+	1358	3411	3616	0.9433075
C4	42752344	42754142	BolC4t25864H	0	-	627	1773	1798	0.9860957
C4	42756285	42756720	BolC4t25865H	0	+	45	307	435	0.7057471
C4	42758599	42758713	BolC4t25866H	0	-	0	0	114	0.0000000
C4	42758936	42759104	BolC4t25867H	0	-	45	168	168	1.0000000
C4	42759562	42759697	BolC4t25868H	0	-	9	135	135	1.0000000
C4	42760445	42760556	BolC4t25869H	0	-	59	111	111	1.0000000
C4	42788850	42790410	BolC4t25870H	0	+	1885	1560	1560	1.0000000
C4	42792086	42792598	BolC4t25871H	0	+	67	457	512	0.8925781
C4	42794251	42795485	BolC4t25872H	0	-	553	1213	1234	0.9829822
C4	42802301	42802982	BolC4t25873H	0	+	511	681	681	1.0000000
C4	42806291	42806750	BolC4t25874H	0	+	41	400	459	0.8714597
C4	42807049	42807271	BolC4t25875H	0	-	105	222	222	1.0000000
C4	42807325	42810016	BolC4t25876H	0	+	738	2212	2691	0.8219993
C4	42808306	42809149	BolC4t25877H	0	+	149	669	843	0.7935943
C4	42810637	42811483	BolC4t25878H	0	+	324	816	846	0.9645390
C4	42823178	42823774	BolC4t25879H	0	+	44	555	596	0.9312081
C4	42824302	42825091	BolC4t25880H	0	+	91	489	789	0.6197718
C4	42867690	42870466	BolC4t25881H	0	+	790	2604	2776	0.9380403
C4	42870793	42872754	BolC4t25882H	0	-	1028	1961	1961	1.0000000
C4	42879797	42880815	BolC4t25883H	0	-	321	888	1018	0.8722986
C4	42883031	42883870	BolC4t25884H	0	+	956	839	839	1.0000000
C4	42884107	42884347	BolC4t25885H	0	-	260	240	240	1.0000000
C4	42890218	42890753	BolC4t25886H	0	+	556	535	535	1.0000000
C4	42892400	42894852	BolC4t25887H	0	+	965	2290	2452	0.9339315
C4	42923378	42923765	BolC4t25888H	0	+	29	263	387	0.6795866
C4	42936971	42937406	BolC4t25889H	0	-	257	435	435	1.0000000
C4	42941295	42942849	BolC4t25890H	0	+	967	1554	1554	1.0000000
C4	42949344	42951882	BolC4t25891H	0	+	1269	2538	2538	1.0000000
C4	42954957	42957748	BolC4t25892H	0	+	787	1135	2791	0.4066643
C4	42969821	42970043	BolC4t25893H	0	+	197	222	222	1.0000000
C4	42972606	42972774	BolC4t25894H	0	+	23	168	168	1.0000000
C4	42979211	42982039	BolC4t25895H	0	+	1961	2828	2828	1.0000000
C4	42987979	42989592	BolC4t25896H	0	+	1467	1608	1613	0.9969002
C4	42991047	42993779	BolC4t25897H	0	-	1207	2506	2732	0.9172767
C4	43006528	43008512	BolC4t25898H	0	-	8	328	1984	0.1653226
C4	43018500	43021266	BolC4t25899H	0	+	0	0	2766	0.0000000
C4	43028831	43029119	BolC4t25900H	0	+	120	288	288	1.0000000
C4	43030557	43031892	BolC4t25901H	0	-	1132	1335	1335	1.0000000
C4	43033852	43039036	BolC4t25902H	0	+	1405	2983	5184	0.5754244
C4	43042327	43044315	BolC4t25903H	0	-	558	1825	1988	0.9180080
C4	43047748	43047961	BolC4t25904H	0	-	0	0	213	0.0000000
C4	43049817	43054057	BolC4t25905H	0	-	1077	4053	4240	0.9558962
C4	43064116	43066909	BolC4t25906H	0	-	1130	2647	2793	0.9477265
C4	43089764	43090424	BolC4t25907H	0	+	70	565	660	0.8560606
C4	43098880	43100477	BolC4t25908H	0	+	19	691	1597	0.4326863
C4	43116134	43117498	BolC4t25909H	0	-	618	1364	1364	1.0000000
C4	43140965	43141109	BolC4t25910H	0	-	2	32	144	0.2222222
C4	43142608	43143354	BolC4t25911H	0	-	427	746	746	1.0000000
C4	43145037	43148072	BolC4t25912H	0	+	441	2686	3035	0.8850082
C4	43164400	43164838	BolC4t25913H	0	-	125	246	438	0.5616438
C4	43169809	43172282	BolC4t25914H	0	-	1960	2466	2473	0.9971694
C4	43175291	43178742	BolC4t25915H	0	-	1215	3252	3451	0.9423355
C4	43182187	43185553	BolC4t25916H	0	+	1664	3155	3366	0.9373143
C4	43188500	43191302	BolC4t25917H	0	-	70	664	2802	0.2369736
C4	43201007	43202723	BolC4t25918H	0	+	1264	1716	1716	1.0000000
C4	43209982	43210282	BolC4t25919H	0	+	25	144	300	0.4800000
C4	43272158	43286212	BolC4t25920H	0	-	5004	14019	14054	0.9975096
C4	43280033	43280698	BolC4t25921H	0	-	256	665	665	1.0000000
C4	43282758	43283289	BolC4t25922H	0	-	73	531	531	1.0000000
C4	43297955	43300394	BolC4t25923H	0	-	662	1870	2439	0.7667077
C4	43304118	43304466	BolC4t25924H	0	+	18	348	348	1.0000000
C4	43328463	43329003	BolC4t25925H	0	-	224	478	540	0.8851852
C4	43329632	43334238	BolC4t25926H	0	-	1017	3439	4606	0.7466348
C4	43349709	43351767	BolC4t25927H	0	-	72	662	2058	0.3216715
C4	43357811	43358622	BolC4t25928H	0	+	384	810	811	0.9987670
C4	43380307	43385141	BolC4t25929H	0	-	459	3064	4834	0.6338436
C4	43412897	43413047	BolC4t25930H	0	+	390	150	150	1.0000000
C4	43429515	43430472	BolC4t25931H	0	+	559	957	957	1.0000000
C4	43497976	43499926	BolC4t25932H	0	-	373	1560	1950	0.8000000
C4	43502416	43506173	BolC4t25933H	0	-	782	2799	3757	0.7450093
C4	43514312	43520376	BolC4t25934H	0	+	1640	4252	6064	0.7011873
C4	43520860	43522339	BolC4t25935H	0	-	269	1316	1479	0.8897904
C4	43524888	43526978	BolC4t25936H	0	+	84	1612	2090	0.7712919
C4	43527054	43527364	BolC4t25937H	0	+	27	216	310	0.6967742
C4	43528954	43529522	BolC4t25938H	0	+	79	568	568	1.0000000
C4	43532192	43532999	BolC4t25939H	0	-	81	468	807	0.5799257
C4	43540620	43542982	BolC4t25940H	0	+	1702	2348	2362	0.9940728
C4	43551770	43553765	BolC4t25941H	0	+	985	1982	1995	0.9934837
C4	43557483	43559846	BolC4t25942H	0	-	972	2123	2363	0.8984342
C4	43561096	43561893	BolC4t25943H	0	+	53	764	797	0.9585947
C4	43578278	43578461	BolC4t25944H	0	+	92	183	183	1.0000000
C4	43579999	43581064	BolC4t25945H	0	+	177	771	1065	0.7239437
C4	43584840	43585026	BolC4t25946H	0	+	147	186	186	1.0000000
C4	43585746	43586399	BolC4t25947H	0	-	308	609	653	0.9326187
C4	43596421	43598756	BolC4t25948H	0	+	1225	2246	2335	0.9618844
C4	43599426	43601568	BolC4t25949H	0	-	467	2023	2142	0.9444444
C4	43607289	43607526	BolC4t25950H	0	+	3	140	237	0.5907173
C4	43611791	43612931	BolC4t25951H	0	+	850	1140	1140	1.0000000
C4	43613080	43613929	BolC4t25952H	0	+	584	849	849	1.0000000
C4	43620352	43622106	BolC4t25953H	0	+	577	1515	1754	0.8637400
C4	43636679	43637402	BolC4t25954H	0	+	575	723	723	1.0000000
C4	43640071	43644688	BolC4t25955H	0	+	2281	4443	4617	0.9623132
C4	43647161	43647730	BolC4t25956H	0	-	274	512	569	0.8998243
C4	43653372	43653501	BolC4t25957H	0	+	248	129	129	1.0000000
C4	43658206	43658704	BolC4t25958H	0	+	397	498	498	1.0000000
C4	43669585	43669714	BolC4t25959H	0	+	124	129	129	1.0000000
C4	43672359	43675269	BolC4t25960H	0	-	1885	2910	2910	1.0000000
C4	43675858	43676410	BolC4t25961H	0	-	216	552	552	1.0000000
C4	43678605	43682165	BolC4t25962H	0	-	1132	3381	3560	0.9497191
C4	43703921	43723464	BolC4t25963H	0	+	12754	19445	19543	0.9949854
C4	43720083	43720764	BolC4t25964H	0	+	750	681	681	1.0000000
C4	43728472	43731836	BolC4t25965H	0	+	550	2868	3364	0.8525565
C4	43732421	43735323	BolC4t25966H	0	-	986	2765	2902	0.9527912
C4	43735735	43738300	BolC4t25967H	0	-	93	1152	2565	0.4491228
C4	43752623	43755182	BolC4t25968H	0	+	932	2507	2559	0.9796796
C4	43755712	43757927	BolC4t25969H	0	+	1270	2208	2215	0.9968397
C4	43758294	43759621	BolC4t25970H	0	-	361	1254	1327	0.9449887
C4	43760066	43760579	BolC4t25971H	0	-	1081	513	513	1.0000000
C4	43766438	43766661	BolC4t25972H	0	-	846	223	223	1.0000000
C4	43767705	43769087	BolC4t25973H	0	-	320	1335	1382	0.9659913
C4	43776626	43776866	BolC4t25974H	0	-	0	0	240	0.0000000
C4	43779830	43781758	BolC4t25975H	0	+	966	1928	1928	1.0000000
C4	43783002	43792396	BolC4t25976H	0	-	5440	9217	9394	0.9811582
C4	43785342	43785564	BolC4t25977H	0	+	310	222	222	1.0000000
C4	43786712	43787663	BolC4t25978H	0	-	695	887	951	0.9327024
C4	43789706	43790767	BolC4t25979H	0	+	437	1061	1061	1.0000000
C4	43793438	43793806	BolC4t25980H	0	+	438	368	368	1.0000000
C4	43794749	43796677	BolC4t25981H	0	-	1214	1928	1928	1.0000000
C4	43798872	43799025	BolC4t25982H	0	+	0	0	153	0.0000000
C4	43808295	43812041	BolC4t25983H	0	-	789	3527	3746	0.9415376
C4	43833888	43834679	BolC4t25984H	0	-	22	494	791	0.6245259
C4	43835602	43873386	BolC4t25985H	0	+	5675	24141	37784	0.6389213
C4	43849515	43850295	BolC4t25986H	0	+	0	0	780	0.0000000
C4	43851242	43851699	BolC4t25987H	0	-	0	0	457	0.0000000
C4	43860352	43860682	BolC4t25988H	0	+	26	330	330	1.0000000
C4	43874748	43875089	BolC4t25989H	0	-	9	223	341	0.6539589
C4	43876537	43879735	BolC4t25990H	0	+	12	415	3198	0.1297686
C4	43880481	43881492	BolC4t25991H	0	+	389	1011	1011	1.0000000
C4	43881882	43883664	BolC4t25992H	0	-	621	1762	1782	0.9887767
C4	43883984	43886335	BolC4t25993H	0	-	526	1887	2351	0.8026372
C4	43902360	43904160	BolC4t25994H	0	+	658	1743	1800	0.9683333
C4	43910688	43912455	BolC4t25995H	0	+	391	1303	1767	0.7374080
C4	43926677	43927791	BolC4t25996H	0	+	731	1114	1114	1.0000000
C4	43940480	43941089	BolC4t25997H	0	-	329	609	609	1.0000000
C4	43942973	43947360	BolC4t25998H	0	-	1542	4201	4387	0.9576020
C4	43950226	43950979	BolC4t25999H	0	+	356	753	753	1.0000000
C4	43959241	43960674	BolC4t26000H	0	-	127	878	1433	0.6127006
C4	43964411	43964703	BolC4t26001H	0	+	121	292	292	1.0000000
C4	43965017	43973584	BolC4t26002H	0	+	2743	8567	8567	1.0000000
C4	43994346	43995722	BolC4t26003H	0	-	294	1266	1376	0.9200581
C4	44007918	44008269	BolC4t26004H	0	+	1	46	351	0.1310541
C4	44037014	44038749	BolC4t26005H	0	+	316	1636	1735	0.9429395
C4	44066394	44068531	BolC4t26006H	0	-	13236	2137	2137	1.0000000
C4	44075641	44076851	BolC4t26007H	0	-	230	1195	1210	0.9876033
C4	44079626	44079869	BolC4t26008H	0	-	163	243	243	1.0000000
C4	44092950	44095472	BolC4t26009H	0	+	302	1824	2522	0.7232355
C4	44103175	44105691	BolC4t26010H	0	+	965	2483	2516	0.9868839
C4	44113300	44114608	BolC4t26011H	0	+	194	1125	1308	0.8600917
C4	44117755	44117929	BolC4t26012H	0	-	187	174	174	1.0000000
C4	44134404	44135029	BolC4t26013H	0	-	45	549	625	0.8784000
C4	44149966	44150650	BolC4t26014H	0	-	87	473	684	0.6915205
C4	44160632	44162279	BolC4t26015H	0	-	269	1321	1647	0.8020644
C4	44163650	44164813	BolC4t26016H	0	-	397	1071	1163	0.9208943
C4	44165376	44169596	BolC4t26017H	0	-	1647	4014	4220	0.9511848
C4	44176944	44179507	BolC4t26018H	0	-	1033	2288	2563	0.8927039
C4	44202118	44202292	BolC4t26019H	0	+	3	172	174	0.9885057
C4	44211232	44215948	BolC4t26020H	0	+	1227	3566	4716	0.7561493
C4	44228383	44229768	BolC4t26021H	0	+	332	1041	1385	0.7516245
C4	44258536	44261905	BolC4t26022H	0	-	1915	3369	3369	1.0000000
C4	44267560	44267896	BolC4t26023H	0	-	236	336	336	1.0000000
C4	44269834	44270074	BolC4t26024H	0	+	167	240	240	1.0000000
C4	44288587	44289238	BolC4t26025H	0	+	0	0	651	0.0000000
C4	44289562	44289731	BolC4t26026H	0	-	0	0	169	0.0000000
C4	44290642	44300256	BolC4t26027H	0	+	1501	5029	9614	0.5230913
C4	44296029	44296680	BolC4t26028H	0	+	0	0	651	0.0000000
C4	44297012	44297178	BolC4t26029H	0	-	3	50	166	0.3012048
C4	44298145	44298682	BolC4t26030H	0	+	34	335	537	0.6238361
C4	44299667	44300054	BolC4t26031H	0	+	141	387	387	1.0000000
C4	44301577	44302832	BolC4t26032H	0	+	109	983	1255	0.7832670
C4	44318300	44318435	BolC4t26033H	0	+	128	135	135	1.0000000
C4	44319006	44320485	BolC4t26034H	0	-	589	1164	1479	0.7870182
C4	44323813	44326175	BolC4t26035H	0	-	109	1075	2362	0.4551228
C4	44327630	44329282	BolC4t26036H	0	-	1146	1652	1652	1.0000000
C4	44332827	44335597	BolC4t26037H	0	+	454	1931	2770	0.6971119
C4	44336022	44338042	BolC4t26038H	0	-	1482	1993	2020	0.9866337
C4	44362715	44363353	BolC4t26039H	0	-	38	363	638	0.5689655
C4	44385940	44386848	BolC4t26040H	0	+	161	874	908	0.9625551
C4	44390666	44390858	BolC4t26041H	0	-	368	192	192	1.0000000
C4	44391182	44391711	BolC4t26042H	0	-	293	529	529	1.0000000
C4	44393225	44394652	BolC4t26043H	0	+	445	1362	1427	0.9544499
C4	44395874	44398026	BolC4t26044H	0	-	668	2152	2152	1.0000000
C4	44400540	44402187	BolC4t26045H	0	+	299	1617	1647	0.9817851
C4	44409605	44410162	BolC4t26046H	0	+	17	281	557	0.5044883
C4	44412581	44414715	BolC4t26047H	0	-	125	1273	2134	0.5965323
C4	44422145	44422409	BolC4t26048H	0	-	39	264	264	1.0000000
C4	44459427	44461761	BolC4t26049H	0	+	117	860	2334	0.3684661
C4	44465499	44466938	BolC4t26050H	0	+	91	588	1439	0.4086171
C4	44480234	44481268	BolC4t26051H	0	+	1057	1030	1034	0.9961315
C4	44490537	44491334	BolC4t26052H	0	-	27	335	797	0.4203262
C4	44506103	44508858	BolC4t26053H	0	+	1208	2611	2755	0.9477314
C4	44509815	44510738	BolC4t26054H	0	-	26	546	923	0.5915493
C4	44515223	44517987	BolC4t26055H	0	+	153	1319	2764	0.4772069
C4	44522073	44522263	BolC4t26056H	0	-	0	0	190	0.0000000
C4	44522371	44524289	BolC4t26057H	0	-	28	424	1918	0.2210636
C4	44526227	44527879	BolC4t26058H	0	-	747	1505	1652	0.9110169
C4	44530457	44545935	BolC4t26059H	0	-	3187	8284	15478	0.5352113
C4	44534829	44543900	BolC4t26060H	0	-	2798	7050	9071	0.7772021
C4	44555979	44556921	BolC4t26061H	0	+	281	942	942	1.0000000
C4	44560596	44560902	BolC4t26062H	0	-	293	306	306	1.0000000
C4	44587761	44589108	BolC4t26063H	0	-	505	1205	1347	0.8945805
C4	44595306	44595892	BolC4t26064H	0	-	2	4	586	0.0068259
C4	44596869	44597754	BolC4t26065H	0	-	176	848	885	0.9581921
C4	44615992	44617649	BolC4t26066H	0	-	392	712	1657	0.4296922
C4	44620046	44621627	BolC4t26067H	0	-	328	1581	1581	1.0000000
C4	44629572	44629836	BolC4t26068H	0	-	93	259	264	0.9810606
C4	44638313	44638712	BolC4t26069H	0	+	607	399	399	1.0000000
C4	44644746	44646869	BolC4t26070H	0	+	280	1381	2123	0.6504946
C4	44648564	44654251	BolC4t26071H	0	+	1292	4664	5687	0.8201160
C4	44671933	44675378	BolC4t26072H	0	-	1182	3128	3445	0.9079826
C4	44686188	44686452	BolC4t26073H	0	+	53	264	264	1.0000000
C4	44691919	44692524	BolC4t26074H	0	-	0	0	605	0.0000000
C4	44698413	44700371	BolC4t26075H	0	-	1226	1958	1958	1.0000000
C4	44703313	44705624	BolC4t26076H	0	-	1249	2309	2311	0.9991346
C4	44717949	44718915	BolC4t26077H	0	+	223	752	966	0.7784679
C4	44723876	44724440	BolC4t26078H	0	-	124	564	564	1.0000000
C4	44756569	44757337	BolC4t26079H	0	-	280	663	768	0.8632812
C4	44761129	44763625	BolC4t26080H	0	+	1532	2398	2496	0.9607372
C4	44769140	44769951	BolC4t26081H	0	-	5	235	811	0.2897657
C4	44776339	44777149	BolC4t26082H	0	-	4	93	810	0.1148148
C4	44788795	44789488	BolC4t26083H	0	+	707	693	693	1.0000000
C4	44805604	44806760	BolC4t26084H	0	+	934	1080	1156	0.9342561
C4	44807092	44807437	BolC4t26085H	0	-	471	345	345	1.0000000
C4	44809740	44810079	BolC4t26086H	0	+	0	0	339	0.0000000
C4	44809858	44810461	BolC4t26087H	0	+	1	6	603	0.0099502
C4	44814939	44815747	BolC4t26088H	0	-	129	709	808	0.8774753
C4	44838459	44842055	BolC4t26089H	0	-	510	2185	3596	0.6076196
C4	44852087	44854575	BolC4t26090H	0	-	1100	2445	2488	0.9827170
C4	44856254	44856611	BolC4t26091H	0	-	601	357	357	1.0000000
C4	44858231	44860825	BolC4t26092H	0	+	931	2554	2594	0.9845798
C4	44870911	44872556	BolC4t26093H	0	-	103	715	1645	0.4346505
C4	44874753	44875725	BolC4t26094H	0	+	457	878	972	0.9032922
C4	44879533	44881310	BolC4t26095H	0	-	1025	1710	1777	0.9622960
C4	44893364	44893909	BolC4t26096H	0	+	437	545	545	1.0000000
C4	44904720	44906076	BolC4t26097H	0	-	1274	1356	1356	1.0000000
C4	44930040	44930735	BolC4t26098H	0	+	446	695	695	1.0000000
C4	44931105	44931942	BolC4t26099H	0	+	537	837	837	1.0000000
C4	44935178	44935793	BolC4t26100H	0	+	326	615	615	1.0000000
C4	44936089	44936687	BolC4t26101H	0	+	459	598	598	1.0000000
C4	44950826	44952980	BolC4t26102H	0	+	316	1558	2154	0.7233055
C4	44972516	44974916	BolC4t26103H	0	+	1769	2144	2400	0.8933333
C4	44976586	44978240	BolC4t26104H	0	+	822	1654	1654	1.0000000
C4	44978800	44980215	BolC4t26105H	0	-	610	1415	1415	1.0000000
C4	44982363	44982879	BolC4t26106H	0	+	527	516	516	1.0000000
C4	44983303	44983824	BolC4t26107H	0	-	502	521	521	1.0000000
C4	44988321	44988807	BolC4t26108H	0	+	63	399	486	0.8209876
C4	44992778	44994105	BolC4t26109H	0	+	853	1016	1327	0.7656368
C4	44994637	44997051	BolC4t26110H	0	-	387	1784	2414	0.7390224
C4	45001000	45002452	BolC4t26111H	0	-	452	1208	1452	0.8319559
C4	45007702	45009960	BolC4t26112H	0	-	1254	2258	2258	1.0000000
C4	45017377	45017863	BolC4t26113H	0	+	125	486	486	1.0000000
C4	45018804	45021270	BolC4t26114H	0	-	936	2322	2466	0.9416059
C4	45045212	45047899	BolC4t26115H	0	+	821	2185	2687	0.8131745
C4	45050794	45052447	BolC4t26116H	0	-	1211	1575	1653	0.9528131
C4	45071579	45073361	BolC4t26117H	0	+	242	1548	1782	0.8686869
C4	45087827	45088130	BolC4t26118H	0	+	41	203	303	0.6699670
C4	45095493	45095874	BolC4t26119H	0	+	48	312	381	0.8188977
C4	45111876	45114157	BolC4t26120H	0	+	984	2265	2281	0.9929855
C4	45114480	45117864	BolC4t26121H	0	-	1424	3179	3384	0.9394208
C4	45119957	45120278	BolC4t26122H	0	-	312	321	321	1.0000000
C4	45130121	45131216	BolC4t26123H	0	-	187	699	1095	0.6383561
C4	45139367	45142626	BolC4t26124H	0	+	1553	3168	3259	0.9720773
C4	45143423	45143561	BolC4t26125H	0	+	234	138	138	1.0000000
C4	45156912	45158340	BolC4t26126H	0	+	261	1208	1428	0.8459384
C4	45160810	45161900	BolC4t26127H	0	-	219	1015	1090	0.9311926
C4	45164932	45165130	BolC4t26128H	0	+	344	198	198	1.0000000
C4	45175691	45176108	BolC4t26129H	0	-	54	346	417	0.8297362
C4	45181522	45183203	BolC4t26130H	0	+	715	1510	1681	0.8982748
C4	45190100	45190373	BolC4t26131H	0	+	528	273	273	1.0000000
C4	45214660	45215750	BolC4t26132H	0	-	16	256	1090	0.2348624
C4	45218623	45219449	BolC4t26133H	0	+	689	826	826	1.0000000
C4	45248105	45250757	BolC4t26134H	0	+	1353	2573	2652	0.9702111
C4	45259650	45262508	BolC4t26135H	0	+	699	2281	2858	0.7981105
C4	45263909	45267203	BolC4t26136H	0	+	1096	3209	3294	0.9741955
C4	45290716	45293418	BolC4t26137H	0	+	660	1897	2702	0.7020726
C4	45304163	45304944	BolC4t26138H	0	-	10	343	781	0.4391805
C4	45308386	45309657	BolC4t26139H	0	+	1256	1271	1271	1.0000000
C4	45324099	45326603	BolC4t26140H	0	+	1103	1875	2504	0.7488019
C4	45341050	45341348	BolC4t26141H	0	+	81	236	298	0.7919463
C4	45345386	45345752	BolC4t26142H	0	-	44	323	366	0.8825136
C4	45376296	45377136	BolC4t26143H	0	-	326	840	840	1.0000000
C4	45378629	45380119	BolC4t26144H	0	+	603	852	1490	0.5718121
C4	45382410	45384538	BolC4t26145H	0	-	367	1421	2128	0.6677632
C4	45390631	45390784	BolC4t26146H	0	-	216	153	153	1.0000000
C4	45395121	45397065	BolC4t26147H	0	+	237	1431	1944	0.7361111
C4	45398891	45400334	BolC4t26148H	0	+	23	89	1443	0.0616771
C4	45400860	45402243	BolC4t26149H	0	-	766	1299	1383	0.9392624
C4	45411357	45412065	BolC4t26150H	0	-	329	708	708	1.0000000
C4	45415421	45415709	BolC4t26151H	0	+	43	194	288	0.6736111
C4	45415898	45417111	BolC4t26152H	0	+	266	825	1213	0.6801319
C4	45417584	45419603	BolC4t26153H	0	+	251	1695	2019	0.8395245
C4	45419876	45420629	BolC4t26154H	0	-	56	389	753	0.5166003
C4	45422376	45423879	BolC4t26155H	0	-	588	1496	1503	0.9953427
C4	45430143	45430962	BolC4t26156H	0	-	502	731	819	0.8925519
C4	45474203	45476307	BolC4t26157H	0	+	882	1968	2104	0.9353612
C4	45476719	45478456	BolC4t26158H	0	-	276	1455	1737	0.8376511
C4	45479151	45479547	BolC4t26159H	0	-	122	396	396	1.0000000
C4	45479667	45480082	BolC4t26160H	0	-	37	414	415	0.9975904
C4	45484632	45485081	BolC4t26161H	0	+	242	449	449	1.0000000
C4	45487402	45491228	BolC4t26162H	0	+	1015	2809	3826	0.7341871
C4	45494093	45494996	BolC4t26163H	0	+	25	309	903	0.3421927
C4	45499725	45501328	BolC4t26164H	0	+	359	1550	1603	0.9669370
C4	45509703	45509939	BolC4t26165H	0	+	278	236	236	1.0000000
C4	45511489	45514015	BolC4t26166H	0	-	112	1516	2526	0.6001583
C4	45531619	45532016	BolC4t26167H	0	+	230	397	397	1.0000000
C4	45543955	45547637	BolC4t26168H	0	+	787	3090	3682	0.8392178
C4	45576132	45576288	BolC4t26169H	0	+	269	156	156	1.0000000
C4	45591937	45602324	BolC4t26170H	0	+	4790	9279	10387	0.8933282
C4	45594036	45616340	BolC4t26171H	0	-	8274	14093	22304	0.6318598
C4	45596921	45598538	BolC4t26172H	0	-	626	1315	1617	0.8132344
C4	45619123	45620464	BolC4t26173H	0	-	1195	1341	1341	1.0000000
C4	45622176	45622668	BolC4t26174H	0	+	40	199	492	0.4044715
C4	45629187	45629625	BolC4t26175H	0	+	21	165	438	0.3767123
C4	45636658	45641207	BolC4t26176H	0	+	462	1632	4549	0.3587602
C4	45643374	45644424	BolC4t26177H	0	+	585	996	1050	0.9485714
C4	45645177	45645704	BolC4t26178H	0	-	49	511	527	0.9696395
C4	45647292	45648555	BolC4t26179H	0	-	47	750	1263	0.5938242
C4	45649337	45650674	BolC4t26180H	0	-	296	1254	1337	0.9379207
C4	45658568	45660156	BolC4t26181H	0	+	1143	1537	1588	0.9678841
C4	45666041	45668288	BolC4t26182H	0	+	1327	2247	2247	1.0000000
C4	45671001	45671482	BolC4t26183H	0	-	360	481	481	1.0000000
C4	45674608	45675831	BolC4t26184H	0	-	66	802	1223	0.6557645
C4	45689169	45701178	BolC4t26185H	0	-	1857	9165	12009	0.7631776
C4	45689520	45690071	BolC4t26186H	0	+	74	457	551	0.8294011
C4	45697470	45697872	BolC4t26187H	0	+	341	402	402	1.0000000
C4	45702147	45702321	BolC4t26188H	0	-	43	174	174	1.0000000
C4	45718690	45719425	BolC4t26189H	0	+	23	377	735	0.5129251
C4	45734942	45735282	BolC4t26190H	0	+	381	340	340	1.0000000
C4	45747437	45749361	BolC4t26191H	0	+	385	1477	1924	0.7676715
C4	45767326	45767923	BolC4t26192H	0	+	11	64	597	0.1072027
C4	45769362	45770470	BolC4t26193H	0	+	367	1108	1108	1.0000000
C4	45770687	45771275	BolC4t26194H	0	-	11	279	588	0.4744898
C4	45786402	45788640	BolC4t26195H	0	+	139	1517	2238	0.6778374
C4	45789318	45790445	BolC4t26196H	0	+	155	752	1127	0.6672582
C4	45791317	45791572	BolC4t26197H	0	+	3	108	255	0.4235294
C4	45797378	45803006	BolC4t26198H	0	-	159	1723	5628	0.3061478
C4	45814758	45815470	BolC4t26199H	0	-	1	128	712	0.1797753
C4	45824253	45825006	BolC4t26200H	0	-	505	753	753	1.0000000
C4	45829769	45830227	BolC4t26201H	0	+	77	458	458	1.0000000
C4	45830730	45831039	BolC4t26202H	0	+	72	309	309	1.0000000
C4	45833793	45834009	BolC4t26203H	0	-	255	216	216	1.0000000
C4	45837053	45837742	BolC4t26204H	0	+	116	454	689	0.6589260
C4	45843671	45844577	BolC4t26205H	0	+	79	598	906	0.6600441
C4	45859804	45860356	BolC4t26206H	0	+	17	485	552	0.8786232
C4	45870404	45871358	BolC4t26207H	0	+	149	801	954	0.8396226
C4	45877864	45878107	BolC4t26208H	0	+	69	243	243	1.0000000
C4	45923088	45927804	BolC4t26209H	0	+	784	3982	4716	0.8443596
C4	45928690	45930503	BolC4t26210H	0	-	962	1813	1813	1.0000000
C4	45943988	45946752	BolC4t26211H	0	+	1822	2764	2764	1.0000000
C4	45955047	45958739	BolC4t26212H	0	+	1132	3000	3692	0.8125677
C4	45959459	45959984	BolC4t26213H	0	+	350	525	525	1.0000000
C4	45961441	45961555	BolC4t26214H	0	+	165	114	114	1.0000000
C4	45963833	45964257	BolC4t26215H	0	-	218	424	424	1.0000000
C4	45974365	45975009	BolC4t26216H	0	+	481	644	644	1.0000000
C4	45977265	45979395	BolC4t26217H	0	+	773	1769	2130	0.8305165
C4	45980447	45982042	BolC4t26218H	0	-	1330	1595	1595	1.0000000
C4	45983111	45984684	BolC4t26219H	0	-	583	1573	1573	1.0000000
C4	45987438	45988704	BolC4t26220H	0	-	723	1266	1266	1.0000000
C4	45995001	45996242	BolC4t26221H	0	-	224	836	1241	0.6736503
C4	46014212	46015396	BolC4t26222H	0	+	268	1054	1184	0.8902027
C4	46016963	46017380	BolC4t26223H	0	+	366	417	417	1.0000000
C4	46020178	46020440	BolC4t26224H	0	-	4	43	262	0.1641221
C4	46026913	46027342	BolC4t26225H	0	+	311	429	429	1.0000000
C4	46036400	46036835	BolC4t26226H	0	+	176	435	435	1.0000000
C4	46045710	46049072	BolC4t26227H	0	-	533	2839	3362	0.8444378
C4	46050303	46051682	BolC4t26228H	0	+	477	1379	1379	1.0000000
C4	46054277	46056803	BolC4t26229H	0	+	584	2074	2526	0.8210610
C4	46067784	46068122	BolC4t26230H	0	+	228	338	338	1.0000000
C4	46070810	46071053	BolC4t26231H	0	-	14	117	243	0.4814815
C4	46073534	46074045	BolC4t26232H	0	+	0	0	511	0.0000000
C4	46084312	46086061	BolC4t26233H	0	+	598	1571	1749	0.8982276
C4	46086788	46087121	BolC4t26234H	0	-	194	333	333	1.0000000
C4	46093875	46100902	BolC4t26235H	0	-	1788	4040	7027	0.5749253
C4	46119282	46119417	BolC4t26236H	0	-	296	135	135	1.0000000
C4	46122276	46122645	BolC4t26237H	0	+	279	369	369	1.0000000
C4	46125094	46125825	BolC4t26238H	0	+	572	731	731	1.0000000
C4	46127329	46128241	BolC4t26239H	0	+	512	912	912	1.0000000
C4	46135432	46137382	BolC4t26240H	0	-	248	1271	1950	0.6517949
C4	46157239	46158774	BolC4t26241H	0	+	2024	1535	1535	1.0000000
C4	46164999	46165350	BolC4t26242H	0	+	358	351	351	1.0000000
C4	46166090	46168364	BolC4t26243H	0	-	601	2162	2274	0.9507476
C4	46168912	46170071	BolC4t26244H	0	-	1071	1159	1159	1.0000000
C4	46170405	46174409	BolC4t26245H	0	+	2870	3953	4004	0.9872627
C4	46176070	46179736	BolC4t26246H	0	+	115	2055	3666	0.5605565
C4	46182617	46182914	BolC4t26247H	0	-	4	160	297	0.5387205
C4	46183551	46185510	BolC4t26248H	0	-	106	1667	1959	0.8509443
C4	46188156	46190409	BolC4t26249H	0	+	335	1021	2253	0.4531735
C4	46193692	46194609	BolC4t26250H	0	-	1148	917	917	1.0000000
C4	46195783	46198587	BolC4t26251H	0	-	2234	2804	2804	1.0000000
C4	46202297	46202522	BolC4t26252H	0	-	0	0	225	0.0000000
C4	46210606	46212919	BolC4t26253H	0	+	945	2292	2313	0.9909209
C4	46224252	46225790	BolC4t26254H	0	+	1005	1538	1538	1.0000000
C4	46232239	46233238	BolC4t26255H	0	-	369	983	999	0.9839840
C4	46244702	46245108	BolC4t26256H	0	-	105	406	406	1.0000000
C4	46246334	46247550	BolC4t26257H	0	+	355	1216	1216	1.0000000
C4	46253431	46254856	BolC4t26258H	0	+	841	1425	1425	1.0000000
C4	46274325	46277841	BolC4t26259H	0	+	2514	3516	3516	1.0000000
C4	46279015	46279933	BolC4t26260H	0	-	656	918	918	1.0000000
C4	46285792	46286197	BolC4t26261H	0	-	69	372	405	0.9185185
C4	46298592	46299552	BolC4t26262H	0	-	290	946	960	0.9854167
C4	46301258	46301648	BolC4t26263H	0	-	206	390	390	1.0000000
C4	46302184	46302448	BolC4t26264H	0	+	14	264	264	1.0000000
C4	46305595	46305963	BolC4t26265H	0	+	19	360	368	0.9782609
C4	46312523	46313271	BolC4t26266H	0	-	189	748	748	1.0000000
C4	46315383	46317048	BolC4t26267H	0	+	564	1552	1665	0.9321321
C4	46318172	46319592	BolC4t26268H	0	+	830	1420	1420	1.0000000
C4	46323413	46324382	BolC4t26269H	0	-	391	854	969	0.8813210
C4	46327049	46328294	BolC4t26270H	0	-	5	469	1245	0.3767068
C4	46329470	46336124	BolC4t26271H	0	-	1993	4194	6654	0.6302975
C4	46336936	46338441	BolC4t26272H	0	-	683	1505	1505	1.0000000
C4	46342228	46345283	BolC4t26273H	0	-	702	2737	3055	0.8959084
C4	46350794	46353373	BolC4t26274H	0	+	1121	2550	2579	0.9887553
C4	46356106	46356466	BolC4t26275H	0	+	312	360	360	1.0000000
C4	46363884	46366170	BolC4t26276H	0	-	367	1572	2286	0.6876640
C4	46377269	46377882	BolC4t26277H	0	+	209	613	613	1.0000000
C4	46378004	46378291	BolC4t26278H	0	+	50	287	287	1.0000000
C4	46381391	46381538	BolC4t26279H	0	+	2	107	147	0.7278911
C4	46388935	46404126	BolC4t26280H	0	-	4582	12598	15191	0.8293068
C4	46404824	46407100	BolC4t26281H	0	-	1048	2205	2276	0.9688049
C4	46404996	46405279	BolC4t26282H	0	-	92	283	283	1.0000000
C4	46408207	46410831	BolC4t26283H	0	-	681	2207	2624	0.8410823
C4	46411960	46413052	BolC4t26284H	0	+	152	917	1092	0.8397436
C4	46424265	46424514	BolC4t26285H	0	-	210	249	249	1.0000000
C4	46424590	46425290	BolC4t26286H	0	-	358	700	700	1.0000000
C4	46435475	46436824	BolC4t26287H	0	+	892	1349	1349	1.0000000
C4	46437573	46441153	BolC4t26288H	0	-	530	2818	3580	0.7871509
C4	46441922	46445176	BolC4t26289H	0	+	1200	3150	3254	0.9680393
C4	46445964	46447525	BolC4t26290H	0	+	1113	1525	1561	0.9769379
C4	46451228	46451678	BolC4t26291H	0	-	153	450	450	1.0000000
C4	46454858	46456329	BolC4t26292H	0	-	418	1349	1471	0.9170632
C4	46465819	46468063	BolC4t26293H	0	+	1447	2244	2244	1.0000000
C4	46492580	46494298	BolC4t26294H	0	-	387	1535	1718	0.8934808
C4	46496556	46496877	BolC4t26295H	0	-	13	257	321	0.8006231
C4	46513315	46515420	BolC4t26296H	0	+	2148	2105	2105	1.0000000
C4	46555142	46555441	BolC4t26297H	0	-	147	299	299	1.0000000
C4	46562628	46563342	BolC4t26298H	0	-	256	696	714	0.9747899
C4	46566748	46568583	BolC4t26299H	0	-	1139	1835	1835	1.0000000
C4	46579447	46579852	BolC4t26300H	0	-	133	405	405	1.0000000
C4	46582593	46584433	BolC4t26301H	0	-	206	1519	1840	0.8255435
C4	46586452	46588095	BolC4t26302H	0	-	974	1643	1643	1.0000000
C4	46589257	46590839	BolC4t26303H	0	-	1617	1582	1582	1.0000000
C4	46591326	46592208	BolC4t26304H	0	+	96	882	882	1.0000000
C4	46593520	46594390	BolC4t26305H	0	+	18	629	870	0.7229885
C4	46595672	46596342	BolC4t26306H	0	-	3	52	670	0.0776119
C4	46611385	46611869	BolC4t26307H	0	-	49	393	484	0.8119835
C4	46613742	46614611	BolC4t26308H	0	+	2	129	869	0.1484465
C4	46616144	46616556	BolC4t26309H	0	-	0	0	412	0.0000000
C4	46633916	46634684	BolC4t26310H	0	+	13	220	768	0.2864583
C4	46637401	46637599	BolC4t26311H	0	-	58	198	198	1.0000000
C4	46641237	46642253	BolC4t26312H	0	+	190	771	1016	0.7588583
C4	46646326	46694451	BolC4t26313H	0	-	19608	35771	48125	0.7432935
C4	46668125	46671570	BolC4t26314H	0	+	733	2931	3445	0.8507982
C4	46694118	46694677	BolC4t26315H	0	-	196	559	559	1.0000000
C4	46697166	46697385	BolC4t26316H	0	+	216	219	219	1.0000000
C4	46700942	46702489	BolC4t26317H	0	-	1039	1547	1547	1.0000000
C4	46706101	46706705	BolC4t26318H	0	-	733	604	604	1.0000000
C4	46713603	46714878	BolC4t26319H	0	-	826	1273	1275	0.9984314
C4	46722685	46730903	BolC4t26320H	0	+	2258	5125	8218	0.6236311
C4	46731779	46732961	BolC4t26321H	0	-	599	1182	1182	1.0000000
C4	46746374	46748647	BolC4t26322H	0	+	286	1911	2273	0.8407391
C4	46756038	46757145	BolC4t26323H	0	-	415	1107	1107	1.0000000
C4	46765873	46767170	BolC4t26324H	0	-	336	1297	1297	1.0000000
C4	46780438	46780759	BolC4t26325H	0	+	5	243	321	0.7570093
C4	46801177	46802468	BolC4t26326H	0	-	57	716	1291	0.5546088
C4	46802242	46803131	BolC4t26327H	0	-	247	889	889	1.0000000
C4	46803725	46805174	BolC4t26328H	0	-	275	1312	1449	0.9054520
C4	46811349	46812068	BolC4t26329H	0	+	390	719	719	1.0000000
C4	46832560	46833551	BolC4t26330H	0	+	307	961	991	0.9697276
C4	46836785	46837955	BolC4t26331H	0	+	889	1170	1170	1.0000000
C4	46839164	46839455	BolC4t26332H	0	-	189	291	291	1.0000000
C4	46853867	46855511	BolC4t26333H	0	+	35	584	1644	0.3552311
C4	46878429	46881548	BolC4t26334H	0	+	836	2303	3119	0.7383777
C4	46882688	46884621	BolC4t26335H	0	+	179	1583	1933	0.8189343
C4	46900211	46901759	BolC4t26336H	0	+	59	636	1548	0.4108527
C4	46906646	46908006	BolC4t26337H	0	+	230	1260	1360	0.9264706
C4	46921033	46921903	BolC4t26338H	0	-	46	674	870	0.7747126
C4	46923336	46923820	BolC4t26339H	0	-	22	365	484	0.7541322
C4	46925481	46927115	BolC4t26340H	0	+	140	1166	1634	0.7135863
C4	46927449	46940384	BolC4t26341H	0	-	9458	8154	12935	0.6303827
C4	46958521	46960779	BolC4t26342H	0	-	932	2210	2258	0.9787422
C4	46961883	46964180	BolC4t26343H	0	-	1000	1599	2297	0.6961254
C4	46972088	46972232	BolC4t26344H	0	-	17	144	144	1.0000000
C4	46979601	46980000	BolC4t26345H	0	+	40	302	399	0.7568922
C4	46994693	46995279	BolC4t26346H	0	+	27	431	586	0.7354949
C4	47019753	47021105	BolC4t26347H	0	-	362	1094	1352	0.8091716
C4	47086555	47089368	BolC4t26348H	0	+	1367	2789	2813	0.9914682
C4	47089525	47090057	BolC4t26349H	0	-	136	521	532	0.9793233
C4	47092515	47094546	BolC4t26350H	0	-	1056	1958	2031	0.9640571
C4	47096475	47097876	BolC4t26351H	0	+	581	1333	1401	0.9514632
C4	47098543	47099167	BolC4t26352H	0	+	211	477	624	0.7644231
C4	47099616	47101068	BolC4t26353H	0	-	346	1401	1452	0.9648761
C4	47105427	47105995	BolC4t26354H	0	+	131	525	568	0.9242958
C4	47119939	47120149	BolC4t26355H	0	+	0	0	210	0.0000000
C4	47121272	47125116	BolC4t26356H	0	-	1553	3780	3844	0.9833507
C4	47127478	47127853	BolC4t26357H	0	-	32	335	375	0.8933333
C4	47143754	47144820	BolC4t26358H	0	-	305	926	1066	0.8686679
C4	47173851	47177098	BolC4t26359H	0	+	1074	2497	3247	0.7690176
C4	47180082	47180250	BolC4t26360H	0	+	57	168	168	1.0000000
C4	47192111	47193038	BolC4t26361H	0	-	32	257	927	0.2772384
C4	47206113	47206947	BolC4t26362H	0	-	16	89	834	0.1067146
C4	47214458	47214863	BolC4t26363H	0	-	447	405	405	1.0000000
C4	47217292	47218979	BolC4t26364H	0	+	707	1518	1687	0.8998222
C4	47221122	47224052	BolC4t26365H	0	+	645	2105	2930	0.7184300
C4	47224341	47228575	BolC4t26366H	0	-	2157	4022	4234	0.9499291
C4	47230004	47231505	BolC4t26367H	0	+	572	1501	1501	1.0000000
C4	47232932	47234069	BolC4t26368H	0	-	60	415	1137	0.3649956
C4	47258390	47260274	BolC4t26369H	0	+	215	1369	1884	0.7266454
C4	47281677	47282454	BolC4t26370H	0	+	668	777	777	1.0000000
C4	47285160	47287772	BolC4t26371H	0	+	1178	2611	2612	0.9996172
C4	47293223	47293766	BolC4t26372H	0	+	452	543	543	1.0000000
C4	47309653	47309996	BolC4t26373H	0	-	1	95	343	0.2769679
C4	47312358	47312891	BolC4t26374H	0	-	12	285	533	0.5347092
C4	47317297	47318239	BolC4t26375H	0	-	0	0	942	0.0000000
C4	47328241	47328349	BolC4t26376H	0	+	0	0	108	0.0000000
C4	47330472	47331603	BolC4t26377H	0	-	1338	1097	1131	0.9699381
C4	47337730	47342075	BolC4t26378H	0	+	7199	4265	4345	0.9815880
C4	47340730	47344588	BolC4t26379H	0	+	4100	3648	3858	0.9455677
C4	47343913	47397637	BolC4t26380H	0	+	6749	20992	53724	0.3907378
C4	47399801	47443450	BolC4t26381H	0	+	22789	36358	43649	0.8329629
C4	47402914	47404180	BolC4t26382H	0	+	715	914	1266	0.7219589
C4	47404260	47406281	BolC4t26383H	0	+	905	1892	2021	0.9361702
C4	47408277	47408711	BolC4t26384H	0	+	297	434	434	1.0000000
C4	47410301	47411003	BolC4t26385H	0	+	937	702	702	1.0000000
C4	47411261	47413402	BolC4t26386H	0	-	1774	2141	2141	1.0000000
C4	47413722	47414418	BolC4t26387H	0	+	1060	696	696	1.0000000
C4	47416112	47419745	BolC4t26388H	0	-	5000	3514	3633	0.9672447
C4	47418219	47418510	BolC4t26389H	0	-	894	291	291	1.0000000
C4	47424919	47426794	BolC4t26390H	0	+	309	1415	1875	0.7546667
C4	47445592	47459696	BolC4t26391H	0	+	1974	6879	14104	0.4877340
C4	47462852	47465597	BolC4t26392H	0	+	3046	2690	2745	0.9799635
C4	47466399	47467626	BolC4t26393H	0	-	412	1200	1227	0.9779951
C4	47467697	47468496	BolC4t26394H	0	+	326	799	799	1.0000000
C4	47472850	47474017	BolC4t26395H	0	-	271	1045	1167	0.8954585
C4	47474586	47475490	BolC4t26396H	0	+	110	845	904	0.9347345
C4	47476320	47476527	BolC4t26397H	0	-	10	141	207	0.6811594
C4	47479084	47479294	BolC4t26398H	0	+	31	198	210	0.9428571
C4	47479836	47480046	BolC4t26399H	0	-	27	199	210	0.9476190
C4	47500660	47502676	BolC4t26400H	0	-	1548	2016	2016	1.0000000
C4	47503738	47504305	BolC4t26401H	0	+	150	567	567	1.0000000
C4	47508587	47510145	BolC4t26402H	0	+	209	1024	1558	0.6572529
C4	47510469	47511096	BolC4t26403H	0	-	217	627	627	1.0000000
C4	47520226	47520599	BolC4t26404H	0	+	285	373	373	1.0000000
C4	47533314	47535247	BolC4t26405H	0	+	676	1933	1933	1.0000000
C4	47536466	47537777	BolC4t26406H	0	+	523	1275	1311	0.9725400
C4	47544695	47546601	BolC4t26407H	0	+	348	1740	1906	0.9129066
C4	47560324	47561046	BolC4t26408H	0	+	32	528	722	0.7313020
C4	47577948	47580317	BolC4t26409H	0	+	1249	2367	2369	0.9991558
C4	47580004	47582364	BolC4t26410H	0	+	1077	2312	2360	0.9796610
C4	47580454	47584402	BolC4t26411H	0	+	1174	3721	3948	0.9425026
C4	47586907	47589979	BolC4t26412H	0	-	1175	2372	3072	0.7721354
C4	47598254	47601956	BolC4t26413H	0	-	2833	3702	3702	1.0000000
C4	47614936	47618495	BolC4t26414H	0	+	1137	3395	3559	0.9539196
C4	47619069	47622802	BolC4t26415H	0	-	1084	3423	3733	0.9169568
C4	47623414	47624860	BolC4t26416H	0	-	49	888	1446	0.6141079
C4	47636330	47639069	BolC4t26417H	0	-	44	847	2739	0.3092369
C4	47639516	47639916	BolC4t26418H	0	-	16	314	400	0.7850000
C4	47641080	47641808	BolC4t26419H	0	+	54	377	728	0.5178571
C4	47644405	47644915	BolC4t26420H	0	-	525	510	510	1.0000000
C4	47649234	47649631	BolC4t26421H	0	-	546	397	397	1.0000000
C4	47649772	47651845	BolC4t26422H	0	-	323	1540	2073	0.7428847
C4	47652245	47653715	BolC4t26423H	0	-	727	1129	1470	0.7680272
C4	47654476	47656394	BolC4t26424H	0	-	620	1651	1918	0.8607925
C4	47657811	47658801	BolC4t26425H	0	+	577	990	990	1.0000000
C4	47659660	47677562	BolC4t26426H	0	-	3578	10433	17902	0.5827841
C4	47693710	47694239	BolC4t26427H	0	-	18	228	529	0.4310019
C4	47705100	47707810	BolC4t26428H	0	+	740	2532	2710	0.9343174
C4	47711900	47713247	BolC4t26429H	0	+	842	1317	1347	0.9777283
C4	47714289	47715660	BolC4t26430H	0	-	468	1371	1371	1.0000000
C4	47716048	47717495	BolC4t26431H	0	-	1130	1445	1447	0.9986178
C4	47719043	47720090	BolC4t26432H	0	-	319	954	1047	0.9111748
C4	47740066	47740777	BolC4t26433H	0	+	4	269	711	0.3783404
C4	47744852	47749577	BolC4t26434H	0	+	928	3669	4725	0.7765079
C4	47771920	47773453	BolC4t26435H	0	-	103	1048	1533	0.6836269
C4	47776984	47777269	BolC4t26436H	0	+	0	0	285	0.0000000
C4	47809265	47812859	BolC4t26437H	0	+	822	2604	3594	0.7245409
C4	47821274	47824549	BolC4t26438H	0	+	1599	2927	3275	0.8937405
C4	47836508	47839086	BolC4t26439H	0	-	278	1944	2578	0.7540729
C4	47843507	47845527	BolC4t26440H	0	-	585	2020	2020	1.0000000
C4	47849490	47851738	BolC4t26441H	0	+	275	2245	2248	0.9986655
C4	47855760	47855928	BolC4t26442H	0	+	184	168	168	1.0000000
C4	47857301	47860650	BolC4t26443H	0	+	2725	3349	3349	1.0000000
C4	47863176	47864741	BolC4t26444H	0	-	1037	1543	1565	0.9859425
C4	47865841	47867529	BolC4t26445H	0	-	1604	1688	1688	1.0000000
C4	47867889	47869443	BolC4t26446H	0	-	1337	1554	1554	1.0000000
C4	47870635	47871484	BolC4t26447H	0	-	1122	849	849	1.0000000
C4	47873370	47874778	BolC4t26448H	0	+	1039	1408	1408	1.0000000
C4	47875294	47878946	BolC4t26449H	0	-	978	3428	3652	0.9386637
C4	47880572	47883225	BolC4t26450H	0	-	274	2166	2653	0.8164342
C4	47885946	47887248	BolC4t26451H	0	+	465	1302	1302	1.0000000
C4	47889005	47889316	BolC4t26452H	0	-	173	311	311	1.0000000
C4	47890178	47891528	BolC4t26453H	0	+	997	1252	1350	0.9274074
C4	47894513	47896092	BolC4t26454H	0	-	143	895	1579	0.5668144
C4	47907967	47910529	BolC4t26455H	0	-	492	2238	2562	0.8735363
C4	47923818	47925958	BolC4t26456H	0	+	453	1970	2140	0.9205608
C4	47963197	47963398	BolC4t26457H	0	+	4	79	201	0.3930348
C4	47966190	47968101	BolC4t26458H	0	+	298	1087	1911	0.5688121
C4	47977816	47979280	BolC4t26459H	0	-	131	1190	1464	0.8128415
C4	47990918	47992478	BolC4t26460H	0	-	325	844	1560	0.5410256
C4	48001654	48002139	BolC4t26461H	0	+	16	353	485	0.7278351
C4	48004356	48004665	BolC4t26462H	0	+	53	158	309	0.5113268
C4	48017107	48017308	BolC4t26463H	0	-	1	28	201	0.1393035
C4	48017725	48017947	BolC4t26464H	0	+	0	0	222	0.0000000
C4	48018810	48019233	BolC4t26465H	0	-	1	13	423	0.0307329
C4	48041222	48042013	BolC4t26466H	0	+	13	330	791	0.4171934
C4	48044133	48044463	BolC4t26467H	0	+	0	0	330	0.0000000
C4	48048445	48048628	BolC4t26468H	0	-	0	0	183	0.0000000
C4	48049060	48049282	BolC4t26469H	0	+	0	0	222	0.0000000
C4	48050171	48050594	BolC4t26470H	0	-	0	0	423	0.0000000
C4	48081712	48083867	BolC4t26471H	0	+	1738	2155	2155	1.0000000
C4	48088389	48090001	BolC4t26472H	0	+	146	1372	1612	0.8511166
C4	48102326	48103367	BolC4t26473H	0	-	15	95	1041	0.0912584
C4	48109371	48110649	BolC4t26474H	0	-	336	1119	1278	0.8755869
C4	48126467	48127250	BolC4t26475H	0	+	268	783	783	1.0000000
C4	48131762	48134395	BolC4t26476H	0	-	1209	2194	2633	0.8332700
C4	48138653	48140877	BolC4t26477H	0	-	288	1676	2224	0.7535971
C4	48164408	48164769	BolC4t26478H	0	-	0	0	361	0.0000000
C4	48199984	48200665	BolC4t26479H	0	-	12	6	681	0.0088106
C4	48204951	48208344	BolC4t26480H	0	+	1	150	3393	0.0442087
C4	48210693	48212880	BolC4t26481H	0	+	113	1409	2187	0.6442615
C4	48223682	48224601	BolC4t26482H	0	-	3	15	919	0.0163221
C4	48231630	48232955	BolC4t26483H	0	-	51	297	1325	0.2241509
C4	48233397	48233557	BolC4t26484H	0	+	21	50	160	0.3125000
C4	48238033	48240542	BolC4t26485H	0	+	6	111	2509	0.0442407
C4	48256500	48257311	BolC4t26486H	0	-	41	248	811	0.3057953
C4	48282612	48282909	BolC4t26487H	0	+	0	0	297	0.0000000
C4	48293005	48293324	BolC4t26488H	0	+	1143	319	319	1.0000000
C4	48294498	48295118	BolC4t26489H	0	+	2	96	620	0.1548387
C4	48308066	48308798	BolC4t26490H	0	-	12	239	732	0.3265027
C4	48319359	48320842	BolC4t26491H	0	+	45	182	1483	0.1227242
C4	48322067	48322277	BolC4t26492H	0	+	16	210	210	1.0000000
C4	48329103	48330680	BolC4t26493H	0	-	290	851	1577	0.5396322
C4	48331816	48334947	BolC4t26494H	0	-	218	1692	3131	0.5404024
C4	48338078	48338749	BolC4t26495H	0	-	14	123	671	0.1833085
C4	48351756	48352418	BolC4t26496H	0	-	0	0	662	0.0000000
C4	48356716	48359806	BolC4t26497H	0	+	1092	2789	3090	0.9025890
C4	48361098	48361692	BolC4t26498H	0	-	549	571	594	0.9612795
C4	48370769	48373002	BolC4t26499H	0	+	1070	2233	2233	1.0000000
C4	48373106	48373424	BolC4t26500H	0	+	58	301	318	0.9465409
C4	48382343	48384634	BolC4t26501H	0	+	873	2077	2291	0.9065910
C4	48386764	48393212	BolC4t26502H	0	+	210	2812	6448	0.4361042
C4	48394162	48394642	BolC4t26503H	0	+	0	0	480	0.0000000
C4	48406737	48410176	BolC4t26504H	0	+	43	406	3439	0.1180576
C4	48410437	48410938	BolC4t26505H	0	+	0	0	501	0.0000000
C4	48414583	48414934	BolC4t26506H	0	+	0	0	351	0.0000000
C4	48427196	48427595	BolC4t26507H	0	-	139	399	399	1.0000000
C4	48450250	48450751	BolC4t26508H	0	+	0	0	501	0.0000000
C4	48468357	48468858	BolC4t26509H	0	+	0	0	501	0.0000000
C4	48488087	48489158	BolC4t26510H	0	+	58	912	1071	0.8515406
C4	48494745	48495205	BolC4t26511H	0	+	24	395	460	0.8586956
C4	48496560	48496908	BolC4t26512H	0	+	0	0	348	0.0000000
C4	48499938	48500166	BolC4t26513H	0	+	10	106	228	0.4649123
C4	48533705	48536425	BolC4t26514H	0	+	1685	2689	2720	0.9886029
C4	48541273	48542546	BolC4t26515H	0	-	724	1256	1273	0.9866457
C4	48542316	48543938	BolC4t26516H	0	-	1471	1622	1622	1.0000000
C4	48551043	48554448	BolC4t26517H	0	+	382	1885	3405	0.5535976
C4	48585889	48587119	BolC4t26518H	0	+	1337	1230	1230	1.0000000
C4	48589064	48591750	BolC4t26519H	0	+	1242	2470	2686	0.9195830
C4	48597618	48600785	BolC4t26520H	0	+	1863	3167	3167	1.0000000
C4	48601257	48604830	BolC4t26521H	0	+	1921	3189	3573	0.8925273
C4	48609800	48610922	BolC4t26522H	0	+	748	1122	1122	1.0000000
C4	48617311	48618752	BolC4t26523H	0	-	1277	1441	1441	1.0000000
C4	48624371	48625379	BolC4t26524H	0	+	383	853	1008	0.8462301
C4	48626180	48632204	BolC4t26525H	0	-	2566	6010	6024	0.9976760
C4	48639739	48640022	BolC4t26526H	0	-	131	283	283	1.0000000
C4	48640751	48643332	BolC4t26527H	0	+	690	2547	2581	0.9868268
C4	48644267	48645416	BolC4t26528H	0	-	422	1131	1149	0.9843342
C4	48646794	48647721	BolC4t26529H	0	+	411	924	927	0.9967638
C4	48648398	48648830	BolC4t26530H	0	-	416	432	432	1.0000000
C4	48653487	48655106	BolC4t26531H	0	-	642	1561	1619	0.9641754
C4	48654294	48655180	BolC4t26532H	0	-	704	868	886	0.9796840
C4	48660253	48662896	BolC4t26533H	0	+	2581	2614	2643	0.9890276
C4	48675109	48676426	BolC4t26534H	0	+	116	743	1317	0.5641609
C4	48680266	48681827	BolC4t26535H	0	+	1082	1561	1561	1.0000000
C4	48684460	48684688	BolC4t26536H	0	-	77	228	228	1.0000000
C4	48693376	48696269	BolC4t26537H	0	-	736	2357	2893	0.8147252
C4	48711998	48712475	BolC4t26538H	0	-	47	406	477	0.8511530
C4	48714786	48715667	BolC4t26539H	0	-	508	873	881	0.9909194
C4	48720627	48722505	BolC4t26540H	0	+	137	1477	1878	0.7864750
C4	48723671	48724925	BolC4t26541H	0	+	7	115	1254	0.0917065
C4	48730987	48731203	BolC4t26542H	0	+	34	110	216	0.5092593
C4	48736061	48737130	BolC4t26543H	0	-	248	1068	1069	0.9990646
C4	48737900	48738125	BolC4t26544H	0	-	2	120	225	0.5333334
C4	48744277	48746828	BolC4t26545H	0	+	282	1913	2551	0.7499020
C4	48749739	48752160	BolC4t26546H	0	-	582	2214	2421	0.9144982
C4	48768037	48768827	BolC4t26547H	0	-	5	161	790	0.2037975
C4	48770255	48770690	BolC4t26548H	0	+	11	100	435	0.2298851
C4	48779666	48780350	BolC4t26549H	0	-	318	684	684	1.0000000
C4	48788331	48789510	BolC4t26550H	0	-	556	1179	1179	1.0000000
C4	48820602	48822878	BolC4t26551H	0	+	2171	2276	2276	1.0000000
C4	48828216	48829666	BolC4t26552H	0	-	130	893	1450	0.6158621
C4	48845499	48847277	BolC4t26553H	0	+	8	300	1778	0.1687289
C4	48847830	48855289	BolC4t26554H	0	+	584	3794	7459	0.5086473
C4	48878516	48878852	BolC4t26555H	0	-	278	336	336	1.0000000
C4	48880534	48881420	BolC4t26556H	0	-	64	462	886	0.5214447
C4	48881675	48881864	BolC4t26557H	0	-	53	189	189	1.0000000
C4	48892545	48892812	BolC4t26558H	0	+	1	20	267	0.0749064
C4	48897815	48900615	BolC4t26559H	0	-	18	963	2800	0.3439286
C4	48912825	48916156	BolC4t26560H	0	-	427	2061	3331	0.6187331
C4	48948430	48948770	BolC4t26561H	0	-	411	340	340	1.0000000
C4	48950538	48951275	BolC4t26562H	0	+	299	737	737	1.0000000
C4	48953295	48953799	BolC4t26563H	0	+	67	419	504	0.8313492
C4	48960139	48961534	BolC4t26564H	0	+	108	473	1395	0.3390681
C4	48966990	48967323	BolC4t26565H	0	+	60	315	333	0.9459459
C4	48967316	48968486	BolC4t26566H	0	+	153	617	1170	0.5273504
C4	48992353	48993119	BolC4t26567H	0	+	166	674	766	0.8798956
C4	48997612	48998391	BolC4t26568H	0	-	12	188	779	0.2413350
C4	49007285	49008009	BolC4t26569H	0	-	187	715	724	0.9875690
C4	49016402	49016531	BolC4t26570H	0	+	0	0	129	0.0000000
C4	49028294	49029424	BolC4t26571H	0	+	131	1083	1130	0.9584071
C4	49040210	49042452	BolC4t26572H	0	+	184	1693	2242	0.7551293
C4	49052623	49053322	BolC4t26573H	0	+	49	401	699	0.5736767
C4	49056650	49058507	BolC4t26574H	0	+	272	1119	1857	0.6025848
C4	49063388	49064115	BolC4t26575H	0	-	0	0	727	0.0000000
C4	49091910	49092280	BolC4t26576H	0	-	8	221	370	0.5972973
C4	49100567	49102344	BolC4t26577H	0	+	147	1252	1777	0.7045583
C4	49107405	49107593	BolC4t26578H	0	-	0	0	188	0.0000000
C4	49114253	49116398	BolC4t26579H	0	+	600	1978	2145	0.9221445
C4	49116579	49117170	BolC4t26580H	0	-	46	464	591	0.7851100
C4	49123967	49136613	BolC4t26581H	0	-	1381	6263	12646	0.4952554
C4	49143055	49150806	BolC4t26582H	0	+	5448	7435	7751	0.9592311
C4	49150967	49151864	BolC4t26583H	0	+	355	897	897	1.0000000
C4	49151372	49162129	BolC4t26584H	0	+	3025	7129	10757	0.6627312
C4	49164162	49165299	BolC4t26585H	0	-	263	909	1137	0.7994723
C4	49177462	49178569	BolC4t26586H	0	+	132	781	1107	0.7055104
C4	49179333	49181891	BolC4t26587H	0	-	900	2457	2558	0.9605160
C4	49194085	49195042	BolC4t26588H	0	-	641	935	957	0.9770115
C4	49212314	49212500	BolC4t26589H	0	-	346	186	186	1.0000000
C4	49215690	49215879	BolC4t26590H	0	-	12	40	189	0.2116402
C4	49217997	49218789	BolC4t26591H	0	-	229	792	792	1.0000000
C4	49223944	49224319	BolC4t26592H	0	+	200	375	375	1.0000000
C4	49224587	49226745	BolC4t26593H	0	-	2077	2131	2158	0.9874884
C4	49229076	49229410	BolC4t26594H	0	+	330	334	334	1.0000000
C4	49237755	49240428	BolC4t26595H	0	+	1103	2606	2673	0.9749345
C4	49244664	49246262	BolC4t26596H	0	-	227	1515	1598	0.9480601
C4	49249127	49255369	BolC4t26597H	0	-	1431	5558	6242	0.8904197
C4	49259556	49261724	BolC4t26598H	0	-	206	1105	2168	0.5096864
C4	49267517	49267757	BolC4t26599H	0	+	151	240	240	1.0000000
C4	49268213	49268456	BolC4t26600H	0	+	9	209	243	0.8600823
C4	49268933	49269296	BolC4t26601H	0	-	0	0	363	0.0000000
C4	49285944	49286514	BolC4t26602H	0	+	10	340	570	0.5964912
C4	49287431	49291140	BolC4t26603H	0	-	298	2016	3709	0.5435427
C4	49292634	49294174	BolC4t26604H	0	+	3	58	1540	0.0376623
C4	49299678	49300847	BolC4t26605H	0	-	112	857	1169	0.7331052
C4	49305450	49306629	BolC4t26606H	0	-	94	696	1179	0.5903308
C4	49323347	49324068	BolC4t26607H	0	-	1630	721	721	1.0000000
C4	49325659	49326826	BolC4t26608H	0	-	1327	1167	1167	1.0000000
C4	49326927	49328787	BolC4t26609H	0	-	1552	1842	1860	0.9903226
C4	49336829	49338492	BolC4t26610H	0	+	75	1017	1663	0.6115454
C4	49339622	49341048	BolC4t26611H	0	-	1367	1426	1426	1.0000000
C4	49347653	49347755	BolC4t26612H	0	+	0	0	102	0.0000000
C4	49347819	49348375	BolC4t26613H	0	+	0	0	556	0.0000000
C4	49349579	49349714	BolC4t26614H	0	+	81	135	135	1.0000000
C4	49351763	49357395	BolC4t26615H	0	-	3225	5481	5632	0.9731889
C4	49391083	49391869	BolC4t26616H	0	-	0	0	786	0.0000000
C4	49393612	49394798	BolC4t26617H	0	-	2723	1186	1186	1.0000000
C4	49398294	49399256	BolC4t26618H	0	-	59	829	962	0.8617464
C4	49399621	49399735	BolC4t26619H	0	-	48	114	114	1.0000000
C4	49407881	49408184	BolC4t26620H	0	+	63	223	303	0.7359736
C4	49411695	49412777	BolC4t26621H	0	+	555	1082	1082	1.0000000
C4	49413405	49417411	BolC4t26622H	0	+	1825	3834	4006	0.9570644
C4	49426162	49435905	BolC4t26623H	0	+	812	4594	9743	0.4715180
C4	49437911	49438250	BolC4t26624H	0	-	199	339	339	1.0000000
C4	49446486	49446618	BolC4t26625H	0	-	38	113	132	0.8560606
C4	49456657	49456972	BolC4t26626H	0	+	3	59	315	0.1873016
C4	49473246	49473993	BolC4t26627H	0	-	271	729	747	0.9759036
C4	49479721	49481434	BolC4t26628H	0	+	1010	1713	1713	1.0000000
C4	49481774	49483671	BolC4t26629H	0	-	338	1838	1897	0.9688982
C4	49487106	49490040	BolC4t26630H	0	-	944	2879	2934	0.9812543
C4	49491502	49492811	BolC4t26631H	0	+	10	387	1309	0.2956455
C4	49496651	49498436	BolC4t26632H	0	-	674	1785	1785	1.0000000
C4	49500396	49501955	BolC4t26633H	0	-	991	1493	1559	0.9576651
C4	49503923	49505268	BolC4t26634H	0	-	839	1273	1345	0.9464684
C4	49509342	49511629	BolC4t26635H	0	+	1267	2281	2287	0.9973765
C4	49512191	49513562	BolC4t26636H	0	+	42	697	1371	0.5083880
C4	49515811	49517506	BolC4t26637H	0	+	1030	1688	1695	0.9958702
C4	49518203	49519799	BolC4t26638H	0	-	460	1579	1596	0.9893484
C4	49527401	49527915	BolC4t26639H	0	+	253	514	514	1.0000000
C4	49536678	49537744	BolC4t26640H	0	-	730	1066	1066	1.0000000
C4	49538399	49550751	BolC4t26641H	0	-	4827	12051	12352	0.9756315
C4	49553577	49554155	BolC4t26642H	0	-	488	558	578	0.9653979
C4	49559255	49560205	BolC4t26643H	0	-	141	924	950	0.9726316
C4	49575283	49578964	BolC4t26644H	0	+	539	2450	3681	0.6655800
C4	49587528	49588164	BolC4t26645H	0	-	168	636	636	1.0000000
C4	49588612	49590297	BolC4t26646H	0	+	122	760	1685	0.4510386
C4	49591641	49592737	BolC4t26647H	0	+	64	1003	1096	0.9151460
C4	49593921	49594699	BolC4t26648H	0	+	66	677	778	0.8701800
C4	49597643	49599331	BolC4t26649H	0	+	452	1521	1688	0.9010664
C4	49599766	49601812	BolC4t26650H	0	-	1492	1976	2046	0.9657869
C4	49602013	49602298	BolC4t26651H	0	+	141	285	285	1.0000000
C4	49609682	49610624	BolC4t26652H	0	-	0	0	942	0.0000000
C4	49615560	49618996	BolC4t26653H	0	-	2326	2983	3436	0.8681607
C4	49623398	49625114	BolC4t26654H	0	-	299	1569	1716	0.9143357
C4	49626328	49627127	BolC4t26655H	0	-	664	799	799	1.0000000
C4	49641404	49642584	BolC4t26656H	0	+	389	1153	1180	0.9771187
C4	49652469	49657070	BolC4t26657H	0	+	363	3149	4601	0.6844164
C4	49682603	49684047	BolC4t26658H	0	-	61	1094	1444	0.7576177
C4	49687300	49689050	BolC4t26659H	0	-	904	1688	1750	0.9645714
C4	49690566	49690971	BolC4t26660H	0	-	391	405	405	1.0000000
C4	49699217	49702066	BolC4t26661H	0	+	706	2797	2849	0.9817480
C4	49702631	49705294	BolC4t26662H	0	-	99	1435	2663	0.5388659
C4	49712956	49714078	BolC4t26663H	0	-	345	1065	1122	0.9491979
C4	49717746	49719460	BolC4t26664H	0	+	463	1475	1714	0.8605601
C4	49720156	49722820	BolC4t26665H	0	-	717	1789	2664	0.6715465
C4	49735084	49735789	BolC4t26666H	0	-	272	670	705	0.9503546
C4	49749818	49750187	BolC4t26667H	0	+	99	369	369	1.0000000
C4	49755380	49758901	BolC4t26668H	0	+	1059	2668	3521	0.7577393
C4	49761068	49761500	BolC4t26669H	0	+	2	55	432	0.1273148
C4	49769750	49770152	BolC4t26670H	0	+	16	204	402	0.5074627
C4	49774008	49774771	BolC4t26671H	0	+	140	754	763	0.9882045
C4	49775056	49777357	BolC4t26672H	0	-	1307	2301	2301	1.0000000
C4	49778876	49783474	BolC4t26673H	0	-	1005	3877	4598	0.8431927
C4	49790484	49792030	BolC4t26674H	0	-	45	950	1546	0.6144890
C4	49821498	49829096	BolC4t26675H	0	+	1765	4723	7598	0.6216109
C4	49823027	49823393	BolC4t26676H	0	+	0	0	366	0.0000000
C4	49831258	49834348	BolC4t26677H	0	-	1251	2923	3090	0.9459547
C4	49834549	49837614	BolC4t26678H	0	+	191	2303	3065	0.7513866
C4	49844649	49848228	BolC4t26679H	0	-	2566	3427	3579	0.9575300
C4	49852259	49852568	BolC4t26680H	0	+	128	309	309	1.0000000
C4	49868833	49869310	BolC4t26681H	0	-	425	477	477	1.0000000
C4	49869589	49870077	BolC4t26682H	0	-	755	389	488	0.7971311
C4	49873295	49874848	BolC4t26683H	0	-	1485	1553	1553	1.0000000
C4	49877542	49877878	BolC4t26684H	0	+	152	336	336	1.0000000
C4	49880827	49881273	BolC4t26685H	0	-	135	446	446	1.0000000
C4	49884528	49886833	BolC4t26686H	0	-	1316	2299	2305	0.9973969
C4	49910971	49914229	BolC4t26687H	0	+	614	2846	3258	0.8735421
C4	49915559	49918199	BolC4t26688H	0	-	709	2524	2640	0.9560606
C4	49928837	49929600	BolC4t26689H	0	+	480	763	763	1.0000000
C4	49938343	49939742	BolC4t26690H	0	+	191	1012	1399	0.7233738
C4	49948903	49949023	BolC4t26691H	0	-	47	92	120	0.7666667
C4	49952043	49953366	BolC4t26692H	0	-	92	736	1323	0.5563114
C4	49964417	49964855	BolC4t26693H	0	-	101	438	438	1.0000000
C4	49965304	49965623	BolC4t26694H	0	-	105	319	319	1.0000000
C4	49965742	49966276	BolC4t26695H	0	-	12	252	534	0.4719101
C4	49968767	49970586	BolC4t26696H	0	-	85	816	1819	0.4485981
C4	49997849	50001594	BolC4t26697H	0	-	316	2325	3745	0.6208278
C4	50002911	50004080	BolC4t26698H	0	-	119	955	1169	0.8169376
C4	50007626	50009294	BolC4t26699H	0	+	920	1668	1668	1.0000000
C4	50009846	50010956	BolC4t26700H	0	-	955	1110	1110	1.0000000
C4	50011790	50013651	BolC4t26701H	0	+	1240	1633	1861	0.8774852
C4	50023237	50024002	BolC4t26702H	0	-	45	584	765	0.7633987
C4	50025504	50026013	BolC4t26703H	0	+	774	509	509	1.0000000
C4	50043241	50044336	BolC4t26704H	0	-	629	1076	1095	0.9826484
C4	50044894	50046943	BolC4t26705H	0	+	1083	2049	2049	1.0000000
C4	50048016	50048184	BolC4t26706H	0	-	7	168	168	1.0000000
C4	50064223	50064334	BolC4t26707H	0	+	2	111	111	1.0000000
C4	50071011	50078512	BolC4t26708H	0	+	1237	3658	7501	0.4876683
C4	50081982	50082084	BolC4t26709H	0	+	60	102	102	1.0000000
C4	50109442	50118572	BolC4t26710H	0	-	434	1724	9130	0.1888280
C4	50136562	50136825	BolC4t26711H	0	-	35	80	263	0.3041825
C4	50158950	50159817	BolC4t26712H	0	+	41	549	867	0.6332180
C4	50162584	50163717	BolC4t26713H	0	+	18	124	1133	0.1094440
C4	50237582	50238251	BolC4t26714H	0	-	3	176	669	0.2630792
C4	50243332	50244344	BolC4t26715H	0	-	2	19	1012	0.0187747
C4	50263589	50264330	BolC4t26716H	0	-	205	512	741	0.6909581
C4	50269602	50270046	BolC4t26717H	0	-	411	444	444	1.0000000
C4	50271713	50272658	BolC4t26718H	0	+	808	945	945	1.0000000
C4	50273874	50274915	BolC4t26719H	0	+	518	1022	1041	0.9817483
C4	50275147	50277207	BolC4t26720H	0	-	346	2060	2060	1.0000000
C4	50279347	50279497	BolC4t26721H	0	+	144	150	150	1.0000000
C4	50283342	50284853	BolC4t26722H	0	-	110	1285	1511	0.8504302
C4	50290236	50290686	BolC4t26723H	0	-	146	438	450	0.9733334
C4	50293241	50294099	BolC4t26724H	0	+	433	858	858	1.0000000
C4	50310351	50311331	BolC4t26725H	0	-	63	792	980	0.8081633
C4	50311595	50311709	BolC4t26726H	0	-	23	114	114	1.0000000
C4	50323066	50324101	BolC4t26727H	0	+	485	1033	1035	0.9980676
C4	50326545	50327879	BolC4t26728H	0	+	728	1218	1334	0.9130435
C4	50339586	50340351	BolC4t26729H	0	-	0	0	765	0.0000000
C4	50342844	50347734	BolC4t26730H	0	+	1237	4517	4890	0.9237219
C4	50352271	50352607	BolC4t26731H	0	+	0	0	336	0.0000000
C4	50361072	50363335	BolC4t26732H	0	+	233	1487	2263	0.6570923
C4	50369631	50371839	BolC4t26733H	0	+	1502	2142	2208	0.9701087
C4	50372842	50373697	BolC4t26734H	0	+	185	839	855	0.9812865
C4	50374865	50375803	BolC4t26735H	0	-	782	938	938	1.0000000
C4	50380912	50384550	BolC4t26736H	0	-	1470	3319	3638	0.9123145
C4	50394332	50395464	BolC4t26737H	0	+	112	757	1132	0.6687279
C4	50405431	50423341	BolC4t26738H	0	-	4764	14521	17910	0.8107761
C4	50472307	50484615	BolC4t26739H	0	+	311	2444	12308	0.1985700
C4	50489226	50489478	BolC4t26740H	0	-	122	252	252	1.0000000
C4	50506665	50507716	BolC4t26741H	0	-	92	946	1051	0.9000952
C4	50526311	50527526	BolC4t26742H	0	-	745	1215	1215	1.0000000
C4	50532296	50534368	BolC4t26743H	0	-	911	2072	2072	1.0000000
C4	50533839	50534196	BolC4t26744H	0	-	307	357	357	1.0000000
C4	50536252	50536612	BolC4t26745H	0	-	40	302	360	0.8388889
C4	50546895	50547306	BolC4t26746H	0	-	195	411	411	1.0000000
C4	50567461	50568359	BolC4t26747H	0	+	42	560	898	0.6236080
C4	50578674	50580201	BolC4t26748H	0	+	872	1518	1527	0.9941061
C4	50587944	50589612	BolC4t26749H	0	-	104	1327	1668	0.7955636
C4	50610514	50611468	BolC4t26750H	0	-	73	780	954	0.8176101
C4	50615147	50615534	BolC4t26751H	0	-	54	352	387	0.9095607
C4	50616466	50627187	BolC4t26752H	0	-	3508	10391	10721	0.9692193
C4	50629206	50633886	BolC4t26753H	0	+	2998	4330	4680	0.9252137
C4	50638115	50640829	BolC4t26754H	0	+	537	2181	2714	0.8036109
C4	50643996	50644265	BolC4t26755H	0	+	268	269	269	1.0000000
C4	50649303	50652327	BolC4t26756H	0	+	754	2754	3024	0.9107143
C4	50653858	50654273	BolC4t26757H	0	-	89	361	415	0.8698795
C4	50661651	50666016	BolC4t26758H	0	-	257	873	4365	0.2000000
C4	50669138	50683532	BolC4t26759H	0	-	4204	11741	14394	0.8156871
C4	50690608	50690849	BolC4t26760H	0	-	293	241	241	1.0000000
C4	50699378	50702991	BolC4t26761H	0	+	1844	2995	3613	0.8289510
C4	50720630	50723746	BolC4t26762H	0	+	593	2388	3116	0.7663671
C4	50737159	50753089	BolC4t26763H	0	+	438	4698	15930	0.2949153
C4	50777562	50780585	BolC4t26764H	0	+	152	1406	3023	0.4651009
C4	50785277	50785842	BolC4t26765H	0	+	265	565	565	1.0000000
C4	50786970	50790087	BolC4t26766H	0	+	695	3039	3117	0.9749759
C4	50810707	50811844	BolC4t26767H	0	+	332	928	1137	0.8161829
C4	50840578	50842600	BolC4t26768H	0	+	268	1683	2022	0.8323442
C4	50851989	50852694	BolC4t26769H	0	+	0	0	705	0.0000000
C4	50864115	50866013	BolC4t26770H	0	-	1186	1805	1898	0.9510010
C4	50868226	50869398	BolC4t26771H	0	+	9	297	1172	0.2534130
C4	50878595	50878784	BolC4t26772H	0	+	30	164	189	0.8677249
C4	50886547	50886932	BolC4t26773H	0	+	2	78	385	0.2025974
C4	50892541	50892691	BolC4t26774H	0	-	0	0	150	0.0000000
C4	50893869	50896878	BolC4t26775H	0	+	1142	2801	3009	0.9308740
C4	50903592	50903943	BolC4t26776H	0	-	161	351	351	1.0000000
C4	50904176	50904433	BolC4t26777H	0	+	34	180	257	0.7003891
C4	50906785	50909110	BolC4t26778H	0	-	565	1960	2325	0.8430107
C4	50925154	50925337	BolC4t26779H	0	+	283	183	183	1.0000000
C4	50946782	50947376	BolC4t26780H	0	-	299	594	594	1.0000000
C4	50955314	50955797	BolC4t26781H	0	+	0	0	483	0.0000000
C4	50970818	50971980	BolC4t26782H	0	+	1340	1162	1162	1.0000000
C4	51033156	51034681	BolC4t26783H	0	+	379	1100	1525	0.7213115
C4	51036209	51038901	BolC4t26784H	0	-	1262	2603	2692	0.9669391
C4	51043126	51044113	BolC4t26785H	0	+	445	937	987	0.9493414
C4	51048517	51050479	BolC4t26786H	0	-	1870	1926	1962	0.9816514
C4	51055472	51056009	BolC4t26787H	0	-	2	129	537	0.2402235
C4	51080577	51080685	BolC4t26788H	0	+	104	108	108	1.0000000
C4	51080692	51080863	BolC4t26789H	0	+	78	171	171	1.0000000
C4	51081825	51082213	BolC4t26790H	0	+	104	388	388	1.0000000
C4	51098701	51099729	BolC4t26791H	0	-	58	524	1028	0.5097276
C4	51117265	51117610	BolC4t26792H	0	-	298	345	345	1.0000000
C4	51133397	51135129	BolC4t26793H	0	-	80	954	1732	0.5508083
C4	51154768	51157228	BolC4t26794H	0	-	879	2240	2460	0.9105691
C4	51162018	51163173	BolC4t26795H	0	+	889	1155	1155	1.0000000
C4	51164013	51164443	BolC4t26796H	0	+	297	430	430	1.0000000
C4	51168427	51169510	BolC4t26797H	0	+	86	796	1083	0.7349954
C4	51173455	51173641	BolC4t26798H	0	+	252	186	186	1.0000000
C4	51175420	51176194	BolC4t26799H	0	+	942	774	774	1.0000000
C4	51178696	51178879	BolC4t26800H	0	+	222	183	183	1.0000000
C4	51186257	51187135	BolC4t26801H	0	-	192	878	878	1.0000000
C4	51188551	51189436	BolC4t26802H	0	-	4	354	885	0.4000000
C4	51200513	51206060	BolC4t26803H	0	-	1765	5396	5547	0.9727781
C4	51226659	51227521	BolC4t26804H	0	+	0	0	862	0.0000000
C4	51237805	51239113	BolC4t26805H	0	-	821	1277	1308	0.9762997
C4	51242336	51243089	BolC4t26806H	0	+	129	727	753	0.9654714
C4	51253224	51256154	BolC4t26807H	0	+	929	2289	2930	0.7812287
C4	51268187	51269655	BolC4t26808H	0	-	8	301	1468	0.2050409
C4	51271650	51273719	BolC4t26809H	0	-	1044	2069	2069	1.0000000
C4	51293214	51295127	BolC4t26810H	0	+	662	1855	1913	0.9696811
C4	51303075	51304827	BolC4t26811H	0	-	95	1340	1752	0.7648402
C4	51345984	51346143	BolC4t26812H	0	-	44	159	159	1.0000000
C4	51365878	51366001	BolC4t26813H	0	-	66	123	123	1.0000000
C4	51371570	51372927	BolC4t26814H	0	+	1019	1357	1357	1.0000000
C4	51375308	51378238	BolC4t26815H	0	-	1088	2415	2930	0.8242321
C4	51399276	51400447	BolC4t26816H	0	+	31	492	1171	0.4201537
C4	51405092	51405398	BolC4t26817H	0	+	53	290	306	0.9477124
C4	51406266	51407021	BolC4t26818H	0	-	3	76	755	0.1006623
C4	51423631	51424826	BolC4t26819H	0	+	115	651	1195	0.5447699
C4	51426860	51435771	BolC4t26820H	0	-	2337	6200	8911	0.6957693
C4	51441003	51443889	BolC4t26821H	0	+	2082	2886	2886	1.0000000
C4	51445181	51446598	BolC4t26822H	0	+	732	1417	1417	1.0000000
C4	51449544	51450082	BolC4t26823H	0	-	194	538	538	1.0000000
C4	51451971	51453842	BolC4t26824H	0	-	501	1868	1871	0.9983966
C4	51465160	51465421	BolC4t26825H	0	+	113	261	261	1.0000000
C4	51469443	51470280	BolC4t26826H	0	-	374	781	837	0.9330944
C4	51506163	51508693	BolC4t26827H	0	+	507	2317	2530	0.9158103
C4	51516792	51516972	BolC4t26828H	0	+	49	180	180	1.0000000
C4	51525913	51527085	BolC4t26829H	0	+	405	1125	1172	0.9598976
C4	51540740	51541125	BolC4t26830H	0	+	1290	385	385	1.0000000
C4	51558925	51559300	BolC4t26831H	0	-	224	375	375	1.0000000
C4	51562637	51563051	BolC4t26832H	0	-	272	414	414	1.0000000
C4	51576492	51577023	BolC4t26833H	0	+	94	384	531	0.7231638
C4	51583056	51585699	BolC4t26834H	0	+	485	2641	2643	0.9992433
C4	51587446	51588654	BolC4t26835H	0	-	32	617	1208	0.5107616
C4	51594162	51594726	BolC4t26836H	0	-	392	564	564	1.0000000
C4	51614025	51616459	BolC4t26837H	0	-	1074	2434	2434	1.0000000
C4	51624487	51624880	BolC4t26838H	0	+	29	377	393	0.9592875
C4	51626343	51628836	BolC4t26839H	0	-	1024	2493	2493	1.0000000
C4	51641553	51641679	BolC4t26840H	0	+	312	126	126	1.0000000
C4	51645047	51649508	BolC4t26841H	0	+	1281	3884	4461	0.8706568
C4	51661683	51661935	BolC4t26842H	0	+	345	252	252	1.0000000
C4	51701289	51702488	BolC4t26843H	0	-	775	1199	1199	1.0000000
C4	51703265	51703577	BolC4t26844H	0	+	419	312	312	1.0000000
C4	51715922	51718641	BolC4t26845H	0	-	887	2477	2719	0.9109967
C4	51734493	51737883	BolC4t26846H	0	+	527	3181	3390	0.9383481
C4	51737982	51740127	BolC4t26847H	0	-	1264	2145	2145	1.0000000
C4	51744752	51747290	BolC4t26848H	0	-	293	1798	2538	0.7084318
C4	51751694	51753666	BolC4t26849H	0	-	343	1740	1972	0.8823529
C4	51754589	51756218	BolC4t26850H	0	+	275	1282	1629	0.7869859
C4	51761921	51762854	BolC4t26851H	0	-	340	909	933	0.9742765
C4	51763161	51801995	BolC4t26852H	0	-	12392	31537	38834	0.8120977
C4	51764787	51765245	BolC4t26853H	0	-	558	458	458	1.0000000
C4	51809433	51819518	BolC4t26854H	0	-	2247	8113	10085	0.8044621
C4	51817177	51817648	BolC4t26855H	0	+	5	168	471	0.3566879
C4	51837353	51838896	BolC4t26856H	0	+	412	1470	1543	0.9526896
C4	51841260	51841422	BolC4t26857H	0	+	178	162	162	1.0000000
C4	51855145	51856072	BolC4t26858H	0	-	77	594	927	0.6407767
C4	51859896	51860592	BolC4t26859H	0	+	184	696	696	1.0000000
C4	51873277	51873766	BolC4t26860H	0	-	182	473	489	0.9672801
C4	51887749	51888266	BolC4t26861H	0	-	424	517	517	1.0000000
C4	51903447	51903939	BolC4t26862H	0	+	682	492	492	1.0000000
C4	51911771	51916044	BolC4t26863H	0	-	3791	4030	4273	0.9431313
C4	51921125	51924158	BolC4t26864H	0	-	1015	2887	3033	0.9518629
C4	51943838	51944012	BolC4t26865H	0	-	34	174	174	1.0000000
C4	51947187	51952200	BolC4t26866H	0	+	1839	4945	5013	0.9864353
C4	51957034	51957467	BolC4t26867H	0	+	396	433	433	1.0000000
C4	51967764	51973383	BolC4t26868H	0	-	1187	4195	5619	0.7465741
C4	51985370	51986087	BolC4t26869H	0	+	0	0	717	0.0000000
C4	51989993	51991790	BolC4t26870H	0	-	555	1587	1797	0.8831385
C4	51993172	51993856	BolC4t26871H	0	-	95	656	684	0.9590643
C4	52001307	52003013	BolC4t26872H	0	-	513	1457	1706	0.8540446
C4	52021611	52022394	BolC4t26873H	0	-	84	675	783	0.8620690
C4	52032082	52058087	BolC4t26874H	0	-	1936	9539	26005	0.3668141
C4	52072728	52074913	BolC4t26875H	0	-	1294	1826	2185	0.8356979
C4	52079073	52079373	BolC4t26876H	0	+	2	106	300	0.3533333
C4	52130750	52130990	BolC4t26877H	0	-	8	149	240	0.6208333
C4	52139340	52140790	BolC4t26878H	0	+	2	149	1450	0.1027586
C4	52143749	52146802	BolC4t26879H	0	-	9	207	3053	0.0678022
C4	52153051	52154428	BolC4t26880H	0	+	1332	1377	1377	1.0000000
C4	52158748	52160126	BolC4t26881H	0	-	49	968	1378	0.7024673
C4	52161602	52161887	BolC4t26882H	0	+	1	1	285	0.0035088
C4	52173611	52173878	BolC4t26883H	0	-	9	113	267	0.4232210
C4	52174912	52175514	BolC4t26884H	0	-	21	301	602	0.5000000
C4	52176261	52176558	BolC4t26885H	0	-	328	297	297	1.0000000
C4	52179942	52180729	BolC4t26886H	0	+	13	132	787	0.1677255
C4	52186946	52187515	BolC4t26887H	0	-	6	148	569	0.2601055
C4	52199418	52200794	BolC4t26888H	0	-	81	734	1376	0.5334302
C4	52202409	52202900	BolC4t26889H	0	-	1812	491	491	1.0000000
C4	52203404	52203614	BolC4t26890H	0	+	168	210	210	1.0000000
C4	52230031	52230328	BolC4t26891H	0	-	5	249	297	0.8383839
C4	52256760	52257888	BolC4t26892H	0	-	101	551	1128	0.4884752
C4	52261074	52261383	BolC4t26893H	0	-	1	70	309	0.2265372
C4	52262738	52264454	BolC4t26894H	0	+	1593	1715	1716	0.9994172
C4	52265282	52268124	BolC4t26895H	0	+	959	2677	2842	0.9419423
C4	52268475	52269968	BolC4t26896H	0	+	862	1180	1493	0.7903550
C4	52270504	52270990	BolC4t26897H	0	-	1	31	486	0.0637860
C4	52271236	52271980	BolC4t26898H	0	-	0	0	744	0.0000000
C4	52274546	52276743	BolC4t26899H	0	-	301	876	2197	0.3987255
C4	52277548	52279424	BolC4t26900H	0	+	58	1102	1876	0.5874200
C4	52279868	52280230	BolC4t26901H	0	+	0	0	362	0.0000000
C4	52307659	52308248	BolC4t26902H	0	+	124	535	589	0.9083192
C4	52308625	52310604	BolC4t26903H	0	+	381	1553	1979	0.7847398
C4	52312869	52313784	BolC4t26904H	0	+	2	188	915	0.2054645
C4	52317306	52319627	BolC4t26905H	0	+	1143	2310	2321	0.9952607
C4	52320767	52322126	BolC4t26906H	0	-	356	1095	1359	0.8057395
C4	52323869	52326610	BolC4t26907H	0	-	1143	2623	2741	0.9569500
C4	52329515	52330631	BolC4t26908H	0	-	523	1116	1116	1.0000000
C4	52330655	52334222	BolC4t26909H	0	-	1782	3567	3567	1.0000000
C4	52353890	52356970	BolC4t26910H	0	-	491	2445	3080	0.7938312
C4	52360602	52361480	BolC4t26911H	0	-	155	742	878	0.8451025
C4	52365047	52366777	BolC4t26912H	0	-	632	1509	1730	0.8722543
C4	52369716	52370195	BolC4t26913H	0	-	53	449	479	0.9373695
C4	52373224	52373795	BolC4t26914H	0	+	158	552	571	0.9667251
C4	52374790	52375057	BolC4t26915H	0	-	553	267	267	1.0000000
C4	52389460	52390581	BolC4t26916H	0	-	1347	1121	1121	1.0000000
C4	52390819	52404472	BolC4t26917H	0	+	1218	9716	13653	0.7116385
C4	52405239	52408497	BolC4t26918H	0	-	852	2805	3258	0.8609576
C4	52411995	52412619	BolC4t26919H	0	-	33	517	624	0.8285257
C4	52424246	52425400	BolC4t26920H	0	-	389	1154	1154	1.0000000
C4	52428519	52430023	BolC4t26921H	0	+	886	1504	1504	1.0000000
C4	52433480	52435577	BolC4t26922H	0	-	1290	2097	2097	1.0000000
C4	52445315	52446448	BolC4t26923H	0	+	663	1133	1133	1.0000000
C4	52447737	52448196	BolC4t26924H	0	-	239	422	459	0.9193900
C4	52449143	52454013	BolC4t26925H	0	-	2307	4612	4870	0.9470226
C4	52464873	52467231	BolC4t26926H	0	-	1578	2358	2358	1.0000000
C4	52468024	52468336	BolC4t26927H	0	-	191	312	312	1.0000000
C4	52472094	52472631	BolC4t26928H	0	+	793	537	537	1.0000000
C4	52475199	52477755	BolC4t26929H	0	-	345	1975	2556	0.7726917
C4	52486377	52488214	BolC4t26930H	0	+	131	813	1837	0.4425694
C4	52496045	52497188	BolC4t26931H	0	-	462	1093	1143	0.9562555
C4	52505976	52507098	BolC4t26932H	0	-	227	1022	1122	0.9108734
C4	52512260	52513448	BolC4t26933H	0	-	210	910	1188	0.7659932
C4	52516328	52519464	BolC4t26934H	0	-	475	2201	3136	0.7018495
C4	52541127	52541322	BolC4t26935H	0	-	239	195	195	1.0000000
C4	52544206	52546434	BolC4t26936H	0	-	122	1307	2228	0.5866248
C4	52568460	52570725	BolC4t26937H	0	+	1327	2127	2265	0.9390728
C4	52579670	52580657	BolC4t26938H	0	-	940	987	987	1.0000000
C4	52588087	52590607	BolC4t26939H	0	+	633	2373	2520	0.9416667
C4	52591654	52592362	BolC4t26940H	0	+	275	706	708	0.9971752
C4	52592558	52593755	BolC4t26941H	0	-	143	1037	1197	0.8663325
C4	52595850	52597968	BolC4t26942H	0	-	1200	2068	2118	0.9763928
C4	52605519	52606644	BolC4t26943H	0	-	97	688	1125	0.6115556
C4	52617478	52618600	BolC4t26944H	0	-	559	1033	1122	0.9206774
C4	52637955	52640044	BolC4t26945H	0	-	1131	1776	2089	0.8501676
C4	52649295	52650450	BolC4t26946H	0	+	425	1155	1155	1.0000000
C4	52651084	52654731	BolC4t26947H	0	-	435	1951	3647	0.5349603
C4	52663620	52663878	BolC4t26948H	0	+	30	243	258	0.9418604
C4	52676184	52676707	BolC4t26949H	0	-	269	490	523	0.9369025
C4	52677736	52677874	BolC4t26950H	0	-	0	0	138	0.0000000
C4	52678658	52679453	BolC4t26951H	0	+	749	795	795	1.0000000
C4	52680162	52680727	BolC4t26952H	0	+	299	565	565	1.0000000
C4	52682719	52683247	BolC4t26953H	0	-	9	199	528	0.3768939
C4	52696114	52699005	BolC4t26954H	0	+	1624	2891	2891	1.0000000
C4	52701107	52703877	BolC4t26955H	0	-	48	858	2770	0.3097473
C4	52716939	52718426	BolC4t26956H	0	+	1079	1451	1487	0.9757902
C4	52718916	52719771	BolC4t26957H	0	-	86	656	855	0.7672515
C4	52721466	52721919	BolC4t26958H	0	+	273	453	453	1.0000000
C4	52722975	52724057	BolC4t26959H	0	-	19	803	1082	0.7421442
C4	52724469	52726173	BolC4t26960H	0	-	72	862	1704	0.5058686
C4	52728688	52729603	BolC4t26961H	0	-	222	778	915	0.8502733
C4	52732561	52734122	BolC4t26962H	0	+	1660	1561	1561	1.0000000
C4	52737899	52739497	BolC4t26963H	0	+	493	1598	1598	1.0000000
C4	52741048	52742622	BolC4t26964H	0	+	1087	1574	1574	1.0000000
C4	52743265	52743790	BolC4t26965H	0	-	179	525	525	1.0000000
C4	52744584	52744919	BolC4t26966H	0	-	126	299	335	0.8925373
C4	52761115	52762082	BolC4t26967H	0	-	394	967	967	1.0000000
C4	52767268	52768776	BolC4t26968H	0	-	531	1496	1508	0.9920424
C4	52786282	52787000	BolC4t26969H	0	-	44	385	718	0.5362117
C4	52787563	52788805	BolC4t26970H	0	-	63	956	1242	0.7697263
C4	52800045	52801019	BolC4t26971H	0	+	693	974	974	1.0000000
C4	52803566	52806832	BolC4t26972H	0	+	129	1730	3266	0.5296999
C4	52808579	52812035	BolC4t26973H	0	-	1162	3375	3456	0.9765625
C4	52813933	52814808	BolC4t26974H	0	-	306	819	875	0.9360000
C4	52826437	52827907	BolC4t26975H	0	-	706	1466	1470	0.9972789
C4	52833207	52876467	BolC4t26976H	0	-	12774	31756	43260	0.7340730
C4	52861707	52864375	BolC4t26977H	0	-	543	2282	2668	0.8553224
C4	52879482	52879708	BolC4t26978H	0	-	112	226	226	1.0000000
C4	52881095	52882806	BolC4t26979H	0	-	165	1325	1711	0.7744009
C4	52909606	52912972	BolC4t26980H	0	-	894	2611	3366	0.7756982
C4	52913999	52929516	BolC4t26981H	0	-	2129	9452	15517	0.6091384
C4	52933912	52936619	BolC4t26982H	0	+	1329	2701	2707	0.9977835
C4	52957602	52962522	BolC4t26983H	0	-	46	469	4920	0.0953252
C4	52985486	52989372	BolC4t26984H	0	-	598	2636	3886	0.6783324
C4	52990031	52991008	BolC4t26985H	0	+	23	555	977	0.5680655
C4	52992955	52993665	BolC4t26986H	0	-	336	710	710	1.0000000
C4	52995074	52996559	BolC4t26987H	0	+	1435	1485	1485	1.0000000
C4	53010157	53011355	BolC4t26988H	0	+	495	1194	1198	0.9966611
C4	53013636	53013870	BolC4t26989H	0	+	130	234	234	1.0000000
C4	53013948	53014584	BolC4t26990H	0	+	66	562	636	0.8836478
C4	53016525	53016687	BolC4t26991H	0	+	10	111	162	0.6851852
C4	53032472	53033525	BolC4t26992H	0	+	290	968	1053	0.9192783
C4	53047845	53055894	BolC4t26993H	0	+	1341	6655	8049	0.8268108
C4	53070670	53070805	BolC4t26994H	0	-	68	135	135	1.0000000
C4	53072624	53073803	BolC4t26995H	0	+	15	205	1179	0.1738762
C4	53077693	53082750	BolC4t26996H	0	+	2631	4154	5057	0.8214356
C4	53085012	53086827	BolC4t26997H	0	+	853	1787	1815	0.9845730
C4	53090567	53091590	BolC4t26998H	0	+	465	1023	1023	1.0000000
C4	53093083	53093341	BolC4t26999H	0	-	8	152	258	0.5891473
C4	53094325	53094838	BolC4t27000H	0	-	131	495	513	0.9649123
C4	53096157	53099229	BolC4t27001H	0	-	1069	2733	3072	0.8896484
C4	53100916	53101030	BolC4t27002H	0	+	138	114	114	1.0000000
C4	53101450	53106945	BolC4t27003H	0	-	1861	4617	5495	0.8402184
C4	53101974	53105509	BolC4t27004H	0	+	1419	3275	3535	0.9264498
C4	53109647	53114875	BolC4t27005H	0	+	1228	4538	5228	0.8680184
C4	53115706	53116351	BolC4t27006H	0	-	278	645	645	1.0000000
C4	53124220	53125224	BolC4t27007H	0	+	66	431	1004	0.4292829
C4	53125809	53125923	BolC4t27008H	0	+	46	114	114	1.0000000
C4	53126121	53126415	BolC4t27009H	0	-	1	96	294	0.3265306
C4	53129389	53130395	BolC4t27010H	0	+	231	1006	1006	1.0000000
C4	53131228	53131873	BolC4t27011H	0	-	86	645	645	1.0000000
C4	53134571	53143592	BolC4t27012H	0	+	1128	5664	9021	0.6278683
C4	53144414	53145059	BolC4t27013H	0	-	297	645	645	1.0000000
C4	53147701	53149032	BolC4t27014H	0	+	163	963	1331	0.7235162
C4	53176710	53176902	BolC4t27015H	0	+	295	192	192	1.0000000
C4	53187478	53187757	BolC4t27016H	0	-	336	273	279	0.9784946
C4	53199716	53203558	BolC4t27017H	0	-	1592	2821	3842	0.7342530
C4	53204754	53205273	BolC4t27018H	0	+	51	272	519	0.5240848
C4	53206005	53206779	BolC4t27019H	0	-	316	759	774	0.9806201
C4	53212982	53213285	BolC4t27020H	0	+	109	303	303	1.0000000
C4	53215042	53218133	BolC4t27021H	0	+	1625	3028	3091	0.9796183
C4	53224020	53224857	BolC4t27022H	0	-	2734	837	837	1.0000000
C4	53228077	53228377	BolC4t27023H	0	-	31	237	300	0.7900000
C4	53249524	53250814	BolC4t27024H	0	-	7113	1290	1290	1.0000000
C4	53253367	53253658	BolC4t27025H	0	-	5	230	291	0.7903780
C4	53254866	53255538	BolC4t27026H	0	-	1056	672	672	1.0000000
C4	53258614	53259070	BolC4t27027H	0	-	393	452	456	0.9912280
C4	53261362	53261821	BolC4t27028H	0	-	1294	459	459	1.0000000
C4	53270050	53270557	BolC4t27029H	0	-	260	507	507	1.0000000
C4	53276804	53279501	BolC4t27030H	0	+	396	2459	2697	0.9117538
C4	53283747	53284266	BolC4t27031H	0	+	515	519	519	1.0000000
C4	53294302	53295454	BolC4t27032H	0	+	711	1152	1152	1.0000000
C4	53295749	53296100	BolC4t27033H	0	+	307	351	351	1.0000000
C4	53296859	53298218	BolC4t27034H	0	-	1006	1359	1359	1.0000000
C4	53299649	53300357	BolC4t27035H	0	-	36	457	708	0.6454802
C4	53305946	53307229	BolC4t27036H	0	+	344	718	1283	0.5596259
C4	53310248	53310701	BolC4t27037H	0	+	0	0	453	0.0000000
C4	53311466	53312017	BolC4t27038H	0	+	352	551	551	1.0000000
C4	53314946	53315339	BolC4t27039H	0	+	152	393	393	1.0000000
C4	53316593	53319038	BolC4t27040H	0	-	1588	2445	2445	1.0000000
C4	53324029	53326000	BolC4t27041H	0	+	749	1942	1971	0.9852867
C4	53328322	53331708	BolC4t27042H	0	+	2451	2821	3386	0.8331364
C4	53333459	53335033	BolC4t27043H	0	-	384	1446	1574	0.9186785
C4	53337994	53340720	BolC4t27044H	0	-	1695	2228	2726	0.8173147
C4	53346528	53346979	BolC4t27045H	0	-	106	403	451	0.8935698
C4	53356358	53357892	BolC4t27046H	0	-	426	1473	1534	0.9602347
C4	53362856	53363387	BolC4t27047H	0	-	248	531	531	1.0000000
C4	53366713	53367689	BolC4t27048H	0	-	898	976	976	1.0000000
C4	53374419	53376927	BolC4t27049H	0	-	327	1944	2508	0.7751196
C4	53386728	53388342	BolC4t27050H	0	+	891	1614	1614	1.0000000
C4	53391994	53392201	BolC4t27051H	0	-	52	201	207	0.9710145
C4	53403509	53409088	BolC4t27052H	0	+	957	4467	5579	0.8006811
C4	53412668	53414072	BolC4t27053H	0	+	594	1289	1404	0.9180912
C4	53419444	53422021	BolC4t27054H	0	-	530	1918	2577	0.7442763
C4	53423720	53424718	BolC4t27055H	0	-	6	296	998	0.2965932
C4	53436091	53437280	BolC4t27056H	0	+	256	1069	1189	0.8990749
C4	53442222	53442660	BolC4t27057H	0	+	305	438	438	1.0000000
C4	53443935	53446725	BolC4t27058H	0	-	788	2585	2790	0.9265233
C4	53447471	53447931	BolC4t27059H	0	-	50	460	460	1.0000000
C4	53451117	53453056	BolC4t27060H	0	+	1398	1939	1939	1.0000000
C4	53454906	53455454	BolC4t27061H	0	+	0	0	548	0.0000000
C4	53459204	53462413	BolC4t27062H	0	-	1651	3114	3209	0.9703957
C4	53478804	53480425	BolC4t27063H	0	-	1159	1621	1621	1.0000000
C4	53488711	53489392	BolC4t27064H	0	+	30	553	681	0.8120411
C4	53493281	53494338	BolC4t27065H	0	-	407	996	1057	0.9422895
C4	53495210	53495707	BolC4t27066H	0	-	301	497	497	1.0000000
C4	53499724	53499973	BolC4t27067H	0	-	119	249	249	1.0000000
C4	53502834	53508765	BolC4t27068H	0	-	1178	5163	5931	0.8705109
C4	53529888	53530188	BolC4t27069H	0	-	69	118	300	0.3933333
C4	53539372	53541313	BolC4t27070H	0	+	686	1847	1941	0.9515713
C4	53553793	53558210	BolC4t27071H	0	+	1844	4296	4417	0.9726058
C4	53561645	53563499	BolC4t27072H	0	-	623	1731	1854	0.9336569
C4	53573612	53573895	BolC4t27073H	0	-	264	283	283	1.0000000
C4	53585030	53588104	BolC4t27074H	0	-	904	2842	3074	0.9245283
C4	53590099	53592010	BolC4t27075H	0	+	792	1851	1911	0.9686028
C4	53595252	53595849	BolC4t27076H	0	-	87	275	597	0.4606365
C4	53632559	53634049	BolC4t27077H	0	+	836	1490	1490	1.0000000
C4	53635216	53636299	BolC4t27078H	0	+	51	694	1083	0.6408126
C4	53642932	53643973	BolC4t27079H	0	+	117	1003	1041	0.9634966
C4	53644750	53645904	BolC4t27080H	0	+	540	1154	1154	1.0000000
C4	53647010	53647567	BolC4t27081H	0	-	112	301	557	0.5403950
C4	53648876	53652080	BolC4t27082H	0	+	2123	3200	3204	0.9987516
C4	53652586	53655202	BolC4t27083H	0	+	795	2502	2616	0.9564220
C4	53655677	53665087	BolC4t27084H	0	-	3109	7489	9410	0.7958555
C4	53713573	53713841	BolC4t27085H	0	-	64	268	268	1.0000000
C4	53715637	53715905	BolC4t27086H	0	-	83	268	268	1.0000000
C4	53721854	53722122	BolC4t27087H	0	-	474	268	268	1.0000000
C4	53723930	53724198	BolC4t27088H	0	-	1341	268	268	1.0000000
C4	53726004	53726273	BolC4t27089H	0	-	117	269	269	1.0000000
C4	53728081	53728350	BolC4t27090H	0	-	12	219	269	0.8141264
C4	53730155	53730424	BolC4t27091H	0	-	31	265	269	0.9851301
C4	53734178	53735122	BolC4t27092H	0	-	143	864	944	0.9152542
C4	53740289	53742910	BolC4t27093H	0	+	338	2256	2621	0.8607402
C4	53743446	53746898	BolC4t27094H	0	-	453	2851	3452	0.8258981
C4	53750048	53751308	BolC4t27095H	0	+	473	1165	1260	0.9246032
C4	53751487	53753317	BolC4t27096H	0	-	546	1708	1830	0.9333333
C4	53769047	53769659	BolC4t27097H	0	+	110	554	612	0.9052287
C4	53776389	53778277	BolC4t27098H	0	-	614	1844	1888	0.9766949
C4	53779279	53782984	BolC4t27099H	0	-	1004	3453	3705	0.9319838
C4	53784823	53787549	BolC4t27100H	0	+	1778	2699	2726	0.9900954
C4	53788262	53791172	BolC4t27101H	0	-	229	1850	2910	0.6357388
C4	53792883	53796150	BolC4t27102H	0	+	394	2309	3267	0.7067646
C4	53799272	53799755	BolC4t27103H	0	+	116	476	483	0.9855072
C4	53802342	53804903	BolC4t27104H	0	+	441	1644	2561	0.6419367
C4	53806049	53807333	BolC4t27105H	0	+	25	617	1284	0.4805296
C4	53809155	53810092	BolC4t27106H	0	+	14	387	937	0.4130203
C4	53819377	53819615	BolC4t27107H	0	+	15	221	238	0.9285714
C4	53836428	53836752	BolC4t27108H	0	-	319	324	324	1.0000000
C4	53845694	53846044	BolC4t27109H	0	-	337	350	350	1.0000000
C4	53846756	53847143	BolC4t27110H	0	+	1	18	387	0.0465116
C4	53847209	53847920	BolC4t27111H	0	+	0	0	711	0.0000000
C4	53869434	53869936	BolC4t27112H	0	-	0	0	502	0.0000000
C4	53874068	53876437	BolC4t27113H	0	-	217	1660	2369	0.7007176
C4	53877116	53877761	BolC4t27114H	0	-	0	0	645	0.0000000
C4	53878301	53879774	BolC4t27115H	0	-	3	381	1473	0.2586558
C4	53885538	53888232	BolC4t27116H	0	+	1980	2691	2694	0.9988864
C4	53888992	53889472	BolC4t27117H	0	-	9	213	480	0.4437500
C4	53890989	53893713	BolC4t27118H	0	-	64	1106	2724	0.4060206
C4	53908815	53910555	BolC4t27119H	0	+	1560	1740	1740	1.0000000
C4	53915851	53918781	BolC4t27120H	0	+	393	1254	2930	0.4279864
C4	53918923	53919212	BolC4t27121H	0	+	183	289	289	1.0000000
C4	53920458	53921322	BolC4t27122H	0	-	130	623	864	0.7210648
C4	53922305	53925886	BolC4t27123H	0	-	1000	2948	3581	0.8232337
C4	53931874	53933799	BolC4t27124H	0	-	821	1686	1925	0.8758442
C4	53935260	53936219	BolC4t27125H	0	+	359	959	959	1.0000000
C4	53941094	53941928	BolC4t27126H	0	+	462	834	834	1.0000000
C4	53947580	53949001	BolC4t27127H	0	+	236	1019	1421	0.7171006
C4	53955782	53958648	BolC4t27128H	0	-	1092	2866	2866	1.0000000
C4	53959582	53961159	BolC4t27129H	0	-	311	1550	1577	0.9828789
C4	53965606	53967685	BolC4t27130H	0	-	840	2008	2079	0.9658490
C4	53971166	53974127	BolC4t27131H	0	+	1064	2795	2961	0.9439378
C4	53975695	53977156	BolC4t27132H	0	-	1300	1461	1461	1.0000000
C4	53978548	53980889	BolC4t27133H	0	-	951	2291	2341	0.9786416
C4	53996836	53999561	BolC4t27134H	0	+	1788	2719	2725	0.9977981
C4	53999910	54001585	BolC4t27135H	0	-	1020	1675	1675	1.0000000
C4	54004402	54007823	BolC4t27136H	0	-	823	2360	3421	0.6898568
C4	54014937	54016767	BolC4t27137H	0	+	1477	1809	1830	0.9885246
C4	54017525	54018902	BolC4t27138H	0	-	851	1368	1377	0.9934641
C4	54034447	54034612	BolC4t27139H	0	-	161	165	165	1.0000000
C4	54036478	54038860	BolC4t27140H	0	+	315	1796	2382	0.7539883
C4	54050081	54052144	BolC4t27141H	0	+	408	1662	2063	0.8056229
C4	54052616	54054905	BolC4t27142H	0	-	1006	2289	2289	1.0000000
C4	54061110	54091792	BolC4t27143H	0	-	635	7253	30682	0.2363927
C4	54069439	54069898	BolC4t27144H	0	-	0	0	459	0.0000000
C4	54082910	54084063	BolC4t27145H	0	-	0	0	1153	0.0000000
C4	54103999	54113935	BolC4t27146H	0	-	1911	6421	9936	0.6462359
C4	54128239	54129613	BolC4t27147H	0	+	33	923	1374	0.6717613
C4	54139322	54142933	BolC4t27148H	0	+	925	3252	3611	0.9005815
C4	54149302	54151677	BolC4t27149H	0	+	611	1919	2375	0.8080000
C4	54153962	54154127	BolC4t27150H	0	-	199	165	165	1.0000000
C4	54164002	54165226	BolC4t27151H	0	-	66	406	1224	0.3316993
C4	54175508	54178235	BolC4t27152H	0	-	798	1832	2727	0.6718005
C4	54183050	54189419	BolC4t27153H	0	+	1558	5442	6369	0.8544512
C4	54190087	54192388	BolC4t27154H	0	-	610	2207	2301	0.9591482
C4	54193851	54195573	BolC4t27155H	0	-	813	1722	1722	1.0000000
C4	54223080	54224620	BolC4t27156H	0	+	730	1540	1540	1.0000000
C4	54225519	54230149	BolC4t27157H	0	-	1969	4060	4630	0.8768898
C4	54234154	54234361	BolC4t27158H	0	-	245	207	207	1.0000000
C4	54234648	54237189	BolC4t27159H	0	-	1716	2541	2541	1.0000000
C4	54240663	54243040	BolC4t27160H	0	+	123	1359	2377	0.5717291
C4	54257592	54257715	BolC4t27161H	0	+	1	8	123	0.0650406
C4	54268136	54270266	BolC4t27162H	0	+	355	2130	2130	1.0000000
C4	54276032	54276356	BolC4t27163H	0	+	320	324	324	1.0000000
C4	54278094	54280063	BolC4t27164H	0	+	554	1959	1969	0.9949213
C4	54296152	54296935	BolC4t27165H	0	+	315	783	783	1.0000000
C4	54298061	54301480	BolC4t27166H	0	-	1281	3216	3419	0.9406259
C4	54303068	54303877	BolC4t27167H	0	-	534	809	809	1.0000000
C4	54304496	54322483	BolC4t27168H	0	-	6833	12809	17987	0.7121254
C4	54313553	54313966	BolC4t27169H	0	+	238	413	413	1.0000000
C4	54314292	54315301	BolC4t27170H	0	+	268	967	1009	0.9583746
C4	54321190	54321427	BolC4t27171H	0	-	220	237	237	1.0000000
C4	54326449	54331767	BolC4t27172H	0	+	3062	5223	5318	0.9821361
C4	54348053	54353982	BolC4t27173H	0	+	3395	5690	5929	0.9596897
C4	54355138	54362494	BolC4t27174H	0	-	2856	6430	7356	0.8741164
C4	54364506	54364938	BolC4t27175H	0	+	142	372	432	0.8611111
C4	54365675	54367127	BolC4t27176H	0	+	25	633	1452	0.4359504
C4	54393306	54393797	BolC4t27177H	0	-	0	0	491	0.0000000
C4	54396393	54398950	BolC4t27178H	0	+	904	2459	2557	0.9616739
C4	54403040	54408930	BolC4t27179H	0	+	3148	5806	5890	0.9857385
C4	54413132	54413816	BolC4t27180H	0	+	32	573	684	0.8377193
C4	54415157	54416842	BolC4t27181H	0	+	1250	1685	1685	1.0000000
C4	54417504	54419327	BolC4t27182H	0	+	2527	1808	1823	0.9917718
C4	54437451	54439239	BolC4t27183H	0	-	330	1483	1788	0.8294184
C4	54466765	54467867	BolC4t27184H	0	-	608	1029	1102	0.9337568
C4	54503027	54503132	BolC4t27185H	0	+	36	105	105	1.0000000
C4	54503312	54506294	BolC4t27186H	0	+	551	2300	2982	0.7712944
C4	54531988	54535272	BolC4t27187H	0	+	78	1113	3284	0.3389159
C4	54540981	54541512	BolC4t27188H	0	-	67	367	531	0.6911488
C4	54561414	54562131	BolC4t27189H	0	+	258	717	717	1.0000000
C4	54562916	54563643	BolC4t27190H	0	+	287	699	727	0.9614856
C4	54564524	54565692	BolC4t27191H	0	-	747	1168	1168	1.0000000
C4	54569882	54570486	BolC4t27192H	0	-	38	125	604	0.2069536
C4	54577357	54579223	BolC4t27193H	0	+	827	1751	1866	0.9383708
C4	54580701	54581444	BolC4t27194H	0	-	184	553	743	0.7442799
C4	54582304	54582640	BolC4t27195H	0	+	0	0	336	0.0000000
C4	54589847	54591613	BolC4t27196H	0	-	3	167	1766	0.0945640
C4	54600294	54601487	BolC4t27197H	0	+	256	405	1193	0.3394803
C4	54607875	54608960	BolC4t27198H	0	+	61	219	1085	0.2018433
C4	54630946	54632044	BolC4t27199H	0	+	171	936	1098	0.8524590
C4	54633496	54634225	BolC4t27200H	0	-	184	729	729	1.0000000
C4	54636185	54637211	BolC4t27201H	0	-	650	1026	1026	1.0000000
C4	54639043	54641143	BolC4t27202H	0	+	1768	2100	2100	1.0000000
C4	54650194	54652398	BolC4t27203H	0	-	1963	2204	2204	1.0000000
C4	54654249	54655465	BolC4t27204H	0	-	236	870	1216	0.7154605
C4	54674940	54677304	BolC4t27205H	0	+	849	2355	2364	0.9961929
C4	54683506	54684974	BolC4t27206H	0	+	450	1052	1468	0.7166213
C4	54685370	54687052	BolC4t27207H	0	-	1441	1682	1682	1.0000000
C4	54687799	54691829	BolC4t27208H	0	+	1974	3767	4030	0.9347395
C4	54692452	54692923	BolC4t27209H	0	-	467	471	471	1.0000000
C4	54696996	54697341	BolC4t27210H	0	+	546	345	345	1.0000000
C4	54699777	54701544	BolC4t27211H	0	-	619	1574	1767	0.8907753
C4	54743641	54744928	BolC4t27212H	0	-	2224	1287	1287	1.0000000
C4	54745795	54746212	BolC4t27213H	0	-	70	342	417	0.8201439
C4	54760596	54761362	BolC4t27214H	0	+	42	417	766	0.5443864
C4	54768907	54769348	BolC4t27215H	0	-	45	441	441	1.0000000
C4	54779975	54780235	BolC4t27216H	0	-	18	260	260	1.0000000
C4	54795410	54795567	BolC4t27217H	0	-	91	157	157	1.0000000
C4	54797922	54799715	BolC4t27218H	0	+	664	1636	1793	0.9124373
C4	54800518	54801988	BolC4t27219H	0	-	615	1470	1470	1.0000000
C4	54802602	54805492	BolC4t27220H	0	-	1224	2876	2890	0.9951557
C4	54806364	54806773	BolC4t27221H	0	-	12	19	409	0.0464548
C4	54808077	54809957	BolC4t27222H	0	-	329	1314	1880	0.6989362
C4	54812514	54814456	BolC4t27223H	0	+	101	1392	1942	0.7167868
C4	54818103	54818745	BolC4t27224H	0	+	371	642	642	1.0000000
C4	54819364	54820438	BolC4t27225H	0	-	863	1074	1074	1.0000000
C4	54832827	54834082	BolC4t27226H	0	+	37	335	1255	0.2669323
C4	54844618	54862080	BolC4t27227H	0	+	3563	13580	17462	0.7776887
C4	54846042	54850796	BolC4t27228H	0	+	755	3875	4754	0.8151031
C4	54877689	54878661	BolC4t27229H	0	-	84	729	972	0.7500000
C4	54887454	54887863	BolC4t27230H	0	-	539	409	409	1.0000000
C4	54888286	54888727	BolC4t27231H	0	-	559	441	441	1.0000000
C4	54888978	54889408	BolC4t27232H	0	-	625	430	430	1.0000000
C4	54891162	54894497	BolC4t27233H	0	+	1277	3263	3335	0.9784108
C4	54897575	54898856	BolC4t27234H	0	+	65	831	1281	0.6487119
C4	54903170	54904401	BolC4t27235H	0	+	308	1065	1231	0.8651503
C4	54914389	54916449	BolC4t27236H	0	-	411	1769	2060	0.8587379
C4	54919670	54926917	BolC4t27237H	0	+	3658	6068	7247	0.8373120
C4	54927562	54931418	BolC4t27238H	0	-	1576	3510	3856	0.9102697
C4	54936220	54936697	BolC4t27239H	0	+	95	477	477	1.0000000
C4	54937592	54938356	BolC4t27240H	0	+	415	689	764	0.9018325
C4	54952814	54953848	BolC4t27241H	0	+	1206	1034	1034	1.0000000
C4	54956404	54957021	BolC4t27242H	0	-	471	617	617	1.0000000
C4	54957896	54963651	BolC4t27243H	0	-	2757	5300	5755	0.9209383
C4	54974831	54982695	BolC4t27244H	0	-	1239	5829	7864	0.7412258
C4	55012670	55015036	BolC4t27245H	0	+	779	2366	2366	1.0000000
C4	55016368	55016668	BolC4t27246H	0	+	2	16	300	0.0533333
C4	55018089	55022513	BolC4t27247H	0	+	1302	4224	4424	0.9547920
C4	55028101	55030387	BolC4t27248H	0	-	146	1277	2286	0.5586177
C4	55032635	55032899	BolC4t27249H	0	-	46	260	264	0.9848485
C4	55039386	55040730	BolC4t27250H	0	-	224	1338	1344	0.9955357
C4	55055096	55056694	BolC4t27251H	0	+	133	1138	1598	0.7121402
C4	55058398	55061083	BolC4t27252H	0	-	592	2394	2685	0.8916201
C4	55070998	55072759	BolC4t27253H	0	+	194	1338	1761	0.7597955
C4	55079282	55080746	BolC4t27254H	0	+	72	1086	1464	0.7418033
C4	55081860	55084680	BolC4t27255H	0	-	85	1167	2820	0.4138298
C4	55091613	55091919	BolC4t27256H	0	-	0	0	306	0.0000000
C4	55103129	55103507	BolC4t27257H	0	+	1	35	378	0.0925926
C4	55106595	55111527	BolC4t27258H	0	-	2706	3763	4932	0.7629765
C4	55114860	55116310	BolC4t27259H	0	+	1447	1450	1450	1.0000000
C4	55122858	55123722	BolC4t27260H	0	+	45	383	864	0.4432870
C4	55126977	55127580	BolC4t27261H	0	-	254	584	603	0.9684909
C4	55142528	55143262	BolC4t27262H	0	+	417	734	734	1.0000000
C4	55151466	55152774	BolC4t27263H	0	+	106	1146	1308	0.8761468
C4	55204584	55204812	BolC4t27264H	0	+	40	228	228	1.0000000
C4	55208728	55212230	BolC4t27265H	0	+	903	3230	3502	0.9223301
C4	55228511	55230865	BolC4t27266H	0	+	1397	1978	2354	0.8402719
C4	55232926	55234613	BolC4t27267H	0	+	154	1214	1687	0.7196206
C4	55247309	55251876	BolC4t27268H	0	+	2530	4249	4567	0.9303700
C4	55259008	55259164	BolC4t27269H	0	+	110	156	156	1.0000000
C4	55263451	55263562	BolC4t27270H	0	+	0	0	111	0.0000000
C4	55273413	55273686	BolC4t27271H	0	-	9	131	273	0.4798535
C4	55278414	55282195	BolC4t27272H	0	-	1058	3032	3781	0.8019043
C4	55289853	55291104	BolC4t27273H	0	+	358	756	1251	0.6043165
C4	55291650	55293155	BolC4t27274H	0	-	483	1345	1505	0.8936877
C4	55299245	55299703	BolC4t27275H	0	-	478	458	458	1.0000000
C4	55318707	55318875	BolC4t27276H	0	+	8	168	168	1.0000000
C4	55319429	55319660	BolC4t27277H	0	-	0	0	231	0.0000000
C4	55319662	55319974	BolC4t27278H	0	+	0	0	312	0.0000000
C4	55320626	55321124	BolC4t27279H	0	-	64	378	498	0.7590361
C4	55325675	55326322	BolC4t27280H	0	+	435	647	647	1.0000000
C4	55336227	55337679	BolC4t27281H	0	-	741	1452	1452	1.0000000
C4	55338615	55339680	BolC4t27282H	0	-	482	1065	1065	1.0000000
C4	55351294	55351642	BolC4t27283H	0	+	28	116	348	0.3333333
C4	55352424	55352625	BolC4t27284H	0	+	183	201	201	1.0000000
C4	55352918	55353367	BolC4t27285H	0	-	162	410	449	0.9131403
C4	55355556	55356111	BolC4t27286H	0	+	243	516	555	0.9297297
C4	55367839	55369150	BolC4t27287H	0	-	98	847	1311	0.6460717
C4	55384379	55385049	BolC4t27288H	0	+	897	670	670	1.0000000
C4	55412267	55414063	BolC4t27289H	0	-	331	1263	1796	0.7032294
C4	55449064	55449907	BolC4t27290H	0	-	67	677	843	0.8030842
C4	55466740	55466953	BolC4t27291H	0	-	0	0	213	0.0000000
C4	55493278	55493866	BolC4t27292H	0	-	916	588	588	1.0000000
C4	55494866	55500146	BolC4t27293H	0	+	3198	5047	5280	0.9558712
C4	55511669	55515702	BolC4t27294H	0	+	643	2497	4033	0.6191421
C4	55516371	55520331	BolC4t27295H	0	-	2178	3936	3960	0.9939394
C4	55524449	55524683	BolC4t27296H	0	+	0	0	234	0.0000000
C4	55526537	55527399	BolC4t27297H	0	+	111	663	862	0.7691416
C4	55529595	55529778	BolC4t27298H	0	-	1	10	183	0.0546448
C4	55549679	55550733	BolC4t27299H	0	+	550	1030	1054	0.9772296
C4	55554465	55559350	BolC4t27300H	0	-	766	3372	4885	0.6902764
C4	55572218	55573330	BolC4t27301H	0	+	29	756	1112	0.6798561
C4	55579338	55579723	BolC4t27302H	0	+	176	321	385	0.8337662
C4	55583719	55585083	BolC4t27303H	0	-	606	1364	1364	1.0000000
C4	55589435	55590866	BolC4t27304H	0	-	29	536	1431	0.3745632
C4	55614447	55616256	BolC4t27305H	0	-	240	593	1809	0.3278054
C4	55646399	55647898	BolC4t27306H	0	+	2	259	1499	0.1727819
C4	55655240	55655735	BolC4t27307H	0	-	0	0	495	0.0000000
C4	55658527	55659127	BolC4t27308H	0	-	0	0	600	0.0000000
C4	55724766	55726290	BolC4t27309H	0	+	107	840	1524	0.5511811
C4	55732903	55734109	BolC4t27310H	0	-	101	782	1206	0.6484246
C4	55736673	55737953	BolC4t27311H	0	-	96	1147	1280	0.8960937
C4	55761356	55762585	BolC4t27312H	0	-	22	347	1229	0.2823434
C4	55791484	55791754	BolC4t27313H	0	-	9	163	270	0.6037037
C4	55798325	55798772	BolC4t27314H	0	+	95	355	447	0.7941834
C4	55803188	55803653	BolC4t27315H	0	+	146	464	465	0.9978495
C4	55807007	55807286	BolC4t27316H	0	-	260	279	279	1.0000000
C4	55807702	55809734	BolC4t27317H	0	-	1327	2032	2032	1.0000000
C4	55810757	55811017	BolC4t27318H	0	-	168	241	260	0.9269231
C4	55828986	55829325	BolC4t27319H	0	+	425	339	339	1.0000000
C4	55830473	55830785	BolC4t27320H	0	-	304	312	312	1.0000000
C4	55832010	55833788	BolC4t27321H	0	-	162	1511	1778	0.8498313
C4	55836206	55839492	BolC4t27322H	0	-	384	2038	3286	0.6202070
C4	55853072	55853237	BolC4t27323H	0	+	1788	165	165	1.0000000
C4	55878829	55879663	BolC4t27324H	0	-	124	356	834	0.4268585
C4	55883165	55885761	BolC4t27325H	0	-	973	2596	2596	1.0000000
C4	55887330	55888301	BolC4t27326H	0	+	32	115	971	0.1184346
C4	55891364	55894737	BolC4t27327H	0	+	440	1878	3373	0.5567744
C4	55921995	55923454	BolC4t27328H	0	+	16	358	1459	0.2453735
C4	55927756	55928880	BolC4t27329H	0	+	66	299	1124	0.2660142
C4	55929282	55931870	BolC4t27330H	0	-	503	2229	2588	0.8612828
C4	55949030	55951126	BolC4t27331H	0	+	516	1954	2096	0.9322519
C4	55966546	55966951	BolC4t27332H	0	-	546	405	405	1.0000000
C4	55976836	55980869	BolC4t27333H	0	-	2840	3586	4033	0.8891644
C4	55987232	55987565	BolC4t27334H	0	+	224	333	333	1.0000000
C4	55992073	55993486	BolC4t27335H	0	+	628	1413	1413	1.0000000
C4	55994815	55995778	BolC4t27336H	0	-	359	963	963	1.0000000
C4	55996905	55997334	BolC4t27337H	0	+	39	124	429	0.2890443
C4	56008922	56010900	BolC4t27338H	0	+	645	1942	1978	0.9817998
C4	56015440	56015659	BolC4t27339H	0	-	248	219	219	1.0000000
C4	56018081	56019987	BolC4t27340H	0	-	1173	1906	1906	1.0000000
C4	56031859	56039136	BolC4t27341H	0	+	2465	6073	7277	0.8345472
C4	56040061	56045046	BolC4t27342H	0	+	2194	4249	4985	0.8523571
C4	56052412	56053362	BolC4t27343H	0	+	702	950	950	1.0000000
C4	56054170	56057034	BolC4t27344H	0	-	1318	2760	2864	0.9636871
C4	56068832	56071010	BolC4t27345H	0	+	690	2001	2178	0.9187328
C4	56077311	56078864	BolC4t27346H	0	+	877	1535	1553	0.9884095
C4	56079650	56083020	BolC4t27347H	0	-	2078	3364	3370	0.9982196
C4	56092701	56096468	BolC4t27348H	0	-	848	3703	3767	0.9830104
C4	56103357	56104009	BolC4t27349H	0	-	51	615	652	0.9432516
C4	56141045	56179853	BolC4t27350H	0	-	28987	31580	38808	0.8137497
C4	56153920	56154319	BolC4t27351H	0	-	210	399	399	1.0000000
C4	56161271	56162293	BolC4t27352H	0	-	1185	1022	1022	1.0000000
C4	56187571	56194697	BolC4t27353H	0	-	4898	6209	7126	0.8713163
C4	56218213	56218486	BolC4t27354H	0	-	28	273	273	1.0000000
C4	56220451	56220835	BolC4t27355H	0	+	200	384	384	1.0000000
C4	56227088	56229608	BolC4t27356H	0	-	1328	2424	2520	0.9619048
C4	56231567	56234964	BolC4t27357H	0	-	452	2800	3397	0.8242567
C4	56236784	56239135	BolC4t27358H	0	+	835	2209	2351	0.9396002
C4	56239729	56240888	BolC4t27359H	0	+	172	1053	1159	0.9085419
C4	56253129	56255772	BolC4t27360H	0	+	1803	2643	2643	1.0000000
C4	56278153	56279629	BolC4t27361H	0	-	46	939	1476	0.6361789
C4	56292262	56294888	BolC4t27362H	0	+	356	2206	2626	0.8400609
C4	56297573	56297876	BolC4t27363H	0	+	0	0	303	0.0000000
C4	56300610	56303749	BolC4t27364H	0	-	3	77	3139	0.0245301
C4	56313006	56313348	BolC4t27365H	0	-	228	342	342	1.0000000
C4	56317375	56318350	BolC4t27366H	0	+	186	967	975	0.9917949
C4	56324920	56326492	BolC4t27367H	0	+	1001	1572	1572	1.0000000
C4	56331827	56332229	BolC4t27368H	0	-	880	402	402	1.0000000
C4	56344046	56344228	BolC4t27369H	0	+	3	124	182	0.6813187
C4	56349108	56358890	BolC4t27370H	0	-	4426	7458	9782	0.7624208
C4	56400948	56422311	BolC4t27371H	0	+	3094	14900	21363	0.6974676
C4	56410210	56410565	BolC4t27372H	0	-	0	0	355	0.0000000
C4	56410805	56411411	BolC4t27373H	0	-	3	158	606	0.2607261
C4	56422774	56424465	BolC4t27374H	0	-	605	1627	1691	0.9621526
C4	56431715	56432945	BolC4t27375H	0	+	319	1182	1230	0.9609756
C4	56433199	56433952	BolC4t27376H	0	-	228	753	753	1.0000000
C4	56436179	56437099	BolC4t27377H	0	-	735	746	920	0.8108696
C4	56438456	56439222	BolC4t27378H	0	-	301	706	766	0.9216710
C4	56443289	56444947	BolC4t27379H	0	-	826	1534	1658	0.9252111
C4	56450971	56451334	BolC4t27380H	0	+	192	310	363	0.8539945
C4	56461075	56461382	BolC4t27381H	0	-	368	297	307	0.9674267
C4	56462715	56463571	BolC4t27382H	0	-	53	856	856	1.0000000
C4	56471150	56472094	BolC4t27383H	0	-	95	538	944	0.5699152
C4	56475120	56475931	BolC4t27384H	0	-	227	797	811	0.9827374
C4	56476470	56476824	BolC4t27385H	0	-	226	354	354	1.0000000
C4	56483361	56483829	BolC4t27386H	0	-	222	405	468	0.8653846
C4	56484968	56486123	BolC4t27387H	0	-	471	1155	1155	1.0000000
C4	56487425	56489048	BolC4t27388H	0	-	358	1548	1623	0.9537893
C4	56489761	56491573	BolC4t27389H	0	+	616	1725	1812	0.9519867
C4	56500896	56503576	BolC4t27390H	0	+	1801	2567	2680	0.9578358
C4	56504626	56505295	BolC4t27391H	0	-	195	669	669	1.0000000
C4	56509825	56510159	BolC4t27392H	0	-	116	332	334	0.9940120
C4	56520684	56526417	BolC4t27393H	0	+	3766	5259	5733	0.9173208
C4	56529833	56532229	BolC4t27394H	0	-	1007	2258	2396	0.9424040
C4	56546839	56548224	BolC4t27395H	0	+	655	1385	1385	1.0000000
C4	56559879	56560233	BolC4t27396H	0	-	24	346	354	0.9774011
C4	56561414	56562433	BolC4t27397H	0	+	471	992	1019	0.9735034
C4	56566804	56573754	BolC4t27398H	0	-	2514	6706	6950	0.9648921
C4	56584044	56585779	BolC4t27399H	0	-	816	1266	1735	0.7296830
C4	56593208	56599129	BolC4t27400H	0	+	2495	5389	5921	0.9101503
C4	56601037	56604159	BolC4t27401H	0	-	791	2539	3122	0.8132607
C4	56610950	56612639	BolC4t27402H	0	-	1417	1689	1689	1.0000000
C4	56613581	56614478	BolC4t27403H	0	-	363	897	897	1.0000000
C4	56624494	56629558	BolC4t27404H	0	+	3564	4983	5064	0.9840047
C4	56639701	56640407	BolC4t27405H	0	-	5	42	706	0.0594901
C4	56643588	56644793	BolC4t27406H	0	+	84	488	1205	0.4049793
C4	56656174	56672931	BolC4t27407H	0	+	2949	13178	16757	0.7864176
C4	56667817	56668202	BolC4t27408H	0	+	137	385	385	1.0000000
C4	56682792	56685154	BolC4t27409H	0	-	91	1201	2362	0.5084674
C4	56691234	56692885	BolC4t27410H	0	+	249	1473	1651	0.8921866
C4	56696786	56697724	BolC4t27411H	0	+	480	938	938	1.0000000
C4	56700148	56703905	BolC4t27412H	0	-	1529	3593	3757	0.9563481
C4	56718812	56719611	BolC4t27413H	0	+	111	636	799	0.7959950
C4	56728732	56729217	BolC4t27414H	0	+	6	122	485	0.2515464
C4	56731710	56731845	BolC4t27415H	0	-	230	135	135	1.0000000
C4	56732311	56732719	BolC4t27416H	0	-	220	408	408	1.0000000
C4	56747524	56747848	BolC4t27417H	0	+	131	324	324	1.0000000
C4	56751469	56753944	BolC4t27418H	0	+	1558	2475	2475	1.0000000
C4	56756577	56757691	BolC4t27419H	0	+	262	1114	1114	1.0000000
C4	56759213	56759471	BolC4t27420H	0	+	157	258	258	1.0000000
C4	56760247	56760724	BolC4t27421H	0	-	124	369	477	0.7735849
C4	56761767	56770830	BolC4t27422H	0	-	1197	4549	9063	0.5019310
C4	56771251	56773322	BolC4t27423H	0	-	486	1592	2071	0.7687108
C4	56785407	56785584	BolC4t27424H	0	-	377	177	177	1.0000000
C4	56807091	56807631	BolC4t27425H	0	+	234	483	540	0.8944445
C4	56813982	56817727	BolC4t27426H	0	-	1012	3257	3745	0.8696929
C4	56818462	56819857	BolC4t27427H	0	-	500	1333	1395	0.9555556
C4	56821367	56822420	BolC4t27428H	0	-	1318	1053	1053	1.0000000
C4	56829023	56831416	BolC4t27429H	0	+	312	1710	2393	0.7145842
C4	56833083	56833728	BolC4t27430H	0	+	200	645	645	1.0000000
C4	56870057	56872479	BolC4t27431H	0	-	74	707	2422	0.2919075
C4	56879120	56880384	BolC4t27432H	0	+	204	894	1264	0.7072785
C4	56883482	56903520	BolC4t27433H	0	-	9908	18643	20038	0.9303823
C4	56892820	56893134	BolC4t27434H	0	+	379	314	314	1.0000000
C4	56894387	56895866	BolC4t27435H	0	+	772	1479	1479	1.0000000
C4	56904642	56905950	BolC4t27436H	0	-	629	1303	1308	0.9961774
C4	56913577	56914143	BolC4t27437H	0	-	700	566	566	1.0000000
C4	56917285	56919731	BolC4t27438H	0	-	664	2416	2446	0.9877351
C4	56923302	56923704	BolC4t27439H	0	+	466	402	402	1.0000000
C4	56935227	56935906	BolC4t27440H	0	-	126	549	679	0.8085420
C4	56954885	56955839	BolC4t27441H	0	+	120	650	954	0.6813417
C4	56957935	56959506	BolC4t27442H	0	+	1141	1563	1571	0.9949077
C4	56964072	56964843	BolC4t27443H	0	-	2	70	771	0.0907912
C4	56970927	56973278	BolC4t27444H	0	-	679	1899	2351	0.8077414
C4	56978405	56980314	BolC4t27445H	0	-	596	1898	1909	0.9942378
C4	56990443	56992655	BolC4t27446H	0	-	621	2174	2212	0.9828210
C4	56996109	56997078	BolC4t27447H	0	-	36	831	969	0.8575851
C4	56998960	56999610	BolC4t27448H	0	+	648	650	650	1.0000000
C4	57000052	57000454	BolC4t27449H	0	-	259	402	402	1.0000000
C4	57001625	57002680	BolC4t27450H	0	-	45	257	1055	0.2436019
C4	57002119	57002578	BolC4t27451H	0	-	22	155	459	0.3376906
C4	57012856	57013285	BolC4t27452H	0	-	170	429	429	1.0000000
C4	57023405	57027994	BolC4t27453H	0	+	1667	4557	4589	0.9930268
C4	57036836	57046434	BolC4t27454H	0	-	834	5373	9598	0.5598041
C4	57039852	57067649	BolC4t27455H	0	-	10692	15848	27797	0.5701334
C4	57043973	57044308	BolC4t27456H	0	-	2	196	335	0.5850746
C4	57062485	57064788	BolC4t27457H	0	-	207	1181	2303	0.5128094
C4	57093387	57093922	BolC4t27458H	0	-	8	354	535	0.6616822
C4	57099116	57102511	BolC4t27459H	0	-	475	1630	3395	0.4801178
C4	57121247	57124009	BolC4t27460H	0	-	1172	2593	2762	0.9388124
C4	57131744	57132282	BolC4t27461H	0	+	5	72	538	0.1338290
C4	57135531	57136814	BolC4t27462H	0	+	0	0	1283	0.0000000
C4	57135552	57136471	BolC4t27463H	0	+	0	0	919	0.0000000
C4	57136850	57137028	BolC4t27464H	0	+	1	17	178	0.0955056
C4	57137563	57139252	BolC4t27465H	0	+	233	677	1689	0.4008289
C4	57141342	57142627	BolC4t27466H	0	+	0	0	1285	0.0000000
C4	57141363	57142284	BolC4t27467H	0	+	0	0	921	0.0000000
C4	57142663	57142841	BolC4t27468H	0	+	0	0	178	0.0000000
C4	57149304	57150034	BolC4t27469H	0	-	36	511	730	0.7000000
C4	57151179	57154935	BolC4t27470H	0	-	1112	3364	3756	0.8956336
C4	57155914	57159762	BolC4t27471H	0	+	2099	3611	3848	0.9384096
C4	57163568	57164718	BolC4t27472H	0	+	765	1150	1150	1.0000000
C4	57166163	57169965	BolC4t27473H	0	+	1580	3754	3802	0.9873751
C4	57175857	57176759	BolC4t27474H	0	+	635	902	902	1.0000000
C4	57177475	57179967	BolC4t27475H	0	-	984	2309	2492	0.9265650
C4	57191843	57192634	BolC4t27476H	0	+	55	581	791	0.7345133
C4	57194549	57196797	BolC4t27477H	0	+	573	1787	2248	0.7949288
C4	57197320	57199362	BolC4t27478H	0	-	1986	2042	2042	1.0000000
C4	57200077	57202232	BolC4t27479H	0	-	932	1921	2155	0.8914153
C4	57204805	57210198	BolC4t27480H	0	-	2089	5218	5393	0.9675505
C4	57212296	57213247	BolC4t27481H	0	-	349	951	951	1.0000000
C4	57216308	57216798	BolC4t27482H	0	-	108	490	490	1.0000000
C4	57220135	57220342	BolC4t27483H	0	+	87	207	207	1.0000000
C4	57224915	57226463	BolC4t27484H	0	+	911	1491	1548	0.9631783
C4	57233968	57234112	BolC4t27485H	0	+	112	144	144	1.0000000
C4	57237737	57238168	BolC4t27486H	0	+	112	215	431	0.4988399
C4	57239573	57240634	BolC4t27487H	0	+	290	799	1061	0.7530631
C4	57245658	57247359	BolC4t27488H	0	+	450	1701	1701	1.0000000
C4	57248704	57254301	BolC4t27489H	0	-	5054	5574	5597	0.9958907
C4	57262771	57310344	BolC4t27490H	0	-	5886	20336	47573	0.4274694
C4	57293593	57294738	BolC4t27491H	0	-	564	990	1145	0.8646288
C4	57340971	57348318	BolC4t27492H	0	-	894	5677	7347	0.7726963
C4	57359939	57362413	BolC4t27493H	0	+	1236	2248	2474	0.9086500
C4	57366651	57367656	BolC4t27494H	0	+	649	1005	1005	1.0000000
C4	57375672	57376226	BolC4t27495H	0	-	92	554	554	1.0000000
C4	57383505	57383895	BolC4t27496H	0	-	202	390	390	1.0000000
C4	57389891	57391146	BolC4t27497H	0	-	25	528	1255	0.4207171
C4	57411691	57411928	BolC4t27498H	0	+	56	237	237	1.0000000
C4	57412763	57414064	BolC4t27499H	0	+	333	1301	1301	1.0000000
C4	57415253	57426939	BolC4t27500H	0	-	6231	10738	11686	0.9188773
C4	57466034	57467489	BolC4t27501H	0	-	583	1455	1455	1.0000000
C4	57470396	57471275	BolC4t27502H	0	+	155	838	879	0.9533561
C4	57480272	57480506	BolC4t27503H	0	-	13	232	234	0.9914530
C4	57482404	57484895	BolC4t27504H	0	-	1521	2365	2491	0.9494179
C4	57486979	57487667	BolC4t27505H	0	-	15	199	688	0.2892442
C4	57489524	57492298	BolC4t27506H	0	+	273	2653	2774	0.9563807
C4	57502713	57502830	BolC4t27507H	0	+	10	117	117	1.0000000
C4	57505088	57509538	BolC4t27508H	0	-	2723	4362	4450	0.9802247
C4	57513448	57514129	BolC4t27509H	0	+	288	665	681	0.9765052
C4	57520064	57520421	BolC4t27510H	0	+	43	357	357	1.0000000
C4	57525453	57530152	BolC4t27511H	0	+	1309	4393	4699	0.9348798
C4	57530351	57533981	BolC4t27512H	0	-	1764	3446	3630	0.9493113
C4	57537617	57537871	BolC4t27513H	0	+	260	254	254	1.0000000
C4	57542756	57544540	BolC4t27514H	0	+	365	1305	1784	0.7315022
C4	57546230	57548769	BolC4t27515H	0	+	703	2235	2539	0.8802678
C4	57551198	57552323	BolC4t27516H	0	+	900	1125	1125	1.0000000
C4	57575871	57578833	BolC4t27517H	0	-	1135	2813	2962	0.9496961
C4	57581367	57583518	BolC4t27518H	0	-	918	2093	2151	0.9730358
C4	57598081	57602330	BolC4t27519H	0	+	1204	3996	4249	0.9404566
C4	57602956	57604887	BolC4t27520H	0	-	996	1931	1931	1.0000000
C4	57607364	57607574	BolC4t27521H	0	+	37	199	210	0.9476190
C4	57608637	57609183	BolC4t27522H	0	-	446	546	546	1.0000000
C4	57613773	57614154	BolC4t27523H	0	+	315	381	381	1.0000000
C4	57615373	57616029	BolC4t27524H	0	-	98	656	656	1.0000000
C4	57624996	57625359	BolC4t27525H	0	-	282	363	363	1.0000000
C4	57626759	57627840	BolC4t27526H	0	+	638	1081	1081	1.0000000
C4	57645463	57646350	BolC4t27527H	0	-	278	874	887	0.9853439
C4	57651920	57656514	BolC4t27528H	0	-	3695	4594	4594	1.0000000
C4	57659418	57661533	BolC4t27529H	0	+	49	478	2115	0.2260047
C4	57670825	57671686	BolC4t27530H	0	+	0	0	861	0.0000000
C4	57673965	57674214	BolC4t27531H	0	+	4	33	249	0.1325301
C4	57685413	57685662	BolC4t27532H	0	+	12	55	249	0.2208835
C4	57723642	57723888	BolC4t27533H	0	+	6	102	246	0.4146341
C4	57726478	57726625	BolC4t27534H	0	+	2	111	147	0.7551020
C4	57728354	57728939	BolC4t27535H	0	+	1	120	585	0.2051282
C4	57735619	57736096	BolC4t27536H	0	+	354	477	477	1.0000000
C4	57758474	57758790	BolC4t27537H	0	+	49	295	316	0.9335443
C4	57759021	57759753	BolC4t27538H	0	+	448	732	732	1.0000000
C4	57760831	57763439	BolC4t27539H	0	+	1165	2424	2608	0.9294478
C4	57764028	57767574	BolC4t27540H	0	-	1249	2371	3546	0.6686407
C4	57768864	57769307	BolC4t27541H	0	+	228	443	443	1.0000000
C4	57777303	57778485	BolC4t27542H	0	-	1508	1182	1182	1.0000000
C4	57780256	57780778	BolC4t27543H	0	-	102	472	522	0.9042146
C4	57782359	57786060	BolC4t27544H	0	-	648	2742	3701	0.7408808
C4	57787663	57788182	BolC4t27545H	0	-	177	519	519	1.0000000
C4	57798973	57799492	BolC4t27546H	0	-	194	486	519	0.9364162
C4	57801087	57801606	BolC4t27547H	0	-	237	519	519	1.0000000
C4	57803460	57803751	BolC4t27548H	0	-	6	236	291	0.8109966
C4	57805744	57806263	BolC4t27549H	0	-	128	454	519	0.8747591
C4	57808885	57809407	BolC4t27550H	0	-	219	522	522	1.0000000
C4	57809578	57810316	BolC4t27551H	0	+	509	722	738	0.9783198
C4	57811196	57820709	BolC4t27552H	0	+	805	4544	9513	0.4776621
C4	57823796	57825784	BolC4t27553H	0	+	189	470	1988	0.2364185
C4	57831453	57831660	BolC4t27554H	0	+	0	0	207	0.0000000
C4	57842427	57843081	BolC4t27555H	0	+	64	439	654	0.6712538
C4	57848860	57852627	BolC4t27556H	0	-	2084	3767	3767	1.0000000
C4	57854827	57856527	BolC4t27557H	0	-	257	1206	1700	0.7094117
C4	57863664	57865951	BolC4t27558H	0	-	2443	2287	2287	1.0000000
C4	57868033	57870139	BolC4t27559H	0	-	427	1758	2106	0.8347579
C4	57871748	57871856	BolC4t27560H	0	-	126	108	108	1.0000000
C4	57885651	57887150	BolC4t27561H	0	+	368	1319	1499	0.8799199
C4	57890958	57892958	BolC4t27562H	0	+	712	2000	2000	1.0000000
C4	57898094	57898892	BolC4t27563H	0	-	58	494	798	0.6190476
C4	57905033	57907433	BolC4t27564H	0	-	628	2015	2400	0.8395833
C4	57906713	57906891	BolC4t27565H	0	-	65	178	178	1.0000000
C4	57907508	57907916	BolC4t27566H	0	-	375	408	408	1.0000000
C4	57924150	57926070	BolC4t27567H	0	-	586	1851	1920	0.9640625
C4	57926886	57930246	BolC4t27568H	0	-	3203	3281	3360	0.9764881
C4	57932167	57934251	BolC4t27569H	0	+	1574	2084	2084	1.0000000
C4	57937270	57937969	BolC4t27570H	0	-	173	699	699	1.0000000
C4	57946531	57946636	BolC4t27571H	0	+	108	105	105	1.0000000
C4	57946818	57950433	BolC4t27572H	0	+	2811	3612	3615	0.9991701
C4	57950946	57951270	BolC4t27573H	0	-	291	324	324	1.0000000
C4	57954495	57955734	BolC4t27574H	0	+	450	1108	1239	0.8942696
C4	57956403	57956879	BolC4t27575H	0	-	385	469	476	0.9852941
C4	57961533	57962784	BolC4t27576H	0	+	231	879	1251	0.7026379
C4	57963108	57965384	BolC4t27577H	0	-	957	1917	2276	0.8422672
C4	57965934	57967246	BolC4t27578H	0	+	277	1302	1312	0.9923781
C4	57968504	57975291	BolC4t27579H	0	-	1176	5894	6787	0.8684250
C4	57977343	57983478	BolC4t27580H	0	+	1465	4029	6135	0.6567237
C4	57984593	57986213	BolC4t27581H	0	-	1048	1620	1620	1.0000000
C4	57999107	57999836	BolC4t27582H	0	-	251	729	729	1.0000000
C4	58001052	58002516	BolC4t27583H	0	-	264	1276	1464	0.8715847
C4	58003739	58005174	BolC4t27584H	0	+	466	1411	1435	0.9832752
C4	58008176	58012065	BolC4t27585H	0	+	2620	3889	3889	1.0000000
C4	58012668	58015488	BolC4t27586H	0	-	1725	2816	2820	0.9985816
C4	58016398	58017156	BolC4t27587H	0	-	674	758	758	1.0000000
C4	58017654	58018457	BolC4t27588H	0	+	4	95	803	0.1183064
C4	58053039	58054257	BolC4t27589H	0	+	998	1043	1218	0.8563218
C4	58054845	58055187	BolC4t27590H	0	+	4	19	342	0.0555556
C4	58062863	58064393	BolC4t27591H	0	-	14	382	1530	0.2496732
C4	58070862	58071489	BolC4t27592H	0	+	10	291	627	0.4641148
C4	58073957	58090470	BolC4t27593H	0	+	244	4236	16513	0.2565252
C4	58078868	58079749	BolC4t27594H	0	-	0	0	881	0.0000000
C4	58085025	58086850	BolC4t27595H	0	+	6	250	1825	0.1369863
C4	58091101	58091686	BolC4t27596H	0	+	123	585	585	1.0000000
C4	58093114	58096152	BolC4t27597H	0	+	408	2739	3038	0.9015800
C4	58098066	58100647	BolC4t27598H	0	+	1309	2581	2581	1.0000000
C4	58100948	58101945	BolC4t27599H	0	-	320	997	997	1.0000000
C4	58103030	58104390	BolC4t27600H	0	-	779	1357	1360	0.9977941
C4	58107547	58107784	BolC4t27601H	0	-	56	237	237	1.0000000
C4	58121658	58121940	BolC4t27602H	0	-	2	164	282	0.5815603
C4	58127889	58129246	BolC4t27603H	0	+	131	1133	1357	0.8349300
C4	58129914	58130722	BolC4t27604H	0	-	718	808	808	1.0000000
C4	58138022	58139526	BolC4t27605H	0	-	180	1174	1504	0.7805851
C4	58145729	58145948	BolC4t27606H	0	+	264	219	219	1.0000000
C4	58147068	58147951	BolC4t27607H	0	-	337	881	883	0.9977350
C4	58147955	58150535	BolC4t27608H	0	-	1402	2501	2580	0.9693798
C4	58157954	58159154	BolC4t27609H	0	-	994	1200	1200	1.0000000
C4	58169291	58170041	BolC4t27610H	0	-	330	750	750	1.0000000
C4	58171114	58176298	BolC4t27611H	0	+	1563	5036	5184	0.9714506
C4	58182000	58186750	BolC4t27612H	0	+	974	3966	4750	0.8349473
C4	58201244	58203483	BolC4t27613H	0	+	575	1452	2239	0.6485038
C4	58207744	58209708	BolC4t27614H	0	+	1425	1908	1964	0.9714867
C4	58210020	58210491	BolC4t27615H	0	+	389	471	471	1.0000000
C4	58216950	58217241	BolC4t27616H	0	+	465	291	291	1.0000000
C4	58223608	58225704	BolC4t27617H	0	+	1043	2067	2096	0.9861641
C4	58226142	58229619	BolC4t27618H	0	-	746	2495	3477	0.7175726
C4	58230783	58233882	BolC4t27619H	0	+	1885	2580	3099	0.8325266
C4	58249977	58252710	BolC4t27620H	0	+	1370	2193	2733	0.8024150
C4	58255719	58258371	BolC4t27621H	0	+	1105	2630	2652	0.9917043
C4	58261947	58268611	BolC4t27622H	0	+	2130	5718	6664	0.8580432
C4	58272696	58275652	BolC4t27623H	0	+	1608	2874	2956	0.9722598
C4	58276292	58277516	BolC4t27624H	0	+	625	1224	1224	1.0000000
C4	58284857	58285461	BolC4t27625H	0	+	398	604	604	1.0000000
C4	58285772	58287588	BolC4t27626H	0	-	598	1559	1816	0.8584802
C4	58290899	58293545	BolC4t27627H	0	-	790	2385	2646	0.9013606
C4	58293985	58297528	BolC4t27628H	0	-	3931	3454	3543	0.9748800
C4	58310749	58311196	BolC4t27629H	0	+	285	447	447	1.0000000
C4	58315554	58315743	BolC4t27630H	0	+	291	189	189	1.0000000
C4	58318722	58320633	BolC4t27631H	0	+	576	1678	1911	0.8780743
C4	58325325	58327251	BolC4t27632H	0	+	453	1772	1926	0.9200416
C4	58327464	58327917	BolC4t27633H	0	-	576	453	453	1.0000000
C4	58328347	58337423	BolC4t27634H	0	+	1129	5585	9076	0.6153592
C4	58341622	58342131	BolC4t27635H	0	-	1	7	509	0.0137525
C4	58353125	58354131	BolC4t27636H	0	-	433	943	1006	0.9373757
C4	58356587	58357916	BolC4t27637H	0	+	335	484	1329	0.3641836
C4	58375010	58376667	BolC4t27638H	0	-	226	1111	1657	0.6704888
C4	58393541	58395954	BolC4t27639H	0	+	181	1772	2413	0.7343556
C4	58399983	58433721	BolC4t27640H	0	+	9539	27985	33738	0.8294801
C4	58404591	58405773	BolC4t27641H	0	+	366	1182	1182	1.0000000
C4	58406770	58407588	BolC4t27642H	0	+	490	818	818	1.0000000
C4	58408497	58410693	BolC4t27643H	0	-	286	1556	2196	0.7085610
C4	58410499	58411101	BolC4t27644H	0	-	40	376	602	0.6245847
C4	58413316	58414200	BolC4t27645H	0	+	403	815	884	0.9219457
C4	58421131	58422346	BolC4t27646H	0	+	692	1215	1215	1.0000000
C4	58423094	58423649	BolC4t27647H	0	-	60	495	555	0.8918919
C4	58424921	58425521	BolC4t27648H	0	-	95	334	600	0.5566667
C4	58436769	58437382	BolC4t27649H	0	-	369	613	613	1.0000000
C4	58448304	58452999	BolC4t27650H	0	+	2166	4313	4695	0.9186369
C4	58465172	58467031	BolC4t27651H	0	+	15	612	1859	0.3292092
C4	58469853	58472412	BolC4t27652H	0	-	93	1152	2559	0.4501759
C4	58474201	58474718	BolC4t27653H	0	-	12	179	517	0.3462282
C4	58477453	58491875	BolC4t27654H	0	-	2707	6500	14422	0.4507003
C4	58495085	58496639	BolC4t27655H	0	-	0	0	1554	0.0000000
C4	58497675	58498877	BolC4t27656H	0	-	55	909	1202	0.7562396
C4	58510160	58510589	BolC4t27657H	0	-	507	429	429	1.0000000
C4	58514021	58516589	BolC4t27658H	0	+	44	696	2568	0.2710280
C4	58531563	58535549	BolC4t27659H	0	+	171	2080	3986	0.5218264
C4	58536038	58540402	BolC4t27660H	0	-	2237	4168	4364	0.9550871
C4	58541606	58542821	BolC4t27661H	0	-	474	1215	1215	1.0000000
C4	58548884	58550048	BolC4t27662H	0	-	260	1050	1164	0.9020619
C4	58551285	58552455	BolC4t27663H	0	-	439	837	1170	0.7153846
C4	58555348	58556503	BolC4t27664H	0	-	481	1155	1155	1.0000000
C4	58558647	58559820	BolC4t27665H	0	-	680	1173	1173	1.0000000
C4	58564990	58565405	BolC4t27666H	0	-	476	415	415	1.0000000
C4	58569750	58571421	BolC4t27667H	0	-	930	1671	1671	1.0000000
C4	58576339	58577497	BolC4t27668H	0	-	213	963	1158	0.8316062
C4	58586613	58587837	BolC4t27669H	0	-	350	1164	1224	0.9509804
C4	58589691	58592722	BolC4t27670H	0	-	2030	3031	3031	1.0000000
C4	58596113	58600021	BolC4t27671H	0	-	1646	3753	3908	0.9603378
C4	58601849	58603755	BolC4t27672H	0	-	296	1598	1906	0.8384050
C4	58616160	58616418	BolC4t27673H	0	-	261	258	258	1.0000000
C4	58643680	58644067	BolC4t27674H	0	+	129	387	387	1.0000000
C4	58661179	58663252	BolC4t27675H	0	+	612	1389	2073	0.6700434
C4	58668942	58669665	BolC4t27676H	0	-	0	0	723	0.0000000
C4	58672464	58673532	BolC4t27677H	0	-	244	984	1068	0.9213483
C4	58691660	58692768	BolC4t27678H	0	-	178	785	1108	0.7084838
C4	58694653	58699633	BolC4t27679H	0	+	144	1202	4980	0.2413655
C4	58705623	58711026	BolC4t27680H	0	+	1196	4246	5403	0.7858597
C4	58712178	58713454	BolC4t27681H	0	+	70	1189	1276	0.9318182
C4	58714501	58715827	BolC4t27682H	0	+	97	849	1326	0.6402715
C4	58716381	58716585	BolC4t27683H	0	-	58	204	204	1.0000000
C4	58767210	58772934	BolC4t27684H	0	+	2128	4249	5724	0.7423131
C4	58778699	58782565	BolC4t27685H	0	+	237	1485	3866	0.3841180
C4	58785820	58787321	BolC4t27686H	0	+	336	1239	1501	0.8254497
C4	58796337	58797195	BolC4t27687H	0	+	301	858	858	1.0000000
C4	58798013	58798418	BolC4t27688H	0	-	133	405	405	1.0000000
C4	58799467	58802309	BolC4t27689H	0	-	2130	2842	2842	1.0000000
C4	58807038	58807233	BolC4t27690H	0	-	232	195	195	1.0000000
C4	58809578	58809928	BolC4t27691H	0	-	0	0	350	0.0000000
C4	58814188	58814602	BolC4t27692H	0	+	66	396	414	0.9565217
C4	58816926	58819242	BolC4t27693H	0	+	409	2211	2316	0.9546632
C4	58821978	58822275	BolC4t27694H	0	-	574	297	297	1.0000000
C4	58823550	58823843	BolC4t27695H	0	+	223	293	293	1.0000000
C4	58829977	58844485	BolC4t27696H	0	-	6920	14429	14508	0.9945548
C4	58839376	58840889	BolC4t27697H	0	+	936	1513	1513	1.0000000
C4	58845208	58847130	BolC4t27698H	0	+	814	1922	1922	1.0000000
C4	58847208	58847994	BolC4t27699H	0	+	515	786	786	1.0000000
C4	58855543	58855896	BolC4t27700H	0	+	331	353	353	1.0000000
C4	58856706	58900889	BolC4t27701H	0	-	18487	33616	44183	0.7608356
C4	58914091	58914721	BolC4t27702H	0	-	347	630	630	1.0000000
C4	58917436	58932505	BolC4t27703H	0	+	2477	8908	15069	0.5911474
C4	58948291	58949805	BolC4t27704H	0	+	806	1492	1514	0.9854690
C4	58951115	58952136	BolC4t27705H	0	-	650	1021	1021	1.0000000
C4	58953702	58958301	BolC4t27706H	0	+	1415	4550	4599	0.9893455
C4	58971854	58977151	BolC4t27707H	0	+	2253	4893	5297	0.9237304
C4	58977843	58978520	BolC4t27708H	0	+	22	469	677	0.6927622
C4	58988703	58988931	BolC4t27709H	0	+	13	66	228	0.2894737
C4	58989938	58997226	BolC4t27710H	0	+	1385	5440	7288	0.7464325
C4	58997849	59003112	BolC4t27711H	0	-	2027	4701	5263	0.8932168
C4	59004470	59005433	BolC4t27712H	0	+	0	0	963	0.0000000
C4	59009787	59013524	BolC4t27713H	0	+	1420	3475	3737	0.9298903
C4	59017758	59019410	BolC4t27714H	0	-	1252	1652	1652	1.0000000
C4	59039099	59044046	BolC4t27715H	0	+	786	2641	4947	0.5338589
C4	59049656	59049887	BolC4t27716H	0	-	352	231	231	1.0000000
C4	59052087	59054970	BolC4t27717H	0	-	1114	2680	2883	0.9295872
C4	59061370	59062369	BolC4t27718H	0	-	59	556	999	0.5565566
C4	59077219	59078904	BolC4t27719H	0	+	424	1119	1685	0.6640950
C4	59080354	59080782	BolC4t27720H	0	+	325	428	428	1.0000000
C4	59084396	59084672	BolC4t27721H	0	+	0	0	276	0.0000000
C4	59085158	59085503	BolC4t27722H	0	-	3	48	345	0.1391304
C4	59096690	59096873	BolC4t27723H	0	-	0	0	183	0.0000000
C4	59099843	59101493	BolC4t27724H	0	-	43	155	1650	0.0939394
C4	59126210	59129055	BolC4t27725H	0	+	485	2430	2845	0.8541300
C4	59147248	59147377	BolC4t27726H	0	+	0	0	129	0.0000000
C4	59150879	59153278	BolC4t27727H	0	+	613	1591	2399	0.6631930
C4	59155854	59156325	BolC4t27728H	0	-	914	471	471	1.0000000
C4	59157062	59157835	BolC4t27729H	0	-	24	299	773	0.3868047
C4	59177229	59177518	BolC4t27730H	0	-	20	170	289	0.5882353
C4	59184925	59185966	BolC4t27731H	0	+	1254	1041	1041	1.0000000
C4	59192306	59193363	BolC4t27732H	0	+	670	1057	1057	1.0000000
C4	59195932	59196427	BolC4t27733H	0	-	276	494	495	0.9979798
C4	59196654	59197244	BolC4t27734H	0	-	304	590	590	1.0000000
C4	59197948	59198913	BolC4t27735H	0	-	608	965	965	1.0000000
C4	59200339	59201394	BolC4t27736H	0	+	792	1055	1055	1.0000000
C4	59202552	59204732	BolC4t27737H	0	-	812	2100	2180	0.9633027
C4	59208318	59209323	BolC4t27738H	0	+	666	1005	1005	1.0000000
C4	59211377	59214958	BolC4t27739H	0	-	684	2675	3581	0.7469981
C4	59215991	59217544	BolC4t27740H	0	-	301	1381	1553	0.8892466
C4	59219118	59222001	BolC4t27741H	0	-	1178	2802	2883	0.9719043
C4	59226201	59227896	BolC4t27742H	0	+	295	1259	1695	0.7427729
C4	59229775	59233542	BolC4t27743H	0	-	292	1964	3767	0.5213698
C4	59240067	59240687	BolC4t27744H	0	+	35	311	620	0.5016129
C4	59241722	59242136	BolC4t27745H	0	-	714	414	414	1.0000000
C4	59243134	59244244	BolC4t27746H	0	+	66	379	1110	0.3414415
C4	59245576	59245984	BolC4t27747H	0	-	83	349	408	0.8553922
C4	59268302	59268628	BolC4t27748H	0	-	29	276	326	0.8466257
C4	59272285	59274645	BolC4t27749H	0	+	213	1651	2360	0.6995763
C4	59278860	59280484	BolC4t27750H	0	-	5	85	1624	0.0523399
C4	59283354	59290661	BolC4t27751H	0	-	2457	6238	7307	0.8537019
C4	59292308	59293487	BolC4t27752H	0	-	673	1071	1179	0.9083970
C4	59293608	59308114	BolC4t27753H	0	-	2210	5216	14506	0.3595754
C4	59308530	59310964	BolC4t27754H	0	+	712	2434	2434	1.0000000
C4	59311854	59314802	BolC4t27755H	0	+	681	2465	2948	0.8361601
C4	59328820	59330667	BolC4t27756H	0	+	224	1635	1847	0.8852193
C4	59334724	59336638	BolC4t27757H	0	+	695	1786	1914	0.9331244
C4	59337851	59340441	BolC4t27758H	0	-	2365	2385	2590	0.9208494
C4	59356494	59358336	BolC4t27759H	0	-	109	1405	1842	0.7627579
C4	59359446	59363540	BolC4t27760H	0	-	1218	3681	4094	0.8991207
C4	59366111	59366315	BolC4t27761H	0	+	21	178	204	0.8725490
C4	59383576	59383792	BolC4t27762H	0	+	5	157	216	0.7268519
C4	59387753	59389076	BolC4t27763H	0	-	324	1064	1323	0.8042328
C4	59400264	59403120	BolC4t27764H	0	+	141	684	2856	0.2394958
C4	59404052	59405648	BolC4t27765H	0	-	205	765	1596	0.4793233
C4	59407231	59415740	BolC4t27766H	0	-	3112	8478	8509	0.9963568
C4	59417119	59418086	BolC4t27767H	0	+	144	684	967	0.7073423
C4	59425177	59426126	BolC4t27768H	0	+	862	949	949	1.0000000
C4	59426684	59427701	BolC4t27769H	0	-	1001	1017	1017	1.0000000
C4	59432249	59433558	BolC4t27770H	0	+	381	1309	1309	1.0000000
C4	59434417	59438640	BolC4t27771H	0	+	1404	4023	4223	0.9526403
C4	59446404	59449149	BolC4t27772H	0	-	2227	2745	2745	1.0000000
C4	59477939	59481398	BolC4t27773H	0	-	3244	3459	3459	1.0000000
C4	59489486	59490805	BolC4t27774H	0	+	1158	1319	1319	1.0000000
C4	59491493	59492317	BolC4t27775H	0	+	80	629	824	0.7633495
C4	59492488	59493313	BolC4t27776H	0	-	343	748	825	0.9066667
C4	59494205	59495829	BolC4t27777H	0	-	346	1340	1624	0.8251231
C4	59505360	59506280	BolC4t27778H	0	+	15	217	920	0.2358696
C4	59511913	59516395	BolC4t27779H	0	+	1760	4093	4482	0.9132084
C4	59520972	59522262	BolC4t27780H	0	+	796	1211	1290	0.9387597
C4	59527818	59529192	BolC4t27781H	0	-	658	1351	1374	0.9832606
C4	59531589	59533444	BolC4t27782H	0	-	1590	1855	1855	1.0000000
C4	59534238	59536227	BolC4t27783H	0	-	1014	1989	1989	1.0000000
C4	59537544	59537919	BolC4t27784H	0	-	362	375	375	1.0000000
C4	59538198	59539769	BolC4t27785H	0	+	636	1368	1571	0.8707829
C4	59547314	59549815	BolC4t27786H	0	+	663	2275	2501	0.9096361
C4	59549894	59553880	BolC4t27787H	0	+	1936	3497	3986	0.8773206
C4	59556012	59558759	BolC4t27788H	0	+	1444	2646	2747	0.9632326
C4	59559398	59562188	BolC4t27789H	0	+	829	2466	2790	0.8838710
C4	59564358	59564702	BolC4t27790H	0	-	246	344	344	1.0000000
C4	59592607	59592841	BolC4t27791H	0	-	96	234	234	1.0000000
C4	59596981	59597200	BolC4t27792H	0	+	406	219	219	1.0000000
C4	59600567	59601985	BolC4t27793H	0	+	656	1373	1418	0.9682652
C4	59602720	59604176	BolC4t27794H	0	-	260	1048	1456	0.7197802
C4	59608683	59608893	BolC4t27795H	0	-	0	0	210	0.0000000
C4	59608774	59609008	BolC4t27796H	0	+	0	0	234	0.0000000
C4	59614403	59616548	BolC4t27797H	0	-	187	1513	2145	0.7053613
C4	59618779	59620519	BolC4t27798H	0	+	1003	1740	1740	1.0000000
C4	59620769	59623939	BolC4t27799H	0	-	1650	2836	3170	0.8946372
C4	59640865	59643962	BolC4t27800H	0	-	1277	2821	3097	0.9108815
C4	59649337	59649667	BolC4t27801H	0	+	368	330	330	1.0000000
C4	59655367	59655973	BolC4t27802H	0	-	348	606	606	1.0000000
C4	59658749	59660028	BolC4t27803H	0	-	1607	1279	1279	1.0000000
C4	59670202	59670676	BolC4t27804H	0	-	447	474	474	1.0000000
C4	59672990	59673593	BolC4t27805H	0	+	187	603	603	1.0000000
C4	59674175	59675318	BolC4t27806H	0	+	311	1143	1143	1.0000000
C4	59677494	59677884	BolC4t27807H	0	+	128	390	390	1.0000000
C4	59686878	59687474	BolC4t27808H	0	+	163	505	596	0.8473154
C4	59691319	59691610	BolC4t27809H	0	-	1	109	291	0.3745705
C4	59706335	59708123	BolC4t27810H	0	+	1429	1788	1788	1.0000000
C4	59708285	59708694	BolC4t27811H	0	+	398	409	409	1.0000000
C4	59709304	59710423	BolC4t27812H	0	-	799	874	1119	0.7810545
C4	59714325	59714836	BolC4t27813H	0	+	181	511	511	1.0000000
C4	59717094	59717993	BolC4t27814H	0	-	1125	899	899	1.0000000
C4	59718863	59719536	BolC4t27815H	0	+	396	673	673	1.0000000
C4	59720714	59721515	BolC4t27816H	0	-	285	801	801	1.0000000
C4	59724525	59724969	BolC4t27817H	0	-	35	440	444	0.9909910
C4	59726080	59728719	BolC4t27818H	0	-	510	2504	2639	0.9488443
C4	59739808	59741185	BolC4t27819H	0	+	218	1370	1377	0.9949165
C4	59748939	59749688	BolC4t27820H	0	-	52	211	749	0.2817090
C4	59753211	59753673	BolC4t27821H	0	+	24	196	462	0.4242424
C4	59765518	59769145	BolC4t27822H	0	-	4248	3627	3627	1.0000000
C4	59778275	59779377	BolC4t27823H	0	-	174	1003	1102	0.9101633
C4	59781537	59785581	BolC4t27824H	0	-	1725	3712	4044	0.9179031
C4	59789532	59790765	BolC4t27825H	0	-	101	694	1233	0.5628548
C4	59800130	59801533	BolC4t27826H	0	+	450	1403	1403	1.0000000
C4	59803479	59803986	BolC4t27827H	0	-	24	100	507	0.1972387
C4	59807699	59808646	BolC4t27828H	0	+	376	914	947	0.9651531
C4	59809616	59811125	BolC4t27829H	0	-	248	930	1509	0.6163022
C4	59820013	59821761	BolC4t27830H	0	+	275	1479	1748	0.8461099
C4	59823128	59825120	BolC4t27831H	0	+	726	1992	1992	1.0000000
C4	59825612	59830167	BolC4t27832H	0	-	1499	4147	4555	0.9104281
C4	59832281	59834322	BolC4t27833H	0	+	1470	2041	2041	1.0000000
C4	59836255	59837317	BolC4t27834H	0	-	551	1062	1062	1.0000000
C4	59846141	59846351	BolC4t27835H	0	+	229	210	210	1.0000000
C4	59846683	59847520	BolC4t27836H	0	-	321	837	837	1.0000000
C4	59848425	59848851	BolC4t27837H	0	-	39	316	426	0.7417840
C4	59854836	59856941	BolC4t27838H	0	+	389	1485	2105	0.7054632
C4	59858458	59860940	BolC4t27839H	0	+	1173	2397	2482	0.9657534
C4	59861657	59862746	BolC4t27840H	0	+	809	1089	1089	1.0000000
C4	59863235	59863553	BolC4t27841H	0	+	161	318	318	1.0000000
C4	59869796	59870600	BolC4t27842H	0	-	60	650	804	0.8084577
C4	59874441	59875008	BolC4t27843H	0	+	373	567	567	1.0000000
C4	59875297	59876743	BolC4t27844H	0	-	1748	1446	1446	1.0000000
C4	59876964	59877958	BolC4t27845H	0	+	427	994	994	1.0000000
C4	59879217	59880373	BolC4t27846H	0	-	2092	1156	1156	1.0000000
C4	59883404	59886050	BolC4t27847H	0	+	1284	2603	2646	0.9837490
C4	59886372	59887730	BolC4t27848H	0	-	649	1339	1358	0.9860088
C4	59888309	59889555	BolC4t27849H	0	-	1004	1246	1246	1.0000000
C4	59892022	59892559	BolC4t27850H	0	+	39	376	537	0.7001862
C4	59905030	59906536	BolC4t27851H	0	-	1131	1504	1506	0.9986720
C4	59908295	59908736	BolC4t27852H	0	-	445	441	441	1.0000000
C4	59909606	59910610	BolC4t27853H	0	-	224	675	1004	0.6723108
C4	59911060	59911447	BolC4t27854H	0	+	324	387	387	1.0000000
C4	59933467	59935302	BolC4t27855H	0	+	651	1633	1835	0.8899183
C4	59942332	59943058	BolC4t27856H	0	-	630	726	726	1.0000000
C4	59949111	59949597	BolC4t27857H	0	-	660	486	486	1.0000000
C4	59950791	59951049	BolC4t27858H	0	-	41	168	258	0.6511628
C4	59953309	59953763	BolC4t27859H	0	+	778	454	454	1.0000000
C4	59957400	59958246	BolC4t27860H	0	+	607	846	846	1.0000000
C4	59964436	59964757	BolC4t27861H	0	+	79	321	321	1.0000000
C4	59973064	59974666	BolC4t27862H	0	-	84	1176	1602	0.7340824
C4	59986990	59987383	BolC4t27863H	0	-	0	0	393	0.0000000
C4	59989760	59993790	BolC4t27864H	0	-	1319	3901	4030	0.9679901
C4	60008918	60011106	BolC4t27865H	0	+	1412	1815	2188	0.8295247
C4	60011462	60012687	BolC4t27866H	0	-	399	1212	1225	0.9893878
C4	60017924	60018197	BolC4t27867H	0	+	11	162	273	0.5934066
C4	60024270	60025746	BolC4t27868H	0	+	1004	1476	1476	1.0000000
C4	60027165	60028208	BolC4t27869H	0	+	866	1043	1043	1.0000000
C4	60030925	60032113	BolC4t27870H	0	+	149	1108	1188	0.9326599
C4	60032814	60037478	BolC4t27871H	0	+	2866	4630	4664	0.9927101
C4	60037764	60041144	BolC4t27872H	0	-	1757	2984	3380	0.8828402
C4	60042887	60043055	BolC4t27873H	0	+	100	168	168	1.0000000
C4	60068354	60069263	BolC4t27874H	0	-	378	909	909	1.0000000
C4	60070285	60071197	BolC4t27875H	0	+	247	912	912	1.0000000
C4	60079904	60082556	BolC4t27876H	0	-	1919	2652	2652	1.0000000
C4	60093479	60094889	BolC4t27877H	0	-	800	1410	1410	1.0000000
C4	60102527	60108454	BolC4t27878H	0	-	1996	4747	5927	0.8009111
C4	60110115	60111916	BolC4t27879H	0	+	622	1801	1801	1.0000000
C4	60112593	60113728	BolC4t27880H	0	+	293	1125	1135	0.9911894
C4	60114872	60118560	BolC4t27881H	0	-	622	3293	3688	0.8928959
C4	60123795	60124644	BolC4t27882H	0	+	207	738	849	0.8692579
C4	60125237	60127689	BolC4t27883H	0	-	1382	2452	2452	1.0000000
C4	60136363	60136504	BolC4t27884H	0	-	114	141	141	1.0000000
C4	60137894	60138152	BolC4t27885H	0	+	284	258	258	1.0000000
C4	60146993	60154668	BolC4t27886H	0	+	2390	6741	7675	0.8783062
C4	60155097	60156810	BolC4t27887H	0	-	137	1498	1713	0.8744892
C4	60157865	60159304	BolC4t27888H	0	+	385	1268	1439	0.8811675
C4	60162444	60163822	BolC4t27889H	0	+	367	1353	1378	0.9818578
C4	60164211	60165398	BolC4t27890H	0	-	907	1187	1187	1.0000000
C4	60167664	60172791	BolC4t27891H	0	+	816	3516	5127	0.6857812
C4	60173130	60173295	BolC4t27892H	0	-	74	165	165	1.0000000
C4	60173353	60174306	BolC4t27893H	0	-	533	953	953	1.0000000
C4	60173542	60174617	BolC4t27894H	0	-	639	1075	1075	1.0000000
C4	60177856	60182116	BolC4t27895H	0	+	1853	3830	4260	0.8990610
C4	60183898	60184309	BolC4t27896H	0	-	0	0	411	0.0000000
C4	60185610	60186469	BolC4t27897H	0	-	263	759	859	0.8835856
C4	60192439	60194071	BolC4t27898H	0	+	647	1632	1632	1.0000000
C4	60196302	60198180	BolC4t27899H	0	+	654	1657	1878	0.8823216
C4	60199549	60199852	BolC4t27900H	0	+	89	267	303	0.8811881
C4	60201787	60202816	BolC4t27901H	0	+	179	843	1029	0.8192420
C4	60203518	60204523	BolC4t27902H	0	-	9	648	1005	0.6447761
C4	60204861	60206733	BolC4t27903H	0	-	424	1819	1872	0.9716880
C4	60210647	60212215	BolC4t27904H	0	-	147	1308	1568	0.8341837
C4	60223252	60223628	BolC4t27905H	0	-	2	38	376	0.1010638
C4	60226717	60228602	BolC4t27906H	0	-	78	1239	1885	0.6572945
C4	60231659	60232697	BolC4t27907H	0	+	328	871	1038	0.8391137
C4	60243806	60247115	BolC4t27908H	0	-	421	2697	3309	0.8150499
C4	60270196	60271060	BolC4t27909H	0	+	40	395	864	0.4571759
C4	60274570	60274939	BolC4t27910H	0	-	100	356	369	0.9647697
C4	60275882	60278335	BolC4t27911H	0	-	607	2279	2453	0.9290664
C4	60282110	60282683	BolC4t27912H	0	-	8	25	573	0.0436300
C4	60294268	60294724	BolC4t27913H	0	-	4	325	456	0.7127193
C4	60294874	60295763	BolC4t27914H	0	-	40	719	889	0.8087739
C4	60296534	60296759	BolC4t27915H	0	-	0	0	225	0.0000000
C4	60297916	60299217	BolC4t27916H	0	+	122	1155	1301	0.8877786
C4	60299358	60300366	BolC4t27917H	0	-	53	370	1008	0.3670635
C4	60302172	60302802	BolC4t27918H	0	-	279	630	630	1.0000000
C4	60305091	60306934	BolC4t27919H	0	+	375	1550	1843	0.8410200
C4	60307249	60309375	BolC4t27920H	0	-	238	1758	2126	0.8269050
C4	60310935	60320333	BolC4t27921H	0	-	3647	9182	9398	0.9770164
C4	60313355	60314816	BolC4t27922H	0	+	836	1351	1461	0.9247091
C4	60315325	60316786	BolC4t27923H	0	-	373	1356	1461	0.9281314
C4	60326903	60328218	BolC4t27924H	0	+	795	1234	1315	0.9384031
C4	60328395	60330529	BolC4t27925H	0	-	475	2018	2134	0.9456420
C4	60337644	60340932	BolC4t27926H	0	-	2738	3279	3288	0.9972628
C4	60344056	60344317	BolC4t27927H	0	-	28	261	261	1.0000000
C4	60349483	60350818	BolC4t27928H	0	+	127	1145	1335	0.8576779
C4	60351149	60354187	BolC4t27929H	0	-	312	2329	3038	0.7666228
C4	60357446	60360041	BolC4t27930H	0	-	756	2257	2595	0.8697495
C4	60364557	60365844	BolC4t27931H	0	+	88	426	1287	0.3310023
C4	60370382	60371848	BolC4t27932H	0	-	183	363	1466	0.2476126
C4	60410713	60411255	BolC4t27933H	0	-	7	264	542	0.4870849
C4	60412467	60412922	BolC4t27934H	0	-	1	50	455	0.1098901
C4	60415007	60416224	BolC4t27935H	0	-	58	783	1217	0.6433854
C4	60419657	60421582	BolC4t27936H	0	+	887	1925	1925	1.0000000
C4	60435350	60436551	BolC4t27937H	0	+	660	1201	1201	1.0000000
C4	60443885	60444707	BolC4t27938H	0	+	157	745	822	0.9063261
C4	60446219	60453370	BolC4t27939H	0	+	3269	7004	7151	0.9794434
C4	60453832	60455600	BolC4t27940H	0	+	656	1465	1768	0.8286199
C4	60455936	60457385	BolC4t27941H	0	-	1306	1449	1449	1.0000000
C4	60464200	60464418	BolC4t27942H	0	-	21	148	218	0.6788991
C4	60467863	60468445	BolC4t27943H	0	+	72	205	582	0.3522337
C4	60493553	60496935	BolC4t27944H	0	-	532	2775	3382	0.8205204
C4	60502845	60505618	BolC4t27945H	0	+	635	2704	2773	0.9751172
C4	60506052	60506620	BolC4t27946H	0	-	48	407	568	0.7165493
C4	60506923	60508346	BolC4t27947H	0	-	66	426	1423	0.2993675
C4	60509784	60509955	BolC4t27948H	0	-	137	171	171	1.0000000
C4	60518928	60521401	BolC4t27949H	0	-	397	2024	2473	0.8184391
C4	60523337	60523487	BolC4t27950H	0	-	221	150	150	1.0000000
C4	60531948	60532671	BolC4t27951H	0	+	226	723	723	1.0000000
C4	60533809	60534218	BolC4t27952H	0	+	385	409	409	1.0000000
C4	60534506	60536829	BolC4t27953H	0	-	565	1907	2323	0.8209212
C4	60547082	60549310	BolC4t27954H	0	-	812	2061	2228	0.9250449
C4	60550155	60551139	BolC4t27955H	0	+	848	984	984	1.0000000
C4	60552503	60555551	BolC4t27956H	0	+	1936	3048	3048	1.0000000
C4	60556249	60557390	BolC4t27957H	0	+	1000	1141	1141	1.0000000
C4	60557612	60560452	BolC4t27958H	0	-	1544	2744	2840	0.9661972
C4	60561928	60564100	BolC4t27959H	0	-	1376	2172	2172	1.0000000
C4	60565318	60567576	BolC4t27960H	0	+	1507	2197	2258	0.9729850
C4	60568536	60568899	BolC4t27961H	0	+	619	363	363	1.0000000
C4	60572762	60574926	BolC4t27962H	0	+	977	2129	2164	0.9838262
C4	60584980	60593366	BolC4t27963H	0	+	4723	8382	8386	0.9995230
C4	60590150	60590565	BolC4t27964H	0	-	122	415	415	1.0000000
C4	60594576	60596554	BolC4t27965H	0	-	478	1681	1978	0.8498483
C4	60597410	60598275	BolC4t27966H	0	-	393	865	865	1.0000000
C4	60601553	60604105	BolC4t27967H	0	+	347	1632	2552	0.6394984
C4	60606164	60607180	BolC4t27968H	0	-	989	1016	1016	1.0000000
C4	60617902	60618091	BolC4t27969H	0	-	2	129	189	0.6825397
C4	60618142	60618668	BolC4t27970H	0	+	2	47	526	0.0893536
C4	60621777	60622380	BolC4t27971H	0	-	26	424	603	0.7031509
C4	60625297	60625495	BolC4t27972H	0	-	70	198	198	1.0000000
C4	60633206	60635735	BolC4t27973H	0	-	262	2268	2529	0.8967972
C4	60637775	60638153	BolC4t27974H	0	-	0	0	378	0.0000000
C4	60658638	60659877	BolC4t27975H	0	-	142	1174	1239	0.9475383
C4	60672935	60675563	BolC4t27976H	0	-	465	2360	2628	0.8980213
C4	60679124	60679439	BolC4t27977H	0	+	75	312	315	0.9904762
C4	60703834	60704455	BolC4t27978H	0	+	141	362	621	0.5829307
C4	60710210	60710549	BolC4t27979H	0	+	18	230	339	0.6784661
C4	60717240	60717839	BolC4t27980H	0	+	395	599	599	1.0000000
C4	60718373	60719057	BolC4t27981H	0	+	14	283	684	0.4137427
C4	60721633	60723352	BolC4t27982H	0	-	128	1345	1719	0.7824317
C4	60728980	60730078	BolC4t27983H	0	+	264	1080	1098	0.9836066
C4	60731332	60733790	BolC4t27984H	0	+	773	2436	2458	0.9910496
C4	60734628	60735811	BolC4t27985H	0	+	177	791	1183	0.6686391
C4	60736858	60740194	BolC4t27986H	0	+	1922	3214	3336	0.9634293
C4	60740668	60742370	BolC4t27987H	0	-	259	1547	1702	0.9089307
C4	60745331	60745892	BolC4t27988H	0	+	93	248	561	0.4420677
C4	60757768	60758545	BolC4t27989H	0	-	72	679	777	0.8738739
C4	60762405	60762519	BolC4t27990H	0	-	86	114	114	1.0000000
C4	60780527	60783851	BolC4t27991H	0	-	2060	3028	3324	0.9109507
C4	60785219	60785369	BolC4t27992H	0	+	8	28	150	0.1866667
C4	60799925	60806347	BolC4t27993H	0	+	3607	5736	6422	0.8931797
C4	60815680	60816467	BolC4t27994H	0	-	1048	787	787	1.0000000
C4	60817921	60818653	BolC4t27995H	0	-	375	658	732	0.8989071
C4	60820568	60821420	BolC4t27996H	0	-	590	852	852	1.0000000
C4	60821869	60822863	BolC4t27997H	0	-	630	994	994	1.0000000
C4	60824191	60827150	BolC4t27998H	0	+	1969	2886	2959	0.9753295
C4	60829150	60829942	BolC4t27999H	0	+	656	792	792	1.0000000
C4	60830888	60834190	BolC4t28000H	0	-	1122	2634	3302	0.7976984
C4	60837517	60842674	BolC4t28001H	0	-	2653	4657	5157	0.9030444
C4	60844186	60844558	BolC4t28002H	0	-	173	372	372	1.0000000
C4	60849258	60849630	BolC4t28003H	0	-	4	15	372	0.0403226
C4	60858349	60859117	BolC4t28004H	0	+	48	563	768	0.7330729
C4	60862646	60864377	BolC4t28005H	0	-	638	1710	1731	0.9878683
C4	60865717	60867202	BolC4t28006H	0	-	376	1485	1485	1.0000000
C4	60871283	60872116	BolC4t28007H	0	+	678	833	833	1.0000000
C4	60872400	60873120	BolC4t28008H	0	-	414	720	720	1.0000000
C4	60875020	60875236	BolC4t28009H	0	-	95	199	216	0.9212963
C4	60898417	60901638	BolC4t28010H	0	-	1788	3221	3221	1.0000000
C4	60910968	60911843	BolC4t28011H	0	+	849	875	875	1.0000000
C4	60918032	60921276	BolC4t28012H	0	-	2272	3244	3244	1.0000000
C4	60923352	60923580	BolC4t28013H	0	-	401	215	228	0.9429824
C4	60933330	60934491	BolC4t28014H	0	-	1005	1161	1161	1.0000000
C4	60936066	60936701	BolC4t28015H	0	+	435	635	635	1.0000000
C4	60943170	60946878	BolC4t28016H	0	+	509	1852	3708	0.4994606
C4	60967736	60969569	BolC4t28017H	0	+	1964	1676	1833	0.9143481
C4	60969906	60974573	BolC4t28018H	0	+	2457	3691	4667	0.7908721
C4	60974650	60978287	BolC4t28019H	0	-	1696	2200	3637	0.6048942
C4	60990806	60997955	BolC4t28020H	0	+	2289	5346	7149	0.7477969
C4	61003285	61005500	BolC4t28021H	0	-	1531	2089	2215	0.9431151
C4	61014441	61015252	BolC4t28022H	0	+	367	759	811	0.9358816
C4	61026308	61027378	BolC4t28023H	0	+	640	1070	1070	1.0000000
C4	61033064	61033271	BolC4t28024H	0	+	91	207	207	1.0000000
C4	61036623	61038503	BolC4t28025H	0	-	239	1534	1880	0.8159574
C4	61045433	61047967	BolC4t28026H	0	+	565	1853	2534	0.7312549
C4	61056803	61058407	BolC4t28027H	0	+	250	1025	1604	0.6390274
C4	61067411	61077174	BolC4t28028H	0	-	5142	7708	9763	0.7895114
C4	61077328	61079160	BolC4t28029H	0	-	374	1629	1832	0.8891922
C4	61080496	61084771	BolC4t28030H	0	-	1484	4007	4275	0.9373099
C4	61087552	61089199	BolC4t28031H	0	+	90	1101	1647	0.6684881
C4	61093387	61096200	BolC4t28032H	0	-	364	2456	2813	0.8730893
C4	61099316	61100491	BolC4t28033H	0	+	382	797	1175	0.6782979
C4	61102202	61103576	BolC4t28034H	0	-	469	1368	1374	0.9956332
C4	61123009	61125287	BolC4t28035H	0	+	874	2115	2278	0.9284460
C4	61130898	61136464	BolC4t28036H	0	-	1424	5039	5566	0.9053180
C4	61140461	61141949	BolC4t28037H	0	-	163	1157	1488	0.7775537
C4	61143368	61144859	BolC4t28038H	0	-	108	974	1491	0.6532528
C4	61145405	61145960	BolC4t28039H	0	-	305	463	555	0.8342342
C4	61146471	61159352	BolC4t28040H	0	-	2173	9670	12881	0.7507181
C4	61166008	61167140	BolC4t28041H	0	+	12	280	1132	0.2473498
C4	61173177	61175045	BolC4t28042H	0	-	276	1408	1868	0.7537473
C4	61178603	61180265	BolC4t28043H	0	-	1243	1123	1662	0.6756920
C4	61182471	61183644	BolC4t28044H	0	-	784	1173	1173	1.0000000
C4	61193470	61195022	BolC4t28045H	0	+	186	1273	1552	0.8202320
C4	61197206	61198411	BolC4t28046H	0	-	446	1091	1205	0.9053942
C4	61198802	61198961	BolC4t28047H	0	-	41	99	159	0.6226415
C4	61211433	61212141	BolC4t28048H	0	-	24	546	708	0.7711864
C4	61221348	61226902	BolC4t28049H	0	+	884	4279	5554	0.7704358
C4	61235177	61236698	BolC4t28050H	0	+	410	1383	1521	0.9092702
C4	61248315	61252085	BolC4t28051H	0	+	1185	2802	3770	0.7432361
C4	61254682	61255382	BolC4t28052H	0	-	1	67	700	0.0957143
C4	61266711	61266930	BolC4t28053H	0	+	267	178	219	0.8127854
C4	61270172	61270334	BolC4t28054H	0	-	11	64	162	0.3950617
C4	61271778	61274851	BolC4t28055H	0	-	969	2678	3073	0.8714611
C4	61275543	61276380	BolC4t28056H	0	-	175	670	837	0.8004779
C4	61280669	61281026	BolC4t28057H	0	+	30	329	357	0.9215686
C4	61281694	61282315	BolC4t28058H	0	-	295	196	621	0.3156200
C4	61285058	61287610	BolC4t28059H	0	-	245	1905	2552	0.7464734
C4	61295419	61296767	BolC4t28060H	0	+	890	1322	1348	0.9807122
C4	61298252	61300413	BolC4t28061H	0	+	1639	2066	2161	0.9560389
C4	61316120	61318148	BolC4t28062H	0	+	8	420	2028	0.2071006
C4	61317330	61317831	BolC4t28063H	0	-	7	188	501	0.3752495
C4	61322441	61322966	BolC4t28064H	0	+	486	525	525	1.0000000
C4	61323810	61326334	BolC4t28065H	0	+	595	1495	2524	0.5923138
C4	61327363	61328230	BolC4t28066H	0	-	472	867	867	1.0000000
C4	61330362	61331035	BolC4t28067H	0	+	238	414	673	0.6151560
C4	61336348	61338022	BolC4t28068H	0	+	366	1522	1674	0.9091995
C4	61339687	61341406	BolC4t28069H	0	-	352	1280	1719	0.7446190
C4	61345095	61345769	BolC4t28070H	0	-	325	650	674	0.9643917
C4	61345852	61346123	BolC4t28071H	0	-	65	271	271	1.0000000
C4	61350241	61352554	BolC4t28072H	0	-	80	1511	2313	0.6532642
C4	61355766	61356267	BolC4t28073H	0	-	58	342	501	0.6826347
C4	61357810	61358557	BolC4t28074H	0	-	207	744	747	0.9959840
C4	61359492	61362354	BolC4t28075H	0	-	30	893	2862	0.3120196
C4	61370097	61371297	BolC4t28076H	0	-	359	1200	1200	1.0000000
C4	61372594	61373803	BolC4t28077H	0	+	134	1170	1209	0.9677419
C4	61375835	61376312	BolC4t28078H	0	-	0	0	477	0.0000000
C4	61381401	61381527	BolC4t28079H	0	+	38	43	126	0.3412699
C4	61382249	61383408	BolC4t28080H	0	-	507	926	1159	0.7989646
C4	61385403	61393408	BolC4t28081H	0	+	2646	7300	8005	0.9119300
C4	61394049	61394947	BolC4t28082H	0	-	1055	898	898	1.0000000
C4	61401451	61401703	BolC4t28083H	0	-	201	252	252	1.0000000
C4	61402550	61404512	BolC4t28084H	0	-	795	1937	1962	0.9872579
C4	61404650	61406162	BolC4t28085H	0	+	623	1512	1512	1.0000000
C4	61407024	61408023	BolC4t28086H	0	+	203	936	999	0.9369369
C4	61408827	61411053	BolC4t28087H	0	-	94	1412	2226	0.6343216
C4	61424895	61429340	BolC4t28088H	0	+	1346	4112	4445	0.9250844
C4	61430424	61430595	BolC4t28089H	0	+	18	139	171	0.8128655
C4	61430734	61430926	BolC4t28090H	0	-	191	192	192	1.0000000
C4	61434792	61436203	BolC4t28091H	0	+	671	1411	1411	1.0000000
C4	61437001	61437985	BolC4t28092H	0	-	1167	984	984	1.0000000
C4	61438814	61444227	BolC4t28093H	0	+	2047	4999	5413	0.9235175
C4	61446253	61446796	BolC4t28094H	0	+	39	328	543	0.6040516
C4	61461571	61464367	BolC4t28095H	0	+	583	2521	2796	0.9016452
C4	61465617	61467747	BolC4t28096H	0	-	1213	2130	2130	1.0000000
C4	61476852	61479456	BolC4t28097H	0	-	607	1827	2604	0.7016129
C4	61487794	61489583	BolC4t28098H	0	-	598	1610	1789	0.8999441
C4	61491161	61492019	BolC4t28099H	0	+	316	825	858	0.9615384
C4	61492295	61495339	BolC4t28100H	0	-	1369	2507	3044	0.8235874
C4	61496148	61500500	BolC4t28101H	0	-	2182	4036	4352	0.9273897
C4	61502236	61503371	BolC4t28102H	0	+	622	1135	1135	1.0000000
C4	61504136	61504397	BolC4t28103H	0	+	335	261	261	1.0000000
C4	61507883	61508218	BolC4t28104H	0	+	272	335	335	1.0000000
C4	61508354	61508606	BolC4t28105H	0	+	242	252	252	1.0000000
C4	61516789	61517470	BolC4t28106H	0	+	368	681	681	1.0000000
C4	61518900	61521480	BolC4t28107H	0	+	138	730	2580	0.2829457
C4	61523438	61524713	BolC4t28108H	0	+	488	945	1275	0.7411765
C4	61534839	61535397	BolC4t28109H	0	-	368	558	558	1.0000000
C4	61535873	61536472	BolC4t28110H	0	-	425	599	599	1.0000000
C4	61537066	61537744	BolC4t28111H	0	-	167	678	678	1.0000000
C4	61540543	61540903	BolC4t28112H	0	-	3	77	360	0.2138889
C4	61543080	61544370	BolC4t28113H	0	+	221	1014	1290	0.7860465
C4	61551483	61553089	BolC4t28114H	0	-	1125	1606	1606	1.0000000
C4	61556536	61559915	BolC4t28115H	0	-	1057	3226	3379	0.9547203
C4	61562162	61565937	BolC4t28116H	0	-	1853	3604	3775	0.9547020
C4	61566427	61569868	BolC4t28117H	0	+	1801	3316	3441	0.9636734
C4	61570166	61575501	BolC4t28118H	0	-	2036	5136	5335	0.9626992
C4	61587949	61591344	BolC4t28119H	0	-	2449	3292	3395	0.9696613
C4	61602629	61603526	BolC4t28120H	0	-	745	897	897	1.0000000
C4	61617423	61617903	BolC4t28121H	0	+	482	480	480	1.0000000
C4	61626308	61626671	BolC4t28122H	0	-	398	363	363	1.0000000
C4	61630651	61631721	BolC4t28123H	0	+	113	1070	1070	1.0000000
C4	61638618	61639269	BolC4t28124H	0	-	219	651	651	1.0000000
C4	61640123	61640309	BolC4t28125H	0	+	187	186	186	1.0000000
C4	61643923	61644319	BolC4t28126H	0	-	192	396	396	1.0000000
C4	61652344	61652629	BolC4t28127H	0	+	254	285	285	1.0000000
C4	61653050	61653410	BolC4t28128H	0	+	340	360	360	1.0000000
C4	61654759	61655512	BolC4t28129H	0	+	72	586	753	0.7782205
C4	61656048	61657555	BolC4t28130H	0	-	353	1386	1507	0.9197080
C4	61658719	61659043	BolC4t28131H	0	+	615	324	324	1.0000000
C4	61661226	61662690	BolC4t28132H	0	+	575	1276	1464	0.8715847
C4	61665201	61667190	BolC4t28133H	0	+	1866	1989	1989	1.0000000
C4	61668376	61669710	BolC4t28134H	0	+	791	1280	1334	0.9595202
C4	61671357	61675969	BolC4t28135H	0	-	1391	3932	4612	0.8525586
C4	61676744	61678072	BolC4t28136H	0	-	383	1143	1328	0.8606928
C4	61678547	61680851	BolC4t28137H	0	-	798	2296	2304	0.9965278
C4	61682724	61683480	BolC4t28138H	0	+	154	659	756	0.8716931
C4	61683671	61688596	BolC4t28139H	0	-	1673	4393	4925	0.8919797
C4	61695982	61697868	BolC4t28140H	0	+	922	1886	1886	1.0000000
C4	61698930	61702296	BolC4t28141H	0	+	1151	3279	3366	0.9741533
C4	61702688	61703562	BolC4t28142H	0	-	142	549	874	0.6281465
C4	61705752	61708878	BolC4t28143H	0	-	939	2806	3126	0.8976328
C4	61714442	61716194	BolC4t28144H	0	+	578	1597	1752	0.9115297
C4	61719319	61722391	BolC4t28145H	0	+	919	2289	3072	0.7451172
C4	61727148	61727451	BolC4t28146H	0	-	8	279	303	0.9207921
C4	61736458	61738179	BolC4t28147H	0	+	828	1702	1721	0.9889599
C4	61742866	61745925	BolC4t28148H	0	-	1171	1938	3059	0.6335404
C4	61794603	61798210	BolC4t28149H	0	+	601	2926	3607	0.8112004
C4	61800585	61802443	BolC4t28150H	0	-	1210	1858	1858	1.0000000
C4	61803398	61807030	BolC4t28151H	0	-	1335	3504	3632	0.9647577
C4	61815508	61833996	BolC4t28152H	0	+	9270	16591	18488	0.8973929
C4	61824436	61824817	BolC4t28153H	0	-	312	381	381	1.0000000
C4	61834210	61835143	BolC4t28154H	0	+	305	769	933	0.8242229
C4	61837400	61839374	BolC4t28155H	0	-	1570	1941	1974	0.9832827
C4	61848639	61853300	BolC4t28156H	0	-	1962	4613	4661	0.9897018
C4	61855433	61858467	BolC4t28157H	0	-	1284	2662	3034	0.8773896
C4	61861407	61864913	BolC4t28158H	0	+	3192	3506	3506	1.0000000
C4	61866833	61868816	BolC4t28159H	0	-	1267	1983	1983	1.0000000
C4	61873629	61874058	BolC4t28160H	0	-	192	426	429	0.9930070
C4	61874196	61875109	BolC4t28161H	0	-	572	913	913	1.0000000
C4	61877574	61877724	BolC4t28162H	0	+	14	150	150	1.0000000
C4	61882002	61882617	BolC4t28163H	0	+	184	571	615	0.9284553
C4	61886484	61889111	BolC4t28164H	0	+	236	1652	2627	0.6288542
C4	61893147	61893309	BolC4t28165H	0	+	217	162	162	1.0000000
C4	61896436	61898788	BolC4t28166H	0	-	1481	2317	2352	0.9851190
C4	61905195	61907586	BolC4t28167H	0	+	12	493	2391	0.2061899
C4	61916999	61918832	BolC4t28168H	0	-	1398	1775	1833	0.9683579
C4	61922838	61924718	BolC4t28169H	0	+	202	1521	1880	0.8090426
C4	61930057	61931683	BolC4t28170H	0	+	975	1538	1626	0.9458795
C4	61933672	61935867	BolC4t28171H	0	+	723	2091	2195	0.9526196
C4	61936372	61939565	BolC4t28172H	0	-	3257	3193	3193	1.0000000
C4	61942341	61944112	BolC4t28173H	0	+	920	1771	1771	1.0000000
C4	61944458	61945314	BolC4t28174H	0	-	544	856	856	1.0000000
C4	61954720	61956169	BolC4t28175H	0	+	539	1144	1449	0.7895100
C4	61966129	61966495	BolC4t28176H	0	+	100	254	366	0.6939891
C4	61973273	61973633	BolC4t28177H	0	+	110	355	360	0.9861111
C4	61976646	61977246	BolC4t28178H	0	+	743	600	600	1.0000000
C4	61979387	61979607	BolC4t28179H	0	-	194	220	220	1.0000000
C4	61980318	61981120	BolC4t28180H	0	-	427	694	802	0.8653367
C4	61983922	61986666	BolC4t28181H	0	-	626	2292	2744	0.8352770
C4	61987519	61988979	BolC4t28182H	0	+	449	1436	1460	0.9835616
C4	61990883	61994336	BolC4t28183H	0	+	707	2931	3453	0.8488271
C4	61994880	61996065	BolC4t28184H	0	-	438	1059	1185	0.8936709
C4	61997022	62000078	BolC4t28185H	0	+	1486	2959	3056	0.9682592
C4	62000430	62001764	BolC4t28186H	0	-	1162	1316	1334	0.9865068
C4	62002737	62004618	BolC4t28187H	0	-	1249	1651	1881	0.8777246
C4	62006226	62008236	BolC4t28188H	0	-	758	1881	2010	0.9358209
C4	62011329	62012880	BolC4t28189H	0	+	488	1531	1551	0.9871051
C4	62013802	62016193	BolC4t28190H	0	+	1890	2391	2391	1.0000000
C4	62016669	62023006	BolC4t28191H	0	-	1079	3619	6337	0.5710904
C4	62030211	62032855	BolC4t28192H	0	+	128	2178	2644	0.8237519
C4	62034725	62038384	BolC4t28193H	0	+	399	3252	3659	0.8887674
C4	62039229	62039424	BolC4t28194H	0	-	0	0	195	0.0000000
C4	62041320	62041473	BolC4t28195H	0	-	1	117	153	0.7647059
C4	62047977	62048145	BolC4t28196H	0	-	23	167	168	0.9940476
C4	62048692	62048944	BolC4t28197H	0	-	1	34	252	0.1349206
C4	62050749	62052005	BolC4t28198H	0	-	44	723	1256	0.5756369
C4	62052453	62053048	BolC4t28199H	0	-	197	595	595	1.0000000
C4	62055318	62056438	BolC4t28200H	0	-	111	503	1120	0.4491071
C4	62072222	62073812	BolC4t28201H	0	+	346	1277	1590	0.8031446
C4	62075212	62075344	BolC4t28202H	0	+	101	132	132	1.0000000
C4	62076179	62077424	BolC4t28203H	0	-	334	996	1245	0.8000000
C4	62081946	62083000	BolC4t28204H	0	-	135	722	1054	0.6850095
C4	62084727	62086024	BolC4t28205H	0	+	590	1297	1297	1.0000000
C4	62087135	62088783	BolC4t28206H	0	+	139	936	1648	0.5679612
C4	62089505	62090699	BolC4t28207H	0	+	139	710	1194	0.5946398
C4	62090895	62094345	BolC4t28208H	0	-	1699	2628	3450	0.7617391
C4	62096807	62096915	BolC4t28209H	0	-	187	108	108	1.0000000
C4	62105496	62109873	BolC4t28210H	0	-	710	2611	4377	0.5965273
C4	62126494	62128652	BolC4t28211H	0	-	172	1088	2158	0.5041705
C4	62131959	62135090	BolC4t28212H	0	-	2194	3131	3131	1.0000000
C4	62142073	62142502	BolC4t28213H	0	+	26	299	429	0.6969697
C4	62142661	62143017	BolC4t28214H	0	+	31	274	356	0.7696629
C4	62143379	62147437	BolC4t28215H	0	-	340	1770	4058	0.4361755
C4	62147969	62148653	BolC4t28216H	0	+	210	684	684	1.0000000
C4	62149081	62151331	BolC4t28217H	0	-	1820	2185	2250	0.9711111
C4	62158416	62160534	BolC4t28218H	0	-	1369	2060	2118	0.9726157
C4	62160605	62161186	BolC4t28219H	0	-	116	453	581	0.7796902
C4	62165929	62170788	BolC4t28220H	0	+	2018	4638	4859	0.9545174
C4	62172906	62175785	BolC4t28221H	0	-	241	1498	2879	0.5203196
C4	62180823	62181762	BolC4t28222H	0	-	168	785	939	0.8359957
C4	62183205	62185095	BolC4t28223H	0	-	400	1277	1890	0.6756614
C4	62187670	62188137	BolC4t28224H	0	-	644	467	467	1.0000000
C4	62189468	62195999	BolC4t28225H	0	+	1271	5068	6531	0.7759914
C4	62199143	62201486	BolC4t28226H	0	+	902	2341	2343	0.9991464
C4	62201902	62202832	BolC4t28227H	0	+	86	751	930	0.8075269
C4	62203299	62203997	BolC4t28228H	0	-	57	279	698	0.3997135
C4	62206605	62207828	BolC4t28229H	0	-	1091	1223	1223	1.0000000
C4	62208673	62210340	BolC4t28230H	0	-	627	1506	1667	0.9034193
C4	62210532	62211757	BolC4t28231H	0	+	787	1225	1225	1.0000000
C4	62218433	62219371	BolC4t28232H	0	-	6	138	938	0.1471215
C4	62223484	62223750	BolC4t28233H	0	-	191	148	266	0.5563910
C4	62225015	62225304	BolC4t28234H	0	+	148	289	289	1.0000000
C4	62226016	62226568	BolC4t28235H	0	-	7	127	552	0.2300725
C4	62231178	62231361	BolC4t28236H	0	+	1	101	183	0.5519125
C4	62235302	62236390	BolC4t28237H	0	-	4	308	1088	0.2830882
C4	62240159	62241156	BolC4t28238H	0	-	46	487	997	0.4884654
C4	62242612	62243753	BolC4t28239H	0	-	426	1005	1141	0.8808063
C4	62247886	62248549	BolC4t28240H	0	-	148	520	663	0.7843137
C4	62250971	62252679	BolC4t28241H	0	+	342	1617	1708	0.9467213
C4	62253987	62260366	BolC4t28242H	0	+	1667	4759	6379	0.7460417
C4	62265454	62265676	BolC4t28243H	0	+	134	222	222	1.0000000
C4	62267568	62270247	BolC4t28244H	0	+	1695	2561	2679	0.9559537
C4	62271476	62272968	BolC4t28245H	0	-	330	1360	1492	0.9115282
C4	62294248	62294521	BolC4t28246H	0	+	26	88	273	0.3223443
C4	62299898	62301401	BolC4t28247H	0	-	263	1243	1503	0.8270127
C4	62304866	62306183	BolC4t28248H	0	-	130	1086	1317	0.8246014
C4	62310621	62311564	BolC4t28249H	0	-	815	943	943	1.0000000
C4	62312944	62313208	BolC4t28250H	0	+	203	264	264	1.0000000
C4	62313845	62318464	BolC4t28251H	0	-	711	4042	4619	0.8750812
C4	62325716	62328103	BolC4t28252H	0	+	2283	2387	2387	1.0000000
C4	62328854	62331400	BolC4t28253H	0	+	2025	2523	2546	0.9909662
C4	62335799	62335916	BolC4t28254H	0	+	1	27	117	0.2307692
C4	62337030	62337428	BolC4t28255H	0	+	16	51	398	0.1281407
C4	62341605	62341722	BolC4t28256H	0	+	0	0	117	0.0000000
C4	62351521	62351923	BolC4t28257H	0	+	30	157	402	0.3905473
C4	62352103	62353970	BolC4t28258H	0	+	561	1518	1867	0.8130691
C4	62358764	62360401	BolC4t28259H	0	+	861	1637	1637	1.0000000
C4	62361374	62365846	BolC4t28260H	0	-	2869	4385	4472	0.9805456
C4	62377964	62379442	BolC4t28261H	0	-	1019	1478	1478	1.0000000
C4	62379827	62384201	BolC4t28262H	0	+	1922	4106	4374	0.9387289
C4	62388524	62389360	BolC4t28263H	0	+	360	816	836	0.9760765
C4	62395028	62396117	BolC4t28264H	0	+	158	1048	1089	0.9623508
C4	62402795	62416419	BolC4t28265H	0	+	4222	11294	13624	0.8289783
C4	62419582	62419989	BolC4t28266H	0	+	301	407	407	1.0000000
C4	62427816	62429775	BolC4t28267H	0	+	1223	1959	1959	1.0000000
C4	62430214	62432404	BolC4t28268H	0	-	94	1752	2190	0.8000000
C4	62437977	62438562	BolC4t28269H	0	+	38	36	585	0.0615385
C4	62438991	62441529	BolC4t28270H	0	-	1201	2454	2538	0.9669031
C4	62446926	62447397	BolC4t28271H	0	-	383	471	471	1.0000000
C4	62451178	62452856	BolC4t28272H	0	-	1722	1678	1678	1.0000000
C4	62453497	62455800	BolC4t28273H	0	-	1131	2290	2303	0.9943552
C4	62457102	62458515	BolC4t28274H	0	-	189	1119	1413	0.7919320
C4	62466914	62468363	BolC4t28275H	0	-	9	475	1449	0.3278123
C4	62480637	62481906	BolC4t28276H	0	-	298	1085	1269	0.8550040
C4	62483543	62483836	BolC4t28277H	0	-	326	293	293	1.0000000
C4	62496779	62497980	BolC4t28278H	0	+	681	1201	1201	1.0000000
C4	62514084	62514423	BolC4t28279H	0	-	146	307	339	0.9056047
C4	62515075	62516383	BolC4t28280H	0	-	376	1197	1308	0.9151376
C4	62521055	62522621	BolC4t28281H	0	+	130	1014	1566	0.6475096
C4	62524088	62524519	BolC4t28282H	0	+	543	431	431	1.0000000
C4	62531126	62535214	BolC4t28283H	0	+	1609	2986	4088	0.7304305
C4	62536722	62537308	BolC4t28284H	0	+	302	428	586	0.7303754
C4	62538159	62540678	BolC4t28285H	0	+	694	2210	2519	0.8773323
C4	62549566	62550397	BolC4t28286H	0	+	192	792	831	0.9530686
C4	62551385	62553118	BolC4t28287H	0	-	516	1383	1733	0.7980381
C4	62554289	62556709	BolC4t28288H	0	-	1290	2420	2420	1.0000000
C4	62559352	62559599	BolC4t28289H	0	-	263	247	247	1.0000000
C4	62562266	62563459	BolC4t28290H	0	+	288	1138	1193	0.9538977
C4	62566216	62568254	BolC4t28291H	0	+	416	2038	2038	1.0000000
C4	62580331	62581776	BolC4t28292H	0	+	751	1227	1445	0.8491349
C4	62582301	62582597	BolC4t28293H	0	-	173	296	296	1.0000000
C4	62586308	62587601	BolC4t28294H	0	-	212	1089	1293	0.8422274
C4	62605846	62608818	BolC4t28295H	0	+	1659	2972	2972	1.0000000
C4	62609613	62610927	BolC4t28296H	0	-	168	1189	1314	0.9048706
C4	62613032	62614695	BolC4t28297H	0	-	6	261	1663	0.1569453
C4	62620666	62621510	BolC4t28298H	0	+	315	801	844	0.9490522
C4	62622213	62624823	BolC4t28299H	0	-	305	1285	2610	0.4923372
C4	62626825	62628814	BolC4t28300H	0	-	480	1889	1989	0.9497235
C4	62629001	62630097	BolC4t28301H	0	-	432	1096	1096	1.0000000
C4	62630480	62631583	BolC4t28302H	0	-	235	954	1103	0.8649139
C4	62639295	62639681	BolC4t28303H	0	+	18	192	386	0.4974093
C4	62639945	62640608	BolC4t28304H	0	+	142	663	663	1.0000000
C4	62642141	62642384	BolC4t28305H	0	-	31	175	243	0.7201646
C4	62642852	62647405	BolC4t28306H	0	-	2713	4409	4553	0.9683725
C4	62661606	62662145	BolC4t28307H	0	-	179	539	539	1.0000000
C4	62662432	62671140	BolC4t28308H	0	+	1372	7048	8708	0.8093707
C4	62673648	62676351	BolC4t28309H	0	-	1230	2703	2703	1.0000000
C4	62678250	62678554	BolC4t28310H	0	-	0	0	304	0.0000000
C4	62680072	62681079	BolC4t28311H	0	-	11	174	1007	0.1727905
C4	62683516	62683805	BolC4t28312H	0	+	72	289	289	1.0000000
C4	62683869	62684317	BolC4t28313H	0	+	20	317	448	0.7075893
C4	62695497	62696283	BolC4t28314H	0	+	101	577	786	0.7340967
C4	62696558	62699265	BolC4t28315H	0	-	1115	1842	2707	0.6804581
C4	62700162	62700506	BolC4t28316H	0	+	123	344	344	1.0000000
C4	62702894	62704457	BolC4t28317H	0	+	59	657	1563	0.4203455
C4	62705462	62714612	BolC4t28318H	0	+	4153	4676	9150	0.5110382
C4	62717549	62718161	BolC4t28319H	0	-	59	612	612	1.0000000
C4	62723083	62724258	BolC4t28320H	0	-	1025	1175	1175	1.0000000
C4	62726808	62729088	BolC4t28321H	0	-	782	2139	2280	0.9381579
C4	62735342	62735873	BolC4t28322H	0	-	483	531	531	1.0000000
C4	62745804	62749672	BolC4t28323H	0	+	2657	3826	3868	0.9891417
C4	62750374	62750997	BolC4t28324H	0	-	637	559	623	0.8972713
C4	62752222	62753137	BolC4t28325H	0	-	819	915	915	1.0000000
C4	62755518	62757638	BolC4t28326H	0	+	1104	1734	2120	0.8179245
C4	62758506	62760474	BolC4t28327H	0	-	1694	1968	1968	1.0000000
C4	62767153	62767318	BolC4t28328H	0	+	28	165	165	1.0000000
C4	62769372	62770621	BolC4t28329H	0	+	182	734	1249	0.5876701
C4	62782572	62783360	BolC4t28330H	0	+	426	788	788	1.0000000
C4	62785736	62786682	BolC4t28331H	0	+	6	42	946	0.0443975
C4	62786847	62787330	BolC4t28332H	0	-	421	483	483	1.0000000
C4	62800211	62801565	BolC4t28333H	0	+	1093	1354	1354	1.0000000
C4	62808347	62808816	BolC4t28334H	0	-	741	469	469	1.0000000
C4	62827861	62828425	BolC4t28335H	0	-	332	564	564	1.0000000
C4	62831649	62835082	BolC4t28336H	0	+	2487	2734	3433	0.7963880
C4	62835834	62837587	BolC4t28337H	0	+	1193	1719	1753	0.9806046
C4	62842017	62844134	BolC4t28338H	0	+	271	1412	2117	0.6669816
C4	62847441	62847750	BolC4t28339H	0	+	13	219	309	0.7087379
C4	62850939	62858266	BolC4t28340H	0	+	4254	7262	7327	0.9911287
C4	62858763	62859798	BolC4t28341H	0	-	122	912	1035	0.8811594
C4	62863097	62865287	BolC4t28342H	0	+	856	2178	2190	0.9945205
C4	62866611	62873614	BolC4t28343H	0	-	4091	5126	7003	0.7319720
C4	62876709	62879046	BolC4t28344H	0	-	1754	2337	2337	1.0000000
C4	62881435	62888125	BolC4t28345H	0	+	688	2493	6690	0.3726457
C4	62889901	62890708	BolC4t28346H	0	-	504	807	807	1.0000000
C4	62896589	62898892	BolC4t28347H	0	-	749	2263	2303	0.9826313
C4	62906279	62908226	BolC4t28348H	0	+	1006	1945	1947	0.9989728
C4	62908745	62913623	BolC4t28349H	0	-	3182	4878	4878	1.0000000
C4	62926100	62927719	BolC4t28350H	0	+	282	1248	1619	0.7708462
C4	62929802	62931322	BolC4t28351H	0	-	12	678	1520	0.4460526
C4	62936411	62938822	BolC4t28352H	0	+	1751	2411	2411	1.0000000
C4	62939230	62939844	BolC4t28353H	0	+	468	614	614	1.0000000
C4	62940376	62946586	BolC4t28354H	0	-	2499	5830	6210	0.9388084
C4	62947211	62948353	BolC4t28355H	0	+	611	1142	1142	1.0000000
C4	62948999	62951048	BolC4t28356H	0	-	1552	2049	2049	1.0000000
C4	62966470	62966923	BolC4t28357H	0	+	160	453	453	1.0000000
C4	62968978	62969110	BolC4t28358H	0	+	60	132	132	1.0000000
C4	62970581	62971908	BolC4t28359H	0	-	1813	1327	1327	1.0000000
C4	62972757	62973348	BolC4t28360H	0	-	597	591	591	1.0000000
C4	62979381	62980361	BolC4t28361H	0	-	860	980	980	1.0000000
C4	62980370	62980789	BolC4t28362H	0	+	225	419	419	1.0000000
C4	63000064	63001864	BolC4t28363H	0	+	1429	1750	1800	0.9722222
C4	63002308	63005471	BolC4t28364H	0	-	1363	2822	3163	0.8921909
C4	63007463	63008939	BolC4t28365H	0	+	165	1089	1476	0.7378049
C4	63010117	63010356	BolC4t28366H	0	+	30	200	239	0.8368201
C4	63011458	63011932	BolC4t28367H	0	+	156	459	474	0.9683544
C4	63012587	63013616	BolC4t28368H	0	-	699	1029	1029	1.0000000
C4	63022338	63022814	BolC4t28369H	0	+	243	476	476	1.0000000
C4	63023303	63025630	BolC4t28370H	0	-	806	2270	2327	0.9755049
C4	63031526	63033572	BolC4t28371H	0	-	947	1726	2046	0.8435972
C4	63037872	63038967	BolC4t28372H	0	-	287	1095	1095	1.0000000
C4	63039540	63044532	BolC4t28373H	0	-	1417	3707	4992	0.7425882
C4	63045945	63046870	BolC4t28374H	0	+	247	860	925	0.9297297
C4	63047045	63049195	BolC4t28375H	0	-	1047	2150	2150	1.0000000
C4	63051541	63053406	BolC4t28376H	0	-	1121	1865	1865	1.0000000
C4	63055316	63056831	BolC4t28377H	0	+	1640	1515	1515	1.0000000
C4	63057551	63058229	BolC4t28378H	0	-	542	678	678	1.0000000
C4	63064955	63068243	BolC4t28379H	0	+	2074	3286	3288	0.9993917
C4	63071933	63073271	BolC4t28380H	0	+	251	1295	1338	0.9678625
C4	63075758	63076689	BolC4t28381H	0	+	411	729	931	0.7830290
C4	63076976	63077985	BolC4t28382H	0	-	506	1009	1009	1.0000000
C4	63078907	63080262	BolC4t28383H	0	+	889	1323	1355	0.9763837
C4	63084132	63086658	BolC4t28384H	0	+	1178	2436	2526	0.9643705
C4	63097717	63100571	BolC4t28385H	0	-	1053	2508	2854	0.8787667
C4	63111175	63121268	BolC4t28386H	0	+	3836	9767	10093	0.9677004
C4	63123464	63123644	BolC4t28387H	0	-	8	78	180	0.4333333
C4	63130041	63132641	BolC4t28388H	0	+	724	1827	2600	0.7026923
C4	63134973	63135979	BolC4t28389H	0	-	149	782	1006	0.7773360
C4	63138629	63140307	BolC4t28390H	0	-	1593	1678	1678	1.0000000
C4	63149694	63149871	BolC4t28391H	0	+	64	146	177	0.8248588
C4	63158461	63159546	BolC4t28392H	0	+	182	963	1085	0.8875576
C4	63169335	63172418	BolC4t28393H	0	+	3350	3083	3083	1.0000000
C4	63175013	63176120	BolC4t28394H	0	+	621	1107	1107	1.0000000
C4	63178198	63179547	BolC4t28395H	0	+	725	1300	1349	0.9636768
C4	63187673	63188243	BolC4t28396H	0	+	659	570	570	1.0000000
C4	63190395	63192399	BolC4t28397H	0	-	817	1705	2004	0.8507984
C4	63221367	63221799	BolC4t28398H	0	+	62	202	432	0.4675926
C4	63222628	63223619	BolC4t28399H	0	+	138	910	991	0.9182644
C4	63226585	63227239	BolC4t28400H	0	-	130	614	654	0.9388379
C4	63235966	63236513	BolC4t28401H	0	+	416	547	547	1.0000000
C4	63238973	63241396	BolC4t28402H	0	+	853	2239	2423	0.9240611
C4	63242647	63245080	BolC4t28403H	0	+	771	2089	2433	0.8586107
C4	63245707	63246805	BolC4t28404H	0	-	36	453	1098	0.4125683
C4	63247817	63249483	BolC4t28405H	0	-	440	1433	1666	0.8601441
C4	63251045	63254487	BolC4t28406H	0	-	1307	2871	3442	0.8341081
C4	63262630	63265035	BolC4t28407H	0	+	718	2169	2405	0.9018711
C4	63266147	63267747	BolC4t28408H	0	-	1772	1600	1600	1.0000000
C4	63272502	63278011	BolC4t28409H	0	-	1991	4913	5509	0.8918134
C4	63279563	63280677	BolC4t28410H	0	-	512	1114	1114	1.0000000
C4	63281250	63286044	BolC4t28411H	0	-	706	4008	4794	0.8360450
C4	63288355	63289111	BolC4t28412H	0	-	12	78	756	0.1031746
C4	63291620	63292535	BolC4t28413H	0	+	26	560	915	0.6120219
C4	63308392	63308660	BolC4t28414H	0	+	132	268	268	1.0000000
C4	63310765	63312528	BolC4t28415H	0	+	470	1561	1763	0.8854226
C4	63313727	63314537	BolC4t28416H	0	+	410	810	810	1.0000000
C4	63316210	63316799	BolC4t28417H	0	-	300	560	589	0.9507640
C4	63318160	63319678	BolC4t28418H	0	-	609	1461	1518	0.9624506
C4	63332654	63335544	BolC4t28419H	0	+	1205	2876	2890	0.9951557
C4	63335957	63341464	BolC4t28420H	0	-	3445	5479	5507	0.9949155
C4	63343002	63344495	BolC4t28421H	0	-	422	1259	1493	0.8432686
C4	63345108	63346742	BolC4t28422H	0	-	271	1254	1634	0.7674419
C4	63349175	63350390	BolC4t28423H	0	-	17	208	1215	0.1711934
C4	63351551	63353692	BolC4t28424H	0	-	282	1982	2141	0.9257357
C4	63356749	63357296	BolC4t28425H	0	-	0	0	547	0.0000000
C4	63360168	63361734	BolC4t28426H	0	+	349	1341	1566	0.8563218
C4	63364922	63367197	BolC4t28427H	0	-	380	1588	2275	0.6980219
C4	63375303	63376925	BolC4t28428H	0	-	64	326	1622	0.2009864
C4	63411203	63415107	BolC4t28429H	0	+	2013	3509	3904	0.8988217
C4	63421779	63422397	BolC4t28430H	0	+	9	300	618	0.4854369
C4	63422478	63422871	BolC4t28431H	0	+	831	393	393	1.0000000
C4	63422823	63423330	BolC4t28432H	0	-	1099	507	507	1.0000000
C4	63423499	63423868	BolC4t28433H	0	+	89	369	369	1.0000000
C4	63433436	63435686	BolC4t28434H	0	-	1228	2136	2250	0.9493333
C4	63438693	63439274	BolC4t28435H	0	-	0	0	581	0.0000000
C4	63441938	63445614	BolC4t28436H	0	+	3665	3676	3676	1.0000000
C4	63446342	63448421	BolC4t28437H	0	+	328	1932	2079	0.9292929
C4	63451011	63451302	BolC4t28438H	0	+	0	0	291	0.0000000
C4	63451893	63452486	BolC4t28439H	0	+	114	593	593	1.0000000
C4	63454007	63454193	BolC4t28440H	0	+	0	0	186	0.0000000
C4	63454800	63455862	BolC4t28441H	0	+	121	871	1062	0.8201507
C4	63461054	63461825	BolC4t28442H	0	+	90	373	771	0.4837873
C4	63470176	63471303	BolC4t28443H	0	-	135	1118	1127	0.9920142
C4	63471720	63473674	BolC4t28444H	0	-	668	1934	1954	0.9897646
C4	63474682	63476175	BolC4t28445H	0	-	479	1493	1493	1.0000000
C4	63479046	63480407	BolC4t28446H	0	-	63	686	1361	0.5040411
C4	63481412	63483028	BolC4t28447H	0	+	1502	1616	1616	1.0000000
C4	63483299	63494209	BolC4t28448H	0	-	2162	7661	10910	0.7021998
C4	63497353	63499376	BolC4t28449H	0	+	207	1659	2023	0.8200692
C4	63499985	63502483	BolC4t28450H	0	-	1051	2435	2498	0.9747798
C4	63516439	63516793	BolC4t28451H	0	+	11	1	354	0.0028249
C4	63517218	63518865	BolC4t28452H	0	+	1275	1628	1647	0.9884639
C4	63519938	63520628	BolC4t28453H	0	+	563	690	690	1.0000000
C4	63527411	63529504	BolC4t28454H	0	+	169	1770	2093	0.8456761
C4	63530780	63531365	BolC4t28455H	0	+	120	585	585	1.0000000
C4	63531818	63532900	BolC4t28456H	0	+	800	1082	1082	1.0000000
C4	63533352	63535292	BolC4t28457H	0	-	80	1233	1940	0.6355670
C4	63538538	63540344	BolC4t28458H	0	-	1071	1806	1806	1.0000000
C4	63544000	63546643	BolC4t28459H	0	-	1952	2643	2643	1.0000000
C4	63553102	63553324	BolC4t28460H	0	+	277	222	222	1.0000000
C4	63554243	63554624	BolC4t28461H	0	+	98	277	381	0.7270341
C4	63556939	63559089	BolC4t28462H	0	+	454	1772	2150	0.8241860
C4	63559228	63560227	BolC4t28463H	0	-	470	889	999	0.8898899
C4	63562523	63563108	BolC4t28464H	0	+	675	585	585	1.0000000
C4	63563922	63564615	BolC4t28465H	0	+	540	693	693	1.0000000
C4	63565079	63566895	BolC4t28466H	0	-	1112	1813	1816	0.9983480
C4	63569393	63570029	BolC4t28467H	0	+	441	636	636	1.0000000
C4	63575374	63576933	BolC4t28468H	0	+	675	1491	1559	0.9563823
C4	63580852	63581597	BolC4t28469H	0	-	130	536	745	0.7194631
C4	63585253	63586289	BolC4t28470H	0	-	160	1021	1036	0.9855213
C4	63586740	63587823	BolC4t28471H	0	+	62	703	1083	0.6491228
C4	63588341	63598044	BolC4t28472H	0	-	2496	6487	9703	0.6685561
C4	63599573	63599678	BolC4t28473H	0	-	2	100	105	0.9523810
C4	63601837	63602128	BolC4t28474H	0	-	214	291	291	1.0000000
C4	63604229	63608081	BolC4t28475H	0	-	1077	3594	3852	0.9330218
C4	63611147	63614085	BolC4t28476H	0	-	1936	2938	2938	1.0000000
C4	63617281	63619788	BolC4t28477H	0	+	1231	2265	2507	0.9034703
C4	63621214	63622690	BolC4t28478H	0	-	797	1476	1476	1.0000000
C4	63628872	63631169	BolC4t28479H	0	+	820	2271	2297	0.9886809
C4	63631632	63634159	BolC4t28480H	0	-	446	2246	2527	0.8888010
C4	63634764	63637073	BolC4t28481H	0	-	678	2070	2309	0.8964920
C4	63641545	63647027	BolC4t28482H	0	-	1647	4914	5482	0.8963882
C4	63671984	63672518	BolC4t28483H	0	+	91	277	534	0.5187266
C4	63683870	63686256	BolC4t28484H	0	+	504	2003	2386	0.8394803
C4	63686610	63691480	BolC4t28485H	0	-	1685	3939	4870	0.8088295
C4	63692089	63692957	BolC4t28486H	0	-	79	717	868	0.8260369
C4	63693949	63695406	BolC4t28487H	0	+	1349	1258	1457	0.8634180
C4	63695907	63696666	BolC4t28488H	0	-	223	578	759	0.7615283
C4	63699359	63699863	BolC4t28489H	0	-	98	428	504	0.8492063
C4	63700307	63701798	BolC4t28490H	0	-	596	1313	1491	0.8806170
C4	63702977	63706387	BolC4t28491H	0	-	1203	2931	3410	0.8595308
C4	63707267	63708107	BolC4t28492H	0	-	132	629	840	0.7488095
C4	63709830	63710951	BolC4t28493H	0	-	80	406	1121	0.3621766
C4	63714283	63714834	BolC4t28494H	0	+	522	551	551	1.0000000
C4	63716576	63716927	BolC4t28495H	0	-	16	89	351	0.2535613
C4	63726812	63730762	BolC4t28496H	0	+	1003	1856	3950	0.4698734
C4	63739759	63740500	BolC4t28497H	0	-	7	331	741	0.4466937
C4	63742345	63743131	BolC4t28498H	0	-	164	774	786	0.9847328
C4	63744522	63746563	BolC4t28499H	0	+	945	2041	2041	1.0000000
C4	63747078	63748116	BolC4t28500H	0	+	980	1038	1038	1.0000000
C4	63748784	63751119	BolC4t28501H	0	-	492	1946	2335	0.8334047
C4	63760739	63760901	BolC4t28502H	0	+	139	162	162	1.0000000
C4	63767463	63770155	BolC4t28503H	0	+	1791	2507	2692	0.9312779
C4	63771976	63772472	BolC4t28504H	0	-	368	496	496	1.0000000
C4	63781645	63783754	BolC4t28505H	0	+	670	1840	2109	0.8724514
C4	63799847	63800316	BolC4t28506H	0	+	1100	469	469	1.0000000
C4	63801137	63803373	BolC4t28507H	0	-	1495	2224	2236	0.9946333
C4	63806547	63808905	BolC4t28508H	0	+	169	680	2358	0.2883800
C4	63813601	63815083	BolC4t28509H	0	-	616	1443	1482	0.9736842
C4	63821842	63822147	BolC4t28510H	0	-	0	0	305	0.0000000
C4	63844797	63845352	BolC4t28511H	0	+	100	555	555	1.0000000
C4	63849504	63850765	BolC4t28512H	0	+	30	183	1261	0.1451229
C4	63851132	63860299	BolC4t28513H	0	+	1735	5678	9167	0.6193957
C4	63860571	63861026	BolC4t28514H	0	-	34	309	455	0.6791209
C4	63863314	63863560	BolC4t28515H	0	-	407	246	246	1.0000000
C4	63867052	63867523	BolC4t28516H	0	+	0	0	471	0.0000000
C4	63868018	63871302	BolC4t28517H	0	-	76	527	3284	0.1604750
C4	63877025	63881826	BolC4t28518H	0	-	904	4009	4801	0.8350344
C4	63899768	63903689	BolC4t28519H	0	+	17922	3606	3921	0.9196634
C4	63905242	63905831	BolC4t28520H	0	+	82	589	589	1.0000000
C4	63906811	63907024	BolC4t28521H	0	+	150	213	213	1.0000000
C4	63908861	63913416	BolC4t28522H	0	+	1645	4488	4555	0.9852909
C4	63915686	63915911	BolC4t28523H	0	+	53	225	225	1.0000000
C4	63917703	63919988	BolC4t28524H	0	+	327	2139	2285	0.9361050
C4	63920951	63925811	BolC4t28525H	0	-	2719	4582	4860	0.9427984
C4	63925978	63927832	BolC4t28526H	0	+	581	1689	1854	0.9110032
C4	63933239	63933602	BolC4t28527H	0	-	414	363	363	1.0000000
C4	63935608	63937086	BolC4t28528H	0	+	1515	1478	1478	1.0000000
C4	63937422	63937767	BolC4t28529H	0	-	120	345	345	1.0000000
C4	63947303	63947690	BolC4t28530H	0	+	39	253	387	0.6537468
C4	63948862	63949219	BolC4t28531H	0	-	6	219	357	0.6134454
C4	63950761	63958669	BolC4t28532H	0	-	4012	7406	7908	0.9365200
C4	63957016	63957262	BolC4t28533H	0	+	67	246	246	1.0000000
C4	63961984	63962618	BolC4t28534H	0	+	274	634	634	1.0000000
C4	63970044	63970390	BolC4t28535H	0	-	435	346	346	1.0000000
C4	63974512	63975148	BolC4t28536H	0	-	387	636	636	1.0000000
C4	63980345	63980735	BolC4t28537H	0	+	95	327	390	0.8384615
C4	63981274	63983381	BolC4t28538H	0	-	1188	2093	2107	0.9933555
C4	63986586	63988954	BolC4t28539H	0	+	798	2320	2368	0.9797297
C4	63992957	63993559	BolC4t28540H	0	+	304	602	602	1.0000000
C4	63994239	63995906	BolC4t28541H	0	+	751	1224	1667	0.7342532
C4	63999808	64000876	BolC4t28542H	0	+	92	352	1068	0.3295880
C4	64005297	64005639	BolC4t28543H	0	-	136	304	342	0.8888889
C4	64006331	64008603	BolC4t28544H	0	-	96	1485	2272	0.6536092
C4	64009515	64009698	BolC4t28545H	0	+	200	183	183	1.0000000
C4	64014222	64016654	BolC4t28546H	0	-	1883	2432	2432	1.0000000
C4	64019668	64020032	BolC4t28547H	0	-	127	364	364	1.0000000
C4	64022510	64024348	BolC4t28548H	0	+	234	1397	1838	0.7600653
C4	64024975	64028365	BolC4t28549H	0	-	727	3265	3390	0.9631268
C4	64035605	64047416	BolC4t28550H	0	+	5806	10467	11811	0.8862078
C4	64042595	64043024	BolC4t28551H	0	+	360	429	429	1.0000000
C4	64054605	64064454	BolC4t28552H	0	+	1587	4991	9849	0.5067520
C4	64062145	64062640	BolC4t28553H	0	+	58	420	495	0.8484849
C4	64064893	64065358	BolC4t28554H	0	+	64	359	465	0.7720430
C4	64068785	64069129	BolC4t28555H	0	+	103	253	344	0.7354651
C4	64070168	64071936	BolC4t28556H	0	-	403	1706	1768	0.9649321
C4	64072945	64073125	BolC4t28557H	0	-	114	146	180	0.8111111
C4	64074270	64077363	BolC4t28558H	0	+	2825	2742	3093	0.8865179
C4	64078582	64079789	BolC4t28559H	0	-	1195	1035	1207	0.8574979
C4	64081075	64082350	BolC4t28560H	0	-	398	891	1275	0.6988235
C4	64085964	64087668	BolC4t28561H	0	+	431	1704	1704	1.0000000
C4	64087858	64088260	BolC4t28562H	0	-	635	402	402	1.0000000
C4	64088724	64089861	BolC4t28563H	0	+	471	1094	1137	0.9621812
C4	64090715	64091309	BolC4t28564H	0	+	401	594	594	1.0000000
C4	64091675	64094975	BolC4t28565H	0	+	2878	3300	3300	1.0000000
C4	64096131	64096722	BolC4t28566H	0	+	75	541	591	0.9153976
C4	64098746	64099336	BolC4t28567H	0	+	127	417	590	0.7067797
C4	64099996	64101371	BolC4t28568H	0	+	158	702	1375	0.5105454
C4	64102912	64103701	BolC4t28569H	0	+	557	789	789	1.0000000
C4	64115824	64117807	BolC4t28570H	0	+	534	1865	1983	0.9404942
C4	64123961	64124720	BolC4t28571H	0	+	95	709	759	0.9341239
C4	64124919	64125102	BolC4t28572H	0	-	155	183	183	1.0000000
C4	64126958	64129305	BolC4t28573H	0	-	1350	2347	2347	1.0000000
C4	64131787	64132375	BolC4t28574H	0	-	359	540	588	0.9183673
C4	64133142	64133741	BolC4t28575H	0	-	67	477	599	0.7963272
C4	64134024	64136364	BolC4t28576H	0	-	1019	2110	2340	0.9017094
C4	64136422	64136771	BolC4t28577H	0	+	250	349	349	1.0000000
C4	64136869	64137447	BolC4t28578H	0	+	146	525	578	0.9083045
C4	64138573	64140055	BolC4t28579H	0	-	54	599	1482	0.4041835
C4	64141477	64142962	BolC4t28580H	0	-	159	1061	1485	0.7144781
C4	64144632	64146412	BolC4t28581H	0	-	497	1553	1780	0.8724719
C4	64150957	64152405	BolC4t28582H	0	+	419	1106	1448	0.7638122
C4	64155647	64157122	BolC4t28583H	0	+	172	841	1475	0.5701695
C4	64157673	64159940	BolC4t28584H	0	-	50	1356	2267	0.5981473
C4	64165431	64166750	BolC4t28585H	0	-	695	1319	1319	1.0000000
C4	64175465	64176950	BolC4t28586H	0	-	850	1485	1485	1.0000000
C4	64177715	64179170	BolC4t28587H	0	+	1479	1455	1455	1.0000000
C4	64180506	64182953	BolC4t28588H	0	+	853	2393	2447	0.9779322
C4	64190488	64190896	BolC4t28589H	0	+	37	251	408	0.6151960
C4	64191687	64198308	BolC4t28590H	0	-	2343	5125	6621	0.7740523
C4	64199698	64203573	BolC4t28591H	0	-	1143	3077	3875	0.7940645
C4	64206751	64207894	BolC4t28592H	0	-	341	1143	1143	1.0000000
C4	64208878	64210690	BolC4t28593H	0	+	611	1698	1812	0.9370861
C4	64217043	64219006	BolC4t28594H	0	+	204	1289	1963	0.6566480
C4	64221044	64222111	BolC4t28595H	0	+	1033	1067	1067	1.0000000
C4	64222906	64226237	BolC4t28596H	0	+	1404	2760	3331	0.8285800
C4	64227517	64229362	BolC4t28597H	0	+	117	852	1845	0.4617886
C4	64231209	64233865	BolC4t28598H	0	-	1396	2438	2656	0.9179217
C4	64240882	64241425	BolC4t28599H	0	+	3	191	543	0.3517495
C4	64243062	64246863	BolC4t28600H	0	+	2938	3801	3801	1.0000000
C4	64247228	64247719	BolC4t28601H	0	-	346	435	491	0.8859470
C4	64248622	64249369	BolC4t28602H	0	-	230	746	747	0.9986613
C4	64250230	64257715	BolC4t28603H	0	-	1221	2486	7485	0.3321309
C4	64250501	64250978	BolC4t28604H	0	-	451	477	477	1.0000000
C4	64252950	64253436	BolC4t28605H	0	+	0	0	486	0.0000000
C4	64258367	64259597	BolC4t28606H	0	+	339	752	1230	0.6113821
C4	64263994	64279410	BolC4t28607H	0	+	6770	12172	15416	0.7895693
C4	64282997	64286245	BolC4t28608H	0	+	233	2044	3248	0.6293104
C4	64309081	64314849	BolC4t28609H	0	+	2386	4758	5768	0.8248960
C4	64315689	64317606	BolC4t28610H	0	+	1043	1917	1917	1.0000000
C4	64319407	64321397	BolC4t28611H	0	+	615	1849	1990	0.9291458
C4	64324997	64325408	BolC4t28612H	0	-	264	345	411	0.8394161
C4	64332146	64335576	BolC4t28613H	0	-	1198	2786	3430	0.8122449
C4	64337752	64338490	BolC4t28614H	0	+	259	738	738	1.0000000
C4	64340401	64346380	BolC4t28615H	0	-	3212	5726	5979	0.9576852
C4	64349992	64351178	BolC4t28616H	0	+	664	1186	1186	1.0000000
C4	64351446	64351796	BolC4t28617H	0	-	420	350	350	1.0000000
C4	64361541	64362574	BolC4t28618H	0	+	495	1033	1033	1.0000000
C4	64363275	64366676	BolC4t28619H	0	-	2814	3268	3401	0.9608939
C4	64367682	64368638	BolC4t28620H	0	-	754	898	956	0.9393305
C4	64369525	64369714	BolC4t28621H	0	-	168	189	189	1.0000000
C4	64373085	64373474	BolC4t28622H	0	+	312	389	389	1.0000000
C4	64376052	64376894	BolC4t28623H	0	-	175	826	842	0.9809976
C4	64380575	64382119	BolC4t28624H	0	-	516	1022	1544	0.6619171
C4	64385659	64385785	BolC4t28625H	0	+	11	111	126	0.8809524
C4	64388338	64388860	BolC4t28626H	0	+	0	0	522	0.0000000
C4	64391761	64393604	BolC4t28627H	0	+	912	1843	1843	1.0000000
C4	64394274	64394978	BolC4t28628H	0	-	1174	704	704	1.0000000
C4	64396757	64398387	BolC4t28629H	0	+	631	1548	1630	0.9496933
C4	64407907	64411249	BolC4t28630H	0	+	1851	3167	3342	0.9476361
C4	64415606	64416320	BolC4t28631H	0	+	264	714	714	1.0000000
C4	64436758	64438002	BolC4t28632H	0	+	529	1235	1244	0.9927652
C4	64438255	64442082	BolC4t28633H	0	-	810	3202	3827	0.8366867
C4	64444605	64446422	BolC4t28634H	0	-	170	1678	1817	0.9235003
C4	64456281	64457205	BolC4t28635H	0	+	210	843	924	0.9123377
C4	64460358	64460693	BolC4t28636H	0	-	0	0	335	0.0000000
C4	64468214	64469039	BolC4t28637H	0	+	49	174	825	0.2109091
C4	64472778	64472949	BolC4t28638H	0	-	23	171	171	1.0000000
C4	64476735	64481448	BolC4t28639H	0	-	1670	4564	4713	0.9683853
C4	64484490	64487338	BolC4t28640H	0	-	442	1453	2848	0.5101826
C4	64493367	64498137	BolC4t28641H	0	+	1474	4041	4770	0.8471698
C4	64503491	64504351	BolC4t28642H	0	+	215	805	860	0.9360465
C4	64506498	64506606	BolC4t28643H	0	+	103	108	108	1.0000000
C4	64509294	64512993	BolC4t28644H	0	-	2140	3086	3699	0.8342795
C4	64513619	64513862	BolC4t28645H	0	-	378	243	243	1.0000000
C4	64516389	64517241	BolC4t28646H	0	+	95	813	852	0.9542254
C4	64520348	64521612	BolC4t28647H	0	-	365	1163	1264	0.9200949
C4	64523571	64525884	BolC4t28648H	0	+	1865	2293	2313	0.9913532
C4	64527778	64530734	BolC4t28649H	0	+	1440	2846	2956	0.9627876
C4	64531433	64533945	BolC4t28650H	0	-	887	2330	2512	0.9275478
C4	64540873	64542825	BolC4t28651H	0	-	807	1921	1952	0.9841189
C4	64544493	64546557	BolC4t28652H	0	-	72	736	2064	0.3565891
C4	64554535	64557343	BolC4t28653H	0	+	1389	2791	2808	0.9939459
C4	64558567	64559460	BolC4t28654H	0	-	487	758	893	0.8488242
C4	64566792	64569551	BolC4t28655H	0	+	459	2557	2759	0.9267851
C4	64569998	64571616	BolC4t28656H	0	+	1012	1618	1618	1.0000000
C4	64573910	64574670	BolC4t28657H	0	+	259	689	760	0.9065790
C4	64579789	64582246	BolC4t28658H	0	-	1266	2315	2457	0.9422060
C4	64587196	64587876	BolC4t28659H	0	-	95	229	680	0.3367647
C4	64594446	64596851	BolC4t28660H	0	+	1426	2405	2405	1.0000000
C4	64618663	64619602	BolC4t28661H	0	+	182	875	939	0.9318424
C4	64624203	64625786	BolC4t28662H	0	+	507	1531	1583	0.9671510
C4	64626126	64626604	BolC4t28663H	0	-	82	478	478	1.0000000
C4	64630145	64631372	BolC4t28664H	0	-	602	1227	1227	1.0000000
C4	64632956	64634737	BolC4t28665H	0	+	497	1543	1781	0.8663672
C4	64634977	64636373	BolC4t28666H	0	-	465	1366	1396	0.9785100
C4	64638036	64642378	BolC4t28667H	0	-	1865	4289	4342	0.9877936
C4	64643226	64666027	BolC4t28668H	0	-	8808	19544	22801	0.8571554
C4	64654991	64657223	BolC4t28669H	0	-	1324	2232	2232	1.0000000
C4	64668032	64670527	BolC4t28670H	0	-	631	2040	2495	0.8176353
C4	64671199	64674931	BolC4t28671H	0	-	1472	3253	3732	0.8716506
C4	64678364	64680338	BolC4t28672H	0	+	339	1933	1974	0.9792300
C4	64681437	64684190	BolC4t28673H	0	+	1149	2581	2753	0.9375227
C4	64686550	64688968	BolC4t28674H	0	-	792	2255	2418	0.9325889
C4	64696343	64699514	BolC4t28675H	0	-	3042	3171	3171	1.0000000
C4	64726984	64729861	BolC4t28676H	0	-	1411	2877	2877	1.0000000
C4	64730802	64732940	BolC4t28677H	0	-	1514	2138	2138	1.0000000
C4	64733905	64735191	BolC4t28678H	0	+	1037	1286	1286	1.0000000
C4	64735971	64741004	BolC4t28679H	0	+	3170	4875	5033	0.9686072
C4	64742196	64742811	BolC4t28680H	0	-	388	615	615	1.0000000
C4	64744893	64747002	BolC4t28681H	0	+	741	2109	2109	1.0000000
C4	64747567	64749172	BolC4t28682H	0	+	347	1585	1605	0.9875389
C4	64749447	64750630	BolC4t28683H	0	-	106	830	1183	0.7016061
C4	64751251	64753421	BolC4t28684H	0	+	1032	2143	2170	0.9875576
C4	64754108	64755532	BolC4t28685H	0	-	963	1049	1424	0.7366573
C4	64757712	64759711	BolC4t28686H	0	+	1307	1999	1999	1.0000000
C4	64759954	64761625	BolC4t28687H	0	-	661	1591	1671	0.9521245
C4	64763088	64763553	BolC4t28688H	0	-	146	465	465	1.0000000
C4	64764019	64765485	BolC4t28689H	0	+	776	1466	1466	1.0000000
C4	64766003	64768582	BolC4t28690H	0	-	477	2189	2579	0.8487786
C4	64773551	64777188	BolC4t28691H	0	+	651	2965	3637	0.8152323
C4	64778512	64779764	BolC4t28692H	0	+	660	1252	1252	1.0000000
C4	64780635	64781370	BolC4t28693H	0	-	678	735	735	1.0000000
C4	64783363	64784861	BolC4t28694H	0	+	802	1498	1498	1.0000000
C4	64786683	64787638	BolC4t28695H	0	-	822	924	955	0.9675393
C4	64788364	64788849	BolC4t28696H	0	+	83	470	485	0.9690722
C4	64792764	64793277	BolC4t28697H	0	+	321	513	513	1.0000000
C4	64793436	64793912	BolC4t28698H	0	-	708	476	476	1.0000000
C4	64795084	64795856	BolC4t28699H	0	-	996	772	772	1.0000000
C4	64796880	64805103	BolC4t28700H	0	+	1804	6367	8223	0.7742916
C4	64805530	64806640	BolC4t28701H	0	-	950	1110	1110	1.0000000
C4	64829252	64831038	BolC4t28702H	0	-	797	1623	1786	0.9087346
C4	64840001	64840370	BolC4t28703H	0	-	55	32	369	0.0867209
C4	64841936	64842748	BolC4t28704H	0	-	538	720	812	0.8866995
C4	64851268	64858515	BolC4t28705H	0	-	1411	5534	7247	0.7636263
C4	64859438	64861167	BolC4t28706H	0	-	324	1631	1729	0.9433199
C4	64862547	64863888	BolC4t28707H	0	-	564	1319	1341	0.9835944
C4	64871638	64872220	BolC4t28708H	0	+	128	582	582	1.0000000
C4	64873672	64874484	BolC4t28709H	0	-	207	742	812	0.9137931
C4	64875331	64876330	BolC4t28710H	0	-	406	968	999	0.9689690
C4	64880145	64882222	BolC4t28711H	0	+	888	2069	2077	0.9961483
C4	64882513	64883836	BolC4t28712H	0	-	862	1270	1323	0.9599395
C4	64886729	64888548	BolC4t28713H	0	+	486	1331	1819	0.7317207
C4	64896480	64896882	BolC4t28714H	0	+	11	331	402	0.8233831
C4	64897112	64898844	BolC4t28715H	0	-	1236	1562	1732	0.9018476
C4	64898889	64899207	BolC4t28716H	0	-	339	318	318	1.0000000
C4	64903767	64904862	BolC4t28717H	0	+	146	896	1095	0.8182648
C4	64905850	64906447	BolC4t28718H	0	+	189	541	597	0.9061977
C4	64910935	64912659	BolC4t28719H	0	-	130	1160	1724	0.6728538
C4	64931517	64932354	BolC4t28720H	0	-	43	554	837	0.6618877
C4	64932776	64933167	BolC4t28721H	0	+	1	21	391	0.0537084
C4	64953191	64953551	BolC4t28722H	0	+	1	56	360	0.1555556
C4	64955503	64958539	BolC4t28723H	0	-	819	2973	3036	0.9792490
C4	64976413	64978873	BolC4t28724H	0	+	1022	2460	2460	1.0000000
C4	64980135	64980615	BolC4t28725H	0	+	143	399	480	0.8312500
C4	64981994	64983024	BolC4t28726H	0	-	24	555	1030	0.5388349
C4	64989449	64989982	BolC4t28727H	0	-	2641	533	533	1.0000000
C4	64993287	64995545	BolC4t28728H	0	-	1030	2181	2258	0.9658991
C4	65011747	65012023	BolC4t28729H	0	+	166	276	276	1.0000000
C4	65015431	65020188	BolC4t28730H	0	+	2675	4721	4757	0.9924322
C4	65017922	65018510	BolC4t28731H	0	+	713	588	588	1.0000000
C4	65021344	65022620	BolC4t28732H	0	+	1328	1276	1276	1.0000000
C4	65023888	65024959	BolC4t28733H	0	+	451	1067	1071	0.9962652
C4	65025564	65025765	BolC4t28734H	0	+	366	201	201	1.0000000
C4	65027229	65028535	BolC4t28735H	0	+	274	481	1306	0.3683001
C4	65033531	65034863	BolC4t28736H	0	+	105	991	1332	0.7439940
C4	65043146	65044061	BolC4t28737H	0	+	149	592	915	0.6469945
C4	65046139	65046757	BolC4t28738H	0	+	33	318	618	0.5145631
C4	65046950	65050379	BolC4t28739H	0	-	1732	2941	3429	0.8576844
C4	65050927	65052045	BolC4t28740H	0	-	664	1118	1118	1.0000000
C4	65057325	65058213	BolC4t28741H	0	+	716	888	888	1.0000000
C4	65060642	65065390	BolC4t28742H	0	-	1449	4679	4748	0.9854676
C4	65068647	65070537	BolC4t28743H	0	-	0	0	1890	0.0000000
C4	65072963	65073614	BolC4t28744H	0	-	19	403	651	0.6190476
C4	65075899	65077268	BolC4t28745H	0	-	193	1191	1369	0.8699781
C4	65141061	65143856	BolC4t28746H	0	-	1012	2475	2795	0.8855098
C4	65154432	65155753	BolC4t28747H	0	-	358	1270	1321	0.9613929
C4	65162462	65163538	BolC4t28748H	0	+	17	155	1076	0.1440520
C4	65164178	65164448	BolC4t28749H	0	-	73	270	270	1.0000000
C4	65165373	65165973	BolC4t28750H	0	+	279	592	600	0.9866667
C4	65166082	65167742	BolC4t28751H	0	+	306	1503	1660	0.9054217
C4	65169732	65173470	BolC4t28752H	0	+	928	3199	3738	0.8558052
C4	65174569	65175801	BolC4t28753H	0	-	578	988	1232	0.8019481
C4	65182502	65183432	BolC4t28754H	0	+	601	930	930	1.0000000
C4	65183630	65184751	BolC4t28755H	0	-	631	1121	1121	1.0000000
C4	65185857	65186052	BolC4t28756H	0	+	249	195	195	1.0000000
C4	65188198	65190367	BolC4t28757H	0	-	2660	2169	2169	1.0000000
C4	65191581	65191959	BolC4t28758H	0	+	270	378	378	1.0000000
C4	65194057	65201944	BolC4t28759H	0	+	1873	6521	7887	0.8268036
C4	65202417	65203500	BolC4t28760H	0	-	601	1029	1083	0.9501385
C4	65206920	65207860	BolC4t28761H	0	+	351	908	940	0.9659575
C4	65210494	65221431	BolC4t28762H	0	+	6481	8683	10937	0.7939106
C4	65215018	65216393	BolC4t28763H	0	-	786	1375	1375	1.0000000
C4	65225120	65225519	BolC4t28764H	0	+	409	399	399	1.0000000
C4	65235259	65236520	BolC4t28765H	0	+	722	1261	1261	1.0000000
C4	65239137	65241271	BolC4t28766H	0	+	588	1759	2134	0.8242736
C4	65241520	65245114	BolC4t28767H	0	+	1780	3555	3594	0.9891486
C4	65245941	65246676	BolC4t28768H	0	-	477	735	735	1.0000000
C4	65248100	65248981	BolC4t28769H	0	+	415	741	881	0.8410897
C4	65255439	65258163	BolC4t28770H	0	+	564	2063	2724	0.7573422
C4	65258632	65259310	BolC4t28771H	0	-	159	532	678	0.7846608
C4	65302153	65304449	BolC4t28772H	0	+	497	2055	2296	0.8950348
C4	65305392	65306257	BolC4t28773H	0	-	783	865	865	1.0000000
C4	65307513	65308125	BolC4t28774H	0	-	7	46	612	0.0751634
C4	65308904	65309513	BolC4t28775H	0	-	7	65	609	0.1067323
C4	65311216	65312537	BolC4t28776H	0	-	136	945	1321	0.7153671
C4	65320418	65323009	BolC4t28777H	0	-	331	2100	2591	0.8104979
C4	65323878	65324463	BolC4t28778H	0	+	147	553	585	0.9452991
C4	65324735	65326261	BolC4t28779H	0	-	540	1481	1526	0.9705111
C4	65330842	65331160	BolC4t28780H	0	+	106	318	318	1.0000000
C4	65340556	65340907	BolC4t28781H	0	+	567	351	351	1.0000000
C4	65341355	65342808	BolC4t28782H	0	-	882	1440	1453	0.9910530
C4	65344324	65345259	BolC4t28783H	0	+	873	935	935	1.0000000
C4	65361285	65365727	BolC4t28784H	0	-	2234	4234	4442	0.9531742
C4	65368239	65368641	BolC4t28785H	0	+	196	378	402	0.9402985
C4	65370121	65380996	BolC4t28786H	0	-	7962	10825	10875	0.9954023
C4	65381457	65381819	BolC4t28787H	0	+	176	362	362	1.0000000
C5	1955	3297	BolC5t28788H	0	-	69	602	1342	0.4485842
C5	3382	3583	BolC5t28789H	0	+	34	152	201	0.7562189
C5	9112	10090	BolC5t28790H	0	+	327	801	978	0.8190184
C5	10844	11344	BolC5t28791H	0	-	185	485	500	0.9700000
C5	11570	13178	BolC5t28792H	0	-	333	936	1608	0.5820895
C5	13495	17039	BolC5t28793H	0	-	1729	3544	3544	1.0000000
C5	17299	18309	BolC5t28794H	0	+	339	876	1010	0.8673267
C5	19079	22893	BolC5t28795H	0	-	1047	3133	3814	0.8214473
C5	23186	23937	BolC5t28796H	0	+	1029	751	751	1.0000000
C5	27490	28279	BolC5t28797H	0	-	415	763	789	0.9670469
C5	34514	36112	BolC5t28798H	0	+	317	1472	1598	0.9211515
C5	39798	39960	BolC5t28799H	0	-	37	162	162	1.0000000
C5	46382	47109	BolC5t28800H	0	-	51	641	727	0.8817056
C5	48079	49015	BolC5t28801H	0	-	349	936	936	1.0000000
C5	53256	53832	BolC5t28802H	0	+	270	553	576	0.9600694
C5	59092	71984	BolC5t28803H	0	+	683	7539	12892	0.5847813
C5	72804	73059	BolC5t28804H	0	-	199	255	255	1.0000000
C5	73451	74171	BolC5t28805H	0	+	438	720	720	1.0000000
C5	74727	75992	BolC5t28806H	0	-	366	1174	1265	0.9280632
C5	76969	77476	BolC5t28807H	0	-	299	507	507	1.0000000
C5	79069	110454	BolC5t28808H	0	+	10850	28684	31385	0.9139398
C5	106104	107544	BolC5t28809H	0	-	22	761	1440	0.5284722
C5	111029	115922	BolC5t28810H	0	-	1183	3980	4893	0.8134069
C5	117115	119696	BolC5t28811H	0	-	354	2191	2581	0.8488958
C5	121920	122388	BolC5t28812H	0	-	76	326	468	0.6965812
C5	125651	127361	BolC5t28813H	0	+	207	1163	1710	0.6801170
C5	127595	128910	BolC5t28814H	0	-	550	1307	1315	0.9939163
C5	129577	135109	BolC5t28815H	0	-	890	4197	5532	0.7586768
C5	136432	136696	BolC5t28816H	0	+	193	264	264	1.0000000
C5	137310	142738	BolC5t28817H	0	-	1433	4947	5428	0.9113854
C5	143701	144865	BolC5t28818H	0	-	317	1164	1164	1.0000000
C5	146446	148464	BolC5t28819H	0	+	690	1856	2018	0.9197225
C5	148710	149242	BolC5t28820H	0	-	17	212	532	0.3984962
C5	150759	152923	BolC5t28821H	0	+	878	2144	2164	0.9907579
C5	153290	153784	BolC5t28822H	0	+	597	494	494	1.0000000
C5	154669	155050	BolC5t28823H	0	-	13	178	381	0.4671916
C5	156559	157599	BolC5t28824H	0	-	248	872	1040	0.8384615
C5	158450	161533	BolC5t28825H	0	-	2516	2940	3083	0.9536166
C5	162174	164444	BolC5t28826H	0	-	602	2111	2270	0.9299560
C5	167973	169443	BolC5t28827H	0	+	1245	1437	1470	0.9775510
C5	173243	175875	BolC5t28828H	0	+	1002	1696	2632	0.6443769
C5	177275	180891	BolC5t28829H	0	+	712	3257	3616	0.9007190
C5	182145	182843	BolC5t28830H	0	+	262	698	698	1.0000000
C5	183284	184677	BolC5t28831H	0	-	577	1393	1393	1.0000000
C5	186856	187922	BolC5t28832H	0	+	305	1066	1066	1.0000000
C5	190551	193006	BolC5t28833H	0	+	502	2220	2455	0.9042770
C5	215190	217171	BolC5t28834H	0	-	137	1518	1981	0.7662796
C5	220876	224366	BolC5t28835H	0	-	265	2309	3490	0.6616046
C5	226285	228685	BolC5t28836H	0	-	313	2128	2400	0.8866667
C5	230893	231946	BolC5t28837H	0	-	99	840	1053	0.7977208
C5	234168	236453	BolC5t28838H	0	-	621	2173	2285	0.9509847
C5	238020	239485	BolC5t28839H	0	-	329	1352	1465	0.9228669
C5	240292	244391	BolC5t28840H	0	-	926	3561	4099	0.8687485
C5	248392	249505	BolC5t28841H	0	+	188	733	1113	0.6585804
C5	253554	255977	BolC5t28842H	0	-	1634	2351	2423	0.9702848
C5	259817	261800	BolC5t28843H	0	-	533	1827	1983	0.9213313
C5	263042	263849	BolC5t28844H	0	+	55	413	807	0.5117720
C5	266293	268287	BolC5t28845H	0	+	206	1750	1994	0.8776329
C5	271701	273442	BolC5t28846H	0	+	331	1699	1741	0.9758759
C5	274314	275184	BolC5t28847H	0	+	187	867	870	0.9965518
C5	275918	277283	BolC5t28848H	0	-	852	1365	1365	1.0000000
C5	279429	280227	BolC5t28849H	0	-	418	798	798	1.0000000
C5	282764	284909	BolC5t28850H	0	-	1437	2028	2145	0.9454545
C5	286164	294805	BolC5t28851H	0	+	2301	8168	8641	0.9452609
C5	295466	296186	BolC5t28852H	0	-	272	712	720	0.9888889
C5	297476	298910	BolC5t28853H	0	-	66	801	1434	0.5585774
C5	300505	302206	BolC5t28854H	0	-	1033	1701	1701	1.0000000
C5	334573	336337	BolC5t28855H	0	-	485	1639	1764	0.9291383
C5	341102	341669	BolC5t28856H	0	+	36	337	567	0.5943562
C5	345166	346254	BolC5t28857H	0	-	551	1088	1088	1.0000000
C5	347686	348662	BolC5t28858H	0	+	100	738	976	0.7561476
C5	351458	353152	BolC5t28859H	0	+	42	326	1694	0.1924439
C5	360838	361768	BolC5t28860H	0	-	294	675	930	0.7258065
C5	362696	363040	BolC5t28861H	0	+	143	344	344	1.0000000
C5	363274	364405	BolC5t28862H	0	-	379	1093	1131	0.9664014
C5	366189	369157	BolC5t28863H	0	+	720	2660	2968	0.8962264
C5	374256	375846	BolC5t28864H	0	+	39	488	1590	0.3069182
C5	377950	380137	BolC5t28865H	0	-	206	1265	2187	0.5784179
C5	380775	382034	BolC5t28866H	0	+	159	1144	1259	0.9086577
C5	382601	384101	BolC5t28867H	0	+	240	1356	1500	0.9040000
C5	384427	385454	BolC5t28868H	0	+	402	1010	1027	0.9834470
C5	387056	396499	BolC5t28869H	0	-	1371	5438	9443	0.5758763
C5	392735	393185	BolC5t28870H	0	+	0	0	450	0.0000000
C5	404466	406850	BolC5t28871H	0	+	683	2251	2384	0.9442114
C5	409544	412409	BolC5t28872H	0	+	1426	2676	2865	0.9340314
C5	413666	414830	BolC5t28873H	0	+	775	1164	1164	1.0000000
C5	415267	422409	BolC5t28874H	0	-	1842	5769	7142	0.8077570
C5	423337	423490	BolC5t28875H	0	+	29	153	153	1.0000000
C5	432560	433595	BolC5t28876H	0	+	8	21	1035	0.0202899
C5	437109	472771	BolC5t28877H	0	+	30677	35047	35662	0.9827548
C5	444803	445995	BolC5t28878H	0	-	800	1192	1192	1.0000000
C5	473285	495122	BolC5t28879H	0	-	9547	19697	21837	0.9020012
C5	477367	482452	BolC5t28880H	0	+	1054	4053	5085	0.7970501
C5	500600	503558	BolC5t28881H	0	+	722	2675	2958	0.9043273
C5	506295	511980	BolC5t28882H	0	-	1885	5232	5685	0.9203166
C5	514926	534584	BolC5t28883H	0	-	12224	16653	19658	0.8471360
C5	518196	519829	BolC5t28884H	0	-	1677	1633	1633	1.0000000
C5	537965	540492	BolC5t28885H	0	-	1741	2527	2527	1.0000000
C5	542335	545099	BolC5t28886H	0	-	1316	2704	2764	0.9782923
C5	546418	547357	BolC5t28887H	0	+	155	729	939	0.7763578
C5	547584	548970	BolC5t28888H	0	-	436	1335	1386	0.9632035
C5	550639	552801	BolC5t28889H	0	-	2644	2162	2162	1.0000000
C5	554042	556378	BolC5t28890H	0	-	1046	2158	2336	0.9238014
C5	558951	560239	BolC5t28891H	0	-	1036	1288	1288	1.0000000
C5	560554	561683	BolC5t28892H	0	-	777	1129	1129	1.0000000
C5	562507	564435	BolC5t28893H	0	-	1776	1843	1928	0.9559129
C5	567250	569839	BolC5t28894H	0	+	910	2589	2589	1.0000000
C5	570011	570224	BolC5t28895H	0	-	391	213	213	1.0000000
C5	571060	571972	BolC5t28896H	0	-	132	796	912	0.8728070
C5	575931	577191	BolC5t28897H	0	+	2274	1260	1260	1.0000000
C5	578340	579437	BolC5t28898H	0	-	2085	1097	1097	1.0000000
C5	583473	585141	BolC5t28899H	0	+	273	1654	1668	0.9916067
C5	586175	586991	BolC5t28900H	0	+	713	816	816	1.0000000
C5	591334	593923	BolC5t28901H	0	+	1104	2470	2589	0.9540363
C5	602990	604371	BolC5t28902H	0	-	103	294	1381	0.2128892
C5	606517	608930	BolC5t28903H	0	+	903	1956	2413	0.8106092
C5	610362	612040	BolC5t28904H	0	+	811	1459	1678	0.8694875
C5	612277	613137	BolC5t28905H	0	-	587	860	860	1.0000000
C5	614050	616345	BolC5t28906H	0	-	2511	2271	2295	0.9895425
C5	616799	617264	BolC5t28907H	0	-	167	434	465	0.9333333
C5	623188	625720	BolC5t28908H	0	-	124	1204	2532	0.4755134
C5	632800	635918	BolC5t28909H	0	-	1458	2575	3118	0.8258499
C5	638481	643792	BolC5t28910H	0	+	716	3879	5311	0.7303709
C5	644487	644695	BolC5t28911H	0	+	144	208	208	1.0000000
C5	647360	648179	BolC5t28912H	0	+	112	737	819	0.8998779
C5	651568	656534	BolC5t28913H	0	+	693	2656	4966	0.5348369
C5	663460	666753	BolC5t28914H	0	-	1340	2934	3293	0.8909808
C5	677879	679357	BolC5t28915H	0	-	1196	1478	1478	1.0000000
C5	685448	688800	BolC5t28916H	0	+	375	2667	3352	0.7956444
C5	689155	690225	BolC5t28917H	0	+	497	1070	1070	1.0000000
C5	690511	691060	BolC5t28918H	0	-	99	549	549	1.0000000
C5	705448	706069	BolC5t28919H	0	+	5	90	621	0.1449275
C5	706527	707321	BolC5t28920H	0	+	108	502	794	0.6322418
C5	709147	713229	BolC5t28921H	0	+	1571	3818	4082	0.9353258
C5	715510	719221	BolC5t28922H	0	-	472	2791	3711	0.7520884
C5	720734	721812	BolC5t28923H	0	+	218	1022	1078	0.9480519
C5	722763	724047	BolC5t28924H	0	-	506	1217	1284	0.9478193
C5	727690	729211	BolC5t28925H	0	-	186	634	1521	0.4168310
C5	731048	735258	BolC5t28926H	0	+	1046	3335	4210	0.7921615
C5	737814	738194	BolC5t28927H	0	-	461	380	380	1.0000000
C5	739398	739953	BolC5t28928H	0	-	416	555	555	1.0000000
C5	741951	744520	BolC5t28929H	0	+	478	2248	2569	0.8750486
C5	747105	748933	BolC5t28930H	0	+	387	1609	1828	0.8801969
C5	749200	750148	BolC5t28931H	0	-	592	948	948	1.0000000
C5	750885	752419	BolC5t28932H	0	-	895	1420	1534	0.9256845
C5	797031	798557	BolC5t28933H	0	-	850	1412	1526	0.9252949
C5	799401	805616	BolC5t28934H	0	-	6877	5889	6215	0.9475462
C5	808575	808944	BolC5t28935H	0	-	8	166	369	0.4498645
C5	810221	811231	BolC5t28936H	0	-	172	938	1010	0.9287128
C5	811867	813145	BolC5t28937H	0	-	408	1232	1278	0.9640062
C5	814780	817597	BolC5t28938H	0	-	985	2511	2817	0.8913738
C5	819889	826616	BolC5t28939H	0	+	3302	6569	6727	0.9765126
C5	827027	830976	BolC5t28940H	0	-	1157	3840	3949	0.9723981
C5	832176	834554	BolC5t28941H	0	-	609	2127	2378	0.8944491
C5	836199	839156	BolC5t28942H	0	+	420	2557	2957	0.8647277
C5	839931	840240	BolC5t28943H	0	-	21	275	309	0.8899676
C5	843642	845551	BolC5t28944H	0	+	1227	1855	1909	0.9717129
C5	846031	847884	BolC5t28945H	0	-	543	1807	1853	0.9751754
C5	848982	851296	BolC5t28946H	0	+	801	2245	2314	0.9701815
C5	852334	866086	BolC5t28947H	0	-	486	4184	13752	0.3042467
C5	868284	869497	BolC5t28948H	0	+	317	1213	1213	1.0000000
C5	869626	877048	BolC5t28949H	0	-	1786	6569	7422	0.8850714
C5	879317	881660	BolC5t28950H	0	-	1058	2268	2343	0.9679897
C5	882361	883557	BolC5t28951H	0	+	812	1161	1196	0.9707358
C5	883871	884729	BolC5t28952H	0	+	698	858	858	1.0000000
C5	885096	886357	BolC5t28953H	0	-	1789	1261	1261	1.0000000
C5	891312	892044	BolC5t28954H	0	+	323	732	732	1.0000000
C5	897043	898492	BolC5t28955H	0	-	1195	1449	1449	1.0000000
C5	898813	901283	BolC5t28956H	0	-	1474	2470	2470	1.0000000
C5	901460	902319	BolC5t28957H	0	+	537	859	859	1.0000000
C5	903171	905170	BolC5t28958H	0	-	1067	1856	1999	0.9284642
C5	906938	910063	BolC5t28959H	0	+	1211	2922	3125	0.9350400
C5	910827	916619	BolC5t28960H	0	+	2441	5212	5792	0.8998619
C5	919024	921592	BolC5t28961H	0	+	857	2377	2568	0.9256231
C5	922062	922405	BolC5t28962H	0	+	160	343	343	1.0000000
C5	923303	924244	BolC5t28963H	0	-	338	936	941	0.9946865
C5	924457	924932	BolC5t28964H	0	+	360	475	475	1.0000000
C5	925351	926560	BolC5t28965H	0	-	351	1201	1209	0.9933830
C5	926869	928501	BolC5t28966H	0	+	477	1604	1632	0.9828432
C5	929270	932218	BolC5t28967H	0	+	483	1456	2948	0.4938942
C5	944248	948714	BolC5t28968H	0	+	1707	4403	4466	0.9858934
C5	949203	950595	BolC5t28969H	0	-	306	1381	1392	0.9920977
C5	958290	964381	BolC5t28970H	0	-	2160	4708	6091	0.7729437
C5	971303	972681	BolC5t28971H	0	+	207	1163	1378	0.8439768
C5	976465	977653	BolC5t28972H	0	+	400	1018	1188	0.8569024
C5	978410	981112	BolC5t28973H	0	-	2777	2702	2702	1.0000000
C5	982640	983479	BolC5t28974H	0	-	950	839	839	1.0000000
C5	984598	986352	BolC5t28975H	0	-	1004	1754	1754	1.0000000
C5	987703	989173	BolC5t28976H	0	+	210	633	1470	0.4306122
C5	995917	998303	BolC5t28977H	0	-	1194	2308	2386	0.9673093
C5	998966	1000628	BolC5t28978H	0	-	791	1662	1662	1.0000000
C5	1001193	1003155	BolC5t28979H	0	-	712	1911	1962	0.9740061
C5	1003488	1005127	BolC5t28980H	0	-	1020	1639	1639	1.0000000
C5	1007736	1008264	BolC5t28981H	0	+	104	528	528	1.0000000
C5	1010719	1011634	BolC5t28982H	0	+	669	915	915	1.0000000
C5	1013347	1015014	BolC5t28983H	0	-	793	1640	1667	0.9838032
C5	1021640	1025694	BolC5t28984H	0	+	1267	3061	4054	0.7550567
C5	1025755	1029668	BolC5t28985H	0	+	4237	3913	3913	1.0000000
C5	1034199	1037294	BolC5t28986H	0	+	1543	2983	3095	0.9638126
C5	1038808	1040484	BolC5t28987H	0	-	882	1676	1676	1.0000000
C5	1042729	1043926	BolC5t28988H	0	+	267	1113	1197	0.9298246
C5	1046109	1048292	BolC5t28989H	0	+	2353	2183	2183	1.0000000
C5	1048826	1052843	BolC5t28990H	0	-	2094	3925	4017	0.9770973
C5	1054844	1055156	BolC5t28991H	0	-	267	312	312	1.0000000
C5	1056528	1057707	BolC5t28992H	0	+	323	1144	1179	0.9703138
C5	1064519	1065062	BolC5t28993H	0	-	246	543	543	1.0000000
C5	1066612	1067112	BolC5t28994H	0	+	244	462	500	0.9240000
C5	1067491	1068154	BolC5t28995H	0	-	261	663	663	1.0000000
C5	1070930	1073096	BolC5t28996H	0	-	588	1946	2166	0.8984303
C5	1078062	1078720	BolC5t28997H	0	-	741	658	658	1.0000000
C5	1083287	1083755	BolC5t28998H	0	-	439	468	468	1.0000000
C5	1086579	1100013	BolC5t28999H	0	-	5635	11878	13434	0.8841745
C5	1089322	1090075	BolC5t29000H	0	-	137	743	753	0.9867198
C5	1094968	1097284	BolC5t29001H	0	+	249	1403	2316	0.6057858
C5	1101227	1103514	BolC5t29002H	0	+	1081	2086	2287	0.9121119
C5	1104116	1107994	BolC5t29003H	0	+	779	2814	3878	0.7256318
C5	1109473	1112459	BolC5t29004H	0	+	910	2709	2986	0.9072338
C5	1112951	1114730	BolC5t29005H	0	-	281	1405	1779	0.7897695
C5	1117169	1118836	BolC5t29006H	0	-	1477	1667	1667	1.0000000
C5	1120195	1120996	BolC5t29007H	0	+	348	801	801	1.0000000
C5	1122251	1123117	BolC5t29008H	0	-	266	845	866	0.9757506
C5	1126124	1127510	BolC5t29009H	0	+	483	1342	1386	0.9682540
C5	1127985	1128450	BolC5t29010H	0	-	16	258	465	0.5548387
C5	1130843	1135107	BolC5t29011H	0	-	1681	4024	4264	0.9437148
C5	1138529	1138820	BolC5t29012H	0	-	74	291	291	1.0000000
C5	1139521	1143954	BolC5t29013H	0	+	1142	4004	4433	0.9032258
C5	1145620	1145821	BolC5t29014H	0	+	86	189	201	0.9402985
C5	1147476	1148671	BolC5t29015H	0	+	1474	1195	1195	1.0000000
C5	1149129	1151463	BolC5t29016H	0	-	349	2024	2334	0.8671808
C5	1154199	1159370	BolC5t29017H	0	-	1804	4925	5171	0.9524270
C5	1167949	1170026	BolC5t29018H	0	+	635	2077	2077	1.0000000
C5	1178572	1179936	BolC5t29019H	0	+	708	1275	1364	0.9347507
C5	1180959	1185308	BolC5t29020H	0	+	1254	4060	4349	0.9335479
C5	1185809	1191293	BolC5t29021H	0	+	1990	5031	5484	0.9173961
C5	1191813	1194678	BolC5t29022H	0	-	2059	2616	2865	0.9130890
C5	1223322	1223505	BolC5t29023H	0	-	370	183	183	1.0000000
C5	1230076	1231427	BolC5t29024H	0	+	510	1343	1351	0.9940785
C5	1234167	1235126	BolC5t29025H	0	-	407	959	959	1.0000000
C5	1235708	1239981	BolC5t29026H	0	-	1641	4071	4273	0.9527264
C5	1241601	1242236	BolC5t29027H	0	-	534	635	635	1.0000000
C5	1243287	1248247	BolC5t29028H	0	-	1847	4155	4960	0.8377016
C5	1250018	1251968	BolC5t29029H	0	-	128	1288	1950	0.6605128
C5	1254908	1255211	BolC5t29030H	0	-	42	280	303	0.9240924
C5	1256645	1257850	BolC5t29031H	0	-	482	1182	1205	0.9809129
C5	1260510	1261999	BolC5t29032H	0	+	101	1114	1489	0.7481532
C5	1264979	1266546	BolC5t29033H	0	+	375	1431	1567	0.9132100
C5	1268793	1271066	BolC5t29034H	0	+	200	1404	2273	0.6176859
C5	1272520	1273627	BolC5t29035H	0	-	170	1055	1107	0.9530262
C5	1282300	1282501	BolC5t29036H	0	+	43	13	201	0.0646766
C5	1287914	1288316	BolC5t29037H	0	+	100	346	402	0.8606965
C5	1290844	1292706	BolC5t29038H	0	-	1043	1862	1862	1.0000000
C5	1294455	1297968	BolC5t29039H	0	-	894	2835	3513	0.8070025
C5	1298430	1301062	BolC5t29040H	0	-	862	2550	2632	0.9688450
C5	1302058	1303950	BolC5t29041H	0	-	544	1686	1892	0.8911205
C5	1304187	1307006	BolC5t29042H	0	+	1431	2811	2819	0.9971621
C5	1308068	1311125	BolC5t29043H	0	+	704	2921	3057	0.9555119
C5	1313052	1315826	BolC5t29044H	0	+	943	2672	2774	0.9632300
C5	1316515	1321022	BolC5t29045H	0	-	1266	4136	4507	0.9176836
C5	1322245	1323183	BolC5t29046H	0	+	663	938	938	1.0000000
C5	1323374	1324656	BolC5t29047H	0	-	1300	1282	1282	1.0000000
C5	1332576	1336469	BolC5t29048H	0	-	868	3185	3893	0.8181351
C5	1340799	1343977	BolC5t29049H	0	+	1475	2974	3178	0.9358087
C5	1345956	1347646	BolC5t29050H	0	+	399	1450	1690	0.8579882
C5	1348270	1349789	BolC5t29051H	0	-	1175	1519	1519	1.0000000
C5	1351015	1352770	BolC5t29052H	0	+	437	1544	1755	0.8797721
C5	1354273	1355599	BolC5t29053H	0	+	1344	1326	1326	1.0000000
C5	1356551	1357731	BolC5t29054H	0	+	1048	1180	1180	1.0000000
C5	1358346	1359071	BolC5t29055H	0	+	454	725	725	1.0000000
C5	1359267	1361295	BolC5t29056H	0	-	1412	2028	2028	1.0000000
C5	1367997	1373108	BolC5t29057H	0	-	3674	5111	5111	1.0000000
C5	1373167	1373717	BolC5t29058H	0	-	512	550	550	1.0000000
C5	1374107	1376452	BolC5t29059H	0	-	1279	2268	2345	0.9671642
C5	1377539	1378682	BolC5t29060H	0	-	291	837	1143	0.7322835
C5	1394461	1394668	BolC5t29061H	0	-	2	80	207	0.3864734
C5	1394762	1395259	BolC5t29062H	0	+	361	440	497	0.8853118
C5	1397879	1399567	BolC5t29063H	0	+	593	1639	1688	0.9709716
C5	1401107	1404421	BolC5t29064H	0	-	3630	3314	3314	1.0000000
C5	1404802	1406154	BolC5t29065H	0	-	1157	1352	1352	1.0000000
C5	1406458	1408215	BolC5t29066H	0	+	393	1717	1757	0.9772339
C5	1411153	1411747	BolC5t29067H	0	-	106	552	594	0.9292929
C5	1412755	1413862	BolC5t29068H	0	+	7	198	1107	0.1788618
C5	1415692	1419227	BolC5t29069H	0	-	497	2521	3535	0.7131542
C5	1427739	1429197	BolC5t29070H	0	+	418	1383	1458	0.9485596
C5	1430527	1434006	BolC5t29071H	0	+	496	2246	3479	0.6455878
C5	1434559	1436581	BolC5t29072H	0	-	187	1488	2022	0.7359051
C5	1437445	1443190	BolC5t29073H	0	-	4049	5522	5745	0.9611837
C5	1443784	1445041	BolC5t29074H	0	-	1024	1257	1257	1.0000000
C5	1447300	1448446	BolC5t29075H	0	-	1205	1146	1146	1.0000000
C5	1456535	1462234	BolC5t29076H	0	+	1853	5043	5699	0.8848921
C5	1462945	1464960	BolC5t29077H	0	-	572	1775	2015	0.8808933
C5	1466828	1469368	BolC5t29078H	0	+	2047	2516	2540	0.9905512
C5	1469907	1470507	BolC5t29079H	0	-	1080	600	600	1.0000000
C5	1472653	1473369	BolC5t29080H	0	-	682	716	716	1.0000000
C5	1474198	1474570	BolC5t29081H	0	-	698	372	372	1.0000000
C5	1475189	1475680	BolC5t29082H	0	-	1171	491	491	1.0000000
C5	1477294	1479286	BolC5t29083H	0	-	1006	1992	1992	1.0000000
C5	1479571	1482499	BolC5t29084H	0	-	2677	2740	2928	0.9357923
C5	1483426	1485137	BolC5t29085H	0	-	1167	1711	1711	1.0000000
C5	1487448	1489313	BolC5t29086H	0	-	1058	1865	1865	1.0000000
C5	1489850	1493019	BolC5t29087H	0	+	1952	3129	3169	0.9873777
C5	1493471	1495987	BolC5t29088H	0	-	969	2169	2516	0.8620827
C5	1496672	1501689	BolC5t29089H	0	-	2347	4547	5017	0.9063185
C5	1502434	1504593	BolC5t29090H	0	-	2587	2159	2159	1.0000000
C5	1505069	1505983	BolC5t29091H	0	+	512	914	914	1.0000000
C5	1506397	1509974	BolC5t29092H	0	-	3065	3577	3577	1.0000000
C5	1511228	1513547	BolC5t29093H	0	-	1054	2319	2319	1.0000000
C5	1515266	1516590	BolC5t29094H	0	-	434	1112	1324	0.8398792
C5	1517134	1519161	BolC5t29095H	0	+	329	1964	2027	0.9689196
C5	1519819	1520743	BolC5t29096H	0	+	586	885	924	0.9577922
C5	1541200	1543980	BolC5t29097H	0	-	357	1873	2780	0.6737410
C5	1544640	1546753	BolC5t29098H	0	-	1475	2111	2113	0.9990535
C5	1559951	1562876	BolC5t29099H	0	+	1072	2278	2925	0.7788034
C5	1563409	1564682	BolC5t29100H	0	-	226	1141	1273	0.8963079
C5	1570235	1572155	BolC5t29101H	0	-	220	1528	1920	0.7958333
C5	1572857	1574891	BolC5t29102H	0	-	1381	1950	2034	0.9587021
C5	1575327	1576727	BolC5t29103H	0	+	152	344	1400	0.2457143
C5	1578841	1579302	BolC5t29104H	0	+	244	461	461	1.0000000
C5	1579869	1582257	BolC5t29105H	0	+	1215	2388	2388	1.0000000
C5	1582732	1585210	BolC5t29106H	0	+	1188	2215	2478	0.8938660
C5	1586476	1586710	BolC5t29107H	0	-	186	234	234	1.0000000
C5	1594179	1595188	BolC5t29108H	0	-	648	1009	1009	1.0000000
C5	1595497	1597791	BolC5t29109H	0	+	1151	2294	2294	1.0000000
C5	1606878	1607895	BolC5t29110H	0	+	248	994	1017	0.9773844
C5	1608746	1612757	BolC5t29111H	0	-	2938	4011	4011	1.0000000
C5	1641874	1642657	BolC5t29112H	0	-	683	783	783	1.0000000
C5	1646541	1647977	BolC5t29113H	0	+	783	1436	1436	1.0000000
C5	1649135	1650384	BolC5t29114H	0	-	901	1249	1249	1.0000000
C5	1654498	1655785	BolC5t29115H	0	+	147	732	1287	0.5687646
C5	1655877	1662675	BolC5t29116H	0	-	4378	6632	6798	0.9755810
C5	1663751	1666171	BolC5t29117H	0	-	419	1869	2420	0.7723141
C5	1667240	1667733	BolC5t29118H	0	-	781	493	493	1.0000000
C5	1668161	1670586	BolC5t29119H	0	-	1047	2357	2425	0.9719588
C5	1685593	1688606	BolC5t29120H	0	-	2886	3013	3013	1.0000000
C5	1689442	1690580	BolC5t29121H	0	-	351	985	1138	0.8655536
C5	1692801	1696050	BolC5t29122H	0	+	1060	3118	3249	0.9596799
C5	1696401	1697260	BolC5t29123H	0	-	565	859	859	1.0000000
C5	1697513	1698388	BolC5t29124H	0	+	344	770	875	0.8800000
C5	1699202	1704614	BolC5t29125H	0	-	3789	5299	5412	0.9791205
C5	1708387	1709727	BolC5t29126H	0	+	668	1194	1340	0.8910448
C5	1713941	1714428	BolC5t29127H	0	-	92	305	487	0.6262833
C5	1716693	1718122	BolC5t29128H	0	+	8	195	1429	0.1364591
C5	1718401	1720718	BolC5t29129H	0	-	921	1956	2317	0.8441951
C5	1721574	1724095	BolC5t29130H	0	-	448	2330	2521	0.9242364
C5	1727063	1730714	BolC5t29131H	0	-	2036	3436	3651	0.9411120
C5	1731234	1732932	BolC5t29132H	0	+	257	918	1698	0.5406361
C5	1731467	1732496	BolC5t29133H	0	-	113	569	1029	0.5529640
C5	1736821	1737520	BolC5t29134H	0	-	807	699	699	1.0000000
C5	1740101	1740350	BolC5t29135H	0	+	82	249	249	1.0000000
C5	1740555	1742011	BolC5t29136H	0	-	2369	1456	1456	1.0000000
C5	1754537	1755343	BolC5t29137H	0	-	474	806	806	1.0000000
C5	1757708	1759016	BolC5t29138H	0	+	34	302	1308	0.2308868
C5	1766177	1768608	BolC5t29139H	0	-	978	2227	2431	0.9160839
C5	1789493	1796551	BolC5t29140H	0	-	743	3635	7058	0.5150184
C5	1793402	1793891	BolC5t29141H	0	-	138	407	489	0.8323109
C5	1800522	1803615	BolC5t29142H	0	+	772	2224	3093	0.7190430
C5	1804272	1804794	BolC5t29143H	0	+	280	522	522	1.0000000
C5	1805497	1805948	BolC5t29144H	0	-	301	451	451	1.0000000
C5	1806991	1809819	BolC5t29145H	0	-	1770	2828	2828	1.0000000
C5	1812360	1815414	BolC5t29146H	0	-	276	2498	3054	0.8179437
C5	1828864	1829422	BolC5t29147H	0	-	208	552	558	0.9892473
C5	1835141	1839644	BolC5t29148H	0	+	1602	3917	4503	0.8698645
C5	1840118	1840948	BolC5t29149H	0	-	639	830	830	1.0000000
C5	1842552	1843155	BolC5t29150H	0	-	689	603	603	1.0000000
C5	1847013	1848282	BolC5t29151H	0	-	1115	1269	1269	1.0000000
C5	1850158	1850914	BolC5t29152H	0	-	127	640	756	0.8465608
C5	1854116	1855951	BolC5t29153H	0	+	902	1731	1835	0.9433243
C5	1856274	1857627	BolC5t29154H	0	-	1348	1353	1353	1.0000000
C5	1859141	1860399	BolC5t29155H	0	-	1142	1258	1258	1.0000000
C5	1861880	1862708	BolC5t29156H	0	+	336	828	828	1.0000000
C5	1864723	1865849	BolC5t29157H	0	+	458	1126	1126	1.0000000
C5	1866114	1869330	BolC5t29158H	0	-	1302	2330	3216	0.7245025
C5	1873990	1876381	BolC5t29159H	0	-	1115	2340	2391	0.9786700
C5	1891018	1891274	BolC5t29160H	0	+	593	256	256	1.0000000
C5	1891353	1891672	BolC5t29161H	0	+	751	319	319	1.0000000
C5	1893027	1898018	BolC5t29162H	0	-	654	4035	4991	0.8084552
C5	1899520	1903308	BolC5t29163H	0	+	2489	3730	3788	0.9846885
C5	1903836	1904862	BolC5t29164H	0	+	412	766	1026	0.7465887
C5	1908719	1931451	BolC5t29165H	0	+	7280	18282	22732	0.8042407
C5	1914895	1915681	BolC5t29166H	0	+	133	762	786	0.9694657
C5	1918304	1918622	BolC5t29167H	0	-	259	318	318	1.0000000
C5	1931691	1932191	BolC5t29168H	0	-	456	500	500	1.0000000
C5	1944316	1945738	BolC5t29169H	0	-	425	1422	1422	1.0000000
C5	1947163	1957245	BolC5t29170H	0	-	3603	9143	10082	0.9068637
C5	1965817	1966084	BolC5t29171H	0	-	83	253	267	0.9475656
C5	1966843	1968565	BolC5t29172H	0	-	435	1495	1722	0.8681765
C5	1971861	1974847	BolC5t29173H	0	-	464	2102	2986	0.7039518
C5	1976042	1977566	BolC5t29174H	0	+	558	1524	1524	1.0000000
C5	1977921	1980127	BolC5t29175H	0	-	2038	2026	2206	0.9184043
C5	1982077	1982716	BolC5t29176H	0	-	747	639	639	1.0000000
C5	1984186	1988843	BolC5t29177H	0	+	2539	4642	4657	0.9967790
C5	1997178	1999489	BolC5t29178H	0	+	1165	2311	2311	1.0000000
C5	2009096	2009543	BolC5t29179H	0	-	375	447	447	1.0000000
C5	2009834	2011938	BolC5t29180H	0	-	1096	2092	2104	0.9942966
C5	2015175	2017365	BolC5t29181H	0	-	938	2120	2190	0.9680365
C5	2023935	2024298	BolC5t29182H	0	+	0	0	363	0.0000000
C5	2025637	2027206	BolC5t29183H	0	-	477	1390	1569	0.8859146
C5	2032661	2039905	BolC5t29184H	0	+	2820	5196	7244	0.7172832
C5	2043100	2043888	BolC5t29185H	0	+	242	771	788	0.9784264
C5	2044240	2044746	BolC5t29186H	0	-	467	506	506	1.0000000
C5	2045462	2045799	BolC5t29187H	0	-	316	337	337	1.0000000
C5	2047275	2048168	BolC5t29188H	0	-	17	383	893	0.4288914
C5	2048859	2054640	BolC5t29189H	0	+	3939	5781	5781	1.0000000
C5	2069391	2070813	BolC5t29190H	0	+	362	1201	1422	0.8445851
C5	2081686	2114512	BolC5t29191H	0	+	3056	13371	32826	0.4073296
C5	2098507	2100278	BolC5t29192H	0	+	340	1076	1771	0.6075664
C5	2101149	2102163	BolC5t29193H	0	+	122	326	1014	0.3214990
C5	2104285	2108975	BolC5t29194H	0	-	826	1561	4690	0.3328358
C5	2117471	2119002	BolC5t29195H	0	-	583	1531	1531	1.0000000
C5	2119867	2120923	BolC5t29196H	0	+	938	1056	1056	1.0000000
C5	2122290	2122920	BolC5t29197H	0	-	181	630	630	1.0000000
C5	2126417	2129088	BolC5t29198H	0	+	418	2452	2671	0.9180082
C5	2129311	2131527	BolC5t29199H	0	-	736	1532	2216	0.6913357
C5	2132920	2134780	BolC5t29200H	0	-	1259	1860	1860	1.0000000
C5	2135858	2140054	BolC5t29201H	0	+	3633	4196	4196	1.0000000
C5	2141304	2146463	BolC5t29202H	0	+	2072	3824	5159	0.7412289
C5	2147022	2147694	BolC5t29203H	0	+	269	672	672	1.0000000
C5	2148498	2153175	BolC5t29204H	0	-	1439	4418	4677	0.9446226
C5	2154022	2154718	BolC5t29205H	0	-	180	696	696	1.0000000
C5	2157222	2158932	BolC5t29206H	0	+	695	1599	1710	0.9350877
C5	2159696	2168480	BolC5t29207H	0	-	2870	4452	8784	0.5068306
C5	2171054	2171386	BolC5t29208H	0	+	301	332	332	1.0000000
C5	2171818	2173464	BolC5t29209H	0	-	2171	1646	1646	1.0000000
C5	2184772	2187264	BolC5t29210H	0	+	625	2126	2492	0.8531300
C5	2194220	2195995	BolC5t29211H	0	+	352	1707	1775	0.9616901
C5	2196229	2198027	BolC5t29212H	0	-	688	1798	1798	1.0000000
C5	2204982	2205195	BolC5t29213H	0	-	40	213	213	1.0000000
C5	2207667	2208466	BolC5t29214H	0	+	521	799	799	1.0000000
C5	2209834	2210437	BolC5t29215H	0	+	856	603	603	1.0000000
C5	2210578	2212429	BolC5t29216H	0	-	1529	1851	1851	1.0000000
C5	2216227	2216962	BolC5t29217H	0	+	370	734	735	0.9986395
C5	2219820	2221224	BolC5t29218H	0	+	849	1404	1404	1.0000000
C5	2225879	2227350	BolC5t29219H	0	+	1162	1471	1471	1.0000000
C5	2229372	2230816	BolC5t29220H	0	-	587	1418	1444	0.9819945
C5	2234736	2236153	BolC5t29221H	0	+	529	1239	1417	0.8743825
C5	2245378	2246852	BolC5t29222H	0	-	985	1474	1474	1.0000000
C5	2247350	2248606	BolC5t29223H	0	-	559	1256	1256	1.0000000
C5	2249225	2250820	BolC5t29224H	0	+	1223	1589	1595	0.9962382
C5	2261597	2261849	BolC5t29225H	0	+	554	252	252	1.0000000
C5	2263489	2265924	BolC5t29226H	0	+	588	1982	2435	0.8139631
C5	2266901	2268262	BolC5t29227H	0	-	97	1169	1361	0.8589272
C5	2269489	2270604	BolC5t29228H	0	+	261	935	1115	0.8385651
C5	2271219	2272245	BolC5t29229H	0	-	340	1007	1026	0.9814815
C5	2285313	2285625	BolC5t29230H	0	+	139	312	312	1.0000000
C5	2291141	2291453	BolC5t29231H	0	+	80	312	312	1.0000000
C5	2292613	2293108	BolC5t29232H	0	+	35	408	495	0.8242424
C5	2293367	2294881	BolC5t29233H	0	-	1571	1144	1514	0.7556143
C5	2298506	2301974	BolC5t29234H	0	+	1398	3431	3468	0.9893310
C5	2303150	2303716	BolC5t29235H	0	+	1	79	566	0.1395760
C5	2307313	2308661	BolC5t29236H	0	-	292	1159	1348	0.8597923
C5	2310215	2313968	BolC5t29237H	0	+	1172	3519	3753	0.9376499
C5	2321888	2323346	BolC5t29238H	0	-	333	1458	1458	1.0000000
C5	2333066	2335739	BolC5t29239H	0	+	1930	2673	2673	1.0000000
C5	2336395	2337055	BolC5t29240H	0	+	848	660	660	1.0000000
C5	2337414	2341018	BolC5t29241H	0	-	1614	3473	3604	0.9636515
C5	2342283	2343462	BolC5t29242H	0	-	77	838	1179	0.7107719
C5	2344121	2346264	BolC5t29243H	0	-	1412	2133	2143	0.9953337
C5	2347924	2350442	BolC5t29244H	0	+	904	2206	2518	0.8760921
C5	2350719	2350983	BolC5t29245H	0	-	63	264	264	1.0000000
C5	2353842	2364317	BolC5t29246H	0	+	1780	6520	10475	0.6224344
C5	2365314	2365701	BolC5t29247H	0	-	598	387	387	1.0000000
C5	2366186	2367292	BolC5t29248H	0	+	499	1106	1106	1.0000000
C5	2367759	2369560	BolC5t29249H	0	-	128	1228	1801	0.6818434
C5	2387558	2388486	BolC5t29250H	0	+	0	0	928	0.0000000
C5	2389161	2390043	BolC5t29251H	0	+	533	882	882	1.0000000
C5	2390324	2390764	BolC5t29252H	0	-	110	362	440	0.8227273
C5	2391318	2395049	BolC5t29253H	0	+	2334	3703	3731	0.9924953
C5	2395195	2397107	BolC5t29254H	0	-	771	1890	1912	0.9884937
C5	2397727	2405278	BolC5t29255H	0	-	1054	6663	7551	0.8823997
C5	2405802	2417306	BolC5t29256H	0	+	2676	8065	11504	0.7010605
C5	2417558	2419862	BolC5t29257H	0	-	1623	2272	2304	0.9861111
C5	2420909	2426629	BolC5t29258H	0	+	3464	5676	5720	0.9923077
C5	2427278	2428377	BolC5t29259H	0	+	185	890	1099	0.8098271
C5	2428713	2430327	BolC5t29260H	0	-	873	1614	1614	1.0000000
C5	2431828	2434978	BolC5t29261H	0	-	1044	2969	3150	0.9425397
C5	2435414	2441087	BolC5t29262H	0	-	891	4890	5673	0.8619778
C5	2441441	2443707	BolC5t29263H	0	+	776	1521	2266	0.6712269
C5	2444587	2445415	BolC5t29264H	0	-	530	828	828	1.0000000
C5	2473237	2473711	BolC5t29265H	0	-	0	0	474	0.0000000
C5	2475398	2476541	BolC5t29266H	0	-	852	1143	1143	1.0000000
C5	2479537	2482559	BolC5t29267H	0	+	3991	3022	3022	1.0000000
C5	2483116	2483594	BolC5t29268H	0	+	215	446	478	0.9330544
C5	2484207	2486509	BolC5t29269H	0	-	579	2041	2302	0.8866203
C5	2493162	2493462	BolC5t29270H	0	+	69	255	300	0.8500000
C5	2494060	2499801	BolC5t29271H	0	-	3594	5465	5741	0.9519247
C5	2504003	2505007	BolC5t29272H	0	+	798	1004	1004	1.0000000
C5	2507202	2508944	BolC5t29273H	0	+	496	1715	1742	0.9845006
C5	2510035	2512171	BolC5t29274H	0	-	451	1884	2136	0.8820225
C5	2513217	2518481	BolC5t29275H	0	-	2876	4871	5264	0.9253420
C5	2519734	2520220	BolC5t29276H	0	+	74	449	486	0.9238683
C5	2521090	2525775	BolC5t29277H	0	-	2379	4638	4685	0.9899680
C5	2536891	2537401	BolC5t29278H	0	-	297	477	510	0.9352941
C5	2542735	2544546	BolC5t29279H	0	+	246	1179	1811	0.6510215
C5	2546371	2547737	BolC5t29280H	0	+	587	1243	1366	0.9099561
C5	2547956	2550298	BolC5t29281H	0	-	580	2153	2342	0.9192997
C5	2551469	2553430	BolC5t29282H	0	+	1538	1916	1961	0.9770525
C5	2554507	2556160	BolC5t29283H	0	-	1395	1653	1653	1.0000000
C5	2556952	2558848	BolC5t29284H	0	-	1176	1896	1896	1.0000000
C5	2560790	2560907	BolC5t29285H	0	-	42	117	117	1.0000000
C5	2561547	2563206	BolC5t29286H	0	-	320	1605	1659	0.9674503
C5	2567731	2568328	BolC5t29287H	0	-	12	122	597	0.2043551
C5	2574415	2574622	BolC5t29288H	0	+	0	0	207	0.0000000
C5	2578314	2583340	BolC5t29289H	0	-	916	3929	5026	0.7817350
C5	2585317	2586547	BolC5t29290H	0	-	444	1140	1230	0.9268293
C5	2596831	2597237	BolC5t29291H	0	-	450	406	406	1.0000000
C5	2598898	2599921	BolC5t29292H	0	-	620	1023	1023	1.0000000
C5	2607042	2609160	BolC5t29293H	0	+	831	2107	2118	0.9948064
C5	2610082	2611435	BolC5t29294H	0	-	934	1353	1353	1.0000000
C5	2614169	2615785	BolC5t29295H	0	-	697	1616	1616	1.0000000
C5	2617501	2617834	BolC5t29296H	0	+	7	127	333	0.3813814
C5	2619568	2620389	BolC5t29297H	0	+	32	457	821	0.5566382
C5	2621511	2623739	BolC5t29298H	0	+	777	2228	2228	1.0000000
C5	2624097	2627262	BolC5t29299H	0	-	1470	3153	3165	0.9962085
C5	2635918	2637187	BolC5t29300H	0	+	643	1241	1269	0.9779354
C5	2637576	2639875	BolC5t29301H	0	-	1331	2259	2299	0.9826011
C5	2640898	2643000	BolC5t29302H	0	-	1221	2102	2102	1.0000000
C5	2643939	2645373	BolC5t29303H	0	+	594	1417	1434	0.9881451
C5	2645642	2647070	BolC5t29304H	0	-	439	1346	1428	0.9425770
C5	2648561	2648971	BolC5t29305H	0	-	441	410	410	1.0000000
C5	2648972	2652585	BolC5t29306H	0	-	2321	3232	3613	0.8945475
C5	2658198	2660948	BolC5t29307H	0	+	520	2248	2750	0.8174545
C5	2662161	2663921	BolC5t29308H	0	-	951	1743	1760	0.9903409
C5	2667172	2667568	BolC5t29309H	0	-	113	396	396	1.0000000
C5	2669154	2670111	BolC5t29310H	0	-	514	957	957	1.0000000
C5	2670420	2671257	BolC5t29311H	0	+	201	804	837	0.9605735
C5	2681128	2683015	BolC5t29312H	0	+	825	1887	1887	1.0000000
C5	2684176	2685999	BolC5t29313H	0	-	2199	1823	1823	1.0000000
C5	2688948	2689159	BolC5t29314H	0	+	337	211	211	1.0000000
C5	2690514	2691587	BolC5t29315H	0	-	827	972	1073	0.9058714
C5	2692527	2692863	BolC5t29316H	0	-	249	336	336	1.0000000
C5	2694725	2698682	BolC5t29317H	0	+	1609	3560	3957	0.8996715
C5	2699886	2701363	BolC5t29318H	0	-	1288	1477	1477	1.0000000
C5	2706374	2707656	BolC5t29319H	0	-	439	1008	1282	0.7862715
C5	2710319	2710685	BolC5t29320H	0	-	122	366	366	1.0000000
C5	2711634	2713617	BolC5t29321H	0	-	1337	1909	1983	0.9626828
C5	2718561	2718933	BolC5t29322H	0	+	94	372	372	1.0000000
C5	2721442	2721700	BolC5t29323H	0	-	131	258	258	1.0000000
C5	2727076	2729161	BolC5t29324H	0	-	1952	2085	2085	1.0000000
C5	2738342	2740849	BolC5t29325H	0	-	1902	2408	2507	0.9605106
C5	2742018	2743612	BolC5t29326H	0	+	885	1392	1594	0.8732748
C5	2744149	2747973	BolC5t29327H	0	-	370	2576	3824	0.6736402
C5	2750430	2751261	BolC5t29328H	0	-	452	831	831	1.0000000
C5	2752826	2763185	BolC5t29329H	0	-	1569	6845	10359	0.6607780
C5	2766427	2768303	BolC5t29330H	0	-	467	1842	1876	0.9818763
C5	2770848	2771119	BolC5t29331H	0	-	301	271	271	1.0000000
C5	2779476	2779951	BolC5t29332H	0	-	330	475	475	1.0000000
C5	2781068	2782835	BolC5t29333H	0	-	1384	1767	1767	1.0000000
C5	2785548	2787800	BolC5t29334H	0	+	1636	2252	2252	1.0000000
C5	2792005	2793343	BolC5t29335H	0	-	982	1338	1338	1.0000000
C5	2800933	2808515	BolC5t29336H	0	-	2170	7092	7582	0.9353732
C5	2812320	2814267	BolC5t29337H	0	-	738	1167	1947	0.5993837
C5	2814743	2815055	BolC5t29338H	0	+	121	312	312	1.0000000
C5	2815870	2819762	BolC5t29339H	0	-	2284	3892	3892	1.0000000
C5	2815962	2816609	BolC5t29340H	0	-	555	647	647	1.0000000
C5	2816651	2820115	BolC5t29341H	0	-	1854	3464	3464	1.0000000
C5	2821195	2821825	BolC5t29342H	0	+	414	630	630	1.0000000
C5	2824403	2825780	BolC5t29343H	0	+	582	1351	1377	0.9811184
C5	2826411	2826711	BolC5t29344H	0	-	250	300	300	1.0000000
C5	2829571	2829871	BolC5t29345H	0	-	80	249	300	0.8300000
C5	2832335	2832635	BolC5t29346H	0	-	18	272	300	0.9066667
C5	2835742	2839866	BolC5t29347H	0	+	2190	4065	4124	0.9856935
C5	2843439	2844855	BolC5t29348H	0	+	303	1273	1416	0.8990113
C5	2849595	2851286	BolC5t29349H	0	+	687	1650	1691	0.9757540
C5	2851860	2852421	BolC5t29350H	0	-	0	0	561	0.0000000
C5	2854409	2859293	BolC5t29351H	0	-	3142	4873	4884	0.9977477
C5	2863982	2865099	BolC5t29352H	0	-	0	0	1117	0.0000000
C5	2877463	2885187	BolC5t29353H	0	+	1934	5191	7724	0.6720611
C5	2886554	2891109	BolC5t29354H	0	+	2245	4535	4555	0.9956092
C5	2891545	2893535	BolC5t29355H	0	-	871	1860	1990	0.9346734
C5	2905316	2907114	BolC5t29356H	0	+	1527	1798	1798	1.0000000
C5	2915571	2916756	BolC5t29357H	0	+	532	1090	1185	0.9198312
C5	2918207	2929086	BolC5t29358H	0	+	5389	10398	10879	0.9557864
C5	2929744	2930691	BolC5t29359H	0	-	1060	947	947	1.0000000
C5	2931004	2931998	BolC5t29360H	0	+	700	994	994	1.0000000
C5	2942001	2949226	BolC5t29361H	0	+	5182	7176	7225	0.9932180
C5	2946942	2948203	BolC5t29362H	0	-	1301	1261	1261	1.0000000
C5	2950241	2955258	BolC5t29363H	0	+	2500	4474	5017	0.8917680
C5	2955652	2958622	BolC5t29364H	0	-	1356	2964	2970	0.9979798
C5	2959043	2962122	BolC5t29365H	0	-	1491	3013	3079	0.9785644
C5	2964905	2967623	BolC5t29366H	0	-	1950	2576	2718	0.9477557
C5	2969456	2971468	BolC5t29367H	0	-	2161	2012	2012	1.0000000
C5	2976447	2984777	BolC5t29368H	0	-	1146	5963	8330	0.7158464
C5	2986909	2993327	BolC5t29369H	0	-	3561	4752	6418	0.7404176
C5	2997828	3000060	BolC5t29370H	0	-	718	1946	2232	0.8718638
C5	3000341	3006647	BolC5t29371H	0	-	5200	6306	6306	1.0000000
C5	3003667	3004436	BolC5t29372H	0	-	570	769	769	1.0000000
C5	3009671	3009975	BolC5t29373H	0	+	83	304	304	1.0000000
C5	3010204	3010936	BolC5t29374H	0	+	64	630	732	0.8606557
C5	3024234	3024852	BolC5t29375H	0	+	149	454	618	0.7346278
C5	3032044	3033852	BolC5t29376H	0	-	337	1328	1808	0.7345133
C5	3045131	3046898	BolC5t29377H	0	+	1208	1762	1767	0.9971703
C5	3047406	3049097	BolC5t29378H	0	-	1727	1691	1691	1.0000000
C5	3050346	3054573	BolC5t29379H	0	-	1539	3832	4227	0.9065531
C5	3054837	3055329	BolC5t29380H	0	+	294	492	492	1.0000000
C5	3055356	3055977	BolC5t29381H	0	+	336	621	621	1.0000000
C5	3057506	3060346	BolC5t29382H	0	-	373	1985	2840	0.6989437
C5	3066690	3069453	BolC5t29383H	0	-	200	1870	2763	0.6768006
C5	3070060	3071440	BolC5t29384H	0	-	44	496	1380	0.3594203
C5	3072884	3073544	BolC5t29385H	0	-	280	660	660	1.0000000
C5	3075379	3077452	BolC5t29386H	0	-	499	1048	2073	0.5055475
C5	3078527	3078860	BolC5t29387H	0	-	333	333	333	1.0000000
C5	3089113	3094444	BolC5t29388H	0	+	1625	5091	5331	0.9549803
C5	3095204	3097100	BolC5t29389H	0	-	732	1778	1896	0.9377637
C5	3099212	3099689	BolC5t29390H	0	+	236	477	477	1.0000000
C5	3100264	3115203	BolC5t29391H	0	+	1539	9834	14939	0.6582770
C5	3116029	3118261	BolC5t29392H	0	-	819	2163	2232	0.9690861
C5	3119400	3120600	BolC5t29393H	0	+	473	1200	1200	1.0000000
C5	3121608	3123710	BolC5t29394H	0	-	277	1723	2102	0.8196955
C5	3126368	3129921	BolC5t29395H	0	+	1215	3267	3553	0.9195046
C5	3130903	3132049	BolC5t29396H	0	+	109	832	1146	0.7260035
C5	3134285	3134636	BolC5t29397H	0	-	218	351	351	1.0000000
C5	3137492	3137808	BolC5t29398H	0	-	6	232	316	0.7341772
C5	3139161	3139621	BolC5t29399H	0	-	0	0	460	0.0000000
C5	3145554	3146499	BolC5t29400H	0	+	0	0	945	0.0000000
C5	3149195	3150252	BolC5t29401H	0	+	5	215	1057	0.2034059
C5	3151043	3165525	BolC5t29402H	0	-	536	2678	14482	0.1849192
C5	3158257	3160009	BolC5t29403H	0	-	0	0	1752	0.0000000
C5	3166745	3167392	BolC5t29404H	0	+	56	282	647	0.4358578
C5	3167494	3168463	BolC5t29405H	0	-	44	508	969	0.5242518
C5	3170128	3171260	BolC5t29406H	0	-	86	715	1132	0.6316254
C5	3186299	3187268	BolC5t29407H	0	-	100	692	969	0.7141383
C5	3188027	3193895	BolC5t29408H	0	-	1126	4043	5868	0.6889911
C5	3198337	3199924	BolC5t29409H	0	+	202	1366	1587	0.8607435
C5	3200209	3202664	BolC5t29410H	0	-	1176	2426	2455	0.9881874
C5	3203613	3204180	BolC5t29411H	0	+	405	567	567	1.0000000
C5	3207168	3207782	BolC5t29412H	0	-	210	614	614	1.0000000
C5	3209355	3210661	BolC5t29413H	0	+	1218	1306	1306	1.0000000
C5	3210801	3213408	BolC5t29414H	0	-	1524	2607	2607	1.0000000
C5	3214556	3216580	BolC5t29415H	0	+	997	2024	2024	1.0000000
C5	3218416	3221137	BolC5t29416H	0	+	564	2130	2721	0.7828004
C5	3227399	3231809	BolC5t29417H	0	+	3184	4160	4410	0.9433107
C5	3235312	3238011	BolC5t29418H	0	-	1452	2663	2699	0.9866617
C5	3238288	3239127	BolC5t29419H	0	+	779	839	839	1.0000000
C5	3239455	3241917	BolC5t29420H	0	-	1143	2444	2462	0.9926889
C5	3243042	3245232	BolC5t29421H	0	-	1318	2190	2190	1.0000000
C5	3250551	3254683	BolC5t29422H	0	+	2319	4132	4132	1.0000000
C5	3255006	3256422	BolC5t29423H	0	+	1145	1416	1416	1.0000000
C5	3256886	3259932	BolC5t29424H	0	+	1975	2955	3046	0.9701248
C5	3260660	3262991	BolC5t29425H	0	+	583	2289	2331	0.9819820
C5	3263097	3264254	BolC5t29426H	0	-	229	1042	1157	0.9006050
C5	3266367	3267350	BolC5t29427H	0	+	659	983	983	1.0000000
C5	3268203	3269028	BolC5t29428H	0	-	388	825	825	1.0000000
C5	3270658	3279889	BolC5t29429H	0	+	4133	8371	9231	0.9068357
C5	3282188	3286571	BolC5t29430H	0	+	2887	4368	4383	0.9965777
C5	3287288	3289243	BolC5t29431H	0	-	1646	1955	1955	1.0000000
C5	3293414	3295626	BolC5t29432H	0	-	1499	2212	2212	1.0000000
C5	3299590	3300610	BolC5t29433H	0	+	806	1020	1020	1.0000000
C5	3306431	3306605	BolC5t29434H	0	+	13	66	174	0.3793103
C5	3324471	3325754	BolC5t29435H	0	+	155	817	1283	0.6367888
C5	3341454	3342857	BolC5t29436H	0	-	1453	1403	1403	1.0000000
C5	3348884	3352864	BolC5t29437H	0	+	2351	3953	3980	0.9932161
C5	3353337	3354725	BolC5t29438H	0	-	358	1327	1388	0.9560519
C5	3355619	3356263	BolC5t29439H	0	+	504	644	644	1.0000000
C5	3356323	3365556	BolC5t29440H	0	+	5455	9156	9233	0.9916604
C5	3368149	3371092	BolC5t29441H	0	+	1116	2791	2943	0.9483520
C5	3372088	3374834	BolC5t29442H	0	+	630	2580	2746	0.9395484
C5	3374977	3375607	BolC5t29443H	0	+	246	630	630	1.0000000
C5	3375913	3376727	BolC5t29444H	0	-	439	807	814	0.9914005
C5	3378237	3378895	BolC5t29445H	0	+	153	496	658	0.7537994
C5	3379962	3382910	BolC5t29446H	0	-	2729	2948	2948	1.0000000
C5	3388055	3389117	BolC5t29447H	0	-	299	1059	1062	0.9971752
C5	3391055	3393448	BolC5t29448H	0	-	1514	2271	2393	0.9490179
C5	3396956	3398136	BolC5t29449H	0	+	819	1180	1180	1.0000000
C5	3398685	3400868	BolC5t29450H	0	+	1885	2183	2183	1.0000000
C5	3401461	3401971	BolC5t29451H	0	-	395	510	510	1.0000000
C5	3402634	3405889	BolC5t29452H	0	+	1484	3186	3255	0.9788018
C5	3407806	3411309	BolC5t29453H	0	+	3006	3503	3503	1.0000000
C5	3425067	3428007	BolC5t29454H	0	+	356	2179	2940	0.7411565
C5	3433216	3436489	BolC5t29455H	0	+	2362	3273	3273	1.0000000
C5	3437431	3438701	BolC5t29456H	0	+	469	1260	1270	0.9921260
C5	3440283	3441638	BolC5t29457H	0	+	842	1255	1355	0.9261993
C5	3443781	3447755	BolC5t29458H	0	+	2875	3584	3974	0.9018621
C5	3448112	3452331	BolC5t29459H	0	-	1535	4032	4219	0.9556767
C5	3454460	3458543	BolC5t29460H	0	-	914	3541	4083	0.8672545
C5	3460789	3461863	BolC5t29461H	0	-	747	1070	1074	0.9962756
C5	3463011	3463410	BolC5t29462H	0	-	52	257	399	0.6441103
C5	3473058	3474308	BolC5t29463H	0	-	608	1160	1250	0.9280000
C5	3477470	3480327	BolC5t29464H	0	+	960	2541	2857	0.8893945
C5	3480799	3481445	BolC5t29465H	0	-	551	646	646	1.0000000
C5	3482036	3482993	BolC5t29466H	0	+	523	957	957	1.0000000
C5	3484395	3486243	BolC5t29467H	0	-	905	1774	1848	0.9599567
C5	3496100	3499082	BolC5t29468H	0	-	3244	2982	2982	1.0000000
C5	3511099	3512225	BolC5t29469H	0	-	0	0	1126	0.0000000
C5	3516004	3517016	BolC5t29470H	0	+	207	1012	1012	1.0000000
C5	3518062	3520464	BolC5t29471H	0	-	1664	2383	2402	0.9920899
C5	3520627	3523983	BolC5t29472H	0	-	2139	3275	3356	0.9758641
C5	3524702	3526157	BolC5t29473H	0	+	558	1404	1455	0.9649485
C5	3526368	3527309	BolC5t29474H	0	-	291	941	941	1.0000000
C5	3534406	3537011	BolC5t29475H	0	+	851	2548	2605	0.9781190
C5	3538545	3538799	BolC5t29476H	0	-	492	254	254	1.0000000
C5	3542539	3543154	BolC5t29477H	0	-	13	500	615	0.8130081
C5	3543322	3543936	BolC5t29478H	0	+	25	436	614	0.7100977
C5	3559858	3560307	BolC5t29479H	0	-	15	132	449	0.2939866
C5	3562279	3562556	BolC5t29480H	0	-	4	12	277	0.0433213
C5	3567158	3570076	BolC5t29481H	0	-	619	2866	2918	0.9821796
C5	3570966	3573663	BolC5t29482H	0	-	1009	2652	2697	0.9833148
C5	3581165	3582137	BolC5t29483H	0	+	4	273	972	0.2808642
C5	3582881	3583497	BolC5t29484H	0	+	41	518	616	0.8409091
C5	3588812	3589331	BolC5t29485H	0	+	287	519	519	1.0000000
C5	3590239	3592947	BolC5t29486H	0	+	798	2610	2708	0.9638109
C5	3593309	3595770	BolC5t29487H	0	-	1164	2420	2461	0.9833401
C5	3600940	3601495	BolC5t29488H	0	+	99	407	555	0.7333333
C5	3602301	3604152	BolC5t29489H	0	-	1020	1851	1851	1.0000000
C5	3604675	3605843	BolC5t29490H	0	-	376	1122	1168	0.9606164
C5	3606713	3609053	BolC5t29491H	0	+	2250	2340	2340	1.0000000
C5	3610224	3610854	BolC5t29492H	0	+	364	630	630	1.0000000
C5	3615215	3615716	BolC5t29493H	0	+	203	468	501	0.9341317
C5	3616557	3617164	BolC5t29494H	0	-	112	334	607	0.5502471
C5	3621370	3621703	BolC5t29495H	0	+	463	333	333	1.0000000
C5	3623942	3624449	BolC5t29496H	0	+	263	507	507	1.0000000
C5	3627137	3630330	BolC5t29497H	0	-	1320	3111	3193	0.9743188
C5	3632463	3634710	BolC5t29498H	0	+	423	1958	2247	0.8713841
C5	3635565	3636315	BolC5t29499H	0	+	270	717	750	0.9560000
C5	3636955	3638697	BolC5t29500H	0	-	423	1600	1742	0.9184845
C5	3650954	3652074	BolC5t29501H	0	+	741	1108	1120	0.9892857
C5	3652337	3653586	BolC5t29502H	0	-	646	1249	1249	1.0000000
C5	3657246	3684834	BolC5t29503H	0	+	9931	22738	27588	0.8241989
C5	3662580	3663000	BolC5t29504H	0	+	224	386	420	0.9190476
C5	3673178	3673525	BolC5t29505H	0	-	3	94	347	0.2708934
C5	3687644	3688376	BolC5t29506H	0	-	341	732	732	1.0000000
C5	3693363	3695484	BolC5t29507H	0	+	1784	2075	2121	0.9783121
C5	3714418	3715622	BolC5t29508H	0	+	285	1013	1204	0.8413621
C5	3717756	3718838	BolC5t29509H	0	-	394	947	1082	0.8752310
C5	3720926	3723874	BolC5t29510H	0	+	693	2832	2948	0.9606513
C5	3734798	3736344	BolC5t29511H	0	-	1233	1495	1546	0.9670116
C5	3746238	3746986	BolC5t29512H	0	+	191	707	748	0.9451872
C5	3747873	3752099	BolC5t29513H	0	-	1436	3884	4226	0.9190724
C5	3753906	3754883	BolC5t29514H	0	-	271	977	977	1.0000000
C5	3756423	3757964	BolC5t29515H	0	+	998	1479	1541	0.9597664
C5	3758998	3760008	BolC5t29516H	0	+	327	1010	1010	1.0000000
C5	3760784	3765077	BolC5t29517H	0	+	1638	3946	4293	0.9191707
C5	3787386	3790644	BolC5t29518H	0	-	3462	3258	3258	1.0000000
C5	3791274	3792461	BolC5t29519H	0	-	623	1187	1187	1.0000000
C5	3793570	3795318	BolC5t29520H	0	+	424	1509	1748	0.8632723
C5	3796065	3797161	BolC5t29521H	0	+	504	1085	1096	0.9899635
C5	3799633	3801119	BolC5t29522H	0	-	909	1486	1486	1.0000000
C5	3817740	3818301	BolC5t29523H	0	+	574	561	561	1.0000000
C5	3819040	3819400	BolC5t29524H	0	-	227	360	360	1.0000000
C5	3819493	3819738	BolC5t29525H	0	-	227	245	245	1.0000000
C5	3828528	3829522	BolC5t29526H	0	+	1031	994	994	1.0000000
C5	3830443	3832270	BolC5t29527H	0	-	860	1734	1827	0.9490969
C5	3832679	3833568	BolC5t29528H	0	-	366	856	889	0.9628797
C5	3834022	3835164	BolC5t29529H	0	-	719	1142	1142	1.0000000
C5	3836367	3839004	BolC5t29530H	0	+	1532	2450	2637	0.9290861
C5	3839197	3841963	BolC5t29531H	0	-	1058	2603	2766	0.9410701
C5	3842555	3849485	BolC5t29532H	0	-	3833	6700	6930	0.9668109
C5	3849835	3850811	BolC5t29533H	0	+	469	912	976	0.9344262
C5	3852262	3853976	BolC5t29534H	0	-	1344	1714	1714	1.0000000
C5	3854324	3857280	BolC5t29535H	0	+	1943	2926	2956	0.9898512
C5	3857851	3860592	BolC5t29536H	0	-	1932	2741	2741	1.0000000
C5	3862458	3862740	BolC5t29537H	0	-	188	282	282	1.0000000
C5	3865379	3866559	BolC5t29538H	0	+	925	1180	1180	1.0000000
C5	3866803	3869397	BolC5t29539H	0	+	2718	2594	2594	1.0000000
C5	3869848	3874464	BolC5t29540H	0	-	3790	4616	4616	1.0000000
C5	3874762	3876124	BolC5t29541H	0	+	872	1362	1362	1.0000000
C5	3876526	3879124	BolC5t29542H	0	-	1357	2465	2598	0.9488068
C5	3900129	3900875	BolC5t29543H	0	+	563	689	746	0.9235925
C5	3901363	3901962	BolC5t29544H	0	+	613	599	599	1.0000000
C5	3902432	3904280	BolC5t29545H	0	-	1116	1848	1848	1.0000000
C5	3907083	3909354	BolC5t29546H	0	-	1367	2271	2271	1.0000000
C5	3909858	3912957	BolC5t29547H	0	-	1545	3056	3099	0.9861246
C5	3915106	3917551	BolC5t29548H	0	+	1025	2404	2445	0.9832311
C5	3917767	3918907	BolC5t29549H	0	-	1003	1140	1140	1.0000000
C5	3922159	3922873	BolC5t29550H	0	-	208	714	714	1.0000000
C5	3923634	3926215	BolC5t29551H	0	+	1301	2435	2581	0.9434327
C5	3926982	3929185	BolC5t29552H	0	-	673	1902	2203	0.8633682
C5	3934105	3937919	BolC5t29553H	0	-	1425	3577	3814	0.9378605
C5	3938007	3939780	BolC5t29554H	0	+	403	1730	1773	0.9757473
C5	3941544	3943676	BolC5t29555H	0	-	1425	2132	2132	1.0000000
C5	3944139	3945560	BolC5t29556H	0	-	972	1385	1421	0.9746657
C5	3946176	3949814	BolC5t29557H	0	-	3157	3602	3638	0.9901044
C5	3951114	3953123	BolC5t29558H	0	-	533	1839	2009	0.9153808
C5	3962770	3963463	BolC5t29559H	0	-	171	681	693	0.9826840
C5	3969970	3970330	BolC5t29560H	0	-	46	197	360	0.5472222
C5	3971912	3972650	BolC5t29561H	0	+	34	468	738	0.6341463
C5	3975169	3976328	BolC5t29562H	0	+	628	1138	1159	0.9818809
C5	3979308	3979639	BolC5t29563H	0	+	140	331	331	1.0000000
C5	3982078	3982605	BolC5t29564H	0	-	119	483	527	0.9165086
C5	3987603	3990208	BolC5t29565H	0	+	691	2387	2605	0.9163148
C5	3994845	3997836	BolC5t29566H	0	+	729	2519	2991	0.8421932
C5	3999093	4002965	BolC5t29567H	0	-	2305	3860	3872	0.9969008
C5	4014666	4017191	BolC5t29568H	0	+	1514	2435	2525	0.9643564
C5	4019959	4022526	BolC5t29569H	0	+	579	1522	2567	0.5929100
C5	4032789	4035826	BolC5t29570H	0	+	133	2002	3037	0.6592032
C5	4036897	4038525	BolC5t29571H	0	-	178	1399	1628	0.8593366
C5	4053911	4054343	BolC5t29572H	0	+	297	432	432	1.0000000
C5	4054644	4056700	BolC5t29573H	0	+	1683	2056	2056	1.0000000
C5	4062015	4066756	BolC5t29574H	0	+	3516	4680	4741	0.9871335
C5	4068181	4071090	BolC5t29575H	0	+	1414	2800	2909	0.9625301
C5	4071261	4073165	BolC5t29576H	0	-	420	1511	1904	0.7935925
C5	4083804	4093751	BolC5t29577H	0	+	2160	8157	9947	0.8200462
C5	4094904	4095420	BolC5t29578H	0	-	49	289	516	0.5600775
C5	4101645	4102597	BolC5t29579H	0	-	5	300	952	0.3151261
C5	4110344	4111076	BolC5t29580H	0	-	343	732	732	1.0000000
C5	4112147	4115498	BolC5t29581H	0	-	561	2847	3351	0.8495972
C5	4116587	4116951	BolC5t29582H	0	+	33	343	364	0.9423077
C5	4120602	4121085	BolC5t29583H	0	-	84	453	483	0.9378882
C5	4122240	4123204	BolC5t29584H	0	-	228	964	964	1.0000000
C5	4125251	4126906	BolC5t29585H	0	+	502	1497	1655	0.9045317
C5	4128286	4128916	BolC5t29586H	0	+	130	538	630	0.8539683
C5	4136634	4140336	BolC5t29587H	0	+	1670	3687	3702	0.9959481
C5	4141137	4143381	BolC5t29588H	0	-	442	1533	2244	0.6831551
C5	4144186	4146664	BolC5t29589H	0	+	482	2018	2478	0.8143664
C5	4147103	4149109	BolC5t29590H	0	-	549	1802	2006	0.8983051
C5	4154718	4161403	BolC5t29591H	0	+	2702	6033	6685	0.9024682
C5	4162689	4164204	BolC5t29592H	0	+	537	1419	1515	0.9366336
C5	4164738	4165122	BolC5t29593H	0	-	29	190	384	0.4947917
C5	4168076	4168957	BolC5t29594H	0	-	733	881	881	1.0000000
C5	4172796	4173504	BolC5t29595H	0	-	8	238	708	0.3361582
C5	4186533	4187084	BolC5t29596H	0	-	190	502	551	0.9110708
C5	4187881	4188256	BolC5t29597H	0	-	153	375	375	1.0000000
C5	4188437	4193291	BolC5t29598H	0	-	2843	4851	4854	0.9993820
C5	4196656	4198051	BolC5t29599H	0	+	652	1395	1395	1.0000000
C5	4198632	4202749	BolC5t29600H	0	-	730	3554	4117	0.8632500
C5	4203563	4203725	BolC5t29601H	0	-	262	162	162	1.0000000
C5	4204658	4205440	BolC5t29602H	0	-	345	779	782	0.9961637
C5	4209331	4210625	BolC5t29603H	0	+	132	1132	1294	0.8748068
C5	4210988	4215618	BolC5t29604H	0	-	1331	4113	4630	0.8883370
C5	4216989	4219357	BolC5t29605H	0	-	1462	2368	2368	1.0000000
C5	4228448	4231352	BolC5t29606H	0	-	2243	2904	2904	1.0000000
C5	4234144	4235703	BolC5t29607H	0	+	850	1514	1559	0.9711353
C5	4236298	4237743	BolC5t29608H	0	-	409	1410	1445	0.9757785
C5	4238311	4240796	BolC5t29609H	0	-	1474	1944	2485	0.7822937
C5	4242548	4247258	BolC5t29610H	0	+	1733	4366	4710	0.9269639
C5	4249119	4250174	BolC5t29611H	0	-	352	1055	1055	1.0000000
C5	4252014	4252710	BolC5t29612H	0	+	16	461	696	0.6623563
C5	4258755	4259265	BolC5t29613H	0	+	175	510	510	1.0000000
C5	4285631	4319789	BolC5t29614H	0	+	12385	27693	34158	0.8107325
C5	4293840	4294363	BolC5t29615H	0	+	155	516	523	0.9866157
C5	4295830	4296197	BolC5t29616H	0	-	103	313	367	0.8528610
C5	4298522	4299108	BolC5t29617H	0	-	260	561	586	0.9573379
C5	4301344	4303881	BolC5t29618H	0	+	305	1799	2537	0.7091053
C5	4309163	4309557	BolC5t29619H	0	+	21	86	394	0.2182741
C5	4311361	4315241	BolC5t29620H	0	+	2128	2516	3880	0.6484536
C5	4320452	4320819	BolC5t29621H	0	-	25	274	367	0.7465940
C5	4330688	4330925	BolC5t29622H	0	+	0	0	237	0.0000000
C5	4334174	4334366	BolC5t29623H	0	+	311	192	192	1.0000000
C5	4341413	4343221	BolC5t29624H	0	-	90	865	1808	0.4784292
C5	4347482	4348752	BolC5t29625H	0	-	310	1210	1270	0.9527559
C5	4348997	4352353	BolC5t29626H	0	+	1707	3351	3356	0.9985101
C5	4353143	4354267	BolC5t29627H	0	+	960	1124	1124	1.0000000
C5	4353832	4354267	BolC5t29628H	0	+	352	435	435	1.0000000
C5	4355714	4357802	BolC5t29629H	0	+	589	2031	2088	0.9727011
C5	4359998	4363001	BolC5t29630H	0	+	1046	3003	3003	1.0000000
C5	4366585	4366699	BolC5t29631H	0	+	74	114	114	1.0000000
C5	4366969	4369011	BolC5t29632H	0	-	2250	2042	2042	1.0000000
C5	4369992	4371696	BolC5t29633H	0	-	188	1492	1704	0.8755869
C5	4373891	4383675	BolC5t29634H	0	-	3917	5631	9784	0.5755315
C5	4394733	4395696	BolC5t29635H	0	-	348	785	963	0.8151609
C5	4399457	4400455	BolC5t29636H	0	+	0	0	998	0.0000000
C5	4400595	4401559	BolC5t29637H	0	+	65	243	964	0.2520747
C5	4402486	4402867	BolC5t29638H	0	+	224	381	381	1.0000000
C5	4409755	4410287	BolC5t29639H	0	-	441	532	532	1.0000000
C5	4410969	4412145	BolC5t29640H	0	+	819	1176	1176	1.0000000
C5	4412998	4415100	BolC5t29641H	0	+	1411	2102	2102	1.0000000
C5	4415337	4418397	BolC5t29642H	0	-	862	2965	3060	0.9689543
C5	4419574	4422044	BolC5t29643H	0	-	331	1645	2470	0.6659919
C5	4434671	4436527	BolC5t29644H	0	+	1873	1824	1856	0.9827586
C5	4436727	4438018	BolC5t29645H	0	-	499	1291	1291	1.0000000
C5	4449285	4450024	BolC5t29646H	0	+	536	735	739	0.9945873
C5	4452167	4453737	BolC5t29647H	0	+	1040	1570	1570	1.0000000
C5	4456013	4456166	BolC5t29648H	0	-	24	123	153	0.8039216
C5	4458638	4459035	BolC5t29649H	0	-	186	397	397	1.0000000
C5	4461288	4468146	BolC5t29650H	0	-	2664	6327	6858	0.9225722
C5	4478009	4478342	BolC5t29651H	0	-	216	333	333	1.0000000
C5	4481397	4483529	BolC5t29652H	0	+	1788	2132	2132	1.0000000
C5	4484143	4485127	BolC5t29653H	0	+	1065	984	984	1.0000000
C5	4490178	4493813	BolC5t29654H	0	+	0	0	3635	0.0000000
C5	4495281	4495563	BolC5t29655H	0	-	0	0	282	0.0000000
C5	4497730	4499964	BolC5t29656H	0	+	1125	1964	2234	0.8791406
C5	4503763	4504270	BolC5t29657H	0	-	8	63	507	0.1242604
C5	4506811	4508261	BolC5t29658H	0	+	478	1439	1450	0.9924138
C5	4508592	4509294	BolC5t29659H	0	-	273	702	702	1.0000000
C5	4509685	4512866	BolC5t29660H	0	-	1865	3040	3181	0.9556743
C5	4515179	4519078	BolC5t29661H	0	-	2208	3899	3899	1.0000000
C5	4522373	4524426	BolC5t29662H	0	+	880	2018	2053	0.9829518
C5	4524879	4529622	BolC5t29663H	0	-	2096	4698	4743	0.9905123
C5	4531920	4534210	BolC5t29664H	0	-	1379	2290	2290	1.0000000
C5	4535537	4537915	BolC5t29665H	0	+	903	2292	2378	0.9638352
C5	4538246	4541498	BolC5t29666H	0	-	1097	2935	3252	0.9025216
C5	4547571	4547760	BolC5t29667H	0	+	4	66	189	0.3492064
C5	4552889	4555952	BolC5t29668H	0	+	1789	3051	3063	0.9960822
C5	4556146	4559730	BolC5t29669H	0	-	3456	3566	3584	0.9949777
C5	4560387	4563387	BolC5t29670H	0	+	1332	2959	3000	0.9863333
C5	4563949	4564396	BolC5t29671H	0	+	785	447	447	1.0000000
C5	4564910	4565553	BolC5t29672H	0	+	320	643	643	1.0000000
C5	4586371	4586770	BolC5t29673H	0	+	237	399	399	1.0000000
C5	4588212	4589877	BolC5t29674H	0	-	455	1664	1665	0.9993994
C5	4597350	4601485	BolC5t29675H	0	+	1831	4025	4135	0.9733979
C5	4602175	4605884	BolC5t29676H	0	-	1583	3567	3709	0.9617147
C5	4608952	4611938	BolC5t29677H	0	-	574	2051	2986	0.6868721
C5	4633380	4633622	BolC5t29678H	0	+	127	242	242	1.0000000
C5	4633981	4634384	BolC5t29679H	0	+	570	403	403	1.0000000
C5	4637224	4637458	BolC5t29680H	0	-	27	166	234	0.7094017
C5	4639879	4641756	BolC5t29681H	0	+	1293	1877	1877	1.0000000
C5	4643162	4643987	BolC5t29682H	0	+	498	825	825	1.0000000
C5	4647502	4651393	BolC5t29683H	0	+	2770	3820	3891	0.9817528
C5	4655945	4656410	BolC5t29684H	0	-	4	188	465	0.4043011
C5	4656457	4656863	BolC5t29685H	0	-	16	291	406	0.7167488
C5	4657115	4657535	BolC5t29686H	0	-	34	378	420	0.9000000
C5	4659767	4662453	BolC5t29687H	0	+	2056	2535	2686	0.9437826
C5	4663440	4665778	BolC5t29688H	0	+	1763	2338	2338	1.0000000
C5	4672301	4672574	BolC5t29689H	0	-	55	273	273	1.0000000
C5	4673425	4674458	BolC5t29690H	0	-	212	798	1033	0.7725073
C5	4683986	4684853	BolC5t29691H	0	-	725	867	867	1.0000000
C5	4687718	4688858	BolC5t29692H	0	-	612	1140	1140	1.0000000
C5	4689322	4690292	BolC5t29693H	0	+	209	970	970	1.0000000
C5	4693512	4694316	BolC5t29694H	0	+	581	804	804	1.0000000
C5	4702857	4705584	BolC5t29695H	0	+	991	2513	2727	0.9215255
C5	4705849	4708987	BolC5t29696H	0	-	2516	3138	3138	1.0000000
C5	4710232	4711728	BolC5t29697H	0	+	1286	1496	1496	1.0000000
C5	4712624	4715628	BolC5t29698H	0	+	1050	3004	3004	1.0000000
C5	4715837	4719853	BolC5t29699H	0	+	2413	4016	4016	1.0000000
C5	4741637	4744534	BolC5t29700H	0	-	1790	2816	2897	0.9720401
C5	4744657	4745873	BolC5t29701H	0	-	568	1126	1216	0.9259868
C5	4746650	4747772	BolC5t29702H	0	+	650	1122	1122	1.0000000
C5	4750227	4752435	BolC5t29703H	0	-	838	2188	2208	0.9909420
C5	4753903	4755004	BolC5t29704H	0	+	558	1045	1101	0.9491372
C5	4757571	4761867	BolC5t29705H	0	-	2314	3861	4296	0.8987430
C5	4789006	4790391	BolC5t29706H	0	+	1290	1385	1385	1.0000000
C5	4790835	4791948	BolC5t29707H	0	+	786	1046	1113	0.9398023
C5	4792756	4793633	BolC5t29708H	0	+	750	877	877	1.0000000
C5	4794161	4797633	BolC5t29709H	0	-	1926	3275	3472	0.9432604
C5	4798456	4799604	BolC5t29710H	0	-	324	910	1148	0.7926829
C5	4800332	4801070	BolC5t29711H	0	+	227	570	738	0.7723577
C5	4801260	4802460	BolC5t29712H	0	-	415	1032	1200	0.8600000
C5	4804876	4806124	BolC5t29713H	0	-	195	1240	1248	0.9935898
C5	4808073	4808349	BolC5t29714H	0	+	407	276	276	1.0000000
C5	4819704	4823153	BolC5t29715H	0	+	1918	3449	3449	1.0000000
C5	4823384	4825063	BolC5t29716H	0	-	521	1551	1679	0.9237642
C5	4826563	4827790	BolC5t29717H	0	-	983	1227	1227	1.0000000
C5	4829244	4829589	BolC5t29718H	0	+	90	330	345	0.9565217
C5	4830593	4833929	BolC5t29719H	0	+	680	2626	3336	0.7871703
C5	4835096	4837036	BolC5t29720H	0	+	290	1271	1940	0.6551546
C5	4842947	4843073	BolC5t29721H	0	+	70	126	126	1.0000000
C5	4848528	4849143	BolC5t29722H	0	+	44	239	615	0.3886179
C5	4853464	4855408	BolC5t29723H	0	+	806	1944	1944	1.0000000
C5	4856256	4864035	BolC5t29724H	0	+	4248	7742	7779	0.9952436
C5	4867108	4867300	BolC5t29725H	0	-	44	192	192	1.0000000
C5	4879608	4888758	BolC5t29726H	0	-	5779	8834	9150	0.9654645
C5	4890344	4891937	BolC5t29727H	0	+	217	1235	1593	0.7752668
C5	4907329	4912693	BolC5t29728H	0	+	3567	5230	5364	0.9750186
C5	4920182	4922501	BolC5t29729H	0	-	1171	2310	2319	0.9961190
C5	4925784	4926464	BolC5t29730H	0	+	310	680	680	1.0000000
C5	4928506	4928744	BolC5t29731H	0	+	25	221	238	0.9285714
C5	4945478	4946215	BolC5t29732H	0	-	0	0	737	0.0000000
C5	4950632	4951205	BolC5t29733H	0	+	251	573	573	1.0000000
C5	4952819	4964682	BolC5t29734H	0	-	4792	10795	11863	0.9099722
C5	4965354	4965861	BolC5t29735H	0	-	0	0	507	0.0000000
C5	4969163	4969463	BolC5t29736H	0	+	346	300	300	1.0000000
C5	4973234	4974527	BolC5t29737H	0	+	840	1293	1293	1.0000000
C5	4979518	4979806	BolC5t29738H	0	+	14	145	288	0.5034722
C5	4981401	4982718	BolC5t29739H	0	-	525	1251	1317	0.9498861
C5	4984976	4989714	BolC5t29740H	0	-	533	2942	4738	0.6209371
C5	4991166	4993261	BolC5t29741H	0	-	0	0	2095	0.0000000
C5	4996158	4996717	BolC5t29742H	0	-	0	0	559	0.0000000
C5	5009907	5016315	BolC5t29743H	0	-	697	3620	6408	0.5649189
C5	5019803	5020858	BolC5t29744H	0	-	0	0	1055	0.0000000
C5	5022415	5022974	BolC5t29745H	0	-	0	0	559	0.0000000
C5	5029778	5031859	BolC5t29746H	0	+	104	958	2081	0.4603556
C5	5033321	5039136	BolC5t29747H	0	-	56	894	5815	0.1537403
C5	5043449	5044366	BolC5t29748H	0	+	13	361	917	0.3936750
C5	5057668	5059781	BolC5t29749H	0	+	200	1016	2113	0.4808329
C5	5066274	5067143	BolC5t29750H	0	-	103	798	869	0.9182969
C5	5070600	5073156	BolC5t29751H	0	-	2838	2556	2556	1.0000000
C5	5074266	5075757	BolC5t29752H	0	-	304	1288	1491	0.8638498
C5	5084394	5084600	BolC5t29753H	0	+	56	206	206	1.0000000
C5	5093639	5095043	BolC5t29754H	0	+	471	1278	1404	0.9102564
C5	5103575	5104601	BolC5t29755H	0	-	27	483	1026	0.4707602
C5	5135997	5137026	BolC5t29756H	0	+	20	602	1029	0.5850340
C5	5144425	5144545	BolC5t29757H	0	+	32	120	120	1.0000000
C5	5148897	5150619	BolC5t29758H	0	-	403	1489	1722	0.8646922
C5	5151286	5155798	BolC5t29759H	0	-	1148	3529	4512	0.7821365
C5	5157868	5162748	BolC5t29760H	0	+	867	4183	4880	0.8571721
C5	5165973	5166917	BolC5t29761H	0	+	118	735	944	0.7786017
C5	5167371	5172442	BolC5t29762H	0	-	2453	4866	5071	0.9595740
C5	5174132	5174492	BolC5t29763H	0	-	531	360	360	1.0000000
C5	5175708	5178839	BolC5t29764H	0	+	981	3054	3131	0.9754072
C5	5181171	5182755	BolC5t29765H	0	+	395	1506	1584	0.9507576
C5	5183230	5187289	BolC5t29766H	0	-	2459	3960	4059	0.9756098
C5	5189535	5191609	BolC5t29767H	0	+	2002	2074	2074	1.0000000
C5	5201317	5201869	BolC5t29768H	0	-	93	297	552	0.5380435
C5	5203787	5205474	BolC5t29769H	0	-	479	1615	1687	0.9573207
C5	5210334	5211145	BolC5t29770H	0	-	2	21	811	0.0258940
C5	5217729	5219473	BolC5t29771H	0	+	225	1387	1744	0.7952982
C5	5223649	5225359	BolC5t29772H	0	-	322	1513	1710	0.8847953
C5	5227054	5241390	BolC5t29773H	0	-	1982	7087	14336	0.4943499
C5	5242243	5243797	BolC5t29774H	0	-	385	1395	1554	0.8976834
C5	5244127	5250686	BolC5t29775H	0	+	3918	6523	6559	0.9945114
C5	5251365	5252822	BolC5t29776H	0	-	881	1457	1457	1.0000000
C5	5262072	5263023	BolC5t29777H	0	-	655	951	951	1.0000000
C5	5283292	5287332	BolC5t29778H	0	+	3280	4040	4040	1.0000000
C5	5289693	5290305	BolC5t29779H	0	-	163	612	612	1.0000000
C5	5296725	5297196	BolC5t29780H	0	+	324	471	471	1.0000000
C5	5298278	5298663	BolC5t29781H	0	+	211	385	385	1.0000000
C5	5300155	5300323	BolC5t29782H	0	-	35	168	168	1.0000000
C5	5302327	5304026	BolC5t29783H	0	+	297	1402	1699	0.8251913
C5	5304512	5306030	BolC5t29784H	0	-	1482	1518	1518	1.0000000
C5	5308804	5310215	BolC5t29785H	0	-	52	669	1411	0.4741318
C5	5312593	5315306	BolC5t29786H	0	+	830	2176	2713	0.8020641
C5	5320055	5320520	BolC5t29787H	0	+	54	140	465	0.3010753
C5	5321550	5323120	BolC5t29788H	0	-	317	1028	1570	0.6547771
C5	5326333	5326793	BolC5t29789H	0	+	591	460	460	1.0000000
C5	5328413	5330685	BolC5t29790H	0	-	1119	2148	2272	0.9454225
C5	5330973	5331369	BolC5t29791H	0	+	314	396	396	1.0000000
C5	5336213	5336405	BolC5t29792H	0	-	14	192	192	1.0000000
C5	5345136	5345749	BolC5t29793H	0	+	56	380	613	0.6199021
C5	5358416	5360276	BolC5t29794H	0	+	70	905	1860	0.4865592
C5	5374548	5374832	BolC5t29795H	0	-	412	284	284	1.0000000
C5	5381200	5384344	BolC5t29796H	0	+	851	2710	3144	0.8619593
C5	5385414	5385678	BolC5t29797H	0	+	24	130	264	0.4924242
C5	5386514	5391286	BolC5t29798H	0	+	4437	4772	4772	1.0000000
C5	5391809	5394111	BolC5t29799H	0	-	1052	2292	2302	0.9956560
C5	5394643	5396371	BolC5t29800H	0	+	703	1728	1728	1.0000000
C5	5399149	5399857	BolC5t29801H	0	-	0	0	708	0.0000000
C5	5401757	5403340	BolC5t29802H	0	+	645	1583	1583	1.0000000
C5	5404718	5405429	BolC5t29803H	0	-	697	711	711	1.0000000
C5	5426897	5427381	BolC5t29804H	0	-	148	479	484	0.9896694
C5	5435455	5437387	BolC5t29805H	0	+	1229	1811	1932	0.9373706
C5	5440607	5441234	BolC5t29806H	0	+	256	625	627	0.9968102
C5	5443160	5444153	BolC5t29807H	0	+	254	993	993	1.0000000
C5	5444914	5446035	BolC5t29808H	0	-	359	1092	1121	0.9741302
C5	5450467	5451632	BolC5t29809H	0	-	4	366	1165	0.3141631
C5	5467759	5468978	BolC5t29810H	0	-	378	1211	1219	0.9934372
C5	5479142	5480161	BolC5t29811H	0	-	1548	1019	1019	1.0000000
C5	5485975	5488845	BolC5t29812H	0	+	1701	2870	2870	1.0000000
C5	5495491	5496730	BolC5t29813H	0	+	533	1156	1239	0.9330105
C5	5501843	5503753	BolC5t29814H	0	+	331	1795	1910	0.9397905
C5	5503943	5509998	BolC5t29815H	0	-	1227	5415	6055	0.8943022
C5	5516686	5519428	BolC5t29816H	0	-	505	2622	2742	0.9562363
C5	5521106	5522474	BolC5t29817H	0	-	780	1368	1368	1.0000000
C5	5526901	5531355	BolC5t29818H	0	+	1708	4124	4454	0.9259093
C5	5534844	5534946	BolC5t29819H	0	+	18	102	102	1.0000000
C5	5537460	5539710	BolC5t29820H	0	+	331	2158	2250	0.9591111
C5	5541785	5543272	BolC5t29821H	0	-	364	1487	1487	1.0000000
C5	5544030	5544358	BolC5t29822H	0	-	196	294	328	0.8963414
C5	5545807	5546799	BolC5t29823H	0	-	467	992	992	1.0000000
C5	5550316	5552596	BolC5t29824H	0	+	506	1986	2280	0.8710526
C5	5572181	5572433	BolC5t29825H	0	-	320	252	252	1.0000000
C5	5573873	5575954	BolC5t29826H	0	-	1070	2081	2081	1.0000000
C5	5582948	5583705	BolC5t29827H	0	-	528	757	757	1.0000000
C5	5592575	5594074	BolC5t29828H	0	-	2	190	1499	0.1267512
C5	5595965	5596412	BolC5t29829H	0	+	99	447	447	1.0000000
C5	5598789	5599119	BolC5t29830H	0	+	222	330	330	1.0000000
C5	5599470	5599935	BolC5t29831H	0	+	301	464	465	0.9978495
C5	5602268	5603568	BolC5t29832H	0	-	292	1228	1300	0.9446154
C5	5605177	5605690	BolC5t29833H	0	+	73	416	513	0.8109162
C5	5614219	5616530	BolC5t29834H	0	+	646	2232	2311	0.9658157
C5	5628083	5652344	BolC5t29835H	0	+	5286	14128	24261	0.5823338
C5	5632218	5633505	BolC5t29836H	0	+	142	1079	1287	0.8383839
C5	5644497	5644965	BolC5t29837H	0	-	0	0	468	0.0000000
C5	5652410	5653826	BolC5t29838H	0	+	357	937	1416	0.6617231
C5	5654732	5655083	BolC5t29839H	0	+	20	150	351	0.4273504
C5	5656750	5657209	BolC5t29840H	0	+	2	6	459	0.0130719
C5	5658393	5660564	BolC5t29841H	0	+	125	253	2171	0.1165362
C5	5686597	5687984	BolC5t29842H	0	+	117	935	1387	0.6741168
C5	5694619	5698411	BolC5t29843H	0	-	1702	3573	3792	0.9422469
C5	5701953	5704369	BolC5t29844H	0	-	1236	2393	2416	0.9904801
C5	5707553	5709958	BolC5t29845H	0	-	110	1222	2405	0.5081081
C5	5714221	5714548	BolC5t29846H	0	+	208	327	327	1.0000000
C5	5716865	5718187	BolC5t29847H	0	+	266	1002	1322	0.7579425
C5	5722286	5726471	BolC5t29848H	0	-	3781	4002	4185	0.9562724
C5	5747417	5748052	BolC5t29849H	0	-	5	108	635	0.1700787
C5	5750197	5750416	BolC5t29850H	0	+	134	219	219	1.0000000
C5	5774775	5775189	BolC5t29851H	0	+	10	91	414	0.2198068
C5	5785251	5785671	BolC5t29852H	0	-	9	89	420	0.2119048
C5	5791460	5792943	BolC5t29853H	0	+	180	874	1483	0.5893459
C5	5793803	5794538	BolC5t29854H	0	-	35	638	735	0.8680272
C5	5795458	5796211	BolC5t29855H	0	-	12	19	753	0.0252324
C5	5796672	5797994	BolC5t29856H	0	-	13	276	1322	0.2087746
C5	5798877	5799216	BolC5t29857H	0	+	2	137	339	0.4041298
C5	5800448	5803499	BolC5t29858H	0	-	1470	3044	3051	0.9977057
C5	5810758	5811711	BolC5t29859H	0	-	75	544	953	0.5708290
C5	5826095	5828180	BolC5t29860H	0	-	1416	1973	2085	0.9462830
C5	5838914	5840333	BolC5t29861H	0	+	1647	1419	1419	1.0000000
C5	5842800	5843490	BolC5t29862H	0	+	208	647	690	0.9376811
C5	5853418	5854277	BolC5t29863H	0	-	1875	859	859	1.0000000
C5	5856125	5857517	BolC5t29864H	0	-	70	946	1392	0.6795977
C5	5861741	5865045	BolC5t29865H	0	+	1405	3177	3304	0.9615617
C5	5865831	5868503	BolC5t29866H	0	+	97	1710	2672	0.6399701
C5	5869118	5869355	BolC5t29867H	0	-	61	221	237	0.9324895
C5	5873180	5882642	BolC5t29868H	0	+	479	2701	9462	0.2854576
C5	5892797	5893220	BolC5t29869H	0	+	18	142	423	0.3356974
C5	5894636	5896270	BolC5t29870H	0	+	66	1049	1634	0.6419829
C5	5897207	5898614	BolC5t29871H	0	+	235	894	1407	0.6353945
C5	5899042	5900304	BolC5t29872H	0	-	401	885	1262	0.7012678
C5	5904303	5907886	BolC5t29873H	0	+	985	2618	3583	0.7306726
C5	5908576	5910518	BolC5t29874H	0	-	232	1558	1942	0.8022657
C5	5911739	5913803	BolC5t29875H	0	-	534	1831	2064	0.8871124
C5	5914189	5915449	BolC5t29876H	0	+	570	1260	1260	1.0000000
C5	5915748	5916854	BolC5t29877H	0	-	377	1106	1106	1.0000000
C5	5918202	5922471	BolC5t29878H	0	-	1632	4220	4269	0.9885219
C5	5922910	5924703	BolC5t29879H	0	-	415	1423	1793	0.7936419
C5	5928479	5930086	BolC5t29880H	0	+	168	917	1607	0.5706285
C5	5930459	5931864	BolC5t29881H	0	-	490	1405	1405	1.0000000
C5	5932399	5935247	BolC5t29882H	0	-	1647	2697	2848	0.9469804
C5	5935941	5937341	BolC5t29883H	0	-	274	1293	1400	0.9235714
C5	5939097	5939244	BolC5t29884H	0	-	17	147	147	1.0000000
C5	5940147	5940636	BolC5t29885H	0	+	15	343	489	0.7014315
C5	5944841	5954882	BolC5t29886H	0	+	2981	9396	10041	0.9357634
C5	5959615	5960212	BolC5t29887H	0	-	11	269	597	0.4505863
C5	5975459	5976922	BolC5t29888H	0	+	272	1362	1463	0.9309638
C5	6007353	6007673	BolC5t29889H	0	-	0	0	320	0.0000000
C5	6010546	6011442	BolC5t29890H	0	-	2	115	896	0.1283482
C5	6014991	6015311	BolC5t29891H	0	-	3	131	320	0.4093750
C5	6017505	6018129	BolC5t29892H	0	-	63	305	624	0.4887820
C5	6018292	6018436	BolC5t29893H	0	-	45	129	144	0.8958333
C5	6028142	6030314	BolC5t29894H	0	-	279	1613	2172	0.7426335
C5	6042684	6043456	BolC5t29895H	0	+	439	772	772	1.0000000
C5	6046263	6049530	BolC5t29896H	0	-	1368	3244	3267	0.9929599
C5	6050590	6051990	BolC5t29897H	0	+	478	963	1400	0.6878572
C5	6053274	6055110	BolC5t29898H	0	-	863	1604	1836	0.8736383
C5	6067052	6067739	BolC5t29899H	0	+	243	687	687	1.0000000
C5	6068652	6070883	BolC5t29900H	0	+	367	1813	2231	0.8126401
C5	6072117	6073646	BolC5t29901H	0	+	993	1527	1529	0.9986920
C5	6073818	6074493	BolC5t29902H	0	-	485	675	675	1.0000000
C5	6096973	6098623	BolC5t29903H	0	-	191	1231	1650	0.7460606
C5	6099863	6100556	BolC5t29904H	0	+	1083	693	693	1.0000000
C5	6119298	6120987	BolC5t29905H	0	+	836	1662	1689	0.9840142
C5	6122689	6123661	BolC5t29906H	0	+	872	972	972	1.0000000
C5	6123943	6126557	BolC5t29907H	0	-	1216	2444	2614	0.9349656
C5	6126961	6129726	BolC5t29908H	0	+	2297	2765	2765	1.0000000
C5	6130907	6132862	BolC5t29909H	0	+	1270	1955	1955	1.0000000
C5	6134842	6136231	BolC5t29910H	0	+	453	1389	1389	1.0000000
C5	6139920	6141412	BolC5t29911H	0	+	860	1492	1492	1.0000000
C5	6141883	6144484	BolC5t29912H	0	-	1350	2601	2601	1.0000000
C5	6144910	6146612	BolC5t29913H	0	+	1548	1702	1702	1.0000000
C5	6147043	6147880	BolC5t29914H	0	-	360	837	837	1.0000000
C5	6155947	6156398	BolC5t29915H	0	-	271	451	451	1.0000000
C5	6160186	6162745	BolC5t29916H	0	-	974	2532	2559	0.9894490
C5	6169476	6170993	BolC5t29917H	0	+	1251	1494	1517	0.9848385
C5	6173728	6175898	BolC5t29918H	0	+	860	2170	2170	1.0000000
C5	6176541	6178666	BolC5t29919H	0	-	753	2013	2125	0.9472941
C5	6192991	6197682	BolC5t29920H	0	+	155	1435	4691	0.3059049
C5	6198111	6199485	BolC5t29921H	0	+	475	1374	1374	1.0000000
C5	6200823	6203028	BolC5t29922H	0	+	723	2205	2205	1.0000000
C5	6217984	6220336	BolC5t29923H	0	+	523	1971	2352	0.8380102
C5	6220850	6221230	BolC5t29924H	0	-	306	380	380	1.0000000
C5	6230008	6230592	BolC5t29925H	0	-	190	344	584	0.5890411
C5	6230962	6231154	BolC5t29926H	0	-	11	180	192	0.9375000
C5	6231558	6234293	BolC5t29927H	0	+	1598	1843	2735	0.6738574
C5	6246970	6251555	BolC5t29928H	0	+	1048	4162	4585	0.9077426
C5	6279082	6280345	BolC5t29929H	0	+	0	0	1263	0.0000000
C5	6302724	6302886	BolC5t29930H	0	-	5	146	162	0.9012346
C5	6305599	6322858	BolC5t29931H	0	+	2393	7949	17259	0.4605713
C5	6324969	6325407	BolC5t29932H	0	+	0	0	438	0.0000000
C5	6328937	6329462	BolC5t29933H	0	+	0	0	525	0.0000000
C5	6348393	6349566	BolC5t29934H	0	+	18	762	1173	0.6496164
C5	6390204	6390312	BolC5t29935H	0	-	183	108	108	1.0000000
C5	6405214	6410616	BolC5t29936H	0	+	2170	4701	5402	0.8702332
C5	6419189	6419342	BolC5t29937H	0	+	1	26	153	0.1699346
C5	6421657	6422158	BolC5t29938H	0	-	90	501	501	1.0000000
C5	6430369	6432078	BolC5t29939H	0	+	260	1399	1709	0.8186074
C5	6432746	6435322	BolC5t29940H	0	+	1460	2442	2576	0.9479814
C5	6445329	6446977	BolC5t29941H	0	+	603	1431	1648	0.8683252
C5	6447988	6488551	BolC5t29942H	0	-	15030	29049	40563	0.7161453
C5	6493686	6494504	BolC5t29943H	0	+	12	39	818	0.0476773
C5	6498488	6500254	BolC5t29944H	0	-	74	683	1766	0.3867497
C5	6517232	6518231	BolC5t29945H	0	+	133	595	999	0.5955956
C5	6519023	6560474	BolC5t29946H	0	-	10891	27152	41451	0.6550385
C5	6535026	6535461	BolC5t29947H	0	+	372	435	435	1.0000000
C5	6553887	6556323	BolC5t29948H	0	-	692	2436	2436	1.0000000
C5	6562861	6564217	BolC5t29949H	0	-	879	1356	1356	1.0000000
C5	6587684	6588502	BolC5t29950H	0	+	11	75	818	0.0916870
C5	6600484	6602216	BolC5t29951H	0	-	39	806	1732	0.4653580
C5	6603230	6603812	BolC5t29952H	0	-	343	535	582	0.9192440
C5	6619974	6620661	BolC5t29953H	0	+	349	687	687	1.0000000
C5	6622549	6625868	BolC5t29954H	0	-	1898	3172	3319	0.9557096
C5	6628597	6634319	BolC5t29955H	0	+	1955	5511	5722	0.9631248
C5	6635660	6637241	BolC5t29956H	0	+	508	1416	1581	0.8956357
C5	6637661	6639493	BolC5t29957H	0	-	914	1832	1832	1.0000000
C5	6640058	6641369	BolC5t29958H	0	+	51	567	1311	0.4324943
C5	6643861	6646732	BolC5t29959H	0	-	1590	2871	2871	1.0000000
C5	6647060	6648511	BolC5t29960H	0	+	1034	1451	1451	1.0000000
C5	6648760	6650290	BolC5t29961H	0	+	1083	1530	1530	1.0000000
C5	6651319	6651847	BolC5t29962H	0	-	622	528	528	1.0000000
C5	6652863	6654238	BolC5t29963H	0	-	987	1375	1375	1.0000000
C5	6671692	6672955	BolC5t29964H	0	-	202	931	1263	0.7371338
C5	6682685	6683637	BolC5t29965H	0	+	545	931	952	0.9779412
C5	6683902	6684490	BolC5t29966H	0	+	90	531	588	0.9030612
C5	6690168	6691188	BolC5t29967H	0	-	4896	1020	1020	1.0000000
C5	6718408	6720631	BolC5t29968H	0	+	361	1974	2223	0.8879892
C5	6721382	6722919	BolC5t29969H	0	-	813	1491	1537	0.9700716
C5	6725664	6727390	BolC5t29970H	0	+	293	1181	1726	0.6842410
C5	6733399	6735226	BolC5t29971H	0	+	630	1526	1827	0.8352491
C5	6735474	6737887	BolC5t29972H	0	-	1307	2413	2413	1.0000000
C5	6754101	6756597	BolC5t29973H	0	+	441	2346	2496	0.9399039
C5	6757215	6758046	BolC5t29974H	0	-	613	798	831	0.9602888
C5	6760441	6762678	BolC5t29975H	0	-	520	1961	2237	0.8766205
C5	6761208	6761431	BolC5t29976H	0	-	105	223	223	1.0000000
C5	6765626	6767303	BolC5t29977H	0	+	91	687	1677	0.4096601
C5	6769471	6770404	BolC5t29978H	0	-	38	388	933	0.4158628
C5	6779671	6779950	BolC5t29979H	0	-	123	279	279	1.0000000
C5	6780849	6781068	BolC5t29980H	0	-	134	219	219	1.0000000
C5	6781843	6785628	BolC5t29981H	0	-	1643	3785	3785	1.0000000
C5	6786034	6788875	BolC5t29982H	0	+	1620	2784	2841	0.9799367
C5	6797770	6799263	BolC5t29983H	0	+	115	1157	1493	0.7749498
C5	6800911	6808017	BolC5t29984H	0	+	3907	7106	7106	1.0000000
C5	6810692	6811313	BolC5t29985H	0	-	277	621	621	1.0000000
C5	6819475	6824450	BolC5t29986H	0	+	3388	4975	4975	1.0000000
C5	6825171	6826990	BolC5t29987H	0	-	719	1807	1819	0.9934030
C5	6833166	6834948	BolC5t29988H	0	-	613	1767	1782	0.9915825
C5	6835294	6836756	BolC5t29989H	0	-	623	1462	1462	1.0000000
C5	6837767	6839359	BolC5t29990H	0	-	839	1592	1592	1.0000000
C5	6841205	6843074	BolC5t29991H	0	-	1758	1869	1869	1.0000000
C5	6851844	6853194	BolC5t29992H	0	-	618	1344	1350	0.9955556
C5	6858633	6859029	BolC5t29993H	0	+	365	396	396	1.0000000
C5	6859571	6860736	BolC5t29994H	0	+	655	1165	1165	1.0000000
C5	6862042	6864577	BolC5t29995H	0	+	1110	2424	2535	0.9562130
C5	6866929	6869057	BolC5t29996H	0	+	264	1343	2128	0.6311090
C5	6885410	6885965	BolC5t29997H	0	+	8	121	555	0.2180180
C5	6893553	6908516	BolC5t29998H	0	+	4528	10922	14963	0.7299339
C5	6919597	6920664	BolC5t29999H	0	-	64	356	1067	0.3336457
C5	6921474	6924021	BolC5t30000H	0	-	1149	2262	2547	0.8881037
C5	6929132	6931513	BolC5t30001H	0	-	1323	2141	2381	0.8992020
C5	6933066	6938680	BolC5t30002H	0	-	2432	5338	5614	0.9508372
C5	6947665	6948946	BolC5t30003H	0	+	12	345	1281	0.2693208
C5	6952101	6954524	BolC5t30004H	0	+	271	1714	2423	0.7073875
C5	6961273	6966512	BolC5t30005H	0	-	2202	4970	5239	0.9486543
C5	6980267	6981109	BolC5t30006H	0	+	488	702	842	0.8337292
C5	6986665	6987576	BolC5t30007H	0	+	595	898	911	0.9857300
C5	6988205	6991275	BolC5t30008H	0	+	1051	2836	3070	0.9237785
C5	6991840	6992905	BolC5t30009H	0	-	494	1046	1065	0.9821596
C5	6993452	6995927	BolC5t30010H	0	-	1537	2475	2475	1.0000000
C5	7009824	7010913	BolC5t30011H	0	+	297	1089	1089	1.0000000
C5	7012620	7015099	BolC5t30012H	0	-	619	2251	2479	0.9080274
C5	7018578	7020919	BolC5t30013H	0	-	529	2208	2341	0.9431867
C5	7021454	7022387	BolC5t30014H	0	+	56	533	933	0.5712755
C5	7026291	7026975	BolC5t30015H	0	-	716	684	684	1.0000000
C5	7034804	7035081	BolC5t30016H	0	-	448	277	277	1.0000000
C5	7037196	7040359	BolC5t30017H	0	+	833	2432	3163	0.7688903
C5	7046022	7049523	BolC5t30018H	0	-	227	2279	3501	0.6509569
C5	7053018	7072539	BolC5t30019H	0	-	1404	10648	19521	0.5454639
C5	7054023	7056436	BolC5t30020H	0	+	210	1997	2413	0.8276005
C5	7059244	7059801	BolC5t30021H	0	+	73	526	557	0.9443447
C5	7060808	7061134	BolC5t30022H	0	+	12	169	326	0.5184049
C5	7065536	7066028	BolC5t30023H	0	-	2	150	492	0.3048781
C5	7066675	7067646	BolC5t30024H	0	+	70	825	971	0.8496395
C5	7072938	7074268	BolC5t30025H	0	-	548	1309	1330	0.9842106
C5	7084839	7086645	BolC5t30026H	0	+	128	917	1806	0.5077519
C5	7093896	7096935	BolC5t30027H	0	-	780	2896	3039	0.9529451
C5	7098389	7104511	BolC5t30028H	0	-	1122	4840	6122	0.7905913
C5	7105787	7106006	BolC5t30029H	0	-	38	175	219	0.7990867
C5	7121062	7121164	BolC5t30030H	0	-	12	42	102	0.4117647
C5	7138715	7138871	BolC5t30031H	0	+	32	156	156	1.0000000
C5	7140790	7141640	BolC5t30032H	0	+	243	813	850	0.9564706
C5	7142516	7147585	BolC5t30033H	0	-	4821	5069	5069	1.0000000
C5	7148450	7150870	BolC5t30034H	0	+	1082	2410	2420	0.9958678
C5	7152459	7153740	BolC5t30035H	0	-	220	1281	1281	1.0000000
C5	7157861	7160271	BolC5t30036H	0	-	997	1586	2410	0.6580913
C5	7165225	7166619	BolC5t30037H	0	-	335	1308	1394	0.9383070
C5	7166684	7167519	BolC5t30038H	0	+	17	310	835	0.3712575
C5	7180106	7182956	BolC5t30039H	0	-	34	1024	2850	0.3592983
C5	7183810	7190475	BolC5t30040H	0	-	1779	5646	6665	0.8471118
C5	7209501	7210050	BolC5t30041H	0	+	499	549	549	1.0000000
C5	7210780	7214555	BolC5t30042H	0	-	987	3311	3775	0.8770861
C5	7216001	7216966	BolC5t30043H	0	+	683	965	965	1.0000000
C5	7221914	7222411	BolC5t30044H	0	-	386	497	497	1.0000000
C5	7226004	7231499	BolC5t30045H	0	-	3361	5127	5495	0.9330300
C5	7233497	7234419	BolC5t30046H	0	+	552	712	922	0.7722343
C5	7240896	7241635	BolC5t30047H	0	-	572	739	739	1.0000000
C5	7249650	7252524	BolC5t30048H	0	-	510	2492	2874	0.8670842
C5	7253928	7254585	BolC5t30049H	0	-	326	657	657	1.0000000
C5	7255409	7256160	BolC5t30050H	0	-	230	751	751	1.0000000
C5	7257080	7258439	BolC5t30051H	0	+	356	1334	1359	0.9816041
C5	7259785	7260217	BolC5t30052H	0	+	308	432	432	1.0000000
C5	7262242	7264827	BolC5t30053H	0	-	209	1990	2585	0.7698259
C5	7266299	7267970	BolC5t30054H	0	+	557	1660	1671	0.9934171
C5	7268201	7269362	BolC5t30055H	0	-	33	844	1161	0.7269595
C5	7270459	7272035	BolC5t30056H	0	-	672	1202	1576	0.7626904
C5	7272779	7275270	BolC5t30057H	0	-	714	2115	2491	0.8490566
C5	7278693	7278852	BolC5t30058H	0	-	72	159	159	1.0000000
C5	7279656	7280487	BolC5t30059H	0	-	2	275	831	0.3309266
C5	7293272	7295658	BolC5t30060H	0	+	770	2325	2386	0.9744342
C5	7296657	7297836	BolC5t30061H	0	+	870	1179	1179	1.0000000
C5	7301668	7304448	BolC5t30062H	0	+	566	2018	2780	0.7258993
C5	7304699	7308298	BolC5t30063H	0	-	608	1838	3599	0.5106974
C5	7308701	7310170	BolC5t30064H	0	-	1013	1469	1469	1.0000000
C5	7311992	7314047	BolC5t30065H	0	+	942	2034	2055	0.9897810
C5	7314466	7315201	BolC5t30066H	0	+	79	663	735	0.9020408
C5	7316293	7318206	BolC5t30067H	0	-	1330	1913	1913	1.0000000
C5	7332642	7333851	BolC5t30068H	0	+	2	56	1209	0.0463193
C5	7334455	7334646	BolC5t30069H	0	+	4	161	191	0.8429319
C5	7347364	7352751	BolC5t30070H	0	-	617	3893	5387	0.7226657
C5	7359323	7361161	BolC5t30071H	0	+	964	1838	1838	1.0000000
C5	7361665	7362310	BolC5t30072H	0	-	463	645	645	1.0000000
C5	7363776	7364271	BolC5t30073H	0	-	198	495	495	1.0000000
C5	7364770	7369531	BolC5t30074H	0	+	1116	4026	4761	0.8456207
C5	7370407	7370959	BolC5t30075H	0	+	330	552	552	1.0000000
C5	7371330	7372056	BolC5t30076H	0	-	617	726	726	1.0000000
C5	7372633	7374172	BolC5t30077H	0	+	857	1539	1539	1.0000000
C5	7375812	7379179	BolC5t30078H	0	+	1943	3367	3367	1.0000000
C5	7380110	7388333	BolC5t30079H	0	-	3113	6907	8223	0.8399611
C5	7389156	7391343	BolC5t30080H	0	-	634	1590	2187	0.7270233
C5	7392209	7394269	BolC5t30081H	0	-	1375	2060	2060	1.0000000
C5	7395823	7396928	BolC5t30082H	0	-	384	1068	1105	0.9665158
C5	7397588	7398741	BolC5t30083H	0	+	512	1087	1153	0.9427580
C5	7400180	7402135	BolC5t30084H	0	-	1109	1955	1955	1.0000000
C5	7402603	7403272	BolC5t30085H	0	-	729	669	669	1.0000000
C5	7412543	7413356	BolC5t30086H	0	-	184	642	813	0.7896679
C5	7422577	7423398	BolC5t30087H	0	+	107	764	821	0.9305725
C5	7425527	7426744	BolC5t30088H	0	+	862	1217	1217	1.0000000
C5	7432518	7433399	BolC5t30089H	0	+	102	707	881	0.8024971
C5	7434266	7434494	BolC5t30090H	0	-	161	228	228	1.0000000
C5	7440940	7442726	BolC5t30091H	0	-	1038	1786	1786	1.0000000
C5	7443245	7444186	BolC5t30092H	0	+	256	842	941	0.8947928
C5	7444846	7445263	BolC5t30093H	0	-	45	403	417	0.9664268
C5	7451816	7452862	BolC5t30094H	0	+	113	962	1046	0.9196941
C5	7453163	7453677	BolC5t30095H	0	-	184	514	514	1.0000000
C5	7454037	7455491	BolC5t30096H	0	-	790	1438	1454	0.9889959
C5	7460686	7461463	BolC5t30097H	0	+	21	481	777	0.6190476
C5	7461901	7465709	BolC5t30098H	0	-	1019	3651	3808	0.9587710
C5	7465942	7468868	BolC5t30099H	0	-	1028	2820	2926	0.9637731
C5	7471680	7473343	BolC5t30100H	0	+	404	1630	1663	0.9801564
C5	7473552	7474848	BolC5t30101H	0	-	867	1296	1296	1.0000000
C5	7474820	7475101	BolC5t30102H	0	-	301	281	281	1.0000000
C5	7480080	7481138	BolC5t30103H	0	-	628	1058	1058	1.0000000
C5	7482961	7484939	BolC5t30104H	0	+	709	1975	1978	0.9984833
C5	7485283	7487673	BolC5t30105H	0	-	793	2283	2390	0.9552301
C5	7499818	7500080	BolC5t30106H	0	-	20	262	262	1.0000000
C5	7501438	7501950	BolC5t30107H	0	-	113	473	512	0.9238281
C5	7502874	7503212	BolC5t30108H	0	-	0	0	338	0.0000000
C5	7506156	7508579	BolC5t30109H	0	+	847	2344	2423	0.9673958
C5	7509310	7511902	BolC5t30110H	0	+	637	2334	2592	0.9004630
C5	7512165	7518109	BolC5t30111H	0	-	1281	5371	5944	0.9036003
C5	7527255	7528958	BolC5t30112H	0	+	868	1685	1703	0.9894304
C5	7538177	7539614	BolC5t30113H	0	-	1275	1404	1437	0.9770355
C5	7582927	7584255	BolC5t30114H	0	-	291	1325	1328	0.9977410
C5	7592647	7593122	BolC5t30115H	0	-	169	475	475	1.0000000
C5	7599282	7601330	BolC5t30116H	0	+	1692	2048	2048	1.0000000
C5	7605438	7607924	BolC5t30117H	0	+	872	2368	2486	0.9525342
C5	7615091	7618836	BolC5t30118H	0	+	1287	2634	3745	0.7033378
C5	7635039	7636116	BolC5t30119H	0	+	200	1071	1077	0.9944290
C5	7674515	7677606	BolC5t30120H	0	+	736	2667	3091	0.8628275
C5	7678350	7680647	BolC5t30121H	0	-	1506	2297	2297	1.0000000
C5	7687786	7690923	BolC5t30122H	0	+	2184	3087	3137	0.9840612
C5	7691433	7696638	BolC5t30123H	0	-	1426	5085	5205	0.9769452
C5	7714258	7715177	BolC5t30124H	0	+	621	919	919	1.0000000
C5	7715438	7715824	BolC5t30125H	0	-	446	386	386	1.0000000
C5	7716083	7716567	BolC5t30126H	0	-	288	425	484	0.8780992
C5	7718185	7718317	BolC5t30127H	0	-	110	132	132	1.0000000
C5	7728329	7728938	BolC5t30128H	0	+	306	609	609	1.0000000
C5	7763137	7763625	BolC5t30129H	0	+	1786	488	488	1.0000000
C5	7771005	7771128	BolC5t30130H	0	-	180	123	123	1.0000000
C5	7771647	7772779	BolC5t30131H	0	+	595	1132	1132	1.0000000
C5	7776599	7776794	BolC5t30132H	0	-	249	195	195	1.0000000
C5	7783809	7792306	BolC5t30133H	0	-	5423	8200	8497	0.9650465
C5	7794346	7801739	BolC5t30134H	0	-	4945	7047	7393	0.9531990
C5	7806528	7806851	BolC5t30135H	0	-	376	323	323	1.0000000
C5	7812928	7815469	BolC5t30136H	0	-	578	2483	2541	0.9771743
C5	7816683	7818444	BolC5t30137H	0	+	378	1688	1761	0.9585463
C5	7818887	7819789	BolC5t30138H	0	-	284	902	902	1.0000000
C5	7821312	7822002	BolC5t30139H	0	-	602	690	690	1.0000000
C5	7823988	7829711	BolC5t30140H	0	+	3269	5453	5723	0.9528220
C5	7830126	7831225	BolC5t30141H	0	+	377	1082	1099	0.9845314
C5	7831574	7832883	BolC5t30142H	0	-	725	1309	1309	1.0000000
C5	7833810	7840327	BolC5t30143H	0	+	1811	5602	6517	0.8595980
C5	7841259	7845052	BolC5t30144H	0	+	3520	3644	3793	0.9607171
C5	7845804	7846383	BolC5t30145H	0	-	760	579	579	1.0000000
C5	7851163	7853335	BolC5t30146H	0	+	1219	2172	2172	1.0000000
C5	7854063	7857801	BolC5t30147H	0	+	1532	3725	3738	0.9965222
C5	7858785	7860244	BolC5t30148H	0	+	328	1341	1459	0.9191227
C5	7862385	7865272	BolC5t30149H	0	-	801	2598	2887	0.8998961
C5	7868948	7870286	BolC5t30150H	0	+	341	1310	1338	0.9790732
C5	7870916	7873718	BolC5t30151H	0	-	436	1988	2802	0.7094932
C5	7874783	7876380	BolC5t30152H	0	-	356	1513	1597	0.9474014
C5	7884158	7884555	BolC5t30153H	0	-	109	352	397	0.8866498
C5	7887632	7888069	BolC5t30154H	0	-	95	415	437	0.9496567
C5	7888614	7890558	BolC5t30155H	0	-	375	1913	1944	0.9840535
C5	7890963	7892677	BolC5t30156H	0	+	1171	1703	1714	0.9935822
C5	7895150	7899011	BolC5t30157H	0	+	2911	3829	3861	0.9917120
C5	7899236	7901112	BolC5t30158H	0	-	827	1709	1876	0.9109808
C5	7902408	7903698	BolC5t30159H	0	+	797	1290	1290	1.0000000
C5	7914133	7914412	BolC5t30160H	0	+	301	279	279	1.0000000
C5	7920467	7921389	BolC5t30161H	0	-	552	922	922	1.0000000
C5	7926126	7934413	BolC5t30162H	0	-	2289	4585	8287	0.5532762
C5	7929460	7930376	BolC5t30163H	0	+	1	5	916	0.0054585
C5	7937139	7939579	BolC5t30164H	0	+	2329	2440	2440	1.0000000
C5	7940542	7942372	BolC5t30165H	0	+	879	1830	1830	1.0000000
C5	7942724	7943879	BolC5t30166H	0	-	464	1154	1155	0.9991342
C5	7950008	7950551	BolC5t30167H	0	+	81	543	543	1.0000000
C5	7952139	7957584	BolC5t30168H	0	+	2224	4630	5445	0.8503214
C5	7960322	7962114	BolC5t30169H	0	-	113	1159	1792	0.6467634
C5	7968229	7969039	BolC5t30170H	0	+	198	810	810	1.0000000
C5	7969520	7972909	BolC5t30171H	0	-	2307	3351	3389	0.9887872
C5	7973252	7976183	BolC5t30172H	0	+	713	2600	2931	0.8870693
C5	7977597	7979734	BolC5t30173H	0	+	1178	2137	2137	1.0000000
C5	7983380	7984340	BolC5t30174H	0	+	66	669	960	0.6968750
C5	7985002	7989083	BolC5t30175H	0	-	1503	3861	4081	0.9460917
C5	7989599	7991567	BolC5t30176H	0	+	521	1847	1968	0.9385163
C5	7999779	8001336	BolC5t30177H	0	-	225	1389	1557	0.8921002
C5	8024080	8024959	BolC5t30178H	0	+	80	783	879	0.8907850
C5	8051906	8052170	BolC5t30179H	0	+	106	264	264	1.0000000
C5	8074995	8076564	BolC5t30180H	0	+	927	1569	1569	1.0000000
C5	8076676	8080964	BolC5t30181H	0	-	1491	3724	4288	0.8684701
C5	8085151	8086756	BolC5t30182H	0	-	3541	1605	1605	1.0000000
C5	8089751	8091935	BolC5t30183H	0	+	595	1737	2184	0.7953297
C5	8096622	8097486	BolC5t30184H	0	+	494	864	864	1.0000000
C5	8097821	8100478	BolC5t30185H	0	+	872	2624	2657	0.9875800
C5	8100942	8103464	BolC5t30186H	0	-	1439	2334	2522	0.9254560
C5	8104312	8104645	BolC5t30187H	0	+	60	280	333	0.8408408
C5	8110270	8110555	BolC5t30188H	0	+	62	202	285	0.7087719
C5	8110876	8112934	BolC5t30189H	0	-	162	854	2058	0.4149660
C5	8116461	8116840	BolC5t30190H	0	+	75	379	379	1.0000000
C5	8147253	8148814	BolC5t30191H	0	-	2	23	1561	0.0147341
C5	8162038	8162979	BolC5t30192H	0	-	725	841	941	0.8937301
C5	8200903	8201735	BolC5t30193H	0	+	140	498	832	0.5985577
C5	8208347	8212278	BolC5t30194H	0	+	1362	2961	3931	0.7532434
C5	8214973	8216254	BolC5t30195H	0	-	1118	1281	1281	1.0000000
C5	8219269	8219710	BolC5t30196H	0	-	29	441	441	1.0000000
C5	8231788	8232052	BolC5t30197H	0	-	452	264	264	1.0000000
C5	8238023	8239908	BolC5t30198H	0	+	873	1885	1885	1.0000000
C5	8240548	8243200	BolC5t30199H	0	-	1595	2334	2652	0.8800905
C5	8244830	8250008	BolC5t30200H	0	+	1694	4725	5178	0.9125145
C5	8251164	8252617	BolC5t30201H	0	+	572	1453	1453	1.0000000
C5	8253024	8255622	BolC5t30202H	0	-	1220	2593	2598	0.9980754
C5	8270507	8275295	BolC5t30203H	0	+	2816	4731	4788	0.9880952
C5	8275663	8278699	BolC5t30204H	0	-	1891	3036	3036	1.0000000
C5	8280591	8283603	BolC5t30205H	0	+	502	1522	3012	0.5053121
C5	8287150	8289790	BolC5t30206H	0	-	690	2223	2640	0.8420454
C5	8292133	8294167	BolC5t30207H	0	+	946	1722	2034	0.8466077
C5	8292756	8293865	BolC5t30208H	0	+	674	1109	1109	1.0000000
C5	8306518	8309299	BolC5t30209H	0	+	1168	2767	2781	0.9949659
C5	8310995	8312638	BolC5t30210H	0	+	532	1620	1643	0.9860012
C5	8314133	8316709	BolC5t30211H	0	+	636	2454	2576	0.9526398
C5	8317450	8319008	BolC5t30212H	0	+	618	1532	1558	0.9833120
C5	8320118	8326854	BolC5t30213H	0	+	1018	4790	6736	0.7111045
C5	8328105	8331079	BolC5t30214H	0	+	1304	2950	2974	0.9919301
C5	8331764	8332882	BolC5t30215H	0	+	323	1074	1118	0.9606440
C5	8334164	8337589	BolC5t30216H	0	+	597	3114	3425	0.9091971
C5	8338144	8338600	BolC5t30217H	0	+	77	371	456	0.8135965
C5	8341777	8342294	BolC5t30218H	0	+	387	517	517	1.0000000
C5	8343783	8344451	BolC5t30219H	0	+	836	668	668	1.0000000
C5	8346572	8348411	BolC5t30220H	0	+	910	1714	1839	0.9320283
C5	8348840	8349440	BolC5t30221H	0	-	297	600	600	1.0000000
C5	8350314	8350867	BolC5t30222H	0	-	486	553	553	1.0000000
C5	8353337	8355012	BolC5t30223H	0	+	328	1610	1675	0.9611940
C5	8357291	8358345	BolC5t30224H	0	-	230	1054	1054	1.0000000
C5	8358931	8360721	BolC5t30225H	0	+	1214	1728	1790	0.9653631
C5	8361125	8362947	BolC5t30226H	0	-	2275	1822	1822	1.0000000
C5	8363582	8366295	BolC5t30227H	0	-	661	2563	2713	0.9447107
C5	8366777	8367206	BolC5t30228H	0	-	109	429	429	1.0000000
C5	8370256	8408332	BolC5t30229H	0	+	15258	30056	38076	0.7893686
C5	8384897	8385688	BolC5t30230H	0	+	384	762	791	0.9633375
C5	8397395	8406443	BolC5t30231H	0	+	3396	6827	9048	0.7545314
C5	8403589	8403883	BolC5t30232H	0	+	120	202	294	0.6870748
C5	8418560	8419632	BolC5t30233H	0	+	522	899	1072	0.8386194
C5	8422215	8426104	BolC5t30234H	0	-	1492	3838	3889	0.9868861
C5	8427637	8431686	BolC5t30235H	0	+	1052	3035	4049	0.7495678
C5	8432755	8433374	BolC5t30236H	0	-	21	457	619	0.7382876
C5	8435612	8436777	BolC5t30237H	0	-	72	672	1165	0.5768240
C5	8443597	8447502	BolC5t30238H	0	+	1319	3353	3905	0.8586428
C5	8447927	8450034	BolC5t30239H	0	-	296	1733	2107	0.8224964
C5	8458309	8460471	BolC5t30240H	0	+	1617	2162	2162	1.0000000
C5	8461728	8463773	BolC5t30241H	0	+	741	1961	2045	0.9589242
C5	8464600	8467523	BolC5t30242H	0	+	614	2498	2923	0.8546014
C5	8469069	8471049	BolC5t30243H	0	+	462	1822	1980	0.9202020
C5	8484055	8485823	BolC5t30244H	0	-	14	39	1768	0.0220588
C5	8529634	8530162	BolC5t30245H	0	-	98	479	528	0.9071970
C5	8537960	8544464	BolC5t30246H	0	+	2316	6301	6504	0.9687884
C5	8548595	8551328	BolC5t30247H	0	-	413	713	2733	0.2608855
C5	8569157	8569746	BolC5t30248H	0	+	221	589	589	1.0000000
C5	8571455	8574386	BolC5t30249H	0	-	401	2515	2931	0.8580689
C5	8579816	8580171	BolC5t30250H	0	-	1	13	355	0.0366197
C5	8584400	8585110	BolC5t30251H	0	-	39	164	710	0.2309859
C5	8585520	8586077	BolC5t30252H	0	+	469	557	557	1.0000000
C5	8586637	8587639	BolC5t30253H	0	+	630	1002	1002	1.0000000
C5	8588253	8588532	BolC5t30254H	0	-	21	272	279	0.9749104
C5	8590796	8591596	BolC5t30255H	0	+	29	477	800	0.5962500
C5	8591738	8595437	BolC5t30256H	0	-	1024	3497	3699	0.9453906
C5	8597845	8599718	BolC5t30257H	0	+	420	1731	1873	0.9241858
C5	8600018	8601192	BolC5t30258H	0	-	269	1174	1174	1.0000000
C5	8605038	8605140	BolC5t30259H	0	+	48	102	102	1.0000000
C5	8617369	8618036	BolC5t30260H	0	+	370	655	667	0.9820090
C5	8625565	8625676	BolC5t30261H	0	+	0	0	111	0.0000000
C5	8627734	8629448	BolC5t30262H	0	-	878	1520	1714	0.8868145
C5	8630073	8630367	BolC5t30263H	0	-	204	294	294	1.0000000
C5	8638590	8639395	BolC5t30264H	0	+	782	805	805	1.0000000
C5	8639910	8641465	BolC5t30265H	0	-	1636	1555	1555	1.0000000
C5	8642432	8643060	BolC5t30266H	0	+	533	628	628	1.0000000
C5	8649636	8650373	BolC5t30267H	0	+	101	597	737	0.8100407
C5	8656850	8657609	BolC5t30268H	0	+	130	759	759	1.0000000
C5	8660392	8661428	BolC5t30269H	0	+	156	832	1036	0.8030888
C5	8662176	8666215	BolC5t30270H	0	-	1188	3505	4039	0.8677890
C5	8666913	8671353	BolC5t30271H	0	+	937	3695	4440	0.8322072
C5	8672749	8675668	BolC5t30272H	0	+	328	2542	2919	0.8708462
C5	8678603	8679897	BolC5t30273H	0	-	520	1287	1294	0.9945904
C5	8680589	8682186	BolC5t30274H	0	-	556	1523	1597	0.9536631
C5	8684717	8689849	BolC5t30275H	0	+	1091	4790	5132	0.9333593
C5	8698387	8699980	BolC5t30276H	0	+	476	1587	1593	0.9962335
C5	8701888	8705828	BolC5t30277H	0	+	1794	3937	3940	0.9992386
C5	8706216	8706366	BolC5t30278H	0	+	140	150	150	1.0000000
C5	8708580	8709583	BolC5t30279H	0	-	58	13	1003	0.0129611
C5	8714017	8714425	BolC5t30280H	0	+	105	391	408	0.9583333
C5	8728801	8730016	BolC5t30281H	0	+	41	431	1215	0.3547325
C5	8732746	8734399	BolC5t30282H	0	-	37	492	1653	0.2976407
C5	8735510	8737230	BolC5t30283H	0	+	640	1458	1720	0.8476744
C5	8740177	8744110	BolC5t30284H	0	+	1619	3675	3933	0.9344012
C5	8744427	8745979	BolC5t30285H	0	-	1606	1552	1552	1.0000000
C5	8747742	8749573	BolC5t30286H	0	-	667	1772	1831	0.9677772
C5	8753291	8755379	BolC5t30287H	0	-	262	1652	2088	0.7911878
C5	8762079	8762380	BolC5t30288H	0	-	305	301	301	1.0000000
C5	8765521	8768346	BolC5t30289H	0	-	2065	2823	2825	0.9992920
C5	8769890	8770291	BolC5t30290H	0	-	0	0	401	0.0000000
C5	8773240	8777551	BolC5t30291H	0	+	1638	4063	4311	0.9424728
C5	8778782	8781304	BolC5t30292H	0	+	2133	2444	2522	0.9690722
C5	8781802	8783265	BolC5t30293H	0	-	522	1396	1463	0.9542037
C5	8787454	8789375	BolC5t30294H	0	+	1307	1921	1921	1.0000000
C5	8799779	8800238	BolC5t30295H	0	+	146	449	459	0.9782135
C5	8800640	8801142	BolC5t30296H	0	-	298	502	502	1.0000000
C5	8810555	8812605	BolC5t30297H	0	-	1131	2008	2050	0.9795122
C5	8813067	8813601	BolC5t30298H	0	+	314	534	534	1.0000000
C5	8814474	8817313	BolC5t30299H	0	-	713	2679	2839	0.9436421
C5	8818442	8820529	BolC5t30300H	0	+	1041	2087	2087	1.0000000
C5	8821443	8822514	BolC5t30301H	0	-	604	1028	1071	0.9598506
C5	8825239	8826865	BolC5t30302H	0	+	1077	1457	1626	0.8960640
C5	8844742	8845519	BolC5t30303H	0	+	661	777	777	1.0000000
C5	8849403	8851608	BolC5t30304H	0	+	1232	2205	2205	1.0000000
C5	8851872	8852013	BolC5t30305H	0	-	183	141	141	1.0000000
C5	8852243	8853819	BolC5t30306H	0	-	1061	1576	1576	1.0000000
C5	8854264	8856426	BolC5t30307H	0	-	2013	2162	2162	1.0000000
C5	8865706	8867809	BolC5t30308H	0	-	1600	2103	2103	1.0000000
C5	8890906	8896560	BolC5t30309H	0	+	2132	5308	5654	0.9388044
C5	8900843	8901398	BolC5t30310H	0	+	892	555	555	1.0000000
C5	8902196	8903374	BolC5t30311H	0	-	311	809	1178	0.6867572
C5	8905503	8909330	BolC5t30312H	0	-	2651	3827	3827	1.0000000
C5	8916875	8919234	BolC5t30313H	0	-	189	325	2359	0.1377702
C5	8921394	8924813	BolC5t30314H	0	+	960	2651	3419	0.7753729
C5	8938309	8939224	BolC5t30315H	0	+	503	789	915	0.8622951
C5	8940053	8943312	BolC5t30316H	0	+	166	2900	3259	0.8898435
C5	8944398	8954152	BolC5t30317H	0	+	1886	7412	9754	0.7598934
C5	8948502	8990996	BolC5t30318H	0	-	5789	26579	42494	0.6254765
C5	8952004	8953738	BolC5t30319H	0	+	130	1385	1734	0.7987313
C5	8961773	8962602	BolC5t30320H	0	-	4	265	829	0.3196622
C5	8991937	8993047	BolC5t30321H	0	+	1065	1110	1110	1.0000000
C5	8993380	8996545	BolC5t30322H	0	-	2268	3028	3165	0.9567140
C5	8998321	9000311	BolC5t30323H	0	-	1160	1962	1990	0.9859297
C5	9015849	9018952	BolC5t30324H	0	+	1001	3103	3103	1.0000000
C5	9019429	9021593	BolC5t30325H	0	-	1799	2164	2164	1.0000000
C5	9021928	9022498	BolC5t30326H	0	+	478	570	570	1.0000000
C5	9022580	9024919	BolC5t30327H	0	-	1143	2303	2339	0.9846088
C5	9025245	9026097	BolC5t30328H	0	-	319	786	852	0.9225352
C5	9027016	9027979	BolC5t30329H	0	-	418	912	963	0.9470405
C5	9029389	9032182	BolC5t30330H	0	-	1765	2756	2793	0.9867526
C5	9033687	9035468	BolC5t30331H	0	-	1045	1751	1781	0.9831555
C5	9039360	9041671	BolC5t30332H	0	-	758	2124	2311	0.9190826
C5	9051727	9051961	BolC5t30333H	0	+	0	0	234	0.0000000
C5	9055398	9057897	BolC5t30334H	0	+	4965	2499	2499	1.0000000
C5	9060012	9062175	BolC5t30335H	0	+	1463	2163	2163	1.0000000
C5	9063415	9067658	BolC5t30336H	0	-	1564	3590	4243	0.8460994
C5	9069953	9070529	BolC5t30337H	0	+	358	576	576	1.0000000
C5	9081326	9082689	BolC5t30338H	0	+	390	1314	1363	0.9640499
C5	9086205	9087096	BolC5t30339H	0	-	231	874	891	0.9809203
C5	9088981	9090586	BolC5t30340H	0	-	295	1392	1605	0.8672897
C5	9093063	9096306	BolC5t30341H	0	-	1507	3143	3243	0.9691644
C5	9097105	9098231	BolC5t30342H	0	-	700	1103	1126	0.9795737
C5	9099801	9100122	BolC5t30343H	0	+	0	0	321	0.0000000
C5	9100222	9100642	BolC5t30344H	0	+	54	313	420	0.7452381
C5	9106813	9111475	BolC5t30345H	0	+	2131	4441	4662	0.9525955
C5	9112938	9114653	BolC5t30346H	0	+	724	1705	1715	0.9941691
C5	9115015	9118550	BolC5t30347H	0	-	2420	3493	3535	0.9881188
C5	9120035	9120569	BolC5t30348H	0	-	85	386	534	0.7228464
C5	9129867	9130817	BolC5t30349H	0	-	139	912	950	0.9600000
C5	9132364	9135185	BolC5t30350H	0	-	650	2587	2821	0.9170507
C5	9135669	9136419	BolC5t30351H	0	-	279	750	750	1.0000000
C5	9136807	9146444	BolC5t30352H	0	-	4615	8651	9637	0.8976860
C5	9149179	9149900	BolC5t30353H	0	+	371	721	721	1.0000000
C5	9151091	9151451	BolC5t30354H	0	-	4	85	360	0.2361111
C5	9154008	9154530	BolC5t30355H	0	+	356	522	522	1.0000000
C5	9157795	9158527	BolC5t30356H	0	+	186	732	732	1.0000000
C5	9159982	9161392	BolC5t30357H	0	-	969	1390	1410	0.9858156
C5	9166046	9167245	BolC5t30358H	0	+	0	0	1199	0.0000000
C5	9171426	9173604	BolC5t30359H	0	-	1616	2070	2178	0.9504132
C5	9183315	9185340	BolC5t30360H	0	-	1774	2025	2025	1.0000000
C5	9192194	9196153	BolC5t30361H	0	-	2253	3808	3959	0.9618590
C5	9204191	9204956	BolC5t30362H	0	-	3	146	765	0.1908497
C5	9211062	9211368	BolC5t30363H	0	-	111	306	306	1.0000000
C5	9215161	9215932	BolC5t30364H	0	+	884	771	771	1.0000000
C5	9218222	9223817	BolC5t30365H	0	+	1975	4542	5595	0.8117962
C5	9225841	9227304	BolC5t30366H	0	+	160	1345	1463	0.9193438
C5	9234210	9234483	BolC5t30367H	0	+	60	203	273	0.7435898
C5	9244395	9253628	BolC5t30368H	0	-	2037	7133	9233	0.7725550
C5	9256502	9257328	BolC5t30369H	0	-	80	544	826	0.6585956
C5	9257883	9260190	BolC5t30370H	0	+	397	1913	2307	0.8292154
C5	9260531	9262333	BolC5t30371H	0	+	805	1802	1802	1.0000000
C5	9263562	9267215	BolC5t30372H	0	+	1593	3623	3653	0.9917876
C5	9267692	9271081	BolC5t30373H	0	-	1959	3132	3389	0.9241664
C5	9277595	9282977	BolC5t30374H	0	+	1913	5115	5382	0.9503902
C5	9283595	9285261	BolC5t30375H	0	+	59	611	1666	0.3667467
C5	9289775	9290225	BolC5t30376H	0	+	114	389	450	0.8644444
C5	9291230	9292522	BolC5t30377H	0	+	405	1259	1292	0.9744582
C5	9298391	9301561	BolC5t30378H	0	+	2798	3021	3170	0.9529969
C5	9301995	9302823	BolC5t30379H	0	+	80	626	828	0.7560387
C5	9304855	9306020	BolC5t30380H	0	+	209	988	1165	0.8480687
C5	9306392	9306866	BolC5t30381H	0	+	41	427	474	0.9008439
C5	9307041	9308157	BolC5t30382H	0	-	216	1043	1116	0.9345878
C5	9308626	9311184	BolC5t30383H	0	-	672	2377	2558	0.9292416
C5	9322280	9323579	BolC5t30384H	0	+	748	1299	1299	1.0000000
C5	9343824	9346298	BolC5t30385H	0	+	1939	2397	2474	0.9688763
C5	9349557	9350571	BolC5t30386H	0	+	102	923	1014	0.9102564
C5	9352807	9354565	BolC5t30387H	0	+	1440	1758	1758	1.0000000
C5	9358626	9358830	BolC5t30388H	0	-	0	0	204	0.0000000
C5	9359914	9361068	BolC5t30389H	0	-	3	222	1154	0.1923743
C5	9364548	9367287	BolC5t30390H	0	+	1138	2654	2739	0.9689668
C5	9369143	9371107	BolC5t30391H	0	-	1408	1964	1964	1.0000000
C5	9372704	9373550	BolC5t30392H	0	+	431	846	846	1.0000000
C5	9373799	9375504	BolC5t30393H	0	-	1728	1705	1705	1.0000000
C5	9377592	9379049	BolC5t30394H	0	-	1243	1457	1457	1.0000000
C5	9406089	9410037	BolC5t30395H	0	+	2661	3938	3948	0.9974671
C5	9412884	9414243	BolC5t30396H	0	+	509	1337	1359	0.9838116
C5	9417956	9418316	BolC5t30397H	0	-	0	0	360	0.0000000
C5	9451216	9451793	BolC5t30398H	0	+	54	463	577	0.8024263
C5	9461608	9462121	BolC5t30399H	0	+	564	513	513	1.0000000
C5	9464060	9473756	BolC5t30400H	0	+	2334	7537	9696	0.7773309
C5	9499028	9512563	BolC5t30401H	0	+	2455	9488	13535	0.7009974
C5	9517563	9517668	BolC5t30402H	0	+	19	105	105	1.0000000
C5	9528898	9529916	BolC5t30403H	0	+	10	211	1018	0.2072692
C5	9548295	9548532	BolC5t30404H	0	+	169	237	237	1.0000000
C5	9550923	9551196	BolC5t30405H	0	+	197	273	273	1.0000000
C5	9576417	9576795	BolC5t30406H	0	+	200	378	378	1.0000000
C5	9578962	9579923	BolC5t30407H	0	-	637	961	961	1.0000000
C5	9582464	9583168	BolC5t30408H	0	-	380	704	704	1.0000000
C5	9591172	9593573	BolC5t30409H	0	+	1054	2254	2401	0.9387755
C5	9623578	9625010	BolC5t30410H	0	+	838	1432	1432	1.0000000
C5	9626468	9627620	BolC5t30411H	0	+	368	1152	1152	1.0000000
C5	9642851	9684385	BolC5t30412H	0	+	21298	28460	41534	0.6852217
C5	9648306	9648963	BolC5t30413H	0	-	15	331	657	0.5038052
C5	9650282	9650613	BolC5t30414H	0	+	223	331	331	1.0000000
C5	9651407	9652079	BolC5t30415H	0	-	0	0	672	0.0000000
C5	9672864	9674542	BolC5t30416H	0	-	2095	1678	1678	1.0000000
C5	9684760	9685417	BolC5t30417H	0	-	5	425	657	0.6468797
C5	9686162	9687652	BolC5t30418H	0	+	377	1114	1490	0.7476510
C5	9688126	9688798	BolC5t30419H	0	-	32	527	672	0.7842262
C5	9694955	9696985	BolC5t30420H	0	-	1570	2030	2030	1.0000000
C5	9702463	9702840	BolC5t30421H	0	-	832	377	377	1.0000000
C5	9716413	9716719	BolC5t30422H	0	-	165	303	306	0.9901960
C5	9724358	9724625	BolC5t30423H	0	-	2	69	267	0.2584270
C5	9745445	9745688	BolC5t30424H	0	-	40	140	243	0.5761317
C5	9746547	9746829	BolC5t30425H	0	-	16	229	282	0.8120567
C5	9748247	9750663	BolC5t30426H	0	-	1331	2416	2416	1.0000000
C5	9752480	9753740	BolC5t30427H	0	-	487	1260	1260	1.0000000
C5	9765220	9768588	BolC5t30428H	0	+	1631	3365	3368	0.9991093
C5	9780306	9782483	BolC5t30429H	0	+	1521	2177	2177	1.0000000
C5	9785659	9787839	BolC5t30430H	0	+	333	1467	2180	0.6729358
C5	9789106	9790079	BolC5t30431H	0	-	132	491	973	0.5046248
C5	9798028	9798466	BolC5t30432H	0	-	89	425	438	0.9703196
C5	9799752	9802374	BolC5t30433H	0	-	547	2510	2622	0.9572845
C5	9811494	9814168	BolC5t30434H	0	+	1019	2670	2674	0.9985041
C5	9815029	9817166	BolC5t30435H	0	+	561	1621	2137	0.7585400
C5	9819027	9823329	BolC5t30436H	0	+	1916	3256	4302	0.7568573
C5	9837507	9837630	BolC5t30437H	0	+	162	123	123	1.0000000
C5	9860717	9861362	BolC5t30438H	0	-	97	642	645	0.9953488
C5	9861982	9863623	BolC5t30439H	0	-	559	1617	1641	0.9853747
C5	9873680	9874483	BolC5t30440H	0	-	706	803	803	1.0000000
C5	9877193	9877451	BolC5t30441H	0	+	67	258	258	1.0000000
C5	9877561	9895411	BolC5t30442H	0	+	9930	14002	17850	0.7844258
C5	9887970	9892866	BolC5t30443H	0	+	162	1177	4896	0.2404003
C5	9895514	9895835	BolC5t30444H	0	+	295	321	321	1.0000000
C5	9910293	9911465	BolC5t30445H	0	-	200	877	1172	0.7482935
C5	9914036	9914824	BolC5t30446H	0	+	616	788	788	1.0000000
C5	9915440	9916748	BolC5t30447H	0	+	779	1308	1308	1.0000000
C5	9919754	9919892	BolC5t30448H	0	+	290	138	138	1.0000000
C5	9925145	9927647	BolC5t30449H	0	+	1296	2254	2502	0.9008793
C5	9929214	9930247	BolC5t30450H	0	-	643	1033	1033	1.0000000
C5	9935471	9940988	BolC5t30451H	0	+	3666	5390	5517	0.9769803
C5	9941992	9945421	BolC5t30452H	0	+	397	2962	3429	0.8638087
C5	9945977	9948227	BolC5t30453H	0	+	2017	2250	2250	1.0000000
C5	9949359	9950796	BolC5t30454H	0	-	472	1437	1437	1.0000000
C5	9951165	9951342	BolC5t30455H	0	-	63	177	177	1.0000000
C5	9959481	9959827	BolC5t30456H	0	+	99	274	346	0.7919075
C5	9963447	9964735	BolC5t30457H	0	+	106	1167	1288	0.9060559
C5	9965505	9966477	BolC5t30458H	0	+	219	929	972	0.9557613
C5	9977198	9978067	BolC5t30459H	0	-	383	869	869	1.0000000
C5	9985457	9986080	BolC5t30460H	0	+	243	623	623	1.0000000
C5	9990734	9991877	BolC5t30461H	0	-	362	1137	1143	0.9947507
C5	9993639	9994833	BolC5t30462H	0	-	880	1141	1194	0.9556114
C5	10003444	10004672	BolC5t30463H	0	-	1139	1228	1228	1.0000000
C5	10007839	10008226	BolC5t30464H	0	-	302	387	387	1.0000000
C5	10009007	10013223	BolC5t30465H	0	-	1382	4001	4216	0.9490038
C5	10031961	10037625	BolC5t30466H	0	+	423	2567	5664	0.4532133
C5	10057583	10058104	BolC5t30467H	0	-	559	521	521	1.0000000
C5	10058803	10061249	BolC5t30468H	0	-	1764	2446	2446	1.0000000
C5	10073260	10073718	BolC5t30469H	0	+	0	0	458	0.0000000
C5	10073510	10078351	BolC5t30470H	0	+	1177	3742	4841	0.7729808
C5	10079419	10082597	BolC5t30471H	0	-	1020	2883	3178	0.9071743
C5	10086066	10088341	BolC5t30472H	0	+	1185	2267	2275	0.9964835
C5	10090624	10091683	BolC5t30473H	0	-	143	897	1059	0.8470255
C5	10103030	10103714	BolC5t30474H	0	-	66	527	684	0.7704678
C5	10120194	10121104	BolC5t30475H	0	+	131	762	910	0.8373626
C5	10133818	10136783	BolC5t30476H	0	-	20	58	2965	0.0195616
C5	10147451	10148404	BolC5t30477H	0	+	270	746	953	0.7827912
C5	10152120	10154496	BolC5t30478H	0	-	991	2300	2376	0.9680135
C5	10156723	10158679	BolC5t30479H	0	+	706	1956	1956	1.0000000
C5	10160217	10161315	BolC5t30480H	0	+	237	1098	1098	1.0000000
C5	10161835	10163323	BolC5t30481H	0	-	390	1466	1488	0.9852151
C5	10164338	10166144	BolC5t30482H	0	-	377	1063	1806	0.5885936
C5	10175270	10175619	BolC5t30483H	0	+	651	349	349	1.0000000
C5	10177489	10179186	BolC5t30484H	0	-	1212	1697	1697	1.0000000
C5	10177692	10178196	BolC5t30485H	0	-	459	504	504	1.0000000
C5	10200571	10202935	BolC5t30486H	0	-	1882	2364	2364	1.0000000
C5	10204534	10206065	BolC5t30487H	0	-	924	1506	1531	0.9836708
C5	10209033	10209492	BolC5t30488H	0	-	276	459	459	1.0000000
C5	10210392	10213512	BolC5t30489H	0	-	667	2423	3120	0.7766026
C5	10215391	10216939	BolC5t30490H	0	+	197	939	1548	0.6065891
C5	10223405	10226258	BolC5t30491H	0	-	598	2490	2853	0.8727655
C5	10228281	10228548	BolC5t30492H	0	+	2	31	267	0.1161049
C5	10231058	10231558	BolC5t30493H	0	-	0	0	500	0.0000000
C5	10231822	10232125	BolC5t30494H	0	-	0	0	303	0.0000000
C5	10235286	10236366	BolC5t30495H	0	+	246	1064	1080	0.9851852
C5	10238388	10242693	BolC5t30496H	0	+	1896	3972	4305	0.9226481
C5	10245173	10245278	BolC5t30497H	0	-	6	105	105	1.0000000
C5	10245952	10248879	BolC5t30498H	0	-	1465	2664	2927	0.9101469
C5	10249645	10250021	BolC5t30499H	0	+	251	376	376	1.0000000
C5	10250425	10251152	BolC5t30500H	0	+	135	727	727	1.0000000
C5	10251905	10252683	BolC5t30501H	0	+	363	778	778	1.0000000
C5	10252905	10253352	BolC5t30502H	0	+	110	442	447	0.9888143
C5	10268854	10269131	BolC5t30503H	0	-	212	277	277	1.0000000
C5	10270571	10271657	BolC5t30504H	0	-	748	1086	1086	1.0000000
C5	10273208	10289099	BolC5t30505H	0	-	12842	14001	15891	0.8810648
C5	10290426	10292941	BolC5t30506H	0	-	3589	2515	2515	1.0000000
C5	10294605	10296224	BolC5t30507H	0	-	235	1548	1619	0.9561458
C5	10300011	10300607	BolC5t30508H	0	-	534	596	596	1.0000000
C5	10303962	10306328	BolC5t30509H	0	+	602	2063	2366	0.8719358
C5	10320372	10321109	BolC5t30510H	0	+	66	557	737	0.7557666
C5	10323931	10326978	BolC5t30511H	0	-	117	1615	3047	0.5300295
C5	10334010	10335807	BolC5t30512H	0	+	257	1543	1797	0.8586533
C5	10336043	10336894	BolC5t30513H	0	-	203	616	851	0.7238543
C5	10337064	10344054	BolC5t30514H	0	+	1159	3763	6990	0.5383405
C5	10345185	10346871	BolC5t30515H	0	+	641	1682	1686	0.9976275
C5	10361277	10362267	BolC5t30516H	0	+	324	893	990	0.9020202
C5	10363479	10366286	BolC5t30517H	0	-	311	2407	2807	0.8574991
C5	10379654	10385411	BolC5t30518H	0	-	1030	5049	5757	0.8770193
C5	10390302	10391653	BolC5t30519H	0	-	302	993	1351	0.7350111
C5	10392590	10394220	BolC5t30520H	0	-	1143	1630	1630	1.0000000
C5	10394788	10396590	BolC5t30521H	0	-	977	1802	1802	1.0000000
C5	10399280	10401043	BolC5t30522H	0	+	270	1578	1763	0.8950652
C5	10401236	10406795	BolC5t30523H	0	-	642	4333	5559	0.7794567
C5	10407440	10408163	BolC5t30524H	0	-	277	708	723	0.9792531
C5	10408597	10409443	BolC5t30525H	0	+	187	677	846	0.8002364
C5	10423325	10424336	BolC5t30526H	0	+	332	981	1011	0.9703264
C5	10438124	10439350	BolC5t30527H	0	+	850	1226	1226	1.0000000
C5	10439673	10441047	BolC5t30528H	0	-	877	1374	1374	1.0000000
C5	10442907	10444187	BolC5t30529H	0	-	39	544	1280	0.4250000
C5	10451716	10452856	BolC5t30530H	0	+	258	1019	1140	0.8938596
C5	10455322	10456376	BolC5t30531H	0	-	13	438	1054	0.4155598
C5	10458180	10458522	BolC5t30532H	0	+	7	76	342	0.2222222
C5	10471383	10474583	BolC5t30533H	0	-	461	2283	3200	0.7134375
C5	10515307	10516538	BolC5t30534H	0	-	387	1171	1231	0.9512591
C5	10523856	10524312	BolC5t30535H	0	-	53	276	456	0.6052632
C5	10563334	10563736	BolC5t30536H	0	-	26	289	402	0.7189054
C5	10569499	10570381	BolC5t30537H	0	-	683	882	882	1.0000000
C5	10573103	10573406	BolC5t30538H	0	-	238	303	303	1.0000000
C5	10587259	10587394	BolC5t30539H	0	-	0	0	135	0.0000000
C5	10613043	10613223	BolC5t30540H	0	+	0	0	180	0.0000000
C5	10615865	10619744	BolC5t30541H	0	+	1434	3791	3879	0.9773138
C5	10620174	10622300	BolC5t30542H	0	-	1838	2126	2126	1.0000000
C5	10625167	10627178	BolC5t30543H	0	+	150	1210	2011	0.6016907
C5	10627694	10627796	BolC5t30544H	0	+	139	102	102	1.0000000
C5	10627862	10628282	BolC5t30545H	0	+	507	379	420	0.9023809
C5	10634296	10635665	BolC5t30546H	0	-	454	1291	1369	0.9430241
C5	10636873	10638213	BolC5t30547H	0	-	28	696	1340	0.5194030
C5	10640204	10643081	BolC5t30548H	0	-	851	2828	2877	0.9829684
C5	10645499	10645886	BolC5t30549H	0	+	10	232	387	0.5994832
C5	10648841	10649336	BolC5t30550H	0	-	693	495	495	1.0000000
C5	10656595	10657577	BolC5t30551H	0	-	130	982	982	1.0000000
C5	10668681	10669308	BolC5t30552H	0	-	450	627	627	1.0000000
C5	10669669	10669996	BolC5t30553H	0	-	276	327	327	1.0000000
C5	10670190	10674743	BolC5t30554H	0	-	3286	4421	4553	0.9710081
C5	10681726	10681858	BolC5t30555H	0	+	0	0	132	0.0000000
C5	10690034	10691135	BolC5t30556H	0	+	10	372	1101	0.3378747
C5	10696773	10697475	BolC5t30557H	0	+	308	702	702	1.0000000
C5	10700377	10703742	BolC5t30558H	0	-	1076	3002	3365	0.8921248
C5	10730767	10732123	BolC5t30559H	0	+	359	1317	1356	0.9712389
C5	10748837	10749002	BolC5t30560H	0	+	5	79	165	0.4787879
C5	10757690	10757873	BolC5t30561H	0	+	0	0	183	0.0000000
C5	10778602	10780021	BolC5t30562H	0	-	188	1081	1419	0.7618041
C5	10781283	10782695	BolC5t30563H	0	+	781	1412	1412	1.0000000
C5	10783687	10785727	BolC5t30564H	0	-	1651	2013	2040	0.9867647
C5	10786900	10787898	BolC5t30565H	0	-	266	998	998	1.0000000
C5	10789499	10790291	BolC5t30566H	0	+	266	792	792	1.0000000
C5	10798334	10798904	BolC5t30567H	0	-	500	570	570	1.0000000
C5	10810206	10811461	BolC5t30568H	0	-	1250	1255	1255	1.0000000
C5	10814262	10814403	BolC5t30569H	0	-	10	141	141	1.0000000
C5	10828550	10829824	BolC5t30570H	0	-	520	1274	1274	1.0000000
C5	10832781	10835616	BolC5t30571H	0	+	1664	2809	2835	0.9908289
C5	10836482	10843946	BolC5t30572H	0	+	2744	5409	7464	0.7246785
C5	10850465	10851429	BolC5t30573H	0	-	11	119	964	0.1234440
C5	10852288	10852772	BolC5t30574H	0	-	172	372	484	0.7685950
C5	10854378	10855005	BolC5t30575H	0	+	227	627	627	1.0000000
C5	10855955	10859010	BolC5t30576H	0	-	298	1359	3055	0.4448445
C5	10863109	10863319	BolC5t30577H	0	-	346	210	210	1.0000000
C5	10865827	10866210	BolC5t30578H	0	-	317	383	383	1.0000000
C5	10866449	10866898	BolC5t30579H	0	-	289	449	449	1.0000000
C5	10887298	10887513	BolC5t30580H	0	-	68	215	215	1.0000000
C5	10888969	10890898	BolC5t30581H	0	-	663	1585	1929	0.8216693
C5	10896420	10897516	BolC5t30582H	0	-	350	1017	1096	0.9279197
C5	10897786	10900069	BolC5t30583H	0	+	248	1698	2283	0.7437582
C5	10902140	10905165	BolC5t30584H	0	+	321	2177	3025	0.7196694
C5	10906207	10907757	BolC5t30585H	0	-	486	1550	1550	1.0000000
C5	10918427	10919312	BolC5t30586H	0	-	16	597	885	0.6745763
C5	10931146	10932751	BolC5t30587H	0	+	395	1571	1605	0.9788162
C5	10936440	10937205	BolC5t30588H	0	+	146	716	765	0.9359477
C5	10952501	10953041	BolC5t30589H	0	-	0	0	540	0.0000000
C5	10970520	10971591	BolC5t30590H	0	-	7	128	1071	0.1195145
C5	10981666	10983074	BolC5t30591H	0	-	0	0	1408	0.0000000
C5	10985352	10985806	BolC5t30592H	0	+	352	454	454	1.0000000
C5	10988542	10989428	BolC5t30593H	0	+	150	886	886	1.0000000
C5	10994163	10994602	BolC5t30594H	0	-	264	439	439	1.0000000
C5	11001325	11001653	BolC5t30595H	0	-	44	328	328	1.0000000
C5	11001798	11001963	BolC5t30596H	0	-	7	165	165	1.0000000
C5	11008063	11008570	BolC5t30597H	0	-	95	435	507	0.8579882
C5	11009039	11010088	BolC5t30598H	0	-	268	921	1049	0.8779790
C5	11027736	11029395	BolC5t30599H	0	-	333	1372	1659	0.8270042
C5	11063817	11064198	BolC5t30600H	0	-	306	381	381	1.0000000
C5	11114128	11118000	BolC5t30601H	0	+	1595	3844	3872	0.9927686
C5	11118351	11121709	BolC5t30602H	0	-	4125	3358	3358	1.0000000
C5	11125704	11127200	BolC5t30603H	0	+	1144	1496	1496	1.0000000
C5	11129962	11133299	BolC5t30604H	0	-	1279	3164	3337	0.9481570
C5	11145926	11147050	BolC5t30605H	0	-	248	1010	1124	0.8985765
C5	11151731	11153343	BolC5t30606H	0	+	1179	1592	1612	0.9875931
C5	11154362	11154818	BolC5t30607H	0	+	83	183	456	0.4013158
C5	11155024	11157041	BolC5t30608H	0	-	657	1957	2017	0.9702529
C5	11157658	11158048	BolC5t30609H	0	-	410	390	390	1.0000000
C5	11163642	11169824	BolC5t30610H	0	-	4371	6172	6182	0.9983824
C5	11176856	11178963	BolC5t30611H	0	+	1484	2049	2107	0.9724727
C5	11179608	11182026	BolC5t30612H	0	-	1453	2418	2418	1.0000000
C5	11183720	11185646	BolC5t30613H	0	-	1213	1820	1926	0.9449636
C5	11186578	11188804	BolC5t30614H	0	-	1820	2024	2226	0.9092543
C5	11195475	11196645	BolC5t30615H	0	+	922	1170	1170	1.0000000
C5	11200960	11202012	BolC5t30616H	0	-	932	1052	1052	1.0000000
C5	11207357	11208315	BolC5t30617H	0	-	929	958	958	1.0000000
C5	11212080	11212668	BolC5t30618H	0	+	206	588	588	1.0000000
C5	11212749	11214784	BolC5t30619H	0	+	380	1895	2035	0.9312039
C5	11226482	11242361	BolC5t30620H	0	+	4253	9897	15879	0.6232760
C5	11228227	11229187	BolC5t30621H	0	+	399	927	960	0.9656250
C5	11250578	11250812	BolC5t30622H	0	+	42	234	234	1.0000000
C5	11251288	11251534	BolC5t30623H	0	-	22	246	246	1.0000000
C5	11252516	11254870	BolC5t30624H	0	+	504	2108	2354	0.8954970
C5	11255363	11258353	BolC5t30625H	0	-	988	2717	2990	0.9086956
C5	11259145	11261104	BolC5t30626H	0	+	365	1731	1959	0.8836141
C5	11269543	11272616	BolC5t30627H	0	+	1822	3073	3073	1.0000000
C5	11273009	11274682	BolC5t30628H	0	-	695	1648	1673	0.9850568
C5	11309555	11312984	BolC5t30629H	0	-	1512	3419	3429	0.9970837
C5	11328329	11329133	BolC5t30630H	0	+	4	163	804	0.2027363
C5	11332711	11333732	BolC5t30631H	0	+	1048	1021	1021	1.0000000
C5	11339842	11340130	BolC5t30632H	0	+	28	212	288	0.7361111
C5	11341220	11348295	BolC5t30633H	0	-	3023	6726	7075	0.9506714
C5	11348792	11349294	BolC5t30634H	0	-	0	0	502	0.0000000
C5	11363371	11365753	BolC5t30635H	0	-	3020	1618	2382	0.6792611
C5	11368675	11370915	BolC5t30636H	0	-	946	2159	2240	0.9638393
C5	11372186	11376896	BolC5t30637H	0	+	1692	4605	4710	0.9777070
C5	11378016	11378493	BolC5t30638H	0	-	553	477	477	1.0000000
C5	11380435	11381645	BolC5t30639H	0	+	786	1210	1210	1.0000000
C5	11394366	11394963	BolC5t30640H	0	+	65	498	597	0.8341709
C5	11408981	11410471	BolC5t30641H	0	+	1259	1490	1490	1.0000000
C5	11410767	11413571	BolC5t30642H	0	-	257	2260	2804	0.8059914
C5	11417096	11418861	BolC5t30643H	0	+	705	1506	1765	0.8532578
C5	11425947	11426292	BolC5t30644H	0	+	435	345	345	1.0000000
C5	11462302	11462788	BolC5t30645H	0	-	227	486	486	1.0000000
C5	11475294	11477523	BolC5t30646H	0	-	742	2090	2229	0.9376402
C5	11477655	11478297	BolC5t30647H	0	-	392	642	642	1.0000000
C5	11482638	11486446	BolC5t30648H	0	-	1368	3399	3808	0.8925945
C5	11490269	11501747	BolC5t30649H	0	-	2316	7752	11478	0.6753790
C5	11501786	11502081	BolC5t30650H	0	-	507	295	295	1.0000000
C5	11509385	11510506	BolC5t30651H	0	+	498	1121	1121	1.0000000
C5	11511691	11513421	BolC5t30652H	0	-	1422	1730	1730	1.0000000
C5	11515018	11515688	BolC5t30653H	0	+	268	670	670	1.0000000
C5	11516737	11527762	BolC5t30654H	0	-	4985	9510	11025	0.8625850
C5	11539882	11540809	BolC5t30655H	0	+	200	927	927	1.0000000
C5	11547366	11550638	BolC5t30656H	0	-	1165	2895	3272	0.8847799
C5	11552547	11556060	BolC5t30657H	0	+	626	1768	3513	0.5032735
C5	11556919	11559970	BolC5t30658H	0	+	1097	2826	3051	0.9262537
C5	11560220	11561157	BolC5t30659H	0	-	769	937	937	1.0000000
C5	11570036	11570525	BolC5t30660H	0	+	76	489	489	1.0000000
C5	11578050	11578528	BolC5t30661H	0	+	363	478	478	1.0000000
C5	11595392	11598367	BolC5t30662H	0	-	720	2406	2975	0.8087395
C5	11641676	11645503	BolC5t30663H	0	-	2552	3827	3827	1.0000000
C5	11648560	11651155	BolC5t30664H	0	-	1345	2595	2595	1.0000000
C5	11658564	11663621	BolC5t30665H	0	+	765	3979	5057	0.7868301
C5	11672500	11676445	BolC5t30666H	0	+	1186	3421	3945	0.8671736
C5	11684567	11686233	BolC5t30667H	0	-	686	1520	1666	0.9123650
C5	11694215	11694901	BolC5t30668H	0	+	309	686	686	1.0000000
C5	11697797	11698118	BolC5t30669H	0	+	192	321	321	1.0000000
C5	11709567	11710647	BolC5t30670H	0	+	617	1080	1080	1.0000000
C5	11731175	11731901	BolC5t30671H	0	+	211	604	726	0.8319559
C5	11738584	11743171	BolC5t30672H	0	+	419	3637	4587	0.7928929
C5	11744033	11744186	BolC5t30673H	0	-	4	105	153	0.6862745
C5	11769935	11770676	BolC5t30674H	0	+	197	741	741	1.0000000
C5	11771077	11771254	BolC5t30675H	0	-	0	0	177	0.0000000
C5	11781563	11792418	BolC5t30676H	0	-	498	3721	10855	0.3427913
C5	11799178	11799466	BolC5t30677H	0	-	0	0	288	0.0000000
C5	11801880	11805627	BolC5t30678H	0	+	2668	3735	3747	0.9967974
C5	11806021	11807820	BolC5t30679H	0	-	918	1489	1799	0.8276820
C5	11809468	11812336	BolC5t30680H	0	-	1959	2810	2868	0.9797769
C5	11816854	11818829	BolC5t30681H	0	+	591	1904	1975	0.9640507
C5	11819619	11842974	BolC5t30682H	0	-	10940	22149	23355	0.9483622
C5	11828866	11829766	BolC5t30683H	0	-	434	900	900	1.0000000
C5	11835281	11835642	BolC5t30684H	0	-	76	325	361	0.9002770
C5	11841531	11841873	BolC5t30685H	0	-	129	342	342	1.0000000
C5	11853849	11854455	BolC5t30686H	0	+	7	105	606	0.1732673
C5	11858294	11858733	BolC5t30687H	0	-	375	439	439	1.0000000
C5	11858800	11859245	BolC5t30688H	0	+	452	445	445	1.0000000
C5	11859802	11860524	BolC5t30689H	0	-	520	722	722	1.0000000
C5	11864940	11865117	BolC5t30690H	0	-	203	177	177	1.0000000
C5	11867272	11868693	BolC5t30691H	0	-	998	1421	1421	1.0000000
C5	11878449	11879649	BolC5t30692H	0	+	238	1187	1200	0.9891667
C5	11880897	11883587	BolC5t30693H	0	+	1051	2382	2690	0.8855019
C5	11884769	11885908	BolC5t30694H	0	+	16	267	1139	0.2344162
C5	11898170	11899066	BolC5t30695H	0	-	103	625	896	0.6975446
C5	11902138	11976905	BolC5t30696H	0	+	23646	58892	74767	0.7876737
C5	11903984	11904518	BolC5t30697H	0	+	56	205	534	0.3838951
C5	11904597	11905196	BolC5t30698H	0	-	467	599	599	1.0000000
C5	11911753	11912458	BolC5t30699H	0	-	513	705	705	1.0000000
C5	11963931	11965045	BolC5t30700H	0	-	0	0	1114	0.0000000
C5	11977626	11995125	BolC5t30701H	0	+	5049	12163	17499	0.6950683
C5	11980585	11981164	BolC5t30702H	0	-	0	0	579	0.0000000
C5	11984226	11985385	BolC5t30703H	0	-	14	337	1159	0.2907679
C5	11987467	11989355	BolC5t30704H	0	+	1172	1888	1888	1.0000000
C5	11990169	11990923	BolC5t30705H	0	+	367	754	754	1.0000000
C5	12000739	12003370	BolC5t30706H	0	+	983	2564	2631	0.9745344
C5	12003634	12005129	BolC5t30707H	0	-	378	908	1495	0.6073579
C5	12015360	12016452	BolC5t30708H	0	-	406	1092	1092	1.0000000
C5	12031746	12032694	BolC5t30709H	0	+	1215	948	948	1.0000000
C5	12032788	12033754	BolC5t30710H	0	+	1795	966	966	1.0000000
C5	12035285	12035419	BolC5t30711H	0	-	12	106	134	0.7910448
C5	12035490	12036714	BolC5t30712H	0	-	126	1179	1224	0.9632353
C5	12060729	12065097	BolC5t30713H	0	-	1824	4296	4368	0.9835165
C5	12073168	12073909	BolC5t30714H	0	-	350	741	741	1.0000000
C5	12077776	12078541	BolC5t30715H	0	+	194	668	765	0.8732026
C5	12079006	12080351	BolC5t30716H	0	-	1464	1345	1345	1.0000000
C5	12084636	12085053	BolC5t30717H	0	-	285	417	417	1.0000000
C5	12090558	12092837	BolC5t30718H	0	+	515	2190	2279	0.9609478
C5	12101501	12102717	BolC5t30719H	0	+	182	899	1216	0.7393092
C5	12103043	12105307	BolC5t30720H	0	-	1220	2264	2264	1.0000000
C5	12106689	12107699	BolC5t30721H	0	-	550	1010	1010	1.0000000
C5	12133295	12133489	BolC5t30722H	0	+	150	194	194	1.0000000
C5	12133500	12133729	BolC5t30723H	0	+	50	165	229	0.7205240
C5	12138263	12140943	BolC5t30724H	0	+	1132	2661	2680	0.9929104
C5	12143404	12144611	BolC5t30725H	0	+	335	1144	1207	0.9478045
C5	12144826	12146608	BolC5t30726H	0	-	936	1713	1782	0.9612795
C5	12158710	12160441	BolC5t30727H	0	+	709	1693	1731	0.9780474
C5	12160871	12161318	BolC5t30728H	0	-	179	447	447	1.0000000
C5	12166204	12167424	BolC5t30729H	0	-	397	1220	1220	1.0000000
C5	12183063	12185105	BolC5t30730H	0	-	1119	2042	2042	1.0000000
C5	12193393	12206075	BolC5t30731H	0	-	7300	12462	12682	0.9826526
C5	12197158	12200559	BolC5t30732H	0	-	1231	3300	3401	0.9703029
C5	12202146	12202369	BolC5t30733H	0	+	464	223	223	1.0000000
C5	12208648	12209154	BolC5t30734H	0	-	335	506	506	1.0000000
C5	12209671	12210646	BolC5t30735H	0	-	513	897	975	0.9200000
C5	12217322	12218006	BolC5t30736H	0	+	1018	684	684	1.0000000
C5	12218629	12218926	BolC5t30737H	0	+	1	39	297	0.1313131
C5	12222376	12222556	BolC5t30738H	0	-	259	180	180	1.0000000
C5	12225484	12225763	BolC5t30739H	0	-	253	279	279	1.0000000
C5	12226740	12226942	BolC5t30740H	0	+	348	202	202	1.0000000
C5	12231135	12231545	BolC5t30741H	0	+	80	410	410	1.0000000
C5	12231752	12232927	BolC5t30742H	0	+	271	1175	1175	1.0000000
C5	12232942	12233149	BolC5t30743H	0	+	75	207	207	1.0000000
C5	12233270	12234691	BolC5t30744H	0	+	432	1421	1421	1.0000000
C5	12238024	12238232	BolC5t30745H	0	+	88	208	208	1.0000000
C5	12243811	12244024	BolC5t30746H	0	-	28	186	213	0.8732395
C5	12259291	12259501	BolC5t30747H	0	-	244	210	210	1.0000000
C5	12275080	12277356	BolC5t30748H	0	-	811	2039	2276	0.8958700
C5	12290654	12291191	BolC5t30749H	0	+	435	537	537	1.0000000
C5	12291412	12292256	BolC5t30750H	0	-	264	844	844	1.0000000
C5	12292421	12294600	BolC5t30751H	0	-	831	2179	2179	1.0000000
C5	12294103	12294859	BolC5t30752H	0	+	337	756	756	1.0000000
C5	12295972	12296437	BolC5t30753H	0	-	88	379	465	0.8150538
C5	12305780	12307319	BolC5t30754H	0	+	1024	1539	1539	1.0000000
C5	12307843	12315544	BolC5t30755H	0	-	5735	7680	7701	0.9972731
C5	12316278	12319287	BolC5t30756H	0	-	2067	2981	3009	0.9906946
C5	12324291	12326125	BolC5t30757H	0	-	2563	1834	1834	1.0000000
C5	12326889	12332836	BolC5t30758H	0	+	825	3947	5947	0.6636960
C5	12333867	12337786	BolC5t30759H	0	+	926	2932	3919	0.7481501
C5	12338035	12341154	BolC5t30760H	0	-	2676	3119	3119	1.0000000
C5	12345617	12345994	BolC5t30761H	0	+	336	377	377	1.0000000
C5	12352162	12354977	BolC5t30762H	0	+	1770	2757	2815	0.9793961
C5	12369367	12371461	BolC5t30763H	0	+	615	1764	2094	0.8424069
C5	12376004	12378125	BolC5t30764H	0	+	468	2106	2121	0.9929278
C5	12385039	12387801	BolC5t30765H	0	+	1279	2671	2762	0.9670529
C5	12388495	12389107	BolC5t30766H	0	+	413	612	612	1.0000000
C5	12389383	12392679	BolC5t30767H	0	-	1185	3028	3296	0.9186893
C5	12402087	12405417	BolC5t30768H	0	+	2474	3330	3330	1.0000000
C5	12405786	12406534	BolC5t30769H	0	+	900	748	748	1.0000000
C5	12406625	12406820	BolC5t30770H	0	+	344	195	195	1.0000000
C5	12408927	12409798	BolC5t30771H	0	+	64	665	871	0.7634903
C5	12410044	12410179	BolC5t30772H	0	+	113	135	135	1.0000000
C5	12416915	12422829	BolC5t30773H	0	+	1510	4652	5914	0.7866080
C5	12430069	12433101	BolC5t30774H	0	+	1381	2806	3032	0.9254618
C5	12433675	12436229	BolC5t30775H	0	+	594	2308	2554	0.9036805
C5	12445238	12447023	BolC5t30776H	0	+	1359	1785	1785	1.0000000
C5	12447256	12447657	BolC5t30777H	0	-	328	401	401	1.0000000
C5	12448010	12449213	BolC5t30778H	0	+	711	1203	1203	1.0000000
C5	12451725	12452726	BolC5t30779H	0	+	832	1001	1001	1.0000000
C5	12457343	12458273	BolC5t30780H	0	-	95	735	930	0.7903226
C5	12462700	12463774	BolC5t30781H	0	+	685	1074	1074	1.0000000
C5	12466691	12466988	BolC5t30782H	0	+	196	297	297	1.0000000
C5	12473558	12475170	BolC5t30783H	0	+	995	1609	1612	0.9981390
C5	12475448	12478882	BolC5t30784H	0	-	1766	3434	3434	1.0000000
C5	12516708	12517869	BolC5t30785H	0	-	781	1161	1161	1.0000000
C5	12529063	12529168	BolC5t30786H	0	-	19	105	105	1.0000000
C5	12534028	12534736	BolC5t30787H	0	+	6	81	708	0.1144068
C5	12560575	12565885	BolC5t30788H	0	-	3351	4835	5310	0.9105461
C5	12580924	12581350	BolC5t30789H	0	+	283	426	426	1.0000000
C5	12581673	12586575	BolC5t30790H	0	+	2539	4330	4902	0.8833129
C5	12588757	12589588	BolC5t30791H	0	-	656	831	831	1.0000000
C5	12609009	12609324	BolC5t30792H	0	-	69	315	315	1.0000000
C5	12610653	12612014	BolC5t30793H	0	-	428	1192	1361	0.8758266
C5	12625850	12626314	BolC5t30794H	0	+	0	0	464	0.0000000
C5	12626590	12626941	BolC5t30795H	0	-	8	210	351	0.5982906
C5	12639475	12639945	BolC5t30796H	0	+	6	198	470	0.4212766
C5	12640217	12640568	BolC5t30797H	0	-	4	211	351	0.6011396
C5	12647228	12648812	BolC5t30798H	0	-	3	245	1584	0.1546717
C5	12672538	12679202	BolC5t30799H	0	-	1672	5976	6664	0.8967587
C5	12685220	12685436	BolC5t30800H	0	-	98	214	216	0.9907407
C5	12701535	12703713	BolC5t30801H	0	-	125	1074	2178	0.4931130
C5	12716981	12719375	BolC5t30802H	0	+	1183	2219	2394	0.9269006
C5	12721280	12722341	BolC5t30803H	0	-	40	627	1061	0.5909519
C5	12724587	12725682	BolC5t30804H	0	-	238	1065	1095	0.9726027
C5	12734529	12735939	BolC5t30805H	0	+	470	1410	1410	1.0000000
C5	12742869	12743711	BolC5t30806H	0	+	758	842	842	1.0000000
C5	12744232	12751020	BolC5t30807H	0	-	4511	6715	6788	0.9892457
C5	12786029	12786428	BolC5t30808H	0	-	376	331	399	0.8295739
C5	12790122	12790344	BolC5t30809H	0	+	106	222	222	1.0000000
C5	12796983	12799233	BolC5t30810H	0	+	1809	2191	2250	0.9737778
C5	12809834	12810674	BolC5t30811H	0	-	417	810	840	0.9642857
C5	12814242	12814733	BolC5t30812H	0	-	193	491	491	1.0000000
C5	12815673	12819131	BolC5t30813H	0	-	3432	3458	3458	1.0000000
C5	12820595	12822179	BolC5t30814H	0	-	2464	1584	1584	1.0000000
C5	12823745	12827068	BolC5t30815H	0	-	1718	3290	3323	0.9900692
C5	12828110	12828266	BolC5t30816H	0	-	200	156	156	1.0000000
C5	12838644	12842194	BolC5t30817H	0	-	1633	3501	3550	0.9861972
C5	12840762	12841083	BolC5t30818H	0	-	31	321	321	1.0000000
C5	12842247	12843003	BolC5t30819H	0	-	935	756	756	1.0000000
C5	12843045	12843500	BolC5t30820H	0	-	581	455	455	1.0000000
C5	12845676	12849982	BolC5t30821H	0	-	632	4014	4306	0.9321876
C5	12851720	12851870	BolC5t30822H	0	-	259	150	150	1.0000000
C5	12852168	12852468	BolC5t30823H	0	-	310	300	300	1.0000000
C5	12863833	12875945	BolC5t30824H	0	+	1423	8724	12112	0.7202774
C5	12884886	12885456	BolC5t30825H	0	+	99	552	570	0.9684210
C5	12886037	12886223	BolC5t30826H	0	-	0	0	186	0.0000000
C5	12889238	12907257	BolC5t30827H	0	-	1949	12829	18019	0.7119707
C5	12939011	12940522	BolC5t30828H	0	+	700	1511	1511	1.0000000
C5	12994368	12995151	BolC5t30829H	0	+	173	738	783	0.9425287
C5	12998671	12999415	BolC5t30830H	0	+	2	80	744	0.1075269
C5	13002041	13004400	BolC5t30831H	0	-	1265	2359	2359	1.0000000
C5	13007649	13008624	BolC5t30832H	0	+	219	639	975	0.6553846
C5	13013575	13014514	BolC5t30833H	0	+	203	902	939	0.9605964
C5	13018769	13020482	BolC5t30834H	0	+	738	1713	1713	1.0000000
C5	13034651	13035548	BolC5t30835H	0	+	348	897	897	1.0000000
C5	13036300	13036681	BolC5t30836H	0	-	268	381	381	1.0000000
C5	13041151	13042546	BolC5t30837H	0	+	685	1368	1395	0.9806452
C5	13043206	13045083	BolC5t30838H	0	-	976	1721	1877	0.9168887
C5	13062533	13067414	BolC5t30839H	0	+	557	1808	4881	0.3704159
C5	13075220	13076103	BolC5t30840H	0	-	367	867	883	0.9818799
C5	13105507	13105861	BolC5t30841H	0	-	195	354	354	1.0000000
C5	13109804	13110451	BolC5t30842H	0	+	12	368	647	0.5687790
C5	13112963	13115438	BolC5t30843H	0	-	1127	2328	2475	0.9406061
C5	13157044	13158643	BolC5t30844H	0	-	549	1382	1599	0.8642902
C5	13164900	13167337	BolC5t30845H	0	+	272	2142	2437	0.8789495
C5	13176721	13177645	BolC5t30846H	0	+	0	0	924	0.0000000
C5	13190571	13191161	BolC5t30847H	0	+	95	539	590	0.9135593
C5	13194412	13194538	BolC5t30848H	0	-	38	126	126	1.0000000
C5	13213560	13215941	BolC5t30849H	0	+	666	1855	2381	0.7790844
C5	13218351	13219681	BolC5t30850H	0	+	1163	1330	1330	1.0000000
C5	13220152	13223143	BolC5t30851H	0	-	1982	2917	2991	0.9752591
C5	13234945	13235395	BolC5t30852H	0	-	25	132	450	0.2933333
C5	13236280	13237229	BolC5t30853H	0	-	649	949	949	1.0000000
C5	13247553	13249737	BolC5t30854H	0	-	499	1913	2184	0.8759158
C5	13252168	13252715	BolC5t30855H	0	+	26	345	547	0.6307130
C5	13253294	13254400	BolC5t30856H	0	-	86	699	1106	0.6320072
C5	13286645	13287776	BolC5t30857H	0	+	145	488	1131	0.4314766
C5	13289757	13291193	BolC5t30858H	0	-	978	1395	1436	0.9714485
C5	13303043	13305682	BolC5t30859H	0	-	779	2534	2639	0.9602122
C5	13349543	13353224	BolC5t30860H	0	-	469	3130	3681	0.8503124
C5	13355926	13357859	BolC5t30861H	0	+	909	1933	1933	1.0000000
C5	13365327	13367305	BolC5t30862H	0	+	364	1716	1978	0.8675430
C5	13367634	13369869	BolC5t30863H	0	-	95	1295	2235	0.5794184
C5	13372757	13374669	BolC5t30864H	0	-	254	547	1912	0.2860879
C5	13376107	13376709	BolC5t30865H	0	-	155	602	602	1.0000000
C5	13392401	13392629	BolC5t30866H	0	+	29	228	228	1.0000000
C5	13394557	13395046	BolC5t30867H	0	+	202	220	489	0.4498977
C5	13398966	13399275	BolC5t30868H	0	-	302	309	309	1.0000000
C5	13415794	13418818	BolC5t30869H	0	+	441	2249	3024	0.7437170
C5	13419094	13423365	BolC5t30870H	0	-	2465	4251	4271	0.9953173
C5	13425817	13426839	BolC5t30871H	0	+	346	1001	1022	0.9794521
C5	13458838	13464872	BolC5t30872H	0	-	1523	5583	6034	0.9252568
C5	13475057	13478677	BolC5t30873H	0	+	817	3100	3620	0.8563536
C5	13478957	13480476	BolC5t30874H	0	-	281	1306	1519	0.8597761
C5	13482001	13482643	BolC5t30875H	0	+	138	642	642	1.0000000
C5	13482908	13484164	BolC5t30876H	0	-	295	1072	1256	0.8535032
C5	13485631	13487712	BolC5t30877H	0	-	134	1470	2081	0.7063912
C5	13528340	13529321	BolC5t30878H	0	+	866	981	981	1.0000000
C5	13547490	13549740	BolC5t30879H	0	+	963	2111	2250	0.9382222
C5	13551322	13552898	BolC5t30880H	0	+	426	1259	1576	0.7988579
C5	13553864	13554257	BolC5t30881H	0	+	39	393	393	1.0000000
C5	13559205	13562239	BolC5t30882H	0	+	2553	3012	3034	0.9927489
C5	13567799	13569270	BolC5t30883H	0	+	435	1471	1471	1.0000000
C5	13574143	13574900	BolC5t30884H	0	+	659	757	757	1.0000000
C5	13575412	13577503	BolC5t30885H	0	+	1637	2091	2091	1.0000000
C5	13578126	13578558	BolC5t30886H	0	-	86	423	432	0.9791667
C5	13583622	13585653	BolC5t30887H	0	+	969	2031	2031	1.0000000
C5	13585998	13586739	BolC5t30888H	0	+	269	741	741	1.0000000
C5	13587329	13589281	BolC5t30889H	0	-	1152	1931	1952	0.9892418
C5	13591430	13593516	BolC5t30890H	0	-	1	31	2086	0.0148610
C5	13594640	13595955	BolC5t30891H	0	-	4	306	1315	0.2326996
C5	13598297	13608563	BolC5t30892H	0	+	3342	9061	10266	0.8826222
C5	13610607	13612695	BolC5t30893H	0	+	1687	2008	2088	0.9616858
C5	13613032	13613392	BolC5t30894H	0	+	673	360	360	1.0000000
C5	13618133	13629825	BolC5t30895H	0	+	1269	8820	11692	0.7543619
C5	13634710	13634998	BolC5t30896H	0	-	170	288	288	1.0000000
C5	13647157	13647715	BolC5t30897H	0	-	619	558	558	1.0000000
C5	13654540	13655395	BolC5t30898H	0	+	1249	855	855	1.0000000
C5	13661177	13661772	BolC5t30899H	0	-	780	595	595	1.0000000
C5	13667006	13667450	BolC5t30900H	0	+	39	422	444	0.9504505
C5	13671563	13673245	BolC5t30901H	0	+	220	1442	1682	0.8573127
C5	13675085	13677102	BolC5t30902H	0	-	598	1923	2017	0.9533961
C5	13688584	13692679	BolC5t30903H	0	+	1215	3884	4095	0.9484738
C5	13694184	13696479	BolC5t30904H	0	+	731	2142	2295	0.9333333
C5	13697060	13698919	BolC5t30905H	0	-	1190	1859	1859	1.0000000
C5	13699824	13701011	BolC5t30906H	0	-	294	691	1187	0.5821398
C5	13707085	13707851	BolC5t30907H	0	+	783	766	766	1.0000000
C5	13717308	13717599	BolC5t30908H	0	-	6	205	291	0.7044674
C5	13720726	13721222	BolC5t30909H	0	-	793	496	496	1.0000000
C5	13722280	13723167	BolC5t30910H	0	+	438	887	887	1.0000000
C5	13728256	13728472	BolC5t30911H	0	+	162	216	216	1.0000000
C5	13733014	13735084	BolC5t30912H	0	+	915	2070	2070	1.0000000
C5	13737871	13738947	BolC5t30913H	0	-	626	1076	1076	1.0000000
C5	13776406	13776836	BolC5t30914H	0	+	306	430	430	1.0000000
C5	13784253	13784424	BolC5t30915H	0	+	201	171	171	1.0000000
C5	13792044	13792422	BolC5t30916H	0	+	545	378	378	1.0000000
C5	13794217	13796440	BolC5t30917H	0	-	1611	2021	2223	0.9091318
C5	13797497	13798871	BolC5t30918H	0	-	996	1374	1374	1.0000000
C5	13801681	13801981	BolC5t30919H	0	+	57	288	300	0.9600000
C5	13805139	13806037	BolC5t30920H	0	+	61	737	898	0.8207127
C5	13818315	13818444	BolC5t30921H	0	+	100	129	129	1.0000000
C5	13824281	13825575	BolC5t30922H	0	+	575	1294	1294	1.0000000
C5	13835574	13839542	BolC5t30923H	0	+	2110	3954	3968	0.9964718
C5	13848489	13850656	BolC5t30924H	0	+	637	2127	2167	0.9815413
C5	13852901	13853336	BolC5t30925H	0	+	74	409	435	0.9402299
C5	13855886	13859345	BolC5t30926H	0	+	830	3199	3459	0.9248338
C5	13867130	13867622	BolC5t30927H	0	+	196	460	492	0.9349594
C5	13868397	13872584	BolC5t30928H	0	-	2050	4109	4187	0.9813709
C5	13875418	13877179	BolC5t30929H	0	+	1647	1761	1761	1.0000000
C5	13894658	13895668	BolC5t30930H	0	-	393	1010	1010	1.0000000
C5	13902249	13902697	BolC5t30931H	0	+	177	448	448	1.0000000
C5	13922735	13923298	BolC5t30932H	0	+	101	563	563	1.0000000
C5	13924523	13925167	BolC5t30933H	0	-	191	644	644	1.0000000
C5	13927168	13927680	BolC5t30934H	0	+	225	426	512	0.8320312
C5	13946580	13949473	BolC5t30935H	0	+	2632	2893	2893	1.0000000
C5	13960406	13960745	BolC5t30936H	0	+	55	312	339	0.9203540
C5	13963939	13964128	BolC5t30937H	0	+	0	0	189	0.0000000
C5	13967782	13971077	BolC5t30938H	0	+	1399	2328	3295	0.7065250
C5	13979913	13982036	BolC5t30939H	0	+	360	1436	2123	0.6764013
C5	13990062	13990767	BolC5t30940H	0	-	209	681	705	0.9659575
C5	13995112	13995286	BolC5t30941H	0	+	80	174	174	1.0000000
C5	14003856	14006066	BolC5t30942H	0	+	314	1158	2210	0.5239819
C5	14010110	14011436	BolC5t30943H	0	+	652	1326	1326	1.0000000
C5	14014331	14021419	BolC5t30944H	0	+	2607	7015	7088	0.9897009
C5	14021955	14023105	BolC5t30945H	0	-	589	1150	1150	1.0000000
C5	14034670	14035420	BolC5t30946H	0	-	139	650	750	0.8666667
C5	14036642	14037083	BolC5t30947H	0	+	106	429	441	0.9727891
C5	14037418	14038992	BolC5t30948H	0	-	1319	1561	1574	0.9917408
C5	14040809	14042349	BolC5t30949H	0	+	1039	1540	1540	1.0000000
C5	14042726	14045250	BolC5t30950H	0	-	1155	2503	2524	0.9916798
C5	14045532	14051444	BolC5t30951H	0	-	5078	4885	5912	0.8262855
C5	14058837	14062054	BolC5t30952H	0	-	497	1529	3217	0.4752875
C5	14063030	14065633	BolC5t30953H	0	+	1737	2603	2603	1.0000000
C5	14068181	14068439	BolC5t30954H	0	+	473	258	258	1.0000000
C5	14081228	14082111	BolC5t30955H	0	-	862	883	883	1.0000000
C5	14085751	14086211	BolC5t30956H	0	+	142	460	460	1.0000000
C5	14094282	14095167	BolC5t30957H	0	+	811	885	885	1.0000000
C5	14103405	14104627	BolC5t30958H	0	+	1575	1222	1222	1.0000000
C5	14104910	14106777	BolC5t30959H	0	-	578	1867	1867	1.0000000
C5	14117011	14119367	BolC5t30960H	0	-	114	1340	2356	0.5687606
C5	14138806	14139301	BolC5t30961H	0	-	8	158	495	0.3191919
C5	14146336	14153922	BolC5t30962H	0	-	4009	6977	7586	0.9197205
C5	14152330	14152604	BolC5t30963H	0	-	33	254	274	0.9270073
C5	14159470	14159793	BolC5t30964H	0	-	48	191	323	0.5913312
C5	14159903	14160389	BolC5t30965H	0	+	69	451	486	0.9279835
C5	14173645	14173759	BolC5t30966H	0	-	166	114	114	1.0000000
C5	14176390	14177617	BolC5t30967H	0	-	230	1214	1227	0.9894050
C5	14185413	14188234	BolC5t30968H	0	-	1127	2252	2821	0.7982985
C5	14192902	14193373	BolC5t30969H	0	+	109	461	471	0.9787686
C5	14195667	14197476	BolC5t30970H	0	+	296	1706	1809	0.9430625
C5	14204161	14205362	BolC5t30971H	0	+	987	1179	1201	0.9816819
C5	14212345	14212678	BolC5t30972H	0	-	247	333	333	1.0000000
C5	14213803	14214098	BolC5t30973H	0	-	226	295	295	1.0000000
C5	14215794	14217789	BolC5t30974H	0	+	1244	1988	1995	0.9964913
C5	14218065	14220444	BolC5t30975H	0	+	1261	2259	2379	0.9495586
C5	14222623	14224996	BolC5t30976H	0	+	294	1616	2373	0.6809945
C5	14227682	14230150	BolC5t30977H	0	+	620	1271	2468	0.5149919
C5	14230674	14233662	BolC5t30978H	0	-	263	1672	2988	0.5595716
C5	14233733	14233874	BolC5t30979H	0	-	0	0	141	0.0000000
C5	14244775	14245000	BolC5t30980H	0	-	248	225	225	1.0000000
C5	14248279	14249917	BolC5t30981H	0	-	349	1183	1638	0.7222222
C5	14263903	14264083	BolC5t30982H	0	-	49	119	180	0.6611111
C5	14275643	14276565	BolC5t30983H	0	+	1768	922	922	1.0000000
C5	14278621	14278861	BolC5t30984H	0	+	208	240	240	1.0000000
C5	14281139	14281778	BolC5t30985H	0	+	153	622	639	0.9733959
C5	14282243	14285215	BolC5t30986H	0	-	1500	2746	2972	0.9239569
C5	14286933	14288079	BolC5t30987H	0	+	1381	1146	1146	1.0000000
C5	14288162	14288336	BolC5t30988H	0	-	295	174	174	1.0000000
C5	14291121	14292624	BolC5t30989H	0	-	287	913	1503	0.6074517
C5	14303155	14303398	BolC5t30990H	0	+	10	114	243	0.4691358
C5	14305420	14306323	BolC5t30991H	0	+	301	709	903	0.7851606
C5	14365333	14365762	BolC5t30992H	0	+	475	360	429	0.8391609
C5	14385614	14387452	BolC5t30993H	0	+	1315	1838	1838	1.0000000
C5	14387637	14389118	BolC5t30994H	0	-	310	1439	1481	0.9716408
C5	14390345	14390890	BolC5t30995H	0	+	129	545	545	1.0000000
C5	14392214	14394065	BolC5t30996H	0	+	953	1851	1851	1.0000000
C5	14394408	14397165	BolC5t30997H	0	-	1214	2757	2757	1.0000000
C5	14407476	14409812	BolC5t30998H	0	+	1787	2336	2336	1.0000000
C5	14410476	14451021	BolC5t30999H	0	-	26694	40258	40545	0.9929215
C5	14417282	14417646	BolC5t31000H	0	-	197	364	364	1.0000000
C5	14429444	14448515	BolC5t31001H	0	-	12112	18784	19071	0.9849510
C5	14439757	14440390	BolC5t31002H	0	-	320	633	633	1.0000000
C5	14448521	14449210	BolC5t31003H	0	-	434	689	689	1.0000000
C5	14452444	14453343	BolC5t31004H	0	-	433	899	899	1.0000000
C5	14456365	14458625	BolC5t31005H	0	+	1252	2260	2260	1.0000000
C5	14458789	14460372	BolC5t31006H	0	-	830	1583	1583	1.0000000
C5	14460863	14466120	BolC5t31007H	0	+	406	3711	5257	0.7059159
C5	14467689	14468577	BolC5t31008H	0	+	92	321	888	0.3614865
C5	14469139	14470207	BolC5t31009H	0	-	470	1068	1068	1.0000000
C5	14515928	14516393	BolC5t31010H	0	-	23	247	465	0.5311828
C5	14533698	14534134	BolC5t31011H	0	+	211	436	436	1.0000000
C5	14535489	14535954	BolC5t31012H	0	-	53	304	465	0.6537634
C5	14548459	14550715	BolC5t31013H	0	-	1591	2256	2256	1.0000000
C5	14587525	14587796	BolC5t31014H	0	-	143	271	271	1.0000000
C5	14588473	14588749	BolC5t31015H	0	-	79	276	276	1.0000000
C5	14589674	14591032	BolC5t31016H	0	-	790	1323	1358	0.9742268
C5	14592748	14593289	BolC5t31017H	0	-	533	541	541	1.0000000
C5	14596389	14598170	BolC5t31018H	0	+	176	554	1781	0.3110612
C5	14598779	14599852	BolC5t31019H	0	-	312	1026	1073	0.9561976
C5	14600075	14601452	BolC5t31020H	0	+	597	1356	1377	0.9847494
C5	14601933	14606216	BolC5t31021H	0	+	3031	4283	4283	1.0000000
C5	14607133	14608707	BolC5t31022H	0	-	283	1545	1574	0.9815756
C5	14610357	14611353	BolC5t31023H	0	+	60	438	996	0.4397590
C5	14611802	14614338	BolC5t31024H	0	-	1032	2516	2536	0.9921136
C5	14618777	14620010	BolC5t31025H	0	-	61	895	1233	0.7258719
C5	14623643	14624795	BolC5t31026H	0	-	575	1080	1152	0.9375000
C5	14627291	14647786	BolC5t31027H	0	-	3791	17092	20495	0.8339595
C5	14668370	14670669	BolC5t31028H	0	+	952	2299	2299	1.0000000
C5	14688687	14689338	BolC5t31029H	0	+	937	651	651	1.0000000
C5	14689495	14695991	BolC5t31030H	0	+	1074	2279	6496	0.3508313
C5	14694014	14694572	BolC5t31031H	0	+	110	290	558	0.5197133
C5	14698260	14700277	BolC5t31032H	0	-	2476	2017	2017	1.0000000
C5	14703650	14703782	BolC5t31033H	0	-	76	132	132	1.0000000
C5	14705212	14705506	BolC5t31034H	0	-	181	294	294	1.0000000
C5	14705625	14706804	BolC5t31035H	0	-	909	1179	1179	1.0000000
C5	14727739	14728024	BolC5t31036H	0	-	54	271	285	0.9508772
C5	14733809	14734367	BolC5t31037H	0	+	547	558	558	1.0000000
C5	14735583	14737811	BolC5t31038H	0	+	810	1877	2228	0.8424596
C5	14739938	14740863	BolC5t31039H	0	-	463	925	925	1.0000000
C5	14741309	14742833	BolC5t31040H	0	-	798	1501	1524	0.9849082
C5	14746334	14746454	BolC5t31041H	0	-	71	120	120	1.0000000
C5	14752501	14753613	BolC5t31042H	0	-	74	546	1112	0.4910072
C5	14765693	14767320	BolC5t31043H	0	-	45	736	1627	0.4523663
C5	14772437	14772877	BolC5t31044H	0	+	268	440	440	1.0000000
C5	14783821	14784119	BolC5t31045H	0	+	509	298	298	1.0000000
C5	14794632	14806371	BolC5t31046H	0	-	6183	10456	11739	0.8907062
C5	14799655	14800584	BolC5t31047H	0	+	1784	929	929	1.0000000
C5	14823029	14823774	BolC5t31048H	0	-	75	663	745	0.8899329
C5	14844784	14845174	BolC5t31049H	0	-	480	390	390	1.0000000
C5	14854582	14856718	BolC5t31050H	0	+	261	1468	2136	0.6872659
C5	14857578	14857899	BolC5t31051H	0	-	3	22	321	0.0685358
C5	14857916	14858519	BolC5t31052H	0	-	64	567	603	0.9402985
C5	14863138	14864142	BolC5t31053H	0	-	615	1004	1004	1.0000000
C5	14870838	14871258	BolC5t31054H	0	-	29	163	420	0.3880952
C5	14879291	14879609	BolC5t31055H	0	-	204	318	318	1.0000000
C5	14880977	14882708	BolC5t31056H	0	+	492	1683	1731	0.9722704
C5	14883835	14885629	BolC5t31057H	0	+	528	1766	1794	0.9843924
C5	14886660	14890409	BolC5t31058H	0	-	2942	3749	3749	1.0000000
C5	14904461	14905315	BolC5t31059H	0	-	31	710	854	0.8313817
C5	14909890	14910148	BolC5t31060H	0	+	232	258	258	1.0000000
C5	14916935	14917268	BolC5t31061H	0	-	25	276	333	0.8288288
C5	14922114	14922407	BolC5t31062H	0	+	38	293	293	1.0000000
C5	14924431	14924622	BolC5t31063H	0	+	170	147	191	0.7696335
C5	14959540	14961399	BolC5t31064H	0	+	1322	1677	1859	0.9020979
C5	14961542	14967376	BolC5t31065H	0	+	3305	5599	5834	0.9597189
C5	14970157	14983213	BolC5t31066H	0	-	5519	12246	13056	0.9379596
C5	14985513	14986200	BolC5t31067H	0	-	394	687	687	1.0000000
C5	14987810	14988708	BolC5t31068H	0	+	12	718	898	0.7995546
C5	14994914	14995816	BolC5t31069H	0	-	351	902	902	1.0000000
C5	14999770	15000110	BolC5t31070H	0	-	0	0	340	0.0000000
C5	15013638	15014355	BolC5t31071H	0	-	103	360	717	0.5020921
C5	15014572	15014929	BolC5t31072H	0	-	0	0	357	0.0000000
C5	15025399	15075064	BolC5t31073H	0	-	692	10061	49665	0.2025773
C5	15043399	15043755	BolC5t31074H	0	-	3	59	356	0.1657303
C5	15048235	15050004	BolC5t31075H	0	-	2	120	1769	0.0678349
C5	15052283	15052640	BolC5t31076H	0	-	0	0	357	0.0000000
C5	15063691	15069045	BolC5t31077H	0	-	144	1284	5354	0.2398207
C5	15079779	15108607	BolC5t31078H	0	-	1604	11246	28828	0.3901068
C5	15081185	15081525	BolC5t31079H	0	-	1	120	340	0.3529412
C5	15085988	15087814	BolC5t31080H	0	-	288	1184	1826	0.6484118
C5	15089294	15090011	BolC5t31081H	0	-	2	21	717	0.0292887
C5	15110990	15111298	BolC5t31082H	0	+	10	181	308	0.5876623
C5	15111752	15112001	BolC5t31083H	0	+	234	249	249	1.0000000
C5	15112426	15112624	BolC5t31084H	0	+	0	0	198	0.0000000
C5	15131241	15132092	BolC5t31085H	0	-	160	793	851	0.9318449
C5	15141174	15143472	BolC5t31086H	0	-	727	2254	2298	0.9808529
C5	15169974	15174208	BolC5t31087H	0	+	1565	4012	4234	0.9475673
C5	15175377	15177422	BolC5t31088H	0	+	796	1922	2045	0.9398533
C5	15178059	15180252	BolC5t31089H	0	+	1091	2177	2193	0.9927040
C5	15180526	15184090	BolC5t31090H	0	-	1367	3297	3564	0.9250842
C5	15212320	15215048	BolC5t31091H	0	-	827	2076	2728	0.7609971
C5	15234620	15235292	BolC5t31092H	0	-	413	672	672	1.0000000
C5	15238743	15239055	BolC5t31093H	0	+	407	312	312	1.0000000
C5	15240319	15248922	BolC5t31094H	0	+	701	6718	8603	0.7808904
C5	15249209	15249779	BolC5t31095H	0	-	45	552	570	0.9684210
C5	15257023	15258237	BolC5t31096H	0	-	929	1214	1214	1.0000000
C5	15290507	15290777	BolC5t31097H	0	-	2	58	270	0.2148148
C5	15306169	15308181	BolC5t31098H	0	-	1578	2012	2012	1.0000000
C5	15309238	15313267	BolC5t31099H	0	-	1008	3794	4029	0.9416729
C5	15318618	15322157	BolC5t31100H	0	-	2457	3399	3539	0.9604408
C5	15322516	15323225	BolC5t31101H	0	+	274	709	709	1.0000000
C5	15332646	15333907	BolC5t31102H	0	-	572	1261	1261	1.0000000
C5	15340974	15343593	BolC5t31103H	0	-	726	2305	2619	0.8801069
C5	15393090	15395075	BolC5t31104H	0	+	243	1482	1985	0.7465995
C5	15403001	15403319	BolC5t31105H	0	-	237	318	318	1.0000000
C5	15407532	15407928	BolC5t31106H	0	+	21	369	396	0.9318182
C5	15410800	15413072	BolC5t31107H	0	-	4	231	2272	0.1016725
C5	15414183	15416466	BolC5t31108H	0	+	7	189	2283	0.0827858
C5	15417531	15418183	BolC5t31109H	0	-	0	0	652	0.0000000
C5	15429304	15430189	BolC5t31110H	0	+	182	715	885	0.8079096
C5	15430726	15430903	BolC5t31111H	0	-	434	177	177	1.0000000
C5	15449707	15450016	BolC5t31112H	0	-	138	292	309	0.9449838
C5	15451466	15452384	BolC5t31113H	0	-	159	789	918	0.8594771
C5	15474190	15476785	BolC5t31114H	0	-	412	2493	2595	0.9606937
C5	15479307	15481596	BolC5t31115H	0	+	2	80	2289	0.0349498
C5	15482661	15483312	BolC5t31116H	0	-	0	0	651	0.0000000
C5	15488803	15489719	BolC5t31117H	0	-	164	895	916	0.9770743
C5	15497544	15498146	BolC5t31118H	0	-	477	602	602	1.0000000
C5	15503688	15503961	BolC5t31119H	0	+	194	273	273	1.0000000
C5	15573074	15574230	BolC5t31120H	0	+	542	1156	1156	1.0000000
C5	15646378	15655618	BolC5t31121H	0	-	1002	5459	9240	0.5908009
C5	15663142	15663850	BolC5t31122H	0	-	273	708	708	1.0000000
C5	15668468	15669824	BolC5t31123H	0	-	165	1299	1356	0.9579646
C5	15671827	15672684	BolC5t31124H	0	-	612	857	857	1.0000000
C5	15674174	15675674	BolC5t31125H	0	-	1011	1500	1500	1.0000000
C5	15684877	15685234	BolC5t31126H	0	-	7	150	357	0.4201681
C5	15715571	15716568	BolC5t31127H	0	-	79	268	997	0.2688064
C5	15736181	15737498	BolC5t31128H	0	-	575	1317	1317	1.0000000
C5	15741817	15743134	BolC5t31129H	0	-	521	1077	1317	0.8177677
C5	15749250	15750222	BolC5t31130H	0	-	644	972	972	1.0000000
C5	15786737	15787918	BolC5t31131H	0	+	455	1123	1181	0.9508891
C5	15800671	15803368	BolC5t31132H	0	-	1745	2697	2697	1.0000000
C5	15804465	15804797	BolC5t31133H	0	-	357	332	332	1.0000000
C5	15811924	15812218	BolC5t31134H	0	-	478	294	294	1.0000000
C5	15868804	15869400	BolC5t31135H	0	-	10	424	596	0.7114094
C5	15890386	15891574	BolC5t31136H	0	-	136	1001	1188	0.8425926
C5	15912597	15914140	BolC5t31137H	0	-	372	1369	1543	0.8872327
C5	15922009	15922576	BolC5t31138H	0	-	0	0	567	0.0000000
C5	15937145	15938456	BolC5t31139H	0	+	87	875	1311	0.6674294
C5	15952076	15953497	BolC5t31140H	0	+	142	477	1421	0.3356791
C5	15957080	15957701	BolC5t31141H	0	+	179	449	621	0.7230273
C5	15958835	15959360	BolC5t31142H	0	-	32	97	525	0.1847619
C5	15993162	15996644	BolC5t31143H	0	-	143	1328	3482	0.3813900
C5	16001382	16001610	BolC5t31144H	0	-	5	162	228	0.7105263
C5	16028665	16030820	BolC5t31145H	0	+	1192	2086	2155	0.9679815
C5	16031381	16033087	BolC5t31146H	0	-	1192	1706	1706	1.0000000
C5	16033758	16036099	BolC5t31147H	0	-	362	1976	2341	0.8440837
C5	16039113	16039315	BolC5t31148H	0	-	154	202	202	1.0000000
C5	16043939	16044545	BolC5t31149H	0	+	322	606	606	1.0000000
C5	16057871	16059086	BolC5t31150H	0	+	742	1205	1215	0.9917696
C5	16061547	16061730	BolC5t31151H	0	-	49	166	183	0.9071038
C5	16088002	16089358	BolC5t31152H	0	-	836	1326	1356	0.9778761
C5	16101800	16102091	BolC5t31153H	0	-	21	200	291	0.6872852
C5	16129317	16130567	BolC5t31154H	0	-	276	1089	1250	0.8712000
C5	16134491	16134653	BolC5t31155H	0	-	139	162	162	1.0000000
C5	16165018	16166338	BolC5t31156H	0	+	673	1273	1320	0.9643939
C5	16166727	16168353	BolC5t31157H	0	+	434	1598	1626	0.9827798
C5	16168825	16169651	BolC5t31158H	0	-	508	826	826	1.0000000
C5	16169940	16171088	BolC5t31159H	0	+	1278	1148	1148	1.0000000
C5	16172014	16175301	BolC5t31160H	0	-	763	2649	3287	0.8059021
C5	16180251	16183430	BolC5t31161H	0	+	5608	3095	3179	0.9735766
C5	16187941	16201387	BolC5t31162H	0	-	4989	10109	13446	0.7518221
C5	16207046	16213646	BolC5t31163H	0	-	3049	6504	6600	0.9854546
C5	16214585	16215469	BolC5t31164H	0	+	269	884	884	1.0000000
C5	16215742	16235175	BolC5t31165H	0	-	8212	18514	19433	0.9527093
C5	16236301	16236675	BolC5t31166H	0	+	421	374	374	1.0000000
C5	16239128	16240588	BolC5t31167H	0	-	1023	1447	1460	0.9910959
C5	16240849	16243083	BolC5t31168H	0	-	638	2226	2234	0.9964190
C5	16247155	16248083	BolC5t31169H	0	+	58	803	928	0.8653017
C5	16253260	16254271	BolC5t31170H	0	-	260	1011	1011	1.0000000
C5	16254933	16257029	BolC5t31171H	0	+	1090	2096	2096	1.0000000
C5	16257541	16258561	BolC5t31172H	0	-	723	1020	1020	1.0000000
C5	16275294	16289422	BolC5t31173H	0	+	910	7351	14128	0.5203143
C5	16276336	16276525	BolC5t31174H	0	+	11	189	189	1.0000000
C5	16289774	16290902	BolC5t31175H	0	+	268	1073	1128	0.9512411
C5	16313287	16316596	BolC5t31176H	0	+	2005	3286	3309	0.9930493
C5	16317134	16318475	BolC5t31177H	0	-	499	1278	1341	0.9530202
C5	16327341	16327473	BolC5t31178H	0	-	42	132	132	1.0000000
C5	16335359	16335704	BolC5t31179H	0	-	433	345	345	1.0000000
C5	16336674	16337625	BolC5t31180H	0	-	661	951	951	1.0000000
C5	16339715	16343806	BolC5t31181H	0	-	1766	4030	4091	0.9850892
C5	16348002	16351035	BolC5t31182H	0	-	668	2555	3033	0.8424003
C5	16353799	16354623	BolC5t31183H	0	-	1253	824	824	1.0000000
C5	16355260	16357304	BolC5t31184H	0	+	563	1618	2044	0.7915851
C5	16358100	16359657	BolC5t31185H	0	-	496	1538	1557	0.9877970
C5	16360117	16361310	BolC5t31186H	0	+	742	1188	1193	0.9958089
C5	16361835	16362844	BolC5t31187H	0	-	2172	1009	1009	1.0000000
C5	16363363	16365985	BolC5t31188H	0	-	1071	2622	2622	1.0000000
C5	16368848	16369061	BolC5t31189H	0	+	51	136	213	0.6384977
C5	16369141	16369873	BolC5t31190H	0	+	40	645	732	0.8811476
C5	16371676	16373160	BolC5t31191H	0	+	922	1477	1484	0.9952830
C5	16377720	16379304	BolC5t31192H	0	+	350	1101	1584	0.6950758
C5	16399244	16400831	BolC5t31193H	0	+	373	1387	1587	0.8739761
C5	16411286	16414435	BolC5t31194H	0	+	1348	3081	3149	0.9784058
C5	16415325	16415984	BolC5t31195H	0	-	380	659	659	1.0000000
C5	16416444	16422357	BolC5t31196H	0	-	3688	5633	5913	0.9526467
C5	16422673	16424975	BolC5t31197H	0	-	821	2132	2302	0.9261512
C5	16433275	16435141	BolC5t31198H	0	+	539	1788	1866	0.9581994
C5	16456825	16457953	BolC5t31199H	0	+	85	633	1128	0.5611702
C5	16462493	16462969	BolC5t31200H	0	-	7	190	476	0.3991597
C5	16465468	16474435	BolC5t31201H	0	+	4195	8444	8967	0.9416750
C5	16478650	16482455	BolC5t31202H	0	+	1801	3759	3805	0.9879106
C5	16484279	16484717	BolC5t31203H	0	+	348	438	438	1.0000000
C5	16485613	16485893	BolC5t31204H	0	+	126	280	280	1.0000000
C5	16487044	16487469	BolC5t31205H	0	+	125	425	425	1.0000000
C5	16490207	16491624	BolC5t31206H	0	+	235	1417	1417	1.0000000
C5	16493185	16494451	BolC5t31207H	0	+	507	1266	1266	1.0000000
C5	16497080	16497705	BolC5t31208H	0	-	4	215	625	0.3440000
C5	16522503	16523539	BolC5t31209H	0	+	354	1036	1036	1.0000000
C5	16534563	16534910	BolC5t31210H	0	+	3	213	347	0.6138328
C5	16552587	16556880	BolC5t31211H	0	-	2556	3990	4293	0.9294200
C5	16561734	16564236	BolC5t31212H	0	+	2442	2502	2502	1.0000000
C5	16564643	16570591	BolC5t31213H	0	-	1123	4775	5948	0.8027909
C5	16578693	16580203	BolC5t31214H	0	+	494	1441	1510	0.9543046
C5	16581641	16583324	BolC5t31215H	0	+	1039	1683	1683	1.0000000
C5	16587565	16590790	BolC5t31216H	0	+	1058	3130	3225	0.9705426
C5	16606501	16615838	BolC5t31217H	0	-	703	5368	9337	0.5749170
C5	16617407	16618523	BolC5t31218H	0	+	177	886	1116	0.7939068
C5	16635003	16635616	BolC5t31219H	0	-	115	360	613	0.5872757
C5	16637064	16637276	BolC5t31220H	0	-	35	212	212	1.0000000
C5	16645331	16650057	BolC5t31221H	0	+	2761	4637	4726	0.9811680
C5	16660693	16664772	BolC5t31222H	0	+	390	2921	4079	0.7161069
C5	16669768	16670388	BolC5t31223H	0	-	366	620	620	1.0000000
C5	16672085	16672280	BolC5t31224H	0	+	45	195	195	1.0000000
C5	16672448	16672727	BolC5t31225H	0	-	101	279	279	1.0000000
C5	16675518	16675857	BolC5t31226H	0	-	187	339	339	1.0000000
C5	16689984	16692989	BolC5t31227H	0	-	1063	2695	3005	0.8968386
C5	16695922	16696272	BolC5t31228H	0	+	61	350	350	1.0000000
C5	16696294	16697041	BolC5t31229H	0	+	97	698	747	0.9344043
C5	16697797	16699022	BolC5t31230H	0	-	320	1177	1225	0.9608163
C5	16704083	16705529	BolC5t31231H	0	-	412	1281	1446	0.8858921
C5	16710421	16710934	BolC5t31232H	0	-	425	513	513	1.0000000
C5	16724470	16724635	BolC5t31233H	0	+	4	21	165	0.1272727
C5	16732101	16734405	BolC5t31234H	0	+	309	1137	2304	0.4934896
C5	16756496	16758040	BolC5t31235H	0	+	153	892	1544	0.5777202
C5	16767194	16781561	BolC5t31236H	0	+	1517	10377	14367	0.7222802
C5	16785544	16785835	BolC5t31237H	0	-	186	291	291	1.0000000
C5	16789129	16789441	BolC5t31238H	0	-	5	107	312	0.3429487
C5	16794431	16794731	BolC5t31239H	0	+	281	300	300	1.0000000
C5	16820846	16823632	BolC5t31240H	0	+	14	706	2786	0.2534099
C5	16826901	16827255	BolC5t31241H	0	+	80	331	354	0.9350283
C5	16843912	16844324	BolC5t31242H	0	+	112	341	412	0.8276699
C5	16870037	16871863	BolC5t31243H	0	+	307	1344	1826	0.7360350
C5	16904638	16906776	BolC5t31244H	0	+	831	2110	2138	0.9869037
C5	16907602	16909879	BolC5t31245H	0	-	955	2204	2277	0.9679403
C5	16921034	16923860	BolC5t31246H	0	+	1769	2826	2826	1.0000000
C5	16928675	16928927	BolC5t31247H	0	-	275	252	252	1.0000000
C5	16933397	16934363	BolC5t31248H	0	+	760	966	966	1.0000000
C5	16936408	16941317	BolC5t31249H	0	+	3042	4872	4909	0.9924628
C5	16955497	16957705	BolC5t31250H	0	-	986	2166	2208	0.9809783
C5	16962510	16965125	BolC5t31251H	0	-	610	2371	2615	0.9066921
C5	16967534	16967949	BolC5t31252H	0	+	2	143	415	0.3445783
C5	16970080	16970512	BolC5t31253H	0	-	24	255	432	0.5902778
C5	16972892	16973850	BolC5t31254H	0	+	486	958	958	1.0000000
C5	16974149	16976086	BolC5t31255H	0	-	1162	1937	1937	1.0000000
C5	16980595	16980877	BolC5t31256H	0	-	101	282	282	1.0000000
C5	16990685	16991306	BolC5t31257H	0	-	45	593	621	0.9549114
C5	16997084	16999785	BolC5t31258H	0	-	133	1599	2701	0.5920030
C5	17001790	17001958	BolC5t31259H	0	-	61	168	168	1.0000000
C5	17008375	17010466	BolC5t31260H	0	-	440	1674	2091	0.8005739
C5	17010743	17010944	BolC5t31261H	0	-	17	201	201	1.0000000
C5	17015298	17015646	BolC5t31262H	0	+	33	344	348	0.9885057
C5	17015742	17015937	BolC5t31263H	0	+	12	159	195	0.8153846
C5	17023788	17024392	BolC5t31264H	0	+	75	604	604	1.0000000
C5	17023873	17024081	BolC5t31265H	0	+	50	208	208	1.0000000
C5	17025781	17027533	BolC5t31266H	0	-	399	1712	1752	0.9771690
C5	17027792	17028432	BolC5t31267H	0	+	211	640	640	1.0000000
C5	17030625	17030847	BolC5t31268H	0	+	55	222	222	1.0000000
C5	17056900	17058379	BolC5t31269H	0	+	560	1202	1479	0.8127113
C5	17064915	17067003	BolC5t31270H	0	-	24	810	2088	0.3879310
C5	17103178	17103325	BolC5t31271H	0	-	26	147	147	1.0000000
C5	17134846	17135728	BolC5t31272H	0	+	660	882	882	1.0000000
C5	17135751	17137790	BolC5t31273H	0	+	1501	2039	2039	1.0000000
C5	17164408	17165545	BolC5t31274H	0	-	55	231	1137	0.2031662
C5	17191679	17193521	BolC5t31275H	0	+	1825	1842	1842	1.0000000
C5	17197366	17200649	BolC5t31276H	0	+	1939	3283	3283	1.0000000
C5	17202285	17206200	BolC5t31277H	0	-	1824	3915	3915	1.0000000
C5	17222978	17224521	BolC5t31278H	0	-	707	1543	1543	1.0000000
C5	17227296	17227866	BolC5t31279H	0	+	6	134	570	0.2350877
C5	17229386	17231259	BolC5t31280H	0	+	439	1834	1873	0.9791778
C5	17241094	17241376	BolC5t31281H	0	+	131	282	282	1.0000000
C5	17254431	17255199	BolC5t31282H	0	-	500	768	768	1.0000000
C5	17255474	17255798	BolC5t31283H	0	+	30	206	324	0.6358024
C5	17265084	17265930	BolC5t31284H	0	+	89	811	846	0.9586288
C5	17266657	17277819	BolC5t31285H	0	-	212	1927	11162	0.1726393
C5	17295912	17296182	BolC5t31286H	0	-	49	270	270	1.0000000
C5	17322835	17324929	BolC5t31287H	0	-	61	390	2094	0.1862464
C5	17336393	17339408	BolC5t31288H	0	-	251	2142	3015	0.7104478
C5	17341778	17341979	BolC5t31289H	0	+	118	201	201	1.0000000
C5	17345491	17347243	BolC5t31290H	0	+	501	1601	1752	0.9138128
C5	17347590	17349153	BolC5t31291H	0	-	435	1141	1563	0.7300064
C5	17352788	17353953	BolC5t31292H	0	-	108	1013	1165	0.8695279
C5	17361575	17361970	BolC5t31293H	0	-	59	395	395	1.0000000
C5	17364138	17366979	BolC5t31294H	0	-	611	2236	2841	0.7870468
C5	17370275	17370635	BolC5t31295H	0	-	10	93	360	0.2583333
C5	17387428	17390261	BolC5t31296H	0	+	1078	2807	2833	0.9908224
C5	17390813	17393500	BolC5t31297H	0	-	976	2687	2687	1.0000000
C5	17401916	17402561	BolC5t31298H	0	-	23	161	645	0.2496124
C5	17414406	17414739	BolC5t31299H	0	-	2	51	333	0.1531532
C5	17415042	17416420	BolC5t31300H	0	-	2	98	1378	0.0711176
C5	17416989	17419441	BolC5t31301H	0	-	1391	2185	2452	0.8911093
C5	17420694	17426862	BolC5t31302H	0	-	1863	5083	6168	0.8240921
C5	17428136	17428964	BolC5t31303H	0	-	1220	828	828	1.0000000
C5	17429866	17431053	BolC5t31304H	0	-	788	1187	1187	1.0000000
C5	17433094	17434399	BolC5t31305H	0	-	701	1131	1305	0.8666667
C5	17435384	17435555	BolC5t31306H	0	-	15	22	171	0.1286550
C5	17459211	17461476	BolC5t31307H	0	+	452	1652	2265	0.7293598
C5	17462075	17464379	BolC5t31308H	0	-	1170	2245	2304	0.9743924
C5	17465588	17466340	BolC5t31309H	0	+	599	752	752	1.0000000
C5	17467929	17468607	BolC5t31310H	0	+	258	678	678	1.0000000
C5	17481749	17482490	BolC5t31311H	0	-	72	713	741	0.9622132
C5	17491244	17502924	BolC5t31312H	0	-	997	4055	11680	0.3471746
C5	17504338	17505973	BolC5t31313H	0	-	858	1387	1635	0.8483180
C5	17507745	17510389	BolC5t31314H	0	+	2332	2527	2644	0.9557489
C5	17513484	17516455	BolC5t31315H	0	-	1577	2798	2971	0.9417704
C5	17519509	17519695	BolC5t31316H	0	-	190	186	186	1.0000000
C5	17520394	17520729	BolC5t31317H	0	-	283	335	335	1.0000000
C5	17539459	17541684	BolC5t31318H	0	+	1472	2213	2225	0.9946067
C5	17547992	17549056	BolC5t31319H	0	+	265	1064	1064	1.0000000
C5	17549356	17550453	BolC5t31320H	0	-	660	1096	1097	0.9990884
C5	17562589	17563090	BolC5t31321H	0	-	18	434	501	0.8662674
C5	17574516	17576511	BolC5t31322H	0	+	1621	1995	1995	1.0000000
C5	17578292	17580074	BolC5t31323H	0	+	741	1761	1782	0.9882155
C5	17580493	17584830	BolC5t31324H	0	-	3174	4282	4337	0.9873184
C5	17585167	17586697	BolC5t31325H	0	+	332	1483	1530	0.9692810
C5	17587371	17588672	BolC5t31326H	0	-	629	1301	1301	1.0000000
C5	17590032	17590531	BolC5t31327H	0	-	281	499	499	1.0000000
C5	17591551	17593911	BolC5t31328H	0	-	1231	2344	2360	0.9932203
C5	17606054	17607149	BolC5t31329H	0	-	627	1095	1095	1.0000000
C5	17635395	17635926	BolC5t31330H	0	-	457	531	531	1.0000000
C5	17645250	17646726	BolC5t31331H	0	+	682	1469	1476	0.9952574
C5	17656497	17657755	BolC5t31332H	0	+	780	1258	1258	1.0000000
C5	17665269	17674927	BolC5t31333H	0	-	4693	9186	9658	0.9511286
C5	17675487	17678016	BolC5t31334H	0	-	2060	2486	2529	0.9829972
C5	17695521	17699459	BolC5t31335H	0	+	1037	3772	3938	0.9578466
C5	17712639	17723522	BolC5t31336H	0	+	7199	10698	10883	0.9830010
C5	17745530	17745710	BolC5t31337H	0	+	22	113	180	0.6277778
C5	17769036	17770150	BolC5t31338H	0	+	11	103	1114	0.0924596
C5	17781703	17781952	BolC5t31339H	0	+	0	0	249	0.0000000
C5	17794682	17795594	BolC5t31340H	0	+	5	132	912	0.1447368
C5	17796446	17797108	BolC5t31341H	0	+	111	466	662	0.7039275
C5	17803828	17813640	BolC5t31342H	0	-	446	5882	9812	0.5994700
C5	17828519	17829302	BolC5t31343H	0	-	623	783	783	1.0000000
C5	17870838	17870988	BolC5t31344H	0	-	7	106	150	0.7066666
C5	17879310	17880738	BolC5t31345H	0	+	6	49	1428	0.0343137
C5	17881783	17882211	BolC5t31346H	0	-	0	0	428	0.0000000
C5	17884204	17929913	BolC5t31347H	0	+	805	9616	45709	0.2103743
C5	17903118	17945157	BolC5t31348H	0	+	1208	10420	42039	0.2478651
C5	17927268	17927580	BolC5t31349H	0	+	0	0	312	0.0000000
C5	17930921	17931349	BolC5t31350H	0	-	0	0	428	0.0000000
C5	17933338	17934576	BolC5t31351H	0	+	38	763	1238	0.6163166
C5	17968494	17968791	BolC5t31352H	0	+	0	0	297	0.0000000
C5	17972205	17972373	BolC5t31353H	0	-	0	0	168	0.0000000
C5	17973826	17975065	BolC5t31354H	0	+	30	397	1239	0.3204197
C5	17977143	17977302	BolC5t31355H	0	-	0	0	159	0.0000000
C5	17978075	17978291	BolC5t31356H	0	+	21	194	216	0.8981481
C5	17982773	17983904	BolC5t31357H	0	+	0	0	1131	0.0000000
C5	17995129	17995942	BolC5t31358H	0	-	133	704	813	0.8659286
C5	18004548	18007550	BolC5t31359H	0	+	1111	2016	3002	0.6715523
C5	18021140	18023011	BolC5t31360H	0	+	180	1271	1871	0.6793159
C5	18030051	18030726	BolC5t31361H	0	+	330	675	675	1.0000000
C5	18031224	18031674	BolC5t31362H	0	+	397	450	450	1.0000000
C5	18032829	18033519	BolC5t31363H	0	-	85	521	690	0.7550725
C5	18051677	18052738	BolC5t31364H	0	+	254	955	1061	0.9000943
C5	18054735	18059068	BolC5t31365H	0	+	925	3149	4333	0.7267482
C5	18059453	18059858	BolC5t31366H	0	+	375	405	405	1.0000000
C5	18064571	18066900	BolC5t31367H	0	+	1349	2313	2329	0.9931301
C5	18067462	18069748	BolC5t31368H	0	-	1359	2092	2286	0.9151356
C5	18080637	18084507	BolC5t31369H	0	+	1669	3462	3870	0.8945736
C5	18085625	18088670	BolC5t31370H	0	-	1608	3020	3045	0.9917898
C5	18108105	18111003	BolC5t31371H	0	+	1028	2410	2898	0.8316080
C5	18112939	18113809	BolC5t31372H	0	-	63	616	870	0.7080460
C5	18114354	18118960	BolC5t31373H	0	-	1081	4263	4606	0.9255319
C5	18121457	18122425	BolC5t31374H	0	+	44	398	968	0.4111570
C5	18166991	18170862	BolC5t31375H	0	+	705	2755	3871	0.7117024
C5	18178238	18179749	BolC5t31376H	0	-	1370	1511	1511	1.0000000
C5	18202305	18203466	BolC5t31377H	0	-	258	1065	1161	0.9173127
C5	18204871	18207924	BolC5t31378H	0	+	194	1662	3053	0.5443826
C5	18225882	18226519	BolC5t31379H	0	+	497	637	637	1.0000000
C5	18226673	18227970	BolC5t31380H	0	-	768	1297	1297	1.0000000
C5	18235181	18235858	BolC5t31381H	0	-	270	651	677	0.9615953
C5	18252865	18254281	BolC5t31382H	0	-	668	1416	1416	1.0000000
C5	18261245	18262250	BolC5t31383H	0	-	64	862	1005	0.8577114
C5	18267106	18269698	BolC5t31384H	0	+	207	874	2592	0.3371913
C5	18273091	18280804	BolC5t31385H	0	+	2120	6041	7713	0.7832232
C5	18280837	18281377	BolC5t31386H	0	+	11	153	540	0.2833333
C5	18294719	18296508	BolC5t31387H	0	+	119	1395	1789	0.7797652
C5	18297581	18297818	BolC5t31388H	0	-	6	211	237	0.8902954
C5	18303310	18303538	BolC5t31389H	0	+	302	228	228	1.0000000
C5	18317247	18346597	BolC5t31390H	0	-	11063	18712	29350	0.6375468
C5	18321734	18323711	BolC5t31391H	0	-	1177	1518	1977	0.7678301
C5	18323743	18324798	BolC5t31392H	0	-	262	588	1055	0.5573460
C5	18331534	18331909	BolC5t31393H	0	+	0	0	375	0.0000000
C5	18334589	18336496	BolC5t31394H	0	-	1	25	1907	0.0131096
C5	18343961	18344420	BolC5t31395H	0	-	400	459	459	1.0000000
C5	18357332	18358922	BolC5t31396H	0	-	950	1590	1590	1.0000000
C5	18367944	18371196	BolC5t31397H	0	+	959	3040	3252	0.9348093
C5	18372691	18373812	BolC5t31398H	0	+	428	1121	1121	1.0000000
C5	18381471	18383454	BolC5t31399H	0	+	444	1825	1983	0.9203227
C5	18411324	18414408	BolC5t31400H	0	+	1620	2960	3084	0.9597925
C5	18421581	18423452	BolC5t31401H	0	+	175	1815	1871	0.9700695
C5	18423641	18426274	BolC5t31402H	0	-	357	2309	2633	0.8769464
C5	18470613	18473722	BolC5t31403H	0	+	100	2390	3109	0.7687359
C5	18474407	18477052	BolC5t31404H	0	+	52	900	2645	0.3402646
C5	18497221	18497601	BolC5t31405H	0	-	410	380	380	1.0000000
C5	18516739	18517012	BolC5t31406H	0	-	10	269	273	0.9853480
C5	18519898	18521327	BolC5t31407H	0	-	396	1357	1429	0.9496151
C5	18522139	18522849	BolC5t31408H	0	-	226	710	710	1.0000000
C5	18529002	18529128	BolC5t31409H	0	+	9	126	126	1.0000000
C5	18546749	18546974	BolC5t31410H	0	+	6	41	225	0.1822222
C5	18551825	18551999	BolC5t31411H	0	+	4	82	174	0.4712644
C5	18559285	18559666	BolC5t31412H	0	-	60	175	381	0.4593176
C5	18568275	18568440	BolC5t31413H	0	+	193	165	165	1.0000000
C5	18591038	18591678	BolC5t31414H	0	+	644	640	640	1.0000000
C5	18592561	18593290	BolC5t31415H	0	+	20	184	729	0.2524005
C5	18595004	18595988	BolC5t31416H	0	+	8	470	984	0.4776423
C5	18609073	18609904	BolC5t31417H	0	-	301	831	831	1.0000000
C5	18638834	18639379	BolC5t31418H	0	+	824	545	545	1.0000000
C5	18649996	18650251	BolC5t31419H	0	+	85	255	255	1.0000000
C5	18651236	18651991	BolC5t31420H	0	+	364	721	755	0.9549669
C5	18653616	18655447	BolC5t31421H	0	+	600	1586	1831	0.8661934
C5	18665462	18666221	BolC5t31422H	0	-	100	394	759	0.5191041
C5	18666687	18669868	BolC5t31423H	0	-	1473	3059	3181	0.9616473
C5	18675336	18676206	BolC5t31424H	0	+	191	717	870	0.8241379
C5	18686050	18687772	BolC5t31425H	0	+	1341	1722	1722	1.0000000
C5	18688402	18691277	BolC5t31426H	0	-	859	2269	2875	0.7892174
C5	18704990	18705326	BolC5t31427H	0	+	16	280	336	0.8333333
C5	18726151	18727734	BolC5t31428H	0	-	275	1255	1583	0.7927985
C5	18737934	18746590	BolC5t31429H	0	-	1218	6532	8656	0.7546211
C5	18739006	18739978	BolC5t31430H	0	+	168	753	972	0.7746913
C5	18780121	18781284	BolC5t31431H	0	-	11	413	1163	0.3551161
C5	18791669	18792373	BolC5t31432H	0	+	41	501	704	0.7116477
C5	18809374	18811786	BolC5t31433H	0	-	1183	2335	2412	0.9680763
C5	18815171	18818705	BolC5t31434H	0	-	978	3030	3534	0.8573854
C5	18822883	18823580	BolC5t31435H	0	-	1	38	697	0.0545194
C5	18825008	18826697	BolC5t31436H	0	+	62	436	1689	0.2581409
C5	18828277	18828501	BolC5t31437H	0	+	104	224	224	1.0000000
C5	18837292	18840259	BolC5t31438H	0	+	1713	2835	2967	0.9555106
C5	18854102	18859705	BolC5t31439H	0	+	2991	5548	5603	0.9901838
C5	18889290	18889473	BolC5t31440H	0	-	9	183	183	1.0000000
C5	18890437	18890980	BolC5t31441H	0	+	410	518	543	0.9539595
C5	18900950	18901153	BolC5t31442H	0	-	269	203	203	1.0000000
C5	18903143	18904529	BolC5t31443H	0	+	252	673	1386	0.4855700
C5	18905226	18907675	BolC5t31444H	0	+	953	2168	2449	0.8852593
C5	18908469	18909165	BolC5t31445H	0	-	1119	696	696	1.0000000
C5	18909857	18913464	BolC5t31446H	0	+	2184	3607	3607	1.0000000
C5	18911139	18911652	BolC5t31447H	0	+	240	513	513	1.0000000
C5	18911910	18912593	BolC5t31448H	0	-	337	683	683	1.0000000
C5	18937563	18938049	BolC5t31449H	0	-	215	486	486	1.0000000
C5	18943188	18943674	BolC5t31450H	0	-	120	483	486	0.9938272
C5	18973018	18976310	BolC5t31451H	0	+	659	2660	3292	0.8080195
C5	18979758	18980242	BolC5t31452H	0	+	415	484	484	1.0000000
C5	18985767	18986127	BolC5t31453H	0	-	451	360	360	1.0000000
C5	18986845	18987376	BolC5t31454H	0	-	149	531	531	1.0000000
C5	19009731	19017759	BolC5t31455H	0	+	3822	6397	8028	0.7968361
C5	19021863	19022823	BolC5t31456H	0	-	9	247	960	0.2572917
C5	19036282	19036687	BolC5t31457H	0	+	46	389	405	0.9604938
C5	19037513	19039304	BolC5t31458H	0	-	1139	1791	1791	1.0000000
C5	19040288	19047410	BolC5t31459H	0	+	2356	7047	7122	0.9894692
C5	19050987	19051125	BolC5t31460H	0	-	3	112	138	0.8115942
C5	19059054	19062250	BolC5t31461H	0	+	366	2513	3196	0.7862954
C5	19066462	19066771	BolC5t31462H	0	+	113	309	309	1.0000000
C5	19068212	19069709	BolC5t31463H	0	+	45	588	1497	0.3927856
C5	19094210	19094879	BolC5t31464H	0	-	95	537	669	0.8026906
C5	19104726	19105539	BolC5t31465H	0	+	57	603	813	0.7416974
C5	19106159	19109362	BolC5t31466H	0	-	204	1846	3203	0.5763347
C5	19123123	19123537	BolC5t31467H	0	-	42	316	414	0.7632850
C5	19131183	19132381	BolC5t31468H	0	+	219	1191	1198	0.9941570
C5	19136104	19137522	BolC5t31469H	0	+	1077	1418	1418	1.0000000
C5	19158877	19160599	BolC5t31470H	0	+	662	1681	1722	0.9761904
C5	19161578	19162314	BolC5t31471H	0	-	209	593	736	0.8057065
C5	19163043	19165024	BolC5t31472H	0	-	692	1637	1981	0.8263503
C5	19165831	19166631	BolC5t31473H	0	-	1014	800	800	1.0000000
C5	19174910	19176452	BolC5t31474H	0	+	967	1542	1542	1.0000000
C5	19176902	19179113	BolC5t31475H	0	-	1784	2211	2211	1.0000000
C5	19179994	19181070	BolC5t31476H	0	+	0	0	1076	0.0000000
C5	19189191	19190532	BolC5t31477H	0	-	669	1341	1341	1.0000000
C5	19196604	19198380	BolC5t31478H	0	-	1549	1776	1776	1.0000000
C5	19199118	19201422	BolC5t31479H	0	-	998	1750	2304	0.7595486
C5	19203982	19204395	BolC5t31480H	0	+	323	413	413	1.0000000
C5	19211070	19214847	BolC5t31481H	0	-	2108	3754	3777	0.9939105
C5	19225444	19226831	BolC5t31482H	0	-	1357	1387	1387	1.0000000
C5	19252894	19254173	BolC5t31483H	0	+	721	1279	1279	1.0000000
C5	19262930	19264438	BolC5t31484H	0	+	732	1276	1508	0.8461539
C5	19267061	19267554	BolC5t31485H	0	-	311	493	493	1.0000000
C5	19283611	19284052	BolC5t31486H	0	+	55	402	441	0.9115646
C5	19303771	19304937	BolC5t31487H	0	+	266	1166	1166	1.0000000
C5	19305511	19308063	BolC5t31488H	0	-	524	1929	2552	0.7558777
C5	19337709	19338467	BolC5t31489H	0	-	130	649	758	0.8562005
C5	19344004	19345623	BolC5t31490H	0	-	1522	1552	1619	0.9586164
C5	19359788	19362492	BolC5t31491H	0	-	433	2026	2704	0.7492604
C5	19377022	19380447	BolC5t31492H	0	-	642	2303	3425	0.6724088
C5	19381433	19382584	BolC5t31493H	0	-	16	399	1151	0.3466551
C5	19387792	19388804	BolC5t31494H	0	+	772	1012	1012	1.0000000
C5	19392144	19392736	BolC5t31495H	0	+	714	592	592	1.0000000
C5	19393017	19393801	BolC5t31496H	0	+	614	784	784	1.0000000
C5	19396003	19397220	BolC5t31497H	0	-	88	707	1217	0.5809367
C5	19400253	19401442	BolC5t31498H	0	-	256	1072	1189	0.9015980
C5	19413376	19413745	BolC5t31499H	0	+	185	369	369	1.0000000
C5	19420071	19420398	BolC5t31500H	0	-	415	327	327	1.0000000
C5	19431218	19431680	BolC5t31501H	0	-	145	222	462	0.4805195
C5	19434930	19435452	BolC5t31502H	0	-	2	24	522	0.0459770
C5	19438987	19439468	BolC5t31503H	0	+	110	481	481	1.0000000
C5	19455189	19456321	BolC5t31504H	0	+	87	766	1132	0.6766784
C5	19458061	19459321	BolC5t31505H	0	+	930	1260	1260	1.0000000
C5	19460914	19461436	BolC5t31506H	0	-	4	72	522	0.1379310
C5	19492838	19494216	BolC5t31507H	0	-	834	1378	1378	1.0000000
C5	19520320	19520830	BolC5t31508H	0	+	260	342	510	0.6705883
C5	19520906	19521107	BolC5t31509H	0	+	165	201	201	1.0000000
C5	19521140	19521320	BolC5t31510H	0	+	14	178	180	0.9888889
C5	19550525	19551059	BolC5t31511H	0	-	118	534	534	1.0000000
C5	19554135	19554702	BolC5t31512H	0	-	431	567	567	1.0000000
C5	19555876	19557146	BolC5t31513H	0	-	152	920	1270	0.7244095
C5	19559644	19560988	BolC5t31514H	0	-	552	1051	1344	0.7819940
C5	19561688	19561901	BolC5t31515H	0	+	196	213	213	1.0000000
C5	19562192	19563173	BolC5t31516H	0	+	736	981	981	1.0000000
C5	19563443	19564397	BolC5t31517H	0	-	305	901	954	0.9444444
C5	19564589	19565641	BolC5t31518H	0	+	754	1052	1052	1.0000000
C5	19567957	19569739	BolC5t31519H	0	+	1205	1782	1782	1.0000000
C5	19569896	19572420	BolC5t31520H	0	-	1529	2265	2524	0.8973851
C5	19573322	19573760	BolC5t31521H	0	-	15	216	438	0.4931507
C5	19575514	19576583	BolC5t31522H	0	-	573	1069	1069	1.0000000
C5	19589632	19590945	BolC5t31523H	0	+	57	912	1313	0.6945925
C5	19597242	19597371	BolC5t31524H	0	+	180	129	129	1.0000000
C5	19601205	19601466	BolC5t31525H	0	-	262	261	261	1.0000000
C5	19603618	19604026	BolC5t31526H	0	-	416	408	408	1.0000000
C5	19604845	19605850	BolC5t31527H	0	+	665	995	1005	0.9900498
C5	19610760	19611652	BolC5t31528H	0	+	337	859	892	0.9630045
C5	19619497	19619776	BolC5t31529H	0	+	74	270	279	0.9677419
C5	19621642	19622041	BolC5t31530H	0	+	278	399	399	1.0000000
C5	19622782	19623193	BolC5t31531H	0	+	120	411	411	1.0000000
C5	19629542	19630826	BolC5t31532H	0	+	1115	1284	1284	1.0000000
C5	19643187	19643508	BolC5t31533H	0	+	93	289	321	0.9003115
C5	19652665	19652776	BolC5t31534H	0	-	56	111	111	1.0000000
C5	19653617	19654967	BolC5t31535H	0	-	338	1235	1350	0.9148148
C5	19668205	19669791	BolC5t31536H	0	+	264	1450	1586	0.9142497
C5	19671666	19673873	BolC5t31537H	0	+	914	2165	2207	0.9809697
C5	19674140	19676183	BolC5t31538H	0	-	1308	2043	2043	1.0000000
C5	19702502	19703167	BolC5t31539H	0	+	1494	665	665	1.0000000
C5	19724367	19726497	BolC5t31540H	0	+	930	1880	2130	0.8826291
C5	19734177	19738911	BolC5t31541H	0	-	1064	3786	4734	0.7997465
C5	19771697	19773214	BolC5t31542H	0	+	392	1229	1517	0.8101516
C5	19773928	19775312	BolC5t31543H	0	-	537	1371	1384	0.9906070
C5	19776239	19779435	BolC5t31544H	0	-	1808	3121	3196	0.9765332
C5	19788316	19788741	BolC5t31545H	0	+	236	425	425	1.0000000
C5	19823191	19823608	BolC5t31546H	0	-	482	417	417	1.0000000
C5	19826252	19826687	BolC5t31547H	0	-	50	342	435	0.7862069
C5	19829229	19829931	BolC5t31548H	0	+	554	702	702	1.0000000
C5	19830410	19830878	BolC5t31549H	0	-	178	468	468	1.0000000
C5	19838270	19838483	BolC5t31550H	0	-	51	213	213	1.0000000
C5	19842017	19843875	BolC5t31551H	0	-	373	1518	1858	0.8170075
C5	19846999	19847825	BolC5t31552H	0	+	480	826	826	1.0000000
C5	19860385	19860811	BolC5t31553H	0	+	250	426	426	1.0000000
C5	19861424	19862232	BolC5t31554H	0	+	278	679	808	0.8403465
C5	19863365	19864367	BolC5t31555H	0	-	1158	1002	1002	1.0000000
C5	19866447	19866720	BolC5t31556H	0	-	31	209	273	0.7655678
C5	19888694	19890038	BolC5t31557H	0	+	1005	1344	1344	1.0000000
C5	19890652	19891742	BolC5t31558H	0	+	620	925	1090	0.8486239
C5	19892434	19896974	BolC5t31559H	0	+	4252	4540	4540	1.0000000
C5	19897419	19897584	BolC5t31560H	0	+	94	165	165	1.0000000
C5	19900855	19903001	BolC5t31561H	0	-	465	1881	2146	0.8765144
C5	19903127	19903413	BolC5t31562H	0	-	95	286	286	1.0000000
C5	19908277	19908721	BolC5t31563H	0	+	600	444	444	1.0000000
C5	19912364	19914190	BolC5t31564H	0	-	41	578	1826	0.3165389
C5	19915335	19916433	BolC5t31565H	0	+	203	1071	1098	0.9754099
C5	19926602	19926806	BolC5t31566H	0	-	95	204	204	1.0000000
C5	19939840	19940347	BolC5t31567H	0	+	205	399	507	0.7869822
C5	19942233	19942538	BolC5t31568H	0	+	225	305	305	1.0000000
C5	19942630	19942747	BolC5t31569H	0	+	174	117	117	1.0000000
C5	19961604	19962021	BolC5t31570H	0	-	186	417	417	1.0000000
C5	20007273	20008291	BolC5t31571H	0	-	267	584	1018	0.5736738
C5	20008705	20024138	BolC5t31572H	0	-	7782	14476	15433	0.9379900
C5	20027042	20027240	BolC5t31573H	0	+	2	10	198	0.0505050
C5	20038090	20043783	BolC5t31574H	0	-	1371	3809	5693	0.6690673
C5	20044986	20046367	BolC5t31575H	0	+	926	1226	1381	0.8877625
C5	20047040	20047886	BolC5t31576H	0	+	184	793	846	0.9373522
C5	20049737	20050055	BolC5t31577H	0	-	215	318	318	1.0000000
C5	20053120	20054242	BolC5t31578H	0	+	318	1104	1122	0.9839572
C5	20056530	20059387	BolC5t31579H	0	+	1316	2663	2857	0.9320966
C5	20059744	20061409	BolC5t31580H	0	-	1700	1665	1665	1.0000000
C5	20065446	20067338	BolC5t31581H	0	+	1821	1892	1892	1.0000000
C5	20072699	20073110	BolC5t31582H	0	+	194	411	411	1.0000000
C5	20083662	20084789	BolC5t31583H	0	+	259	1105	1127	0.9804791
C5	20085545	20088481	BolC5t31584H	0	-	605	1959	2936	0.6672344
C5	20089741	20090988	BolC5t31585H	0	-	286	1040	1247	0.8340016
C5	20095047	20096148	BolC5t31586H	0	-	128	594	1101	0.5395095
C5	20112622	20116383	BolC5t31587H	0	+	443	2344	3761	0.6232385
C5	20116991	20117795	BolC5t31588H	0	-	37	469	804	0.5833333
C5	20126016	20126601	BolC5t31589H	0	+	171	585	585	1.0000000
C5	20127699	20128742	BolC5t31590H	0	-	1376	1043	1043	1.0000000
C5	20130076	20130744	BolC5t31591H	0	-	383	668	668	1.0000000
C5	20137119	20140094	BolC5t31592H	0	-	1616	2975	2975	1.0000000
C5	20143881	20145222	BolC5t31593H	0	+	732	1341	1341	1.0000000
C5	20145603	20148329	BolC5t31594H	0	-	547	2543	2726	0.9328687
C5	20159864	20160068	BolC5t31595H	0	-	174	204	204	1.0000000
C5	20160771	20161059	BolC5t31596H	0	+	322	288	288	1.0000000
C5	20225215	20227312	BolC5t31597H	0	+	660	1618	2097	0.7715784
C5	20231499	20231793	BolC5t31598H	0	-	19	222	294	0.7551020
C5	20280193	20282661	BolC5t31599H	0	+	1180	2468	2468	1.0000000
C5	20302534	20303207	BolC5t31600H	0	-	1886	673	673	1.0000000
C5	20309058	20310474	BolC5t31601H	0	+	1	52	1416	0.0367232
C5	20312486	20314340	BolC5t31602H	0	+	356	1347	1854	0.7265372
C5	20329278	20330541	BolC5t31603H	0	+	238	1254	1263	0.9928741
C5	20332939	20333194	BolC5t31604H	0	-	232	255	255	1.0000000
C5	20336239	20339210	BolC5t31605H	0	-	2030	2970	2971	0.9996634
C5	20366362	20366626	BolC5t31606H	0	+	2209	264	264	1.0000000
C5	20382472	20385367	BolC5t31607H	0	-	303	1865	2895	0.6442142
C5	20439517	20441455	BolC5t31608H	0	-	964	1938	1938	1.0000000
C5	20514319	20515516	BolC5t31609H	0	-	103	739	1197	0.6173768
C5	20544796	20545401	BolC5t31610H	0	-	1	127	605	0.2099174
C5	20554470	20556240	BolC5t31611H	0	+	228	1141	1770	0.6446328
C5	20562286	20563907	BolC5t31612H	0	-	1181	1621	1621	1.0000000
C5	20572410	20572866	BolC5t31613H	0	+	403	456	456	1.0000000
C5	20573676	20577491	BolC5t31614H	0	-	2655	3815	3815	1.0000000
C5	20581140	20586918	BolC5t31615H	0	-	2181	5479	5778	0.9482520
C5	20617897	20619012	BolC5t31616H	0	+	380	895	1115	0.8026906
C5	20620429	20622520	BolC5t31617H	0	-	1464	1953	2091	0.9340029
C5	20627849	20631713	BolC5t31618H	0	+	2837	3495	3864	0.9045031
C5	20634406	20634718	BolC5t31619H	0	+	263	312	312	1.0000000
C5	20634936	20635214	BolC5t31620H	0	+	379	278	278	1.0000000
C5	20647778	20648357	BolC5t31621H	0	+	138	508	579	0.8773748
C5	20650375	20650531	BolC5t31622H	0	+	184	156	156	1.0000000
C5	20652473	20652692	BolC5t31623H	0	+	59	219	219	1.0000000
C5	20663918	20664633	BolC5t31624H	0	+	485	715	715	1.0000000
C5	20668413	20669292	BolC5t31625H	0	+	145	879	879	1.0000000
C5	20675354	20676783	BolC5t31626H	0	-	108	1242	1429	0.8691393
C5	20683124	20683647	BolC5t31627H	0	-	223	523	523	1.0000000
C5	20684173	20685350	BolC5t31628H	0	+	570	1177	1177	1.0000000
C5	20687510	20688006	BolC5t31629H	0	-	426	496	496	1.0000000
C5	20733098	20733930	BolC5t31630H	0	+	555	832	832	1.0000000
C5	20738165	20738996	BolC5t31631H	0	+	309	831	831	1.0000000
C5	20766458	20766668	BolC5t31632H	0	-	0	0	210	0.0000000
C5	20767963	20768422	BolC5t31633H	0	-	133	457	459	0.9956427
C5	20773121	20774225	BolC5t31634H	0	+	478	1104	1104	1.0000000
C5	20776625	20777576	BolC5t31635H	0	-	328	810	951	0.8517350
C5	20789650	20790413	BolC5t31636H	0	-	0	0	763	0.0000000
C5	20790519	20791498	BolC5t31637H	0	-	0	0	979	0.0000000
C5	20792587	20793652	BolC5t31638H	0	+	616	1065	1065	1.0000000
C5	20798308	20802353	BolC5t31639H	0	-	1506	3748	4045	0.9265760
C5	20812363	20813272	BolC5t31640H	0	-	87	884	909	0.9724972
C5	20835494	20835788	BolC5t31641H	0	+	3	171	294	0.5816327
C5	20858311	20858626	BolC5t31642H	0	-	193	315	315	1.0000000
C5	20879960	20882765	BolC5t31643H	0	+	1024	2795	2805	0.9964349
C5	20889014	20889670	BolC5t31644H	0	-	1047	656	656	1.0000000
C5	20899585	20901121	BolC5t31645H	0	-	793	1536	1536	1.0000000
C5	20974572	20975385	BolC5t31646H	0	-	216	766	813	0.9421894
C5	20976745	20977913	BolC5t31647H	0	-	382	1057	1168	0.9049658
C5	21001769	21002631	BolC5t31648H	0	-	445	862	862	1.0000000
C5	21008572	21009275	BolC5t31649H	0	+	565	703	703	1.0000000
C5	21015119	21016512	BolC5t31650H	0	-	178	1130	1393	0.8111988
C5	21028934	21029299	BolC5t31651H	0	+	223	365	365	1.0000000
C5	21040584	21043026	BolC5t31652H	0	-	402	1833	2442	0.7506142
C5	21043824	21045694	BolC5t31653H	0	+	1144	1870	1870	1.0000000
C5	21068507	21070951	BolC5t31654H	0	+	569	2326	2444	0.9517185
C5	21099398	21103178	BolC5t31655H	0	-	915	3524	3780	0.9322751
C5	21105075	21106382	BolC5t31656H	0	+	827	1307	1307	1.0000000
C5	21113036	21116818	BolC5t31657H	0	+	1059	3487	3782	0.9219989
C5	21125229	21125427	BolC5t31658H	0	-	128	198	198	1.0000000
C5	21127894	21128716	BolC5t31659H	0	-	516	822	822	1.0000000
C5	21165503	21165926	BolC5t31660H	0	-	124	423	423	1.0000000
C5	21222409	21222622	BolC5t31661H	0	-	21	199	213	0.9342723
C5	21232855	21233131	BolC5t31662H	0	-	247	276	276	1.0000000
C5	21236744	21240642	BolC5t31663H	0	+	1247	3751	3898	0.9622884
C5	21247691	21249281	BolC5t31664H	0	-	303	1317	1590	0.8283019
C5	21254268	21255041	BolC5t31665H	0	+	156	497	773	0.6429495
C5	21290857	21299771	BolC5t31666H	0	+	2839	8377	8914	0.9397577
C5	21304742	21305787	BolC5t31667H	0	-	435	1045	1045	1.0000000
C5	21307840	21314338	BolC5t31668H	0	+	1688	5711	6498	0.8788858
C5	21330045	21331886	BolC5t31669H	0	+	151	1504	1841	0.8169473
C5	21336262	21338920	BolC5t31670H	0	+	802	2274	2658	0.8555305
C5	21342869	21343631	BolC5t31671H	0	+	569	762	762	1.0000000
C5	21344323	21365606	BolC5t31672H	0	+	9559	16971	21283	0.7973970
C5	21354682	21357020	BolC5t31673H	0	-	98	1263	2338	0.5402053
C5	21370868	21371875	BolC5t31674H	0	+	696	989	1007	0.9821251
C5	21372732	21374470	BolC5t31675H	0	-	1067	1738	1738	1.0000000
C5	21377348	21378422	BolC5t31676H	0	-	18	391	1074	0.3640596
C5	21379018	21381641	BolC5t31677H	0	-	18	875	2623	0.3335875
C5	21382618	21384200	BolC5t31678H	0	+	1285	1565	1582	0.9892541
C5	21389500	21393852	BolC5t31679H	0	-	1206	4085	4352	0.9386489
C5	21399435	21400781	BolC5t31680H	0	-	243	1126	1346	0.8365527
C5	21401885	21403671	BolC5t31681H	0	-	417	1444	1786	0.8085107
C5	21404187	21404628	BolC5t31682H	0	-	323	441	441	1.0000000
C5	21406931	21407189	BolC5t31683H	0	+	23	256	258	0.9922481
C5	21407355	21408023	BolC5t31684H	0	-	53	663	668	0.9925150
C5	21409112	21411677	BolC5t31685H	0	+	1930	2565	2565	1.0000000
C5	21412521	21414531	BolC5t31686H	0	+	1316	1967	2010	0.9786069
C5	21414913	21416792	BolC5t31687H	0	-	1170	1879	1879	1.0000000
C5	21422452	21422638	BolC5t31688H	0	-	283	186	186	1.0000000
C5	21429083	21431594	BolC5t31689H	0	+	2355	2511	2511	1.0000000
C5	21432763	21433009	BolC5t31690H	0	+	94	246	246	1.0000000
C5	21443401	21445443	BolC5t31691H	0	+	951	2042	2042	1.0000000
C5	21445695	21446725	BolC5t31692H	0	-	355	1022	1030	0.9922330
C5	21460083	21462645	BolC5t31693H	0	+	1107	2443	2562	0.9535519
C5	21463101	21466125	BolC5t31694H	0	-	2535	3024	3024	1.0000000
C5	21478973	21482330	BolC5t31695H	0	-	1131	3318	3357	0.9883825
C5	21484309	21487898	BolC5t31696H	0	+	1836	3145	3589	0.8762887
C5	21500144	21502529	BolC5t31697H	0	+	580	2236	2385	0.9375262
C5	21503369	21504887	BolC5t31698H	0	-	404	1511	1518	0.9953887
C5	21505923	21509372	BolC5t31699H	0	+	541	2381	3449	0.6903450
C5	21514271	21514514	BolC5t31700H	0	+	110	243	243	1.0000000
C5	21521218	21523532	BolC5t31701H	0	+	591	2081	2314	0.8993086
C5	21560859	21564856	BolC5t31702H	0	+	4302	3997	3997	1.0000000
C5	21566553	21568411	BolC5t31703H	0	+	1499	1858	1858	1.0000000
C5	21576038	21577848	BolC5t31704H	0	+	422	1193	1810	0.6591160
C5	21582636	21583263	BolC5t31705H	0	-	52	320	627	0.5103668
C5	21586029	21587613	BolC5t31706H	0	+	267	1147	1584	0.7241161
C5	21589312	21590923	BolC5t31707H	0	+	503	1611	1611	1.0000000
C5	21591216	21593874	BolC5t31708H	0	-	469	2220	2658	0.8352144
C5	21598848	21599385	BolC5t31709H	0	-	399	537	537	1.0000000
C5	21599681	21602564	BolC5t31710H	0	-	1927	2685	2883	0.9313216
C5	21611783	21613092	BolC5t31711H	0	+	6	11	1309	0.0084034
C5	21613362	21615358	BolC5t31712H	0	+	79	165	1996	0.0826653
C5	21618179	21618463	BolC5t31713H	0	-	2	19	284	0.0669014
C5	21626065	21628843	BolC5t31714H	0	+	538	1969	2778	0.7087833
C5	21630422	21631513	BolC5t31715H	0	-	311	1050	1091	0.9624198
C5	21632558	21633140	BolC5t31716H	0	-	0	0	582	0.0000000
C5	21660152	21660581	BolC5t31717H	0	-	15	213	429	0.4965035
C5	21661717	21666034	BolC5t31718H	0	-	1325	3570	4317	0.8269632
C5	21667753	21668740	BolC5t31719H	0	-	81	660	987	0.6686930
C5	21671303	21674872	BolC5t31720H	0	-	1527	3541	3569	0.9921547
C5	21704179	21704792	BolC5t31721H	0	+	294	613	613	1.0000000
C5	21757488	21759422	BolC5t31722H	0	+	386	1884	1934	0.9741468
C5	21762393	21762636	BolC5t31723H	0	+	179	243	243	1.0000000
C5	21780281	21780605	BolC5t31724H	0	+	147	324	324	1.0000000
C5	21815730	21816640	BolC5t31725H	0	+	198	653	910	0.7175824
C5	21836796	21837147	BolC5t31726H	0	-	64	351	351	1.0000000
C5	21837200	21839658	BolC5t31727H	0	-	3054	2458	2458	1.0000000
C5	21862881	21863433	BolC5t31728H	0	+	9	53	552	0.0960145
C5	21873784	21874135	BolC5t31729H	0	+	395	351	351	1.0000000
C5	21884722	21884827	BolC5t31730H	0	+	180	105	105	1.0000000
C5	21889222	21890740	BolC5t31731H	0	-	574	1465	1518	0.9650856
C5	21893688	21894344	BolC5t31732H	0	+	14	191	656	0.2911585
C5	21900329	21902563	BolC5t31733H	0	+	850	2221	2234	0.9941809
C5	21910130	21910556	BolC5t31734H	0	+	35	199	426	0.4671361
C5	21918635	21919039	BolC5t31735H	0	-	307	404	404	1.0000000
C5	21923784	21924440	BolC5t31736H	0	+	0	0	656	0.0000000
C5	21943946	21945119	BolC5t31737H	0	+	61	259	1173	0.2208014
C5	21953977	21959637	BolC5t31738H	0	-	3755	5559	5660	0.9821555
C5	21960569	21961313	BolC5t31739H	0	+	934	744	744	1.0000000
C5	22002242	22002830	BolC5t31740H	0	+	502	588	588	1.0000000
C5	22006633	22008102	BolC5t31741H	0	+	99	1397	1469	0.9509870
C5	22009456	22010674	BolC5t31742H	0	-	32	825	1218	0.6773399
C5	22023888	22025981	BolC5t31743H	0	+	1884	2093	2093	1.0000000
C5	22030244	22031144	BolC5t31744H	0	+	48	431	900	0.4788889
C5	22032010	22034606	BolC5t31745H	0	-	1725	2596	2596	1.0000000
C5	22035190	22039512	BolC5t31746H	0	+	437	1668	4322	0.3859324
C5	22043405	22043641	BolC5t31747H	0	-	113	236	236	1.0000000
C5	22064571	22066473	BolC5t31748H	0	+	1081	1902	1902	1.0000000
C5	22066973	22067505	BolC5t31749H	0	-	414	532	532	1.0000000
C5	22070861	22074026	BolC5t31750H	0	+	1395	3044	3165	0.9617693
C5	22075666	22077479	BolC5t31751H	0	-	1098	1756	1813	0.9685604
C5	22078406	22080580	BolC5t31752H	0	-	1154	2174	2174	1.0000000
C5	22104836	22105037	BolC5t31753H	0	+	93	201	201	1.0000000
C5	22106144	22107705	BolC5t31754H	0	-	1184	1561	1561	1.0000000
C5	22110913	22112121	BolC5t31755H	0	+	536	1208	1208	1.0000000
C5	22129654	22130035	BolC5t31756H	0	+	321	381	381	1.0000000
C5	22130701	22130989	BolC5t31757H	0	+	280	288	288	1.0000000
C5	22148041	22149284	BolC5t31758H	0	-	256	1218	1243	0.9798874
C5	22166226	22176058	BolC5t31759H	0	-	5112	9433	9832	0.9594182
C5	22186614	22187275	BolC5t31760H	0	+	644	661	661	1.0000000
C5	22201010	22201711	BolC5t31761H	0	+	406	701	701	1.0000000
C5	22205964	22206366	BolC5t31762H	0	+	159	402	402	1.0000000
C5	22206402	22206693	BolC5t31763H	0	+	212	291	291	1.0000000
C5	22207909	22208528	BolC5t31764H	0	-	376	619	619	1.0000000
C5	22217031	22220856	BolC5t31765H	0	-	1117	2883	3825	0.7537255
C5	22248415	22251943	BolC5t31766H	0	+	103	1910	3528	0.5413832
C5	22254043	22255268	BolC5t31767H	0	+	1303	1225	1225	1.0000000
C5	22271029	22271188	BolC5t31768H	0	+	0	0	159	0.0000000
C5	22274858	22275824	BolC5t31769H	0	-	161	784	966	0.8115942
C5	22277017	22277182	BolC5t31770H	0	+	141	165	165	1.0000000
C5	22286172	22287997	BolC5t31771H	0	+	2077	1825	1825	1.0000000
C5	22331946	22332229	BolC5t31772H	0	+	9	251	283	0.8869258
C5	22336341	22336720	BolC5t31773H	0	+	89	358	379	0.9445910
C5	22341796	22342593	BolC5t31774H	0	-	95	785	797	0.9849435
C5	22342884	22344726	BolC5t31775H	0	+	216	1315	1842	0.7138979
C5	22344877	22347826	BolC5t31776H	0	-	1156	2943	2949	0.9979654
C5	22348941	22349422	BolC5t31777H	0	+	598	481	481	1.0000000
C5	22360877	22362068	BolC5t31778H	0	+	341	1148	1191	0.9638959
C5	22363005	22367260	BolC5t31779H	0	-	1018	3501	4255	0.8227967
C5	22369572	22370418	BolC5t31780H	0	-	393	750	846	0.8865248
C5	22372838	22374982	BolC5t31781H	0	-	342	1755	2144	0.8185635
C5	22442858	22444078	BolC5t31782H	0	+	58	986	1220	0.8081967
C5	22463403	22463616	BolC5t31783H	0	+	0	0	213	0.0000000
C5	22476085	22476415	BolC5t31784H	0	-	208	330	330	1.0000000
C5	22478279	22481284	BolC5t31785H	0	-	475	1367	3005	0.4549085
C5	22482314	22483086	BolC5t31786H	0	+	543	772	772	1.0000000
C5	22485311	22485506	BolC5t31787H	0	-	230	195	195	1.0000000
C5	22494273	22495794	BolC5t31788H	0	-	178	966	1521	0.6351085
C5	22532707	22533914	BolC5t31789H	0	-	376	1202	1207	0.9958575
C5	22538044	22538533	BolC5t31790H	0	-	0	0	489	0.0000000
C5	22546392	22547097	BolC5t31791H	0	-	577	703	705	0.9971631
C5	22558377	22558596	BolC5t31792H	0	-	40	219	219	1.0000000
C5	22593982	22595720	BolC5t31793H	0	+	16	39	1738	0.0224396
C5	22597589	22598480	BolC5t31794H	0	-	579	891	891	1.0000000
C5	22611491	22612706	BolC5t31795H	0	-	22	568	1215	0.4674897
C5	22618094	22619033	BolC5t31796H	0	-	737	939	939	1.0000000
C5	22626201	22626447	BolC5t31797H	0	+	199	246	246	1.0000000
C5	22651048	22652389	BolC5t31798H	0	+	227	1107	1341	0.8255033
C5	22670797	22672177	BolC5t31799H	0	-	1347	1380	1380	1.0000000
C5	22672886	22675542	BolC5t31800H	0	-	1679	2656	2656	1.0000000
C5	22688706	22690302	BolC5t31801H	0	-	406	1291	1596	0.8088973
C5	22695361	22696116	BolC5t31802H	0	-	655	755	755	1.0000000
C5	22704884	22705040	BolC5t31803H	0	+	10	151	156	0.9679487
C5	22705144	22708227	BolC5t31804H	0	-	1124	3062	3083	0.9931884
C5	22710663	22715573	BolC5t31805H	0	+	2079	4835	4910	0.9847251
C5	22715765	22717088	BolC5t31806H	0	-	210	1183	1323	0.8941799
C5	22741836	22745685	BolC5t31807H	0	-	3750	3849	3849	1.0000000
C5	22758171	22759442	BolC5t31808H	0	-	195	423	1271	0.3328088
C5	22765423	22768682	BolC5t31809H	0	-	805	2845	3259	0.8729672
C5	22786308	22787946	BolC5t31810H	0	-	291	1426	1638	0.8705739
C5	22795139	22795405	BolC5t31811H	0	-	214	266	266	1.0000000
C5	22804244	22804493	BolC5t31812H	0	-	49	208	249	0.8353414
C5	22815167	22815410	BolC5t31813H	0	+	327	243	243	1.0000000
C5	22816465	22816684	BolC5t31814H	0	+	0	0	219	0.0000000
C5	22823607	22827562	BolC5t31815H	0	+	165	1791	3955	0.4528445
C5	22833843	22838218	BolC5t31816H	0	-	3140	4375	4375	1.0000000
C5	22842485	22842731	BolC5t31817H	0	+	150	246	246	1.0000000
C5	22849822	22850269	BolC5t31818H	0	-	346	447	447	1.0000000
C5	22897719	22898344	BolC5t31819H	0	-	258	594	625	0.9504000
C5	22912744	22916590	BolC5t31820H	0	-	1076	2541	3846	0.6606864
C5	22956686	22959790	BolC5t31821H	0	+	771	2697	3104	0.8688788
C5	22961861	22962201	BolC5t31822H	0	+	181	340	340	1.0000000
C5	22962933	22968520	BolC5t31823H	0	-	1683	4702	5587	0.8415965
C5	22970342	22971700	BolC5t31824H	0	+	835	1358	1358	1.0000000
C5	22973452	22973942	BolC5t31825H	0	+	457	490	490	1.0000000
C5	22974177	22974366	BolC5t31826H	0	+	190	189	189	1.0000000
C5	22976126	22976637	BolC5t31827H	0	-	809	511	511	1.0000000
C5	22977696	22979094	BolC5t31828H	0	-	1133	1398	1398	1.0000000
C5	22989852	22990431	BolC5t31829H	0	+	88	189	579	0.3264249
C5	22994956	22996140	BolC5t31830H	0	-	435	1153	1184	0.9738176
C5	22996564	22997961	BolC5t31831H	0	-	198	1195	1397	0.8554044
C5	23000560	23002054	BolC5t31832H	0	-	242	1154	1494	0.7724230
C5	23019867	23020817	BolC5t31833H	0	+	678	832	950	0.8757895
C5	23045871	23046216	BolC5t31834H	0	+	430	345	345	1.0000000
C5	23054490	23055197	BolC5t31835H	0	+	36	487	707	0.6888260
C5	23085899	23086240	BolC5t31836H	0	-	109	341	341	1.0000000
C5	23090250	23090802	BolC5t31837H	0	+	34	442	552	0.8007246
C5	23091937	23094319	BolC5t31838H	0	+	332	2119	2382	0.8895886
C5	23095664	23096018	BolC5t31839H	0	+	67	344	354	0.9717514
C5	23099039	23099789	BolC5t31840H	0	+	15	353	750	0.4706667
C5	23101697	23102273	BolC5t31841H	0	+	8	387	576	0.6718750
C5	23105826	23106911	BolC5t31842H	0	+	95	883	1085	0.8138249
C5	23127727	23131753	BolC5t31843H	0	+	1131	3654	4026	0.9076006
C5	23149598	23152062	BolC5t31844H	0	-	947	2003	2464	0.8129058
C5	23189185	23192135	BolC5t31845H	0	-	938	2325	2950	0.7881356
C5	23196179	23196524	BolC5t31846H	0	+	53	345	345	1.0000000
C5	23198107	23198318	BolC5t31847H	0	+	381	211	211	1.0000000
C5	23204249	23204532	BolC5t31848H	0	-	212	283	283	1.0000000
C5	23212401	23212581	BolC5t31849H	0	+	7	45	180	0.2500000
C5	23224344	23227299	BolC5t31850H	0	+	1317	2341	2955	0.7922166
C5	23251650	23254418	BolC5t31851H	0	+	693	2361	2768	0.8529624
C5	23254817	23255941	BolC5t31852H	0	-	1272	1124	1124	1.0000000
C5	23263238	23264121	BolC5t31853H	0	-	393	883	883	1.0000000
C5	23269750	23272472	BolC5t31854H	0	+	1489	2722	2722	1.0000000
C5	23280262	23280776	BolC5t31855H	0	-	15	218	514	0.4241245
C5	23299105	23300119	BolC5t31856H	0	+	564	1000	1014	0.9861933
C5	23305499	23305973	BolC5t31857H	0	+	39	248	474	0.5232068
C5	23313886	23314165	BolC5t31858H	0	+	240	279	279	1.0000000
C5	23325875	23327261	BolC5t31859H	0	+	851	1386	1386	1.0000000
C5	23327959	23329512	BolC5t31860H	0	-	609	1517	1553	0.9768190
C5	23331049	23337183	BolC5t31861H	0	-	1060	4139	6134	0.6747636
C5	23331132	23336519	BolC5t31862H	0	-	620	3392	5387	0.6296640
C5	23379561	23380689	BolC5t31863H	0	+	138	660	1128	0.5851064
C5	23386935	23387619	BolC5t31864H	0	+	126	613	684	0.8961988
C5	23390812	23391311	BolC5t31865H	0	-	68	499	499	1.0000000
C5	23420953	23421235	BolC5t31866H	0	-	316	282	282	1.0000000
C5	23427282	23427753	BolC5t31867H	0	+	11	187	471	0.3970276
C5	23454172	23456586	BolC5t31868H	0	+	555	2219	2414	0.9192212
C5	23458043	23459734	BolC5t31869H	0	+	333	1426	1691	0.8432880
C5	23497607	23497886	BolC5t31870H	0	+	0	0	279	0.0000000
C5	23500463	23521517	BolC5t31871H	0	-	1286	7232	21054	0.3434977
C5	23509137	23509509	BolC5t31872H	0	+	7	251	372	0.6747312
C5	23523082	23523319	BolC5t31873H	0	+	201	237	237	1.0000000
C5	23540963	23541815	BolC5t31874H	0	-	124	684	852	0.8028169
C5	23596825	23599715	BolC5t31875H	0	+	304	2127	2890	0.7359862
C5	23608237	23609094	BolC5t31876H	0	-	54	570	857	0.6651108
C5	23612112	23616597	BolC5t31877H	0	+	990	3935	4485	0.8773690
C5	23622982	23625586	BolC5t31878H	0	-	1338	2604	2604	1.0000000
C5	23630488	23632587	BolC5t31879H	0	+	1027	2058	2099	0.9804669
C5	23665134	23665655	BolC5t31880H	0	+	433	521	521	1.0000000
C5	23683621	23683804	BolC5t31881H	0	-	3	95	183	0.5191257
C5	23714410	23716887	BolC5t31882H	0	-	371	1757	2477	0.7093258
C5	23759028	23761432	BolC5t31883H	0	-	1331	2391	2404	0.9945924
C5	23766856	23768064	BolC5t31884H	0	-	802	1206	1208	0.9983444
C5	23768464	23770084	BolC5t31885H	0	+	1455	1620	1620	1.0000000
C5	23775969	23776894	BolC5t31886H	0	-	798	925	925	1.0000000
C5	23797575	23797857	BolC5t31887H	0	+	1	150	282	0.5319149
C5	23806601	23807022	BolC5t31888H	0	+	622	421	421	1.0000000
C5	23807488	23809764	BolC5t31889H	0	+	928	2192	2276	0.9630932
C5	23811434	23812195	BolC5t31890H	0	-	314	761	761	1.0000000
C5	23830946	23832578	BolC5t31891H	0	-	2268	1632	1632	1.0000000
C5	23836495	23836915	BolC5t31892H	0	-	425	420	420	1.0000000
C5	23881164	23884175	BolC5t31893H	0	+	4118	3011	3011	1.0000000
C5	23884942	23885512	BolC5t31894H	0	-	294	570	570	1.0000000
C5	23897531	23901427	BolC5t31895H	0	-	1345	3700	3896	0.9496920
C5	23931144	23931633	BolC5t31896H	0	-	226	489	489	1.0000000
C5	23956343	23956592	BolC5t31897H	0	-	49	249	249	1.0000000
C5	23983743	23984637	BolC5t31898H	0	-	621	894	894	1.0000000
C5	23985019	23986841	BolC5t31899H	0	+	1106	1822	1822	1.0000000
C5	23987565	23987883	BolC5t31900H	0	+	55	220	318	0.6918239
C5	23992242	23994967	BolC5t31901H	0	-	1073	2536	2725	0.9306422
C5	23998563	24001572	BolC5t31902H	0	-	13	660	3009	0.2193420
C5	24006895	24007568	BolC5t31903H	0	+	2	63	673	0.0936107
C5	24008636	24010412	BolC5t31904H	0	-	363	1521	1776	0.8564189
C5	24015517	24015943	BolC5t31905H	0	-	420	426	426	1.0000000
C5	24016147	24016648	BolC5t31906H	0	-	644	501	501	1.0000000
C5	24016706	24017074	BolC5t31907H	0	-	357	368	368	1.0000000
C5	24051111	24051402	BolC5t31908H	0	-	198	291	291	1.0000000
C5	24052185	24053536	BolC5t31909H	0	+	1332	1351	1351	1.0000000
C5	24060802	24061774	BolC5t31910H	0	+	209	904	972	0.9300411
C5	24073239	24074281	BolC5t31911H	0	+	1000	1042	1042	1.0000000
C5	24076751	24078950	BolC5t31912H	0	+	815	2081	2199	0.9463392
C5	24094609	24096063	BolC5t31913H	0	-	1050	1454	1454	1.0000000
C5	24109910	24110471	BolC5t31914H	0	+	87	561	561	1.0000000
C5	24111969	24112808	BolC5t31915H	0	+	463	839	839	1.0000000
C5	24113138	24115388	BolC5t31916H	0	+	250	1433	2250	0.6368889
C5	24115739	24119925	BolC5t31917H	0	-	1066	2856	4186	0.6822742
C5	24181550	24181787	BolC5t31918H	0	+	208	237	237	1.0000000
C5	24182094	24182882	BolC5t31919H	0	-	593	788	788	1.0000000
C5	24207388	24208479	BolC5t31920H	0	+	684	1091	1091	1.0000000
C5	24212277	24213908	BolC5t31921H	0	+	1129	1631	1631	1.0000000
C5	24214601	24215394	BolC5t31922H	0	-	127	633	793	0.7982346
C5	24215823	24218271	BolC5t31923H	0	-	701	2305	2448	0.9415849
C5	24247199	24248620	BolC5t31924H	0	-	815	1421	1421	1.0000000
C5	24249038	24249224	BolC5t31925H	0	-	47	175	186	0.9408602
C5	24253553	24258658	BolC5t31926H	0	+	2385	4454	5105	0.8724779
C5	24256319	24257548	BolC5t31927H	0	-	1069	1167	1229	0.9495525
C5	24268143	24269501	BolC5t31928H	0	-	199	1251	1358	0.9212077
C5	24270349	24270844	BolC5t31929H	0	+	134	495	495	1.0000000
C5	24283201	24284157	BolC5t31930H	0	+	137	901	956	0.9424686
C5	24287396	24297177	BolC5t31931H	0	-	4121	6795	9781	0.6947142
C5	24290901	24291655	BolC5t31932H	0	+	774	754	754	1.0000000
C5	24291783	24292637	BolC5t31933H	0	+	1200	854	854	1.0000000
C5	24292795	24293347	BolC5t31934H	0	+	222	552	552	1.0000000
C5	24295243	24295857	BolC5t31935H	0	+	7	92	614	0.1498371
C5	24303649	24304092	BolC5t31936H	0	-	117	441	443	0.9954853
C5	24304747	24304860	BolC5t31937H	0	+	34	113	113	1.0000000
C5	24305159	24305970	BolC5t31938H	0	+	11	345	811	0.4254007
C5	24307859	24309006	BolC5t31939H	0	-	375	1032	1147	0.8997384
C5	24316970	24317451	BolC5t31940H	0	-	117	467	481	0.9708940
C5	24318392	24318812	BolC5t31941H	0	+	448	420	420	1.0000000
C5	24330577	24331029	BolC5t31942H	0	-	128	452	452	1.0000000
C5	24354054	24355056	BolC5t31943H	0	+	1004	1002	1002	1.0000000
C5	24355165	24356545	BolC5t31944H	0	+	464	1378	1380	0.9985507
C5	24373111	24373294	BolC5t31945H	0	+	42	26	183	0.1420765
C5	24385835	24386183	BolC5t31946H	0	-	340	348	348	1.0000000
C5	24386712	24386990	BolC5t31947H	0	-	191	278	278	1.0000000
C5	24388607	24389977	BolC5t31948H	0	+	1014	1370	1370	1.0000000
C5	24390093	24392539	BolC5t31949H	0	+	1762	2446	2446	1.0000000
C5	24401157	24401292	BolC5t31950H	0	-	97	135	135	1.0000000
C5	24458175	24478323	BolC5t31951H	0	+	5146	17998	20148	0.8932897
C5	24480137	24481499	BolC5t31952H	0	+	778	1362	1362	1.0000000
C5	24484218	24486299	BolC5t31953H	0	+	1439	2081	2081	1.0000000
C5	24502857	24503229	BolC5t31954H	0	+	263	372	372	1.0000000
C5	24503818	24505347	BolC5t31955H	0	-	431	1453	1529	0.9502943
C5	24518589	24519501	BolC5t31956H	0	+	131	825	912	0.9046053
C5	24562375	24565231	BolC5t31957H	0	-	1977	2856	2856	1.0000000
C5	24566820	24568652	BolC5t31958H	0	-	250	1207	1832	0.6588428
C5	24590507	24590787	BolC5t31959H	0	-	285	280	280	1.0000000
C5	24591132	24591775	BolC5t31960H	0	-	402	643	643	1.0000000
C5	24594550	24597441	BolC5t31961H	0	+	2156	2891	2891	1.0000000
C5	24602777	24605199	BolC5t31962H	0	-	297	1306	2422	0.5392238
C5	24607710	24609406	BolC5t31963H	0	-	1561	1696	1696	1.0000000
C5	24649826	24653582	BolC5t31964H	0	+	717	3136	3756	0.8349308
C5	24655768	24656714	BolC5t31965H	0	+	480	946	946	1.0000000
C5	24659037	24663853	BolC5t31966H	0	-	1045	3950	4816	0.8201827
C5	24664450	24666161	BolC5t31967H	0	-	361	1268	1711	0.7410871
C5	24679206	24679440	BolC5t31968H	0	+	60	215	234	0.9188034
C5	24685191	24685443	BolC5t31969H	0	+	240	252	252	1.0000000
C5	24685884	24688162	BolC5t31970H	0	-	1444	2263	2278	0.9934153
C5	24718035	24724938	BolC5t31971H	0	+	3099	6463	6903	0.9362596
C5	24727002	24727510	BolC5t31972H	0	+	601	508	508	1.0000000
C5	24733676	24734823	BolC5t31973H	0	+	1833	1147	1147	1.0000000
C5	24735308	24736920	BolC5t31974H	0	-	1636	1612	1612	1.0000000
C5	24746004	24746485	BolC5t31975H	0	+	224	481	481	1.0000000
C5	24750617	24751772	BolC5t31976H	0	+	652	1138	1155	0.9852814
C5	24758389	24758717	BolC5t31977H	0	+	642	328	328	1.0000000
C5	24777461	24777662	BolC5t31978H	0	-	26	170	201	0.8457711
C5	24785246	24785458	BolC5t31979H	0	+	275	212	212	1.0000000
C5	24798362	24798590	BolC5t31980H	0	+	331	228	228	1.0000000
C5	24800030	24800270	BolC5t31981H	0	+	154	240	240	1.0000000
C5	24806408	24809247	BolC5t31982H	0	+	2379	2839	2839	1.0000000
C5	24809813	24810509	BolC5t31983H	0	+	226	696	696	1.0000000
C5	24812452	24812752	BolC5t31984H	0	+	1	95	300	0.3166667
C5	24877791	24878796	BolC5t31985H	0	-	711	1005	1005	1.0000000
C5	24894365	24910937	BolC5t31986H	0	+	14630	15958	16572	0.9629496
C5	24906549	24907224	BolC5t31987H	0	+	309	675	675	1.0000000
C5	24936939	24937291	BolC5t31988H	0	-	246	352	352	1.0000000
C5	24939980	24970471	BolC5t31989H	0	+	14229	25550	30491	0.8379522
C5	24965352	24966324	BolC5t31990H	0	-	468	834	972	0.8580247
C5	24973076	24974547	BolC5t31991H	0	-	959	1372	1471	0.9326988
C5	25018160	25019269	BolC5t31992H	0	+	709	1109	1109	1.0000000
C5	25019451	25025280	BolC5t31993H	0	-	2449	5829	5829	1.0000000
C5	25052365	25053502	BolC5t31994H	0	+	1088	1137	1137	1.0000000
C5	25062645	25064611	BolC5t31995H	0	-	3135	1966	1966	1.0000000
C5	25067666	25069447	BolC5t31996H	0	-	1568	1350	1781	0.7580011
C5	25077221	25077609	BolC5t31997H	0	+	304	388	388	1.0000000
C5	25088588	25089288	BolC5t31998H	0	-	750	700	700	1.0000000
C5	25090567	25091089	BolC5t31999H	0	-	314	522	522	1.0000000
C5	25104419	25105040	BolC5t32000H	0	-	164	496	621	0.7987118
C5	25119839	25122142	BolC5t32001H	0	+	1238	2299	2303	0.9982631
C5	25122293	25122653	BolC5t32002H	0	-	3	20	360	0.0555556
C5	25134679	25137196	BolC5t32003H	0	-	225	1873	2517	0.7441399
C5	25139755	25140060	BolC5t32004H	0	-	210	305	305	1.0000000
C5	25141619	25141899	BolC5t32005H	0	+	17	280	280	1.0000000
C5	25148977	25149181	BolC5t32006H	0	+	97	204	204	1.0000000
C5	25194094	25195609	BolC5t32007H	0	-	8	478	1515	0.3155116
C5	25202250	25203794	BolC5t32008H	0	-	1906	1544	1544	1.0000000
C5	25223637	25224898	BolC5t32009H	0	-	2420	1261	1261	1.0000000
C5	25230082	25230220	BolC5t32010H	0	-	171	138	138	1.0000000
C5	25230332	25230827	BolC5t32011H	0	-	448	495	495	1.0000000
C5	25258523	25260873	BolC5t32012H	0	+	1659	2253	2350	0.9587234
C5	25279456	25279943	BolC5t32013H	0	+	375	487	487	1.0000000
C5	25282270	25282746	BolC5t32014H	0	+	202	476	476	1.0000000
C5	25283234	25284366	BolC5t32015H	0	-	362	1132	1132	1.0000000
C5	25285570	25286843	BolC5t32016H	0	+	1647	1273	1273	1.0000000
C5	25287698	25290429	BolC5t32017H	0	+	1092	2474	2731	0.9058953
C5	25303021	25305067	BolC5t32018H	0	-	357	1316	2046	0.6432062
C5	25308428	25315004	BolC5t32019H	0	+	729	5067	6576	0.7705292
C5	25338537	25344492	BolC5t32020H	0	+	2245	5638	5955	0.9467674
C5	25370875	25376934	BolC5t32021H	0	+	3756	6059	6059	1.0000000
C5	25386267	25386531	BolC5t32022H	0	-	285	264	264	1.0000000
C5	25387221	25387398	BolC5t32023H	0	-	195	177	177	1.0000000
C5	25387927	25388299	BolC5t32024H	0	+	548	372	372	1.0000000
C5	25388352	25389344	BolC5t32025H	0	+	973	992	992	1.0000000
C5	25390601	25391058	BolC5t32026H	0	-	371	457	457	1.0000000
C5	25460176	25462208	BolC5t32027H	0	+	1602	2018	2032	0.9931102
C5	25462522	25463569	BolC5t32028H	0	-	113	843	1047	0.8051576
C5	25466963	25468208	BolC5t32029H	0	-	1254	1245	1245	1.0000000
C5	25468969	25469446	BolC5t32030H	0	-	443	477	477	1.0000000
C5	25482371	25490643	BolC5t32031H	0	-	5031	8272	8272	1.0000000
C5	25496057	25499131	BolC5t32032H	0	-	1684	3012	3074	0.9798309
C5	25522411	25522624	BolC5t32033H	0	-	317	213	213	1.0000000
C5	25624555	25625023	BolC5t32034H	0	+	36	468	468	1.0000000
C5	25631778	25632072	BolC5t32035H	0	+	133	294	294	1.0000000
C5	25632645	25633221	BolC5t32036H	0	+	151	576	576	1.0000000
C5	25684268	25684841	BolC5t32037H	0	-	173	573	573	1.0000000
C5	25685341	25685500	BolC5t32038H	0	+	123	159	159	1.0000000
C5	25703893	25705687	BolC5t32039H	0	+	259	1248	1794	0.6956522
C5	25706178	25706472	BolC5t32040H	0	+	16	211	294	0.7176871
C5	25712265	25713087	BolC5t32041H	0	-	145	822	822	1.0000000
C5	25756211	25759114	BolC5t32042H	0	-	2013	2672	2903	0.9204271
C5	25779062	25779715	BolC5t32043H	0	-	116	624	653	0.9555896
C5	25793238	25800308	BolC5t32044H	0	+	3917	6182	7070	0.8743989
C5	25798288	25798996	BolC5t32045H	0	+	997	708	708	1.0000000
C5	25809222	25810826	BolC5t32046H	0	+	1581	1604	1604	1.0000000
C5	25811575	25811695	BolC5t32047H	0	-	55	104	120	0.8666667
C5	25815825	25815993	BolC5t32048H	0	-	145	168	168	1.0000000
C5	25824740	25828616	BolC5t32049H	0	+	1526	3646	3876	0.9406605
C5	25905453	25906599	BolC5t32050H	0	-	760	1146	1146	1.0000000
C5	25909421	25909976	BolC5t32051H	0	-	354	555	555	1.0000000
C5	25913491	25914030	BolC5t32052H	0	+	25	367	539	0.6808906
C5	25921083	25922208	BolC5t32053H	0	-	288	1086	1125	0.9653333
C5	25934448	25938417	BolC5t32054H	0	+	608	3160	3969	0.7961703
C5	25948227	25951127	BolC5t32055H	0	-	1482	2900	2900	1.0000000
C5	26014345	26040486	BolC5t32056H	0	+	7373	19032	26141	0.7280517
C5	26090915	26092284	BolC5t32057H	0	+	738	1369	1369	1.0000000
C5	26102195	26102354	BolC5t32058H	0	-	165	159	159	1.0000000
C5	26115127	26115495	BolC5t32059H	0	+	285	368	368	1.0000000
C5	26119353	26120844	BolC5t32060H	0	+	795	1491	1491	1.0000000
C5	26124696	26125855	BolC5t32061H	0	+	193	894	1159	0.7713546
C5	26134706	26135731	BolC5t32062H	0	-	694	1025	1025	1.0000000
C5	26147416	26163531	BolC5t32063H	0	+	5449	12048	16115	0.7476264
C5	26150767	26153925	BolC5t32064H	0	+	961	2102	3158	0.6656111
C5	26154013	26154791	BolC5t32065H	0	+	61	538	778	0.6915167
C5	26199980	26202870	BolC5t32066H	0	+	207	2111	2890	0.7304499
C5	26216308	26216488	BolC5t32067H	0	+	270	180	180	1.0000000
C5	26231559	26233109	BolC5t32068H	0	+	2469	1550	1550	1.0000000
C5	26253445	26254133	BolC5t32069H	0	+	14	351	688	0.5101744
C5	26257544	26258646	BolC5t32070H	0	+	168	760	1102	0.6896552
C5	26285675	26286000	BolC5t32071H	0	+	476	325	325	1.0000000
C5	26295453	26296265	BolC5t32072H	0	-	243	713	812	0.8780788
C5	26297257	26298004	BolC5t32073H	0	-	12	318	747	0.4257028
C5	26300643	26305304	BolC5t32074H	0	+	443	3065	4661	0.6575842
C5	26308886	26309024	BolC5t32075H	0	-	127	138	138	1.0000000
C5	26309273	26309651	BolC5t32076H	0	-	326	378	378	1.0000000
C5	26319303	26321763	BolC5t32077H	0	-	886	2013	2460	0.8182927
C5	26352460	26352925	BolC5t32078H	0	+	361	465	465	1.0000000
C5	26359780	26362172	BolC5t32079H	0	-	228	944	2392	0.3946488
C5	26376781	26377105	BolC5t32080H	0	+	1	59	324	0.1820988
C5	26385689	26385887	BolC5t32081H	0	-	83	198	198	1.0000000
C5	26388801	26389266	BolC5t32082H	0	+	44	465	465	1.0000000
C5	26405724	26408801	BolC5t32083H	0	+	2526	3077	3077	1.0000000
C5	26430134	26430550	BolC5t32084H	0	+	332	416	416	1.0000000
C5	26430824	26435095	BolC5t32085H	0	-	1382	4136	4271	0.9683915
C5	26435278	26444061	BolC5t32086H	0	+	1176	3170	8783	0.3609245
C5	26447466	26447642	BolC5t32087H	0	-	4	99	176	0.5625000
C5	26447949	26448099	BolC5t32088H	0	-	9	150	150	1.0000000
C5	26465831	26466029	BolC5t32089H	0	+	129	198	198	1.0000000
C5	26467949	26468963	BolC5t32090H	0	+	264	951	1014	0.9378698
C5	26469278	26471472	BolC5t32091H	0	-	275	1314	2194	0.5989061
C5	26474139	26474685	BolC5t32092H	0	-	294	546	546	1.0000000
C5	26474965	26476223	BolC5t32093H	0	-	12	393	1258	0.3124006
C5	26478097	26479654	BolC5t32094H	0	-	1968	1557	1557	1.0000000
C5	26480760	26490671	BolC5t32095H	0	+	4099	8739	9911	0.8817475
C5	26504179	26507233	BolC5t32096H	0	-	1349	2956	3054	0.9679109
C5	26523634	26527699	BolC5t32097H	0	-	1232	3383	4065	0.8322263
C5	26534717	26535177	BolC5t32098H	0	+	330	460	460	1.0000000
C5	26548970	26552165	BolC5t32099H	0	-	2398	3195	3195	1.0000000
C5	26555628	26555934	BolC5t32100H	0	+	56	303	306	0.9901960
C5	26558839	26562593	BolC5t32101H	0	+	2094	3650	3754	0.9722962
C5	26560100	26561489	BolC5t32102H	0	-	740	1389	1389	1.0000000
C5	26566350	26566992	BolC5t32103H	0	+	176	588	642	0.9158878
C5	26572698	26572986	BolC5t32104H	0	-	37	248	288	0.8611111
C5	26578220	26578537	BolC5t32105H	0	+	164	317	317	1.0000000
C5	26584883	26585317	BolC5t32106H	0	+	87	434	434	1.0000000
C5	26585957	26586068	BolC5t32107H	0	+	20	111	111	1.0000000
C5	26589320	26590165	BolC5t32108H	0	-	60	681	845	0.8059171
C5	26593070	26594985	BolC5t32109H	0	+	1282	1915	1915	1.0000000
C5	26598863	26599446	BolC5t32110H	0	+	303	583	583	1.0000000
C5	26603684	26603837	BolC5t32111H	0	+	14	38	153	0.2483660
C5	26608071	26608547	BolC5t32112H	0	+	6	171	476	0.3592437
C5	26618632	26619145	BolC5t32113H	0	+	3	176	513	0.3430799
C5	26633291	26634216	BolC5t32114H	0	-	27	377	925	0.4075676
C5	26635694	26636400	BolC5t32115H	0	-	15	411	706	0.5821530
C5	26642488	26642728	BolC5t32116H	0	+	38	240	240	1.0000000
C5	26694992	26696344	BolC5t32117H	0	-	708	1306	1352	0.9659764
C5	26697260	26710918	BolC5t32118H	0	+	1090	3129	13658	0.2290965
C5	26754449	26755223	BolC5t32119H	0	+	857	774	774	1.0000000
C5	26763774	26764146	BolC5t32120H	0	-	172	372	372	1.0000000
C5	26790090	26791812	BolC5t32121H	0	+	385	1663	1722	0.9657375
C5	26796723	26796978	BolC5t32122H	0	+	162	255	255	1.0000000
C5	26801803	26802538	BolC5t32123H	0	+	292	735	735	1.0000000
C5	26812408	26813047	BolC5t32124H	0	+	358	639	639	1.0000000
C5	26821299	26821795	BolC5t32125H	0	+	497	496	496	1.0000000
C5	26825221	26826577	BolC5t32126H	0	-	980	1356	1356	1.0000000
C5	26836970	26837210	BolC5t32127H	0	+	468	240	240	1.0000000
C5	26841326	26841656	BolC5t32128H	0	+	11	330	330	1.0000000
C5	26842826	26844022	BolC5t32129H	0	+	203	985	1196	0.8235786
C5	26861988	26862336	BolC5t32130H	0	-	31	321	348	0.9224138
C5	26865216	26867457	BolC5t32131H	0	+	2420	2241	2241	1.0000000
C5	26869284	26869773	BolC5t32132H	0	-	673	489	489	1.0000000
C5	26877095	26883166	BolC5t32133H	0	-	2003	5651	6071	0.9308186
C5	26895270	26895511	BolC5t32134H	0	-	18	23	241	0.0954357
C5	26895573	26896021	BolC5t32135H	0	-	105	399	448	0.8906250
C5	26900577	26902772	BolC5t32136H	0	-	127	1399	2195	0.6373577
C5	26904720	26908754	BolC5t32137H	0	-	2586	4034	4034	1.0000000
C5	26924508	26925278	BolC5t32138H	0	-	649	770	770	1.0000000
C5	26928290	26932359	BolC5t32139H	0	+	2813	3960	4069	0.9732121
C5	26940712	26941353	BolC5t32140H	0	-	133	641	641	1.0000000
C5	26949587	26950450	BolC5t32141H	0	-	0	0	863	0.0000000
C5	26953740	26954137	BolC5t32142H	0	-	0	0	397	0.0000000
C5	26970002	26971221	BolC5t32143H	0	-	127	967	1219	0.7932732
C5	26981691	26982072	BolC5t32144H	0	-	809	381	381	1.0000000
C5	26994732	26995400	BolC5t32145H	0	-	28	445	668	0.6661677
C5	27018699	27035863	BolC5t32146H	0	+	2216	10634	17164	0.6195526
C5	27038887	27040045	BolC5t32147H	0	-	150	922	1158	0.7962003
C5	27040904	27045631	BolC5t32148H	0	+	1853	4695	4727	0.9932304
C5	27046356	27046680	BolC5t32149H	0	-	88	321	324	0.9907407
C5	27051969	27053854	BolC5t32150H	0	-	1445	1885	1885	1.0000000
C5	27054930	27056513	BolC5t32151H	0	+	1110	1583	1583	1.0000000
C5	27083950	27085710	BolC5t32152H	0	+	1296	1760	1760	1.0000000
C5	27165863	27172067	BolC5t32153H	0	+	452	3477	6204	0.5604449
C5	27172169	27174438	BolC5t32154H	0	+	112	813	2269	0.3583076
C5	27180076	27181695	BolC5t32155H	0	-	1204	1619	1619	1.0000000
C5	27197154	27197957	BolC5t32156H	0	+	601	803	803	1.0000000
C5	27207817	27208331	BolC5t32157H	0	-	480	514	514	1.0000000
C5	27208269	27209941	BolC5t32158H	0	+	574	1318	1672	0.7882775
C5	27257006	27257425	BolC5t32159H	0	+	148	419	419	1.0000000
C5	27265844	27266681	BolC5t32160H	0	-	557	837	837	1.0000000
C5	27295117	27297494	BolC5t32161H	0	+	1741	2377	2377	1.0000000
C5	27335914	27336809	BolC5t32162H	0	+	400	895	895	1.0000000
C5	27350579	27354906	BolC5t32163H	0	-	1065	3782	4327	0.8740467
C5	27358076	27358397	BolC5t32164H	0	-	266	321	321	1.0000000
C5	27385206	27385464	BolC5t32165H	0	+	1	55	258	0.2131783
C5	27410691	27412574	BolC5t32166H	0	-	109	855	1883	0.4540627
C5	27469162	27469915	BolC5t32167H	0	+	22	311	753	0.4130146
C5	27472063	27472423	BolC5t32168H	0	+	0	0	360	0.0000000
C5	27492248	27518410	BolC5t32169H	0	+	828	5463	26162	0.2088143
C5	27529887	27530265	BolC5t32170H	0	-	523	378	378	1.0000000
C5	27537382	27537595	BolC5t32171H	0	+	180	213	213	1.0000000
C5	27548012	27548344	BolC5t32172H	0	+	283	332	332	1.0000000
C5	27555287	27556087	BolC5t32173H	0	-	639	800	800	1.0000000
C5	27574607	27575567	BolC5t32174H	0	+	118	905	960	0.9427083
C5	27577852	27578119	BolC5t32175H	0	-	173	267	267	1.0000000
C5	27586145	27587987	BolC5t32176H	0	+	803	1842	1842	1.0000000
C5	27590123	27596247	BolC5t32177H	0	-	4272	4148	6124	0.6773351
C5	27607775	27609157	BolC5t32178H	0	-	846	1378	1382	0.9971057
C5	27611133	27611787	BolC5t32179H	0	+	612	654	654	1.0000000
C5	27627421	27628378	BolC5t32180H	0	-	405	828	957	0.8652037
C5	27649954	27652896	BolC5t32181H	0	+	673	2824	2942	0.9598913
C5	27653459	27653882	BolC5t32182H	0	+	59	422	423	0.9976360
C5	27654252	27656002	BolC5t32183H	0	-	377	1744	1750	0.9965714
C5	27658853	27659285	BolC5t32184H	0	-	386	432	432	1.0000000
C5	27660089	27661540	BolC5t32185H	0	+	717	1451	1451	1.0000000
C5	27674901	27675072	BolC5t32186H	0	-	285	171	171	1.0000000
C5	27682649	27683182	BolC5t32187H	0	+	980	533	533	1.0000000
C5	27688164	27700291	BolC5t32188H	0	-	5181	8857	12127	0.7303538
C5	27701940	27702282	BolC5t32189H	0	+	220	340	342	0.9941521
C5	27707139	27707824	BolC5t32190H	0	-	23	326	685	0.4759124
C5	27740851	27741661	BolC5t32191H	0	-	231	692	810	0.8543210
C5	27747698	27748292	BolC5t32192H	0	-	0	0	594	0.0000000
C5	27763156	27764232	BolC5t32193H	0	+	0	0	1076	0.0000000
C5	27772354	27773176	BolC5t32194H	0	+	291	747	822	0.9087591
C5	27786397	27791453	BolC5t32195H	0	-	1161	4547	5056	0.8993275
C5	27834393	27836063	BolC5t32196H	0	+	36	692	1670	0.4143713
C5	27838781	27839654	BolC5t32197H	0	-	2	126	873	0.1443299
C5	27844288	27846037	BolC5t32198H	0	-	75	1052	1749	0.6014866
C5	27855027	27855246	BolC5t32199H	0	-	881	219	219	1.0000000
C5	27870442	27871555	BolC5t32200H	0	-	48	653	1113	0.5867026
C5	27875724	27876534	BolC5t32201H	0	-	722	810	810	1.0000000
C5	27877668	27886318	BolC5t32202H	0	+	80	2075	8650	0.2398844
C5	27886364	27889733	BolC5t32203H	0	-	933	3349	3369	0.9940635
C5	27886657	27887401	BolC5t32204H	0	-	53	724	744	0.9731183
C5	27890794	27891545	BolC5t32205H	0	-	65	535	751	0.7123835
C5	27918256	27918577	BolC5t32206H	0	-	8	165	321	0.5140187
C5	27930524	27933600	BolC5t32207H	0	+	327	1839	3076	0.5978544
C5	27934377	27934497	BolC5t32208H	0	-	0	0	120	0.0000000
C5	27938003	27938527	BolC5t32209H	0	+	92	524	524	1.0000000
C5	28028124	28028587	BolC5t32210H	0	+	153	463	463	1.0000000
C5	28031852	28032290	BolC5t32211H	0	+	3	115	438	0.2625571
C5	28032835	28033165	BolC5t32212H	0	+	10	330	330	1.0000000
C5	28033254	28034242	BolC5t32213H	0	+	176	929	988	0.9402834
C5	28037229	28038441	BolC5t32214H	0	+	277	1083	1212	0.8935643
C5	28047820	28059049	BolC5t32215H	0	+	988	4897	11229	0.4361030
C5	28060454	28060896	BolC5t32216H	0	+	304	442	442	1.0000000
C5	28062701	28065286	BolC5t32217H	0	+	231	2150	2585	0.8317215
C5	28070008	28070246	BolC5t32218H	0	-	20	185	238	0.7773109
C5	28073580	28074323	BolC5t32219H	0	-	0	0	743	0.0000000
C5	28075650	28077386	BolC5t32220H	0	+	50	800	1736	0.4608295
C5	28082711	28083146	BolC5t32221H	0	+	27	203	435	0.4666667
C5	28092362	28092722	BolC5t32222H	0	+	328	360	360	1.0000000
C5	28110598	28113185	BolC5t32223H	0	-	1220	2094	2587	0.8094318
C5	28113785	28115820	BolC5t32224H	0	-	762	1764	2035	0.8668305
C5	28118704	28119549	BolC5t32225H	0	+	19	432	845	0.5112426
C5	28147941	28148704	BolC5t32226H	0	-	0	0	763	0.0000000
C5	28160375	28160741	BolC5t32227H	0	+	373	366	366	1.0000000
C5	28161276	28161909	BolC5t32228H	0	+	60	438	633	0.6919431
C5	28162516	28163792	BolC5t32229H	0	-	438	742	1276	0.5815047
C5	28172852	28173050	BolC5t32230H	0	+	197	198	198	1.0000000
C5	28183270	28183620	BolC5t32231H	0	+	38	345	350	0.9857143
C5	28184255	28184769	BolC5t32232H	0	+	49	467	514	0.9085603
C5	28185907	28186270	BolC5t32233H	0	-	101	358	363	0.9862259
C5	28192809	28193876	BolC5t32234H	0	+	240	611	1067	0.5726336
C5	28246316	28246505	BolC5t32235H	0	+	49	189	189	1.0000000
C5	28337494	28338349	BolC5t32236H	0	-	476	855	855	1.0000000
C5	28360724	28362068	BolC5t32237H	0	-	986	1344	1344	1.0000000
C5	28362814	28363087	BolC5t32238H	0	+	263	273	273	1.0000000
C5	28371658	28371880	BolC5t32239H	0	+	292	222	222	1.0000000
C5	28379715	28380008	BolC5t32240H	0	-	5	40	293	0.1365188
C5	28404235	28406620	BolC5t32241H	0	-	548	1929	2385	0.8088050
C5	28414706	28415798	BolC5t32242H	0	+	249	1049	1092	0.9606227
C5	28422963	28426031	BolC5t32243H	0	+	50	1089	3068	0.3549544
C5	28426373	28429139	BolC5t32244H	0	-	897	2766	2766	1.0000000
C5	28437563	28437908	BolC5t32245H	0	+	474	345	345	1.0000000
C5	28443059	28443338	BolC5t32246H	0	+	385	279	279	1.0000000
C5	28447710	28447830	BolC5t32247H	0	-	239	120	120	1.0000000
C5	28451982	28454532	BolC5t32248H	0	+	934	2470	2550	0.9686275
C5	28454699	28457420	BolC5t32249H	0	-	572	2605	2721	0.9573686
C5	28490449	28492227	BolC5t32250H	0	+	23	478	1778	0.2688414
C5	28635349	28635664	BolC5t32251H	0	-	7	120	315	0.3809524
C5	28756640	28759161	BolC5t32252H	0	-	754	2347	2521	0.9309798
C5	28770299	28770515	BolC5t32253H	0	+	52	216	216	1.0000000
C5	28772398	28772602	BolC5t32254H	0	+	10	204	204	1.0000000
C5	28807155	28807422	BolC5t32255H	0	+	175	267	267	1.0000000
C5	28808539	28818077	BolC5t32256H	0	+	1480	6440	9538	0.6751940
C5	28813165	28815576	BolC5t32257H	0	-	62	775	2411	0.3214434
C5	28819245	28824295	BolC5t32258H	0	-	303	2111	5050	0.4180198
C5	28825569	28825891	BolC5t32259H	0	-	309	322	322	1.0000000
C5	28844947	28845623	BolC5t32260H	0	-	34	448	676	0.6627219
C5	28857481	28858585	BolC5t32261H	0	+	0	0	1104	0.0000000
C5	28871323	28871844	BolC5t32262H	0	+	0	0	521	0.0000000
C5	28881082	28881527	BolC5t32263H	0	-	279	445	445	1.0000000
C5	28896005	28896713	BolC5t32264H	0	-	1275	708	708	1.0000000
C5	28907354	28908823	BolC5t32265H	0	+	418	1466	1469	0.9979578
C5	28910020	28910397	BolC5t32266H	0	+	408	377	377	1.0000000
C5	28913807	28914005	BolC5t32267H	0	+	33	198	198	1.0000000
C5	28914065	28914269	BolC5t32268H	0	+	33	188	204	0.9215686
C5	28944043	28949695	BolC5t32269H	0	+	76	1015	5652	0.1795824
C5	28952962	28953286	BolC5t32270H	0	-	0	0	324	0.0000000
C5	28955639	28956380	BolC5t32271H	0	+	241	741	741	1.0000000
C5	28959667	28960084	BolC5t32272H	0	-	842	417	417	1.0000000
C5	28960591	28962484	BolC5t32273H	0	-	1774	1893	1893	1.0000000
C5	28963037	28966428	BolC5t32274H	0	+	1620	1373	3391	0.4048953
C5	28969717	28969885	BolC5t32275H	0	-	0	0	168	0.0000000
C5	28990436	28991522	BolC5t32276H	0	+	9333	1086	1086	1.0000000
C5	29040453	29040687	BolC5t32277H	0	-	0	0	234	0.0000000
C5	29077978	29079045	BolC5t32278H	0	+	901	1067	1067	1.0000000
C5	29098225	29098530	BolC5t32279H	0	+	20	304	305	0.9967213
C5	29107338	29113150	BolC5t32280H	0	+	5890	5358	5812	0.9218857
C5	29131540	29136840	BolC5t32281H	0	+	116	2617	5300	0.4937736
C5	29153875	29154310	BolC5t32282H	0	+	337	435	435	1.0000000
C5	29162970	29167843	BolC5t32283H	0	+	317	1412	4873	0.2897599
C5	29168391	29169138	BolC5t32284H	0	+	260	693	747	0.9277108
C5	29188244	29192710	BolC5t32285H	0	+	1478	3531	4466	0.7906404
C5	29201990	29202776	BolC5t32286H	0	-	84	696	786	0.8854962
C5	29210545	29210883	BolC5t32287H	0	+	75	338	338	1.0000000
C5	29217988	29218916	BolC5t32288H	0	+	382	928	928	1.0000000
C5	29218638	29219374	BolC5t32289H	0	+	167	736	736	1.0000000
C5	29222862	29223699	BolC5t32290H	0	-	65	698	837	0.8339307
C5	29224924	29225221	BolC5t32291H	0	+	210	297	297	1.0000000
C5	29258764	29259073	BolC5t32292H	0	-	513	309	309	1.0000000
C5	29263458	29263644	BolC5t32293H	0	-	426	186	186	1.0000000
C5	29269787	29273099	BolC5t32294H	0	-	193	2430	3312	0.7336956
C5	29273467	29283247	BolC5t32295H	0	+	362	3274	9780	0.3347648
C5	29283594	29284590	BolC5t32296H	0	-	1	102	996	0.1024096
C5	29287336	29287839	BolC5t32297H	0	-	254	503	503	1.0000000
C5	29287623	29287839	BolC5t32298H	0	-	192	216	216	1.0000000
C5	29289505	29289931	BolC5t32299H	0	-	11	282	426	0.6619718
C5	29293314	29293588	BolC5t32300H	0	+	1	11	274	0.0401460
C5	29305023	29305557	BolC5t32301H	0	+	0	0	534	0.0000000
C5	29336137	29338193	BolC5t32302H	0	-	0	0	2056	0.0000000
C5	29382334	29382666	BolC5t32303H	0	-	3	144	332	0.4337350
C5	29385881	29387431	BolC5t32304H	0	-	898	1523	1550	0.9825807
C5	29388721	29389102	BolC5t32305H	0	-	45	381	381	1.0000000
C5	29390129	29390726	BolC5t32306H	0	+	440	597	597	1.0000000
C5	29393426	29393872	BolC5t32307H	0	-	111	446	446	1.0000000
C5	29395003	29395321	BolC5t32308H	0	-	93	299	318	0.9402516
C5	29396700	29399004	BolC5t32309H	0	-	1207	2304	2304	1.0000000
C5	29401504	29401654	BolC5t32310H	0	+	0	0	150	0.0000000
C5	29416034	29416370	BolC5t32311H	0	+	283	336	336	1.0000000
C5	29417640	29420826	BolC5t32312H	0	-	792	3186	3186	1.0000000
C5	29422601	29432525	BolC5t32313H	0	+	529	4216	9924	0.4248287
C5	29432707	29434102	BolC5t32314H	0	-	77	572	1395	0.4100358
C5	29440542	29440751	BolC5t32315H	0	-	109	209	209	1.0000000
C5	29440988	29443149	BolC5t32316H	0	-	1225	2161	2161	1.0000000
C5	29443188	29452829	BolC5t32317H	0	-	9481	9641	9641	1.0000000
C5	29454112	29454349	BolC5t32318H	0	+	156	237	237	1.0000000
C5	29494213	29496710	BolC5t32319H	0	-	42	642	2497	0.2571085
C5	29502204	29503287	BolC5t32320H	0	+	327	1083	1083	1.0000000
C5	29512991	29513296	BolC5t32321H	0	-	282	305	305	1.0000000
C5	29515115	29516262	BolC5t32322H	0	+	6	71	1147	0.0619006
C5	29516683	29517343	BolC5t32323H	0	-	44	512	660	0.7757576
C5	29524484	29526024	BolC5t32324H	0	-	10	468	1540	0.3038961
C5	29556562	29556811	BolC5t32325H	0	-	268	249	249	1.0000000
C5	29570419	29572004	BolC5t32326H	0	-	241	1355	1585	0.8548896
C5	29577278	29578965	BolC5t32327H	0	+	63	635	1687	0.3764078
C5	29584386	29584902	BolC5t32328H	0	+	2	151	516	0.2926356
C5	29585634	29587092	BolC5t32329H	0	-	18	382	1458	0.2620027
C5	29587281	29587610	BolC5t32330H	0	-	0	0	329	0.0000000
C5	29602345	29602684	BolC5t32331H	0	-	225	284	339	0.8377581
C5	29603337	29603771	BolC5t32332H	0	+	347	434	434	1.0000000
C5	29605350	29606052	BolC5t32333H	0	+	246	626	702	0.8917379
C5	29606350	29606821	BolC5t32334H	0	-	104	471	471	1.0000000
C5	29607768	29608278	BolC5t32335H	0	-	69	510	510	1.0000000
C5	29608282	29612529	BolC5t32336H	0	-	2160	3570	4247	0.8405933
C5	29610251	29610662	BolC5t32337H	0	-	513	411	411	1.0000000
C5	29613664	29613837	BolC5t32338H	0	-	39	173	173	1.0000000
C5	29617236	29631089	BolC5t32339H	0	-	1954	8712	13853	0.6288890
C5	29647784	29648348	BolC5t32340H	0	+	146	564	564	1.0000000
C5	29660277	29670399	BolC5t32341H	0	-	34762	10122	10122	1.0000000
C5	29677162	29678663	BolC5t32342H	0	-	284	1045	1501	0.6962025
C5	29690252	29697127	BolC5t32343H	0	-	4074	5844	6875	0.8500364
C5	29697852	29699316	BolC5t32344H	0	+	175	1293	1464	0.8831967
C5	29700649	29703293	BolC5t32345H	0	+	161	1423	2644	0.5381997
C5	29716483	29716870	BolC5t32346H	0	+	3	49	387	0.1266150
C5	29753584	29763150	BolC5t32347H	0	+	3323	9550	9566	0.9983274
C5	29758196	29758501	BolC5t32348H	0	+	228	305	305	1.0000000
C5	29768251	29769748	BolC5t32349H	0	-	121	1045	1497	0.6980628
C5	29775492	29776169	BolC5t32350H	0	-	4	20	677	0.0295421
C5	29788186	29789731	BolC5t32351H	0	+	14	230	1545	0.1488673
C5	29857981	29859330	BolC5t32352H	0	+	73	997	1349	0.7390659
C5	29865001	29866517	BolC5t32353H	0	+	98	761	1516	0.5019789
C5	29883120	29884227	BolC5t32354H	0	+	70	832	1107	0.7515808
C5	29897931	29899587	BolC5t32355H	0	-	89	598	1656	0.3611111
C5	29927785	29928049	BolC5t32356H	0	-	182	264	264	1.0000000
C5	29961855	29962263	BolC5t32357H	0	+	20	238	408	0.5833333
C5	29975495	29975765	BolC5t32358H	0	-	183	270	270	1.0000000
C5	29977303	29980235	BolC5t32359H	0	+	184	1109	2932	0.3782401
C5	29980481	29981857	BolC5t32360H	0	-	3	128	1376	0.0930233
C5	29988355	29989628	BolC5t32361H	0	-	496	1155	1273	0.9073056
C5	29990551	29997357	BolC5t32362H	0	-	22	384	6806	0.0564208
C5	30031520	30032710	BolC5t32363H	0	+	119	432	1190	0.3630252
C5	30037258	30037527	BolC5t32364H	0	+	0	0	269	0.0000000
C5	30051395	30051755	BolC5t32365H	0	+	15	141	360	0.3916667
C5	30052290	30054489	BolC5t32366H	0	+	231	1533	2199	0.6971351
C5	30061175	30061824	BolC5t32367H	0	+	2562	649	649	1.0000000
C5	30062540	30062894	BolC5t32368H	0	+	5413	354	354	1.0000000
C5	30115919	30116165	BolC5t32369H	0	+	301	246	246	1.0000000
C5	30130046	30132356	BolC5t32370H	0	+	856	2255	2310	0.9761904
C5	30141298	30142852	BolC5t32371H	0	+	778	1397	1554	0.8989704
C5	30261117	30261973	BolC5t32372H	0	-	0	0	856	0.0000000
C5	30263698	30265354	BolC5t32373H	0	-	992	1614	1656	0.9746377
C5	30267404	30269326	BolC5t32374H	0	-	12	90	1922	0.0468262
C5	30280548	30282113	BolC5t32375H	0	-	32	628	1565	0.4012780
C5	30284392	30284686	BolC5t32376H	0	+	0	0	294	0.0000000
C5	30305893	30307312	BolC5t32377H	0	+	11	362	1419	0.2551092
C5	30307803	30311114	BolC5t32378H	0	-	260	2160	3311	0.6523709
C5	30315564	30318162	BolC5t32379H	0	+	318	1772	2598	0.6820631
C5	30326121	30334682	BolC5t32380H	0	+	741	3238	8561	0.3782268
C5	30341115	30341622	BolC5t32381H	0	-	385	507	507	1.0000000
C5	30348067	30348991	BolC5t32382H	0	-	0	0	924	0.0000000
C5	30363089	30363290	BolC5t32383H	0	+	101	201	201	1.0000000
C5	30365384	30367526	BolC5t32384H	0	+	501	1189	2142	0.5550887
C5	30382003	30383041	BolC5t32385H	0	+	28	114	1038	0.1098266
C5	30386668	30387430	BolC5t32386H	0	+	19	542	762	0.7112861
C5	30410267	30411639	BolC5t32387H	0	+	133	572	1372	0.4169096
C5	30450202	30450445	BolC5t32388H	0	+	9	243	243	1.0000000
C5	30486407	30487251	BolC5t32389H	0	-	43	488	844	0.5781990
C5	30493810	30495026	BolC5t32390H	0	-	127	601	1216	0.4942434
C5	30498881	30500845	BolC5t32391H	0	+	121	1367	1964	0.6960285
C5	30501221	30502923	BolC5t32392H	0	-	47	614	1702	0.3607520
C5	30558812	30559052	BolC5t32393H	0	-	107	240	240	1.0000000
C5	30561674	30561977	BolC5t32394H	0	+	0	0	303	0.0000000
C5	30772075	30772276	BolC5t32395H	0	+	17	201	201	1.0000000
C5	30772872	30774997	BolC5t32396H	0	-	1091	2052	2125	0.9656470
C5	30865462	30868420	BolC5t32397H	0	+	138	1386	2958	0.4685598
C5	30870013	30872422	BolC5t32398H	0	-	538	2231	2409	0.9261104
C5	31014873	31015205	BolC5t32399H	0	+	0	0	332	0.0000000
C5	31015505	31016470	BolC5t32400H	0	+	44	19	965	0.0196891
C5	31016681	31017646	BolC5t32401H	0	+	5	162	965	0.1678756
C5	31020709	31021299	BolC5t32402H	0	-	3	67	590	0.1135593
C5	31021930	31028533	BolC5t32403H	0	-	1118	3339	6603	0.5056792
C5	31033771	31034296	BolC5t32404H	0	-	80	487	525	0.9276190
C5	31079480	31079696	BolC5t32405H	0	-	200	216	216	1.0000000
C5	31101180	31101971	BolC5t32406H	0	+	15	165	791	0.2085967
C5	31104232	31104840	BolC5t32407H	0	-	200	608	608	1.0000000
C5	31112343	31113309	BolC5t32408H	0	+	5	230	966	0.2380952
C5	31125122	31125893	BolC5t32409H	0	+	532	771	771	1.0000000
C5	31185569	31185791	BolC5t32410H	0	+	17	148	222	0.6666667
C5	31276687	31276891	BolC5t32411H	0	-	78	204	204	1.0000000
C5	31279155	31279383	BolC5t32412H	0	+	264	228	228	1.0000000
C5	31279579	31279780	BolC5t32413H	0	+	197	201	201	1.0000000
C5	31285708	31286550	BolC5t32414H	0	-	236	828	842	0.9833729
C5	31294478	31294865	BolC5t32415H	0	+	296	387	387	1.0000000
C5	31315211	31315358	BolC5t32416H	0	+	0	0	147	0.0000000
C5	31315792	31338849	BolC5t32417H	0	+	1621	14317	23057	0.6209394
C5	31385471	31386020	BolC5t32418H	0	-	2	20	549	0.0364299
C5	31395027	31396572	BolC5t32419H	0	-	194	1005	1545	0.6504855
C5	31425679	31429491	BolC5t32420H	0	+	2061	3807	3812	0.9986883
C5	31430816	31431519	BolC5t32421H	0	+	372	703	703	1.0000000
C5	31446579	31446936	BolC5t32422H	0	-	307	357	357	1.0000000
C5	31463020	31464118	BolC5t32423H	0	+	791	1098	1098	1.0000000
C5	31489626	31503675	BolC5t32424H	0	-	6499	9641	14049	0.6862410
C5	31505735	31506257	BolC5t32425H	0	-	31	410	522	0.7854406
C5	31516430	31516745	BolC5t32426H	0	+	2	100	315	0.3174603
C5	31538985	31540469	BolC5t32427H	0	+	454	873	1484	0.5882750
C5	31558049	31558527	BolC5t32428H	0	+	1	34	478	0.0711297
C5	31572911	31575038	BolC5t32429H	0	-	6	317	2127	0.1490362
C5	31588302	31588601	BolC5t32430H	0	-	17	45	299	0.1505017
C5	31620866	31625683	BolC5t32431H	0	-	791	3320	4817	0.6892257
C5	31629466	31631918	BolC5t32432H	0	-	67	579	2452	0.2361338
C5	31654785	31658573	BolC5t32433H	0	-	32	554	3788	0.1462513
C5	31662284	31662761	BolC5t32434H	0	-	0	0	477	0.0000000
C5	31742824	31743286	BolC5t32435H	0	+	498	462	462	1.0000000
C5	31743493	31743934	BolC5t32436H	0	-	346	441	441	1.0000000
C5	31754398	31754773	BolC5t32437H	0	-	258	375	375	1.0000000
C5	31771593	31772370	BolC5t32438H	0	+	0	0	777	0.0000000
C5	31823124	31824890	BolC5t32439H	0	-	52	928	1766	0.5254813
C5	31845849	31846354	BolC5t32440H	0	+	450	505	505	1.0000000
C5	31848949	31852131	BolC5t32441H	0	-	135	1184	3182	0.3720930
C5	31859127	31860338	BolC5t32442H	0	+	2	23	1211	0.0189926
C5	31915028	31915274	BolC5t32443H	0	+	301	240	246	0.9756098
C5	31917597	31917789	BolC5t32444H	0	+	0	0	192	0.0000000
C5	31918286	31919702	BolC5t32445H	0	+	2370	1232	1416	0.8700565
C5	31921749	31922046	BolC5t32446H	0	+	325	297	297	1.0000000
C5	31925228	31925993	BolC5t32447H	0	+	1201	640	765	0.8366013
C5	31926925	31927288	BolC5t32448H	0	-	25	223	363	0.6143250
C5	31958256	31959671	BolC5t32449H	0	-	171	1279	1415	0.9038869
C5	31961848	31963262	BolC5t32450H	0	-	112	954	1414	0.6746818
C5	31996672	31997068	BolC5t32451H	0	+	39	271	396	0.6843435
C5	32036445	32038641	BolC5t32452H	0	-	263	1808	2196	0.8233151
C5	32039752	32041574	BolC5t32453H	0	-	674	1822	1822	1.0000000
C5	32041589	32041908	BolC5t32454H	0	-	80	319	319	1.0000000
C5	32042214	32043344	BolC5t32455H	0	+	678	1130	1130	1.0000000
C5	32054413	32056071	BolC5t32456H	0	-	67	489	1658	0.2949336
C5	32056721	32056922	BolC5t32457H	0	-	25	177	201	0.8805970
C5	32065364	32065725	BolC5t32458H	0	-	0	0	361	0.0000000
C5	32068551	32069447	BolC5t32459H	0	-	225	809	896	0.9029018
C5	32121594	32124100	BolC5t32460H	0	-	776	2506	2506	1.0000000
C5	32193326	32193521	BolC5t32461H	0	-	96	195	195	1.0000000
C5	32195822	32198222	BolC5t32462H	0	+	79	599	2400	0.2495833
C5	32219575	32220017	BolC5t32463H	0	+	7	67	442	0.1515837
C5	32220050	32221595	BolC5t32464H	0	+	9	385	1545	0.2491909
C5	32224493	32224863	BolC5t32465H	0	+	15	218	370	0.5891892
C5	32226526	32233070	BolC5t32466H	0	+	1003	3429	6544	0.5239915
C5	32238304	32238685	BolC5t32467H	0	-	1	70	381	0.1837270
C5	32272941	32279788	BolC5t32468H	0	+	201	3141	6847	0.4587411
C5	32286681	32291413	BolC5t32469H	0	+	107	684	4732	0.1445478
C5	32303286	32304517	BolC5t32470H	0	-	32	408	1231	0.3314379
C5	32304989	32307620	BolC5t32471H	0	+	113	1181	2631	0.4488788
C5	32309228	32310768	BolC5t32472H	0	-	73	866	1540	0.5623376
C5	32373620	32373869	BolC5t32473H	0	-	167	249	249	1.0000000
C5	32378409	32378880	BolC5t32474H	0	+	12	281	471	0.5966030
C5	32391697	32393715	BolC5t32475H	0	-	795	1972	2018	0.9772052
C5	32417459	32418368	BolC5t32476H	0	-	272	846	909	0.9306931
C5	32459952	32461379	BolC5t32477H	0	+	133	1226	1427	0.8591450
C5	32464077	32466115	BolC5t32478H	0	-	117	774	2038	0.3797841
C5	32476922	32478486	BolC5t32479H	0	-	1153	1564	1564	1.0000000
C5	32482063	32482345	BolC5t32480H	0	+	0	0	282	0.0000000
C5	32500339	32500770	BolC5t32481H	0	-	6	34	431	0.0788863
C5	32526141	32526282	BolC5t32482H	0	-	0	0	141	0.0000000
C5	32540963	32542090	BolC5t32483H	0	+	458	1127	1127	1.0000000
C5	32543215	32544545	BolC5t32484H	0	-	118	967	1330	0.7270676
C5	32548389	32548581	BolC5t32485H	0	+	90	192	192	1.0000000
C5	32549474	32549897	BolC5t32486H	0	+	282	423	423	1.0000000
C5	32550371	32551344	BolC5t32487H	0	-	214	973	973	1.0000000
C5	32553170	32553874	BolC5t32488H	0	+	286	704	704	1.0000000
C5	32557315	32558214	BolC5t32489H	0	+	0	0	899	0.0000000
C5	32559663	32560442	BolC5t32490H	0	-	133	758	779	0.9730424
C5	32594461	32595204	BolC5t32491H	0	+	47	501	743	0.6742934
C5	32595549	32597035	BolC5t32492H	0	+	1056	1486	1486	1.0000000
C5	32652357	32654534	BolC5t32493H	0	-	482	1472	2177	0.6761599
C5	32667796	32668705	BolC5t32494H	0	+	21	540	909	0.5940594
C5	32670404	32683740	BolC5t32495H	0	+	760	4063	13336	0.3046641
C5	32691153	32692383	BolC5t32496H	0	-	983	1230	1230	1.0000000
C5	32704839	32706749	BolC5t32497H	0	+	124	1629	1910	0.8528796
C5	32716308	32735174	BolC5t32498H	0	-	3296	12116	18866	0.6422135
C5	32770686	32772319	BolC5t32499H	0	+	827	1633	1633	1.0000000
C5	32774928	32775390	BolC5t32500H	0	-	194	462	462	1.0000000
C5	32784363	32785006	BolC5t32501H	0	+	425	643	643	1.0000000
C5	32795979	32798049	BolC5t32502H	0	-	1583	2070	2070	1.0000000
C5	32799274	32799580	BolC5t32503H	0	+	319	306	306	1.0000000
C5	32811640	32811937	BolC5t32504H	0	+	6	127	297	0.4276094
C5	32813456	32815823	BolC5t32505H	0	-	1643	2364	2367	0.9987326
C5	32822799	32823009	BolC5t32506H	0	-	116	210	210	1.0000000
C5	32832433	32832700	BolC5t32507H	0	-	259	267	267	1.0000000
C5	32837843	32837990	BolC5t32508H	0	+	77	147	147	1.0000000
C5	32843286	32845683	BolC5t32509H	0	-	972	2260	2397	0.9428452
C5	32862746	32863008	BolC5t32510H	0	-	0	0	262	0.0000000
C5	32867898	32869039	BolC5t32511H	0	+	430	1141	1141	1.0000000
C5	32908615	32911997	BolC5t32512H	0	+	561	2642	3382	0.7811946
C5	32914433	32936198	BolC5t32513H	0	+	21609	18755	21765	0.8617046
C5	32930600	32931050	BolC5t32514H	0	+	4	135	450	0.3000000
C5	32936604	32938099	BolC5t32515H	0	-	120	1057	1495	0.7070234
C5	32938871	32939486	BolC5t32516H	0	-	112	615	615	1.0000000
C5	32940342	32940621	BolC5t32517H	0	-	121	279	279	1.0000000
C5	32944354	32945331	BolC5t32518H	0	+	64	704	977	0.7205732
C5	32947058	32949270	BolC5t32519H	0	-	87	1209	2212	0.5465642
C5	32964202	32965885	BolC5t32520H	0	+	116	969	1683	0.5757576
C5	32966551	32968103	BolC5t32521H	0	-	56	441	1552	0.2841495
C5	32975024	32975986	BolC5t32522H	0	-	24	294	962	0.3056133
C5	32979698	32991638	BolC5t32523H	0	+	1938	7890	11940	0.6608040
C5	32991888	32994241	BolC5t32524H	0	-	31	655	2353	0.2783680
C5	33001142	33001439	BolC5t32525H	0	-	145	297	297	1.0000000
C5	33013080	33016280	BolC5t32526H	0	+	836	2423	3200	0.7571875
C5	33018972	33019524	BolC5t32527H	0	-	21	113	552	0.2047101
C5	33028932	33030369	BolC5t32528H	0	-	7	430	1437	0.2992345
C5	33034963	33038374	BolC5t32529H	0	-	1315	3411	3411	1.0000000
C5	33040093	33041425	BolC5t32530H	0	+	78	904	1332	0.6786787
C5	33042510	33044431	BolC5t32531H	0	-	687	1338	1921	0.6965122
C5	33051876	33052041	BolC5t32532H	0	+	235	165	165	1.0000000
C5	33053572	33055036	BolC5t32533H	0	-	26	493	1464	0.3367486
C5	33074800	33076387	BolC5t32534H	0	+	7	111	1587	0.0699433
C5	33078698	33078935	BolC5t32535H	0	-	70	221	237	0.9324895
C5	33087356	33095555	BolC5t32536H	0	+	193	2266	8199	0.2763752
C5	33099432	33103974	BolC5t32537H	0	+	837	3569	4542	0.7857772
C5	33105745	33106756	BolC5t32538H	0	-	628	984	1011	0.9732938
C5	33112871	33113135	BolC5t32539H	0	-	12	156	264	0.5909091
C5	33128890	33131309	BolC5t32540H	0	+	72	1309	2419	0.5411327
C5	33146584	33146791	BolC5t32541H	0	+	17	198	207	0.9565217
C5	33153503	33153701	BolC5t32542H	0	+	14	112	198	0.5656565
C5	33154020	33154257	BolC5t32543H	0	-	0	0	237	0.0000000
C5	33165431	33166403	BolC5t32544H	0	+	46	265	972	0.2726337
C5	33174634	33175996	BolC5t32545H	0	+	17	448	1362	0.3289281
C5	33185971	33186178	BolC5t32546H	0	+	6	58	207	0.2801932
C5	33186239	33189374	BolC5t32547H	0	+	305	1691	3135	0.5393940
C5	33202052	33205541	BolC5t32548H	0	-	792	2903	3489	0.8320436
C5	33208643	33210518	BolC5t32549H	0	-	1015	1875	1875	1.0000000
C5	33285858	33286368	BolC5t32550H	0	+	279	510	510	1.0000000
C5	33305969	33306366	BolC5t32551H	0	-	197	397	397	1.0000000
C5	33310776	33318912	BolC5t32552H	0	+	2452	6020	8136	0.7399213
C5	33341883	33343820	BolC5t32553H	0	+	400	1640	1937	0.8466701
C5	33344009	33347393	BolC5t32554H	0	+	1501	3384	3384	1.0000000
C5	33379396	33379885	BolC5t32555H	0	+	299	489	489	1.0000000
C5	33383694	33384066	BolC5t32556H	0	-	375	370	372	0.9946237
C5	33390493	33390825	BolC5t32557H	0	-	258	332	332	1.0000000
C5	33402318	33402951	BolC5t32558H	0	+	382	633	633	1.0000000
C5	33403380	33417556	BolC5t32559H	0	-	5181	13123	14176	0.9257195
C5	33407680	33408949	BolC5t32560H	0	+	614	1269	1269	1.0000000
C5	33425250	33426730	BolC5t32561H	0	-	476	1364	1480	0.9216216
C5	33435743	33436319	BolC5t32562H	0	+	10	197	576	0.3420139
C5	33446400	33446721	BolC5t32563H	0	+	195	321	321	1.0000000
C5	33518077	33518741	BolC5t32564H	0	+	595	664	664	1.0000000
C5	33534920	33535826	BolC5t32565H	0	-	596	906	906	1.0000000
C5	33535859	33536138	BolC5t32566H	0	-	148	279	279	1.0000000
C5	33556300	33556657	BolC5t32567H	0	-	348	357	357	1.0000000
C5	33585983	33586108	BolC5t32568H	0	+	168	125	125	1.0000000
C5	33596572	33598405	BolC5t32569H	0	+	77	1077	1833	0.5875614
C5	33599591	33600047	BolC5t32570H	0	-	242	456	456	1.0000000
C5	33602376	33602724	BolC5t32571H	0	+	1707	348	348	1.0000000
C5	33602714	33603407	BolC5t32572H	0	+	2552	693	693	1.0000000
C5	33607040	33607691	BolC5t32573H	0	-	1108	651	651	1.0000000
C5	33610553	33611300	BolC5t32574H	0	+	365	747	747	1.0000000
C5	33611732	33613541	BolC5t32575H	0	+	189	1601	1809	0.8850194
C5	33614585	33615522	BolC5t32576H	0	-	232	880	937	0.9391676
C5	33684192	33684535	BolC5t32577H	0	+	193	343	343	1.0000000
C5	33733273	33734793	BolC5t32578H	0	-	203	1254	1520	0.8250000
C5	33775347	33775697	BolC5t32579H	0	+	126	347	350	0.9914286
C5	33775812	33776501	BolC5t32580H	0	+	473	689	689	1.0000000
C5	33777093	33791127	BolC5t32581H	0	-	2187	10720	14034	0.7638592
C5	33792738	33794505	BolC5t32582H	0	+	215	1441	1767	0.8155065
C5	33795157	33801913	BolC5t32583H	0	+	1165	4634	6756	0.6859088
C5	33804795	33805549	BolC5t32584H	0	+	35	572	754	0.7586207
C5	33805802	33806093	BolC5t32585H	0	-	19	210	291	0.7216495
C5	33808066	33809378	BolC5t32586H	0	-	2	79	1312	0.0602134
C5	33860046	33861053	BolC5t32587H	0	+	69	764	1007	0.7586892
C5	33880412	33880814	BolC5t32588H	0	+	290	402	402	1.0000000
C5	33917859	33918648	BolC5t32589H	0	-	769	765	789	0.9695817
C5	33919302	33923488	BolC5t32590H	0	+	262	2593	4186	0.6194458
C5	33923730	33926334	BolC5t32591H	0	-	1027	2515	2604	0.9658218
C5	33964210	33964504	BolC5t32592H	0	+	302	294	294	1.0000000
C5	33966303	33967014	BolC5t32593H	0	+	489	711	711	1.0000000
C5	33970275	33970572	BolC5t32594H	0	+	233	297	297	1.0000000
C5	33988481	33988901	BolC5t32595H	0	-	604	420	420	1.0000000
C5	34010540	34012460	BolC5t32596H	0	+	841	1739	1920	0.9057292
C5	34014078	34020021	BolC5t32597H	0	-	2812	5943	5943	1.0000000
C5	34025823	34027666	BolC5t32598H	0	-	952	1843	1843	1.0000000
C5	34028124	34038233	BolC5t32599H	0	-	2725	9588	10109	0.9484618
C5	34029935	34030283	BolC5t32600H	0	-	141	348	348	1.0000000
C5	34042501	34043601	BolC5t32601H	0	-	241	920	1100	0.8363636
C5	34044455	34045333	BolC5t32602H	0	+	59	388	878	0.4419134
C5	34049891	34050173	BolC5t32603H	0	-	0	0	282	0.0000000
C5	34050577	34051993	BolC5t32604H	0	-	0	0	1416	0.0000000
C5	34053300	34053489	BolC5t32605H	0	+	0	0	189	0.0000000
C5	34056535	34056823	BolC5t32606H	0	-	212	288	288	1.0000000
C5	34062166	34062331	BolC5t32607H	0	+	406	165	165	1.0000000
C5	34069985	34071042	BolC5t32608H	0	+	793	1057	1057	1.0000000
C5	34071742	34072006	BolC5t32609H	0	-	355	264	264	1.0000000
C5	34073940	34074240	BolC5t32610H	0	-	549	300	300	1.0000000
C5	34076261	34077007	BolC5t32611H	0	+	561	746	746	1.0000000
C5	34085308	34086508	BolC5t32612H	0	-	782	1200	1200	1.0000000
C5	34087280	34087673	BolC5t32613H	0	+	340	393	393	1.0000000
C5	34090130	34091155	BolC5t32614H	0	+	731	1025	1025	1.0000000
C5	34098020	34100117	BolC5t32615H	0	-	1116	2097	2097	1.0000000
C5	34106511	34107949	BolC5t32616H	0	-	451	1438	1438	1.0000000
C5	34109116	34111503	BolC5t32617H	0	+	1380	2387	2387	1.0000000
C5	34111563	34111689	BolC5t32618H	0	+	119	126	126	1.0000000
C5	34130967	34132987	BolC5t32619H	0	-	10	626	2020	0.3099010
C5	34137676	34147664	BolC5t32620H	0	-	433	3431	9988	0.3435122
C5	34149840	34151574	BolC5t32621H	0	+	556	1717	1734	0.9901960
C5	34175171	34175382	BolC5t32622H	0	+	3	54	211	0.2559242
C5	34181753	34182983	BolC5t32623H	0	+	543	1167	1230	0.9487805
C5	34184751	34185298	BolC5t32624H	0	-	450	547	547	1.0000000
C5	34197404	34201357	BolC5t32625H	0	-	1677	3921	3953	0.9919049
C5	34207649	34207997	BolC5t32626H	0	+	56	257	348	0.7385057
C5	34212206	34212620	BolC5t32627H	0	-	156	414	414	1.0000000
C5	34218846	34219614	BolC5t32628H	0	+	770	768	768	1.0000000
C5	34247053	34247702	BolC5t32629H	0	-	229	638	649	0.9830508
C5	34250767	34251078	BolC5t32630H	0	-	43	311	311	1.0000000
C5	34254516	34254828	BolC5t32631H	0	-	500	312	312	1.0000000
C5	34269339	34269840	BolC5t32632H	0	-	30	152	501	0.3033932
C5	34282389	34283704	BolC5t32633H	0	-	87	599	1315	0.4555133
C5	34283560	34289551	BolC5t32634H	0	-	1035	4902	5991	0.8182274
C5	34284045	34284312	BolC5t32635H	0	-	0	0	267	0.0000000
C5	34292472	34292682	BolC5t32636H	0	-	0	0	210	0.0000000
C5	34297010	34297426	BolC5t32637H	0	+	205	416	416	1.0000000
C5	34326700	34329022	BolC5t32638H	0	-	1236	2322	2322	1.0000000
C5	34332384	34333714	BolC5t32639H	0	-	21	476	1330	0.3578947
C5	34355983	34356229	BolC5t32640H	0	-	377	246	246	1.0000000
C5	34359541	34365252	BolC5t32641H	0	+	2514	5497	5711	0.9625285
C5	34422094	34427074	BolC5t32642H	0	+	1706	4258	4980	0.8550201
C5	34429107	34429780	BolC5t32643H	0	+	576	673	673	1.0000000
C5	34489350	34489770	BolC5t32644H	0	+	163	420	420	1.0000000
C5	34511571	34511769	BolC5t32645H	0	+	294	198	198	1.0000000
C5	34540277	34540418	BolC5t32646H	0	+	64	141	141	1.0000000
C5	34549111	34551550	BolC5t32647H	0	-	1686	2439	2439	1.0000000
C5	34559234	34559569	BolC5t32648H	0	+	366	335	335	1.0000000
C5	34586773	34589130	BolC5t32649H	0	+	446	1481	2357	0.6283411
C5	34595899	34599026	BolC5t32650H	0	+	278	2398	3127	0.7668692
C5	34637550	34637986	BolC5t32651H	0	+	253	436	436	1.0000000
C5	34657807	34658398	BolC5t32652H	0	-	24	201	591	0.3401015
C5	34660433	34662151	BolC5t32653H	0	+	163	1175	1718	0.6839348
C5	34668357	34668606	BolC5t32654H	0	+	16	60	249	0.2409639
C5	34698312	34698957	BolC5t32655H	0	-	107	585	645	0.9069768
C5	34709838	34711683	BolC5t32656H	0	+	918	1845	1845	1.0000000
C5	34717165	34717798	BolC5t32657H	0	-	598	633	633	1.0000000
C5	34718411	34719608	BolC5t32658H	0	+	183	1109	1197	0.9264829
C5	34733517	34734974	BolC5t32659H	0	+	828	1457	1457	1.0000000
C5	34735326	34736520	BolC5t32660H	0	+	294	1178	1194	0.9865997
C5	34738531	34740634	BolC5t32661H	0	-	1211	2103	2103	1.0000000
C5	34742211	34744988	BolC5t32662H	0	-	466	2427	2777	0.8739647
C5	34751545	34751746	BolC5t32663H	0	+	59	192	201	0.9552239
C5	34774330	34775748	BolC5t32664H	0	-	202	1016	1418	0.7165021
C5	34776053	34777588	BolC5t32665H	0	+	930	1535	1535	1.0000000
C5	34794850	34796055	BolC5t32666H	0	+	387	1163	1205	0.9651452
C5	34818513	34819369	BolC5t32667H	0	-	207	838	856	0.9789720
C5	34866329	34867801	BolC5t32668H	0	+	684	1442	1472	0.9796196
C5	34873676	34873964	BolC5t32669H	0	+	358	288	288	1.0000000
C5	34893709	34898070	BolC5t32670H	0	+	2417	4361	4361	1.0000000
C5	34964057	34968184	BolC5t32671H	0	+	1270	3964	4127	0.9605040
C5	34968989	34973017	BolC5t32672H	0	+	1960	3982	4028	0.9885799
C5	34973424	34975097	BolC5t32673H	0	-	201	1126	1673	0.6730424
C5	34980351	34981782	BolC5t32674H	0	-	1171	1431	1431	1.0000000
C5	35009161	35009500	BolC5t32675H	0	-	336	339	339	1.0000000
C5	35034167	35034775	BolC5t32676H	0	-	439	608	608	1.0000000
C5	35066602	35067568	BolC5t32677H	0	-	813	966	966	1.0000000
C5	35070324	35071126	BolC5t32678H	0	+	264	802	802	1.0000000
C5	35071892	35072144	BolC5t32679H	0	-	206	252	252	1.0000000
C5	35073273	35076433	BolC5t32680H	0	-	943	3007	3160	0.9515823
C5	35079834	35081658	BolC5t32681H	0	+	389	1643	1824	0.9007676
C5	35083324	35083941	BolC5t32682H	0	-	1	5	617	0.0081037
C5	35094194	35094833	BolC5t32683H	0	-	22	156	639	0.2441315
C5	35095402	35112749	BolC5t32684H	0	-	3047	10092	17347	0.5817721
C5	35097923	35098640	BolC5t32685H	0	+	2	131	717	0.1827057
C5	35131499	35133192	BolC5t32686H	0	+	39	37	1693	0.0218547
C5	35135121	35135584	BolC5t32687H	0	+	0	0	463	0.0000000
C5	35174181	35198588	BolC5t32688H	0	-	7724	20006	24407	0.8196829
C5	35189857	35190139	BolC5t32689H	0	+	114	276	282	0.9787234
C5	35191086	35192123	BolC5t32690H	0	-	125	964	1037	0.9296046
C5	35219354	35219878	BolC5t32691H	0	-	1	128	524	0.2442748
C5	35223297	35225276	BolC5t32692H	0	-	544	1899	1979	0.9595755
C5	35230973	35231096	BolC5t32693H	0	+	0	0	123	0.0000000
C5	35242060	35244428	BolC5t32694H	0	-	515	1635	2368	0.6904561
C5	35245048	35246948	BolC5t32695H	0	+	736	1851	1900	0.9742105
C5	35273282	35273496	BolC5t32696H	0	-	144	214	214	1.0000000
C5	35283276	35284352	BolC5t32697H	0	+	139	944	1076	0.8773234
C5	35286094	35286321	BolC5t32698H	0	-	60	227	227	1.0000000
C5	35294912	35295988	BolC5t32699H	0	+	147	1008	1076	0.9368030
C5	35297028	35298042	BolC5t32700H	0	+	117	1014	1014	1.0000000
C5	35301855	35302670	BolC5t32701H	0	-	2	22	815	0.0269939
C5	35304032	35306833	BolC5t32702H	0	-	717	2407	2801	0.8593360
C5	35329175	35332296	BolC5t32703H	0	+	2186	3121	3121	1.0000000
C5	35340015	35340510	BolC5t32704H	0	+	33	329	495	0.6646464
C5	35341009	35341759	BolC5t32705H	0	+	20	427	750	0.5693333
C5	35397783	35397957	BolC5t32706H	0	+	0	0	174	0.0000000
C5	35408114	35408581	BolC5t32707H	0	+	5	174	467	0.3725910
C5	35409108	35409531	BolC5t32708H	0	+	1	56	423	0.1323877
C5	35457394	35457797	BolC5t32709H	0	-	336	403	403	1.0000000
C5	35460220	35462638	BolC5t32710H	0	-	858	1998	2418	0.8263027
C5	35465489	35467856	BolC5t32711H	0	+	138	1259	2367	0.5318969
C5	35470787	35471847	BolC5t32712H	0	+	1061	1060	1060	1.0000000
C5	35477354	35479796	BolC5t32713H	0	+	1558	2442	2442	1.0000000
C5	35502636	35503212	BolC5t32714H	0	-	215	576	576	1.0000000
C5	35513716	35514614	BolC5t32715H	0	-	516	898	898	1.0000000
C5	35516702	35516954	BolC5t32716H	0	+	429	252	252	1.0000000
C5	35519545	35521315	BolC5t32717H	0	-	794	1718	1770	0.9706215
C5	35527992	35528274	BolC5t32718H	0	+	363	282	282	1.0000000
C5	35528997	35530025	BolC5t32719H	0	+	652	1028	1028	1.0000000
C5	35539204	35540338	BolC5t32720H	0	+	157	808	1134	0.7125220
C5	35540815	35541265	BolC5t32721H	0	-	65	332	450	0.7377778
C5	35542336	35544069	BolC5t32722H	0	-	100	867	1733	0.5002885
C5	35554381	35554600	BolC5t32723H	0	-	216	219	219	1.0000000
C5	35555004	35555238	BolC5t32724H	0	-	247	234	234	1.0000000
C5	35556288	35556801	BolC5t32725H	0	-	275	513	513	1.0000000
C5	35562002	35563407	BolC5t32726H	0	+	21	458	1405	0.3259786
C5	35565009	35566741	BolC5t32727H	0	+	1568	1732	1732	1.0000000
C5	35567119	35570583	BolC5t32728H	0	-	1420	3218	3464	0.9289838
C5	35574213	35574378	BolC5t32729H	0	+	310	165	165	1.0000000
C5	35600030	35602001	BolC5t32730H	0	-	219	1488	1971	0.7549467
C5	35624838	35626809	BolC5t32731H	0	+	970	1962	1971	0.9954338
C5	35629387	35630117	BolC5t32732H	0	-	55	586	730	0.8027397
C5	35632394	35632670	BolC5t32733H	0	-	27	192	276	0.6956522
C5	35645791	35646672	BolC5t32734H	0	+	66	578	881	0.6560726
C5	35648036	35649031	BolC5t32735H	0	-	169	633	995	0.6361809
C5	35650389	35651043	BolC5t32736H	0	-	783	654	654	1.0000000
C5	35655953	35657274	BolC5t32737H	0	+	1046	1321	1321	1.0000000
C5	35686420	35687204	BolC5t32738H	0	+	535	784	784	1.0000000
C5	35687632	35688539	BolC5t32739H	0	-	541	907	907	1.0000000
C5	35691194	35693747	BolC5t32740H	0	+	305	1860	2553	0.7285547
C5	35694053	35695331	BolC5t32741H	0	-	132	1048	1278	0.8200313
C5	35713878	35714409	BolC5t32742H	0	+	27	490	531	0.9227872
C5	35715439	35715757	BolC5t32743H	0	+	99	318	318	1.0000000
C5	35716037	35716484	BolC5t32744H	0	+	79	447	447	1.0000000
C5	35722023	35723007	BolC5t32745H	0	+	1326	984	984	1.0000000
C5	35727954	35729944	BolC5t32746H	0	-	923	1969	1990	0.9894472
C5	35730707	35733746	BolC5t32747H	0	+	274	1835	3039	0.6038170
C5	35735524	35738123	BolC5t32748H	0	-	1807	2599	2599	1.0000000
C5	35748112	35748400	BolC5t32749H	0	+	79	288	288	1.0000000
C5	35777477	35779494	BolC5t32750H	0	+	1992	2017	2017	1.0000000
C5	35783629	35783901	BolC5t32751H	0	+	542	272	272	1.0000000
C5	35784972	35786257	BolC5t32752H	0	-	185	1044	1285	0.8124514
C5	35801885	35803544	BolC5t32753H	0	+	138	1056	1659	0.6365280
C5	35817688	35818695	BolC5t32754H	0	-	135	937	1007	0.9304866
C5	35876842	35877046	BolC5t32755H	0	-	169	204	204	1.0000000
C5	35877985	35878446	BolC5t32756H	0	+	89	405	461	0.8785250
C5	35891761	35892282	BolC5t32757H	0	-	46	398	521	0.7639155
C5	35891868	35893448	BolC5t32758H	0	-	460	1432	1580	0.9063291
C5	35897921	35898212	BolC5t32759H	0	+	436	291	291	1.0000000
C5	35902979	35903975	BolC5t32760H	0	-	3525	996	996	1.0000000
C5	35904237	35906200	BolC5t32761H	0	-	1610	1902	1963	0.9689251
C5	35915407	35918485	BolC5t32762H	0	+	495	2939	3078	0.9548408
C5	35919675	35921710	BolC5t32763H	0	-	352	1429	2035	0.7022113
C5	35939561	35939786	BolC5t32764H	0	+	204	225	225	1.0000000
C5	35976443	35976911	BolC5t32765H	0	+	507	468	468	1.0000000
C5	35982235	35985560	BolC5t32766H	0	+	910	2597	3325	0.7810526
C5	35986166	35987457	BolC5t32767H	0	-	646	1291	1291	1.0000000
C5	35996849	35997182	BolC5t32768H	0	-	223	333	333	1.0000000
C5	36000849	36002004	BolC5t32769H	0	+	493	970	1155	0.8398268
C5	36014142	36016108	BolC5t32770H	0	-	150	831	1966	0.4226857
C5	36043391	36044888	BolC5t32771H	0	+	546	885	1497	0.5911824
C5	36052974	36053932	BolC5t32772H	0	-	146	732	958	0.7640918
C5	36106596	36111894	BolC5t32773H	0	+	607	4097	5298	0.7733107
C5	36118824	36121621	BolC5t32774H	0	-	1819	2785	2797	0.9957097
C5	36123379	36126023	BolC5t32775H	0	-	1138	2381	2644	0.9005295
C5	36181116	36182264	BolC5t32776H	0	-	16	525	1148	0.4573171
C5	36184117	36184255	BolC5t32777H	0	+	181	138	138	1.0000000
C5	36184684	36185949	BolC5t32778H	0	-	1209	1265	1265	1.0000000
C5	36189600	36191518	BolC5t32779H	0	+	633	1805	1918	0.9410844
C5	36200270	36202703	BolC5t32780H	0	+	794	2299	2433	0.9449239
C5	36209719	36210130	BolC5t32781H	0	-	713	411	411	1.0000000
C5	36215371	36215996	BolC5t32782H	0	-	208	625	625	1.0000000
C5	36217100	36217451	BolC5t32783H	0	-	552	351	351	1.0000000
C5	36218454	36220986	BolC5t32784H	0	+	653	2223	2532	0.8779621
C5	36221067	36221644	BolC5t32785H	0	-	288	577	577	1.0000000
C5	36222370	36223255	BolC5t32786H	0	+	102	713	885	0.8056497
C5	36224276	36225842	BolC5t32787H	0	+	926	1526	1566	0.9744572
C5	36226026	36226833	BolC5t32788H	0	-	172	789	807	0.9776952
C5	36228131	36228831	BolC5t32789H	0	+	280	700	700	1.0000000
C5	36229700	36231123	BolC5t32790H	0	-	524	1284	1423	0.9023191
C5	36232653	36233034	BolC5t32791H	0	+	8	270	381	0.7086614
C5	36239927	36241139	BolC5t32792H	0	+	0	0	1212	0.0000000
C5	36253748	36253895	BolC5t32793H	0	+	2	55	147	0.3741497
C5	36264322	36264649	BolC5t32794H	0	-	355	327	327	1.0000000
C5	36294902	36296315	BolC5t32795H	0	+	456	1314	1413	0.9299363
C5	36312373	36314985	BolC5t32796H	0	-	1544	2612	2612	1.0000000
C5	36329907	36330727	BolC5t32797H	0	-	12	368	820	0.4487805
C5	36335403	36336678	BolC5t32798H	0	-	778	1275	1275	1.0000000
C5	36345733	36346060	BolC5t32799H	0	+	57	311	327	0.9510703
C5	36378600	36379008	BolC5t32800H	0	+	498	408	408	1.0000000
C5	36390862	36391096	BolC5t32801H	0	-	182	234	234	1.0000000
C5	36399558	36400149	BolC5t32802H	0	+	127	591	591	1.0000000
C5	36401138	36403528	BolC5t32803H	0	-	921	2257	2390	0.9443514
C5	36416423	36416813	BolC5t32804H	0	+	258	390	390	1.0000000
C5	36422551	36423094	BolC5t32805H	0	-	336	543	543	1.0000000
C5	36423607	36424552	BolC5t32806H	0	+	118	855	945	0.9047619
C5	36424863	36425500	BolC5t32807H	0	-	297	637	637	1.0000000
C5	36428729	36429652	BolC5t32808H	0	-	99	877	923	0.9501625
C5	36506466	36506862	BolC5t32809H	0	+	211	396	396	1.0000000
C5	36509898	36510453	BolC5t32810H	0	+	269	555	555	1.0000000
C5	36528289	36529604	BolC5t32811H	0	-	342	1315	1315	1.0000000
C5	36543180	36544558	BolC5t32812H	0	+	157	1160	1378	0.8417997
C5	36548054	36549828	BolC5t32813H	0	+	297	1774	1774	1.0000000
C5	36558692	36559114	BolC5t32814H	0	-	123	422	422	1.0000000
C5	36578104	36578591	BolC5t32815H	0	+	395	487	487	1.0000000
C5	36582575	36583157	BolC5t32816H	0	+	200	582	582	1.0000000
C5	36584098	36593079	BolC5t32817H	0	-	1474	5181	8981	0.5768845
C5	36595493	36596711	BolC5t32818H	0	+	915	1218	1218	1.0000000
C5	36597226	36598892	BolC5t32819H	0	-	598	1666	1666	1.0000000
C5	36599506	36600453	BolC5t32820H	0	+	267	878	947	0.9271383
C5	36600763	36601225	BolC5t32821H	0	-	177	462	462	1.0000000
C5	36602962	36620537	BolC5t32822H	0	-	2431	7986	17575	0.4543954
C5	36627776	36628363	BolC5t32823H	0	-	101	587	587	1.0000000
C5	36644853	36644997	BolC5t32824H	0	-	0	0	144	0.0000000
C5	36652950	36653625	BolC5t32825H	0	+	692	675	675	1.0000000
C5	36657553	36657856	BolC5t32826H	0	+	404	303	303	1.0000000
C5	36659741	36660771	BolC5t32827H	0	-	1053	1030	1030	1.0000000
C5	36711411	36727133	BolC5t32828H	0	-	7093	13602	15722	0.8651571
C5	36727231	36727900	BolC5t32829H	0	-	570	669	669	1.0000000
C5	36730529	36730781	BolC5t32830H	0	-	267	252	252	1.0000000
C5	36736332	36737214	BolC5t32831H	0	-	59	579	882	0.6564626
C5	36741497	36743597	BolC5t32832H	0	-	1312	2100	2100	1.0000000
C5	36746107	36749808	BolC5t32833H	0	-	826	2983	3701	0.8059984
C5	36774282	36775463	BolC5t32834H	0	-	7	237	1181	0.2006774
C5	36777456	36779031	BolC5t32835H	0	-	1868	1575	1575	1.0000000
C5	36782660	36783067	BolC5t32836H	0	-	243	393	407	0.9656020
C5	36783369	36785885	BolC5t32837H	0	-	1577	2416	2516	0.9602544
C5	36798911	36799321	BolC5t32838H	0	-	751	410	410	1.0000000
C5	36803864	36805340	BolC5t32839H	0	-	928	1476	1476	1.0000000
C5	36837239	36839707	BolC5t32840H	0	+	978	2016	2468	0.8168557
C5	36843227	36843596	BolC5t32841H	0	-	229	364	369	0.9864498
C5	36845869	36846470	BolC5t32842H	0	-	290	489	601	0.8136439
C5	36860831	36861014	BolC5t32843H	0	-	94	183	183	1.0000000
C5	36881257	36886983	BolC5t32844H	0	-	1000	4550	5726	0.7946211
C5	36901901	36903413	BolC5t32845H	0	-	523	1420	1512	0.9391534
C5	36923005	36923968	BolC5t32846H	0	+	460	963	963	1.0000000
C5	36926791	36929113	BolC5t32847H	0	-	1586	2322	2322	1.0000000
C5	36930068	36930847	BolC5t32848H	0	-	471	704	779	0.9037227
C5	36931355	36933651	BolC5t32849H	0	-	2378	2296	2296	1.0000000
C5	36941739	36942283	BolC5t32850H	0	+	72	472	544	0.8676471
C5	36948687	36951736	BolC5t32851H	0	-	1305	2645	3049	0.8674976
C5	36957153	36957291	BolC5t32852H	0	-	182	138	138	1.0000000
C5	36965564	37012851	BolC5t32853H	0	-	15547	33413	47287	0.7066001
C5	36978357	36981610	BolC5t32854H	0	-	922	2853	3253	0.8770366
C5	37016910	37017509	BolC5t32855H	0	+	430	599	599	1.0000000
C5	37023793	37024201	BolC5t32856H	0	+	38	308	408	0.7549019
C5	37040483	37041798	BolC5t32857H	0	-	270	717	1315	0.5452471
C5	37050014	37052534	BolC5t32858H	0	+	425	1981	2520	0.7861111
C5	37053053	37053368	BolC5t32859H	0	+	45	315	315	1.0000000
C5	37053840	37080745	BolC5t32860H	0	-	13657	26036	26905	0.9677012
C5	37061114	37062394	BolC5t32861H	0	+	401	1280	1280	1.0000000
C5	37069762	37071218	BolC5t32862H	0	-	447	1456	1456	1.0000000
C5	37073943	37075023	BolC5t32863H	0	+	881	1080	1080	1.0000000
C5	37084628	37086630	BolC5t32864H	0	+	841	1943	2002	0.9705295
C5	37088533	37088927	BolC5t32865H	0	+	356	394	394	1.0000000
C5	37090844	37093939	BolC5t32866H	0	+	307	1735	3095	0.5605816
C5	37096667	37097252	BolC5t32867H	0	+	28	104	585	0.1777778
C5	37104208	37106677	BolC5t32868H	0	-	53	320	2469	0.1296071
C5	37143837	37144532	BolC5t32869H	0	+	528	695	695	1.0000000
C5	37145309	37147675	BolC5t32870H	0	-	726	2140	2366	0.9044802
C5	37152870	37152999	BolC5t32871H	0	+	26	129	129	1.0000000
C5	37154501	37155371	BolC5t32872H	0	+	1023	870	870	1.0000000
C5	37155618	37156114	BolC5t32873H	0	-	276	470	496	0.9475806
C5	37158259	37160430	BolC5t32874H	0	+	1436	2171	2171	1.0000000
C5	37161207	37170436	BolC5t32875H	0	-	4997	8701	9229	0.9427890
C5	37208747	37209542	BolC5t32876H	0	-	6	317	795	0.3987421
C5	37214445	37215675	BolC5t32877H	0	+	2168	1230	1230	1.0000000
C5	37252839	37254536	BolC5t32878H	0	-	933	1697	1697	1.0000000
C5	37257250	37257782	BolC5t32879H	0	-	139	365	532	0.6860902
C5	37271053	37271962	BolC5t32880H	0	-	143	731	909	0.8041804
C5	37309253	37310202	BolC5t32881H	0	-	61	674	949	0.7102213
C5	37318734	37319633	BolC5t32882H	0	-	215	767	899	0.8531702
C5	37329383	37329888	BolC5t32883H	0	+	420	505	505	1.0000000
C5	37353400	37353529	BolC5t32884H	0	-	651	129	129	1.0000000
C5	37359532	37360467	BolC5t32885H	0	-	30	354	935	0.3786096
C5	37374738	37375683	BolC5t32886H	0	-	38	457	945	0.4835979
C5	37382410	37385450	BolC5t32887H	0	-	1339	3040	3040	1.0000000
C5	37417353	37417731	BolC5t32888H	0	+	330	378	378	1.0000000
C5	37440304	37441191	BolC5t32889H	0	+	75	546	887	0.6155581
C5	37443058	37445078	BolC5t32890H	0	+	1409	2020	2020	1.0000000
C5	37464510	37464852	BolC5t32891H	0	-	259	342	342	1.0000000
C5	37476493	37477563	BolC5t32892H	0	+	2512	1070	1070	1.0000000
C5	37482381	37485268	BolC5t32893H	0	+	2363	2882	2887	0.9982681
C5	37492685	37502534	BolC5t32894H	0	+	2017	6314	9849	0.6410803
C5	37495545	37495793	BolC5t32895H	0	-	179	248	248	1.0000000
C5	37513914	37514134	BolC5t32896H	0	-	15	154	220	0.7000000
C5	37514483	37515954	BolC5t32897H	0	-	171	936	1471	0.6363018
C5	37558513	37559977	BolC5t32898H	0	-	139	874	1464	0.5969945
C5	37582263	37583676	BolC5t32899H	0	-	176	1234	1413	0.8733192
C5	37593037	37594112	BolC5t32900H	0	+	288	945	1075	0.8790697
C5	37595390	37595882	BolC5t32901H	0	-	42	225	492	0.4573171
C5	37604599	37606036	BolC5t32902H	0	-	313	1001	1437	0.6965901
C5	37614845	37615629	BolC5t32903H	0	-	474	784	784	1.0000000
C5	37640118	37644154	BolC5t32904H	0	+	610	2713	4036	0.6722002
C5	37655988	37657138	BolC5t32905H	0	-	123	815	1150	0.7086957
C5	37662244	37674823	BolC5t32906H	0	-	301	1865	12579	0.1482630
C5	37687310	37712521	BolC5t32907H	0	-	9721	16890	25211	0.6699457
C5	37747453	37748097	BolC5t32908H	0	-	4	254	644	0.3944099
C5	37749136	37749945	BolC5t32909H	0	-	0	0	809	0.0000000
C5	37752198	37752866	BolC5t32910H	0	-	23	249	668	0.3727545
C5	37759748	37760000	BolC5t32911H	0	-	254	252	252	1.0000000
C5	37764077	37764329	BolC5t32912H	0	-	36	217	252	0.8611111
C5	37803492	37803615	BolC5t32913H	0	+	0	0	123	0.0000000
C5	37827834	37830055	BolC5t32914H	0	+	257	1767	2221	0.7955876
C5	37839959	37841565	BolC5t32915H	0	+	223	1478	1606	0.9202989
C5	37843378	37844389	BolC5t32916H	0	+	552	1011	1011	1.0000000
C5	37844575	37846387	BolC5t32917H	0	+	494	1448	1812	0.7991170
C5	37848542	37848750	BolC5t32918H	0	+	156	208	208	1.0000000
C5	37850241	37851571	BolC5t32919H	0	+	727	1330	1330	1.0000000
C5	37853375	37855468	BolC5t32920H	0	+	745	1949	2093	0.9311993
C5	37864051	37866168	BolC5t32921H	0	+	150	1818	2117	0.8587624
C5	37866168	37867003	BolC5t32922H	0	+	23	618	835	0.7401198
C5	37867182	37867305	BolC5t32923H	0	+	3	92	123	0.7479675
C5	37885600	37887094	BolC5t32924H	0	-	25	405	1494	0.2710843
C5	37906160	37906718	BolC5t32925H	0	+	47	479	558	0.8584229
C5	37918757	37919369	BolC5t32926H	0	-	2	82	612	0.1339869
C5	37920488	37920761	BolC5t32927H	0	-	23	218	273	0.7985348
C5	37955461	37959464	BolC5t32928H	0	-	1270	3801	4003	0.9495379
C5	37960422	37962319	BolC5t32929H	0	-	855	1771	1897	0.9335793
C5	37966388	37968012	BolC5t32930H	0	-	101	833	1624	0.5129310
C5	37973825	37975420	BolC5t32931H	0	+	129	894	1595	0.5605016
C5	37976021	37978208	BolC5t32932H	0	-	1383	2167	2187	0.9908550
C5	37980285	37987850	BolC5t32933H	0	+	1331	4487	7565	0.5931262
C5	37990920	37992599	BolC5t32934H	0	-	81	1004	1679	0.5979750
C5	38012284	38012580	BolC5t32935H	0	-	57	212	296	0.7162162
C5	38019711	38019939	BolC5t32936H	0	+	431	228	228	1.0000000
C5	38020918	38022178	BolC5t32937H	0	+	1413	1260	1260	1.0000000
C5	38022366	38023595	BolC5t32938H	0	-	699	1229	1229	1.0000000
C5	38030963	38031338	BolC5t32939H	0	-	50	334	375	0.8906667
C5	38041697	38042011	BolC5t32940H	0	-	46	162	314	0.5159236
C5	38042479	38043784	BolC5t32941H	0	-	830	1271	1305	0.9739463
C5	38075691	38077335	BolC5t32942H	0	-	249	1540	1644	0.9367397
C5	38097820	38098828	BolC5t32943H	0	-	129	659	1008	0.6537699
C5	38106180	38106556	BolC5t32944H	0	+	531	376	376	1.0000000
C5	38111547	38113318	BolC5t32945H	0	-	1736	1771	1771	1.0000000
C5	38117428	38122459	BolC5t32946H	0	-	21662	5013	5031	0.9964222
C5	38135820	38137936	BolC5t32947H	0	+	712	1987	2116	0.9390359
C5	38138357	38139592	BolC5t32948H	0	-	135	773	1235	0.6259109
C5	38152078	38154684	BolC5t32949H	0	+	1428	2467	2606	0.9466615
C5	38154969	38155191	BolC5t32950H	0	-	342	222	222	1.0000000
C5	38156075	38158441	BolC5t32951H	0	-	1447	2329	2366	0.9843618
C5	38161641	38167513	BolC5t32952H	0	-	845	3107	5872	0.5291213
C5	38169747	38170499	BolC5t32953H	0	+	450	752	752	1.0000000
C5	38184146	38184707	BolC5t32954H	0	-	177	561	561	1.0000000
C5	38215436	38215739	BolC5t32955H	0	-	761	303	303	1.0000000
C5	38217408	38218927	BolC5t32956H	0	-	1837	1519	1519	1.0000000
C5	38232069	38232461	BolC5t32957H	0	-	32	379	392	0.9668368
C5	38256111	38256502	BolC5t32958H	0	-	234	391	391	1.0000000
C5	38280681	38280893	BolC5t32959H	0	+	132	212	212	1.0000000
C5	38281049	38281497	BolC5t32960H	0	+	138	448	448	1.0000000
C5	38285329	38285572	BolC5t32961H	0	+	223	243	243	1.0000000
C5	38309193	38310788	BolC5t32962H	0	+	39	506	1595	0.3172414
C5	38321585	38326754	BolC5t32963H	0	+	4507	4611	5169	0.8920488
C5	38327716	38327983	BolC5t32964H	0	-	73	267	267	1.0000000
C5	38328336	38328894	BolC5t32965H	0	-	566	558	558	1.0000000
C5	38334385	38336055	BolC5t32966H	0	-	439	1570	1670	0.9401197
C5	38338806	38339157	BolC5t32967H	0	-	162	351	351	1.0000000
C5	38340327	38340848	BolC5t32968H	0	+	400	521	521	1.0000000
C5	38343199	38350140	BolC5t32969H	0	+	2684	6920	6941	0.9969745
C5	38355307	38355643	BolC5t32970H	0	+	294	336	336	1.0000000
C5	38371181	38371901	BolC5t32971H	0	+	51	689	720	0.9569445
C5	38380549	38380999	BolC5t32972H	0	-	495	450	450	1.0000000
C5	38392146	38392362	BolC5t32973H	0	+	368	216	216	1.0000000
C5	38417626	38427952	BolC5t32974H	0	+	5833	10122	10326	0.9802440
C5	38423510	38423787	BolC5t32975H	0	-	214	277	277	1.0000000
C5	38506869	38508421	BolC5t32976H	0	-	1421	1552	1552	1.0000000
C5	38511771	38516457	BolC5t32977H	0	+	2436	4616	4686	0.9850619
C5	38546691	38548317	BolC5t32978H	0	-	1189	1505	1626	0.9255843
C5	38563193	38563298	BolC5t32979H	0	-	68	105	105	1.0000000
C5	38563399	38563648	BolC5t32980H	0	-	77	249	249	1.0000000
C5	38564239	38564536	BolC5t32981H	0	-	274	297	297	1.0000000
C5	38566589	38568649	BolC5t32982H	0	+	325	1727	2060	0.8383495
C5	38569299	38575247	BolC5t32983H	0	-	1290	5169	5948	0.8690316
C5	38576242	38577712	BolC5t32984H	0	-	534	1470	1470	1.0000000
C5	38581322	38584768	BolC5t32985H	0	+	1404	3376	3446	0.9796866
C5	38585562	38586234	BolC5t32986H	0	+	125	531	672	0.7901786
C5	38594173	38594675	BolC5t32987H	0	-	11	206	502	0.4103586
C5	38594752	38595324	BolC5t32988H	0	-	17	446	572	0.7797203
C5	38597635	38598175	BolC5t32989H	0	+	31	400	540	0.7407407
C5	38610682	38613054	BolC5t32990H	0	+	984	2235	2372	0.9422429
C5	38614710	38615130	BolC5t32991H	0	+	11	269	420	0.6404762
C5	38616695	38617358	BolC5t32992H	0	-	257	532	663	0.8024133
C5	38617489	38618041	BolC5t32993H	0	-	160	552	552	1.0000000
C5	38619036	38620041	BolC5t32994H	0	-	670	1005	1005	1.0000000
C5	38649065	38650517	BolC5t32995H	0	+	1581	1452	1452	1.0000000
C5	38652644	38653047	BolC5t32996H	0	+	542	403	403	1.0000000
C5	38656468	38657541	BolC5t32997H	0	+	754	1073	1073	1.0000000
C5	38696616	38697168	BolC5t32998H	0	+	67	489	552	0.8858696
C5	38698109	38698645	BolC5t32999H	0	+	298	536	536	1.0000000
C5	38708344	38708881	BolC5t33000H	0	+	437	537	537	1.0000000
C5	38710491	38711686	BolC5t33001H	0	-	542	1195	1195	1.0000000
C5	38711188	38711608	BolC5t33002H	0	-	135	420	420	1.0000000
C5	38713506	38715082	BolC5t33003H	0	-	994	1576	1576	1.0000000
C5	38728447	38728735	BolC5t33004H	0	+	248	288	288	1.0000000
C5	38748016	38749534	BolC5t33005H	0	+	12	438	1518	0.2885376
C5	38753952	38754240	BolC5t33006H	0	+	183	288	288	1.0000000
C5	38757716	38759188	BolC5t33007H	0	+	263	1285	1472	0.8729619
C5	38765625	38765847	BolC5t33008H	0	-	4	200	222	0.9009009
C5	38774271	38775674	BolC5t33009H	0	+	555	1403	1403	1.0000000
C5	38780575	38780821	BolC5t33010H	0	+	135	246	246	1.0000000
C5	38830371	38830551	BolC5t33011H	0	+	242	180	180	1.0000000
C5	38832338	38832590	BolC5t33012H	0	-	129	252	252	1.0000000
C5	38842134	38847295	BolC5t33013H	0	-	2019	5161	5161	1.0000000
C5	38849238	38850373	BolC5t33014H	0	-	658	1135	1135	1.0000000
C5	38869457	38873876	BolC5t33015H	0	+	2390	4419	4419	1.0000000
C5	38887619	38891932	BolC5t33016H	0	+	2826	4313	4313	1.0000000
C5	38892920	38893121	BolC5t33017H	0	+	121	201	201	1.0000000
C5	38906521	38907957	BolC5t33018H	0	-	397	1429	1436	0.9951254
C5	38930566	38931709	BolC5t33019H	0	-	758	1143	1143	1.0000000
C5	38951871	38956211	BolC5t33020H	0	+	1961	3800	4340	0.8755760
C5	38959120	38960160	BolC5t33021H	0	-	663	1040	1040	1.0000000
C5	38961351	38961678	BolC5t33022H	0	-	0	0	327	0.0000000
C5	38963168	38963390	BolC5t33023H	0	-	47	215	222	0.9684685
C5	38963813	38964317	BolC5t33024H	0	-	9	169	504	0.3353175
C5	38967762	38968810	BolC5t33025H	0	-	249	976	1048	0.9312977
C5	38970167	38972732	BolC5t33026H	0	-	1039	2459	2565	0.9586745
C5	38974602	38976645	BolC5t33027H	0	+	4416	2043	2043	1.0000000
C5	38982547	38983788	BolC5t33028H	0	+	135	889	1241	0.7163578
C5	38984744	38984967	BolC5t33029H	0	+	610	223	223	1.0000000
C5	39006564	39006949	BolC5t33030H	0	-	1	28	385	0.0727273
C5	39009077	39009616	BolC5t33031H	0	-	66	414	539	0.7680891
C5	39010621	39014306	BolC5t33032H	0	+	503	2802	3685	0.7603799
C5	39034085	39037140	BolC5t33033H	0	+	1331	3003	3055	0.9829787
C5	39056758	39057128	BolC5t33034H	0	-	4	118	370	0.3189189
C5	39057971	39058286	BolC5t33035H	0	+	150	308	315	0.9777778
C5	39058510	39059746	BolC5t33036H	0	-	61	699	1236	0.5655340
C5	39067931	39107176	BolC5t33037H	0	-	17327	29599	39245	0.7542107
C5	39071159	39071735	BolC5t33038H	0	-	534	576	576	1.0000000
C5	39091930	39093482	BolC5t33039H	0	-	1131	1552	1552	1.0000000
C5	39094634	39095122	BolC5t33040H	0	+	422	488	488	1.0000000
C5	39109869	39111459	BolC5t33041H	0	-	648	1479	1590	0.9301887
C5	39111768	39113781	BolC5t33042H	0	-	1942	2013	2013	1.0000000
C5	39116761	39118442	BolC5t33043H	0	+	613	1644	1681	0.9779893
C5	39118766	39120235	BolC5t33044H	0	-	651	1218	1469	0.8291355
C5	39123046	39123469	BolC5t33045H	0	-	8	206	423	0.4869976
C5	39132774	39133581	BolC5t33046H	0	-	429	807	807	1.0000000
C5	39152690	39154781	BolC5t33047H	0	+	401	1371	2091	0.6556671
C5	39159623	39162374	BolC5t33048H	0	+	663	2184	2751	0.7938932
C5	39162834	39163029	BolC5t33049H	0	+	5	62	195	0.3179487
C5	39163324	39165625	BolC5t33050H	0	-	625	1842	2301	0.8005215
C5	39169599	39169842	BolC5t33051H	0	-	17	149	243	0.6131687
C5	39170919	39173540	BolC5t33052H	0	-	155	1511	2621	0.5764975
C5	39210392	39211043	BolC5t33053H	0	+	493	651	651	1.0000000
C5	39259599	39260805	BolC5t33054H	0	+	190	1155	1206	0.9577115
C5	39271327	39272425	BolC5t33055H	0	-	18	503	1098	0.4581057
C5	39276105	39278056	BolC5t33056H	0	-	926	1764	1951	0.9041517
C5	39285873	39286347	BolC5t33057H	0	-	228	474	474	1.0000000
C5	39311905	39312118	BolC5t33058H	0	+	0	0	213	0.0000000
C5	39316773	39317762	BolC5t33059H	0	+	297	974	989	0.9848332
C5	39331706	39333758	BolC5t33060H	0	+	631	2002	2052	0.9756335
C5	39334144	39336692	BolC5t33061H	0	-	1137	2133	2548	0.8371271
C5	39337056	39341361	BolC5t33062H	0	+	2437	3932	4305	0.9133565
C5	39348110	39350691	BolC5t33063H	0	+	382	2406	2581	0.9321968
C5	39358912	39359238	BolC5t33064H	0	-	2	51	326	0.1564417
C5	39369832	39372204	BolC5t33065H	0	+	2238	2372	2372	1.0000000
C5	39381364	39381550	BolC5t33066H	0	-	3	148	186	0.7956989
C5	39381961	39383712	BolC5t33067H	0	+	288	938	1751	0.5356939
C5	39433757	39435016	BolC5t33068H	0	-	2	41	1259	0.0325655
C5	39442338	39444344	BolC5t33069H	0	+	127	1027	2006	0.5119641
C5	39456956	39459632	BolC5t33070H	0	+	2286	2676	2676	1.0000000
C5	39459935	39462872	BolC5t33071H	0	-	1127	2843	2937	0.9679946
C5	39467550	39468515	BolC5t33072H	0	+	568	965	965	1.0000000
C5	39470292	39471386	BolC5t33073H	0	-	720	1094	1094	1.0000000
C5	39477376	39480030	BolC5t33074H	0	-	1993	2654	2654	1.0000000
C5	39481358	39484266	BolC5t33075H	0	+	1437	2864	2908	0.9848693
C5	39497705	39497918	BolC5t33076H	0	+	239	213	213	1.0000000
C5	39533454	39533979	BolC5t33077H	0	+	122	350	525	0.6666667
C5	39534633	39535118	BolC5t33078H	0	-	164	473	485	0.9752578
C5	39536211	39539585	BolC5t33079H	0	+	1163	2862	3374	0.8482513
C5	39554703	39557343	BolC5t33080H	0	+	890	2573	2640	0.9746212
C5	39591044	39593591	BolC5t33081H	0	+	239	1675	2547	0.6576365
C5	39597435	39602363	BolC5t33082H	0	+	604	3519	4928	0.7140828
C5	39607149	39607890	BolC5t33083H	0	+	6	81	741	0.1093117
C5	39612126	39612687	BolC5t33084H	0	-	50	304	561	0.5418895
C5	39620545	39621167	BolC5t33085H	0	-	417	622	622	1.0000000
C5	39623209	39623517	BolC5t33086H	0	-	670	308	308	1.0000000
C5	39624226	39625104	BolC5t33087H	0	+	0	0	878	0.0000000
C5	39626367	39627650	BolC5t33088H	0	+	93	184	1283	0.1434139
C5	39630053	39630290	BolC5t33089H	0	+	189	237	237	1.0000000
C5	39630329	39630659	BolC5t33090H	0	+	241	330	330	1.0000000
C5	39631543	39632257	BolC5t33091H	0	+	1008	714	714	1.0000000
C5	39632528	39636530	BolC5t33092H	0	-	4342	4000	4002	0.9995003
C5	39649175	39649845	BolC5t33093H	0	-	37	449	670	0.6701493
C5	39651577	39651959	BolC5t33094H	0	+	449	382	382	1.0000000
C5	39652153	39652780	BolC5t33095H	0	-	116	594	627	0.9473684
C5	39656574	39660851	BolC5t33096H	0	-	2150	4046	4277	0.9459902
C5	39662703	39667664	BolC5t33097H	0	-	875	3893	4961	0.7847208
C5	39668340	39669641	BolC5t33098H	0	-	1161	1301	1301	1.0000000
C5	39673066	39675283	BolC5t33099H	0	-	732	1951	2217	0.8800181
C5	39676229	39683337	BolC5t33100H	0	-	709	4608	7108	0.6482836
C5	39692624	39692864	BolC5t33101H	0	+	0	0	240	0.0000000
C5	39705842	39706340	BolC5t33102H	0	+	25	338	498	0.6787149
C5	39714074	39714879	BolC5t33103H	0	+	0	0	805	0.0000000
C5	39718382	39738565	BolC5t33104H	0	-	6854	17735	20183	0.8787098
C5	39741477	39742048	BolC5t33105H	0	+	156	395	571	0.6917688
C5	39744642	39750430	BolC5t33106H	0	+	3456	5719	5788	0.9880788
C5	39750874	39752563	BolC5t33107H	0	-	478	1271	1689	0.7525163
C5	39753354	39755511	BolC5t33108H	0	+	716	2131	2157	0.9879462
C5	39756069	39756778	BolC5t33109H	0	+	20	528	709	0.7447109
C5	39757038	39757864	BolC5t33110H	0	+	49	55	826	0.0665860
C5	39776022	39779213	BolC5t33111H	0	+	1575	3191	3191	1.0000000
C5	39790297	39791868	BolC5t33112H	0	+	533	1569	1571	0.9987269
C5	39804974	39805684	BolC5t33113H	0	-	817	710	710	1.0000000
C5	39807668	39811858	BolC5t33114H	0	+	2351	3856	4190	0.9202864
C5	39812785	39814754	BolC5t33115H	0	-	1830	1969	1969	1.0000000
C5	39825945	39828423	BolC5t33116H	0	-	567	2333	2478	0.9414850
C5	39830524	39830803	BolC5t33117H	0	-	259	279	279	1.0000000
C5	39833830	39834178	BolC5t33118H	0	+	183	348	348	1.0000000
C5	39835699	39837226	BolC5t33119H	0	+	834	1527	1527	1.0000000
C5	39837903	39838951	BolC5t33120H	0	+	0	0	1048	0.0000000
C5	39840520	39845103	BolC5t33121H	0	-	104	1340	4583	0.2923849
C5	39845853	39847017	BolC5t33122H	0	-	284	1116	1164	0.9587629
C5	39848764	39850117	BolC5t33123H	0	-	288	1295	1353	0.9571323
C5	39851273	39854736	BolC5t33124H	0	+	2133	3246	3463	0.9373376
C5	39865842	39867535	BolC5t33125H	0	+	53	1009	1693	0.5959834
C5	39868463	39871764	BolC5t33126H	0	+	1136	2974	3301	0.9009391
C5	39872373	39875022	BolC5t33127H	0	-	778	2471	2649	0.9328048
C5	39877872	39879422	BolC5t33128H	0	-	1092	1550	1550	1.0000000
C5	39883162	39884669	BolC5t33129H	0	+	472	1481	1507	0.9827472
C5	39897736	39899272	BolC5t33130H	0	+	262	1483	1536	0.9654948
C5	39899290	39899947	BolC5t33131H	0	+	188	657	657	1.0000000
C5	39910028	39910616	BolC5t33132H	0	-	6	102	588	0.1734694
C5	39916178	39916469	BolC5t33133H	0	+	190	291	291	1.0000000
C5	39926534	39934166	BolC5t33134H	0	-	1611	6788	7632	0.8894130
C5	39934587	39934960	BolC5t33135H	0	+	196	373	373	1.0000000
C5	39936457	39939936	BolC5t33136H	0	+	1023	3021	3479	0.8683529
C5	39940421	39941810	BolC5t33137H	0	-	666	1246	1389	0.8970482
C5	39942241	39943194	BolC5t33138H	0	+	713	953	953	1.0000000
C5	39943321	39943675	BolC5t33139H	0	-	17	269	354	0.7598870
C5	39944190	39946300	BolC5t33140H	0	-	202	1674	2110	0.7933649
C5	39947220	39950913	BolC5t33141H	0	-	1288	3221	3693	0.8721907
C5	39967562	39968084	BolC5t33142H	0	+	667	522	522	1.0000000
C5	39968237	39969632	BolC5t33143H	0	-	539	1313	1395	0.9412186
C5	39975234	39976287	BolC5t33144H	0	-	120	779	1053	0.7397911
C5	39978942	39988071	BolC5t33145H	0	-	2367	8394	9129	0.9194874
C5	39990666	39990837	BolC5t33146H	0	+	202	171	171	1.0000000
C5	39996701	39998348	BolC5t33147H	0	-	160	1044	1647	0.6338798
C5	40006733	40007475	BolC5t33148H	0	-	377	742	742	1.0000000
C5	40007820	40025218	BolC5t33149H	0	-	6101	16049	17398	0.9224623
C5	40008649	40011040	BolC5t33150H	0	-	1257	2391	2391	1.0000000
C5	40059708	40059882	BolC5t33151H	0	-	291	174	174	1.0000000
C5	40079199	40079778	BolC5t33152H	0	-	353	579	579	1.0000000
C5	40080995	40081877	BolC5t33153H	0	+	337	882	882	1.0000000
C5	40105209	40105677	BolC5t33154H	0	-	432	468	468	1.0000000
C5	40106814	40120566	BolC5t33155H	0	+	6790	12133	13752	0.8822716
C5	40110515	40110718	BolC5t33156H	0	+	0	0	203	0.0000000
C5	40116258	40116707	BolC5t33157H	0	-	160	449	449	1.0000000
C5	40117321	40119384	BolC5t33158H	0	-	1002	1490	2063	0.7222492
C5	40121286	40123646	BolC5t33159H	0	+	1023	2214	2360	0.9381356
C5	40171742	40172831	BolC5t33160H	0	-	193	917	1089	0.8420569
C5	40186766	40187130	BolC5t33161H	0	-	2	107	364	0.2939560
C5	40194138	40195103	BolC5t33162H	0	-	227	891	965	0.9233161
C5	40210290	40211540	BolC5t33163H	0	-	219	1084	1250	0.8672000
C5	40237154	40238601	BolC5t33164H	0	+	867	1447	1447	1.0000000
C5	40239126	40240746	BolC5t33165H	0	-	333	1098	1620	0.6777778
C5	40246758	40247217	BolC5t33166H	0	-	340	459	459	1.0000000
C5	40247686	40250536	BolC5t33167H	0	+	2407	2850	2850	1.0000000
C5	40258799	40260555	BolC5t33168H	0	-	67	749	1756	0.4265376
C5	40261752	40262351	BolC5t33169H	0	-	641	599	599	1.0000000
C5	40265530	40266829	BolC5t33170H	0	+	457	1299	1299	1.0000000
C5	40267325	40270818	BolC5t33171H	0	+	1445	3394	3493	0.9716576
C5	40271133	40273827	BolC5t33172H	0	-	347	2023	2694	0.7509280
C5	40277755	40281268	BolC5t33173H	0	+	1638	3469	3513	0.9874751
C5	40298153	40302610	BolC5t33174H	0	-	1286	3488	4457	0.7825892
C5	40303709	40308237	BolC5t33175H	0	+	1173	2849	4528	0.6291961
C5	40334120	40338164	BolC5t33176H	0	-	1087	3217	4044	0.7954995
C5	40339048	40341062	BolC5t33177H	0	-	723	2014	2014	1.0000000
C5	40341669	40344396	BolC5t33178H	0	-	1457	2707	2727	0.9926659
C5	40347526	40348283	BolC5t33179H	0	+	505	757	757	1.0000000
C5	40348708	40348921	BolC5t33180H	0	-	182	213	213	1.0000000
C5	40356875	40357037	BolC5t33181H	0	-	23	162	162	1.0000000
C5	40360534	40361233	BolC5t33182H	0	-	169	580	699	0.8297568
C5	40362635	40363199	BolC5t33183H	0	-	335	564	564	1.0000000
C5	40367513	40368183	BolC5t33184H	0	-	633	669	670	0.9985074
C5	40381459	40381810	BolC5t33185H	0	+	163	351	351	1.0000000
C5	40382361	40383908	BolC5t33186H	0	+	292	1170	1547	0.7563025
C5	40386636	40386954	BolC5t33187H	0	+	57	318	318	1.0000000
C5	40390535	40392121	BolC5t33188H	0	-	252	1497	1586	0.9438840
C5	40406243	40406610	BolC5t33189H	0	-	107	367	367	1.0000000
C5	40424697	40424915	BolC5t33190H	0	-	2	47	218	0.2155963
C5	40426319	40426592	BolC5t33191H	0	-	2	85	273	0.3113553
C5	40427757	40428120	BolC5t33192H	0	-	0	0	363	0.0000000
C5	40433613	40433844	BolC5t33193H	0	+	205	231	231	1.0000000
C5	40435076	40435217	BolC5t33194H	0	+	26	141	141	1.0000000
C5	40438020	40444081	BolC5t33195H	0	-	2528	5881	6061	0.9703019
C5	40450918	40451947	BolC5t33196H	0	-	408	1029	1029	1.0000000
C5	40455457	40457243	BolC5t33197H	0	-	107	1531	1786	0.8572229
C5	40464220	40466539	BolC5t33198H	0	+	654	2029	2319	0.8749461
C5	40466985	40469437	BolC5t33199H	0	-	309	1797	2452	0.7328711
C5	40484229	40485475	BolC5t33200H	0	+	17	696	1246	0.5585875
C5	40499872	40500318	BolC5t33201H	0	+	177	446	446	1.0000000
C5	40507214	40508272	BolC5t33202H	0	-	0	0	1058	0.0000000
C5	40508553	40519972	BolC5t33203H	0	+	1904	6747	11419	0.5908573
C5	40538199	40539885	BolC5t33204H	0	-	460	1533	1686	0.9092526
C5	40541190	40546644	BolC5t33205H	0	-	711	3603	5454	0.6606160
C5	40548242	40551920	BolC5t33206H	0	+	471	3052	3678	0.8297988
C5	40555738	40556275	BolC5t33207H	0	-	333	537	537	1.0000000
C5	40558353	40560144	BolC5t33208H	0	+	113	1400	1791	0.7816862
C5	40563082	40563974	BolC5t33209H	0	+	1374	892	892	1.0000000
C5	40567457	40569062	BolC5t33210H	0	+	63	801	1605	0.4990654
C5	40569243	40570267	BolC5t33211H	0	+	47	648	1024	0.6328125
C5	40571673	40572910	BolC5t33212H	0	-	473	761	1237	0.6151981
C5	40573528	40573927	BolC5t33213H	0	-	341	399	399	1.0000000
C5	40577751	40578045	BolC5t33214H	0	+	18	213	294	0.7244898
C5	40579027	40581783	BolC5t33215H	0	-	1258	2448	2756	0.8882439
C5	40594532	40595586	BolC5t33216H	0	+	192	711	1054	0.6745731
C5	40596418	40597090	BolC5t33217H	0	-	525	672	672	1.0000000
C5	40598374	40599605	BolC5t33218H	0	-	557	1231	1231	1.0000000
C5	40598868	40607257	BolC5t33219H	0	-	1692	4857	8389	0.5789725
C5	40609154	40609331	BolC5t33220H	0	+	31	177	177	1.0000000
C5	40616859	40617036	BolC5t33221H	0	+	4	177	177	1.0000000
C5	40621843	40622669	BolC5t33222H	0	-	0	0	826	0.0000000
C5	40650217	40651330	BolC5t33223H	0	+	104	832	1113	0.7475292
C5	40652803	40652977	BolC5t33224H	0	-	56	174	174	1.0000000
C5	40665809	40671069	BolC5t33225H	0	-	781	3524	5260	0.6699620
C5	40680064	40682030	BolC5t33226H	0	-	753	1936	1966	0.9847406
C5	40682686	40684866	BolC5t33227H	0	-	356	1859	2180	0.8527523
C5	40685769	40685904	BolC5t33228H	0	+	162	135	135	1.0000000
C5	40694279	40694765	BolC5t33229H	0	+	0	0	486	0.0000000
C5	40696884	40699479	BolC5t33230H	0	+	470	1689	2595	0.6508670
C5	40700971	40702512	BolC5t33231H	0	-	432	1541	1541	1.0000000
C5	40711820	40712271	BolC5t33232H	0	+	1	124	451	0.2749446
C5	40721046	40721319	BolC5t33233H	0	+	11	110	273	0.4029304
C5	40725104	40725971	BolC5t33234H	0	+	12	411	867	0.4740484
C5	40730080	40731407	BolC5t33235H	0	-	1096	1327	1327	1.0000000
C5	40734330	40736440	BolC5t33236H	0	-	6	301	2110	0.1426540
C5	40795186	40795492	BolC5t33237H	0	-	0	0	306	0.0000000
C5	40814939	40815390	BolC5t33238H	0	+	0	0	451	0.0000000
C5	40827948	40828307	BolC5t33239H	0	-	267	359	359	1.0000000
C5	40838123	40838423	BolC5t33240H	0	+	0	0	300	0.0000000
C5	40839034	40839442	BolC5t33241H	0	+	61	306	408	0.7500000
C5	40851507	40859305	BolC5t33242H	0	+	722	4411	7798	0.5656579
C5	40860364	40860562	BolC5t33243H	0	+	57	198	198	1.0000000
C5	40860986	40865224	BolC5t33244H	0	-	1701	3797	4238	0.8959415
C5	40888546	40891621	BolC5t33245H	0	+	494	2770	3075	0.9008130
C5	40915668	40916763	BolC5t33246H	0	-	531	1095	1095	1.0000000
C5	40933104	40933626	BolC5t33247H	0	-	389	522	522	1.0000000
C5	40934529	40935574	BolC5t33248H	0	+	62	798	1045	0.7636364
C5	40936361	40936838	BolC5t33249H	0	-	83	435	477	0.9119497
C5	40939572	40940402	BolC5t33250H	0	+	58	401	830	0.4831325
C5	40944810	40945151	BolC5t33251H	0	-	233	341	341	1.0000000
C5	40951284	40953828	BolC5t33252H	0	+	824	2522	2544	0.9913522
C5	40957050	40957860	BolC5t33253H	0	+	319	810	810	1.0000000
C5	40968687	40969948	BolC5t33254H	0	-	594	1261	1261	1.0000000
C5	40977183	40978290	BolC5t33255H	0	-	507	1107	1107	1.0000000
C5	40990022	40994332	BolC5t33256H	0	-	450	2140	4310	0.4965197
C5	40996738	40997068	BolC5t33257H	0	-	149	330	330	1.0000000
C5	41000745	41040700	BolC5t33258H	0	-	21673	37728	39955	0.9442623
C5	41022094	41022648	BolC5t33259H	0	+	228	554	554	1.0000000
C5	41022745	41022948	BolC5t33260H	0	+	91	203	203	1.0000000
C5	41023349	41025452	BolC5t33261H	0	+	663	1986	2103	0.9443652
C5	41025918	41026335	BolC5t33262H	0	+	671	399	417	0.9568346
C5	41028208	41030114	BolC5t33263H	0	+	1822	1827	1906	0.9585519
C5	41030571	41031273	BolC5t33264H	0	-	655	702	702	1.0000000
C5	41032940	41033374	BolC5t33265H	0	-	570	434	434	1.0000000
C5	41034173	41034848	BolC5t33266H	0	+	243	675	675	1.0000000
C5	41038194	41038644	BolC5t33267H	0	-	160	250	450	0.5555556
C5	41041900	41042213	BolC5t33268H	0	+	0	0	313	0.0000000
C5	41048089	41049966	BolC5t33269H	0	-	951	1844	1877	0.9824188
C5	41058766	41059548	BolC5t33270H	0	-	467	782	782	1.0000000
C5	41077013	41077924	BolC5t33271H	0	-	248	806	911	0.8847420
C5	41084635	41085508	BolC5t33272H	0	-	414	873	873	1.0000000
C5	41091298	41093259	BolC5t33273H	0	+	573	1587	1961	0.8092810
C5	41096055	41097182	BolC5t33274H	0	+	277	1127	1127	1.0000000
C5	41104051	41105731	BolC5t33275H	0	-	444	1625	1680	0.9672619
C5	41106441	41106600	BolC5t33276H	0	-	77	159	159	1.0000000
C5	41113030	41114107	BolC5t33277H	0	-	2	19	1077	0.0176416
C5	41132115	41134756	BolC5t33278H	0	+	1200	2589	2641	0.9803105
C5	41141336	41141671	BolC5t33279H	0	+	250	335	335	1.0000000
C5	41143383	41144931	BolC5t33280H	0	+	1036	1548	1548	1.0000000
C5	41145691	41148427	BolC5t33281H	0	+	845	2639	2736	0.9645468
C5	41149317	41150475	BolC5t33282H	0	-	554	1158	1158	1.0000000
C5	41151615	41153287	BolC5t33283H	0	-	304	1352	1672	0.8086125
C5	41155163	41157396	BolC5t33284H	0	-	1668	2147	2233	0.9614868
C5	41188584	41190405	BolC5t33285H	0	+	285	1183	1821	0.6496431
C5	41194765	41195921	BolC5t33286H	0	-	442	1156	1156	1.0000000
C5	41205673	41209007	BolC5t33287H	0	-	1250	3047	3334	0.9139172
C5	41220435	41220555	BolC5t33288H	0	+	50	120	120	1.0000000
C5	41231099	41231639	BolC5t33289H	0	-	126	532	540	0.9851852
C5	41231705	41234732	BolC5t33290H	0	-	323	1150	3027	0.3799141
C5	41248541	41254034	BolC5t33291H	0	-	3400	5088	5493	0.9262698
C5	41259670	41260057	BolC5t33292H	0	+	32	359	387	0.9276486
C5	41263387	41264502	BolC5t33293H	0	+	1827	1115	1115	1.0000000
C5	41285075	41285891	BolC5t33294H	0	-	176	720	816	0.8823529
C5	41286780	41289472	BolC5t33295H	0	-	107	1689	2692	0.6274146
C5	41292515	41293781	BolC5t33296H	0	+	440	1266	1266	1.0000000
C5	41294415	41296966	BolC5t33297H	0	-	1365	2503	2551	0.9811838
C5	41300131	41301702	BolC5t33298H	0	-	316	812	1571	0.5168682
C5	41306232	41306466	BolC5t33299H	0	-	202	234	234	1.0000000
C5	41307350	41308936	BolC5t33300H	0	+	72	785	1586	0.4949559
C5	41309136	41312356	BolC5t33301H	0	-	882	3060	3220	0.9503106
C5	41317877	41320125	BolC5t33302H	0	-	128	926	2248	0.4119217
C5	41321743	41324364	BolC5t33303H	0	+	1127	2488	2621	0.9492560
C5	41324766	41326397	BolC5t33304H	0	-	1224	1582	1631	0.9699571
C5	41329005	41332002	BolC5t33305H	0	+	1213	2897	2997	0.9666333
C5	41340859	41341543	BolC5t33306H	0	+	0	0	684	0.0000000
C5	41346889	41349422	BolC5t33307H	0	+	212	1253	2533	0.4946704
C5	41356136	41356442	BolC5t33308H	0	-	0	0	306	0.0000000
C5	41381998	41382445	BolC5t33309H	0	-	2	165	447	0.3691275
C5	41402721	41404495	BolC5t33310H	0	+	361	1657	1774	0.9340473
C5	41404920	41405967	BolC5t33311H	0	-	799	1047	1047	1.0000000
C5	41410869	41411802	BolC5t33312H	0	-	652	933	933	1.0000000
C5	41426210	41426405	BolC5t33313H	0	+	295	195	195	1.0000000
C5	41428094	41428520	BolC5t33314H	0	+	365	426	426	1.0000000
C5	41428799	41430991	BolC5t33315H	0	-	230	1148	2192	0.5237226
C5	41442918	41443478	BolC5t33316H	0	-	0	0	560	0.0000000
C5	41453651	41458145	BolC5t33317H	0	-	1694	4276	4494	0.9514909
C5	41469360	41469685	BolC5t33318H	0	-	8	63	325	0.1938462
C5	41472700	41485517	BolC5t33319H	0	-	2049	6918	12817	0.5397519
C5	41473652	41473844	BolC5t33320H	0	+	7	116	192	0.6041667
C5	41475187	41475391	BolC5t33321H	0	+	37	198	204	0.9705882
C5	41502122	41502413	BolC5t33322H	0	+	0	0	291	0.0000000
C5	41502510	41502654	BolC5t33323H	0	+	0	0	144	0.0000000
C5	41502862	41503138	BolC5t33324H	0	+	2	19	276	0.0688406
C5	41508061	41510077	BolC5t33325H	0	-	724	1946	2016	0.9652778
C5	41516079	41516374	BolC5t33326H	0	+	17	142	295	0.4813559
C5	41517906	41518443	BolC5t33327H	0	-	507	537	537	1.0000000
C5	41518983	41521351	BolC5t33328H	0	+	1068	1806	2368	0.7626689
C5	41521901	41523220	BolC5t33329H	0	-	510	1319	1319	1.0000000
C5	41523608	41529629	BolC5t33330H	0	+	1686	4127	6021	0.6854343
C5	41543364	41543923	BolC5t33331H	0	+	7	296	559	0.5295170
C5	41546536	41553986	BolC5t33332H	0	-	986	3902	7450	0.5237584
C5	41555421	41559721	BolC5t33333H	0	-	430	3035	4300	0.7058139
C5	41561476	41563448	BolC5t33334H	0	+	1325	1972	1972	1.0000000
C5	41566132	41568043	BolC5t33335H	0	+	1329	1911	1911	1.0000000
C5	41568617	41569421	BolC5t33336H	0	+	270	792	804	0.9850746
C5	41575614	41576647	BolC5t33337H	0	-	264	1033	1033	1.0000000
C5	41591443	41593827	BolC5t33338H	0	+	597	2369	2384	0.9937081
C5	41602297	41606449	BolC5t33339H	0	-	715	1887	4152	0.4544798
C5	41608530	41611055	BolC5t33340H	0	-	1686	2516	2525	0.9964356
C5	41611940	41612693	BolC5t33341H	0	-	258	723	753	0.9601594
C5	41614934	41615816	BolC5t33342H	0	-	773	881	882	0.9988662
C5	41617817	41618069	BolC5t33343H	0	+	174	252	252	1.0000000
C5	41619727	41622173	BolC5t33344H	0	-	1869	2375	2446	0.9709730
C5	41627496	41628560	BolC5t33345H	0	-	550	1061	1064	0.9971805
C5	41630626	41630785	BolC5t33346H	0	-	368	159	159	1.0000000
C5	41640454	41640790	BolC5t33347H	0	-	201	336	336	1.0000000
C5	41641806	41642533	BolC5t33348H	0	+	47	561	727	0.7716644
C5	41731167	41731554	BolC5t33349H	0	-	168	387	387	1.0000000
C5	41734867	41737028	BolC5t33350H	0	-	1127	2018	2161	0.9338269
C5	41742743	41743765	BolC5t33351H	0	-	0	0	1022	0.0000000
C5	41756650	41757277	BolC5t33352H	0	-	0	0	627	0.0000000
C5	41757357	41759124	BolC5t33353H	0	-	30	443	1767	0.2507074
C5	41785610	41786539	BolC5t33354H	0	-	98	699	929	0.7524220
C5	41795374	41796475	BolC5t33355H	0	+	137	1101	1101	1.0000000
C5	41796933	41797407	BolC5t33356H	0	-	58	474	474	1.0000000
C5	41798097	41798442	BolC5t33357H	0	-	237	345	345	1.0000000
C5	41827469	41838981	BolC5t33358H	0	-	2968	8659	11512	0.7521716
C5	41842497	41842842	BolC5t33359H	0	-	3	268	345	0.7768116
C5	41843694	41844803	BolC5t33360H	0	-	18	515	1109	0.4643823
C5	41844861	41845619	BolC5t33361H	0	-	41	691	758	0.9116095
C5	41863604	41863787	BolC5t33362H	0	+	10	109	183	0.5956284
C5	41873977	41875016	BolC5t33363H	0	+	350	1020	1039	0.9817132
C5	41900521	41901593	BolC5t33364H	0	-	12	456	1072	0.4253731
C5	41918659	41920461	BolC5t33365H	0	-	312	509	1802	0.2824639
C5	41921109	41922722	BolC5t33366H	0	+	159	802	1613	0.4972102
C5	41924396	41924771	BolC5t33367H	0	+	164	375	375	1.0000000
C5	41927418	41927601	BolC5t33368H	0	+	151	183	183	1.0000000
C5	41930588	41932680	BolC5t33369H	0	-	1387	2092	2092	1.0000000
C5	41933919	41934965	BolC5t33370H	0	-	304	736	1046	0.7036329
C5	41940963	41943236	BolC5t33371H	0	+	581	1358	2273	0.5974483
C5	41943988	41945338	BolC5t33372H	0	+	153	895	1350	0.6629630
C5	41947874	41949504	BolC5t33373H	0	-	15	630	1630	0.3865031
C5	41950942	41951140	BolC5t33374H	0	+	165	198	198	1.0000000
C5	41953631	41955790	BolC5t33375H	0	+	1396	2148	2159	0.9949051
C5	41956767	41958171	BolC5t33376H	0	+	721	1404	1404	1.0000000
C5	41958256	41959199	BolC5t33377H	0	-	957	943	943	1.0000000
C5	41960972	41962636	BolC5t33378H	0	-	889	1641	1664	0.9861779
C5	41964906	41966277	BolC5t33379H	0	-	747	1371	1371	1.0000000
C5	41975652	41976591	BolC5t33380H	0	+	585	939	939	1.0000000
C5	41985409	41985517	BolC5t33381H	0	-	7	108	108	1.0000000
C5	41987331	41988582	BolC5t33382H	0	+	106	1230	1251	0.9832134
C5	41990119	41993252	BolC5t33383H	0	-	1300	2709	3133	0.8646665
C5	41994491	41994964	BolC5t33384H	0	-	190	473	473	1.0000000
C5	41995160	41995988	BolC5t33385H	0	+	202	799	828	0.9649758
C5	41996546	42001393	BolC5t33386H	0	-	2023	4429	4847	0.9137611
C5	42016369	42017641	BolC5t33387H	0	+	218	736	1272	0.5786164
C5	42018452	42018758	BolC5t33388H	0	+	11	98	306	0.3202614
C5	42019357	42021382	BolC5t33389H	0	-	699	1897	2025	0.9367901
C5	42023466	42024307	BolC5t33390H	0	-	1109	841	841	1.0000000
C5	42028107	42028515	BolC5t33391H	0	-	46	194	408	0.4754902
C5	42030485	42030977	BolC5t33392H	0	-	3	134	492	0.2723577
C5	42031855	42032747	BolC5t33393H	0	+	707	892	892	1.0000000
C5	42044390	42044645	BolC5t33394H	0	+	165	255	255	1.0000000
C5	42045307	42046169	BolC5t33395H	0	+	276	862	862	1.0000000
C5	42046349	42047061	BolC5t33396H	0	+	409	634	712	0.8904495
C5	42047850	42049911	BolC5t33397H	0	-	982	1975	2061	0.9582727
C5	42053245	42056208	BolC5t33398H	0	+	1421	2473	2963	0.8346271
C5	42056659	42057379	BolC5t33399H	0	-	87	671	720	0.9319444
C5	42058113	42059004	BolC5t33400H	0	-	131	741	891	0.8316498
C5	42062432	42062669	BolC5t33401H	0	-	0	0	237	0.0000000
C5	42062714	42064784	BolC5t33402H	0	-	12	24	2070	0.0115942
C5	42065608	42066922	BolC5t33403H	0	-	0	0	1314	0.0000000
C5	42070491	42071863	BolC5t33404H	0	-	268	1185	1372	0.8637026
C5	42086159	42087060	BolC5t33405H	0	+	198	901	901	1.0000000
C5	42088681	42089329	BolC5t33406H	0	-	172	577	648	0.8904321
C5	42095181	42095820	BolC5t33407H	0	-	80	317	639	0.4960876
C5	42105482	42107391	BolC5t33408H	0	-	728	1870	1909	0.9795704
C5	42115316	42117705	BolC5t33409H	0	+	1823	2389	2389	1.0000000
C5	42118184	42118966	BolC5t33410H	0	+	695	782	782	1.0000000
C5	42120221	42120651	BolC5t33411H	0	-	287	430	430	1.0000000
C5	42121002	42127829	BolC5t33412H	0	+	2261	4263	6827	0.6244324
C5	42128776	42129058	BolC5t33413H	0	-	175	282	282	1.0000000
C5	42146164	42147436	BolC5t33414H	0	+	451	1232	1272	0.9685535
C5	42152095	42152740	BolC5t33415H	0	+	296	628	645	0.9736434
C5	42152998	42154892	BolC5t33416H	0	-	791	1838	1894	0.9704329
C5	42156912	42159424	BolC5t33417H	0	+	372	2216	2512	0.8821656
C5	42176462	42176687	BolC5t33418H	0	+	331	225	225	1.0000000
C5	42191081	42191516	BolC5t33419H	0	+	83	435	435	1.0000000
C5	42196963	42197251	BolC5t33420H	0	-	127	288	288	1.0000000
C5	42209173	42210244	BolC5t33421H	0	+	644	1021	1071	0.9533147
C5	42217836	42220445	BolC5t33422H	0	-	2064	2609	2609	1.0000000
C5	42221119	42222543	BolC5t33423H	0	-	319	1407	1424	0.9880618
C5	42227085	42228200	BolC5t33424H	0	-	97	1115	1115	1.0000000
C5	42228228	42229567	BolC5t33425H	0	-	151	1086	1339	0.8110530
C5	42232162	42233755	BolC5t33426H	0	+	1104	1593	1593	1.0000000
C5	42234308	42236417	BolC5t33427H	0	-	1540	2109	2109	1.0000000
C5	42240044	42244085	BolC5t33428H	0	+	3239	4041	4041	1.0000000
C5	42245107	42249075	BolC5t33429H	0	+	2965	3919	3968	0.9876512
C5	42259173	42262299	BolC5t33430H	0	+	1033	2977	3126	0.9523352
C5	42262840	42263502	BolC5t33431H	0	-	243	444	662	0.6706949
C5	42263845	42265097	BolC5t33432H	0	+	847	1252	1252	1.0000000
C5	42265402	42265900	BolC5t33433H	0	+	204	482	498	0.9678715
C5	42266329	42266797	BolC5t33434H	0	-	438	468	468	1.0000000
C5	42283547	42285316	BolC5t33435H	0	-	1252	1769	1769	1.0000000
C5	42301675	42303624	BolC5t33436H	0	-	1098	1949	1949	1.0000000
C5	42335145	42338547	BolC5t33437H	0	-	3740	3402	3402	1.0000000
C5	42345052	42345987	BolC5t33438H	0	+	331	897	935	0.9593583
C5	42346550	42347125	BolC5t33439H	0	+	204	453	575	0.7878261
C5	42366705	42366996	BolC5t33440H	0	-	528	291	291	1.0000000
C5	42367632	42370474	BolC5t33441H	0	-	2446	2787	2842	0.9806474
C5	42374546	42376140	BolC5t33442H	0	+	348	1367	1594	0.8575910
C5	42389761	42391435	BolC5t33443H	0	+	1496	1674	1674	1.0000000
C5	42397201	42401800	BolC5t33444H	0	-	3388	4536	4599	0.9863014
C5	42402757	42403565	BolC5t33445H	0	+	436	808	808	1.0000000
C5	42420214	42420361	BolC5t33446H	0	+	53	147	147	1.0000000
C5	42423114	42423761	BolC5t33447H	0	+	152	647	647	1.0000000
C5	42425886	42426552	BolC5t33448H	0	+	146	498	666	0.7477477
C5	42427106	42428102	BolC5t33449H	0	+	171	725	996	0.7279117
C5	42428062	42428259	BolC5t33450H	0	+	4	170	197	0.8629442
C5	42430863	42434878	BolC5t33451H	0	+	1815	4015	4015	1.0000000
C5	42439319	42440808	BolC5t33452H	0	-	828	1489	1489	1.0000000
C5	42467809	42469597	BolC5t33453H	0	-	694	1788	1788	1.0000000
C5	42473663	42474649	BolC5t33454H	0	+	2	46	986	0.0466531
C5	42487459	42487971	BolC5t33455H	0	+	0	0	512	0.0000000
C5	42546512	42547021	BolC5t33456H	0	-	8	293	509	0.5756385
C5	42552640	42553243	BolC5t33457H	0	+	0	0	603	0.0000000
C5	42559678	42560917	BolC5t33458H	0	+	17	675	1239	0.5447942
C5	42576116	42577198	BolC5t33459H	0	-	6	171	1082	0.1580407
C5	42580029	42580680	BolC5t33460H	0	+	3	79	651	0.1213518
C5	42585034	42585457	BolC5t33461H	0	-	149	423	423	1.0000000
C5	42588466	42590316	BolC5t33462H	0	+	49	1037	1850	0.5605406
C5	42591305	42592559	BolC5t33463H	0	-	36	757	1254	0.6036683
C5	42608201	42610235	BolC5t33464H	0	+	133	879	2034	0.4321534
C5	42612334	42612517	BolC5t33465H	0	+	390	183	183	1.0000000
C5	42613779	42617773	BolC5t33466H	0	-	1853	3794	3994	0.9499249
C5	42620313	42620738	BolC5t33467H	0	-	15	371	425	0.8729412
C5	42629611	42630816	BolC5t33468H	0	-	399	1147	1205	0.9518672
C5	42632510	42633478	BolC5t33469H	0	-	3	198	968	0.2045455
C5	42646330	42647584	BolC5t33470H	0	-	153	919	1254	0.7328548
C5	42654288	42654766	BolC5t33471H	0	+	73	70	478	0.1464435
C5	42723463	42725974	BolC5t33472H	0	+	436	1869	2511	0.7443250
C5	42726454	42729203	BolC5t33473H	0	-	169	2256	2749	0.8206621
C5	42731642	42737237	BolC5t33474H	0	-	755	3782	5595	0.6759607
C5	42753548	42756113	BolC5t33475H	0	+	1583	2436	2565	0.9497076
C5	42756461	42756752	BolC5t33476H	0	-	43	291	291	1.0000000
C5	42764340	42766104	BolC5t33477H	0	-	646	1764	1764	1.0000000
C5	42767789	42768086	BolC5t33478H	0	+	118	297	297	1.0000000
C5	42769095	42770707	BolC5t33479H	0	+	256	1393	1612	0.8641439
C5	42771901	42772950	BolC5t33480H	0	-	34	228	1049	0.2173499
C5	42777292	42779518	BolC5t33481H	0	-	520	2196	2226	0.9865229
C5	42796070	42796430	BolC5t33482H	0	+	63	359	360	0.9972222
C5	42797335	42797593	BolC5t33483H	0	-	341	258	258	1.0000000
C5	42799674	42800059	BolC5t33484H	0	-	47	385	385	1.0000000
C5	42801292	42801589	BolC5t33485H	0	-	242	297	297	1.0000000
C5	42802696	42802969	BolC5t33486H	0	-	447	273	273	1.0000000
C5	42804678	42806073	BolC5t33487H	0	-	1492	1395	1395	1.0000000
C5	42807076	42808358	BolC5t33488H	0	-	6290	1255	1282	0.9789392
C5	42809316	42810905	BolC5t33489H	0	+	450	1480	1589	0.9314034
C5	42812039	42830052	BolC5t33490H	0	+	6679	11033	18013	0.6125021
C5	42830528	42832669	BolC5t33491H	0	-	882	2087	2141	0.9747781
C5	42839039	42841286	BolC5t33492H	0	-	1957	2247	2247	1.0000000
C5	42847688	42849315	BolC5t33493H	0	-	1232	1627	1627	1.0000000
C5	42851308	42852410	BolC5t33494H	0	-	566	1102	1102	1.0000000
C5	42855258	42857248	BolC5t33495H	0	+	811	1965	1990	0.9874372
C5	42859179	42859845	BolC5t33496H	0	-	3	127	666	0.1906907
C5	42860011	42860800	BolC5t33497H	0	-	3	153	789	0.1939164
C5	42861266	42862868	BolC5t33498H	0	-	142	1275	1602	0.7958801
C5	42863255	42864203	BolC5t33499H	0	+	358	906	948	0.9556962
C5	42870513	42871258	BolC5t33500H	0	+	69	745	745	1.0000000
C5	42875188	42887036	BolC5t33501H	0	-	3325	8615	11848	0.7271270
C5	42878594	42879801	BolC5t33502H	0	+	15	434	1207	0.3595692
C5	42895026	42895408	BolC5t33503H	0	-	316	382	382	1.0000000
C5	42898257	42900010	BolC5t33504H	0	-	273	1275	1753	0.7273246
C5	42913800	42915214	BolC5t33505H	0	-	1644	1414	1414	1.0000000
C5	42937039	42943092	BolC5t33506H	0	-	1446	4896	6053	0.8088551
C5	42944764	42945199	BolC5t33507H	0	-	36	357	435	0.8206897
C5	42948471	42950584	BolC5t33508H	0	-	100	1059	2113	0.5011832
C5	42951010	42952589	BolC5t33509H	0	-	49	287	1579	0.1817606
C5	42984473	42986096	BolC5t33510H	0	-	171	808	1623	0.4978435
C5	42989405	42991238	BolC5t33511H	0	+	48	692	1833	0.3775232
C5	42992827	42994021	BolC5t33512H	0	+	15	434	1194	0.3634841
C5	43002867	43005186	BolC5t33513H	0	+	53	309	2319	0.1332471
C5	43011982	43013080	BolC5t33514H	0	+	13	154	1098	0.1402550
C5	43014557	43015226	BolC5t33515H	0	-	376	669	669	1.0000000
C5	43017518	43018171	BolC5t33516H	0	+	273	653	653	1.0000000
C5	43019900	43024634	BolC5t33517H	0	+	560	2944	4734	0.6218842
C5	43024928	43028565	BolC5t33518H	0	-	539	2583	3637	0.7102007
C5	43029670	43029979	BolC5t33519H	0	-	0	0	309	0.0000000
C5	43030509	43034383	BolC5t33520H	0	-	35	1161	3874	0.2996902
C5	43036469	43038239	BolC5t33521H	0	-	333	1476	1770	0.8338983
C5	43040354	43040747	BolC5t33522H	0	+	192	301	393	0.7659033
C5	43043636	43044276	BolC5t33523H	0	-	6	54	640	0.0843750
C5	43045234	43045880	BolC5t33524H	0	+	0	0	646	0.0000000
C5	43046832	43047388	BolC5t33525H	0	+	5	150	556	0.2697842
C5	43063087	43063294	BolC5t33526H	0	+	0	0	207	0.0000000
C5	43077780	43081561	BolC5t33527H	0	-	49	528	3781	0.1396456
C5	43115352	43116764	BolC5t33528H	0	+	1	40	1412	0.0283286
C5	43120262	43120900	BolC5t33529H	0	+	8	208	638	0.3260188
C5	43144387	43145048	BolC5t33530H	0	+	3	44	661	0.0665658
C5	43156941	43157229	BolC5t33531H	0	+	26	13	288	0.0451389
C5	43161966	43162692	BolC5t33532H	0	-	58	541	726	0.7451791
C5	43173832	43175089	BolC5t33533H	0	-	4	271	1257	0.2155927
C5	43178550	43178955	BolC5t33534H	0	+	121	405	405	1.0000000
C5	43179656	43179917	BolC5t33535H	0	+	0	0	261	0.0000000
C5	43180831	43181940	BolC5t33536H	0	+	37	281	1109	0.2533814
C5	43189469	43189829	BolC5t33537H	0	+	1	147	360	0.4083333
C5	43190524	43190863	BolC5t33538H	0	+	1	31	339	0.0914454
C5	43193551	43193713	BolC5t33539H	0	+	0	0	162	0.0000000
C5	43207019	43207874	BolC5t33540H	0	-	43	485	855	0.5672514
C5	43211315	43212170	BolC5t33541H	0	-	37	634	855	0.7415205
C5	43489193	43490315	BolC5t33542H	0	-	6	508	1122	0.4527629
C5	43493814	43494143	BolC5t33543H	0	-	105	279	329	0.8480243
C5	43494937	43495640	BolC5t33544H	0	+	27	144	703	0.2048364
C5	43496117	43497227	BolC5t33545H	0	+	24	241	1110	0.2171171
C5	43504821	43505181	BolC5t33546H	0	+	3	167	360	0.4638889
C5	43505877	43506216	BolC5t33547H	0	+	0	0	339	0.0000000
C5	43687155	43690852	BolC5t33548H	0	+	8	314	3697	0.0849337
C5	43692469	43694394	BolC5t33549H	0	-	216	1349	1925	0.7007792
C5	43696748	43697057	BolC5t33550H	0	-	0	0	309	0.0000000
C5	43700228	43701656	BolC5t33551H	0	-	144	907	1428	0.6351541
C5	43702694	43710478	BolC5t33552H	0	-	1740	6844	7784	0.8792394
C5	43712730	43713506	BolC5t33553H	0	+	2	198	776	0.2551546
C5	43713801	43713987	BolC5t33554H	0	+	0	0	186	0.0000000
C5	43735299	43737193	BolC5t33555H	0	-	361	1394	1894	0.7360085
C5	43744812	43748116	BolC5t33556H	0	-	1445	3206	3304	0.9703390
C5	43764200	43764503	BolC5t33557H	0	+	307	303	303	1.0000000
C5	43825900	43829793	BolC5t33558H	0	+	1293	3893	3893	1.0000000
C5	43861599	43862530	BolC5t33559H	0	-	311	931	931	1.0000000
C5	43871732	43873848	BolC5t33560H	0	+	425	1970	2116	0.9310019
C5	43881638	43882349	BolC5t33561H	0	+	319	683	711	0.9606189
C5	43882434	43884751	BolC5t33562H	0	-	773	1846	2317	0.7967199
C5	43888131	43890314	BolC5t33563H	0	+	701	2144	2183	0.9821347
C5	43899527	43900319	BolC5t33564H	0	-	281	792	792	1.0000000
C5	43903916	43904933	BolC5t33565H	0	-	8	76	1017	0.0747296
C5	43905841	43908284	BolC5t33566H	0	-	703	2214	2443	0.9062628
C5	43910600	43915529	BolC5t33567H	0	-	3402	4682	4929	0.9498884
C5	43915861	43917550	BolC5t33568H	0	+	858	1493	1689	0.8839550
C5	43919131	43920911	BolC5t33569H	0	+	803	1749	1780	0.9825843
C5	43926017	43926506	BolC5t33570H	0	-	44	413	489	0.8445808
C5	43930943	43931069	BolC5t33571H	0	+	0	0	126	0.0000000
C5	43936452	43937066	BolC5t33572H	0	+	57	460	614	0.7491857
C5	43937514	43938452	BolC5t33573H	0	+	155	873	938	0.9307036
C5	43938776	43943926	BolC5t33574H	0	-	598	3261	5150	0.6332039
C5	43950311	43950683	BolC5t33575H	0	-	61	372	372	1.0000000
C5	43953019	43955335	BolC5t33576H	0	-	1634	2316	2316	1.0000000
C5	43957443	43958050	BolC5t33577H	0	-	93	483	607	0.7957166
C5	43958589	43960925	BolC5t33578H	0	-	1173	2336	2336	1.0000000
C5	43969276	43972098	BolC5t33579H	0	-	1061	2785	2822	0.9868887
C5	43994200	43994673	BolC5t33580H	0	+	0	0	473	0.0000000
C5	44008378	44009492	BolC5t33581H	0	+	525	1110	1114	0.9964094
C5	44012453	44012784	BolC5t33582H	0	-	201	331	331	1.0000000
C5	44012998	44013268	BolC5t33583H	0	-	170	270	270	1.0000000
C5	44025097	44025512	BolC5t33584H	0	-	337	415	415	1.0000000
C5	44044420	44050436	BolC5t33585H	0	+	3040	5180	6016	0.8610373
C5	44051934	44053947	BolC5t33586H	0	-	495	1873	2013	0.9304520
C5	44055293	44057720	BolC5t33587H	0	-	915	2194	2427	0.9039967
C5	44060603	44062331	BolC5t33588H	0	-	592	1668	1728	0.9652778
C5	44068885	44070767	BolC5t33589H	0	-	1206	1882	1882	1.0000000
C5	44072118	44073747	BolC5t33590H	0	+	802	1629	1629	1.0000000
C5	44074202	44075409	BolC5t33591H	0	-	245	801	1207	0.6636288
C5	44077125	44078294	BolC5t33592H	0	-	980	1157	1169	0.9897348
C5	44079793	44083700	BolC5t33593H	0	+	846	2497	3907	0.6391093
C5	44084614	44086755	BolC5t33594H	0	+	659	2001	2141	0.9346100
C5	44087450	44091419	BolC5t33595H	0	-	1575	3302	3969	0.8319476
C5	44098176	44098482	BolC5t33596H	0	+	86	306	306	1.0000000
C5	44106954	44109336	BolC5t33597H	0	-	1211	2332	2382	0.9790092
C5	44113847	44114597	BolC5t33598H	0	-	627	750	750	1.0000000
C5	44114797	44116178	BolC5t33599H	0	-	761	1381	1381	1.0000000
C5	44119388	44124056	BolC5t33600H	0	+	2091	4574	4668	0.9798629
C5	44131410	44132529	BolC5t33601H	0	+	410	1066	1119	0.9526363
C5	44150572	44152373	BolC5t33602H	0	-	213	1491	1801	0.8278734
C5	44155059	44158314	BolC5t33603H	0	-	2940	3020	3255	0.9278034
C5	44163192	44164177	BolC5t33604H	0	+	65	694	985	0.7045685
C5	44169538	44172670	BolC5t33605H	0	-	696	2271	3132	0.7250958
C5	44175368	44178606	BolC5t33606H	0	-	1045	3193	3238	0.9861025
C5	44181194	44183384	BolC5t33607H	0	+	311	1806	2190	0.8246576
C5	44183705	44184754	BolC5t33608H	0	-	625	1049	1049	1.0000000
C5	44185312	44187382	BolC5t33609H	0	-	1373	1998	2070	0.9652174
C5	44190159	44191347	BolC5t33610H	0	-	133	989	1188	0.8324916
C5	44192363	44198666	BolC5t33611H	0	-	747	2647	6303	0.4199587
C5	44199265	44200348	BolC5t33612H	0	-	506	1083	1083	1.0000000
C5	44201926	44202557	BolC5t33613H	0	-	108	608	631	0.9635499
C5	44211159	44211549	BolC5t33614H	0	+	228	390	390	1.0000000
C5	44213259	44214017	BolC5t33615H	0	+	723	758	758	1.0000000
C5	44214608	44216638	BolC5t33616H	0	+	1342	2030	2030	1.0000000
C5	44218565	44218814	BolC5t33617H	0	-	195	249	249	1.0000000
C5	44227635	44228768	BolC5t33618H	0	-	285	1133	1133	1.0000000
C5	44249195	44249438	BolC5t33619H	0	-	136	243	243	1.0000000
C5	44256564	44256831	BolC5t33620H	0	+	155	267	267	1.0000000
C5	44257642	44258533	BolC5t33621H	0	+	159	598	891	0.6711560
C5	44270531	44272617	BolC5t33622H	0	+	259	1452	2086	0.6960690
C5	44276943	44280388	BolC5t33623H	0	+	518	2847	3445	0.8264151
C5	44282660	44284283	BolC5t33624H	0	+	461	1623	1623	1.0000000
C5	44286741	44287004	BolC5t33625H	0	+	221	263	263	1.0000000
C5	44287405	44287804	BolC5t33626H	0	-	129	399	399	1.0000000
C5	44297153	44298110	BolC5t33627H	0	+	556	957	957	1.0000000
C5	44299055	44299625	BolC5t33628H	0	-	441	570	570	1.0000000
C5	44318983	44319283	BolC5t33629H	0	-	376	300	300	1.0000000
C5	44334324	44336761	BolC5t33630H	0	-	1676	2437	2437	1.0000000
C5	44344061	44345053	BolC5t33631H	0	-	303	992	992	1.0000000
C5	44357937	44359112	BolC5t33632H	0	-	674	1175	1175	1.0000000
C5	44361945	44366016	BolC5t33633H	0	+	69	2152	4071	0.5286170
C5	44366650	44366833	BolC5t33634H	0	+	13	129	183	0.7049180
C5	44371721	44372910	BolC5t33635H	0	-	18	401	1189	0.3372582
C5	44372980	44373312	BolC5t33636H	0	-	3	166	332	0.5000000
C5	44374219	44375549	BolC5t33637H	0	+	276	1233	1330	0.9270677
C5	44376008	44376569	BolC5t33638H	0	+	444	561	561	1.0000000
C5	44377887	44379954	BolC5t33639H	0	+	1452	2067	2067	1.0000000
C5	44380825	44382656	BolC5t33640H	0	-	1512	1831	1831	1.0000000
C5	44403450	44405224	BolC5t33641H	0	+	377	1768	1774	0.9966178
C5	44407484	44410341	BolC5t33642H	0	-	865	2833	2857	0.9915996
C5	44413859	44423835	BolC5t33643H	0	-	771	4018	9976	0.4027666
C5	44428285	44429534	BolC5t33644H	0	-	329	1203	1249	0.9631705
C5	44432475	44438898	BolC5t33645H	0	+	1895	5683	6423	0.8847890
C5	44456342	44459849	BolC5t33646H	0	+	743	3114	3507	0.8879384
C5	44460819	44461154	BolC5t33647H	0	+	61	114	335	0.3402985
C5	44461650	44462703	BolC5t33648H	0	+	989	1053	1053	1.0000000
C5	44478770	44479160	BolC5t33649H	0	-	392	390	390	1.0000000
C5	44478878	44479160	BolC5t33650H	0	-	358	282	282	1.0000000
C5	44492375	44494622	BolC5t33651H	0	+	673	1558	2247	0.6933689
C5	44507413	44508442	BolC5t33652H	0	+	290	977	1029	0.9494655
C5	44514203	44515442	BolC5t33653H	0	+	509	1228	1239	0.9911219
C5	44517791	44519260	BolC5t33654H	0	+	950	1469	1469	1.0000000
C5	44520097	44522271	BolC5t33655H	0	+	950	1944	2174	0.8942043
C5	44523284	44525294	BolC5t33656H	0	+	4	85	2010	0.0422886
C5	44533279	44533653	BolC5t33657H	0	-	13	201	374	0.5374331
C5	44537799	44538054	BolC5t33658H	0	+	71	255	255	1.0000000
C5	44538948	44539494	BolC5t33659H	0	+	84	540	546	0.9890110
C5	44566975	44568140	BolC5t33660H	0	+	20	324	1165	0.2781116
C5	44585536	44587586	BolC5t33661H	0	-	188	1057	2050	0.5156097
C5	44593803	44594173	BolC5t33662H	0	-	66	294	370	0.7945946
C5	44604100	44604661	BolC5t33663H	0	+	18	64	561	0.1140820
C5	44618420	44618576	BolC5t33664H	0	+	1	144	156	0.9230769
C5	44628120	44629022	BolC5t33665H	0	-	0	0	902	0.0000000
C5	44677760	44684416	BolC5t33666H	0	-	1808	4267	6656	0.6410757
C5	44717675	44718369	BolC5t33667H	0	-	178	619	694	0.8919308
C5	44726791	44727825	BolC5t33668H	0	-	39	716	1034	0.6924565
C5	44728375	44729472	BolC5t33669H	0	-	15	322	1097	0.2935278
C5	44730760	44731036	BolC5t33670H	0	+	273	276	276	1.0000000
C5	44731304	44731949	BolC5t33671H	0	-	413	645	645	1.0000000
C5	44734403	44734955	BolC5t33672H	0	+	12	61	552	0.1105072
C5	44735650	44736514	BolC5t33673H	0	-	77	849	864	0.9826389
C5	44764125	44764662	BolC5t33674H	0	-	161	537	537	1.0000000
C5	44783603	44784236	BolC5t33675H	0	-	219	633	633	1.0000000
C5	44790141	44790471	BolC5t33676H	0	-	731	330	330	1.0000000
C5	44790775	44794784	BolC5t33677H	0	-	1540	3743	4009	0.9336493
C5	44802912	44805905	BolC5t33678H	0	-	1473	2922	2993	0.9762780
C5	44809239	44812795	BolC5t33679H	0	-	30	282	3556	0.0793026
C5	44813529	44815833	BolC5t33680H	0	-	319	578	2304	0.2508681
C5	44816718	44818930	BolC5t33681H	0	+	757	2093	2212	0.9462025
C5	44823252	44824724	BolC5t33682H	0	+	161	1069	1472	0.7262228
C5	44825217	44826150	BolC5t33683H	0	-	1351	915	933	0.9807074
C5	44827132	44831052	BolC5t33684H	0	-	621	2369	3920	0.6043367
C5	44834944	44835148	BolC5t33685H	0	+	49	204	204	1.0000000
C5	44848884	44851630	BolC5t33686H	0	+	789	2513	2746	0.9151493
C5	44852245	44853327	BolC5t33687H	0	+	1579	1082	1082	1.0000000
C5	44853726	44855258	BolC5t33688H	0	-	1119	1532	1532	1.0000000
C5	44861684	44861984	BolC5t33689H	0	-	254	300	300	1.0000000
C5	44868282	44874740	BolC5t33690H	0	+	1098	5863	6458	0.9078662
C5	44875293	44875981	BolC5t33691H	0	-	175	293	688	0.4258721
C5	44884308	44888564	BolC5t33692H	0	-	1186	3871	4256	0.9095395
C5	44902062	44902923	BolC5t33693H	0	-	0	0	861	0.0000000
C5	44929753	44930337	BolC5t33694H	0	+	634	584	584	1.0000000
C5	44932165	44932762	BolC5t33695H	0	+	166	537	597	0.8994975
C5	44933392	44935360	BolC5t33696H	0	+	649	1679	1968	0.8531504
C5	44947857	44950290	BolC5t33697H	0	+	799	2317	2433	0.9523222
C5	44951694	44952268	BolC5t33698H	0	+	712	574	574	1.0000000
C5	44952667	44956059	BolC5t33699H	0	-	1089	3235	3392	0.9537146
C5	44961190	44962850	BolC5t33700H	0	-	470	1637	1660	0.9861446
C5	44980256	44985508	BolC5t33701H	0	-	2819	5153	5252	0.9811500
C5	44989768	44990005	BolC5t33702H	0	+	2	52	237	0.2194093
C5	45009298	45010574	BolC5t33703H	0	+	117	1130	1276	0.8855799
C5	45013839	45013998	BolC5t33704H	0	-	45	159	159	1.0000000
C5	45014221	45014521	BolC5t33705H	0	-	27	292	300	0.9733334
C5	45025585	45029195	BolC5t33706H	0	+	1094	3537	3610	0.9797784
C5	45030203	45032011	BolC5t33707H	0	-	1010	1634	1808	0.9037611
C5	45033992	45035479	BolC5t33708H	0	-	553	1432	1487	0.9630128
C5	45045232	45052459	BolC5t33709H	0	-	2383	6177	7227	0.8547115
C5	45054305	45058067	BolC5t33710H	0	-	1295	3505	3762	0.9316853
C5	45059916	45060656	BolC5t33711H	0	+	2	21	740	0.0283784
C5	45061107	45062180	BolC5t33712H	0	-	468	1073	1073	1.0000000
C5	45064069	45064507	BolC5t33713H	0	+	2	140	438	0.3196347
C5	45078257	45084452	BolC5t33714H	0	+	53	1360	6195	0.2195319
C5	45094848	45095437	BolC5t33715H	0	-	2035	580	589	0.9847199
C5	45103164	45106312	BolC5t33716H	0	+	1957	3146	3148	0.9993647
C5	45108212	45109019	BolC5t33717H	0	-	157	749	807	0.9281289
C5	45109539	45110646	BolC5t33718H	0	+	222	739	1107	0.6675700
C5	45132539	45133680	BolC5t33719H	0	+	494	1086	1141	0.9517967
C5	45144251	45144648	BolC5t33720H	0	+	170	397	397	1.0000000
C5	45147107	45152199	BolC5t33721H	0	+	1506	3245	5092	0.6372741
C5	45165526	45168583	BolC5t33722H	0	+	158	1575	3057	0.5152110
C5	45172963	45173806	BolC5t33723H	0	+	952	843	843	1.0000000
C5	45191773	45198402	BolC5t33724H	0	+	1634	4214	6629	0.6356916
C5	45194195	45195269	BolC5t33725H	0	+	78	503	1074	0.4683426
C5	45223974	45224358	BolC5t33726H	0	-	234	384	384	1.0000000
C5	45232883	45234842	BolC5t33727H	0	+	1667	1959	1959	1.0000000
C5	45240678	45242290	BolC5t33728H	0	+	445	1445	1612	0.8964020
C5	45243838	45246029	BolC5t33729H	0	+	1412	2191	2191	1.0000000
C5	45250133	45251463	BolC5t33730H	0	+	260	1255	1330	0.9436090
C5	45272856	45274299	BolC5t33731H	0	+	168	889	1443	0.6160776
C5	45276135	45279252	BolC5t33732H	0	-	1869	2551	3117	0.8184152
C5	45282533	45282912	BolC5t33733H	0	-	17	84	379	0.2216359
C5	45289056	45289518	BolC5t33734H	0	+	0	0	462	0.0000000
C5	45313140	45315442	BolC5t33735H	0	+	2504	1906	2302	0.8279757
C5	45315281	45315733	BolC5t33736H	0	+	52	319	452	0.7057522
C5	45322963	45336990	BolC5t33737H	0	-	2544	9339	14027	0.6657874
C5	45340888	45341627	BolC5t33738H	0	+	209	739	739	1.0000000
C5	45371104	45371332	BolC5t33739H	0	-	0	0	228	0.0000000
C5	45381151	45382774	BolC5t33740H	0	+	437	1287	1623	0.7929760
C5	45383172	45385508	BolC5t33741H	0	-	2099	2336	2336	1.0000000
C5	45400311	45402746	BolC5t33742H	0	-	1099	2359	2435	0.9687885
C5	45410978	45413761	BolC5t33743H	0	+	65	1200	2783	0.4311894
C5	45443369	45443712	BolC5t33744H	0	+	12	40	343	0.1166181
C5	45460062	45460461	BolC5t33745H	0	+	57	398	399	0.9974937
C5	45465898	45466141	BolC5t33746H	0	-	19	167	243	0.6872428
C5	45468002	45468474	BolC5t33747H	0	+	88	468	472	0.9915254
C5	45478465	45480333	BolC5t33748H	0	-	1046	1858	1868	0.9946467
C5	45507069	45507981	BolC5t33749H	0	+	0	0	912	0.0000000
C5	45523250	45524483	BolC5t33750H	0	-	152	1214	1233	0.9845904
C5	45548647	45548977	BolC5t33751H	0	-	241	270	330	0.8181818
C5	45555953	45556151	BolC5t33752H	0	-	1	1	198	0.0050505
C5	45560368	45561238	BolC5t33753H	0	-	2	62	870	0.0712644
C5	45584336	45586179	BolC5t33754H	0	+	81	1257	1843	0.6820402
C5	45614426	45614819	BolC5t33755H	0	+	482	393	393	1.0000000
C5	45619768	45620695	BolC5t33756H	0	+	141	412	927	0.4444444
C5	45632167	45633012	BolC5t33757H	0	+	10	23	845	0.0272189
C5	45638552	45640899	BolC5t33758H	0	+	315	1766	2347	0.7524499
C5	45642398	45647515	BolC5t33759H	0	+	86	996	5117	0.1946453
C5	45647889	45648072	BolC5t33760H	0	+	0	0	183	0.0000000
C5	45648587	45650011	BolC5t33761H	0	-	225	1109	1424	0.7787921
C5	45651390	45652376	BolC5t33762H	0	-	387	872	986	0.8843814
C5	45685101	45686880	BolC5t33763H	0	-	1120	1779	1779	1.0000000
C5	45687889	45696529	BolC5t33764H	0	-	1747	7597	8640	0.8792824
C5	45720091	45720847	BolC5t33765H	0	+	93	567	756	0.7500000
C5	45721728	45722184	BolC5t33766H	0	-	46	422	456	0.9254386
C5	45730138	45730762	BolC5t33767H	0	-	216	624	624	1.0000000
C5	45731991	45736289	BolC5t33768H	0	-	1486	3570	4298	0.8306189
C5	45738666	45741601	BolC5t33769H	0	+	1898	2892	2935	0.9853492
C5	45742353	45742506	BolC5t33770H	0	+	181	153	153	1.0000000
C5	45750821	45751645	BolC5t33771H	0	-	641	824	824	1.0000000
C5	45756492	45760313	BolC5t33772H	0	+	2530	3656	3821	0.9568176
C5	45760877	45764339	BolC5t33773H	0	+	987	1688	3462	0.4875794
C5	45777643	45778366	BolC5t33774H	0	-	39	262	723	0.3623790
C5	45780706	45783345	BolC5t33775H	0	-	217	1564	2639	0.5926487
C5	45784093	45788335	BolC5t33776H	0	-	1686	4052	4242	0.9552098
C5	45799578	45800807	BolC5t33777H	0	+	1589	1229	1229	1.0000000
C5	45801070	45802570	BolC5t33778H	0	-	597	1412	1500	0.9413334
C5	45818469	45819561	BolC5t33779H	0	+	812	1081	1092	0.9899268
C5	45822282	45826119	BolC5t33780H	0	+	1339	3667	3837	0.9556946
C5	45831172	45835298	BolC5t33781H	0	+	1151	3480	4126	0.8434319
C5	45837033	45840828	BolC5t33782H	0	-	1264	3626	3795	0.9554677
C5	45842580	45843799	BolC5t33783H	0	-	541	1171	1219	0.9606234
C5	45875326	45876259	BolC5t33784H	0	+	384	933	933	1.0000000
C5	45876411	45878700	BolC5t33785H	0	-	790	2160	2289	0.9436435
C5	45879422	45879795	BolC5t33786H	0	-	6	108	373	0.2895442
C5	45883146	45884333	BolC5t33787H	0	+	407	550	1187	0.4633530
C5	45890578	45891037	BolC5t33788H	0	+	155	459	459	1.0000000
C5	45897006	45900497	BolC5t33789H	0	-	1326	3166	3491	0.9069034
C5	45903860	45908200	BolC5t33790H	0	-	3542	4284	4340	0.9870968
C5	45915305	45917869	BolC5t33791H	0	+	728	2024	2564	0.7893916
C5	45918204	45922903	BolC5t33792H	0	-	1561	4051	4699	0.8620983
C5	45940772	45941252	BolC5t33793H	0	-	0	0	480	0.0000000
C5	45946667	45951262	BolC5t33794H	0	+	1539	3949	4595	0.8594124
C5	45954473	45954968	BolC5t33795H	0	+	142	375	495	0.7575758
C5	45964964	45965306	BolC5t33796H	0	-	7	273	342	0.7982456
C5	45974191	45976537	BolC5t33797H	0	+	635	2180	2346	0.9292412
C5	45977192	45978656	BolC5t33798H	0	-	1453	1449	1464	0.9897541
C5	45982280	45982781	BolC5t33799H	0	+	42	302	501	0.6027944
C5	45985344	45987207	BolC5t33800H	0	-	845	1840	1863	0.9876543
C5	45987802	45989287	BolC5t33801H	0	+	304	847	1485	0.5703704
C5	45990208	45992157	BolC5t33802H	0	-	500	1328	1949	0.6813751
C5	46007405	46008360	BolC5t33803H	0	+	18	425	955	0.4450262
C5	46009283	46010984	BolC5t33804H	0	-	59	1039	1701	0.6108172
C5	46025965	46026990	BolC5t33805H	0	-	680	1004	1025	0.9795122
C5	46027628	46029770	BolC5t33806H	0	-	1662	2106	2142	0.9831933
C5	46031954	46032439	BolC5t33807H	0	-	97	485	485	1.0000000
C5	46034170	46037236	BolC5t33808H	0	-	617	2609	3066	0.8509458
C5	46045074	46045275	BolC5t33809H	0	-	0	0	201	0.0000000
C5	46051264	46053358	BolC5t33810H	0	+	36	1042	2094	0.4976122
C5	46053825	46054305	BolC5t33811H	0	-	84	282	480	0.5875000
C5	46057958	46058446	BolC5t33812H	0	-	630	488	488	1.0000000
C5	46060713	46061247	BolC5t33813H	0	-	172	463	534	0.8670412
C5	46068279	46070953	BolC5t33814H	0	+	130	1590	2674	0.5946148
C5	46079071	46080181	BolC5t33815H	0	-	300	1098	1110	0.9891892
C5	46083066	46085085	BolC5t33816H	0	-	96	895	2019	0.4432887
C5	46102937	46104059	BolC5t33817H	0	-	298	1082	1122	0.9643494
C5	46111829	46112252	BolC5t33818H	0	-	243	423	423	1.0000000
C5	46113894	46115183	BolC5t33819H	0	+	1188	1289	1289	1.0000000
C5	46115433	46117477	BolC5t33820H	0	-	1179	2044	2044	1.0000000
C5	46118068	46119856	BolC5t33821H	0	-	1318	1788	1788	1.0000000
C5	46121734	46121935	BolC5t33822H	0	+	3	136	201	0.6766169
C5	46122339	46123350	BolC5t33823H	0	-	180	899	1011	0.8892186
C5	46129216	46129336	BolC5t33824H	0	+	1	91	120	0.7583333
C5	46132919	46133120	BolC5t33825H	0	+	56	188	201	0.9353234
C5	46134316	46134531	BolC5t33826H	0	-	0	0	215	0.0000000
C5	46145004	46145316	BolC5t33827H	0	+	0	0	312	0.0000000
C5	46147786	46149353	BolC5t33828H	0	-	800	1542	1567	0.9840459
C5	46155727	46159860	BolC5t33829H	0	-	2984	4133	4133	1.0000000
C5	46161564	46164878	BolC5t33830H	0	-	541	2651	3314	0.7999396
C5	46166175	46169427	BolC5t33831H	0	+	1303	2878	3252	0.8849939
C5	46171485	46174410	BolC5t33832H	0	+	604	2637	2925	0.9015385
C5	46174805	46177717	BolC5t33833H	0	-	1538	2901	2912	0.9962226
C5	46179235	46180387	BolC5t33834H	0	-	2	19	1152	0.0164931
C5	46181803	46188940	BolC5t33835H	0	+	263	2819	7137	0.3949839
C5	46216066	46216180	BolC5t33836H	0	-	127	114	114	1.0000000
C5	46218735	46220164	BolC5t33837H	0	-	507	1429	1429	1.0000000
C5	46226057	46228322	BolC5t33838H	0	+	884	2065	2265	0.9116998
C5	46229651	46233874	BolC5t33839H	0	-	186	2031	4223	0.4809377
C5	46235395	46235611	BolC5t33840H	0	+	0	0	216	0.0000000
C5	46236733	46237225	BolC5t33841H	0	+	24	133	492	0.2703252
C5	46239508	46240696	BolC5t33842H	0	-	122	940	1188	0.7912458
C5	46258031	46258639	BolC5t33843H	0	+	585	608	608	1.0000000
C5	46260442	46261436	BolC5t33844H	0	+	215	994	994	1.0000000
C5	46281228	46281435	BolC5t33845H	0	-	88	207	207	1.0000000
C5	46308408	46309356	BolC5t33846H	0	+	238	893	948	0.9419831
C5	46310847	46313532	BolC5t33847H	0	-	12	348	2685	0.1296089
C5	46314762	46317223	BolC5t33848H	0	+	1135	2154	2461	0.8752540
C5	46317404	46317725	BolC5t33849H	0	-	36	316	321	0.9844237
C5	46344253	46345680	BolC5t33850H	0	-	541	1229	1427	0.8612474
C5	46359630	46360254	BolC5t33851H	0	-	33	177	624	0.2836539
C5	46375474	46377169	BolC5t33852H	0	-	167	1312	1695	0.7740413
C5	46386706	46388250	BolC5t33853H	0	+	470	1251	1544	0.8102332
C5	46395575	46396677	BolC5t33854H	0	-	152	980	1102	0.8892922
C5	46400019	46400967	BolC5t33855H	0	+	418	900	948	0.9493671
C5	46405885	46406170	BolC5t33856H	0	+	53	285	285	1.0000000
C5	46425592	46430625	BolC5t33857H	0	+	1920	4182	5033	0.8309159
C5	46431436	46432292	BolC5t33858H	0	-	494	856	856	1.0000000
C5	46438360	46440261	BolC5t33859H	0	-	281	1844	1901	0.9700158
C5	46441190	46445153	BolC5t33860H	0	-	972	2726	3963	0.6878628
C5	46449073	46449418	BolC5t33861H	0	+	9	137	345	0.3971015
C5	46449828	46451514	BolC5t33862H	0	-	752	1686	1686	1.0000000
C5	46451883	46452134	BolC5t33863H	0	-	409	251	251	1.0000000
C5	46454360	46457281	BolC5t33864H	0	+	1109	2894	2921	0.9907566
C5	46457516	46460214	BolC5t33865H	0	-	1388	2487	2698	0.9217939
C5	46478031	46479107	BolC5t33866H	0	-	206	944	1076	0.8773234
C5	46485777	46486920	BolC5t33867H	0	-	402	886	1143	0.7751531
C5	46487740	46488169	BolC5t33868H	0	-	594	429	429	1.0000000
C5	46488616	46491185	BolC5t33869H	0	-	899	2470	2569	0.9614636
C5	46499331	46499742	BolC5t33870H	0	+	325	411	411	1.0000000
C5	46500366	46501209	BolC5t33871H	0	+	418	843	843	1.0000000
C5	46501411	46501846	BolC5t33872H	0	-	37	352	435	0.8091954
C5	46513778	46514609	BolC5t33873H	0	+	38	116	831	0.1395909
C5	46531184	46532015	BolC5t33874H	0	+	13	214	831	0.2575211
C5	46536056	46538971	BolC5t33875H	0	+	661	2720	2915	0.9331046
C5	46539354	46540892	BolC5t33876H	0	-	336	1487	1538	0.9668400
C5	46553751	46555970	BolC5t33877H	0	+	1091	2208	2219	0.9950428
C5	46563444	46564122	BolC5t33878H	0	+	187	662	678	0.9764012
C5	46564647	46565517	BolC5t33879H	0	-	238	833	870	0.9574713
C5	46567190	46568478	BolC5t33880H	0	-	729	1264	1288	0.9813665
C5	46568795	46569388	BolC5t33881H	0	+	220	593	593	1.0000000
C5	46572103	46572715	BolC5t33882H	0	+	86	447	612	0.7303922
C5	46573100	46574643	BolC5t33883H	0	-	1195	1543	1543	1.0000000
C5	46586498	46587128	BolC5t33884H	0	+	307	613	630	0.9730158
C5	46588829	46591109	BolC5t33885H	0	-	176	1168	2280	0.5122807
C5	46595839	46600590	BolC5t33886H	0	+	1573	4562	4751	0.9602189
C5	46603024	46603210	BolC5t33887H	0	-	299	186	186	1.0000000
C5	46627649	46628303	BolC5t33888H	0	-	190	654	654	1.0000000
C5	46634838	46636425	BolC5t33889H	0	+	953	1587	1587	1.0000000
C5	46637660	46642706	BolC5t33890H	0	-	3992	5004	5046	0.9916766
C5	46651078	46651291	BolC5t33891H	0	+	32	208	213	0.9765258
C5	46654922	46655545	BolC5t33892H	0	-	524	623	623	1.0000000
C5	46658102	46659710	BolC5t33893H	0	+	510	1608	1608	1.0000000
C5	46660064	46661757	BolC5t33894H	0	+	724	1594	1693	0.9415239
C5	46663163	46663975	BolC5t33895H	0	+	34	572	812	0.7044335
C5	46664741	46666222	BolC5t33896H	0	+	716	1481	1481	1.0000000
C5	46666558	46668442	BolC5t33897H	0	-	1197	1876	1884	0.9957537
C5	46672580	46676713	BolC5t33898H	0	-	2182	4065	4133	0.9835470
C5	46681685	46683383	BolC5t33899H	0	+	636	1667	1698	0.9817432
C5	46687268	46687919	BolC5t33900H	0	+	300	651	651	1.0000000
C5	46689760	46690975	BolC5t33901H	0	-	750	1202	1215	0.9893004
C5	46704700	46706522	BolC5t33902H	0	-	1258	1787	1822	0.9807903
C5	46707187	46709525	BolC5t33903H	0	+	655	2205	2338	0.9431137
C5	46710422	46711352	BolC5t33904H	0	+	122	785	930	0.8440861
C5	46718780	46720787	BolC5t33905H	0	-	607	1841	2007	0.9172895
C5	46746446	46746790	BolC5t33906H	0	-	129	344	344	1.0000000
C5	46748979	46753126	BolC5t33907H	0	+	2112	3910	4147	0.9428502
C5	46753838	46755624	BolC5t33908H	0	+	420	1779	1786	0.9960806
C5	46761299	46763969	BolC5t33909H	0	+	618	2416	2670	0.9048689
C5	46765034	46768933	BolC5t33910H	0	-	1571	3675	3899	0.9425493
C5	46773984	46774137	BolC5t33911H	0	-	0	0	153	0.0000000
C5	46776430	46778446	BolC5t33912H	0	-	571	1870	2016	0.9275793
C5	46779196	46781151	BolC5t33913H	0	-	587	1955	1955	1.0000000
C5	46781566	46783402	BolC5t33914H	0	+	73	1112	1836	0.6056645
C5	46783807	46787905	BolC5t33915H	0	-	1064	3982	4098	0.9716935
C5	46789096	46789984	BolC5t33916H	0	-	53	561	888	0.6317568
C5	46789968	46795744	BolC5t33917H	0	+	1619	3543	5776	0.6134003
C5	46798822	46800012	BolC5t33918H	0	-	577	1157	1190	0.9722689
C5	46802631	46803930	BolC5t33919H	0	-	322	1091	1299	0.8398768
C5	46814178	46815655	BolC5t33920H	0	-	156	448	1477	0.3033175
C5	46816265	46816703	BolC5t33921H	0	-	17	60	438	0.1369863
C5	46816841	46833115	BolC5t33922H	0	-	2826	8842	16274	0.5433207
C5	46848704	46850181	BolC5t33923H	0	-	15	369	1477	0.2498307
C5	46851351	46863106	BolC5t33924H	0	-	3971	8273	11755	0.7037856
C5	46924483	46926568	BolC5t33925H	0	+	722	1919	2085	0.9203837
C5	46931147	46932043	BolC5t33926H	0	+	2	47	896	0.0524554
C5	46944444	46944837	BolC5t33927H	0	-	389	393	393	1.0000000
C5	46948309	46949206	BolC5t33928H	0	+	0	0	897	0.0000000
C5	46986560	46988461	BolC5t33929H	0	-	878	1901	1901	1.0000000
C5	46990371	46991484	BolC5t33930H	0	+	137	765	1113	0.6873316
C5	46991860	46993949	BolC5t33931H	0	-	110	1229	2089	0.5883198
C5	47009642	47011106	BolC5t33932H	0	+	837	1464	1464	1.0000000
C5	47034984	47036612	BolC5t33933H	0	+	532	1628	1628	1.0000000
C5	47037131	47038249	BolC5t33934H	0	+	314	1118	1118	1.0000000
C5	47040436	47042931	BolC5t33935H	0	-	662	2336	2495	0.9362726
C5	47052757	47052982	BolC5t33936H	0	-	206	225	225	1.0000000
C5	47054510	47056457	BolC5t33937H	0	-	744	1799	1947	0.9239856
C5	47059999	47060416	BolC5t33938H	0	-	170	417	417	1.0000000
C5	47065597	47066176	BolC5t33939H	0	+	345	579	579	1.0000000
C5	47072897	47073876	BolC5t33940H	0	+	0	0	979	0.0000000
C5	47088458	47089439	BolC5t33941H	0	+	1	42	981	0.0428135
C5	47102828	47109388	BolC5t33942H	0	-	3902	6219	6560	0.9480183
C5	47109849	47111710	BolC5t33943H	0	-	777	1861	1861	1.0000000
C5	47114670	47115349	BolC5t33944H	0	-	381	646	679	0.9513991
C5	47133511	47141835	BolC5t33945H	0	+	1696	3090	8324	0.3712158
C5	47164230	47165455	BolC5t33946H	0	-	205	1058	1225	0.8636734
C5	47174213	47177299	BolC5t33947H	0	+	879	2927	3086	0.9484770
C5	47177579	47178797	BolC5t33948H	0	-	411	1218	1218	1.0000000
C5	47180438	47180982	BolC5t33949H	0	+	151	544	544	1.0000000
C5	47187415	47197667	BolC5t33950H	0	-	3689	9920	10252	0.9676161
C5	47206668	47207133	BolC5t33951H	0	-	132	388	465	0.8344086
C5	47221831	47223124	BolC5t33952H	0	+	1620	1293	1293	1.0000000
C5	47290116	47292865	BolC5t33953H	0	+	1632	2749	2749	1.0000000
C5	47293695	47295365	BolC5t33954H	0	-	865	1631	1670	0.9766467
C5	47301690	47303301	BolC5t33955H	0	-	622	1611	1611	1.0000000
C5	47303990	47305944	BolC5t33956H	0	+	735	1954	1954	1.0000000
C5	47317301	47317937	BolC5t33957H	0	-	60	516	636	0.8113208
C5	47320648	47330803	BolC5t33958H	0	-	3869	9787	10155	0.9637617
C5	47332413	47336241	BolC5t33959H	0	+	387	1675	3828	0.4375653
C5	47336812	47338871	BolC5t33960H	0	-	1507	2059	2059	1.0000000
C5	47346196	47346439	BolC5t33961H	0	+	271	243	243	1.0000000
C5	47411104	47412061	BolC5t33962H	0	+	2	37	957	0.0386625
C5	47423980	47424730	BolC5t33963H	0	-	2	116	750	0.1546667
C5	47424965	47425722	BolC5t33964H	0	-	0	0	757	0.0000000
C5	47469542	47470238	BolC5t33965H	0	+	0	0	696	0.0000000
C5	47486507	47488301	BolC5t33966H	0	+	34	1217	1794	0.6783723
C5	47517486	47517812	BolC5t33967H	0	+	143	326	326	1.0000000
C5	47518314	47520248	BolC5t33968H	0	-	735	1831	1934	0.9467425
C5	47521622	47524342	BolC5t33969H	0	-	1469	2610	2720	0.9595588
C5	47525674	47527324	BolC5t33970H	0	+	638	1581	1650	0.9581818
C5	47528044	47531047	BolC5t33971H	0	+	308	2043	3003	0.6803197
C5	47531567	47531798	BolC5t33972H	0	-	49	169	231	0.7316017
C5	47545852	47546450	BolC5t33973H	0	+	23	133	598	0.2224080
C5	47558254	47559697	BolC5t33974H	0	+	103	1201	1443	0.8322938
C5	47572169	47573880	BolC5t33975H	0	+	36	856	1711	0.5002922
C5	47576303	47576438	BolC5t33976H	0	+	94	135	135	1.0000000
C5	47578518	47578665	BolC5t33977H	0	+	6	129	147	0.8775510
C5	47579321	47581209	BolC5t33978H	0	-	445	1710	1888	0.9057204
C5	47585134	47585413	BolC5t33979H	0	-	22	279	279	1.0000000
C5	47585631	47585784	BolC5t33980H	0	-	7	25	153	0.1633987
C5	47589125	47593285	BolC5t33981H	0	+	1393	4099	4160	0.9853365
C5	47593952	47594385	BolC5t33982H	0	+	215	433	433	1.0000000
C5	47599648	47600120	BolC5t33983H	0	-	72	263	472	0.5572034
C5	47601456	47601996	BolC5t33984H	0	+	243	540	540	1.0000000
C5	47604321	47604510	BolC5t33985H	0	+	841	189	189	1.0000000
C5	47610929	47614197	BolC5t33986H	0	+	1285	3012	3268	0.9216647
C5	47616811	47617450	BolC5t33987H	0	+	420	639	639	1.0000000
C5	47618166	47619185	BolC5t33988H	0	+	1018	1019	1019	1.0000000
C5	47620957	47623270	BolC5t33989H	0	+	135	1449	2313	0.6264591
C5	47632362	47633336	BolC5t33990H	0	+	250	618	974	0.6344969
C5	47636548	47639451	BolC5t33991H	0	+	215	1356	2903	0.4671030
C5	47648946	47649905	BolC5t33992H	0	-	37	78	959	0.0813347
C5	47652095	47655769	BolC5t33993H	0	+	1926	3112	3674	0.8470332
C5	47655929	47657792	BolC5t33994H	0	+	753	1833	1863	0.9838969
C5	47672403	47673803	BolC5t33995H	0	+	390	1284	1400	0.9171429
C5	47674628	47675904	BolC5t33996H	0	+	24	231	1276	0.1810345
C5	47680249	47682179	BolC5t33997H	0	-	1175	1920	1930	0.9948186
C5	47733685	47775647	BolC5t33998H	0	-	17591	33830	41962	0.8062056
C5	47783187	47785447	BolC5t33999H	0	-	1904	2260	2260	1.0000000
C5	47786489	47786858	BolC5t34000H	0	+	269	369	369	1.0000000
C5	47789763	47790209	BolC5t34001H	0	-	587	446	446	1.0000000
C5	47793445	47795726	BolC5t34002H	0	-	1609	2281	2281	1.0000000
C5	47803550	47803694	BolC5t34003H	0	-	304	144	144	1.0000000
C5	47833967	47835161	BolC5t34004H	0	-	14	258	1194	0.2160804
C5	47850130	47850674	BolC5t34005H	0	-	280	541	544	0.9944853
C5	47851573	47853349	BolC5t34006H	0	-	1261	1537	1776	0.8654279
C5	47854348	47854933	BolC5t34007H	0	+	242	585	585	1.0000000
C5	47859599	47859953	BolC5t34008H	0	-	254	354	354	1.0000000
C5	47861653	47862934	BolC5t34009H	0	-	781	1187	1281	0.9266198
C5	47874981	47875488	BolC5t34010H	0	-	2	148	507	0.2919132
C5	47892299	47894074	BolC5t34011H	0	-	3	183	1775	0.1030986
C5	47905239	47906483	BolC5t34012H	0	-	79	1167	1244	0.9381029
C5	47910410	47912959	BolC5t34013H	0	-	2110	2516	2549	0.9870538
C5	47914013	47914420	BolC5t34014H	0	+	302	407	407	1.0000000
C5	47917275	47917721	BolC5t34015H	0	-	229	446	446	1.0000000
C5	47919299	47919653	BolC5t34016H	0	-	318	354	354	1.0000000
C5	47920992	47923294	BolC5t34017H	0	-	964	2302	2302	1.0000000
C5	47935976	47936483	BolC5t34018H	0	-	0	0	507	0.0000000
C5	47947456	47951677	BolC5t34019H	0	+	2200	4218	4221	0.9992893
C5	47953100	47954180	BolC5t34020H	0	+	864	1080	1080	1.0000000
C5	47957216	47958379	BolC5t34021H	0	+	719	1085	1163	0.9329321
C5	47959040	47959504	BolC5t34022H	0	-	277	464	464	1.0000000
C5	47960062	47960497	BolC5t34023H	0	+	124	435	435	1.0000000
C5	47964656	47970115	BolC5t34024H	0	+	1584	4927	5459	0.9025462
C5	47970818	47972585	BolC5t34025H	0	+	974	1767	1767	1.0000000
C5	47972795	47974401	BolC5t34026H	0	-	932	1563	1606	0.9732254
C5	47974951	47976775	BolC5t34027H	0	+	1302	1736	1824	0.9517544
C5	47979057	47980744	BolC5t34028H	0	+	873	1687	1687	1.0000000
C5	47980946	47988514	BolC5t34029H	0	-	2378	6391	7568	0.8444768
C5	47988959	47990589	BolC5t34030H	0	+	1172	1630	1630	1.0000000
C5	47992246	47994428	BolC5t34031H	0	+	933	2124	2182	0.9734189
C5	47994697	47995742	BolC5t34032H	0	-	909	1045	1045	1.0000000
C5	48001738	48003667	BolC5t34033H	0	+	578	1888	1929	0.9787455
C5	48003935	48004775	BolC5t34034H	0	+	233	779	840	0.9273810
C5	48011887	48014408	BolC5t34035H	0	+	960	2142	2521	0.8496628
C5	48021769	48023296	BolC5t34036H	0	-	113	994	1527	0.6509496
C5	48035033	48035513	BolC5t34037H	0	-	514	480	480	1.0000000
C5	48039140	48041320	BolC5t34038H	0	+	815	2103	2180	0.9646789
C5	48042588	48046958	BolC5t34039H	0	+	1350	3902	4370	0.8929062
C5	48055960	48056239	BolC5t34040H	0	+	738	279	279	1.0000000
C5	48071248	48071449	BolC5t34041H	0	-	185	201	201	1.0000000
C5	48074460	48075588	BolC5t34042H	0	+	497	931	1128	0.8253546
C5	48088015	48089087	BolC5t34043H	0	+	864	1072	1072	1.0000000
C5	48096034	48096505	BolC5t34044H	0	+	456	471	471	1.0000000
C5	48098157	48099703	BolC5t34045H	0	-	97	1012	1546	0.6545925
C5	48104169	48105283	BolC5t34046H	0	-	185	817	1114	0.7333932
C5	48111365	48112647	BolC5t34047H	0	-	1567	1282	1282	1.0000000
C5	48114278	48115749	BolC5t34048H	0	+	311	1413	1471	0.9605711
C5	48121731	48122010	BolC5t34049H	0	+	110	279	279	1.0000000
C5	48122396	48126902	BolC5t34050H	0	-	2466	4506	4506	1.0000000
C5	48130910	48131120	BolC5t34051H	0	-	0	0	210	0.0000000
C5	48131259	48131454	BolC5t34052H	0	-	2	102	195	0.5230770
C5	48141251	48143566	BolC5t34053H	0	+	8	340	2315	0.1468682
C5	48145809	48145947	BolC5t34054H	0	+	0	0	138	0.0000000
C5	48153451	48153913	BolC5t34055H	0	-	58	301	462	0.6515151
C5	48155677	48156281	BolC5t34056H	0	-	37	535	604	0.8857616
C5	48163375	48164596	BolC5t34057H	0	+	1237	1221	1221	1.0000000
C5	48165801	48166807	BolC5t34058H	0	-	1058	1006	1006	1.0000000
C5	48170607	48175110	BolC5t34059H	0	+	904	3945	4503	0.8760826
C5	48177186	48177960	BolC5t34060H	0	-	15	89	774	0.1149871
C5	48185827	48186037	BolC5t34061H	0	+	36	178	210	0.8476191
C5	48192891	48195235	BolC5t34062H	0	-	2369	2332	2344	0.9948806
C5	48208458	48208668	BolC5t34063H	0	+	58	184	210	0.8761905
C5	48219902	48220231	BolC5t34064H	0	-	432	329	329	1.0000000
C5	48231862	48233803	BolC5t34065H	0	-	1118	1941	1941	1.0000000
C5	48233911	48244688	BolC5t34066H	0	+	2594	9144	10777	0.8484736
C5	48249658	48252736	BolC5t34067H	0	+	814	2481	3078	0.8060429
C5	48254729	48256844	BolC5t34068H	0	+	908	2041	2115	0.9650118
C5	48256982	48258734	BolC5t34069H	0	-	1455	1752	1752	1.0000000
C5	48259115	48260423	BolC5t34070H	0	-	873	1308	1308	1.0000000
C5	48264114	48267066	BolC5t34071H	0	+	1588	2845	2952	0.9637534
C5	48267220	48269092	BolC5t34072H	0	-	624	1715	1872	0.9161325
C5	48270139	48274533	BolC5t34073H	0	-	1313	4246	4394	0.9663177
C5	48283952	48285457	BolC5t34074H	0	-	901	1505	1505	1.0000000
C5	48288781	48291894	BolC5t34075H	0	+	2352	2297	3113	0.7378734
C5	48292883	48294989	BolC5t34076H	0	+	87	1341	2106	0.6367521
C5	48302797	48303368	BolC5t34077H	0	+	10	173	571	0.3029772
C5	48303473	48307202	BolC5t34078H	0	+	228	2646	3729	0.7095736
C5	48309832	48310378	BolC5t34079H	0	+	332	546	546	1.0000000
C5	48311265	48312427	BolC5t34080H	0	-	281	1162	1162	1.0000000
C5	48313549	48315293	BolC5t34081H	0	+	1752	1744	1744	1.0000000
C5	48316190	48319090	BolC5t34082H	0	-	863	2733	2900	0.9424138
C5	48330612	48334188	BolC5t34083H	0	-	810	3022	3576	0.8450783
C5	48336351	48336912	BolC5t34084H	0	-	444	561	561	1.0000000
C5	48342906	48343200	BolC5t34085H	0	+	499	294	294	1.0000000
C5	48372130	48372268	BolC5t34086H	0	+	0	0	138	0.0000000
C5	48372991	48373378	BolC5t34087H	0	+	0	0	387	0.0000000
C5	48381310	48382860	BolC5t34088H	0	+	153	1151	1550	0.7425807
C5	48383171	48384716	BolC5t34089H	0	-	433	1339	1545	0.8666667
C5	48386162	48388335	BolC5t34090H	0	-	1966	2122	2173	0.9765301
C5	48398455	48400635	BolC5t34091H	0	-	519	2087	2180	0.9573395
C5	48409066	48409714	BolC5t34092H	0	-	403	648	648	1.0000000
C5	48414112	48414847	BolC5t34093H	0	-	616	735	735	1.0000000
C5	48446219	48446378	BolC5t34094H	0	-	90	159	159	1.0000000
C5	48448199	48448811	BolC5t34095H	0	+	27	155	612	0.2532680
C5	48449609	48451067	BolC5t34096H	0	+	2892	1458	1458	1.0000000
C5	48452311	48452622	BolC5t34097H	0	-	0	0	311	0.0000000
C5	48453185	48454626	BolC5t34098H	0	+	1036	1441	1441	1.0000000
C5	48464233	48466022	BolC5t34099H	0	+	870	1763	1789	0.9854667
C5	48467523	48468613	BolC5t34100H	0	+	891	1087	1090	0.9972477
C5	48471612	48472934	BolC5t34101H	0	-	762	1322	1322	1.0000000
C5	48472932	48475203	BolC5t34102H	0	+	2075	2271	2271	1.0000000
C5	48477802	48477988	BolC5t34103H	0	-	85	142	186	0.7634408
C5	48481267	48483318	BolC5t34104H	0	-	916	1998	2051	0.9741589
C5	48496851	48502100	BolC5t34105H	0	+	2989	4764	5249	0.9076015
C5	48502988	48506194	BolC5t34106H	0	-	2358	3206	3206	1.0000000
C5	48513777	48514249	BolC5t34107H	0	-	453	472	472	1.0000000
C5	48515564	48517100	BolC5t34108H	0	-	959	1536	1536	1.0000000
C5	48526294	48528293	BolC5t34109H	0	-	2509	1999	1999	1.0000000
C5	48534989	48535097	BolC5t34110H	0	-	52	108	108	1.0000000
C5	48541452	48541798	BolC5t34111H	0	-	57	346	346	1.0000000
C5	48541975	48542886	BolC5t34112H	0	-	393	911	911	1.0000000
C5	48544168	48546519	BolC5t34113H	0	+	1032	2104	2351	0.8949383
C5	48552890	48555862	BolC5t34114H	0	-	2110	2972	2972	1.0000000
C5	48556838	48561626	BolC5t34115H	0	-	2720	4680	4788	0.9774436
C5	48562129	48564035	BolC5t34116H	0	+	800	1493	1906	0.7833158
C5	48570892	48573284	BolC5t34117H	0	-	539	2068	2392	0.8645485
C5	48575766	48577753	BolC5t34118H	0	+	120	1334	1987	0.6713639
C5	48578066	48581336	BolC5t34119H	0	-	676	3051	3270	0.9330275
C5	48616489	48616701	BolC5t34120H	0	-	94	212	212	1.0000000
C5	48624199	48626081	BolC5t34121H	0	+	373	1501	1882	0.7975558
C5	48648818	48649113	BolC5t34122H	0	-	48	283	295	0.9593220
C5	48652761	48653650	BolC5t34123H	0	+	49	541	889	0.6085489
C5	48654786	48656833	BolC5t34124H	0	-	1341	1960	2047	0.9574988
C5	48661388	48663412	BolC5t34125H	0	-	782	2011	2024	0.9935771
C5	48667923	48668409	BolC5t34126H	0	+	51	243	486	0.5000000
C5	48669056	48674690	BolC5t34127H	0	-	976	4238	5634	0.7522187
C5	48677222	48677640	BolC5t34128H	0	-	561	418	418	1.0000000
C5	48687541	48690450	BolC5t34129H	0	+	197	2393	2909	0.8226194
C5	48690787	48691009	BolC5t34130H	0	-	4	165	222	0.7432432
C5	48691661	48691913	BolC5t34131H	0	-	6	185	252	0.7341270
C5	48694884	48695534	BolC5t34132H	0	+	416	650	650	1.0000000
C5	48701614	48702203	BolC5t34133H	0	+	188	589	589	1.0000000
C5	48708696	48709213	BolC5t34134H	0	-	385	517	517	1.0000000
C5	48709209	48710001	BolC5t34135H	0	-	304	792	792	1.0000000
C5	48710138	48710809	BolC5t34136H	0	+	280	613	671	0.9135618
C5	48712595	48714040	BolC5t34137H	0	-	394	1407	1445	0.9737024
C5	48721284	48726529	BolC5t34138H	0	-	759	3425	5245	0.6530029
C5	48727465	48727660	BolC5t34139H	0	+	12	195	195	1.0000000
C5	48730844	48731492	BolC5t34140H	0	-	202	636	648	0.9814815
C5	48732795	48733131	BolC5t34141H	0	-	68	148	336	0.4404762
C5	48737671	48738649	BolC5t34142H	0	-	221	961	978	0.9826176
C5	48744558	48744859	BolC5t34143H	0	-	2	58	301	0.1926910
C5	48748343	48748811	BolC5t34144H	0	-	546	468	468	1.0000000
C5	48749026	48750451	BolC5t34145H	0	+	22	431	1425	0.3024561
C5	48754103	48754592	BolC5t34146H	0	+	1	33	489	0.0674847
C5	48757285	48758212	BolC5t34147H	0	-	2	115	927	0.1240561
C5	48758245	48758573	BolC5t34148H	0	-	0	0	328	0.0000000
C5	48759821	48761438	BolC5t34149H	0	-	1024	1588	1617	0.9820656
C5	48761974	48763091	BolC5t34150H	0	-	804	1117	1117	1.0000000
C5	48771177	48771492	BolC5t34151H	0	+	128	315	315	1.0000000
C5	48775711	48776438	BolC5t34152H	0	+	227	683	727	0.9394773
C5	48787758	48788355	BolC5t34153H	0	-	289	559	597	0.9363484
C5	48795863	48796825	BolC5t34154H	0	+	433	962	962	1.0000000
C5	48802249	48810077	BolC5t34155H	0	+	4006	7481	7828	0.9556720
C5	48810616	48814253	BolC5t34156H	0	+	2376	3535	3637	0.9719549
C5	48815220	48818502	BolC5t34157H	0	-	910	2480	3282	0.7556368
C5	48820020	48822893	BolC5t34158H	0	-	1716	2873	2873	1.0000000
C5	48825122	48827014	BolC5t34159H	0	+	396	1892	1892	1.0000000
C5	48828948	48831324	BolC5t34160H	0	+	1065	2218	2376	0.9335017
C5	48833872	48835641	BolC5t34161H	0	+	644	1539	1769	0.8699830
C5	48838383	48838774	BolC5t34162H	0	-	58	353	391	0.9028133
C5	48839391	48841364	BolC5t34163H	0	-	938	1840	1973	0.9325899
C5	48845410	48846517	BolC5t34164H	0	+	165	953	1107	0.8608853
C5	48851255	48851761	BolC5t34165H	0	+	279	506	506	1.0000000
C5	48852819	48854682	BolC5t34166H	0	+	727	1826	1863	0.9801396
C5	48855344	48856534	BolC5t34167H	0	-	620	1073	1190	0.9016806
C5	48858409	48858721	BolC5t34168H	0	-	0	0	312	0.0000000
C5	48865870	48867054	BolC5t34169H	0	+	7	203	1184	0.1714527
C5	48873947	48877168	BolC5t34170H	0	-	905	2782	3221	0.8637069
C5	48890228	48891841	BolC5t34171H	0	-	13	235	1613	0.1456913
C5	48909546	48910579	BolC5t34172H	0	-	8	148	1033	0.1432720
C5	48916359	48916812	BolC5t34173H	0	-	443	453	453	1.0000000
C5	48919505	48920117	BolC5t34174H	0	+	311	612	612	1.0000000
C5	48921768	48923828	BolC5t34175H	0	-	1365	1949	2060	0.9461165
C5	48934811	48935210	BolC5t34176H	0	+	235	373	399	0.9348371
C5	48943580	48951774	BolC5t34177H	0	-	761	4195	8194	0.5119600
C5	48953707	48955861	BolC5t34178H	0	+	25	132	2154	0.0612813
C5	48955956	48956823	BolC5t34179H	0	+	2	30	867	0.0346021
C5	48959624	48963946	BolC5t34180H	0	+	2186	4089	4322	0.9460897
C5	48964535	48965669	BolC5t34181H	0	-	484	1134	1134	1.0000000
C5	48967378	48969553	BolC5t34182H	0	+	344	2077	2175	0.9549425
C5	48969713	48971561	BolC5t34183H	0	-	685	1833	1848	0.9918831
C5	48983436	48984569	BolC5t34184H	0	+	312	1133	1133	1.0000000
C5	48984947	48986719	BolC5t34185H	0	-	775	1757	1772	0.9915350
C5	48992758	48993949	BolC5t34186H	0	+	97	474	1191	0.3979849
C5	49004710	49005791	BolC5t34187H	0	+	94	832	1081	0.7696577
C5	49007799	49009096	BolC5t34188H	0	+	279	883	1297	0.6808019
C5	49010445	49012567	BolC5t34189H	0	-	363	1673	2122	0.7884071
C5	49014141	49016088	BolC5t34190H	0	-	550	1520	1947	0.7806882
C5	49031555	49033869	BolC5t34191H	0	+	601	2135	2314	0.9226448
C5	49042052	49045729	BolC5t34192H	0	+	1291	3363	3677	0.9146043
C5	49047579	49051202	BolC5t34193H	0	+	617	3257	3623	0.8989788
C5	49052123	49052948	BolC5t34194H	0	-	137	511	825	0.6193939
C5	49054878	49062047	BolC5t34195H	0	+	2351	6439	7169	0.8981727
C5	49064987	49065341	BolC5t34196H	0	+	295	354	354	1.0000000
C5	49078750	49079230	BolC5t34197H	0	-	48	393	480	0.8187500
C5	49080317	49081993	BolC5t34198H	0	+	472	1650	1676	0.9844869
C5	49083345	49094173	BolC5t34199H	0	+	3462	8955	10828	0.8270226
C5	49096442	49097838	BolC5t34200H	0	-	604	1396	1396	1.0000000
C5	49098923	49099037	BolC5t34201H	0	+	14	114	114	1.0000000
C5	49100821	49103252	BolC5t34202H	0	+	1342	2361	2431	0.9712053
C5	49103889	49106338	BolC5t34203H	0	-	851	2449	2449	1.0000000
C5	49118729	49119011	BolC5t34204H	0	+	21	102	282	0.3617021
C5	49119548	49121758	BolC5t34205H	0	-	362	1858	2210	0.8407240
C5	49123060	49124362	BolC5t34206H	0	+	142	860	1302	0.6605223
C5	49135620	49137008	BolC5t34207H	0	+	309	1117	1388	0.8047550
C5	49137702	49138771	BolC5t34208H	0	+	518	1069	1069	1.0000000
C5	49148663	49149332	BolC5t34209H	0	+	490	669	669	1.0000000
C5	49150620	49151715	BolC5t34210H	0	-	344	1089	1095	0.9945205
C5	49152008	49155213	BolC5t34211H	0	+	800	3205	3205	1.0000000
C5	49155741	49156254	BolC5t34212H	0	+	94	258	513	0.5029240
C5	49157416	49160271	BolC5t34213H	0	-	891	2665	2855	0.9334501
C5	49161201	49161738	BolC5t34214H	0	+	181	537	537	1.0000000
C5	49162750	49164024	BolC5t34215H	0	-	558	1239	1274	0.9725274
C5	49172025	49173647	BolC5t34216H	0	-	334	1519	1622	0.9364982
C5	49174560	49179308	BolC5t34217H	0	+	263	2740	4748	0.5770851
C5	49179744	49182293	BolC5t34218H	0	-	731	2470	2549	0.9690074
C5	49182772	49183996	BolC5t34219H	0	+	859	1127	1224	0.9207516
C5	49184500	49186385	BolC5t34220H	0	-	651	1880	1885	0.9973475
C5	49189037	49190157	BolC5t34221H	0	-	415	1120	1120	1.0000000
C5	49190453	49191361	BolC5t34222H	0	+	631	888	908	0.9779736
C5	49191402	49191573	BolC5t34223H	0	+	164	171	171	1.0000000
C5	49191865	49192804	BolC5t34224H	0	-	513	853	939	0.9084132
C5	49193360	49195096	BolC5t34225H	0	-	956	1711	1736	0.9855991
C5	49195895	49197141	BolC5t34226H	0	+	1144	1246	1246	1.0000000
C5	49202022	49203922	BolC5t34227H	0	+	834	1900	1900	1.0000000
C5	49204741	49206080	BolC5t34228H	0	+	453	1273	1339	0.9507095
C5	49206995	49208684	BolC5t34229H	0	+	267	1197	1689	0.7087034
C5	49209933	49211295	BolC5t34230H	0	+	49	589	1362	0.4324523
C5	49214806	49215712	BolC5t34231H	0	-	49	358	906	0.3951435
C5	49216974	49218124	BolC5t34232H	0	+	156	864	1150	0.7513043
C5	49219070	49220926	BolC5t34233H	0	+	949	1856	1856	1.0000000
C5	49227328	49228687	BolC5t34234H	0	+	279	1359	1359	1.0000000
C5	49247276	49249565	BolC5t34235H	0	+	751	1148	2289	0.5015290
C5	49250594	49252535	BolC5t34236H	0	+	1101	1941	1941	1.0000000
C5	49254544	49257041	BolC5t34237H	0	+	1248	2277	2497	0.9118943
C5	49261437	49263125	BolC5t34238H	0	-	591	1644	1688	0.9739336
C5	49265717	49268625	BolC5t34239H	0	+	1330	2535	2908	0.8717331
C5	49269865	49271193	BolC5t34240H	0	+	377	1162	1328	0.8750000
C5	49279102	49282399	BolC5t34241H	0	-	850	3207	3297	0.9727024
C5	49286098	49287410	BolC5t34242H	0	-	596	1312	1312	1.0000000
C5	49289877	49291588	BolC5t34243H	0	-	650	1702	1711	0.9947399
C5	49292513	49293916	BolC5t34244H	0	+	1357	1403	1403	1.0000000
C5	49295030	49301602	BolC5t34245H	0	-	4060	6304	6572	0.9592209
C5	49305655	49316383	BolC5t34246H	0	-	3274	7512	10728	0.7002237
C5	49316391	49316611	BolC5t34247H	0	-	242	220	220	1.0000000
C5	49322370	49324734	BolC5t34248H	0	+	1190	2364	2364	1.0000000
C5	49328131	49328356	BolC5t34249H	0	+	32	225	225	1.0000000
C5	49328738	49328948	BolC5t34250H	0	+	39	210	210	1.0000000
C5	49330464	49332020	BolC5t34251H	0	-	343	1548	1556	0.9948586
C5	49332328	49333438	BolC5t34252H	0	-	592	1110	1110	1.0000000
C5	49333849	49334383	BolC5t34253H	0	-	103	482	534	0.9026217
C5	49334807	49335309	BolC5t34254H	0	-	404	502	502	1.0000000
C5	49341514	49342048	BolC5t34255H	0	-	116	534	534	1.0000000
C5	49343987	49344485	BolC5t34256H	0	-	52	498	498	1.0000000
C5	49345798	49346296	BolC5t34257H	0	-	26	443	498	0.8895583
C5	49348290	49348788	BolC5t34258H	0	-	110	498	498	1.0000000
C5	49350366	49350576	BolC5t34259H	0	-	249	210	210	1.0000000
C5	49351915	49353314	BolC5t34260H	0	-	938	1399	1399	1.0000000
C5	49354100	49355990	BolC5t34261H	0	-	1009	1890	1890	1.0000000
C5	49356253	49368131	BolC5t34262H	0	+	3364	9880	11878	0.8317899
C5	49368374	49369180	BolC5t34263H	0	-	982	806	806	1.0000000
C5	49368621	49377772	BolC5t34264H	0	-	3193	6676	9151	0.7295378
C5	49374866	49375325	BolC5t34265H	0	-	472	459	459	1.0000000
C5	49377930	49385081	BolC5t34266H	0	-	1589	6044	7151	0.8451965
C5	49390641	49392941	BolC5t34267H	0	+	1042	2225	2300	0.9673913
C5	49394019	49395391	BolC5t34268H	0	+	891	1338	1372	0.9752187
C5	49395971	49397239	BolC5t34269H	0	-	393	1268	1268	1.0000000
C5	49411495	49420200	BolC5t34270H	0	+	1232	5222	8705	0.5998851
C5	49447624	49451477	BolC5t34271H	0	-	2085	3533	3853	0.9169478
C5	49462181	49464173	BolC5t34272H	0	-	921	1757	1992	0.8820281
C5	49466161	49468026	BolC5t34273H	0	+	233	1614	1865	0.8654156
C5	49472520	49474298	BolC5t34274H	0	+	369	1576	1778	0.8863892
C5	49474529	49477699	BolC5t34275H	0	-	2273	3168	3170	0.9993691
C5	49481549	49485203	BolC5t34276H	0	+	2125	3654	3654	1.0000000
C5	49487140	49488178	BolC5t34277H	0	+	417	1016	1038	0.9788054
C5	49488790	49490212	BolC5t34278H	0	-	633	1353	1422	0.9514768
C5	49492540	49493700	BolC5t34279H	0	+	2514	1160	1160	1.0000000
C5	49494449	49495607	BolC5t34280H	0	+	755	1124	1158	0.9706391
C5	49505563	49508177	BolC5t34281H	0	+	920	2019	2614	0.7723795
C5	49510123	49510378	BolC5t34282H	0	+	34	177	255	0.6941177
C5	49522672	49522921	BolC5t34283H	0	-	479	249	249	1.0000000
C5	49524328	49525969	BolC5t34284H	0	+	1148	1641	1641	1.0000000
C5	49527131	49528984	BolC5t34285H	0	-	86	1200	1853	0.6475985
C5	49531915	49532539	BolC5t34286H	0	-	77	624	624	1.0000000
C5	49541628	49543624	BolC5t34287H	0	+	27	667	1996	0.3341683
C5	49553256	49556665	BolC5t34288H	0	-	546	2909	3409	0.8533294
C5	49558435	49566827	BolC5t34289H	0	+	3097	6570	8392	0.7828885
C5	49567022	49567475	BolC5t34290H	0	-	36	308	453	0.6799117
C5	49570048	49570687	BolC5t34291H	0	+	0	0	639	0.0000000
C5	49576336	49576537	BolC5t34292H	0	-	253	201	201	1.0000000
C5	49577094	49577390	BolC5t34293H	0	+	266	296	296	1.0000000
C5	49582765	49583686	BolC5t34294H	0	+	494	921	921	1.0000000
C5	49583940	49585258	BolC5t34295H	0	-	700	1318	1318	1.0000000
C5	49585812	49587804	BolC5t34296H	0	+	1446	1992	1992	1.0000000
C5	49588883	49589240	BolC5t34297H	0	-	12	219	357	0.6134454
C5	49593699	49596509	BolC5t34298H	0	-	1022	2805	2810	0.9982206
C5	49598176	49598350	BolC5t34299H	0	+	280	174	174	1.0000000
C5	49614287	49614539	BolC5t34300H	0	-	186	252	252	1.0000000
C5	49625333	49625582	BolC5t34301H	0	+	88	242	249	0.9718875
C5	49627509	49628031	BolC5t34302H	0	+	29	341	522	0.6532567
C5	49633115	49633406	BolC5t34303H	0	+	86	291	291	1.0000000
C5	49638328	49640655	BolC5t34304H	0	+	918	2281	2327	0.9802321
C5	49643139	49644771	BolC5t34305H	0	+	466	1558	1632	0.9546568
C5	49644792	49650661	BolC5t34306H	0	-	3848	5515	5869	0.9396831
C5	49651163	49651941	BolC5t34307H	0	-	292	751	778	0.9652956
C5	49652640	49657044	BolC5t34308H	0	-	1410	4198	4404	0.9532244
C5	49658523	49661756	BolC5t34309H	0	+	2550	3230	3233	0.9990721
C5	49664865	49666004	BolC5t34310H	0	+	1004	1139	1139	1.0000000
C5	49675190	49675921	BolC5t34311H	0	-	387	731	731	1.0000000
C5	49676557	49676662	BolC5t34312H	0	+	117	105	105	1.0000000
C5	49687110	49689517	BolC5t34313H	0	+	1496	2366	2407	0.9829664
C5	49689717	49693416	BolC5t34314H	0	-	1251	3699	3699	1.0000000
C5	49696859	49697785	BolC5t34315H	0	+	883	926	926	1.0000000
C5	49699524	49701027	BolC5t34316H	0	+	281	1464	1503	0.9740519
C5	49702156	49706358	BolC5t34317H	0	-	2208	4202	4202	1.0000000
C5	49707334	49708099	BolC5t34318H	0	-	585	765	765	1.0000000
C5	49708388	49712036	BolC5t34319H	0	-	1509	3394	3648	0.9303728
C5	49713395	49715028	BolC5t34320H	0	-	0	0	1633	0.0000000
C5	49716802	49718632	BolC5t34321H	0	-	985	1830	1830	1.0000000
C5	49717196	49717818	BolC5t34322H	0	+	336	622	622	1.0000000
C5	49718900	49719011	BolC5t34323H	0	+	79	111	111	1.0000000
C5	49723860	49724022	BolC5t34324H	0	+	70	162	162	1.0000000
C5	49728746	49729511	BolC5t34325H	0	+	362	765	765	1.0000000
C5	49733106	49733608	BolC5t34326H	0	-	51	187	502	0.3725100
C5	49758032	49758194	BolC5t34327H	0	+	9	162	162	1.0000000
C5	49791412	49791778	BolC5t34328H	0	+	2	70	366	0.1912568
C5	49792185	49793309	BolC5t34329H	0	-	11	107	1124	0.0951957
C5	49809186	49810101	BolC5t34330H	0	-	85	375	915	0.4098361
C5	49822781	49824333	BolC5t34331H	0	+	999	1552	1552	1.0000000
C5	49824393	49827637	BolC5t34332H	0	-	741	2002	3244	0.6171393
C5	49828857	49830783	BolC5t34333H	0	+	988	1926	1926	1.0000000
C5	49831168	49832871	BolC5t34334H	0	-	232	1242	1703	0.7293012
C5	49835074	49835263	BolC5t34335H	0	+	64	189	189	1.0000000
C5	49837285	49839193	BolC5t34336H	0	-	402	1838	1908	0.9633124
C5	49841217	49843714	BolC5t34337H	0	-	939	2459	2497	0.9847817
C5	49865458	49866751	BolC5t34338H	0	+	423	1248	1293	0.9651972
C5	49871403	49872834	BolC5t34339H	0	-	655	1430	1431	0.9993012
C5	49874593	49875953	BolC5t34340H	0	-	797	1360	1360	1.0000000
C5	49876627	49880088	BolC5t34341H	0	-	906	3366	3461	0.9725513
C5	49907147	49908975	BolC5t34342H	0	-	424	1330	1828	0.7275711
C5	49912154	49914460	BolC5t34343H	0	+	1159	2200	2306	0.9540330
C5	49916371	49917880	BolC5t34344H	0	+	501	1469	1509	0.9734924
C5	49919305	49921994	BolC5t34345H	0	+	948	2517	2689	0.9360357
C5	49923388	49924276	BolC5t34346H	0	+	351	885	888	0.9966216
C5	49928760	49929735	BolC5t34347H	0	-	812	975	975	1.0000000
C5	49933443	49934175	BolC5t34348H	0	-	245	732	732	1.0000000
C5	49948394	49950670	BolC5t34349H	0	+	1429	2276	2276	1.0000000
C5	49951162	49952135	BolC5t34350H	0	-	777	973	973	1.0000000
C5	49962463	49964362	BolC5t34351H	0	+	471	1683	1899	0.8862559
C5	49967972	49970011	BolC5t34352H	0	+	921	2039	2039	1.0000000
C5	49971742	49974127	BolC5t34353H	0	+	1873	2385	2385	1.0000000
C5	49980734	49983414	BolC5t34354H	0	-	796	2568	2680	0.9582090
C5	49987464	49988586	BolC5t34355H	0	-	11	382	1122	0.3404635
C5	49992034	49992521	BolC5t34356H	0	-	425	487	487	1.0000000
C5	50003630	50005759	BolC5t34357H	0	-	1291	2129	2129	1.0000000
C5	50008471	50009003	BolC5t34358H	0	-	193	532	532	1.0000000
C5	50012969	50021273	BolC5t34359H	0	+	1994	5988	8304	0.7210982
C5	50023704	50024208	BolC5t34360H	0	-	206	504	504	1.0000000
C5	50027182	50027962	BolC5t34361H	0	+	321	780	780	1.0000000
C5	50029027	50029543	BolC5t34362H	0	-	56	442	516	0.8565891
C5	50030577	50032804	BolC5t34363H	0	-	1734	2227	2227	1.0000000
C5	50033781	50042578	BolC5t34364H	0	-	6540	8575	8797	0.9747641
C5	50036005	50039654	BolC5t34365H	0	-	2591	3649	3649	1.0000000
C5	50042788	50044301	BolC5t34366H	0	-	1415	1513	1513	1.0000000
C5	50045446	50047288	BolC5t34367H	0	+	455	1842	1842	1.0000000
C5	50054127	50055042	BolC5t34368H	0	-	263	827	915	0.9038252
C5	50061656	50063397	BolC5t34369H	0	-	325	1741	1741	1.0000000
C5	50074177	50074648	BolC5t34370H	0	-	66	378	471	0.8025478
C5	50087521	50087773	BolC5t34371H	0	-	1	152	252	0.6031746
C5	50092125	50092434	BolC5t34372H	0	-	28	309	309	1.0000000
C5	50134409	50137236	BolC5t34373H	0	+	949	2400	2827	0.8489565
C5	50151391	50152742	BolC5t34374H	0	+	736	1305	1351	0.9659511
C5	50153872	50155588	BolC5t34375H	0	+	521	1716	1716	1.0000000
C5	50162050	50162344	BolC5t34376H	0	+	65	282	294	0.9591837
C5	50163344	50164640	BolC5t34377H	0	-	1139	1296	1296	1.0000000
C5	50165079	50166285	BolC5t34378H	0	+	346	1159	1206	0.9610282
C5	50167537	50172929	BolC5t34379H	0	-	3270	5392	5392	1.0000000
C5	50176275	50176428	BolC5t34380H	0	+	247	153	153	1.0000000
C5	50181683	50182740	BolC5t34381H	0	-	680	846	1057	0.8003784
C5	50193906	50195015	BolC5t34382H	0	+	220	1012	1109	0.9125338
C5	50197831	50205085	BolC5t34383H	0	+	5574	7234	7254	0.9972429
C5	50202926	50203408	BolC5t34384H	0	-	458	482	482	1.0000000
C5	50205432	50207584	BolC5t34385H	0	+	528	2058	2152	0.9563197
C5	50207861	50209817	BolC5t34386H	0	-	1473	1920	1956	0.9815951
C5	50214636	50215230	BolC5t34387H	0	+	298	594	594	1.0000000
C5	50221638	50222886	BolC5t34388H	0	-	22	393	1248	0.3149039
C5	50226912	50227830	BolC5t34389H	0	+	30	513	918	0.5588235
C5	50229239	50230602	BolC5t34390H	0	-	187	891	1363	0.6537051
C5	50233221	50233555	BolC5t34391H	0	+	43	317	334	0.9491018
C5	50237232	50238093	BolC5t34392H	0	-	256	861	861	1.0000000
C5	50240702	50242321	BolC5t34393H	0	-	1148	1619	1619	1.0000000
C5	50255139	50257548	BolC5t34394H	0	+	633	2362	2409	0.9804899
C5	50258185	50260939	BolC5t34395H	0	+	873	2556	2754	0.9281046
C5	50261610	50263225	BolC5t34396H	0	-	1723	1615	1615	1.0000000
C5	50263708	50269437	BolC5t34397H	0	+	1937	5159	5729	0.9005062
C5	50269825	50271219	BolC5t34398H	0	-	807	1347	1394	0.9662841
C5	50272169	50273273	BolC5t34399H	0	-	1079	1104	1104	1.0000000
C5	50273725	50273962	BolC5t34400H	0	-	211	237	237	1.0000000
C5	50274735	50275903	BolC5t34401H	0	+	446	1109	1168	0.9494863
C5	50276471	50277320	BolC5t34402H	0	-	57	406	849	0.4782096
C5	50279461	50279893	BolC5t34403H	0	+	109	364	432	0.8425926
C5	50280356	50282031	BolC5t34404H	0	-	704	1675	1675	1.0000000
C5	50283390	50284941	BolC5t34405H	0	-	693	1551	1551	1.0000000
C5	50291297	50291444	BolC5t34406H	0	-	154	147	147	1.0000000
C5	50301084	50302197	BolC5t34407H	0	-	388	983	1113	0.8831986
C5	50303448	50312803	BolC5t34408H	0	-	3336	7795	9355	0.8332443
C5	50320737	50321268	BolC5t34409H	0	+	258	531	531	1.0000000
C5	50329885	50331128	BolC5t34410H	0	+	1240	1243	1243	1.0000000
C5	50331579	50334953	BolC5t34411H	0	-	960	3153	3374	0.9344991
C5	50337251	50340021	BolC5t34412H	0	+	1976	2720	2770	0.9819494
C5	50340721	50343315	BolC5t34413H	0	-	1293	2261	2594	0.8716269
C5	50346295	50347450	BolC5t34414H	0	-	338	1123	1155	0.9722944
C5	50351833	50352387	BolC5t34415H	0	+	181	554	554	1.0000000
C5	50365944	50366112	BolC5t34416H	0	+	28	158	168	0.9404762
C5	50366662	50369205	BolC5t34417H	0	-	918	2302	2543	0.9052300
C5	50373390	50374505	BolC5t34418H	0	-	640	1110	1115	0.9955157
C5	50378418	50379685	BolC5t34419H	0	+	813	1226	1267	0.9676401
C5	50379759	50379864	BolC5t34420H	0	+	158	105	105	1.0000000
C5	50389833	50391336	BolC5t34421H	0	-	94	874	1503	0.5815036
C5	50396028	50401754	BolC5t34422H	0	-	2219	4694	5726	0.8197695
C5	50404687	50405435	BolC5t34423H	0	+	74	627	748	0.8382353
C5	50407136	50407495	BolC5t34424H	0	+	222	359	359	1.0000000
C5	50411205	50412120	BolC5t34425H	0	+	598	915	915	1.0000000
C5	50413136	50413331	BolC5t34426H	0	-	272	195	195	1.0000000
C5	50414163	50414729	BolC5t34427H	0	+	75	298	566	0.5265018
C5	50420902	50421361	BolC5t34428H	0	+	4	48	459	0.1045752
C5	50421567	50422389	BolC5t34429H	0	+	41	433	822	0.5267640
C5	50429893	50431066	BolC5t34430H	0	+	823	1173	1173	1.0000000
C5	50431811	50433298	BolC5t34431H	0	+	1107	1487	1487	1.0000000
C5	50436582	50439408	BolC5t34432H	0	-	1327	2811	2826	0.9946921
C5	50440468	50443225	BolC5t34433H	0	+	1128	2527	2757	0.9165760
C5	50443903	50444707	BolC5t34434H	0	-	811	804	804	1.0000000
C5	50445902	50453939	BolC5t34435H	0	+	999	5503	8037	0.6847082
C5	50454809	50457653	BolC5t34436H	0	-	399	2145	2844	0.7542194
C5	50459074	50459257	BolC5t34437H	0	+	55	183	183	1.0000000
C5	50462611	50464847	BolC5t34438H	0	-	2006	1822	2236	0.8148479
C5	50465683	50469935	BolC5t34439H	0	-	1333	3113	4252	0.7321261
C5	50481439	50483095	BolC5t34440H	0	+	114	915	1656	0.5525362
C5	50483418	50488081	BolC5t34441H	0	-	2019	4482	4663	0.9611838
C5	50491819	50494334	BolC5t34442H	0	+	1018	2168	2515	0.8620278
C5	50495088	50500906	BolC5t34443H	0	+	2033	5031	5818	0.8647301
C5	50502491	50503737	BolC5t34444H	0	+	627	1188	1246	0.9534510
C5	50504927	50506899	BolC5t34445H	0	+	908	1944	1972	0.9858012
C5	50508181	50509681	BolC5t34446H	0	+	439	1172	1500	0.7813333
C5	50509913	50511707	BolC5t34447H	0	-	568	1701	1794	0.9481605
C5	50513438	50514589	BolC5t34448H	0	+	381	1117	1151	0.9704605
C5	50514830	50517241	BolC5t34449H	0	-	1435	2334	2411	0.9680631
C5	50520465	50521122	BolC5t34450H	0	-	98	601	657	0.9147641
C5	50522341	50523057	BolC5t34451H	0	-	390	716	716	1.0000000
C5	50529527	50531349	BolC5t34452H	0	+	464	1465	1822	0.8040615
C5	50533026	50533743	BolC5t34453H	0	-	45	338	717	0.4714086
C5	50533855	50534213	BolC5t34454H	0	-	11	60	358	0.1675978
C5	50535100	50537448	BolC5t34455H	0	+	610	2064	2348	0.8790460
C5	50538742	50539237	BolC5t34456H	0	-	82	261	495	0.5272727
C5	50543957	50546774	BolC5t34457H	0	+	2535	2705	2817	0.9602414
C5	50547090	50548745	BolC5t34458H	0	-	1033	1429	1655	0.8634441
C5	50549040	50551824	BolC5t34459H	0	+	701	2422	2784	0.8699713
C5	50552847	50554110	BolC5t34460H	0	+	917	1263	1263	1.0000000
C5	50557834	50560203	BolC5t34461H	0	+	767	2280	2369	0.9624314
C5	50560827	50561286	BolC5t34462H	0	+	203	459	459	1.0000000
C5	50575412	50576967	BolC5t34463H	0	-	395	1484	1555	0.9543408
C5	50581563	50582909	BolC5t34464H	0	-	846	1211	1346	0.8997028
C5	50583458	50585272	BolC5t34465H	0	-	20	116	1814	0.0639471
C5	50589424	50589700	BolC5t34466H	0	+	98	276	276	1.0000000
C5	50591009	50593305	BolC5t34467H	0	-	1020	1714	2296	0.7465157
C5	50597036	50597746	BolC5t34468H	0	+	183	626	710	0.8816901
C5	50611535	50612443	BolC5t34469H	0	+	4	168	908	0.1850220
C5	50632466	50636077	BolC5t34470H	0	+	1179	3501	3611	0.9695375
C5	50636599	50637987	BolC5t34471H	0	+	861	1388	1388	1.0000000
C5	50638411	50639951	BolC5t34472H	0	-	755	1491	1540	0.9681818
C5	50640738	50641797	BolC5t34473H	0	-	112	932	1059	0.8800755
C5	50643581	50645737	BolC5t34474H	0	+	1350	2038	2156	0.9452690
C5	50648530	50658435	BolC5t34475H	0	+	4802	8873	9905	0.8958102
C5	50652807	50654273	BolC5t34476H	0	+	485	1466	1466	1.0000000
C5	50661823	50662165	BolC5t34477H	0	+	219	342	342	1.0000000
C5	50662795	50663632	BolC5t34478H	0	-	616	837	837	1.0000000
C5	50664040	50666278	BolC5t34479H	0	+	717	2176	2238	0.9722967
C5	50666689	50669853	BolC5t34480H	0	-	884	2890	3164	0.9134008
C5	50671398	50673520	BolC5t34481H	0	-	967	1553	2122	0.7318568
C5	50685431	50686497	BolC5t34482H	0	-	225	1022	1066	0.9587242
C5	50689922	50690937	BolC5t34483H	0	+	685	1015	1015	1.0000000
C5	50699806	50701792	BolC5t34484H	0	-	785	1972	1986	0.9929507
C5	50703058	50704078	BolC5t34485H	0	+	907	1020	1020	1.0000000
C5	50704983	50707278	BolC5t34486H	0	+	915	2198	2295	0.9577342
C5	50724371	50725552	BolC5t34487H	0	+	382	1181	1181	1.0000000
C5	50729304	50732327	BolC5t34488H	0	+	1648	2729	3023	0.9027456
C5	50733886	50734120	BolC5t34489H	0	+	6	22	234	0.0940171
C5	50735634	50736333	BolC5t34490H	0	-	0	0	699	0.0000000
C5	50737703	50739953	BolC5t34491H	0	+	869	2060	2250	0.9155555
C5	50740690	50742284	BolC5t34492H	0	-	759	1594	1594	1.0000000
C5	50742730	50743474	BolC5t34493H	0	+	474	732	744	0.9838710
C5	50748946	50753547	BolC5t34494H	0	-	2337	4492	4601	0.9763095
C5	50753924	50758659	BolC5t34495H	0	+	1828	4367	4735	0.9222809
C5	50758921	50761255	BolC5t34496H	0	-	983	2179	2334	0.9335904
C5	50761845	50763445	BolC5t34497H	0	-	462	1561	1600	0.9756250
C5	50766008	50768649	BolC5t34498H	0	-	918	2635	2641	0.9977281
C5	50770581	50772294	BolC5t34499H	0	-	687	1713	1713	1.0000000
C5	50772932	50774342	BolC5t34500H	0	+	907	1410	1410	1.0000000
C5	50774943	50776269	BolC5t34501H	0	-	367	1184	1326	0.8929110
C5	50779168	50782485	BolC5t34502H	0	+	1892	3317	3317	1.0000000
C5	50783225	50785284	BolC5t34503H	0	+	828	2011	2059	0.9766877
C5	50786743	50788600	BolC5t34504H	0	-	830	1857	1857	1.0000000
C5	50801821	50802730	BolC5t34505H	0	-	715	909	909	1.0000000
C5	50803060	50805733	BolC5t34506H	0	+	965	2579	2673	0.9648335
C5	50806628	50810078	BolC5t34507H	0	-	1026	3238	3450	0.9385507
C5	50811617	50813568	BolC5t34508H	0	-	1318	1951	1951	1.0000000
C5	50813813	50816429	BolC5t34509H	0	+	1016	2530	2616	0.9671254
C5	50819021	50822369	BolC5t34510H	0	+	1178	3226	3348	0.9635603
C5	50823787	50824666	BolC5t34511H	0	-	20	333	879	0.3788396
C5	50826736	50827105	BolC5t34512H	0	+	189	369	369	1.0000000
C5	50831983	50832832	BolC5t34513H	0	+	633	849	849	1.0000000
C5	50835895	50837374	BolC5t34514H	0	-	986	1479	1479	1.0000000
C5	50838237	50840499	BolC5t34515H	0	-	1499	2262	2262	1.0000000
C5	50848272	50849971	BolC5t34516H	0	-	962	1699	1699	1.0000000
C5	50852271	50853898	BolC5t34517H	0	+	959	1627	1627	1.0000000
C5	50854356	50854913	BolC5t34518H	0	-	512	557	557	1.0000000
C5	50855282	50855969	BolC5t34519H	0	+	369	687	687	1.0000000
C5	50856096	50858366	BolC5t34520H	0	-	426	2098	2270	0.9242291
C5	50878802	50881993	BolC5t34521H	0	+	716	2295	3191	0.7192103
C5	50884399	50884918	BolC5t34522H	0	+	0	0	519	0.0000000
C5	50885738	50885849	BolC5t34523H	0	+	0	0	111	0.0000000
C5	50887583	50890749	BolC5t34524H	0	+	165	1596	3166	0.5041061
C5	50892855	50898764	BolC5t34525H	0	+	440	3829	5909	0.6479946
C5	50900819	50903635	BolC5t34526H	0	+	410	2235	2816	0.7936790
C5	50905691	50906692	BolC5t34527H	0	-	639	1001	1001	1.0000000
C5	50906801	50908042	BolC5t34528H	0	-	529	1129	1241	0.9097502
C5	50912625	50916575	BolC5t34529H	0	+	2708	3933	3950	0.9956962
C5	50917265	50918691	BolC5t34530H	0	+	1218	1426	1426	1.0000000
C5	50919260	50919989	BolC5t34531H	0	+	122	658	729	0.9026063
C5	50920800	50922628	BolC5t34532H	0	-	1026	1533	1828	0.8386214
C5	50931315	50936084	BolC5t34533H	0	+	1576	4407	4769	0.9240931
C5	50937378	50943677	BolC5t34534H	0	+	1852	5276	6299	0.8375933
C5	50947434	50948342	BolC5t34535H	0	-	202	908	908	1.0000000
C5	50954055	50956426	BolC5t34536H	0	+	1121	2371	2371	1.0000000
C5	50956924	50957983	BolC5t34537H	0	-	785	1059	1059	1.0000000
C5	50959991	50960393	BolC5t34538H	0	+	147	402	402	1.0000000
C5	50961763	50963149	BolC5t34539H	0	-	483	1383	1386	0.9978355
C5	50963870	50965094	BolC5t34540H	0	-	127	752	1224	0.6143791
C5	50967168	50969471	BolC5t34541H	0	-	538	2178	2303	0.9457230
C5	50970574	50971466	BolC5t34542H	0	-	1251	892	892	1.0000000
C5	50975888	50977186	BolC5t34543H	0	-	820	1298	1298	1.0000000
C5	50978206	50980593	BolC5t34544H	0	-	1119	2387	2387	1.0000000
C5	50981396	50987766	BolC5t34545H	0	+	986	4351	6370	0.6830455
C5	50988727	50990644	BolC5t34546H	0	-	755	1911	1917	0.9968701
C5	50991698	50994409	BolC5t34547H	0	+	414	1166	2711	0.4300996
C5	50994926	50995873	BolC5t34548H	0	-	189	893	947	0.9429778
C5	51005955	51009092	BolC5t34549H	0	-	1761	3036	3137	0.9678037
C5	51009501	51010286	BolC5t34550H	0	-	30	511	785	0.6509554
C5	51012817	51014649	BolC5t34551H	0	+	545	1762	1832	0.9617904
C5	51015916	51017110	BolC5t34552H	0	+	858	1194	1194	1.0000000
C5	51017439	51018387	BolC5t34553H	0	-	883	948	948	1.0000000
C5	51019904	51027006	BolC5t34554H	0	+	963	4876	7102	0.6865672
C5	51028313	51028451	BolC5t34555H	0	-	162	138	138	1.0000000
C5	51042942	51045000	BolC5t34556H	0	+	375	1613	2058	0.7837707
C5	51045085	51048749	BolC5t34557H	0	-	753	3252	3664	0.8875546
C5	51049909	51050965	BolC5t34558H	0	+	125	997	1056	0.9441288
C5	51052398	51052734	BolC5t34559H	0	+	45	256	336	0.7619048
C5	51054750	51055941	BolC5t34560H	0	-	14	185	1191	0.1553317
C5	51056782	51060419	BolC5t34561H	0	+	30	219	3637	0.0602145
C5	51062637	51063828	BolC5t34562H	0	-	1	56	1191	0.0470193
C5	51064283	51064970	BolC5t34563H	0	-	0	0	687	0.0000000
C5	51067634	51068697	BolC5t34564H	0	+	0	0	1063	0.0000000
C5	51078533	51079747	BolC5t34565H	0	-	18	417	1214	0.3434926
C5	51081582	51082817	BolC5t34566H	0	-	191	1180	1235	0.9554656
C5	51094078	51096991	BolC5t34567H	0	-	712	2643	2913	0.9073120
C5	51098074	51106416	BolC5t34568H	0	-	2195	7366	8342	0.8830017
C5	51107859	51110506	BolC5t34569H	0	+	1300	2566	2647	0.9693993
C5	51111258	51114065	BolC5t34570H	0	-	1127	2780	2807	0.9903812
C5	51116105	51117035	BolC5t34571H	0	+	277	909	930	0.9774194
C5	51119630	51119953	BolC5t34572H	0	-	53	323	323	1.0000000
C5	51120246	51122363	BolC5t34573H	0	+	1149	2113	2117	0.9981105
C5	51123167	51124136	BolC5t34574H	0	+	133	960	969	0.9907120
C5	51124872	51125734	BolC5t34575H	0	-	433	862	862	1.0000000
C5	51131986	51132310	BolC5t34576H	0	+	561	324	324	1.0000000
C5	51133126	51135620	BolC5t34577H	0	-	1431	2494	2494	1.0000000
C5	51138747	51142159	BolC5t34578H	0	+	1220	3286	3412	0.9630715
C5	51144466	51147545	BolC5t34579H	0	+	1059	2504	3079	0.8132511
C5	51148951	51150803	BolC5t34580H	0	+	996	1809	1852	0.9767818
C5	51151586	51153918	BolC5t34581H	0	-	384	1900	2332	0.8147513
C5	51155683	51157400	BolC5t34582H	0	-	354	1381	1717	0.8043098
C5	51157860	51158397	BolC5t34583H	0	-	282	537	537	1.0000000
C5	51158466	51159810	BolC5t34584H	0	-	856	1344	1344	1.0000000
C5	51164731	51166965	BolC5t34585H	0	-	641	2215	2234	0.9914951
C5	51170103	51172769	BolC5t34586H	0	+	41	999	2666	0.3747187
C5	51173328	51175137	BolC5t34587H	0	+	226	1548	1809	0.8557214
C5	51176156	51176822	BolC5t34588H	0	+	30	154	666	0.2312312
C5	51177472	51178719	BolC5t34589H	0	-	2	19	1247	0.0152366
C5	51179780	51181347	BolC5t34590H	0	-	334	1567	1567	1.0000000
C5	51187047	51187790	BolC5t34591H	0	+	671	743	743	1.0000000
C5	51188074	51190015	BolC5t34592H	0	-	254	1682	1941	0.8665636
C5	51196489	51199107	BolC5t34593H	0	-	220	1248	2618	0.4766998
C5	51207180	51209012	BolC5t34594H	0	-	1564	1816	1832	0.9912664
C5	51216412	51218451	BolC5t34595H	0	-	1164	2032	2039	0.9965670
C5	51220227	51220695	BolC5t34596H	0	-	0	0	468	0.0000000
C5	51220707	51221528	BolC5t34597H	0	-	0	0	821	0.0000000
C5	51222586	51223388	BolC5t34598H	0	+	714	802	802	1.0000000
C5	51223703	51226002	BolC5t34599H	0	-	981	2136	2299	0.9290996
C5	51231829	51233903	BolC5t34600H	0	+	694	2070	2074	0.9980714
C5	51235248	51236555	BolC5t34601H	0	-	438	1278	1307	0.9778118
C5	51244330	51246188	BolC5t34602H	0	+	110	1028	1858	0.5532831
C5	51251139	51254640	BolC5t34603H	0	-	2264	2726	3501	0.7786347
C5	51262359	51262827	BolC5t34604H	0	+	129	468	468	1.0000000
C5	51267678	51269363	BolC5t34605H	0	-	363	1563	1685	0.9275964
C5	51274582	51275524	BolC5t34606H	0	+	644	942	942	1.0000000
C5	51275974	51277435	BolC5t34607H	0	-	1415	1461	1461	1.0000000
C5	51318065	51318725	BolC5t34608H	0	+	93	525	660	0.7954546
C5	51325221	51326663	BolC5t34609H	0	-	1015	1442	1442	1.0000000
C5	51327622	51331927	BolC5t34610H	0	-	1618	4095	4305	0.9512195
C5	51332882	51334054	BolC5t34611H	0	-	640	1068	1172	0.9112628
C5	51335219	51335495	BolC5t34612H	0	-	88	276	276	1.0000000
C5	51337126	51339924	BolC5t34613H	0	+	539	2462	2798	0.8799142
C5	51340294	51341701	BolC5t34614H	0	-	679	1407	1407	1.0000000
C5	51343085	51344737	BolC5t34615H	0	-	251	1282	1652	0.7760291
C5	51355708	51359218	BolC5t34616H	0	+	1151	3474	3510	0.9897436
C5	51359472	51361701	BolC5t34617H	0	-	443	1805	2229	0.8097802
C5	51364317	51364725	BolC5t34618H	0	+	166	392	408	0.9607843
C5	51373020	51374083	BolC5t34619H	0	-	588	1030	1063	0.9689558
C5	51377925	51382054	BolC5t34620H	0	+	2747	4129	4129	1.0000000
C5	51383125	51384798	BolC5t34621H	0	-	1320	1673	1673	1.0000000
C5	51388841	51390912	BolC5t34622H	0	-	1077	2071	2071	1.0000000
C5	51391397	51398423	BolC5t34623H	0	-	4319	6831	7026	0.9722459
C5	51399019	51401219	BolC5t34624H	0	-	756	1690	2200	0.7681818
C5	51403469	51404260	BolC5t34625H	0	-	508	791	791	1.0000000
C5	51404619	51406052	BolC5t34626H	0	+	917	1433	1433	1.0000000
C5	51407344	51410795	BolC5t34627H	0	+	543	2508	3451	0.7267458
C5	51411729	51412045	BolC5t34628H	0	+	150	316	316	1.0000000
C5	51413223	51414816	BolC5t34629H	0	-	813	1460	1593	0.9165097
C5	51415111	51416535	BolC5t34630H	0	+	946	1424	1424	1.0000000
C5	51416849	51418022	BolC5t34631H	0	-	523	1173	1173	1.0000000
C5	51421812	51424265	BolC5t34632H	0	+	1265	2448	2453	0.9979617
C5	51424799	51427658	BolC5t34633H	0	-	2307	2859	2859	1.0000000
C5	51428251	51429323	BolC5t34634H	0	+	980	1072	1072	1.0000000
C5	51430322	51430907	BolC5t34635H	0	+	331	585	585	1.0000000
C5	51431441	51432364	BolC5t34636H	0	-	622	923	923	1.0000000
C5	51433592	51434054	BolC5t34637H	0	-	125	318	462	0.6883117
C5	51437064	51437538	BolC5t34638H	0	-	114	470	474	0.9915612
C5	51438681	51439623	BolC5t34639H	0	+	590	942	942	1.0000000
C5	51440959	51441274	BolC5t34640H	0	+	171	315	315	1.0000000
C5	51441732	51442029	BolC5t34641H	0	-	205	297	297	1.0000000
C5	51444413	51446822	BolC5t34642H	0	+	839	2307	2409	0.9576588
C5	51447131	51451595	BolC5t34643H	0	-	1910	4337	4464	0.9715502
C5	51453750	51458069	BolC5t34644H	0	-	315	3000	4319	0.6946052
C5	51462298	51463749	BolC5t34645H	0	-	92	1381	1451	0.9517574
C5	51466414	51467143	BolC5t34646H	0	-	244	728	729	0.9986283
C5	51470682	51471982	BolC5t34647H	0	+	1458	1300	1300	1.0000000
C5	51472028	51473748	BolC5t34648H	0	+	1360	1720	1720	1.0000000
C5	51475280	51477038	BolC5t34649H	0	-	340	1531	1758	0.8708760
C5	51486650	51487553	BolC5t34650H	0	-	307	865	903	0.9579180
C5	51499376	51501436	BolC5t34651H	0	+	471	1772	2060	0.8601941
C5	51503246	51503465	BolC5t34652H	0	-	214	219	219	1.0000000
C5	51512957	51513107	BolC5t34653H	0	+	9	72	150	0.4800000
C5	51516480	51518428	BolC5t34654H	0	+	1060	1947	1948	0.9994866
C5	51519576	51523153	BolC5t34655H	0	+	2125	3577	3577	1.0000000
C5	51525096	51525402	BolC5t34656H	0	+	151	306	306	1.0000000
C5	51527111	51531039	BolC5t34657H	0	+	3898	3928	3928	1.0000000
C5	51534004	51566678	BolC5t34658H	0	+	9842	29847	32674	0.9134786
C5	51548019	51551775	BolC5t34659H	0	-	982	3756	3756	1.0000000
C5	51551911	51552766	BolC5t34660H	0	-	241	855	855	1.0000000
C5	51567043	51567492	BolC5t34661H	0	-	278	449	449	1.0000000
C5	51578870	51580312	BolC5t34662H	0	-	276	1340	1442	0.9292649
C5	51594240	51594444	BolC5t34663H	0	+	190	204	204	1.0000000
C5	51595254	51595500	BolC5t34664H	0	-	74	246	246	1.0000000
C5	51603304	51605168	BolC5t34665H	0	-	896	1848	1864	0.9914163
C5	51606146	51608755	BolC5t34666H	0	+	840	2512	2609	0.9628210
C5	51609476	51610272	BolC5t34667H	0	-	451	796	796	1.0000000
C5	51611248	51612369	BolC5t34668H	0	-	620	1121	1121	1.0000000
C5	51617829	51620659	BolC5t34669H	0	+	2528	2830	2830	1.0000000
C5	51621053	51622292	BolC5t34670H	0	-	624	1210	1239	0.9765940
C5	51623211	51635856	BolC5t34671H	0	+	3745	10159	12645	0.8034006
C5	51643706	51645022	BolC5t34672H	0	+	195	1098	1316	0.8343465
C5	51645610	51646469	BolC5t34673H	0	+	163	773	859	0.8998836
C5	51646632	51649316	BolC5t34674H	0	-	1498	2682	2684	0.9992548
C5	51651032	51653581	BolC5t34675H	0	+	328	2055	2549	0.8061985
C5	51653657	51654293	BolC5t34676H	0	-	322	636	636	1.0000000
C5	51659696	51666798	BolC5t34677H	0	+	2555	6887	7102	0.9697269
C5	51667100	51668399	BolC5t34678H	0	-	607	1286	1299	0.9899923
C5	51676054	51676390	BolC5t34679H	0	+	31	76	336	0.2261905
C5	51682053	51685728	BolC5t34680H	0	-	849	3472	3675	0.9447619
C5	51686653	51689104	BolC5t34681H	0	+	968	2311	2451	0.9428805
C5	51690778	51701043	BolC5t34682H	0	+	5286	10186	10265	0.9923040
C5	51704699	51705099	BolC5t34683H	0	-	366	400	400	1.0000000
C5	51706504	51710050	BolC5t34684H	0	+	1405	3515	3546	0.9912577
C5	51711305	51715127	BolC5t34685H	0	+	1408	3566	3822	0.9330193
C5	51716725	51721629	BolC5t34686H	0	-	3221	4904	4904	1.0000000
C5	51721836	51722213	BolC5t34687H	0	-	28	171	377	0.4535809
C5	51749584	51752483	BolC5t34688H	0	-	1209	2759	2899	0.9517075
C5	51752779	51754831	BolC5t34689H	0	+	529	2042	2052	0.9951267
C5	51757824	51758274	BolC5t34690H	0	+	74	398	450	0.8844444
C5	51766328	51767396	BolC5t34691H	0	+	0	0	1068	0.0000000
C5	51768644	51769157	BolC5t34692H	0	-	5	99	513	0.1929825
C5	51773823	51774224	BolC5t34693H	0	-	16	60	401	0.1496259
C5	51774223	51774748	BolC5t34694H	0	-	0	0	525	0.0000000
C5	51775075	51776757	BolC5t34695H	0	+	6	38	1682	0.0225922
C5	51783712	51784822	BolC5t34696H	0	+	8	219	1110	0.1972973
C5	51785336	51786725	BolC5t34697H	0	+	10	170	1389	0.1223902
C5	51801877	51802116	BolC5t34698H	0	+	33	133	239	0.5564854
C5	51811822	51812032	BolC5t34699H	0	-	2	114	210	0.5428572
C5	51813999	51816822	BolC5t34700H	0	+	506	2438	2823	0.8636203
C5	51817557	51817938	BolC5t34701H	0	-	24	298	381	0.7821522
C5	51830024	51831086	BolC5t34702H	0	-	433	1033	1062	0.9726930
C5	51834075	51838442	BolC5t34703H	0	-	868	3710	4367	0.8495535
C5	51839618	51841811	BolC5t34704H	0	-	606	1735	2193	0.7911537
C5	51846247	51851020	BolC5t34705H	0	-	1801	4741	4773	0.9932956
C5	51851593	51851883	BolC5t34706H	0	+	376	290	290	1.0000000
C5	51852192	51852795	BolC5t34707H	0	-	645	603	603	1.0000000
C5	51854424	51855773	BolC5t34708H	0	-	758	1349	1349	1.0000000
C5	51863169	51863652	BolC5t34709H	0	+	536	483	483	1.0000000
C5	51864696	51865895	BolC5t34710H	0	-	286	782	1199	0.6522102
C5	51866311	51866582	BolC5t34711H	0	+	62	271	271	1.0000000
C5	51868049	51874143	BolC5t34712H	0	+	755	3392	6094	0.5566131
C5	51875501	51875621	BolC5t34713H	0	+	13	80	120	0.6666667
C5	51875904	51876159	BolC5t34714H	0	+	19	226	255	0.8862745
C5	51880569	51881105	BolC5t34715H	0	+	68	468	536	0.8731343
C5	51884709	51885271	BolC5t34716H	0	+	691	562	562	1.0000000
C5	51888425	51891445	BolC5t34717H	0	+	1750	2966	3020	0.9821192
C5	51891981	51895198	BolC5t34718H	0	+	1551	3217	3217	1.0000000
C5	51896045	51897535	BolC5t34719H	0	-	1130	1490	1490	1.0000000
C5	51910679	51910916	BolC5t34720H	0	-	0	0	237	0.0000000
C5	51912620	51918429	BolC5t34721H	0	+	1579	5134	5809	0.8838010
C5	51918783	51924023	BolC5t34722H	0	+	1564	4370	5240	0.8339695
C5	51925093	51925721	BolC5t34723H	0	-	422	628	628	1.0000000
C5	51926022	51926708	BolC5t34724H	0	+	514	686	686	1.0000000
C5	51949075	51949732	BolC5t34725H	0	+	498	657	657	1.0000000
C5	51952516	51955187	BolC5t34726H	0	+	1836	2614	2671	0.9786597
C5	51955568	51958014	BolC5t34727H	0	-	1644	2392	2446	0.9779232
C5	51959542	51962743	BolC5t34728H	0	+	740	3119	3201	0.9743830
C5	51963476	51966085	BolC5t34729H	0	+	832	2311	2609	0.8857800
C5	51966441	51977265	BolC5t34730H	0	-	5402	10531	10824	0.9729306
C5	51978101	51980978	BolC5t34731H	0	-	550	2359	2877	0.8199514
C5	51982165	51985624	BolC5t34732H	0	-	1140	3177	3459	0.9184735
C5	52003084	52005313	BolC5t34733H	0	-	16	633	2229	0.2839839
C5	52020436	52022721	BolC5t34734H	0	+	1666	2285	2285	1.0000000
C5	52023411	52024233	BolC5t34735H	0	-	285	800	822	0.9732360
C5	52025112	52025685	BolC5t34736H	0	+	270	573	573	1.0000000
C5	52033791	52034515	BolC5t34737H	0	+	78	343	724	0.4737569
C5	52089581	52091203	BolC5t34738H	0	+	2045	1622	1622	1.0000000
C5	52091574	52092665	BolC5t34739H	0	+	1000	887	1091	0.8130156
C5	52100365	52102177	BolC5t34740H	0	+	2014	1812	1812	1.0000000
C5	52103171	52111391	BolC5t34741H	0	-	7718	7694	8220	0.9360097
C5	52119867	52120685	BolC5t34742H	0	+	1418	818	818	1.0000000
C5	52123498	52127461	BolC5t34743H	0	+	3240	3940	3963	0.9941963
C5	52128545	52129988	BolC5t34744H	0	-	1262	1443	1443	1.0000000
C5	52148974	52151913	BolC5t34745H	0	+	623	2580	2939	0.8778496
C5	52167100	52173473	BolC5t34746H	0	+	1846	3859	6373	0.6055233
C5	52176689	52178633	BolC5t34747H	0	+	979	1918	1944	0.9866255
C5	52179314	52181925	BolC5t34748H	0	-	1501	2552	2611	0.9774033
C5	52187367	52188333	BolC5t34749H	0	-	584	966	966	1.0000000
C5	52197309	52203610	BolC5t34750H	0	+	4129	6301	6301	1.0000000
C5	52209776	52211474	BolC5t34751H	0	-	327	1448	1698	0.8527679
C5	52211952	52216404	BolC5t34752H	0	+	3396	4409	4452	0.9903414
C5	52218776	52219698	BolC5t34753H	0	+	762	922	922	1.0000000
C5	52223595	52224642	BolC5t34754H	0	+	61	400	1047	0.3820439
C5	52239811	52239982	BolC5t34755H	0	-	83	171	171	1.0000000
C5	52270590	52271009	BolC5t34756H	0	-	49	392	419	0.9355609
C5	52274877	52276536	BolC5t34757H	0	+	1150	1659	1659	1.0000000
C5	52277075	52278912	BolC5t34758H	0	-	1365	1787	1837	0.9727817
C5	52279618	52282645	BolC5t34759H	0	+	1226	2955	3027	0.9762141
C5	52282705	52282810	BolC5t34760H	0	+	151	105	105	1.0000000
C5	52284051	52285227	BolC5t34761H	0	+	819	1176	1176	1.0000000
C5	52313219	52313375	BolC5t34762H	0	+	333	156	156	1.0000000
C5	52316727	52320794	BolC5t34763H	0	+	1201	3547	4067	0.8721416
C5	52321500	52322454	BolC5t34764H	0	+	257	879	954	0.9213836
C5	52324377	52326234	BolC5t34765H	0	+	634	1817	1857	0.9784599
C5	52328071	52328587	BolC5t34766H	0	+	121	382	516	0.7403101
C5	52329143	52329378	BolC5t34767H	0	-	0	0	235	0.0000000
C5	52330908	52331370	BolC5t34768H	0	-	425	462	462	1.0000000
C5	52332063	52333573	BolC5t34769H	0	+	761	1426	1510	0.9443709
C5	52334599	52335711	BolC5t34770H	0	-	124	884	1112	0.7949640
C5	52338442	52340107	BolC5t34771H	0	+	217	1605	1665	0.9639640
C5	52345381	52346584	BolC5t34772H	0	-	513	1164	1203	0.9675810
C5	52348712	52349998	BolC5t34773H	0	-	676	1286	1286	1.0000000
C5	52350896	52352490	BolC5t34774H	0	+	522	1312	1594	0.8230866
C5	52353354	52353522	BolC5t34775H	0	-	138	168	168	1.0000000
C5	52358786	52358990	BolC5t34776H	0	-	153	204	204	1.0000000
C5	52359241	52361658	BolC5t34777H	0	+	951	2266	2417	0.9375259
C5	52371652	52371850	BolC5t34778H	0	+	35	198	198	1.0000000
C5	52373148	52374773	BolC5t34779H	0	+	1084	1625	1625	1.0000000
C5	52375322	52376584	BolC5t34780H	0	+	537	1091	1262	0.8645008
C5	52377838	52378411	BolC5t34781H	0	+	391	573	573	1.0000000
C5	52379461	52379608	BolC5t34782H	0	+	50	147	147	1.0000000
C5	52380316	52384366	BolC5t34783H	0	+	2163	3754	4050	0.9269136
C5	52389104	52389986	BolC5t34784H	0	-	477	767	882	0.8696145
C5	52406081	52406819	BolC5t34785H	0	-	358	664	738	0.8997290
C5	52445541	52447159	BolC5t34786H	0	+	782	1608	1618	0.9938195
C5	52447963	52448674	BolC5t34787H	0	-	319	711	711	1.0000000
C5	52451915	52452488	BolC5t34788H	0	+	0	0	573	0.0000000
C5	52454800	52460098	BolC5t34789H	0	+	887	4436	5298	0.8372971
C5	52461335	52463432	BolC5t34790H	0	+	449	1855	2097	0.8845971
C5	52465313	52467273	BolC5t34791H	0	+	473	1921	1960	0.9801021
C5	52468474	52468795	BolC5t34792H	0	+	103	321	321	1.0000000
C5	52469683	52470427	BolC5t34793H	0	-	170	720	744	0.9677419
C5	52473657	52473762	BolC5t34794H	0	+	17	88	105	0.8380952
C5	52480957	52483594	BolC5t34795H	0	+	787	2474	2637	0.9381874
C5	52484051	52486174	BolC5t34796H	0	+	921	2056	2123	0.9684409
C5	52491052	52491514	BolC5t34797H	0	+	227	462	462	1.0000000
C5	52498331	52499336	BolC5t34798H	0	+	388	997	1005	0.9920398
C5	52504116	52505025	BolC5t34799H	0	+	64	585	909	0.6435643
C5	52510195	52510450	BolC5t34800H	0	-	235	255	255	1.0000000
C5	52515283	52517788	BolC5t34801H	0	+	474	2368	2505	0.9453094
C5	52520550	52522566	BolC5t34802H	0	-	1067	2006	2016	0.9950397
C5	52525494	52526934	BolC5t34803H	0	-	640	1440	1440	1.0000000
C5	52532661	52533267	BolC5t34804H	0	-	26	462	606	0.7623762
C5	52538949	52541088	BolC5t34805H	0	+	820	2106	2139	0.9845722
C5	52541646	52575059	BolC5t34806H	0	-	15430	30346	33413	0.9082094
C5	52577023	52580577	BolC5t34807H	0	-	2652	3554	3554	1.0000000
C5	52584593	52586094	BolC5t34808H	0	-	900	1385	1501	0.9227182
C5	52589061	52592181	BolC5t34809H	0	+	1594	3073	3120	0.9849359
C5	52592942	52594534	BolC5t34810H	0	-	1317	1592	1592	1.0000000
C5	52596431	52620180	BolC5t34811H	0	+	56426	7625	23749	0.3210661
C5	52626127	52628783	BolC5t34812H	0	-	1387	2656	2656	1.0000000
C5	52630487	52632610	BolC5t34813H	0	+	61	1313	2123	0.6184644
C5	52633122	52635376	BolC5t34814H	0	+	352	1968	2254	0.8731145
C5	52636768	52638772	BolC5t34815H	0	+	474	1376	2004	0.6866267
C5	52641080	52642264	BolC5t34816H	0	+	162	973	1184	0.8217905
C5	52643542	52651228	BolC5t34817H	0	+	265	2410	7686	0.3135571
C5	52657710	52659355	BolC5t34818H	0	+	245	1337	1645	0.8127660
C5	52658624	52659088	BolC5t34819H	0	-	113	430	464	0.9267241
C5	52663524	52663709	BolC5t34820H	0	-	29	161	185	0.8702703
C5	52664993	52666154	BolC5t34821H	0	+	212	1112	1161	0.9577950
C5	52667097	52668278	BolC5t34822H	0	-	797	1181	1181	1.0000000
C5	52669167	52670451	BolC5t34823H	0	-	1076	1284	1284	1.0000000
C5	52670721	52671806	BolC5t34824H	0	+	782	1085	1085	1.0000000
C5	52672312	52672764	BolC5t34825H	0	-	256	452	452	1.0000000
C5	52673708	52675952	BolC5t34826H	0	-	2042	2244	2244	1.0000000
C5	52678214	52678588	BolC5t34827H	0	+	537	374	374	1.0000000
C5	52678874	52681218	BolC5t34828H	0	-	1012	2297	2344	0.9799488
C5	52684018	52685396	BolC5t34829H	0	-	1348	1378	1378	1.0000000
C5	52701970	52702461	BolC5t34830H	0	-	473	491	491	1.0000000
C5	52757060	52758187	BolC5t34831H	0	-	520	1004	1127	0.8908607
C5	52760987	52761347	BolC5t34832H	0	-	208	360	360	1.0000000
C5	52762956	52765693	BolC5t34833H	0	-	2774	2737	2737	1.0000000
C5	52770166	52773127	BolC5t34834H	0	+	906	2807	2961	0.9479905
C5	52777980	52778595	BolC5t34835H	0	-	528	615	615	1.0000000
C5	52783463	52789413	BolC5t34836H	0	+	358	2061	5950	0.3463866
C5	52784902	52785389	BolC5t34837H	0	-	96	451	487	0.9260780
C5	52792626	52793373	BolC5t34838H	0	-	479	317	747	0.4243641
C5	52793897	52795059	BolC5t34839H	0	-	352	618	1162	0.5318416
C5	52803884	52804400	BolC5t34840H	0	-	228	516	516	1.0000000
C5	52806152	52810758	BolC5t34841H	0	-	1825	4361	4606	0.9468085
C5	52811458	52817502	BolC5t34842H	0	-	2003	4854	6044	0.8031105
C5	52822004	52823399	BolC5t34843H	0	+	461	1362	1395	0.9763441
C5	52823755	52828594	BolC5t34844H	0	-	2111	4661	4839	0.9632155
C5	52829997	52834366	BolC5t34845H	0	+	1349	3863	4369	0.8841840
C5	52834679	52836632	BolC5t34846H	0	+	898	1906	1953	0.9759344
C5	52837259	52839168	BolC5t34847H	0	+	995	1909	1909	1.0000000
C5	52839726	52841178	BolC5t34848H	0	+	697	1437	1452	0.9896694
C5	52843374	52843548	BolC5t34849H	0	+	506	174	174	1.0000000
C5	52846470	52847763	BolC5t34850H	0	+	242	1023	1293	0.7911833
C5	52850472	52851950	BolC5t34851H	0	+	478	1478	1478	1.0000000
C5	52852995	52855538	BolC5t34852H	0	+	1404	2524	2543	0.9925285
C5	52856387	52858008	BolC5t34853H	0	+	526	1526	1621	0.9413942
C5	52858788	52860346	BolC5t34854H	0	-	779	1369	1558	0.8786906
C5	52861176	52862862	BolC5t34855H	0	+	507	1626	1686	0.9644128
C5	52862992	52864101	BolC5t34856H	0	-	750	1109	1109	1.0000000
C5	52865056	52867307	BolC5t34857H	0	-	1761	2251	2251	1.0000000
C5	52881073	52883270	BolC5t34858H	0	-	1711	2197	2197	1.0000000
C5	52885369	52886518	BolC5t34859H	0	-	453	1048	1149	0.9120975
C5	52919946	52923709	BolC5t34860H	0	-	1422	3412	3763	0.9067234
C5	52959761	52960569	BolC5t34861H	0	+	149	511	808	0.6324257
C5	52960869	52962103	BolC5t34862H	0	-	234	1234	1234	1.0000000
C5	52965361	52973227	BolC5t34863H	0	+	1232	4686	7866	0.5957285
C5	52974245	52977882	BolC5t34864H	0	-	816	2959	3637	0.8135826
C5	52983505	52983730	BolC5t34865H	0	+	169	225	225	1.0000000
C5	52987400	52987595	BolC5t34866H	0	+	35	195	195	1.0000000
C5	52991965	52995433	BolC5t34867H	0	+	1648	3397	3468	0.9795271
C5	52996831	52998466	BolC5t34868H	0	+	1392	1618	1635	0.9896024
C5	52999328	53000706	BolC5t34869H	0	-	837	1378	1378	1.0000000
C5	53005164	53007023	BolC5t34870H	0	+	888	1859	1859	1.0000000
C5	53008025	53010788	BolC5t34871H	0	+	1095	2335	2763	0.8450959
C5	53011763	53013746	BolC5t34872H	0	-	1885	1983	1983	1.0000000
C5	53015432	53019302	BolC5t34873H	0	+	2297	3778	3870	0.9762274
C5	53020187	53021368	BolC5t34874H	0	-	1214	1181	1181	1.0000000
C5	53023313	53025951	BolC5t34875H	0	+	810	2438	2638	0.9241850
C5	53029351	53030431	BolC5t34876H	0	+	114	967	1080	0.8953704
C5	53032056	53033146	BolC5t34877H	0	+	913	1090	1090	1.0000000
C5	53035003	53038015	BolC5t34878H	0	+	2141	2896	3012	0.9614874
C5	53039291	53040709	BolC5t34879H	0	+	999	1418	1418	1.0000000
C5	53041363	53041783	BolC5t34880H	0	+	384	420	420	1.0000000
C5	53043939	53048341	BolC5t34881H	0	+	1612	4174	4402	0.9482054
C5	53048782	53050156	BolC5t34882H	0	+	400	1269	1374	0.9235808
C5	53051925	53054238	BolC5t34883H	0	+	387	2109	2313	0.9118028
C5	53055939	53056509	BolC5t34884H	0	+	33	88	570	0.1543860
C5	53059194	53062959	BolC5t34885H	0	+	2244	3565	3765	0.9468791
C5	53063365	53065312	BolC5t34886H	0	-	680	1920	1947	0.9861325
C5	53066442	53071330	BolC5t34887H	0	-	2173	4879	4888	0.9981588
C5	53075045	53075689	BolC5t34888H	0	+	241	611	644	0.9487578
C5	53078787	53079161	BolC5t34889H	0	+	218	374	374	1.0000000
C5	53082084	53082598	BolC5t34890H	0	-	0	0	514	0.0000000
C5	53082605	53082846	BolC5t34891H	0	-	41	218	241	0.9045643
C5	53084780	53085143	BolC5t34892H	0	+	0	0	363	0.0000000
C5	53114903	53120084	BolC5t34893H	0	-	1933	4532	5181	0.8747346
C5	53121253	53122479	BolC5t34894H	0	-	402	1192	1226	0.9722675
C5	53125378	53128023	BolC5t34895H	0	-	938	2541	2645	0.9606805
C5	53135014	53136269	BolC5t34896H	0	-	727	1248	1255	0.9944223
C5	53137183	53138252	BolC5t34897H	0	+	129	1048	1069	0.9803555
C5	53138365	53141130	BolC5t34898H	0	-	857	2457	2765	0.8886076
C5	53142410	53143259	BolC5t34899H	0	+	274	849	849	1.0000000
C5	53145584	53147134	BolC5t34900H	0	-	407	1549	1550	0.9993548
C5	53148679	53150960	BolC5t34901H	0	-	315	1609	2281	0.7053924
C5	53152905	53155894	BolC5t34902H	0	-	715	2768	2989	0.9260622
C5	53160145	53160793	BolC5t34903H	0	-	213	648	648	1.0000000
C5	53163209	53163698	BolC5t34904H	0	-	534	489	489	1.0000000
C5	53168826	53169360	BolC5t34905H	0	+	2	25	534	0.0468165
C5	53170909	53171574	BolC5t34906H	0	-	6	69	665	0.1037594
C5	53175176	53176901	BolC5t34907H	0	+	326	1682	1725	0.9750724
C5	53177523	53179482	BolC5t34908H	0	+	233	1856	1959	0.9474221
C5	53179607	53186304	BolC5t34909H	0	-	1620	6133	6697	0.9157832
C5	53191957	53192209	BolC5t34910H	0	-	174	252	252	1.0000000
C5	53198377	53198629	BolC5t34911H	0	-	24	183	252	0.7261904
C5	53202839	53204355	BolC5t34912H	0	+	325	1068	1516	0.7044855
C5	53208042	53208408	BolC5t34913H	0	+	193	326	366	0.8907104
C5	53210195	53210842	BolC5t34914H	0	-	162	615	647	0.9505410
C5	53215013	53216138	BolC5t34915H	0	+	998	1125	1125	1.0000000
C5	53217728	53218178	BolC5t34916H	0	+	180	450	450	1.0000000
C5	53218696	53219940	BolC5t34917H	0	-	799	1244	1244	1.0000000
C5	53221995	53222976	BolC5t34918H	0	+	274	981	981	1.0000000
C5	53290892	53293687	BolC5t34919H	0	+	1844	2795	2795	1.0000000
C5	53295623	53297618	BolC5t34920H	0	+	1485	1995	1995	1.0000000
C5	53299452	53301444	BolC5t34921H	0	+	1364	1992	1992	1.0000000
C5	53302526	53303009	BolC5t34922H	0	+	254	483	483	1.0000000
C5	53306717	53307653	BolC5t34923H	0	-	199	913	936	0.9754273
C5	53310442	53312345	BolC5t34924H	0	+	755	1855	1903	0.9747767
C5	53312944	53313873	BolC5t34925H	0	-	302	901	929	0.9698601
C5	53362823	53365166	BolC5t34926H	0	+	590	2211	2343	0.9436620
C5	53367754	53368348	BolC5t34927H	0	+	1	35	594	0.0589226
C5	53371392	53373038	BolC5t34928H	0	+	562	1492	1646	0.9064398
C5	53377064	53385448	BolC5t34929H	0	-	3258	6837	8384	0.8154818
C5	53386529	53389996	BolC5t34930H	0	+	1877	3467	3467	1.0000000
C5	53390810	53391047	BolC5t34931H	0	+	110	237	237	1.0000000
C5	53392916	53393207	BolC5t34932H	0	+	348	291	291	1.0000000
C5	53395779	53396401	BolC5t34933H	0	-	422	622	622	1.0000000
C5	53397320	53399097	BolC5t34934H	0	-	1384	1777	1777	1.0000000
C5	53401188	53401759	BolC5t34935H	0	-	470	571	571	1.0000000
C5	53403656	53405033	BolC5t34936H	0	-	428	1367	1377	0.9927378
C5	53406620	53408024	BolC5t34937H	0	-	1233	1404	1404	1.0000000
C5	53410891	53412034	BolC5t34938H	0	+	170	1128	1143	0.9868767
C5	53412145	53421610	BolC5t34939H	0	-	863	5519	9465	0.5830956
C5	53422375	53428563	BolC5t34940H	0	+	1330	5324	6188	0.8603749
C5	53428615	53429339	BolC5t34941H	0	+	666	724	724	1.0000000
C5	53430121	53430483	BolC5t34942H	0	-	292	362	362	1.0000000
C5	53434490	53437728	BolC5t34943H	0	+	1154	2968	3238	0.9166152
C5	53446926	53447449	BolC5t34944H	0	+	132	424	523	0.8107074
C5	53449817	53450758	BolC5t34945H	0	+	203	804	941	0.8544102
C5	53452508	53452949	BolC5t34946H	0	+	66	441	441	1.0000000
C5	53454905	53465810	BolC5t34947H	0	+	1698	7225	10905	0.6625401
C5	53467092	53470986	BolC5t34948H	0	+	236	1847	3894	0.4743195
C5	53471126	53471602	BolC5t34949H	0	+	286	373	476	0.7836134
C5	53472074	53474148	BolC5t34950H	0	-	124	1569	2074	0.7565092
C5	53475434	53476946	BolC5t34951H	0	-	848	1512	1512	1.0000000
C5	53478782	53480934	BolC5t34952H	0	-	1152	2152	2152	1.0000000
C5	53568960	53570449	BolC5t34953H	0	+	418	1301	1489	0.8737408
C5	53573446	53574851	BolC5t34954H	0	+	1390	1385	1405	0.9857651
C5	53576604	53578324	BolC5t34955H	0	-	561	1720	1720	1.0000000
C5	53596246	53597969	BolC5t34956H	0	+	1010	1583	1723	0.9187464
C5	53598262	53600286	BolC5t34957H	0	-	732	2024	2024	1.0000000
C5	53602557	53604952	BolC5t34958H	0	+	1023	2228	2395	0.9302714
C5	53606424	53607415	BolC5t34959H	0	-	535	986	991	0.9949546
C5	53608198	53609137	BolC5t34960H	0	-	17	168	939	0.1789137
C5	53613781	53615464	BolC5t34961H	0	+	835	1676	1683	0.9958408
C5	53615808	53619045	BolC5t34962H	0	-	938	3098	3237	0.9570590
C5	53619736	53621877	BolC5t34963H	0	-	1134	2141	2141	1.0000000
C5	53623459	53626983	BolC5t34964H	0	+	1774	3490	3524	0.9903519
C5	53647947	53650102	BolC5t34965H	0	+	741	2132	2155	0.9893271
C5	53652127	53653966	BolC5t34966H	0	-	636	1564	1839	0.8504622
C5	53655162	53656270	BolC5t34967H	0	+	861	1108	1108	1.0000000
C5	53657036	53657246	BolC5t34968H	0	+	333	210	210	1.0000000
C5	53657495	53659808	BolC5t34969H	0	+	1830	2313	2313	1.0000000
C5	53660648	53661515	BolC5t34970H	0	-	563	867	867	1.0000000
C5	53662030	53665037	BolC5t34971H	0	+	5186	3007	3007	1.0000000
C5	53667617	53668410	BolC5t34972H	0	-	331	793	793	1.0000000
C5	53669995	53671341	BolC5t34973H	0	-	425	1187	1346	0.8818722
C5	53672903	53674445	BolC5t34974H	0	-	525	1401	1542	0.9085603
C5	53706937	53707267	BolC5t34975H	0	-	0	0	330	0.0000000
C5	53714873	53715187	BolC5t34976H	0	-	0	0	314	0.0000000
C5	53717036	53717365	BolC5t34977H	0	-	7	224	329	0.6808510
C5	53718563	53718900	BolC5t34978H	0	-	0	0	337	0.0000000
C5	53721810	53722125	BolC5t34979H	0	-	0	0	315	0.0000000
C5	53723126	53725276	BolC5t34980H	0	-	149	1050	2150	0.4883721
C5	53725921	53730325	BolC5t34981H	0	-	1523	4191	4404	0.9516349
C5	53735023	53736142	BolC5t34982H	0	-	555	1119	1119	1.0000000
C5	53742722	53745549	BolC5t34983H	0	+	629	2687	2827	0.9504775
C5	53745872	53747523	BolC5t34984H	0	-	963	1651	1651	1.0000000
C5	53748718	53751853	BolC5t34985H	0	+	1625	3135	3135	1.0000000
C5	53752488	53757319	BolC5t34986H	0	-	2189	4794	4831	0.9923411
C5	53757979	53759771	BolC5t34987H	0	-	541	1676	1792	0.9352679
C5	53779533	53781158	BolC5t34988H	0	+	476	1297	1625	0.7981538
C5	53786451	53788319	BolC5t34989H	0	+	493	1476	1868	0.7901499
C5	53790751	53792875	BolC5t34990H	0	+	1590	2124	2124	1.0000000
C5	53793131	53794821	BolC5t34991H	0	-	1546	1690	1690	1.0000000
C5	53796316	53796955	BolC5t34992H	0	+	70	479	639	0.7496088
C5	53797752	53798715	BolC5t34993H	0	+	606	963	963	1.0000000
C5	53799465	53802120	BolC5t34994H	0	+	402	2253	2655	0.8485876
C5	53803187	53804542	BolC5t34995H	0	-	294	1240	1355	0.9151291
C5	53809340	53812129	BolC5t34996H	0	+	852	2182	2789	0.7823592
C5	53866380	53868104	BolC5t34997H	0	-	1990	1724	1724	1.0000000
C5	53870068	53871629	BolC5t34998H	0	+	1839	1561	1561	1.0000000
C5	53874810	53875356	BolC5t34999H	0	+	6	168	546	0.3076923
C5	53876777	53879757	BolC5t35000H	0	+	104	561	2980	0.1882550
C5	53885895	53887532	BolC5t35001H	0	+	544	1401	1637	0.8558338
C5	53895752	53897384	BolC5t35002H	0	+	1280	1632	1632	1.0000000
C5	53898401	53900967	BolC5t35003H	0	-	2431	2566	2566	1.0000000
C5	53901882	53902134	BolC5t35004H	0	-	387	252	252	1.0000000
C5	53902541	53903548	BolC5t35005H	0	-	619	1007	1007	1.0000000
C5	53904714	53904927	BolC5t35006H	0	+	205	213	213	1.0000000
C5	53905633	53914229	BolC5t35007H	0	-	8698	8596	8596	1.0000000
C5	53916063	53918421	BolC5t35008H	0	+	2080	2358	2358	1.0000000
C5	53918885	53920498	BolC5t35009H	0	+	1155	1549	1613	0.9603224
C5	53920936	53922350	BolC5t35010H	0	-	1449	1414	1414	1.0000000
C5	53922878	53925373	BolC5t35011H	0	+	2920	2491	2495	0.9983968
C5	53925621	53928524	BolC5t35012H	0	+	3530	2903	2903	1.0000000
C5	53929460	53935382	BolC5t35013H	0	+	280	3047	5922	0.5145221
C5	53936495	53936869	BolC5t35014H	0	-	13	161	374	0.4304813
C5	53944473	53955782	BolC5t35015H	0	+	315	3476	11309	0.3073658
C5	53946024	53947445	BolC5t35016H	0	+	205	1279	1421	0.9000704
C5	53956470	53956844	BolC5t35017H	0	-	0	0	374	0.0000000
C5	53965450	53966873	BolC5t35018H	0	+	106	1321	1423	0.9283205
C5	53978252	53979346	BolC5t35019H	0	-	1264	1094	1094	1.0000000
C5	53981807	53982017	BolC5t35020H	0	-	287	210	210	1.0000000
C5	53983963	53984488	BolC5t35021H	0	-	684	525	525	1.0000000
C5	53994091	53995039	BolC5t35022H	0	+	1175	948	948	1.0000000
C5	53996803	54000431	BolC5t35023H	0	+	1407	3628	3628	1.0000000
C5	54001123	54005034	BolC5t35024H	0	+	4836	3911	3911	1.0000000
C5	54006738	54008217	BolC5t35025H	0	+	1324	1479	1479	1.0000000
C5	54010043	54011521	BolC5t35026H	0	+	1482	1478	1478	1.0000000
C5	54099760	54100343	BolC5t35027H	0	+	586	583	583	1.0000000
C5	54100760	54102320	BolC5t35028H	0	+	1014	1416	1560	0.9076923
C5	54102648	54103743	BolC5t35029H	0	-	550	1054	1095	0.9625571
C5	54106827	54109270	BolC5t35030H	0	+	859	2387	2443	0.9770774
C5	54109851	54111197	BolC5t35031H	0	-	391	836	1346	0.6210995
C5	54112484	54113006	BolC5t35032H	0	-	146	522	522	1.0000000
C5	54115245	54115383	BolC5t35033H	0	-	104	133	138	0.9637681
C5	54116479	54116872	BolC5t35034H	0	-	50	364	393	0.9262087
C5	54117290	54119426	BolC5t35035H	0	+	867	2035	2136	0.9527153
C5	54120049	54122652	BolC5t35036H	0	-	314	2106	2603	0.8090665
C5	54123580	54124988	BolC5t35037H	0	-	1416	1408	1408	1.0000000
C5	54125439	54131787	BolC5t35038H	0	-	1283	5380	6348	0.8475111
C5	54133273	54134302	BolC5t35039H	0	+	523	1012	1029	0.9834791
C5	54141424	54142451	BolC5t35040H	0	+	187	1027	1027	1.0000000
C5	54142547	54144531	BolC5t35041H	0	+	801	1976	1984	0.9959677
C5	54145259	54145974	BolC5t35042H	0	+	296	700	715	0.9790210
C5	54148513	54149224	BolC5t35043H	0	+	476	711	711	1.0000000
C5	54149669	54152673	BolC5t35044H	0	-	1698	2968	3004	0.9880159
C5	54153461	54157477	BolC5t35045H	0	-	836	3430	4016	0.8540837
C5	54159810	54162037	BolC5t35046H	0	-	749	2162	2227	0.9708127
C5	54162520	54162673	BolC5t35047H	0	+	109	153	153	1.0000000
C5	54163428	54164081	BolC5t35048H	0	+	698	653	653	1.0000000
C5	54165217	54166828	BolC5t35049H	0	+	319	1072	1611	0.6654252
C5	54168184	54168984	BolC5t35050H	0	+	210	757	800	0.9462500
C5	54169864	54171617	BolC5t35051H	0	-	3	99	1753	0.0564746
C5	54246513	54246714	BolC5t35052H	0	-	517	201	201	1.0000000
C5	54250152	54252529	BolC5t35053H	0	-	773	1846	2377	0.7766092
C5	54255259	54255838	BolC5t35054H	0	-	158	524	579	0.9050086
C5	54260062	54262113	BolC5t35055H	0	-	614	1865	2051	0.9093125
C5	54263007	54265304	BolC5t35056H	0	-	441	2050	2297	0.8924685
C5	54266372	54268063	BolC5t35057H	0	+	963	1691	1691	1.0000000
C5	54268766	54270441	BolC5t35058H	0	+	1076	1671	1675	0.9976119
C5	54271799	54275577	BolC5t35059H	0	+	1316	3543	3778	0.9377978
C5	54275652	54276780	BolC5t35060H	0	-	223	973	1128	0.8625886
C5	54279917	54280043	BolC5t35061H	0	+	189	126	126	1.0000000
C5	54280876	54282662	BolC5t35062H	0	-	377	1501	1786	0.8404256
C5	54283221	54284708	BolC5t35063H	0	-	652	1469	1487	0.9878951
C5	54285423	54287519	BolC5t35064H	0	+	497	1804	2096	0.8606870
C5	54288886	54289961	BolC5t35065H	0	+	725	1075	1075	1.0000000
C5	54290903	54291221	BolC5t35066H	0	-	274	318	318	1.0000000
C5	54291570	54293348	BolC5t35067H	0	+	1220	1778	1778	1.0000000
C5	54294162	54297491	BolC5t35068H	0	+	2075	3261	3329	0.9795734
C5	54297958	54300229	BolC5t35069H	0	-	1249	2140	2271	0.9423162
C5	54301319	54302131	BolC5t35070H	0	+	727	812	812	1.0000000
C5	54303353	54304953	BolC5t35071H	0	+	455	820	1600	0.5125000
C5	54305181	54309027	BolC5t35072H	0	-	1910	3206	3846	0.8335934
C5	54311901	54314631	BolC5t35073H	0	-	2202	2730	2730	1.0000000
C5	54460134	54461189	BolC5t35074H	0	-	847	1055	1055	1.0000000
C5	54461958	54462790	BolC5t35075H	0	+	397	832	832	1.0000000
C5	54463041	54465082	BolC5t35076H	0	-	676	1749	2041	0.8569329
C5	54467479	54469209	BolC5t35077H	0	+	831	1730	1730	1.0000000
C5	54470059	54472591	BolC5t35078H	0	+	1455	2532	2532	1.0000000
C5	54474193	54476548	BolC5t35079H	0	+	963	1826	2355	0.7753716
C5	54487357	54488455	BolC5t35080H	0	-	83	950	1098	0.8652095
C5	54488581	54488819	BolC5t35081H	0	-	92	229	238	0.9621848
C5	54491117	54496014	BolC5t35082H	0	+	2698	4790	4897	0.9781499
C5	54496964	54499364	BolC5t35083H	0	+	870	2328	2400	0.9700000
C5	54499713	54500718	BolC5t35084H	0	-	210	855	1005	0.8507463
C5	54502073	54502495	BolC5t35085H	0	+	8	181	422	0.4289100
C5	54504858	54506785	BolC5t35086H	0	-	22	734	1927	0.3809029
C5	54507333	54507752	BolC5t35087H	0	-	125	354	419	0.8448687
C5	54509796	54511590	BolC5t35088H	0	+	123	1066	1794	0.5942029
C5	54514366	54515919	BolC5t35089H	0	-	259	1209	1553	0.7784932
C5	54519932	54521565	BolC5t35090H	0	+	1066	1598	1633	0.9785671
C5	54522658	54524932	BolC5t35091H	0	-	870	2034	2274	0.8944591
C5	54525822	54529019	BolC5t35092H	0	-	1027	3052	3197	0.9546450
C5	54526189	54527032	BolC5t35093H	0	-	254	698	843	0.8279952
C5	54530457	54547518	BolC5t35094H	0	+	847	3921	17061	0.2298224
C5	54553102	54553642	BolC5t35095H	0	+	57	188	540	0.3481481
C5	54554203	54555052	BolC5t35096H	0	-	387	733	849	0.8633687
C5	54556900	54558781	BolC5t35097H	0	-	544	1836	1881	0.9760765
C5	54561754	54563035	BolC5t35098H	0	+	606	1281	1281	1.0000000
C5	54563714	54565811	BolC5t35099H	0	+	964	1996	2097	0.9518359
C5	54566191	54568305	BolC5t35100H	0	-	1429	2114	2114	1.0000000
C5	54568756	54568998	BolC5t35101H	0	+	145	242	242	1.0000000
C5	54582749	54585639	BolC5t35102H	0	+	1209	2775	2890	0.9602076
C5	54585959	54587084	BolC5t35103H	0	-	926	1125	1125	1.0000000
C5	54590226	54591607	BolC5t35104H	0	-	429	1226	1381	0.8877625
C5	54597857	54598700	BolC5t35105H	0	+	376	584	843	0.6927639
C5	54600030	54601202	BolC5t35106H	0	-	169	688	1172	0.5870307
C5	54704276	54706740	BolC5t35107H	0	+	495	2142	2464	0.8693182
C5	54707417	54708752	BolC5t35108H	0	-	163	1251	1335	0.9370787
C5	54710900	54712435	BolC5t35109H	0	+	180	1175	1535	0.7654723
C5	54713273	54716986	BolC5t35110H	0	-	868	3380	3713	0.9103151
C5	54717318	54718262	BolC5t35111H	0	+	594	944	944	1.0000000
C5	54718976	54721304	BolC5t35112H	0	+	780	2214	2328	0.9510309
C5	54724839	54725208	BolC5t35113H	0	-	131	369	369	1.0000000
C5	54730133	54735356	BolC5t35114H	0	+	1404	4838	5223	0.9262876
C5	54736052	54738410	BolC5t35115H	0	-	271	1960	2358	0.8312129
C5	54742223	54745549	BolC5t35116H	0	-	1353	3300	3326	0.9921828
C5	54746874	54749398	BolC5t35117H	0	-	969	2524	2524	1.0000000
C5	54752098	54752826	BolC5t35118H	0	-	233	561	728	0.7706044
C5	54759252	54760729	BolC5t35119H	0	-	196	1020	1477	0.6905890
C5	54763742	54766385	BolC5t35120H	0	+	506	2551	2643	0.9651911
C5	54766891	54769642	BolC5t35121H	0	-	1257	2687	2751	0.9767357
C5	54770249	54770885	BolC5t35122H	0	+	600	636	636	1.0000000
C5	54771781	54774895	BolC5t35123H	0	-	1451	3114	3114	1.0000000
C5	54776530	54777738	BolC5t35124H	0	-	188	928	1208	0.7682119
C5	54780155	54781615	BolC5t35125H	0	-	106	1046	1460	0.7164384
C5	54782437	54784458	BolC5t35126H	0	+	261	1707	2021	0.8446314
C5	54787030	54787408	BolC5t35127H	0	-	0	0	378	0.0000000
C5	54790151	54790544	BolC5t35128H	0	-	16	113	393	0.2875318
C5	54790946	54791429	BolC5t35129H	0	+	11	240	483	0.4968944
C5	54794126	54795546	BolC5t35130H	0	+	518	1201	1420	0.8457747
C5	54828850	54829281	BolC5t35131H	0	-	0	0	431	0.0000000
C5	54832030	54832378	BolC5t35132H	0	+	0	0	348	0.0000000
C5	54835182	54835314	BolC5t35133H	0	-	0	0	132	0.0000000
C5	54838080	54838425	BolC5t35134H	0	-	0	0	345	0.0000000
C5	54839076	54839307	BolC5t35135H	0	+	0	0	231	0.0000000
C5	54841982	54842622	BolC5t35136H	0	+	0	0	640	0.0000000
C5	54882728	54884892	BolC5t35137H	0	-	760	2118	2164	0.9787431
C5	54886784	54887937	BolC5t35138H	0	-	309	1114	1153	0.9661752
C5	54890687	54896355	BolC5t35139H	0	-	469	2103	5668	0.3710304
C5	54897761	54899829	BolC5t35140H	0	-	552	1993	2068	0.9637331
C5	54900320	54901229	BolC5t35141H	0	-	134	785	909	0.8635864
C5	54908571	54911083	BolC5t35142H	0	+	452	2103	2512	0.8371815
C5	54911323	54912274	BolC5t35143H	0	-	288	891	951	0.9369085
C5	54912570	54916944	BolC5t35144H	0	+	813	3716	4374	0.8495656
C5	54917327	54922364	BolC5t35145H	0	-	1812	4909	5037	0.9745880
C5	54922809	54923371	BolC5t35146H	0	-	646	553	562	0.9839858
C5	54924981	54929368	BolC5t35147H	0	-	1295	3820	4387	0.8707545
C5	54943207	54944063	BolC5t35148H	0	-	562	827	856	0.9661215
C5	54944460	54945182	BolC5t35149H	0	+	276	638	722	0.8836565
C5	54946117	54954911	BolC5t35150H	0	+	1489	6457	8794	0.7342506
C5	54955507	54956732	BolC5t35151H	0	-	493	1160	1225	0.9469388
C5	54970165	54971905	BolC5t35152H	0	+	1125	1702	1740	0.9781609
C5	54972362	54974423	BolC5t35153H	0	-	725	1928	2061	0.9354682
C5	54976602	54980610	BolC5t35154H	0	-	992	3491	4008	0.8710080
C5	54982950	54983521	BolC5t35155H	0	-	680	571	571	1.0000000
C5	54992235	54992781	BolC5t35156H	0	+	531	546	546	1.0000000
C5	54993963	54994993	BolC5t35157H	0	+	896	1030	1030	1.0000000
C5	54995604	54996772	BolC5t35158H	0	-	696	1168	1168	1.0000000
C6	8001	8496	BolC6t35159H	0	-	0	0	495	0.0000000
C6	11114	11309	BolC6t35160H	0	-	0	0	195	0.0000000
C6	46685	47595	BolC6t35161H	0	+	0	0	910	0.0000000
C6	53588	53909	BolC6t35162H	0	+	372	321	321	1.0000000
C6	56286	56445	BolC6t35163H	0	+	40	159	159	1.0000000
C6	65494	65916	BolC6t35164H	0	+	133	422	422	1.0000000
C6	69617	69935	BolC6t35165H	0	+	327	318	318	1.0000000
C6	70607	70781	BolC6t35166H	0	+	229	174	174	1.0000000
C6	93024	93162	BolC6t35167H	0	+	70	110	138	0.7971014
C6	131826	134879	BolC6t35168H	0	+	5601	3053	3053	1.0000000
C6	135304	135994	BolC6t35169H	0	+	691	690	690	1.0000000
C6	160678	162075	BolC6t35170H	0	+	1464	1397	1397	1.0000000
C6	164798	166035	BolC6t35171H	0	-	173	1066	1237	0.8617623
C6	169657	171275	BolC6t35172H	0	-	2279	1618	1618	1.0000000
C6	207947	208945	BolC6t35173H	0	+	0	0	998	0.0000000
C6	209629	210500	BolC6t35174H	0	+	30	477	871	0.5476464
C6	218640	218829	BolC6t35175H	0	+	208	189	189	1.0000000
C6	223129	225034	BolC6t35176H	0	-	2282	1905	1905	1.0000000
C6	239270	240401	BolC6t35177H	0	-	1527	1131	1131	1.0000000
C6	249354	250000	BolC6t35178H	0	+	294	646	646	1.0000000
C6	313425	315656	BolC6t35179H	0	-	2772	2231	2231	1.0000000
C6	341283	341618	BolC6t35180H	0	+	308	335	335	1.0000000
C6	353881	355891	BolC6t35181H	0	-	1240	2010	2010	1.0000000
C6	362283	368442	BolC6t35182H	0	-	161	1531	6159	0.2485793
C6	377532	379799	BolC6t35183H	0	-	16	553	2267	0.2439347
C6	399238	399352	BolC6t35184H	0	+	18	114	114	1.0000000
C6	400672	401182	BolC6t35185H	0	+	149	510	510	1.0000000
C6	403797	403911	BolC6t35186H	0	+	81	114	114	1.0000000
C6	406755	412985	BolC6t35187H	0	+	2109	6156	6230	0.9881220
C6	411058	411958	BolC6t35188H	0	-	300	859	900	0.9544445
C6	412992	413494	BolC6t35189H	0	-	244	502	502	1.0000000
C6	443293	444523	BolC6t35190H	0	+	1551	1230	1230	1.0000000
C6	444842	445726	BolC6t35191H	0	-	887	884	884	1.0000000
C6	460805	461604	BolC6t35192H	0	-	994	799	799	1.0000000
C6	465531	467922	BolC6t35193H	0	+	2922	2391	2391	1.0000000
C6	472044	477022	BolC6t35194H	0	+	1387	4449	4978	0.8937324
C6	479647	480073	BolC6t35195H	0	+	302	426	426	1.0000000
C6	481041	486716	BolC6t35196H	0	-	5212	5675	5675	1.0000000
C6	544874	545876	BolC6t35197H	0	+	0	0	1002	0.0000000
C6	549466	549649	BolC6t35198H	0	-	0	0	183	0.0000000
C6	587120	587423	BolC6t35199H	0	+	221	303	303	1.0000000
C6	588985	589219	BolC6t35200H	0	-	118	234	234	1.0000000
C6	638365	640631	BolC6t35201H	0	-	2392	2266	2266	1.0000000
C6	647352	648652	BolC6t35202H	0	-	1283	1300	1300	1.0000000
C6	660961	673403	BolC6t35203H	0	-	3289	6480	12442	0.5208166
C6	684404	687224	BolC6t35204H	0	-	3645	2820	2820	1.0000000
C6	712236	713105	BolC6t35205H	0	+	23	768	869	0.8837745
C6	713499	713947	BolC6t35206H	0	-	7	274	448	0.6116071
C6	727596	727941	BolC6t35207H	0	-	0	0	345	0.0000000
C6	730935	731934	BolC6t35208H	0	-	1553	999	999	1.0000000
C6	750887	751097	BolC6t35209H	0	+	176	210	210	1.0000000
C6	753875	754127	BolC6t35210H	0	-	329	252	252	1.0000000
C6	755527	755758	BolC6t35211H	0	-	101	231	231	1.0000000
C6	808245	809340	BolC6t35212H	0	+	1335	1095	1095	1.0000000
C6	811741	813483	BolC6t35213H	0	-	2055	1742	1742	1.0000000
C6	834737	835052	BolC6t35214H	0	+	463	315	315	1.0000000
C6	852512	853331	BolC6t35215H	0	+	568	765	819	0.9340659
C6	858366	858775	BolC6t35216H	0	+	828	409	409	1.0000000
C6	860665	861830	BolC6t35217H	0	-	39	553	1165	0.4746781
C6	865909	867453	BolC6t35218H	0	-	1806	1544	1544	1.0000000
C6	875321	877502	BolC6t35219H	0	+	2957	2181	2181	1.0000000
C6	878048	879192	BolC6t35220H	0	-	1810	1144	1144	1.0000000
C6	884089	884444	BolC6t35221H	0	+	50	344	355	0.9690141
C6	886294	886713	BolC6t35222H	0	-	279	419	419	1.0000000
C6	894530	896999	BolC6t35223H	0	-	3348	2469	2469	1.0000000
C6	914708	915008	BolC6t35224H	0	-	328	300	300	1.0000000
C6	920816	921326	BolC6t35225H	0	-	370	510	510	1.0000000
C6	949554	955064	BolC6t35226H	0	-	1390	5120	5510	0.9292196
C6	1004513	1006831	BolC6t35227H	0	+	280	1954	2318	0.8429680
C6	1017709	1018075	BolC6t35228H	0	-	413	366	366	1.0000000
C6	1018675	1018777	BolC6t35229H	0	+	166	102	102	1.0000000
C6	1042855	1044717	BolC6t35230H	0	+	3138	1862	1862	1.0000000
C6	1072659	1072887	BolC6t35231H	0	-	150	228	228	1.0000000
C6	1150134	1150758	BolC6t35232H	0	+	1447	624	624	1.0000000
C6	1181373	1183350	BolC6t35233H	0	+	2455	1977	1977	1.0000000
C6	1191609	1191855	BolC6t35234H	0	+	40	173	246	0.7032520
C6	1200717	1201026	BolC6t35235H	0	-	244	309	309	1.0000000
C6	1208651	1209530	BolC6t35236H	0	+	12	493	879	0.5608646
C6	1215133	1215430	BolC6t35237H	0	+	367	297	297	1.0000000
C6	1238846	1239095	BolC6t35238H	0	+	54	249	249	1.0000000
C6	1242040	1246220	BolC6t35239H	0	+	3744	4180	4180	1.0000000
C6	1246890	1247961	BolC6t35240H	0	+	1234	1071	1071	1.0000000
C6	1255309	1259889	BolC6t35241H	0	+	820	3549	4580	0.7748908
C6	1272797	1273047	BolC6t35242H	0	-	273	250	250	1.0000000
C6	1273459	1275012	BolC6t35243H	0	-	583	1528	1553	0.9839021
C6	1280022	1281029	BolC6t35244H	0	-	208	390	1007	0.3872890
C6	1283014	1284079	BolC6t35245H	0	+	651	1065	1065	1.0000000
C6	1284752	1286316	BolC6t35246H	0	+	294	1338	1564	0.8554987
C6	1292594	1293137	BolC6t35247H	0	+	9	453	543	0.8342541
C6	1297947	1298133	BolC6t35248H	0	+	115	186	186	1.0000000
C6	1299724	1312851	BolC6t35249H	0	+	3969	9655	13127	0.7355070
C6	1314030	1315452	BolC6t35250H	0	+	198	1422	1422	1.0000000
C6	1323642	1325349	BolC6t35251H	0	+	1266	1707	1707	1.0000000
C6	1326873	1329101	BolC6t35252H	0	-	943	2228	2228	1.0000000
C6	1336356	1338057	BolC6t35253H	0	+	1024	1687	1701	0.9917696
C6	1363869	1367631	BolC6t35254H	0	+	2595	3611	3762	0.9598618
C6	1367794	1368243	BolC6t35255H	0	-	359	449	449	1.0000000
C6	1374695	1375654	BolC6t35256H	0	+	2	113	959	0.1178311
C6	1377353	1377738	BolC6t35257H	0	+	10	176	385	0.4571429
C6	1414075	1414779	BolC6t35258H	0	-	294	704	704	1.0000000
C6	1416318	1418200	BolC6t35259H	0	+	1891	1867	1882	0.9920297
C6	1441354	1442897	BolC6t35260H	0	+	75	475	1543	0.3078419
C6	1458270	1458411	BolC6t35261H	0	-	399	141	141	1.0000000
C6	1462077	1462497	BolC6t35262H	0	-	0	0	420	0.0000000
C6	1480568	1480673	BolC6t35263H	0	-	16	105	105	1.0000000
C6	1483509	1495263	BolC6t35264H	0	+	3656	10267	11754	0.8734899
C6	1497253	1497484	BolC6t35265H	0	+	12	141	231	0.6103896
C6	1500664	1501906	BolC6t35266H	0	+	2321	1242	1242	1.0000000
C6	1510573	1513419	BolC6t35267H	0	+	16	747	2846	0.2624736
C6	1518796	1520946	BolC6t35268H	0	+	120	296	2150	0.1376744
C6	1524135	1524609	BolC6t35269H	0	+	4	118	474	0.2489451
C6	1528031	1532641	BolC6t35270H	0	+	1763	3670	4610	0.7960954
C6	1544745	1546077	BolC6t35271H	0	+	4951	1332	1332	1.0000000
C6	1558291	1558639	BolC6t35272H	0	-	1165	348	348	1.0000000
C6	1569906	1570743	BolC6t35273H	0	-	65090	837	837	1.0000000
C6	1601504	1601760	BolC6t35274H	0	+	288	256	256	1.0000000
C6	1605032	1607753	BolC6t35275H	0	-	1324	2706	2721	0.9944873
C6	1620413	1622189	BolC6t35276H	0	-	138	449	1776	0.2528153
C6	1630769	1631594	BolC6t35277H	0	+	793	649	825	0.7866667
C6	1636468	1637104	BolC6t35278H	0	-	212	453	636	0.7122642
C6	1638872	1640442	BolC6t35279H	0	+	1361	1570	1570	1.0000000
C6	1641834	1643593	BolC6t35280H	0	-	1066	1759	1759	1.0000000
C6	1663701	1666052	BolC6t35281H	0	-	1221	2184	2351	0.9289664
C6	1680223	1680816	BolC6t35282H	0	-	218	593	593	1.0000000
C6	1690117	1691479	BolC6t35283H	0	+	592	1362	1362	1.0000000
C6	1691999	1694124	BolC6t35284H	0	-	1256	2125	2125	1.0000000
C6	1702387	1703600	BolC6t35285H	0	+	447	1213	1213	1.0000000
C6	1719946	1721003	BolC6t35286H	0	+	674	1057	1057	1.0000000
C6	1743248	1743419	BolC6t35287H	0	-	368	171	171	1.0000000
C6	1783574	1783955	BolC6t35288H	0	-	202	381	381	1.0000000
C6	1789138	1789357	BolC6t35289H	0	-	315	219	219	1.0000000
C6	1801067	1801313	BolC6t35290H	0	+	441	246	246	1.0000000
C6	1813596	1813791	BolC6t35291H	0	-	339	195	195	1.0000000
C6	1843487	1844574	BolC6t35292H	0	+	199	1053	1087	0.9687213
C6	1853844	1854493	BolC6t35293H	0	+	500	649	649	1.0000000
C6	1881693	1882953	BolC6t35294H	0	-	171	1021	1260	0.8103175
C6	1886102	1888296	BolC6t35295H	0	-	709	1920	2194	0.8751140
C6	1907137	1907656	BolC6t35296H	0	+	155	518	519	0.9980732
C6	1925309	1927015	BolC6t35297H	0	-	8	20	1706	0.0117233
C6	1952398	1952929	BolC6t35298H	0	-	148	531	531	1.0000000
C6	1954070	1972621	BolC6t35299H	0	+	6802	15726	18551	0.8477171
C6	1962003	1965476	BolC6t35300H	0	-	722	2790	3473	0.8033401
C6	1973026	1975123	BolC6t35301H	0	-	366	1604	2097	0.7649022
C6	1993035	1993638	BolC6t35302H	0	+	237	599	603	0.9933665
C6	1999576	2019364	BolC6t35303H	0	+	5534	16743	19788	0.8461189
C6	2006264	2006728	BolC6t35304H	0	-	34	381	464	0.8211207
C6	2019451	2019595	BolC6t35305H	0	+	214	144	144	1.0000000
C6	2022307	2024646	BolC6t35306H	0	-	1709	2321	2339	0.9923044
C6	2049790	2051188	BolC6t35307H	0	+	291	1378	1398	0.9856939
C6	2051195	2052776	BolC6t35308H	0	+	1471	1581	1581	1.0000000
C6	2053866	2055760	BolC6t35309H	0	-	383	1595	1894	0.8421330
C6	2065129	2068708	BolC6t35310H	0	+	1359	3403	3579	0.9508243
C6	2097240	2098508	BolC6t35311H	0	+	16	806	1268	0.6356467
C6	2106197	2108886	BolC6t35312H	0	+	1851	2675	2689	0.9947936
C6	2111935	2112586	BolC6t35313H	0	-	1	80	651	0.1228879
C6	2117788	2119034	BolC6t35314H	0	-	100	1066	1246	0.8555377
C6	2121210	2122557	BolC6t35315H	0	-	1097	1347	1347	1.0000000
C6	2131204	2133194	BolC6t35316H	0	-	1626	1990	1990	1.0000000
C6	2152001	2152160	BolC6t35317H	0	-	221	159	159	1.0000000
C6	2153496	2162788	BolC6t35318H	0	+	5134	6899	9292	0.7424666
C6	2179797	2185244	BolC6t35319H	0	+	2702	4027	5447	0.7393060
C6	2190416	2190524	BolC6t35320H	0	+	94	108	108	1.0000000
C6	2206210	2206836	BolC6t35321H	0	+	24	608	626	0.9712460
C6	2216426	2216534	BolC6t35322H	0	+	161	108	108	1.0000000
C6	2217312	2218126	BolC6t35323H	0	-	622	814	814	1.0000000
C6	2240352	2240829	BolC6t35324H	0	+	0	0	477	0.0000000
C6	2251501	2252285	BolC6t35325H	0	+	481	718	784	0.9158163
C6	2264262	2278173	BolC6t35326H	0	+	2247	7109	13911	0.5110344
C6	2309554	2311636	BolC6t35327H	0	-	188	1331	2082	0.6392891
C6	2358152	2358386	BolC6t35328H	0	+	353	234	234	1.0000000
C6	2379267	2385236	BolC6t35329H	0	+	2941	5102	5969	0.8547496
C6	2402242	2407667	BolC6t35330H	0	+	1750	4976	5425	0.9172350
C6	2428926	2430015	BolC6t35331H	0	+	203	704	1089	0.6464646
C6	2438923	2440235	BolC6t35332H	0	-	781	1312	1312	1.0000000
C6	2441637	2442309	BolC6t35333H	0	+	26	496	672	0.7380952
C6	2445480	2446395	BolC6t35334H	0	-	522	915	915	1.0000000
C6	2448465	2448669	BolC6t35335H	0	-	0	0	204	0.0000000
C6	2449635	2450082	BolC6t35336H	0	-	11	33	447	0.0738255
C6	2458637	2459436	BolC6t35337H	0	-	769	770	799	0.9637046
C6	2469948	2470145	BolC6t35338H	0	+	194	197	197	1.0000000
C6	2471174	2472765	BolC6t35339H	0	+	805	1591	1591	1.0000000
C6	2473991	2475644	BolC6t35340H	0	+	516	1379	1653	0.8342408
C6	2494453	2494666	BolC6t35341H	0	+	202	213	213	1.0000000
C6	2528267	2528414	BolC6t35342H	0	+	122	147	147	1.0000000
C6	2540362	2540908	BolC6t35343H	0	+	13	368	546	0.6739927
C6	2548553	2550272	BolC6t35344H	0	-	876	1719	1719	1.0000000
C6	2566526	2567262	BolC6t35345H	0	+	313	736	736	1.0000000
C6	2574044	2574320	BolC6t35346H	0	+	117	209	276	0.7572464
C6	2575220	2576139	BolC6t35347H	0	-	1002	919	919	1.0000000
C6	2576996	2577218	BolC6t35348H	0	+	416	222	222	1.0000000
C6	2594922	2597305	BolC6t35349H	0	-	952	2152	2383	0.9030634
C6	2614591	2621156	BolC6t35350H	0	-	1175	4607	6565	0.7017517
C6	2646335	2648996	BolC6t35351H	0	-	868	2537	2661	0.9534010
C6	2656650	2657771	BolC6t35352H	0	-	588	1101	1121	0.9821588
C6	2658909	2667650	BolC6t35353H	0	+	3232	5918	8741	0.6770393
C6	2677525	2678392	BolC6t35354H	0	+	0	0	867	0.0000000
C6	2691282	2691384	BolC6t35355H	0	-	189	102	102	1.0000000
C6	2707312	2708320	BolC6t35356H	0	-	1217	1008	1008	1.0000000
C6	2716460	2716839	BolC6t35357H	0	-	0	0	379	0.0000000
C6	2721982	2722719	BolC6t35358H	0	-	88	721	737	0.9782904
C6	2733112	2733775	BolC6t35359H	0	-	386	663	663	1.0000000
C6	2758525	2759561	BolC6t35360H	0	+	1021	920	1036	0.8880309
C6	2762537	2763277	BolC6t35361H	0	-	41	204	740	0.2756757
C6	2775693	2777163	BolC6t35362H	0	-	373	1298	1470	0.8829932
C6	2814025	2814187	BolC6t35363H	0	-	159	162	162	1.0000000
C6	2816608	2816812	BolC6t35364H	0	-	167	204	204	1.0000000
C6	2830468	2833708	BolC6t35365H	0	+	2185	3240	3240	1.0000000
C6	2838635	2838749	BolC6t35366H	0	+	190	114	114	1.0000000
C6	2841120	2841384	BolC6t35367H	0	+	44	264	264	1.0000000
C6	2859861	2861603	BolC6t35368H	0	+	440	1336	1742	0.7669346
C6	2879019	2881487	BolC6t35369H	0	+	748	2134	2468	0.8646678
C6	2894177	2894539	BolC6t35370H	0	+	218	362	362	1.0000000
C6	2895936	2898006	BolC6t35371H	0	-	626	1554	2070	0.7507246
C6	2898783	2900556	BolC6t35372H	0	-	1180	1773	1773	1.0000000
C6	2907048	2917144	BolC6t35373H	0	-	4357	9797	10096	0.9703843
C6	2927659	2951877	BolC6t35374H	0	-	4448	17309	24218	0.7147163
C6	2956509	2956794	BolC6t35375H	0	+	190	285	285	1.0000000
C6	2969035	2969994	BolC6t35376H	0	+	282	959	959	1.0000000
C6	2973392	2973674	BolC6t35377H	0	+	245	282	282	1.0000000
C6	2973677	2974471	BolC6t35378H	0	+	527	794	794	1.0000000
C6	3010734	3013564	BolC6t35379H	0	+	1315	2764	2830	0.9766784
C6	3014559	3016932	BolC6t35380H	0	-	2015	2373	2373	1.0000000
C6	3020957	3025984	BolC6t35381H	0	-	1873	4583	5027	0.9116769
C6	3028937	3032898	BolC6t35382H	0	+	2164	3806	3961	0.9608685
C6	3034834	3035270	BolC6t35383H	0	+	778	436	436	1.0000000
C6	3036074	3036686	BolC6t35384H	0	-	519	530	612	0.8660131
C6	3038585	3040282	BolC6t35385H	0	+	197	1420	1697	0.8367708
C6	3044347	3044971	BolC6t35386H	0	+	197	624	624	1.0000000
C6	3063750	3064261	BolC6t35387H	0	-	155	503	511	0.9843444
C6	3064535	3065648	BolC6t35388H	0	-	16	175	1113	0.1572327
C6	3089500	3090788	BolC6t35389H	0	+	287	1217	1288	0.9448758
C6	3091761	3092603	BolC6t35390H	0	-	8	121	842	0.1437055
C6	3095899	3096956	BolC6t35391H	0	-	102	1054	1057	0.9971618
C6	3101675	3110154	BolC6t35392H	0	-	297	3697	8479	0.4360184
C6	3131086	3131866	BolC6t35393H	0	+	752	780	780	1.0000000
C6	3141709	3142730	BolC6t35394H	0	+	900	1021	1021	1.0000000
C6	3143782	3144553	BolC6t35395H	0	-	769	771	771	1.0000000
C6	3153721	3155505	BolC6t35396H	0	+	1162	1784	1784	1.0000000
C6	3166636	3171600	BolC6t35397H	0	+	1349	4557	4964	0.9180097
C6	3173480	3176967	BolC6t35398H	0	-	691	3017	3487	0.8652136
C6	3203341	3207391	BolC6t35399H	0	-	2246	4050	4050	1.0000000
C6	3215332	3215638	BolC6t35400H	0	-	13	114	306	0.3725490
C6	3215795	3217822	BolC6t35401H	0	+	90	1079	2027	0.5323138
C6	3220230	3221050	BolC6t35402H	0	+	1	33	820	0.0402439
C6	3225240	3227590	BolC6t35403H	0	+	67	1336	2350	0.5685107
C6	3230297	3246038	BolC6t35404H	0	+	358	5078	15741	0.3225970
C6	3238476	3240812	BolC6t35405H	0	+	125	563	2336	0.2410103
C6	3268956	3270783	BolC6t35406H	0	-	1483	1795	1827	0.9824849
C6	3279073	3281421	BolC6t35407H	0	+	675	2258	2348	0.9616695
C6	3292351	3292798	BolC6t35408H	0	+	433	447	447	1.0000000
C6	3299020	3304164	BolC6t35409H	0	-	2099	4918	5144	0.9560653
C6	3322183	3324957	BolC6t35410H	0	-	2332	2559	2774	0.9224946
C6	3335646	3336639	BolC6t35411H	0	-	1389	993	993	1.0000000
C6	3339600	3339831	BolC6t35412H	0	+	62	132	231	0.5714286
C6	3371142	3426941	BolC6t35413H	0	+	2138	22055	55799	0.3952580
C6	3373409	3375360	BolC6t35414H	0	+	4	236	1951	0.1209636
C6	3390692	3391112	BolC6t35415H	0	-	18	268	420	0.6380953
C6	3415123	3415543	BolC6t35416H	0	-	0	0	420	0.0000000
C6	3428951	3429161	BolC6t35417H	0	-	0	0	210	0.0000000
C6	3429959	3431568	BolC6t35418H	0	+	340	1198	1609	0.7445619
C6	3449593	3452545	BolC6t35419H	0	+	1550	2952	2952	1.0000000
C6	3454104	3456032	BolC6t35420H	0	-	1572	1928	1928	1.0000000
C6	3467096	3467548	BolC6t35421H	0	+	24	399	452	0.8827434
C6	3470060	3470828	BolC6t35422H	0	+	438	768	768	1.0000000
C6	3481308	3504223	BolC6t35423H	0	-	10674	22317	22915	0.9739035
C6	3510316	3512604	BolC6t35424H	0	+	444	2128	2288	0.9300699
C6	3518623	3525519	BolC6t35425H	0	-	3538	6685	6896	0.9694026
C6	3534177	3539481	BolC6t35426H	0	+	1254	4364	5304	0.8227752
C6	3539838	3541676	BolC6t35427H	0	-	1171	1838	1838	1.0000000
C6	3542969	3543443	BolC6t35428H	0	-	275	474	474	1.0000000
C6	3545932	3546676	BolC6t35429H	0	-	432	744	744	1.0000000
C6	3562197	3565773	BolC6t35430H	0	+	2088	3475	3576	0.9717562
C6	3567451	3568126	BolC6t35431H	0	-	289	675	675	1.0000000
C6	3572583	3574185	BolC6t35432H	0	+	886	1574	1602	0.9825218
C6	3578245	3580353	BolC6t35433H	0	+	646	2051	2108	0.9729602
C6	3580695	3582845	BolC6t35434H	0	-	840	2150	2150	1.0000000
C6	3584144	3587112	BolC6t35435H	0	+	2666	2968	2968	1.0000000
C6	3587455	3589437	BolC6t35436H	0	-	1564	1982	1982	1.0000000
C6	3592466	3595444	BolC6t35437H	0	+	2328	2746	2978	0.9220954
C6	3596395	3596836	BolC6t35438H	0	-	1	114	441	0.2585034
C6	3598014	3599093	BolC6t35439H	0	-	11	48	1079	0.0444856
C6	3600469	3601109	BolC6t35440H	0	+	0	0	640	0.0000000
C6	3614360	3622196	BolC6t35441H	0	+	9971	7189	7836	0.9174324
C6	3620683	3621166	BolC6t35442H	0	-	387	483	483	1.0000000
C6	3623133	3623646	BolC6t35443H	0	+	128	513	513	1.0000000
C6	3623904	3624606	BolC6t35444H	0	-	238	702	702	1.0000000
C6	3625740	3628109	BolC6t35445H	0	+	429	1905	2369	0.8041368
C6	3631509	3633637	BolC6t35446H	0	+	1548	1389	2128	0.6527256
C6	3634011	3634299	BolC6t35447H	0	-	304	273	288	0.9479167
C6	3634586	3634844	BolC6t35448H	0	+	613	258	258	1.0000000
C6	3641194	3641586	BolC6t35449H	0	-	1	42	392	0.1071429
C6	3643967	3645262	BolC6t35450H	0	-	448	1256	1295	0.9698842
C6	3652526	3652700	BolC6t35451H	0	+	11	152	174	0.8735632
C6	3658268	3659707	BolC6t35452H	0	-	2	5	1439	0.0034746
C6	3664628	3665444	BolC6t35453H	0	-	113	581	816	0.7120098
C6	3666163	3668494	BolC6t35454H	0	-	488	2169	2331	0.9305019
C6	3670692	3671235	BolC6t35455H	0	-	404	543	543	1.0000000
C6	3673918	3674299	BolC6t35456H	0	+	381	381	381	1.0000000
C6	3677081	3678615	BolC6t35457H	0	-	1414	1534	1534	1.0000000
C6	3684805	3686856	BolC6t35458H	0	-	1767	2051	2051	1.0000000
C6	3702465	3702711	BolC6t35459H	0	+	11	180	246	0.7317073
C6	3718876	3720104	BolC6t35460H	0	-	611	1228	1228	1.0000000
C6	3723502	3725220	BolC6t35461H	0	+	834	1672	1718	0.9732247
C6	3737496	3737995	BolC6t35462H	0	+	240	499	499	1.0000000
C6	3741761	3742235	BolC6t35463H	0	+	3	103	474	0.2172996
C6	3743410	3744229	BolC6t35464H	0	+	0	0	819	0.0000000
C6	3749995	3777956	BolC6t35465H	0	+	10284	19726	27961	0.7054827
C6	3786119	3786425	BolC6t35466H	0	+	4	90	306	0.2941177
C6	3788596	3789140	BolC6t35467H	0	+	127	274	544	0.5036765
C6	3794806	3800252	BolC6t35468H	0	-	1779	4957	5446	0.9102094
C6	3804685	3806147	BolC6t35469H	0	-	458	1393	1462	0.9528044
C6	3807891	3808299	BolC6t35470H	0	+	0	0	408	0.0000000
C6	3809039	3811556	BolC6t35471H	0	+	4	219	2517	0.0870083
C6	3823149	3823468	BolC6t35472H	0	-	132	311	319	0.9749216
C6	3826943	3827820	BolC6t35473H	0	-	523	877	877	1.0000000
C6	3835182	3836001	BolC6t35474H	0	-	585	819	819	1.0000000
C6	3838145	3843314	BolC6t35475H	0	+	1377	3725	5169	0.7206423
C6	3845762	3845978	BolC6t35476H	0	-	419	216	216	1.0000000
C6	3855947	3867672	BolC6t35477H	0	+	3694	7691	11725	0.6559488
C6	3873993	3876566	BolC6t35478H	0	+	1399	2510	2573	0.9755149
C6	3877493	3880766	BolC6t35479H	0	-	1273	3178	3273	0.9709746
C6	3883248	3884416	BolC6t35480H	0	+	552	1168	1168	1.0000000
C6	3885496	3920279	BolC6t35481H	0	-	15678	29314	34783	0.8427680
C6	3923236	3925249	BolC6t35482H	0	-	668	1997	2013	0.9920517
C6	3949397	3951505	BolC6t35483H	0	+	1316	2059	2108	0.9767552
C6	3956305	3956563	BolC6t35484H	0	+	75	258	258	1.0000000
C6	3957822	3958194	BolC6t35485H	0	+	1	31	372	0.0833333
C6	3961925	3962944	BolC6t35486H	0	+	578	899	1019	0.8822375
C6	3963632	3966046	BolC6t35487H	0	-	643	2203	2414	0.9125932
C6	3968130	3970315	BolC6t35488H	0	+	622	2030	2185	0.9290618
C6	4000790	4002110	BolC6t35489H	0	-	758	1320	1320	1.0000000
C6	4006278	4038080	BolC6t35490H	0	+	105606	19687	31802	0.6190491
C6	4030492	4031026	BolC6t35491H	0	-	13	460	534	0.8614232
C6	4044512	4047315	BolC6t35492H	0	+	958	2803	2803	1.0000000
C6	4047595	4050281	BolC6t35493H	0	-	419	2568	2686	0.9560685
C6	4064948	4065381	BolC6t35494H	0	-	1	80	433	0.1847575
C6	4069515	4070166	BolC6t35495H	0	-	16	479	651	0.7357911
C6	4071954	4073017	BolC6t35496H	0	-	43	776	1063	0.7300094
C6	4074995	4075175	BolC6t35497H	0	+	13	178	180	0.9888889
C6	4088244	4088549	BolC6t35498H	0	+	0	0	305	0.0000000
C6	4100801	4132764	BolC6t35499H	0	-	5915	20660	31963	0.6463724
C6	4116585	4117652	BolC6t35500H	0	+	7	274	1067	0.2567948
C6	4151377	4152211	BolC6t35501H	0	-	0	0	834	0.0000000
C6	4152324	4152659	BolC6t35502H	0	-	0	0	335	0.0000000
C6	4156109	4156417	BolC6t35503H	0	+	18	263	308	0.8538961
C6	4157378	4157742	BolC6t35504H	0	-	42	353	364	0.9697802
C6	4158264	4160812	BolC6t35505H	0	-	158	2087	2548	0.8190738
C6	4160826	4161186	BolC6t35506H	0	-	1	35	360	0.0972222
C6	4162867	4166510	BolC6t35507H	0	+	2330	3446	3643	0.9459237
C6	4166545	4167637	BolC6t35508H	0	+	158	858	1092	0.7857143
C6	4177592	4183818	BolC6t35509H	0	-	2386	5484	6226	0.8808224
C6	4182210	4182471	BolC6t35510H	0	-	87	261	261	1.0000000
C6	4184865	4185453	BolC6t35511H	0	-	162	588	588	1.0000000
C6	4194053	4194534	BolC6t35512H	0	-	4	162	481	0.3367983
C6	4202847	4204307	BolC6t35513H	0	+	405	1445	1460	0.9897260
C6	4209011	4209284	BolC6t35514H	0	-	105	262	273	0.9597070
C6	4246931	4247351	BolC6t35515H	0	-	15	164	420	0.3904762
C6	4258718	4259579	BolC6t35516H	0	+	130	627	861	0.7282230
C6	4275484	4275775	BolC6t35517H	0	-	88	291	291	1.0000000
C6	4294509	4295496	BolC6t35518H	0	+	34	644	987	0.6524823
C6	4322167	4323238	BolC6t35519H	0	+	3	207	1071	0.1932773
C6	4323950	4333152	BolC6t35520H	0	-	653	3792	9202	0.4120843
C6	4335938	4336148	BolC6t35521H	0	-	6	129	210	0.6142857
C6	4341796	4343939	BolC6t35522H	0	-	95	1296	2143	0.6047597
C6	4356431	4357109	BolC6t35523H	0	+	22	373	678	0.5501475
C6	4391064	4394111	BolC6t35524H	0	+	230	2307	3047	0.7571382
C6	4404005	4420044	BolC6t35525H	0	+	3225	11510	16039	0.7176258
C6	4423696	4424341	BolC6t35526H	0	+	27	250	645	0.3875969
C6	4426121	4426705	BolC6t35527H	0	+	53	584	584	1.0000000
C6	4432837	4433040	BolC6t35528H	0	-	88	203	203	1.0000000
C6	4433148	4436518	BolC6t35529H	0	-	685	3087	3370	0.9160237
C6	4438449	4441645	BolC6t35530H	0	-	749	2231	3196	0.6980601
C6	4442669	4443905	BolC6t35531H	0	-	568	1204	1236	0.9741100
C6	4447542	4447818	BolC6t35532H	0	+	204	276	276	1.0000000
C6	4453482	4455792	BolC6t35533H	0	-	719	2178	2310	0.9428571
C6	4475063	4475399	BolC6t35534H	0	-	47	336	336	1.0000000
C6	4492694	4492811	BolC6t35535H	0	+	82	117	117	1.0000000
C6	4498151	4500394	BolC6t35536H	0	-	482	2095	2243	0.9340169
C6	4503399	4504618	BolC6t35537H	0	+	278	645	1219	0.5291222
C6	4509654	4509984	BolC6t35538H	0	+	302	330	330	1.0000000
C6	4515906	4518379	BolC6t35539H	0	+	181	1024	2473	0.4140720
C6	4549146	4560942	BolC6t35540H	0	+	3946	9886	11796	0.8380807
C6	4576006	4576408	BolC6t35541H	0	+	127	312	402	0.7761194
C6	4581563	4581782	BolC6t35542H	0	-	0	0	219	0.0000000
C6	4582308	4582564	BolC6t35543H	0	-	260	256	256	1.0000000
C6	4588218	4588997	BolC6t35544H	0	-	148	708	779	0.9088575
C6	4593419	4594908	BolC6t35545H	0	-	0	0	1489	0.0000000
C6	4596569	4598561	BolC6t35546H	0	-	834	1607	1992	0.8067269
C6	4600461	4600924	BolC6t35547H	0	-	81	436	463	0.9416847
C6	4621442	4622975	BolC6t35548H	0	+	1346	1533	1533	1.0000000
C6	4624650	4638726	BolC6t35549H	0	+	9303	13310	14076	0.9455811
C6	4639117	4642629	BolC6t35550H	0	-	1715	3512	3512	1.0000000
C6	4648438	4648813	BolC6t35551H	0	+	522	375	375	1.0000000
C6	4654631	4654964	BolC6t35552H	0	-	189	333	333	1.0000000
C6	4661994	4662327	BolC6t35553H	0	-	65	321	333	0.9639640
C6	4664277	4664610	BolC6t35554H	0	-	184	333	333	1.0000000
C6	4666562	4666895	BolC6t35555H	0	-	187	333	333	1.0000000
C6	4668845	4669178	BolC6t35556H	0	-	213	333	333	1.0000000
C6	4671130	4671463	BolC6t35557H	0	-	262	333	333	1.0000000
C6	4677993	4678326	BolC6t35558H	0	-	134	333	333	1.0000000
C6	4687007	4687340	BolC6t35559H	0	-	175	333	333	1.0000000
C6	4716768	4718113	BolC6t35560H	0	+	1225	1345	1345	1.0000000
C6	4725835	4727872	BolC6t35561H	0	-	986	2005	2037	0.9842906
C6	4734061	4734175	BolC6t35562H	0	-	7	114	114	1.0000000
C6	4742219	4745153	BolC6t35563H	0	-	750	2051	2934	0.6990457
C6	4762213	4765545	BolC6t35564H	0	-	604	2954	3332	0.8865546
C6	4767961	4770119	BolC6t35565H	0	-	455	1400	2158	0.6487488
C6	4787246	4787795	BolC6t35566H	0	+	271	549	549	1.0000000
C6	4788580	4793710	BolC6t35567H	0	+	3587	5130	5130	1.0000000
C6	4806070	4806271	BolC6t35568H	0	+	6	120	201	0.5970149
C6	4824483	4824735	BolC6t35569H	0	-	264	252	252	1.0000000
C6	4831655	4833022	BolC6t35570H	0	+	28	589	1367	0.4308705
C6	4843367	4846069	BolC6t35571H	0	-	965	2702	2702	1.0000000
C6	4848317	4851906	BolC6t35572H	0	+	1395	3339	3589	0.9303427
C6	4852169	4853558	BolC6t35573H	0	-	723	1256	1389	0.9042476
C6	4855180	4855912	BolC6t35574H	0	-	452	732	732	1.0000000
C6	4855927	4865452	BolC6t35575H	0	-	3176	9027	9525	0.9477165
C6	4870362	4871803	BolC6t35576H	0	+	0	0	1441	0.0000000
C6	4877346	4878126	BolC6t35577H	0	+	267	780	780	1.0000000
C6	4891045	4898084	BolC6t35578H	0	+	2880	6665	7039	0.9468675
C6	4907195	4911093	BolC6t35579H	0	+	1632	3592	3898	0.9214982
C6	4920676	4954377	BolC6t35580H	0	+	8145	18445	33701	0.5473132
C6	4929900	4932269	BolC6t35581H	0	-	323	1289	2369	0.5441114
C6	4958095	4959064	BolC6t35582H	0	+	660	969	969	1.0000000
C6	4965433	4966576	BolC6t35583H	0	+	241	1079	1143	0.9440070
C6	4970969	4972659	BolC6t35584H	0	+	204	1024	1690	0.6059172
C6	4975797	4975920	BolC6t35585H	0	+	66	123	123	1.0000000
C6	4978951	4984626	BolC6t35586H	0	+	2268	5339	5675	0.9407930
C6	4995428	4996333	BolC6t35587H	0	+	467	905	905	1.0000000
C6	5010147	5013189	BolC6t35588H	0	+	1231	2988	3042	0.9822485
C6	5015039	5015219	BolC6t35589H	0	-	23	155	180	0.8611111
C6	5022127	5022250	BolC6t35590H	0	+	60	123	123	1.0000000
C6	5023503	5024681	BolC6t35591H	0	-	547	1168	1178	0.9915110
C6	5025223	5025928	BolC6t35592H	0	+	375	705	705	1.0000000
C6	5028892	5029492	BolC6t35593H	0	-	1	33	600	0.0550000
C6	5031391	5035934	BolC6t35594H	0	+	414	2442	4543	0.5375302
C6	5039603	5042377	BolC6t35595H	0	+	524	1501	2774	0.5410959
C6	5047355	5050172	BolC6t35596H	0	+	678	2756	2817	0.9783458
C6	5051512	5053539	BolC6t35597H	0	-	769	1928	2027	0.9511594
C6	5055022	5057171	BolC6t35598H	0	-	770	1948	2149	0.9064682
C6	5082473	5124187	BolC6t35599H	0	+	14612	30119	41714	0.7220358
C6	5089027	5089653	BolC6t35600H	0	+	339	626	626	1.0000000
C6	5090156	5090726	BolC6t35601H	0	-	278	473	570	0.8298246
C6	5095317	5097528	BolC6t35602H	0	-	268	769	2211	0.3478064
C6	5101157	5102450	BolC6t35603H	0	-	54	374	1293	0.2892498
C6	5114655	5115328	BolC6t35604H	0	-	651	673	673	1.0000000
C6	5118183	5121850	BolC6t35605H	0	+	683	3210	3667	0.8753750
C6	5121924	5122526	BolC6t35606H	0	+	20	374	602	0.6212624
C6	5124460	5126143	BolC6t35607H	0	-	540	1268	1683	0.7534165
C6	5126563	5128585	BolC6t35608H	0	+	659	1976	2022	0.9772502
C6	5129186	5130315	BolC6t35609H	0	-	613	1129	1129	1.0000000
C6	5136163	5139018	BolC6t35610H	0	+	260	1769	2855	0.6196147
C6	5155135	5155831	BolC6t35611H	0	+	514	696	696	1.0000000
C6	5157620	5175052	BolC6t35612H	0	-	3340	13939	17432	0.7996214
C6	5185921	5191152	BolC6t35613H	0	+	1071	3637	5231	0.6952782
C6	5191439	5193448	BolC6t35614H	0	-	1188	1871	2009	0.9313091
C6	5208624	5211146	BolC6t35615H	0	+	181	1634	2522	0.6478985
C6	5230588	5230826	BolC6t35616H	0	+	4	43	238	0.1806723
C6	5239320	5241841	BolC6t35617H	0	+	1009	1899	2521	0.7532725
C6	5255983	5256430	BolC6t35618H	0	-	0	0	447	0.0000000
C6	5258025	5258360	BolC6t35619H	0	-	108	173	335	0.5164179
C6	5261023	5273436	BolC6t35620H	0	+	4018	9635	12413	0.7762024
C6	5277546	5277726	BolC6t35621H	0	+	17	180	180	1.0000000
C6	5288068	5304882	BolC6t35622H	0	-	3658	9612	16814	0.5716665
C6	5301102	5301720	BolC6t35623H	0	+	895	612	618	0.9902912
C6	5305038	5306677	BolC6t35624H	0	+	220	969	1639	0.5912142
C6	5307961	5309896	BolC6t35625H	0	-	292	1935	1935	1.0000000
C6	5310444	5311659	BolC6t35626H	0	-	60	539	1215	0.4436214
C6	5313949	5317582	BolC6t35627H	0	+	299	2247	3633	0.6184971
C6	5319530	5320672	BolC6t35628H	0	-	2297	1142	1142	1.0000000
C6	5320983	5321610	BolC6t35629H	0	-	463	627	627	1.0000000
C6	5324932	5327788	BolC6t35630H	0	-	134	2169	2856	0.7594538
C6	5371982	5378558	BolC6t35631H	0	-	612	4461	6576	0.6783759
C6	5397263	5397803	BolC6t35632H	0	-	20	224	540	0.4148148
C6	5401228	5401411	BolC6t35633H	0	+	0	0	183	0.0000000
C6	5413820	5416598	BolC6t35634H	0	-	295	2171	2778	0.7814975
C6	5426853	5427247	BolC6t35635H	0	+	39	176	394	0.4467005
C6	5454887	5461397	BolC6t35636H	0	-	562	3780	6510	0.5806451
C6	5473525	5496925	BolC6t35637H	0	+	11440	21341	23400	0.9120085
C6	5476169	5476427	BolC6t35638H	0	+	232	258	258	1.0000000
C6	5477921	5478951	BolC6t35639H	0	-	693	1030	1030	1.0000000
C6	5487237	5487784	BolC6t35640H	0	+	421	547	547	1.0000000
C6	5497201	5499553	BolC6t35641H	0	-	767	2336	2352	0.9931973
C6	5501820	5502315	BolC6t35642H	0	+	295	495	495	1.0000000
C6	5503869	5506896	BolC6t35643H	0	-	1858	2953	3027	0.9755533
C6	5512944	5514844	BolC6t35644H	0	+	367	1688	1900	0.8884211
C6	5518994	5521278	BolC6t35645H	0	+	465	1609	2284	0.7044659
C6	5522678	5523340	BolC6t35646H	0	-	314	662	662	1.0000000
C6	5531324	5531876	BolC6t35647H	0	+	822	552	552	1.0000000
C6	5535022	5541340	BolC6t35648H	0	+	2070	4893	6318	0.7744539
C6	5543956	5598198	BolC6t35649H	0	+	26401	44381	54242	0.8182036
C6	5544474	5544850	BolC6t35650H	0	+	186	291	376	0.7739362
C6	5550950	5556602	BolC6t35651H	0	+	861	4665	5652	0.8253716
C6	5565353	5565750	BolC6t35652H	0	+	69	325	397	0.8186398
C6	5579368	5579671	BolC6t35653H	0	-	494	303	303	1.0000000
C6	5604214	5604655	BolC6t35654H	0	+	0	0	441	0.0000000
C6	5621448	5621910	BolC6t35655H	0	+	8	281	462	0.6082251
C6	5622096	5622331	BolC6t35656H	0	+	0	0	235	0.0000000
C6	5625873	5626338	BolC6t35657H	0	+	20	239	465	0.5139785
C6	5656724	5657228	BolC6t35658H	0	-	0	0	504	0.0000000
C6	5657708	5658186	BolC6t35659H	0	-	0	0	478	0.0000000
C6	5658154	5658885	BolC6t35660H	0	-	0	0	731	0.0000000
C6	5661408	5662414	BolC6t35661H	0	-	2	20	1006	0.0198807
C6	5707907	5708434	BolC6t35662H	0	-	80	519	527	0.9848197
C6	5728664	5732571	BolC6t35663H	0	+	1198	3609	3907	0.9237266
C6	5738739	5739297	BolC6t35664H	0	-	38	249	558	0.4462366
C6	5743051	5744434	BolC6t35665H	0	-	24	302	1383	0.2183659
C6	5745769	5747933	BolC6t35666H	0	+	1134	2149	2164	0.9930684
C6	5765817	5765982	BolC6t35667H	0	-	278	165	165	1.0000000
C6	5767699	5767885	BolC6t35668H	0	-	199	186	186	1.0000000
C6	5784949	5788999	BolC6t35669H	0	+	1238	3685	4050	0.9098765
C6	5789680	5791322	BolC6t35670H	0	-	483	1491	1642	0.9080390
C6	5796571	5799219	BolC6t35671H	0	-	1292	2648	2648	1.0000000
C6	5804733	5805877	BolC6t35672H	0	+	84	706	1144	0.6171328
C6	5806382	5807039	BolC6t35673H	0	+	17	563	657	0.8569254
C6	5807841	5808426	BolC6t35674H	0	+	283	525	585	0.8974359
C6	5809840	5812878	BolC6t35675H	0	+	2380	3038	3038	1.0000000
C6	5815636	5815846	BolC6t35676H	0	-	474	210	210	1.0000000
C6	5834537	5837429	BolC6t35677H	0	+	1346	2669	2892	0.9228907
C6	5838124	5839343	BolC6t35678H	0	-	820	1219	1219	1.0000000
C6	5840373	5842483	BolC6t35679H	0	-	695	2082	2110	0.9867299
C6	5843604	5844651	BolC6t35680H	0	+	412	1047	1047	1.0000000
C6	5866110	5868046	BolC6t35681H	0	+	277	1753	1936	0.9054752
C6	5868409	5869945	BolC6t35682H	0	-	639	1376	1536	0.8958333
C6	5875919	5877453	BolC6t35683H	0	-	519	1486	1534	0.9687092
C6	5880672	5881957	BolC6t35684H	0	-	499	1273	1285	0.9906615
C6	5886889	5888463	BolC6t35685H	0	-	319	1161	1574	0.7376112
C6	5895731	5897306	BolC6t35686H	0	-	160	903	1575	0.5733333
C6	5919351	5922241	BolC6t35687H	0	-	1000	2621	2890	0.9069204
C6	5934450	5934678	BolC6t35688H	0	+	233	228	228	1.0000000
C6	5938504	5940093	BolC6t35689H	0	-	634	1589	1589	1.0000000
C6	5943302	5944225	BolC6t35690H	0	-	1079	923	923	1.0000000
C6	5944381	5944709	BolC6t35691H	0	-	256	328	328	1.0000000
C6	5952872	5953697	BolC6t35692H	0	+	307	825	825	1.0000000
C6	5965383	5965537	BolC6t35693H	0	-	167	154	154	1.0000000
C6	5965755	5966242	BolC6t35694H	0	-	446	487	487	1.0000000
C6	5972775	5973272	BolC6t35695H	0	-	371	497	497	1.0000000
C6	5978664	5978877	BolC6t35696H	0	+	192	213	213	1.0000000
C6	6004415	6006050	BolC6t35697H	0	-	565	1589	1635	0.9718654
C6	6011390	6012033	BolC6t35698H	0	+	576	643	643	1.0000000
C6	6014513	6015030	BolC6t35699H	0	+	218	517	517	1.0000000
C6	6016262	6017432	BolC6t35700H	0	+	693	1170	1170	1.0000000
C6	6041766	6072099	BolC6t35701H	0	+	12044	29747	30333	0.9806811
C6	6081044	6081671	BolC6t35702H	0	-	226	627	627	1.0000000
C6	6093264	6094094	BolC6t35703H	0	+	12	27	830	0.0325301
C6	6095729	6096251	BolC6t35704H	0	-	0	0	522	0.0000000
C6	6116178	6118935	BolC6t35705H	0	+	1315	2757	2757	1.0000000
C6	6120452	6121579	BolC6t35706H	0	-	424	1098	1127	0.9742680
C6	6123262	6124264	BolC6t35707H	0	-	401	1002	1002	1.0000000
C6	6126598	6127630	BolC6t35708H	0	-	595	998	1032	0.9670542
C6	6128182	6131327	BolC6t35709H	0	-	2890	3123	3145	0.9930048
C6	6139507	6139966	BolC6t35710H	0	-	164	403	459	0.8779957
C6	6149204	6150620	BolC6t35711H	0	+	345	1416	1416	1.0000000
C6	6155979	6162482	BolC6t35712H	0	+	2544	5649	6503	0.8686760
C6	6164178	6164617	BolC6t35713H	0	+	172	393	439	0.8952164
C6	6165381	6165957	BolC6t35714H	0	+	93	492	576	0.8541667
C6	6170502	6172608	BolC6t35715H	0	-	1396	2106	2106	1.0000000
C6	6183584	6183821	BolC6t35716H	0	-	236	237	237	1.0000000
C6	6204506	6210823	BolC6t35717H	0	-	912	5260	6317	0.8326737
C6	6214471	6214846	BolC6t35718H	0	-	293	375	375	1.0000000
C6	6237507	6247009	BolC6t35719H	0	+	4368	9075	9502	0.9550621
C6	6269570	6270204	BolC6t35720H	0	+	786	634	634	1.0000000
C6	6270235	6273097	BolC6t35721H	0	-	1878	2862	2862	1.0000000
C6	6286356	6287097	BolC6t35722H	0	+	28	434	741	0.5856950
C6	6306071	6307868	BolC6t35723H	0	+	1171	1797	1797	1.0000000
C6	6315388	6315545	BolC6t35724H	0	+	155	157	157	1.0000000
C6	6315610	6347956	BolC6t35725H	0	+	14211	30546	32346	0.9443517
C6	6350094	6350513	BolC6t35726H	0	-	271	419	419	1.0000000
C6	6350862	6354774	BolC6t35727H	0	+	1424	3857	3912	0.9859407
C6	6355059	6355718	BolC6t35728H	0	-	73	588	659	0.8922610
C6	6363856	6364276	BolC6t35729H	0	+	289	420	420	1.0000000
C6	6440561	6441395	BolC6t35730H	0	-	30	237	834	0.2841727
C6	6446475	6447651	BolC6t35731H	0	-	69	679	1176	0.5773810
C6	6449475	6450452	BolC6t35732H	0	-	12	408	977	0.4176049
C6	6457920	6467425	BolC6t35733H	0	+	2385	7505	9505	0.7895845
C6	6471999	6513609	BolC6t35734H	0	+	18776	36334	41610	0.8732036
C6	6524109	6569511	BolC6t35735H	0	+	15882	40423	45402	0.8903352
C6	6553681	6554635	BolC6t35736H	0	+	607	954	954	1.0000000
C6	6576803	6578272	BolC6t35737H	0	+	1543	1469	1469	1.0000000
C6	6579384	6580233	BolC6t35738H	0	-	392	849	849	1.0000000
C6	6581774	6582413	BolC6t35739H	0	+	194	575	639	0.8998435
C6	6582950	6585033	BolC6t35740H	0	+	876	2083	2083	1.0000000
C6	6586098	6586554	BolC6t35741H	0	-	290	456	456	1.0000000
C6	6586884	6587658	BolC6t35742H	0	+	468	774	774	1.0000000
C6	6589111	6590128	BolC6t35743H	0	+	133	869	1017	0.8544739
C6	6590429	6592407	BolC6t35744H	0	-	630	1867	1978	0.9438827
C6	6594960	6595687	BolC6t35745H	0	+	999	727	727	1.0000000
C6	6600380	6600617	BolC6t35746H	0	-	15	220	237	0.9282700
C6	6607138	6608707	BolC6t35747H	0	-	295	1532	1569	0.9764181
C6	6613216	6613498	BolC6t35748H	0	+	262	282	282	1.0000000
C6	6619752	6621374	BolC6t35749H	0	+	976	1622	1622	1.0000000
C6	6623863	6625006	BolC6t35750H	0	-	103	798	1143	0.6981627
C6	6662490	6665180	BolC6t35751H	0	+	3309	2539	2690	0.9438662
C6	6671609	6677948	BolC6t35752H	0	-	3341	5438	6339	0.8578640
C6	6699056	6699242	BolC6t35753H	0	-	0	0	186	0.0000000
C6	6708741	6709248	BolC6t35754H	0	+	79	490	507	0.9664694
C6	6718468	6719458	BolC6t35755H	0	+	0	0	990	0.0000000
C6	6722054	6723440	BolC6t35756H	0	+	47	761	1386	0.5490621
C6	6732767	6734156	BolC6t35757H	0	+	1727	1389	1389	1.0000000
C6	6734683	6736792	BolC6t35758H	0	-	70	855	2109	0.4054054
C6	6737601	6738375	BolC6t35759H	0	-	128	774	774	1.0000000
C6	6740424	6742388	BolC6t35760H	0	-	32	262	1964	0.1334012
C6	6742679	6743252	BolC6t35761H	0	-	9	119	573	0.2076789
C6	6766511	6769702	BolC6t35762H	0	+	1870	2903	3191	0.9097462
C6	6773600	6774913	BolC6t35763H	0	+	997	1313	1313	1.0000000
C6	6779821	6780172	BolC6t35764H	0	+	34	351	351	1.0000000
C6	6793479	6794434	BolC6t35765H	0	+	1116	955	955	1.0000000
C6	6798322	6798894	BolC6t35766H	0	-	143	372	572	0.6503497
C6	6800212	6801592	BolC6t35767H	0	+	835	1380	1380	1.0000000
C6	6801959	6802268	BolC6t35768H	0	-	109	309	309	1.0000000
C6	6804498	6804980	BolC6t35769H	0	-	299	482	482	1.0000000
C6	6807664	6809805	BolC6t35770H	0	+	1322	2044	2141	0.9546941
C6	6823837	6824964	BolC6t35771H	0	+	1331	1127	1127	1.0000000
C6	6828842	6830396	BolC6t35772H	0	+	522	1399	1554	0.9002574
C6	6839445	6840242	BolC6t35773H	0	-	344	797	797	1.0000000
C6	6841146	6843211	BolC6t35774H	0	+	1082	2061	2065	0.9980630
C6	6843983	6849522	BolC6t35775H	0	-	3620	5482	5539	0.9897093
C6	6863404	6864985	BolC6t35776H	0	-	405	1543	1581	0.9759646
C6	6873419	6873770	BolC6t35777H	0	-	470	351	351	1.0000000
C6	6875590	6880445	BolC6t35778H	0	+	3796	4855	4855	1.0000000
C6	6887215	6892382	BolC6t35779H	0	+	2629	4005	5167	0.7751113
C6	6894020	6896915	BolC6t35780H	0	+	1961	2895	2895	1.0000000
C6	6897444	6901373	BolC6t35781H	0	-	2188	3905	3929	0.9938916
C6	6911295	6914079	BolC6t35782H	0	+	1299	2623	2784	0.9421695
C6	6914915	6916371	BolC6t35783H	0	+	79	495	1456	0.3399725
C6	6916950	6918648	BolC6t35784H	0	-	695	1628	1698	0.9587750
C6	6926023	6927880	BolC6t35785H	0	-	990	1840	1857	0.9908454
C6	6931060	6931854	BolC6t35786H	0	+	547	765	794	0.9634761
C6	6947446	6948119	BolC6t35787H	0	+	748	673	673	1.0000000
C6	6965920	6967002	BolC6t35788H	0	+	4	341	1082	0.3151571
C6	6972820	6973267	BolC6t35789H	0	-	0	0	447	0.0000000
C6	6986596	6991520	BolC6t35790H	0	+	63	1191	4924	0.2418765
C6	6998309	7001380	BolC6t35791H	0	+	1456	2893	3071	0.9420384
C6	7005619	7016222	BolC6t35792H	0	-	2743	8504	10603	0.8020372
C6	7016502	7020146	BolC6t35793H	0	-	939	3297	3644	0.9047750
C6	7028186	7031744	BolC6t35794H	0	+	850	3060	3558	0.8600338
C6	7033673	7034919	BolC6t35795H	0	-	1608	1169	1246	0.9382023
C6	7042492	7045030	BolC6t35796H	0	-	359	2149	2538	0.8467297
C6	7048781	7053842	BolC6t35797H	0	+	1208	4683	5061	0.9253112
C6	7067079	7069308	BolC6t35798H	0	+	353	2127	2229	0.9542395
C6	7069775	7070400	BolC6t35799H	0	+	104	617	625	0.9872000
C6	7071248	7071827	BolC6t35800H	0	+	33	564	579	0.9740933
C6	7072553	7076984	BolC6t35801H	0	-	618	2958	4431	0.6675694
C6	7077852	7078171	BolC6t35802H	0	-	0	0	319	0.0000000
C6	7079613	7080733	BolC6t35803H	0	+	28	493	1120	0.4401786
C6	7081959	7158509	BolC6t35804H	0	-	27537	64281	76550	0.8397257
C6	7099017	7100409	BolC6t35805H	0	+	229	1228	1392	0.8821839
C6	7118611	7121003	BolC6t35806H	0	-	2845	2392	2392	1.0000000
C6	7121472	7122954	BolC6t35807H	0	-	89	802	1482	0.5411606
C6	7124761	7125774	BolC6t35808H	0	-	312	1013	1013	1.0000000
C6	7141408	7142728	BolC6t35809H	0	-	268	1046	1320	0.7924243
C6	7161197	7163829	BolC6t35810H	0	-	1292	2630	2632	0.9992401
C6	7168181	7168817	BolC6t35811H	0	+	867	636	636	1.0000000
C6	7175987	7177337	BolC6t35812H	0	+	799	1350	1350	1.0000000
C6	7178995	7182573	BolC6t35813H	0	-	1039	3147	3578	0.8795416
C6	7186554	7190065	BolC6t35814H	0	-	677	3178	3511	0.9051552
C6	7196762	7197579	BolC6t35815H	0	-	654	817	817	1.0000000
C6	7214173	7215133	BolC6t35816H	0	+	269	754	960	0.7854167
C6	7220578	7221533	BolC6t35817H	0	-	1026	955	955	1.0000000
C6	7255504	7257636	BolC6t35818H	0	+	740	2132	2132	1.0000000
C6	7266532	7268389	BolC6t35819H	0	+	964	1826	1857	0.9833064
C6	7269075	7278284	BolC6t35820H	0	+	1297	8778	9209	0.9531980
C6	7282205	7283555	BolC6t35821H	0	+	341	1278	1350	0.9466667
C6	7284015	7286373	BolC6t35822H	0	+	852	2358	2358	1.0000000
C6	7293209	7295406	BolC6t35823H	0	-	1330	2197	2197	1.0000000
C6	7303616	7307387	BolC6t35824H	0	+	2816	3771	3771	1.0000000
C6	7313911	7320962	BolC6t35825H	0	-	4570	6586	7051	0.9340519
C6	7346537	7353862	BolC6t35826H	0	-	1423	5780	7325	0.7890785
C6	7364061	7364622	BolC6t35827H	0	-	525	561	561	1.0000000
C6	7365751	7369824	BolC6t35828H	0	-	1971	4004	4073	0.9830592
C6	7374221	7375755	BolC6t35829H	0	+	752	1531	1534	0.9980443
C6	7376632	7380885	BolC6t35830H	0	-	1903	3966	4253	0.9325182
C6	7383442	7384579	BolC6t35831H	0	-	874	1137	1137	1.0000000
C6	7418471	7422614	BolC6t35832H	0	+	826	2830	4143	0.6830799
C6	7424049	7425071	BolC6t35833H	0	-	89	947	1022	0.9266145
C6	7425873	7426839	BolC6t35834H	0	-	200	830	966	0.8592132
C6	7427112	7427701	BolC6t35835H	0	+	112	548	589	0.9303905
C6	7427928	7432600	BolC6t35836H	0	-	1122	3743	4672	0.8011558
C6	7434511	7437093	BolC6t35837H	0	+	2136	2582	2582	1.0000000
C6	7437297	7438607	BolC6t35838H	0	-	830	1310	1310	1.0000000
C6	7441376	7442394	BolC6t35839H	0	-	511	1018	1018	1.0000000
C6	7444727	7445170	BolC6t35840H	0	-	41	311	443	0.7020316
C6	7446456	7448485	BolC6t35841H	0	+	927	2029	2029	1.0000000
C6	7449032	7449427	BolC6t35842H	0	+	118	395	395	1.0000000
C6	7449607	7450794	BolC6t35843H	0	+	325	1039	1187	0.8753159
C6	7453439	7453574	BolC6t35844H	0	-	112	135	135	1.0000000
C6	7472348	7473269	BolC6t35845H	0	-	639	921	921	1.0000000
C6	7475423	7476612	BolC6t35846H	0	+	851	1189	1189	1.0000000
C6	7478754	7479165	BolC6t35847H	0	-	290	411	411	1.0000000
C6	7479672	7480119	BolC6t35848H	0	+	343	447	447	1.0000000
C6	7489888	7490436	BolC6t35849H	0	+	406	548	548	1.0000000
C6	7490936	7492760	BolC6t35850H	0	-	1247	1824	1824	1.0000000
C6	7516372	7518968	BolC6t35851H	0	+	1104	1673	2596	0.6444530
C6	7524266	7524512	BolC6t35852H	0	+	140	246	246	1.0000000
C6	7524627	7525971	BolC6t35853H	0	+	780	1273	1344	0.9471726
C6	7526404	7526734	BolC6t35854H	0	+	985	330	330	1.0000000
C6	7527596	7528701	BolC6t35855H	0	+	749	883	1105	0.7990950
C6	7531317	7531569	BolC6t35856H	0	+	159	252	252	1.0000000
C6	7534364	7534550	BolC6t35857H	0	+	199	186	186	1.0000000
C6	7534894	7537108	BolC6t35858H	0	+	2488	2214	2214	1.0000000
C6	7567465	7572339	BolC6t35859H	0	-	2911	4874	4874	1.0000000
C6	7586435	7588277	BolC6t35860H	0	+	212	1699	1842	0.9223670
C6	7589669	7590889	BolC6t35861H	0	+	412	1050	1220	0.8606557
C6	7592166	7595262	BolC6t35862H	0	+	1583	3096	3096	1.0000000
C6	7596456	7597718	BolC6t35863H	0	-	767	1262	1262	1.0000000
C6	7615972	7616500	BolC6t35864H	0	-	12	159	528	0.3011364
C6	7627400	7627986	BolC6t35865H	0	-	31	413	586	0.7047781
C6	7637481	7638917	BolC6t35866H	0	-	117	1032	1436	0.7186630
C6	7651169	7652939	BolC6t35867H	0	-	759	1565	1770	0.8841808
C6	7655036	7660560	BolC6t35868H	0	+	3427	5524	5524	1.0000000
C6	7668711	7670453	BolC6t35869H	0	+	1425	1742	1742	1.0000000
C6	7673661	7701722	BolC6t35870H	0	-	4422	20452	28061	0.7288408
C6	7734627	7735167	BolC6t35871H	0	+	566	540	540	1.0000000
C6	7747758	7748914	BolC6t35872H	0	+	1384	1156	1156	1.0000000
C6	7763650	7764417	BolC6t35873H	0	-	48	743	767	0.9687092
C6	7768251	7771704	BolC6t35874H	0	+	545	2713	3453	0.7856936
C6	7774881	7775133	BolC6t35875H	0	-	221	252	252	1.0000000
C6	7794326	7798539	BolC6t35876H	0	+	1355	3894	4213	0.9242820
C6	7799656	7801057	BolC6t35877H	0	-	389	1284	1401	0.9164882
C6	7814475	7815907	BolC6t35878H	0	-	2273	1432	1432	1.0000000
C6	7820196	7820743	BolC6t35879H	0	+	445	547	547	1.0000000
C6	7822696	7823074	BolC6t35880H	0	+	152	378	378	1.0000000
C6	7831035	7832404	BolC6t35881H	0	-	219	1015	1369	0.7414171
C6	7843149	7843626	BolC6t35882H	0	-	206	455	477	0.9538784
C6	7851289	7852788	BolC6t35883H	0	+	181	1053	1499	0.7024683
C6	7865488	7866550	BolC6t35884H	0	+	1113	1062	1062	1.0000000
C6	7871098	7871392	BolC6t35885H	0	+	191	294	294	1.0000000
C6	7881883	7883100	BolC6t35886H	0	+	943	1217	1217	1.0000000
C6	7889525	7889871	BolC6t35887H	0	-	523	346	346	1.0000000
C6	7892957	7895372	BolC6t35888H	0	+	1208	2187	2415	0.9055901
C6	7896589	7898515	BolC6t35889H	0	-	968	1926	1926	1.0000000
C6	7904248	7905841	BolC6t35890H	0	-	1439	1593	1593	1.0000000
C6	7906171	7906399	BolC6t35891H	0	+	224	228	228	1.0000000
C6	7908909	7909573	BolC6t35892H	0	-	793	664	664	1.0000000
C6	7911078	7912383	BolC6t35893H	0	+	386	1170	1305	0.8965517
C6	7913157	7913861	BolC6t35894H	0	-	94	340	704	0.4829545
C6	7917935	7921017	BolC6t35895H	0	-	1777	3082	3082	1.0000000
C6	7921299	7921716	BolC6t35896H	0	+	55	417	417	1.0000000
C6	7921765	7922118	BolC6t35897H	0	+	7	102	353	0.2889518
C6	7926515	7929377	BolC6t35898H	0	+	2153	2862	2862	1.0000000
C6	7930577	7932263	BolC6t35899H	0	+	1429	1686	1686	1.0000000
C6	7932700	7933930	BolC6t35900H	0	+	1412	1230	1230	1.0000000
C6	7934356	7936835	BolC6t35901H	0	-	1385	2479	2479	1.0000000
C6	7945747	7947588	BolC6t35902H	0	+	44	578	1841	0.3139598
C6	7951279	7951554	BolC6t35903H	0	+	0	0	275	0.0000000
C6	7953203	7953422	BolC6t35904H	0	-	109	206	219	0.9406393
C6	7956649	7957445	BolC6t35905H	0	+	382	796	796	1.0000000
C6	7982057	7983839	BolC6t35906H	0	+	26	603	1782	0.3383838
C6	7987923	7988355	BolC6t35907H	0	+	0	0	432	0.0000000
C6	7989462	7989681	BolC6t35908H	0	-	23	203	219	0.9269406
C6	8034998	8036095	BolC6t35909H	0	-	692	1097	1097	1.0000000
C6	8037400	8037634	BolC6t35910H	0	+	321	234	234	1.0000000
C6	8039318	8039582	BolC6t35911H	0	+	60	264	264	1.0000000
C6	8045333	8047258	BolC6t35912H	0	+	429	1563	1925	0.8119481
C6	8052488	8052830	BolC6t35913H	0	+	481	342	342	1.0000000
C6	8058255	8063134	BolC6t35914H	0	+	458	3593	4879	0.7364214
C6	8085787	8086287	BolC6t35915H	0	-	6	277	500	0.5540000
C6	8096686	8096890	BolC6t35916H	0	+	152	204	204	1.0000000
C6	8100283	8101381	BolC6t35917H	0	-	124	953	1098	0.8679417
C6	8102269	8105261	BolC6t35918H	0	+	1147	2635	2992	0.8806818
C6	8107581	8114362	BolC6t35919H	0	+	1188	4996	6781	0.7367645
C6	8116106	8118807	BolC6t35920H	0	+	263	1003	2701	0.3713439
C6	8119605	8127732	BolC6t35921H	0	+	100	2206	8127	0.2714409
C6	8131829	8136269	BolC6t35922H	0	-	1706	4373	4440	0.9849099
C6	8136543	8136996	BolC6t35923H	0	+	325	453	453	1.0000000
C6	8137082	8137903	BolC6t35924H	0	-	529	821	821	1.0000000
C6	8139906	8141169	BolC6t35925H	0	+	137	1045	1263	0.8273951
C6	8142903	8161930	BolC6t35926H	0	+	2108	7347	19027	0.3861355
C6	8163468	8169761	BolC6t35927H	0	+	219	935	6293	0.1485778
C6	8170319	8170577	BolC6t35928H	0	-	133	258	258	1.0000000
C6	8171150	8172195	BolC6t35929H	0	-	272	853	1045	0.8162680
C6	8183527	8183819	BolC6t35930H	0	-	109	292	292	1.0000000
C6	8184519	8185104	BolC6t35931H	0	+	86	225	585	0.3846154
C6	8191941	8192148	BolC6t35932H	0	-	15	110	207	0.5314010
C6	8196986	8198537	BolC6t35933H	0	+	820	1431	1551	0.9226305
C6	8199137	8199455	BolC6t35934H	0	-	404	318	318	1.0000000
C6	8203604	8204826	BolC6t35935H	0	-	126	961	1222	0.7864157
C6	8207449	8208181	BolC6t35936H	0	+	116	706	732	0.9644809
C6	8232810	8233965	BolC6t35937H	0	-	92	784	1155	0.6787879
C6	8235970	8237086	BolC6t35938H	0	-	0	0	1116	0.0000000
C6	8252133	8252856	BolC6t35939H	0	-	58	575	723	0.7952974
C6	8260831	8261827	BolC6t35940H	0	+	737	996	996	1.0000000
C6	8261997	8264631	BolC6t35941H	0	-	1326	2340	2634	0.8883827
C6	8265503	8266650	BolC6t35942H	0	-	120	992	1147	0.8648649
C6	8276744	8277776	BolC6t35943H	0	-	4	92	1032	0.0891473
C6	8294083	8294209	BolC6t35944H	0	+	104	121	126	0.9603174
C6	8310176	8312368	BolC6t35945H	0	+	1395	2179	2192	0.9940693
C6	8313077	8313428	BolC6t35946H	0	-	236	351	351	1.0000000
C6	8356751	8357282	BolC6t35947H	0	+	34	139	531	0.2617702
C6	8357987	8360241	BolC6t35948H	0	-	1046	2254	2254	1.0000000
C6	8360936	8361155	BolC6t35949H	0	-	403	219	219	1.0000000
C6	8364089	8364542	BolC6t35950H	0	-	40	405	453	0.8940398
C6	8366854	8369641	BolC6t35951H	0	-	641	2753	2787	0.9878005
C6	8371804	8372242	BolC6t35952H	0	-	64	231	438	0.5273973
C6	8381214	8382042	BolC6t35953H	0	+	275	828	828	1.0000000
C6	8383106	8383426	BolC6t35954H	0	-	112	273	320	0.8531250
C6	8384143	8384611	BolC6t35955H	0	-	440	468	468	1.0000000
C6	8393161	8393986	BolC6t35956H	0	+	208	562	825	0.6812121
C6	8397662	8397848	BolC6t35957H	0	+	217	186	186	1.0000000
C6	8402779	8404368	BolC6t35958H	0	-	232	1388	1589	0.8735054
C6	8408147	8409786	BolC6t35959H	0	+	449	1558	1639	0.9505796
C6	8411044	8411296	BolC6t35960H	0	-	65	252	252	1.0000000
C6	8411789	8413959	BolC6t35961H	0	-	999	1604	2170	0.7391705
C6	8419358	8431491	BolC6t35962H	0	+	2036	9345	12133	0.7702135
C6	8434805	8436466	BolC6t35963H	0	-	153	1347	1661	0.8109573
C6	8438514	8438697	BolC6t35964H	0	-	110	115	183	0.6284153
C6	8442190	8442579	BolC6t35965H	0	-	245	389	389	1.0000000
C6	8455581	8455743	BolC6t35966H	0	-	70	162	162	1.0000000
C6	8478147	8478849	BolC6t35967H	0	-	403	702	702	1.0000000
C6	8482588	8483029	BolC6t35968H	0	-	331	441	441	1.0000000
C6	8485148	8487908	BolC6t35969H	0	-	2381	2760	2760	1.0000000
C6	8489821	8490370	BolC6t35970H	0	+	135	358	549	0.6520947
C6	8510204	8511163	BolC6t35971H	0	+	114	663	959	0.6913452
C6	8518403	8519222	BolC6t35972H	0	+	353	819	819	1.0000000
C6	8533663	8534200	BolC6t35973H	0	-	51	537	537	1.0000000
C6	8536700	8536958	BolC6t35974H	0	+	255	258	258	1.0000000
C6	8546585	8548579	BolC6t35975H	0	+	937	1994	1994	1.0000000
C6	8563058	8565779	BolC6t35976H	0	-	2458	2721	2721	1.0000000
C6	8571043	8571205	BolC6t35977H	0	-	1	62	162	0.3827161
C6	8572558	8575329	BolC6t35978H	0	+	1099	2681	2771	0.9675208
C6	8577297	8578915	BolC6t35979H	0	-	1003	1618	1618	1.0000000
C6	8580847	8582056	BolC6t35980H	0	-	591	1209	1209	1.0000000
C6	8582432	8583748	BolC6t35981H	0	+	1095	1286	1316	0.9772037
C6	8584083	8586436	BolC6t35982H	0	-	1180	2339	2353	0.9940501
C6	8603113	8604846	BolC6t35983H	0	-	106	1162	1733	0.6705136
C6	8605912	8606708	BolC6t35984H	0	+	344	737	796	0.9258794
C6	8612381	8645609	BolC6t35985H	0	-	20874	14745	33228	0.4437523
C6	8618274	8619079	BolC6t35986H	0	-	52	289	805	0.3590062
C6	8619513	8625310	BolC6t35987H	0	+	183	553	5797	0.0953942
C6	8647620	8648955	BolC6t35988H	0	-	231	1159	1335	0.8681648
C6	8655022	8655130	BolC6t35989H	0	-	0	0	108	0.0000000
C6	8659142	8664209	BolC6t35990H	0	+	2278	4754	5067	0.9382278
C6	8665865	8667919	BolC6t35991H	0	+	322	745	2054	0.3627069
C6	8667441	8667758	BolC6t35992H	0	+	62	276	317	0.8706625
C6	8670237	8670516	BolC6t35993H	0	-	133	227	279	0.8136201
C6	8671190	8674726	BolC6t35994H	0	-	64	154	3536	0.0435520
C6	8675424	8676994	BolC6t35995H	0	+	1118	1570	1570	1.0000000
C6	8677455	8682076	BolC6t35996H	0	+	181	2139	4621	0.4628868
C6	8683896	8685949	BolC6t35997H	0	+	1452	2053	2053	1.0000000
C6	8686173	8687672	BolC6t35998H	0	-	156	1272	1499	0.8485657
C6	8689218	8691378	BolC6t35999H	0	-	622	2067	2160	0.9569445
C6	8722942	8723170	BolC6t36000H	0	+	76	225	228	0.9868421
C6	8726735	8730372	BolC6t36001H	0	+	1410	3376	3637	0.9282376
C6	8731753	8733371	BolC6t36002H	0	+	744	1011	1618	0.6248455
C6	8733787	8735872	BolC6t36003H	0	-	142	1138	2085	0.5458034
C6	8737622	8740419	BolC6t36004H	0	-	2480	2797	2797	1.0000000
C6	8742555	8744161	BolC6t36005H	0	-	1054	1383	1606	0.8611457
C6	8745024	8748604	BolC6t36006H	0	-	865	2846	3580	0.7949721
C6	8752240	8755030	BolC6t36007H	0	-	1322	2703	2790	0.9688172
C6	8758915	8759158	BolC6t36008H	0	+	128	210	243	0.8641976
C6	8769588	8772375	BolC6t36009H	0	+	962	2539	2787	0.9110155
C6	8780618	8781468	BolC6t36010H	0	-	213	636	850	0.7482353
C6	8782789	8783052	BolC6t36011H	0	-	0	0	263	0.0000000
C6	8798800	8799091	BolC6t36012H	0	-	7	193	291	0.6632302
C6	8805165	8809440	BolC6t36013H	0	-	2463	4266	4275	0.9978948
C6	8810890	8811085	BolC6t36014H	0	-	28	60	195	0.3076923
C6	8812375	8813017	BolC6t36015H	0	+	32	156	642	0.2429907
C6	8813873	8815284	BolC6t36016H	0	-	487	1359	1411	0.9631467
C6	8842633	8842822	BolC6t36017H	0	+	174	189	189	1.0000000
C6	8850242	8853192	BolC6t36018H	0	+	426	2292	2950	0.7769492
C6	8856078	8856667	BolC6t36019H	0	+	478	589	589	1.0000000
C6	8889072	8889452	BolC6t36020H	0	-	394	380	380	1.0000000
C6	8894754	8896068	BolC6t36021H	0	+	134	765	1314	0.5821918
C6	8897212	8897623	BolC6t36022H	0	+	577	411	411	1.0000000
C6	8897557	8898542	BolC6t36023H	0	-	523	985	985	1.0000000
C6	8905963	8906389	BolC6t36024H	0	-	0	0	426	0.0000000
C6	8914825	8914972	BolC6t36025H	0	+	197	147	147	1.0000000
C6	8919796	8923544	BolC6t36026H	0	+	1714	3560	3748	0.9498399
C6	8923804	8926396	BolC6t36027H	0	-	1537	2470	2592	0.9529321
C6	8934298	8935840	BolC6t36028H	0	-	1282	1542	1542	1.0000000
C6	8938923	8940748	BolC6t36029H	0	-	778	1825	1825	1.0000000
C6	8941801	8944709	BolC6t36030H	0	+	2050	2908	2908	1.0000000
C6	8946201	8947858	BolC6t36031H	0	+	681	1621	1657	0.9782740
C6	8955795	8965170	BolC6t36032H	0	+	2776	8843	9375	0.9432533
C6	8966690	8969143	BolC6t36033H	0	+	669	2287	2453	0.9323277
C6	8971475	8976729	BolC6t36034H	0	-	2521	5199	5254	0.9895318
C6	8978037	8978643	BolC6t36035H	0	+	139	606	606	1.0000000
C6	8981753	8997564	BolC6t36036H	0	+	10514	15410	15811	0.9746379
C6	8988051	8988462	BolC6t36037H	0	+	231	411	411	1.0000000
C6	9008980	9009453	BolC6t36038H	0	+	737	473	473	1.0000000
C6	9026723	9027209	BolC6t36039H	0	-	167	399	486	0.8209876
C6	9030259	9030757	BolC6t36040H	0	-	384	498	498	1.0000000
C6	9033220	9046183	BolC6t36041H	0	-	4168	10058	12963	0.7759007
C6	9055651	9064202	BolC6t36042H	0	+	4964	8445	8551	0.9876038
C6	9058794	9059349	BolC6t36043H	0	-	341	555	555	1.0000000
C6	9076779	9077309	BolC6t36044H	0	+	235	530	530	1.0000000
C6	9138622	9138838	BolC6t36045H	0	+	2	140	216	0.6481481
C6	9143518	9143941	BolC6t36046H	0	+	28	423	423	1.0000000
C6	9144798	9147243	BolC6t36047H	0	-	1014	2384	2445	0.9750511
C6	9162653	9164345	BolC6t36048H	0	+	1098	1692	1692	1.0000000
C6	9164441	9165005	BolC6t36049H	0	+	101	473	564	0.8386525
C6	9171700	9172158	BolC6t36050H	0	+	30	458	458	1.0000000
C6	9195552	9196594	BolC6t36051H	0	-	612	1042	1042	1.0000000
C6	9210451	9212275	BolC6t36052H	0	-	888	1741	1824	0.9544956
C6	9224235	9224882	BolC6t36053H	0	+	284	647	647	1.0000000
C6	9259778	9260613	BolC6t36054H	0	-	724	835	835	1.0000000
C6	9274550	9275442	BolC6t36055H	0	-	620	892	892	1.0000000
C6	9280759	9281269	BolC6t36056H	0	-	714	510	510	1.0000000
C6	9287045	9290120	BolC6t36057H	0	+	1965	3075	3075	1.0000000
C6	9290730	9293169	BolC6t36058H	0	-	1995	2439	2439	1.0000000
C6	9297946	9298387	BolC6t36059H	0	+	60	441	441	1.0000000
C6	9300836	9302170	BolC6t36060H	0	-	1504	1334	1334	1.0000000
C6	9302383	9302830	BolC6t36061H	0	+	710	447	447	1.0000000
C6	9333094	9333469	BolC6t36062H	0	+	187	375	375	1.0000000
C6	9352772	9356275	BolC6t36063H	0	+	3202	3503	3503	1.0000000
C6	9356566	9357070	BolC6t36064H	0	-	612	504	504	1.0000000
C6	9357843	9358071	BolC6t36065H	0	+	424	228	228	1.0000000
C6	9360945	9362971	BolC6t36066H	0	+	945	2026	2026	1.0000000
C6	9363206	9364323	BolC6t36067H	0	-	532	1024	1117	0.9167413
C6	9368643	9370355	BolC6t36068H	0	-	296	1285	1712	0.7505841
C6	9374263	9376366	BolC6t36069H	0	+	1071	2103	2103	1.0000000
C6	9404017	9405040	BolC6t36070H	0	+	670	1023	1023	1.0000000
C6	9413277	9414022	BolC6t36071H	0	+	756	745	745	1.0000000
C6	9416520	9417070	BolC6t36072H	0	-	551	550	550	1.0000000
C6	9420116	9420557	BolC6t36073H	0	+	613	441	441	1.0000000
C6	9422857	9426535	BolC6t36074H	0	-	2566	3461	3678	0.9410005
C6	9430990	9432400	BolC6t36075H	0	+	403	1410	1410	1.0000000
C6	9437212	9438894	BolC6t36076H	0	+	307	1103	1682	0.6557670
C6	9439408	9439847	BolC6t36077H	0	-	221	439	439	1.0000000
C6	9448512	9448812	BolC6t36078H	0	+	236	300	300	1.0000000
C6	9468205	9468391	BolC6t36079H	0	-	356	186	186	1.0000000
C6	9470942	9474532	BolC6t36080H	0	+	1034	3070	3590	0.8551532
C6	9476383	9476892	BolC6t36081H	0	-	150	509	509	1.0000000
C6	9479136	9479598	BolC6t36082H	0	-	5	179	462	0.3874459
C6	9481417	9482046	BolC6t36083H	0	+	55	546	629	0.8680445
C6	9489177	9489532	BolC6t36084H	0	+	37	355	355	1.0000000
C6	9491542	9491901	BolC6t36085H	0	-	1	138	359	0.3844011
C6	9514052	9516500	BolC6t36086H	0	+	279	1747	2448	0.7136438
C6	9517474	9518078	BolC6t36087H	0	+	382	604	604	1.0000000
C6	9522449	9524913	BolC6t36088H	0	-	1500	2464	2464	1.0000000
C6	9529454	9534747	BolC6t36089H	0	+	1622	4204	5293	0.7942566
C6	9541145	9541715	BolC6t36090H	0	-	210	570	570	1.0000000
C6	9555385	9555952	BolC6t36091H	0	-	307	567	567	1.0000000
C6	9572770	9574333	BolC6t36092H	0	-	912	1552	1563	0.9929622
C6	9577895	9586829	BolC6t36093H	0	-	984	3321	8934	0.3717260
C6	9601241	9603216	BolC6t36094H	0	+	858	1934	1975	0.9792405
C6	9626623	9626992	BolC6t36095H	0	+	802	369	369	1.0000000
C6	9634849	9636154	BolC6t36096H	0	+	551	1244	1305	0.9532567
C6	9664136	9665598	BolC6t36097H	0	-	878	1462	1462	1.0000000
C6	9669682	9671048	BolC6t36098H	0	-	744	1330	1366	0.9736457
C6	9673007	9676572	BolC6t36099H	0	+	375	2235	3565	0.6269284
C6	9674739	9675161	BolC6t36100H	0	+	8	302	422	0.7156398
C6	9681208	9683054	BolC6t36101H	0	+	1274	1846	1846	1.0000000
C6	9684556	9704136	BolC6t36102H	0	+	7235	18248	19580	0.9319714
C6	9688738	9691179	BolC6t36103H	0	-	485	2256	2441	0.9242114
C6	9705260	9705440	BolC6t36104H	0	-	101	180	180	1.0000000
C6	9710018	9710665	BolC6t36105H	0	+	145	636	647	0.9829984
C6	9718013	9719611	BolC6t36106H	0	-	14	243	1598	0.1520651
C6	9733309	9733471	BolC6t36107H	0	-	0	0	162	0.0000000
C6	9734654	9735402	BolC6t36108H	0	+	555	748	748	1.0000000
C6	9744850	9754272	BolC6t36109H	0	-	2281	8654	9422	0.9184886
C6	9768714	9769104	BolC6t36110H	0	-	342	390	390	1.0000000
C6	9769842	9771067	BolC6t36111H	0	+	667	1225	1225	1.0000000
C6	9774259	9774769	BolC6t36112H	0	+	552	510	510	1.0000000
C6	9780930	9781461	BolC6t36113H	0	-	193	521	531	0.9811676
C6	9784457	9784979	BolC6t36114H	0	+	398	522	522	1.0000000
C6	9785979	9787059	BolC6t36115H	0	-	2	134	1080	0.1240741
C6	9804854	9805230	BolC6t36116H	0	+	205	376	376	1.0000000
C6	9812441	9812981	BolC6t36117H	0	-	380	540	540	1.0000000
C6	9814510	9815184	BolC6t36118H	0	+	523	674	674	1.0000000
C6	9815998	9824625	BolC6t36119H	0	-	3029	7430	8627	0.8612496
C6	9836909	9837161	BolC6t36120H	0	+	331	252	252	1.0000000
C6	9842260	9843688	BolC6t36121H	0	-	1099	1428	1428	1.0000000
C6	9847884	9848321	BolC6t36122H	0	+	140	437	437	1.0000000
C6	9850489	9850915	BolC6t36123H	0	-	245	426	426	1.0000000
C6	9853335	9854742	BolC6t36124H	0	-	1081	1407	1407	1.0000000
C6	9857717	9858313	BolC6t36125H	0	-	398	596	596	1.0000000
C6	9860654	9872965	BolC6t36126H	0	-	5530	11124	12311	0.9035822
C6	9878059	9878914	BolC6t36127H	0	-	654	855	855	1.0000000
C6	9881070	9882171	BolC6t36128H	0	+	101	809	1101	0.7347866
C6	9886829	9887714	BolC6t36129H	0	-	1160	885	885	1.0000000
C6	9906794	9910262	BolC6t36130H	0	+	985	3294	3468	0.9498270
C6	9911283	9913508	BolC6t36131H	0	+	657	1743	2225	0.7833708
C6	9920914	9922237	BolC6t36132H	0	+	46	399	1323	0.3015873
C6	9936031	9938122	BolC6t36133H	0	-	356	1092	2091	0.5222381
C6	9939644	9942304	BolC6t36134H	0	-	979	2273	2660	0.8545113
C6	9947358	9947562	BolC6t36135H	0	+	0	0	204	0.0000000
C6	9948061	9949145	BolC6t36136H	0	+	6	20	1084	0.0184502
C6	9950848	9951451	BolC6t36137H	0	+	0	0	603	0.0000000
C6	9952329	9955654	BolC6t36138H	0	-	22	493	3325	0.1482707
C6	9981298	9984917	BolC6t36139H	0	-	1117	3254	3619	0.8991434
C6	9985438	9986848	BolC6t36140H	0	-	221	1100	1410	0.7801418
C6	10001391	10001949	BolC6t36141H	0	+	64	292	558	0.5232975
C6	10007296	10008759	BolC6t36142H	0	+	323	1380	1463	0.9432673
C6	10011901	10012387	BolC6t36143H	0	-	164	470	486	0.9670782
C6	10013450	10015145	BolC6t36144H	0	-	932	1695	1695	1.0000000
C6	10015996	10016568	BolC6t36145H	0	+	699	572	572	1.0000000
C6	10018033	10020004	BolC6t36146H	0	-	1527	1971	1971	1.0000000
C6	10021184	10021424	BolC6t36147H	0	-	223	240	240	1.0000000
C6	10028359	10029017	BolC6t36148H	0	-	253	498	658	0.7568389
C6	10040760	10041939	BolC6t36149H	0	-	21	230	1179	0.1950806
C6	10042905	10047856	BolC6t36150H	0	-	603	3107	4951	0.6275500
C6	10051526	10055449	BolC6t36151H	0	+	185	2789	3923	0.7109355
C6	10061940	10062102	BolC6t36152H	0	-	0	0	162	0.0000000
C6	10064766	10064937	BolC6t36153H	0	-	0	0	171	0.0000000
C6	10067589	10067760	BolC6t36154H	0	-	0	0	171	0.0000000
C6	10070448	10070613	BolC6t36155H	0	-	0	0	165	0.0000000
C6	10073228	10073399	BolC6t36156H	0	-	0	0	171	0.0000000
C6	10083064	10088003	BolC6t36157H	0	-	573	2765	4939	0.5598300
C6	10098034	10101551	BolC6t36158H	0	+	1892	3313	3517	0.9419960
C6	10101665	10103685	BolC6t36159H	0	-	2196	2020	2020	1.0000000
C6	10108977	10111072	BolC6t36160H	0	+	1063	2004	2095	0.9565632
C6	10111842	10120765	BolC6t36161H	0	+	1144	3625	8923	0.4062535
C6	10121355	10122188	BolC6t36162H	0	-	891	833	833	1.0000000
C6	10123795	10126364	BolC6t36163H	0	+	1355	2257	2569	0.8785520
C6	10126970	10128779	BolC6t36164H	0	-	592	1719	1809	0.9502488
C6	10149888	10150387	BolC6t36165H	0	-	8	255	499	0.5110220
C6	10152352	10152820	BolC6t36166H	0	+	0	0	468	0.0000000
C6	10157536	10158490	BolC6t36167H	0	+	305	954	954	1.0000000
C6	10159259	10161102	BolC6t36168H	0	-	915	1843	1843	1.0000000
C6	10167943	10169550	BolC6t36169H	0	+	827	1607	1607	1.0000000
C6	10172600	10172916	BolC6t36170H	0	+	329	316	316	1.0000000
C6	10172974	10176084	BolC6t36171H	0	+	2224	3052	3110	0.9813505
C6	10177739	10179317	BolC6t36172H	0	-	709	1578	1578	1.0000000
C6	10188432	10189386	BolC6t36173H	0	+	575	954	954	1.0000000
C6	10207283	10207723	BolC6t36174H	0	-	118	430	440	0.9772727
C6	10208787	10211083	BolC6t36175H	0	-	1311	2296	2296	1.0000000
C6	10212641	10214268	BolC6t36176H	0	-	448	1561	1627	0.9594346
C6	10217872	10219125	BolC6t36177H	0	-	677	1253	1253	1.0000000
C6	10220006	10228288	BolC6t36178H	0	-	645	5009	8282	0.6048056
C6	10250115	10250815	BolC6t36179H	0	-	474	700	700	1.0000000
C6	10253745	10255952	BolC6t36180H	0	-	22	548	2207	0.2483009
C6	10263290	10263560	BolC6t36181H	0	-	150	270	270	1.0000000
C6	10266190	10271360	BolC6t36182H	0	-	813	4028	5170	0.7791103
C6	10273608	10273971	BolC6t36183H	0	+	2724	363	363	1.0000000
C6	10297495	10298038	BolC6t36184H	0	+	281	543	543	1.0000000
C6	10298357	10300262	BolC6t36185H	0	-	136	506	1905	0.2656168
C6	10304690	10305382	BolC6t36186H	0	+	8	456	692	0.6589595
C6	10305773	10306445	BolC6t36187H	0	+	81	662	672	0.9851190
C6	10309818	10316688	BolC6t36188H	0	+	4004	4930	6870	0.7176128
C6	10322911	10324164	BolC6t36189H	0	-	155	928	1253	0.7406225
C6	10348686	10349091	BolC6t36190H	0	-	300	405	405	1.0000000
C6	10350309	10351437	BolC6t36191H	0	+	803	1128	1128	1.0000000
C6	10351826	10352190	BolC6t36192H	0	+	133	364	364	1.0000000
C6	10549109	10549403	BolC6t36193H	0	-	20	69	294	0.2346939
C6	10550251	10550504	BolC6t36194H	0	+	170	253	253	1.0000000
C6	10558222	10558690	BolC6t36195H	0	+	82	109	468	0.2329060
C6	10559104	10559516	BolC6t36196H	0	-	96	268	412	0.6504855
C6	10564118	10564319	BolC6t36197H	0	+	16	98	201	0.4875622
C6	10564530	10564836	BolC6t36198H	0	+	0	0	306	0.0000000
C6	10565118	10565472	BolC6t36199H	0	-	44	153	354	0.4322034
C6	10566531	10566639	BolC6t36200H	0	-	1	24	108	0.2222222
C6	10567820	10568599	BolC6t36201H	0	-	96	493	779	0.6328626
C6	10569103	10569754	BolC6t36202H	0	+	52	339	651	0.5207373
C6	10571081	10571387	BolC6t36203H	0	+	5	212	306	0.6928105
C6	10577323	10577995	BolC6t36204H	0	+	1211	623	672	0.9270833
C6	10582256	10582742	BolC6t36205H	0	-	9	334	486	0.6872428
C6	10582747	10603891	BolC6t36206H	0	-	9891	8450	21144	0.3996406
C6	10585066	10585369	BolC6t36207H	0	+	29	162	303	0.5346535
C6	10587339	10587708	BolC6t36208H	0	-	546	314	369	0.8509485
C6	10588561	10589671	BolC6t36209H	0	-	778	997	1110	0.8981982
C6	10591083	10592010	BolC6t36210H	0	+	1315	927	927	1.0000000
C6	10607475	10608120	BolC6t36211H	0	-	377	615	645	0.9534883
C6	10608716	10609376	BolC6t36212H	0	-	63	81	660	0.1227273
C6	10613573	10614199	BolC6t36213H	0	-	0	0	626	0.0000000
C6	10622449	10622830	BolC6t36214H	0	-	0	0	381	0.0000000
C6	10626130	10626328	BolC6t36215H	0	-	0	0	198	0.0000000
C6	10631693	10632537	BolC6t36216H	0	+	50	67	844	0.0793839
C6	10632656	10632797	BolC6t36217H	0	+	51	17	141	0.1205674
C6	10634388	10635030	BolC6t36218H	0	+	64	102	642	0.1588785
C6	10635052	10636855	BolC6t36219H	0	-	99	188	1803	0.1042707
C6	10637553	10638692	BolC6t36220H	0	+	13	109	1139	0.0956980
C6	10854086	10856681	BolC6t36221H	0	-	1329	2482	2595	0.9564547
C6	10887375	10889251	BolC6t36222H	0	-	1558	1873	1876	0.9984009
C6	10971993	10972610	BolC6t36223H	0	+	313	617	617	1.0000000
C6	10978478	10978754	BolC6t36224H	0	+	152	276	276	1.0000000
C6	11001507	11002939	BolC6t36225H	0	+	57	925	1432	0.6459497
C6	11004165	11004669	BolC6t36226H	0	+	376	504	504	1.0000000
C6	11004833	11005268	BolC6t36227H	0	+	246	435	435	1.0000000
C6	11067605	11067899	BolC6t36228H	0	+	86	294	294	1.0000000
C6	11071277	11071724	BolC6t36229H	0	-	243	447	447	1.0000000
C6	11073594	11075731	BolC6t36230H	0	-	1062	2112	2137	0.9883013
C6	11121577	11122639	BolC6t36231H	0	-	39	595	1062	0.5602636
C6	11137728	11137923	BolC6t36232H	0	-	163	195	195	1.0000000
C6	11146677	11150147	BolC6t36233H	0	+	323	2256	3470	0.6501441
C6	11150210	11150923	BolC6t36234H	0	+	3	184	713	0.2580645
C6	11151092	11151215	BolC6t36235H	0	+	1	11	123	0.0894309
C6	11155945	11157072	BolC6t36236H	0	+	109	589	1127	0.5226265
C6	11163807	11164194	BolC6t36237H	0	+	15	304	387	0.7855297
C6	11165106	11165587	BolC6t36238H	0	+	13	309	481	0.6424116
C6	11167736	11168171	BolC6t36239H	0	+	23	363	435	0.8344827
C6	11171480	11171996	BolC6t36240H	0	-	48	456	516	0.8837209
C6	11172491	11173697	BolC6t36241H	0	-	1482	764	1206	0.6334991
C6	11175369	11175927	BolC6t36242H	0	-	46	511	558	0.9157706
C6	11176063	11176617	BolC6t36243H	0	-	94	521	554	0.9404332
C6	11178335	11178548	BolC6t36244H	0	-	21	180	213	0.8450704
C6	11183073	11183512	BolC6t36245H	0	+	0	0	439	0.0000000
C6	11184331	11184496	BolC6t36246H	0	+	0	0	165	0.0000000
C6	11189884	11196671	BolC6t36247H	0	-	6759	635	6787	0.0935612
C6	11197997	11198483	BolC6t36248H	0	-	90	228	486	0.4691358
C6	11206544	11207945	BolC6t36249H	0	-	314	1137	1401	0.8115632
C6	11292038	11293923	BolC6t36250H	0	-	151	1505	1885	0.7984085
C6	11294258	11295181	BolC6t36251H	0	-	371	826	923	0.8949079
C6	11296671	11299736	BolC6t36252H	0	+	275	1904	3065	0.6212072
C6	11389069	11391578	BolC6t36253H	0	-	554	2253	2509	0.8979673
C6	11401312	11401484	BolC6t36254H	0	-	3	121	172	0.7034883
C6	11401700	11401916	BolC6t36255H	0	-	74	216	216	1.0000000
C6	11404445	11407391	BolC6t36256H	0	+	133	1573	2946	0.5339443
C6	11409951	11411815	BolC6t36257H	0	-	153	1007	1864	0.5402361
C6	11495913	11496306	BolC6t36258H	0	-	290	393	393	1.0000000
C6	11503055	11508934	BolC6t36259H	0	-	2159	5879	5879	1.0000000
C6	11508961	11509288	BolC6t36260H	0	-	112	327	327	1.0000000
C6	11509741	11510104	BolC6t36261H	0	-	218	363	363	1.0000000
C6	11517739	11519506	BolC6t36262H	0	+	220	1621	1767	0.9173741
C6	11552071	11552891	BolC6t36263H	0	+	604	820	820	1.0000000
C6	11554542	11555099	BolC6t36264H	0	-	231	557	557	1.0000000
C6	11652505	11653846	BolC6t36265H	0	-	178	947	1341	0.7061894
C6	11654055	11661947	BolC6t36266H	0	-	5115	7892	7892	1.0000000
C6	11667132	11667668	BolC6t36267H	0	+	698	536	536	1.0000000
C6	11684913	11685948	BolC6t36268H	0	+	647	1035	1035	1.0000000
C6	11750151	11750694	BolC6t36269H	0	+	173	543	543	1.0000000
C6	11761116	11761795	BolC6t36270H	0	-	161	653	679	0.9617084
C6	11768660	11768915	BolC6t36271H	0	+	159	255	255	1.0000000
C6	11789264	11791000	BolC6t36272H	0	-	274	1279	1736	0.7367511
C6	11795134	11795875	BolC6t36273H	0	-	15085	741	741	1.0000000
C6	11811702	11812283	BolC6t36274H	0	+	370	581	581	1.0000000
C6	11845331	11845953	BolC6t36275H	0	+	568	622	622	1.0000000
C6	11846939	11848020	BolC6t36276H	0	-	32	880	1081	0.8140610
C6	11848965	11851638	BolC6t36277H	0	+	1213	2639	2673	0.9872802
C6	11868279	11868502	BolC6t36278H	0	-	230	223	223	1.0000000
C6	11883153	11885000	BolC6t36279H	0	-	346	887	1847	0.4802382
C6	11885440	11885626	BolC6t36280H	0	-	25	186	186	1.0000000
C6	11910280	11912576	BolC6t36281H	0	-	369	1593	2296	0.6938154
C6	11955199	11973611	BolC6t36282H	0	+	4766	12839	18412	0.6973169
C6	11998690	12000638	BolC6t36283H	0	+	587	1896	1948	0.9733059
C6	12001091	12001600	BolC6t36284H	0	-	188	509	509	1.0000000
C6	12002397	12002754	BolC6t36285H	0	-	224	357	357	1.0000000
C6	12003645	12003887	BolC6t36286H	0	-	229	242	242	1.0000000
C6	12005696	12007161	BolC6t36287H	0	+	263	1273	1465	0.8689420
C6	12007619	12009020	BolC6t36288H	0	-	614	1330	1401	0.9493219
C6	12036301	12038652	BolC6t36289H	0	-	1639	2351	2351	1.0000000
C6	12041786	12042395	BolC6t36290H	0	+	343	609	609	1.0000000
C6	12043782	12044775	BolC6t36291H	0	-	120	781	993	0.7865055
C6	12045141	12045316	BolC6t36292H	0	-	16	175	175	1.0000000
C6	12047004	12050220	BolC6t36293H	0	+	1001	1223	3216	0.3802861
C6	12056396	12060795	BolC6t36294H	0	-	1791	3821	4399	0.8686065
C6	12062991	12064572	BolC6t36295H	0	-	717	1539	1581	0.9734345
C6	12089702	12092713	BolC6t36296H	0	-	1074	2859	3011	0.9495184
C6	12093493	12096615	BolC6t36297H	0	-	589	2424	3122	0.7764254
C6	12107094	12109626	BolC6t36298H	0	-	104	1382	2532	0.5458136
C6	12110905	12111262	BolC6t36299H	0	-	161	357	357	1.0000000
C6	12121876	12123064	BolC6t36300H	0	-	14	561	1188	0.4722222
C6	12155248	12156868	BolC6t36301H	0	+	582	1446	1620	0.8925926
C6	12157468	12163280	BolC6t36302H	0	-	682	3894	5812	0.6699931
C6	12184479	12185721	BolC6t36303H	0	+	80	903	1242	0.7270532
C6	12192201	12193321	BolC6t36304H	0	-	166	909	1120	0.8116071
C6	12194742	12195849	BolC6t36305H	0	+	433	1107	1107	1.0000000
C6	12219058	12221182	BolC6t36306H	0	-	2311	2124	2124	1.0000000
C6	12223410	12224501	BolC6t36307H	0	-	193	415	1091	0.3803850
C6	12231781	12231910	BolC6t36308H	0	-	174	129	129	1.0000000
C6	12267362	12267548	BolC6t36309H	0	-	72	186	186	1.0000000
C6	12277171	12279255	BolC6t36310H	0	+	998	1848	2084	0.8867562
C6	12280441	12282792	BolC6t36311H	0	-	445	1929	2351	0.8205019
C6	12293128	12294780	BolC6t36312H	0	-	459	1502	1652	0.9092010
C6	12315630	12316602	BolC6t36313H	0	+	167	949	972	0.9763374
C6	12322792	12323609	BolC6t36314H	0	+	86	522	817	0.6389229
C6	12325976	12328171	BolC6t36315H	0	-	607	1642	2195	0.7480638
C6	12331883	12339067	BolC6t36316H	0	+	2896	3319	7184	0.4619989
C6	12339558	12340102	BolC6t36317H	0	+	1710	544	544	1.0000000
C6	12351140	12352215	BolC6t36318H	0	-	705	1071	1075	0.9962791
C6	12384541	12406599	BolC6t36319H	0	+	5230	16262	22058	0.7372382
C6	12413247	12415913	BolC6t36320H	0	+	451	2525	2666	0.9471118
C6	12462721	12467950	BolC6t36321H	0	-	2088	4168	5229	0.7970932
C6	12470778	12470946	BolC6t36322H	0	+	5	55	168	0.3273810
C6	12474592	12475789	BolC6t36323H	0	+	249	982	1197	0.8203843
C6	12482088	12482247	BolC6t36324H	0	-	145	159	159	1.0000000
C6	12516941	12517440	BolC6t36325H	0	-	35	491	499	0.9839680
C6	12517479	12517746	BolC6t36326H	0	-	122	265	267	0.9925094
C6	12517888	12518080	BolC6t36327H	0	-	210	192	192	1.0000000
C6	12538393	12539428	BolC6t36328H	0	+	713	1035	1035	1.0000000
C6	12576962	12578727	BolC6t36329H	0	+	998	1628	1765	0.9223796
C6	12579850	12582972	BolC6t36330H	0	-	1720	2896	3122	0.9276105
C6	12625108	12626942	BolC6t36331H	0	-	259	1369	1834	0.7464558
C6	12637256	12639638	BolC6t36332H	0	+	1561	2382	2382	1.0000000
C6	12648754	12649486	BolC6t36333H	0	+	504	732	732	1.0000000
C6	12649534	12655572	BolC6t36334H	0	+	1169	4715	6038	0.7808877
C6	12672810	12673020	BolC6t36335H	0	+	323	210	210	1.0000000
C6	12676344	12677577	BolC6t36336H	0	+	61	366	1233	0.2968370
C6	12682496	12684282	BolC6t36337H	0	+	167	1349	1786	0.7553192
C6	12721362	12721649	BolC6t36338H	0	-	248	287	287	1.0000000
C6	12721671	12721895	BolC6t36339H	0	-	184	224	224	1.0000000
C6	12759123	12759650	BolC6t36340H	0	+	73	375	527	0.7115750
C6	12788532	12789566	BolC6t36341H	0	+	183	854	1034	0.8259187
C6	12791313	12794450	BolC6t36342H	0	+	684	2958	3137	0.9429391
C6	12794914	12796535	BolC6t36343H	0	-	587	1478	1621	0.9117829
C6	12803062	12803317	BolC6t36344H	0	-	202	255	255	1.0000000
C6	12806293	12807332	BolC6t36345H	0	+	742	1039	1039	1.0000000
C6	12807972	12808946	BolC6t36346H	0	+	603	974	974	1.0000000
C6	12809242	12811017	BolC6t36347H	0	-	950	1767	1775	0.9954929
C6	12822152	12822314	BolC6t36348H	0	-	3	111	162	0.6851852
C6	12822594	12825064	BolC6t36349H	0	-	786	1895	2470	0.7672065
C6	12829226	12836908	BolC6t36350H	0	-	1562	5197	7682	0.6765165
C6	12842633	12851182	BolC6t36351H	0	-	5344	8541	8549	0.9990642
C6	12856931	12861770	BolC6t36352H	0	+	2264	4810	4839	0.9940071
C6	12867186	12870503	BolC6t36353H	0	-	243	1645	3317	0.4959300
C6	12871456	12871969	BolC6t36354H	0	-	34	141	513	0.2748538
C6	12888214	12889685	BolC6t36355H	0	+	378	1359	1471	0.9238613
C6	12890054	12890638	BolC6t36356H	0	-	309	584	584	1.0000000
C6	12895336	12895655	BolC6t36357H	0	-	81	319	319	1.0000000
C6	12905465	12905761	BolC6t36358H	0	+	47	111	296	0.3750000
C6	12908672	12909159	BolC6t36359H	0	+	13	270	487	0.5544148
C6	12909914	12910016	BolC6t36360H	0	-	0	0	102	0.0000000
C6	12910495	12912539	BolC6t36361H	0	-	161	846	2044	0.4138943
C6	12912860	12912968	BolC6t36362H	0	-	0	0	108	0.0000000
C6	12917288	12919230	BolC6t36363H	0	+	239	1493	1942	0.7687951
C6	12932705	12933289	BolC6t36364H	0	-	7	375	584	0.6421233
C6	12936706	12936904	BolC6t36365H	0	-	111	198	198	1.0000000
C6	12938577	12939532	BolC6t36366H	0	-	29	459	955	0.4806283
C6	12963885	12965158	BolC6t36367H	0	+	714	1237	1273	0.9717203
C6	12965480	12967776	BolC6t36368H	0	-	96	1300	2296	0.5662021
C6	12986215	12986341	BolC6t36369H	0	-	2	62	126	0.4920635
C6	12997683	12999197	BolC6t36370H	0	-	1080	1514	1514	1.0000000
C6	13015742	13016294	BolC6t36371H	0	-	8	260	552	0.4710145
C6	13044218	13044761	BolC6t36372H	0	+	290	543	543	1.0000000
C6	13058975	13059272	BolC6t36373H	0	+	71	297	297	1.0000000
C6	13094560	13099175	BolC6t36374H	0	+	153	1239	4615	0.2684724
C6	13099521	13100547	BolC6t36375H	0	+	0	0	1026	0.0000000
C6	13151236	13156168	BolC6t36376H	0	+	70	859	4932	0.1741687
C6	13156528	13157014	BolC6t36377H	0	+	1	4	486	0.0082305
C6	13193404	13193563	BolC6t36378H	0	+	120	159	159	1.0000000
C6	13217190	13221859	BolC6t36379H	0	+	759	3476	4669	0.7444849
C6	13222411	13226520	BolC6t36380H	0	-	1108	3436	4109	0.8362132
C6	13240219	13254290	BolC6t36381H	0	+	1895	9348	14071	0.6643451
C6	13257629	13266154	BolC6t36382H	0	-	397	2533	8525	0.2971261
C6	13294551	13295673	BolC6t36383H	0	+	605	1122	1122	1.0000000
C6	13296392	13297609	BolC6t36384H	0	+	449	1217	1217	1.0000000
C6	13299418	13300403	BolC6t36385H	0	+	141	702	985	0.7126904
C6	13309332	13310804	BolC6t36386H	0	-	8	217	1472	0.1474185
C6	13313815	13314208	BolC6t36387H	0	+	288	393	393	1.0000000
C6	13323922	13324536	BolC6t36388H	0	+	389	614	614	1.0000000
C6	13353330	13354585	BolC6t36389H	0	-	8139	1255	1255	1.0000000
C6	13388835	13388952	BolC6t36390H	0	-	0	0	117	0.0000000
C6	13407842	13410656	BolC6t36391H	0	+	81	1642	2814	0.5835110
C6	13412133	13413881	BolC6t36392H	0	+	134	1309	1748	0.7488558
C6	13436529	13436970	BolC6t36393H	0	-	55	440	441	0.9977324
C6	13443440	13445001	BolC6t36394H	0	+	862	1482	1561	0.9493914
C6	13445898	13447005	BolC6t36395H	0	+	59	539	1107	0.4869015
C6	13455720	13455882	BolC6t36396H	0	-	239	162	162	1.0000000
C6	13492617	13492884	BolC6t36397H	0	-	41	267	267	1.0000000
C6	13499140	13499659	BolC6t36398H	0	+	246	519	519	1.0000000
C6	13500212	13501775	BolC6t36399H	0	-	173	1151	1563	0.7364044
C6	13502149	13505425	BolC6t36400H	0	+	1277	3275	3276	0.9996948
C6	13509640	13543070	BolC6t36401H	0	-	7673	17304	33430	0.5176189
C6	13517468	13517746	BolC6t36402H	0	+	0	0	278	0.0000000
C6	13521772	13522049	BolC6t36403H	0	+	0	0	277	0.0000000
C6	13526078	13526355	BolC6t36404H	0	+	0	0	277	0.0000000
C6	13549483	13551071	BolC6t36405H	0	+	903	1588	1588	1.0000000
C6	13554546	13554816	BolC6t36406H	0	-	50	234	270	0.8666667
C6	13557423	13557621	BolC6t36407H	0	+	239	198	198	1.0000000
C6	13570505	13570643	BolC6t36408H	0	-	0	0	138	0.0000000
C6	13582355	13582625	BolC6t36409H	0	-	30	244	270	0.9037037
C6	13614426	13615955	BolC6t36410H	0	-	805	1529	1529	1.0000000
C6	13619890	13622702	BolC6t36411H	0	-	114	1449	2812	0.5152916
C6	13650383	13650671	BolC6t36412H	0	+	152	288	288	1.0000000
C6	13655596	13656075	BolC6t36413H	0	+	147	459	479	0.9582464
C6	13656532	13657167	BolC6t36414H	0	-	205	635	635	1.0000000
C6	13683396	13685143	BolC6t36415H	0	-	260	1586	1747	0.9078420
C6	13693100	13693334	BolC6t36416H	0	+	993	234	234	1.0000000
C6	13763230	13765122	BolC6t36417H	0	+	755	1731	1892	0.9149048
C6	13765546	13766730	BolC6t36418H	0	-	502	1184	1184	1.0000000
C6	13789382	13790703	BolC6t36419H	0	-	47	556	1321	0.4208933
C6	13826076	13826214	BolC6t36420H	0	-	0	0	138	0.0000000
C6	13851614	13852009	BolC6t36421H	0	-	36	357	395	0.9037974
C6	13865110	13865731	BolC6t36422H	0	-	106	621	621	1.0000000
C6	13866164	13866419	BolC6t36423H	0	-	55	255	255	1.0000000
C6	13881281	13883066	BolC6t36424H	0	+	664	1712	1785	0.9591036
C6	13884979	13885159	BolC6t36425H	0	-	138	180	180	1.0000000
C6	13891452	13893934	BolC6t36426H	0	+	1459	2482	2482	1.0000000
C6	13937370	13939789	BolC6t36427H	0	+	565	2258	2419	0.9334435
C6	13941980	13942639	BolC6t36428H	0	+	29	311	659	0.4719272
C6	13946687	13947054	BolC6t36429H	0	+	1	53	367	0.1444142
C6	13950226	13954778	BolC6t36430H	0	+	97	1610	4552	0.3536907
C6	13958003	13960692	BolC6t36431H	0	-	1940	2689	2689	1.0000000
C6	13983618	13985499	BolC6t36432H	0	+	598	1873	1881	0.9957470
C6	13988767	13991199	BolC6t36433H	0	-	232	1780	2432	0.7319079
C6	13993252	13993645	BolC6t36434H	0	-	232	393	393	1.0000000
C6	13996516	13996822	BolC6t36435H	0	-	504	306	306	1.0000000
C6	13998799	13999153	BolC6t36436H	0	-	303	354	354	1.0000000
C6	13999285	14002209	BolC6t36437H	0	-	1637	2612	2924	0.8932968
C6	14011507	14012107	BolC6t36438H	0	+	185	600	600	1.0000000
C6	14013069	14013633	BolC6t36439H	0	-	11	436	564	0.7730497
C6	14014982	14017466	BolC6t36440H	0	-	973	2468	2484	0.9935588
C6	14038277	14038910	BolC6t36441H	0	-	445	633	633	1.0000000
C6	14043494	14044280	BolC6t36442H	0	-	581	786	786	1.0000000
C6	14046642	14048055	BolC6t36443H	0	-	838	1413	1413	1.0000000
C6	14082867	14084017	BolC6t36444H	0	-	936	1150	1150	1.0000000
C6	14095262	14096913	BolC6t36445H	0	+	974	1561	1651	0.9454876
C6	14097495	14098491	BolC6t36446H	0	+	84	848	996	0.8514056
C6	14129338	14131875	BolC6t36447H	0	+	62	1468	2537	0.5786362
C6	14138013	14138316	BolC6t36448H	0	+	12	299	303	0.9867987
C6	14139578	14140067	BolC6t36449H	0	+	32	339	489	0.6932516
C6	14149406	14150022	BolC6t36450H	0	+	468	616	616	1.0000000
C6	14153666	14153834	BolC6t36451H	0	-	29	168	168	1.0000000
C6	14172013	14173023	BolC6t36452H	0	+	1	98	1010	0.0970297
C6	14173549	14174106	BolC6t36453H	0	+	0	0	557	0.0000000
C6	14178291	14178680	BolC6t36454H	0	-	1	54	389	0.1388175
C6	14192728	14193523	BolC6t36455H	0	+	38	451	795	0.5672956
C6	14198496	14241082	BolC6t36456H	0	-	2509	14852	42586	0.3487531
C6	14206367	14206879	BolC6t36457H	0	+	0	0	512	0.0000000
C6	14210247	14210988	BolC6t36458H	0	-	0	0	741	0.0000000
C6	14222445	14234355	BolC6t36459H	0	+	120	2335	11910	0.1960537
C6	14231142	14231870	BolC6t36460H	0	-	7	291	728	0.3997253
C6	14247246	14247803	BolC6t36461H	0	+	0	0	557	0.0000000
C6	14251528	14251869	BolC6t36462H	0	-	0	0	341	0.0000000
C6	14280351	14328544	BolC6t36463H	0	+	5757	27474	48193	0.5700828
C6	14289257	14290966	BolC6t36464H	0	-	107	1397	1709	0.8174371
C6	14297137	14297694	BolC6t36465H	0	+	0	0	557	0.0000000
C6	14300819	14301160	BolC6t36466H	0	-	0	0	341	0.0000000
C6	14319431	14320760	BolC6t36467H	0	-	17	735	1329	0.5530474
C6	14371385	14374744	BolC6t36468H	0	-	840	3078	3359	0.9163442
C6	14377443	14378878	BolC6t36469H	0	-	692	1411	1435	0.9832752
C6	14391519	14393470	BolC6t36470H	0	-	1358	1951	1951	1.0000000
C6	14411921	14414680	BolC6t36471H	0	+	1491	2759	2759	1.0000000
C6	14416979	14418829	BolC6t36472H	0	-	827	1833	1850	0.9908108
C6	14422639	14424562	BolC6t36473H	0	-	852	1806	1923	0.9391575
C6	14440065	14440744	BolC6t36474H	0	+	224	679	679	1.0000000
C6	14441901	14442929	BolC6t36475H	0	+	1094	1028	1028	1.0000000
C6	14446603	14447620	BolC6t36476H	0	+	215	815	1017	0.8013766
C6	14454760	14457414	BolC6t36477H	0	-	835	2395	2654	0.9024115
C6	14470368	14471719	BolC6t36478H	0	+	0	0	1351	0.0000000
C6	14472532	14474148	BolC6t36479H	0	+	0	0	1616	0.0000000
C6	14474529	14476215	BolC6t36480H	0	-	0	0	1686	0.0000000
C6	14502629	14503213	BolC6t36481H	0	-	362	584	584	1.0000000
C6	14503698	14504013	BolC6t36482H	0	-	210	315	315	1.0000000
C6	14504170	14507167	BolC6t36483H	0	-	1591	2997	2997	1.0000000
C6	14509660	14512825	BolC6t36484H	0	+	2053	3165	3165	1.0000000
C6	14516423	14517964	BolC6t36485H	0	+	66	1257	1541	0.8157041
C6	14525075	14525591	BolC6t36486H	0	+	102	499	516	0.9670542
C6	14535318	14535928	BolC6t36487H	0	-	41	467	610	0.7655738
C6	14545694	14546246	BolC6t36488H	0	+	624	523	552	0.9474638
C6	14555812	14557232	BolC6t36489H	0	-	869	1420	1420	1.0000000
C6	14557887	14563618	BolC6t36490H	0	+	3005	5146	5731	0.8979236
C6	14577393	14579774	BolC6t36491H	0	+	166	1758	2381	0.7383452
C6	14580759	14582010	BolC6t36492H	0	+	77	737	1251	0.5891287
C6	14582514	14586727	BolC6t36493H	0	-	701	3544	4213	0.8412058
C6	14586877	14587416	BolC6t36494H	0	-	134	539	539	1.0000000
C6	14591572	14592091	BolC6t36495H	0	-	20	363	519	0.6994219
C6	14596542	14603628	BolC6t36496H	0	+	880	2668	7086	0.3765171
C6	14611759	14615445	BolC6t36497H	0	+	583	2382	3686	0.6462290
C6	14615767	14619586	BolC6t36498H	0	-	452	2449	3819	0.6412674
C6	14633692	14634005	BolC6t36499H	0	-	2	145	313	0.4632588
C6	14649636	14653663	BolC6t36500H	0	-	273	1941	4027	0.4819965
C6	14661376	14661649	BolC6t36501H	0	+	133	273	273	1.0000000
C6	14662314	14662509	BolC6t36502H	0	+	28	195	195	1.0000000
C6	14668733	14734211	BolC6t36503H	0	-	24491	64275	65478	0.9816274
C6	14668897	14669413	BolC6t36504H	0	-	53	268	516	0.5193799
C6	14743759	14744832	BolC6t36505H	0	-	479	1073	1073	1.0000000
C6	14749764	14754629	BolC6t36506H	0	-	2829	4865	4865	1.0000000
C6	14762368	14763772	BolC6t36507H	0	+	6	511	1404	0.3639601
C6	14765213	14766326	BolC6t36508H	0	+	39	665	1113	0.5974843
C6	14798997	14803584	BolC6t36509H	0	-	2002	4277	4587	0.9324177
C6	14824890	14825429	BolC6t36510H	0	-	427	539	539	1.0000000
C6	14838347	14839346	BolC6t36511H	0	-	1098	999	999	1.0000000
C6	14870709	14871073	BolC6t36512H	0	+	42	294	364	0.8076923
C6	14875640	14876048	BolC6t36513H	0	-	261	408	408	1.0000000
C6	14883207	14883525	BolC6t36514H	0	+	89	269	318	0.8459119
C6	14884096	14884468	BolC6t36515H	0	-	266	372	372	1.0000000
C6	14910437	14910658	BolC6t36516H	0	+	41	221	221	1.0000000
C6	14912817	14913531	BolC6t36517H	0	+	345	714	714	1.0000000
C6	14914828	14915212	BolC6t36518H	0	+	261	384	384	1.0000000
C6	14933812	14936995	BolC6t36519H	0	+	1943	3183	3183	1.0000000
C6	14939015	14939610	BolC6t36520H	0	-	383	595	595	1.0000000
C6	14964633	14967449	BolC6t36521H	0	+	453	2044	2816	0.7258523
C6	14968136	14968655	BolC6t36522H	0	+	40	419	519	0.8073218
C6	14969784	14973621	BolC6t36523H	0	+	1429	3612	3837	0.9413604
C6	14974260	14976304	BolC6t36524H	0	-	346	1721	2044	0.8419765
C6	14977169	14980224	BolC6t36525H	0	-	513	2575	3055	0.8428805
C6	14989093	14994490	BolC6t36526H	0	-	1385	5361	5397	0.9933296
C6	14994039	14994848	BolC6t36527H	0	-	651	809	809	1.0000000
C6	15001397	15003850	BolC6t36528H	0	+	1301	2453	2453	1.0000000
C6	15013570	15017902	BolC6t36529H	0	-	545	3801	4332	0.8774238
C6	15035816	15036059	BolC6t36530H	0	+	240	243	243	1.0000000
C6	15037127	15037473	BolC6t36531H	0	+	245	346	346	1.0000000
C6	15051314	15051938	BolC6t36532H	0	-	150	624	624	1.0000000
C6	15079604	15079958	BolC6t36533H	0	+	65	354	354	1.0000000
C6	15094704	15095268	BolC6t36534H	0	+	285	564	564	1.0000000
C6	15118286	15120701	BolC6t36535H	0	-	1487	2270	2415	0.9399586
C6	15133371	15134440	BolC6t36536H	0	-	810	1069	1069	1.0000000
C6	15137827	15143451	BolC6t36537H	0	+	2486	5415	5624	0.9628378
C6	15146953	15147151	BolC6t36538H	0	-	191	198	198	1.0000000
C6	15160476	15161463	BolC6t36539H	0	-	357	987	987	1.0000000
C6	15163199	15163817	BolC6t36540H	0	-	1	82	618	0.1326861
C6	15175280	15176112	BolC6t36541H	0	-	42	608	832	0.7307692
C6	15182935	15183866	BolC6t36542H	0	-	669	931	931	1.0000000
C6	15188582	15188828	BolC6t36543H	0	-	143	187	246	0.7601626
C6	15189453	15189712	BolC6t36544H	0	+	207	259	259	1.0000000
C6	15190029	15193208	BolC6t36545H	0	-	191	1565	3179	0.4922932
C6	15194272	15195843	BolC6t36546H	0	+	556	1555	1571	0.9898154
C6	15206375	15206842	BolC6t36547H	0	-	853	467	467	1.0000000
C6	15215232	15216664	BolC6t36548H	0	-	668	1432	1432	1.0000000
C6	15217608	15217857	BolC6t36549H	0	-	75	249	249	1.0000000
C6	15218956	15221376	BolC6t36550H	0	+	1520	2416	2420	0.9983471
C6	15222591	15222959	BolC6t36551H	0	-	177	368	368	1.0000000
C6	15227369	15227784	BolC6t36552H	0	+	355	415	415	1.0000000
C6	15249636	15251561	BolC6t36553H	0	-	528	1873	1925	0.9729870
C6	15255118	15255537	BolC6t36554H	0	-	754	419	419	1.0000000
C6	15271145	15272593	BolC6t36555H	0	-	441	1372	1448	0.9475138
C6	15274029	15274584	BolC6t36556H	0	-	521	555	555	1.0000000
C6	15282944	15283438	BolC6t36557H	0	+	299	494	494	1.0000000
C6	15283533	15283743	BolC6t36558H	0	+	230	210	210	1.0000000
C6	15290856	15291027	BolC6t36559H	0	-	78	171	171	1.0000000
C6	15294425	15294813	BolC6t36560H	0	+	198	388	388	1.0000000
C6	15296327	15297419	BolC6t36561H	0	-	489	1092	1092	1.0000000
C6	15298699	15299392	BolC6t36562H	0	+	426	693	693	1.0000000
C6	15299476	15299712	BolC6t36563H	0	+	57	236	236	1.0000000
C6	15299754	15300457	BolC6t36564H	0	+	174	703	703	1.0000000
C6	15301806	15302370	BolC6t36565H	0	+	239	564	564	1.0000000
C6	15304654	15304798	BolC6t36566H	0	-	47	120	144	0.8333333
C6	15306574	15307018	BolC6t36567H	0	-	325	444	444	1.0000000
C6	15308260	15312269	BolC6t36568H	0	-	3168	4009	4009	1.0000000
C6	15332159	15333319	BolC6t36569H	0	+	700	1146	1160	0.9879310
C6	15334373	15335728	BolC6t36570H	0	+	494	1355	1355	1.0000000
C6	15336983	15337737	BolC6t36571H	0	+	134	666	754	0.8832891
C6	15344201	15344576	BolC6t36572H	0	+	306	375	375	1.0000000
C6	15355950	15356647	BolC6t36573H	0	-	556	697	697	1.0000000
C6	15364922	15374494	BolC6t36574H	0	+	3676	7263	9572	0.7587756
C6	15386760	15389440	BolC6t36575H	0	+	378	2353	2680	0.8779851
C6	15415428	15419494	BolC6t36576H	0	+	2050	3709	4066	0.9121987
C6	15421730	15424147	BolC6t36577H	0	+	1281	2318	2417	0.9590401
C6	15431744	15432099	BolC6t36578H	0	+	147	355	355	1.0000000
C6	15441265	15441772	BolC6t36579H	0	+	8	72	507	0.1420118
C6	15444847	15446279	BolC6t36580H	0	+	331	1176	1432	0.8212290
C6	15452784	15455178	BolC6t36581H	0	+	1225	2304	2394	0.9624060
C6	15455324	15457185	BolC6t36582H	0	-	635	1826	1861	0.9811929
C6	15458881	15461003	BolC6t36583H	0	+	852	2096	2122	0.9877474
C6	15473405	15474365	BolC6t36584H	0	+	448	960	960	1.0000000
C6	15474508	15475783	BolC6t36585H	0	-	927	1275	1275	1.0000000
C6	15480172	15480940	BolC6t36586H	0	+	712	768	768	1.0000000
C6	15481554	15482001	BolC6t36587H	0	-	374	447	447	1.0000000
C6	15490740	15491873	BolC6t36588H	0	+	11	752	1133	0.6637246
C6	15501616	15502084	BolC6t36589H	0	-	53	431	468	0.9209402
C6	15502861	15512528	BolC6t36590H	0	-	427	5064	9667	0.5238440
C6	15516482	15519531	BolC6t36591H	0	-	636	2647	3049	0.8681535
C6	15520527	15528289	BolC6t36592H	0	+	3262	2905	7762	0.3742592
C6	15531975	15532515	BolC6t36593H	0	-	62	330	540	0.6111111
C6	15534090	15534399	BolC6t36594H	0	-	44	309	309	1.0000000
C6	15547477	15549802	BolC6t36595H	0	+	2462	2325	2325	1.0000000
C6	15555370	15555973	BolC6t36596H	0	-	911	603	603	1.0000000
C6	15586798	15589132	BolC6t36597H	0	-	471	2316	2334	0.9922879
C6	15609542	15610267	BolC6t36598H	0	+	758	725	725	1.0000000
C6	15622598	15622814	BolC6t36599H	0	-	177	216	216	1.0000000
C6	15629905	15630265	BolC6t36600H	0	+	66	277	360	0.7694445
C6	15632176	15634200	BolC6t36601H	0	+	2590	2024	2024	1.0000000
C6	15634616	15635561	BolC6t36602H	0	+	849	945	945	1.0000000
C6	15645031	15646810	BolC6t36603H	0	+	1388	1779	1779	1.0000000
C6	15647612	15648457	BolC6t36604H	0	+	52	651	845	0.7704142
C6	15651960	15652659	BolC6t36605H	0	-	54	523	699	0.7482117
C6	15659793	15661297	BolC6t36606H	0	-	206	1498	1504	0.9960107
C6	15665171	15665572	BolC6t36607H	0	+	423	401	401	1.0000000
C6	15674440	15677193	BolC6t36608H	0	+	1875	2753	2753	1.0000000
C6	15681904	15682126	BolC6t36609H	0	-	290	222	222	1.0000000
C6	15776463	15776781	BolC6t36610H	0	+	551	318	318	1.0000000
C6	15780076	15780379	BolC6t36611H	0	-	214	303	303	1.0000000
C6	15781462	15782044	BolC6t36612H	0	-	399	582	582	1.0000000
C6	15788679	15789303	BolC6t36613H	0	-	772	624	624	1.0000000
C6	15790898	15791313	BolC6t36614H	0	-	331	415	415	1.0000000
C6	15794693	15796510	BolC6t36615H	0	-	798	1780	1817	0.9796368
C6	15818871	15820185	BolC6t36616H	0	-	90	635	1314	0.4832572
C6	15826720	15827427	BolC6t36617H	0	+	1133	707	707	1.0000000
C6	15834084	15834974	BolC6t36618H	0	-	102	523	890	0.5876405
C6	15835855	15838439	BolC6t36619H	0	+	950	2531	2584	0.9794891
C6	15865231	15865443	BolC6t36620H	0	-	57	212	212	1.0000000
C6	15867875	15868079	BolC6t36621H	0	-	2	75	204	0.3676471
C6	15868268	15869423	BolC6t36622H	0	-	97	1007	1155	0.8718615
C6	15877544	15877993	BolC6t36623H	0	-	63	307	449	0.6837416
C6	15904852	15907617	BolC6t36624H	0	+	1799	2765	2765	1.0000000
C6	15917176	15919995	BolC6t36625H	0	+	1094	2794	2819	0.9911316
C6	15921653	15923554	BolC6t36626H	0	+	928	1876	1901	0.9868490
C6	15929027	15932038	BolC6t36627H	0	+	456	2299	3011	0.7635337
C6	15938299	15938920	BolC6t36628H	0	+	141	613	621	0.9871175
C6	15948647	15948845	BolC6t36629H	0	+	16	170	198	0.8585858
C6	15955164	15960411	BolC6t36630H	0	+	1061	3509	5247	0.6687631
C6	15961678	15962557	BolC6t36631H	0	+	70	667	879	0.7588168
C6	15966890	15967496	BolC6t36632H	0	-	27	375	606	0.6188119
C6	15977104	15978259	BolC6t36633H	0	-	65	751	1155	0.6502165
C6	15980359	15983826	BolC6t36634H	0	+	2687	3467	3467	1.0000000
C6	15993942	15995057	BolC6t36635H	0	+	54	845	1115	0.7578475
C6	16044409	16046270	BolC6t36636H	0	+	407	1635	1861	0.8785599
C6	16050813	16053624	BolC6t36637H	0	-	860	2346	2811	0.8345785
C6	16059792	16062154	BolC6t36638H	0	+	371	2028	2362	0.8585944
C6	16065897	16066732	BolC6t36639H	0	-	530	835	835	1.0000000
C6	16069005	16069994	BolC6t36640H	0	+	1545	989	989	1.0000000
C6	16072640	16075139	BolC6t36641H	0	-	237	2031	2499	0.8127251
C6	16081573	16082313	BolC6t36642H	0	-	596	740	740	1.0000000
C6	16085285	16086823	BolC6t36643H	0	+	1213	1538	1538	1.0000000
C6	16088553	16090142	BolC6t36644H	0	-	712	1589	1589	1.0000000
C6	16090282	16092432	BolC6t36645H	0	+	388	1063	2150	0.4944186
C6	16095601	16096843	BolC6t36646H	0	-	615	1242	1242	1.0000000
C6	16098203	16100176	BolC6t36647H	0	+	835	1928	1973	0.9771921
C6	16119208	16129370	BolC6t36648H	0	+	800	3222	10162	0.3170636
C6	16132326	16133554	BolC6t36649H	0	+	8	272	1228	0.2214984
C6	16140153	16141585	BolC6t36650H	0	+	475	1339	1432	0.9350559
C6	16144393	16148408	BolC6t36651H	0	-	1977	4015	4015	1.0000000
C6	16171078	16171492	BolC6t36652H	0	-	406	414	414	1.0000000
C6	16178857	16181112	BolC6t36653H	0	-	1092	2136	2255	0.9472284
C6	16181867	16182344	BolC6t36654H	0	+	404	477	477	1.0000000
C6	16203940	16204805	BolC6t36655H	0	-	577	865	865	1.0000000
C6	16204964	16207302	BolC6t36656H	0	-	1743	2338	2338	1.0000000
C6	16208498	16211108	BolC6t36657H	0	+	714	2069	2610	0.7927203
C6	16212827	16215735	BolC6t36658H	0	+	872	2577	2908	0.8861760
C6	16217448	16224546	BolC6t36659H	0	+	1673	5685	7098	0.8009298
C6	16225689	16226846	BolC6t36660H	0	-	830	1157	1157	1.0000000
C6	16236501	16237602	BolC6t36661H	0	+	745	1101	1101	1.0000000
C6	16240686	16242551	BolC6t36662H	0	-	846	1710	1865	0.9168901
C6	16247432	16247781	BolC6t36663H	0	-	0	0	349	0.0000000
C6	16258295	16273282	BolC6t36664H	0	-	7591	11323	14987	0.7555215
C6	16258974	16260221	BolC6t36665H	0	-	1262	1247	1247	1.0000000
C6	16280071	16280689	BolC6t36666H	0	-	45	522	618	0.8446602
C6	16295640	16295862	BolC6t36667H	0	+	253	222	222	1.0000000
C6	16302388	16307282	BolC6t36668H	0	+	752	3415	4894	0.6977932
C6	16308467	16309073	BolC6t36669H	0	-	75	355	606	0.5858086
C6	16312147	16314091	BolC6t36670H	0	+	1343	1944	1944	1.0000000
C6	16318456	16324787	BolC6t36671H	0	+	1820	5149	6331	0.8132997
C6	16325632	16326228	BolC6t36672H	0	-	633	596	596	1.0000000
C6	16336458	16336895	BolC6t36673H	0	-	393	437	437	1.0000000
C6	16341442	16342322	BolC6t36674H	0	-	160	530	880	0.6022727
C6	16343631	16344500	BolC6t36675H	0	+	101	803	869	0.9240506
C6	16344911	16346995	BolC6t36676H	0	-	51	670	2084	0.3214971
C6	16348649	16351125	BolC6t36677H	0	-	952	2309	2476	0.9325525
C6	16386813	16393117	BolC6t36678H	0	+	68	1801	6304	0.2856916
C6	16393880	16397416	BolC6t36679H	0	+	1332	3164	3536	0.8947964
C6	16402921	16403385	BolC6t36680H	0	+	335	464	464	1.0000000
C6	16413290	16413656	BolC6t36681H	0	-	123	366	366	1.0000000
C6	16423039	16423258	BolC6t36682H	0	-	44	219	219	1.0000000
C6	16442594	16442849	BolC6t36683H	0	-	39	255	255	1.0000000
C6	16464493	16464595	BolC6t36684H	0	-	78	102	102	1.0000000
C6	16472345	16472882	BolC6t36685H	0	+	578	537	537	1.0000000
C6	16474924	16475436	BolC6t36686H	0	+	722	512	512	1.0000000
C6	16487806	16487955	BolC6t36687H	0	-	0	0	149	0.0000000
C6	16491019	16491526	BolC6t36688H	0	+	5	64	507	0.1262327
C6	16519597	16520839	BolC6t36689H	0	+	20	122	1242	0.0982287
C6	16525562	16525772	BolC6t36690H	0	-	94	210	210	1.0000000
C6	16530621	16530813	BolC6t36691H	0	-	31	192	192	1.0000000
C6	16534896	16535121	BolC6t36692H	0	-	41	225	225	1.0000000
C6	16535906	16537360	BolC6t36693H	0	-	814	1449	1454	0.9965612
C6	16541727	16543513	BolC6t36694H	0	-	1048	1786	1786	1.0000000
C6	16559656	16560419	BolC6t36695H	0	-	102	275	763	0.3604194
C6	16577359	16579250	BolC6t36696H	0	+	1481	1856	1891	0.9814913
C6	16579998	16580450	BolC6t36697H	0	-	385	452	452	1.0000000
C6	16611059	16612535	BolC6t36698H	0	+	98	912	1476	0.6178862
C6	16617630	16618915	BolC6t36699H	0	-	1441	1255	1285	0.9766537
C6	16623845	16624463	BolC6t36700H	0	+	39	282	618	0.4563107
C6	16626448	16628372	BolC6t36701H	0	-	918	1911	1924	0.9932432
C6	16628653	16643471	BolC6t36702H	0	-	3336	8831	14818	0.5959644
C6	16648506	16650050	BolC6t36703H	0	-	1437	1544	1544	1.0000000
C6	16651696	16651873	BolC6t36704H	0	-	165	177	177	1.0000000
C6	16652343	16655122	BolC6t36705H	0	+	1583	2719	2779	0.9784095
C6	16658910	16660267	BolC6t36706H	0	+	1057	1357	1357	1.0000000
C6	16670044	16670995	BolC6t36707H	0	+	40	499	951	0.5247108
C6	16673262	16674344	BolC6t36708H	0	+	441	1050	1082	0.9704251
C6	16701669	16704015	BolC6t36709H	0	+	517	2012	2346	0.8576300
C6	16705456	16707293	BolC6t36710H	0	+	201	1666	1837	0.9069135
C6	16708285	16709675	BolC6t36711H	0	-	798	1374	1390	0.9884892
C6	16716872	16718081	BolC6t36712H	0	-	143	687	1209	0.5682382
C6	16741620	16741852	BolC6t36713H	0	+	164	232	232	1.0000000
C6	16745175	16745418	BolC6t36714H	0	-	0	0	243	0.0000000
C6	16753786	16754629	BolC6t36715H	0	+	180	656	843	0.7781732
C6	16758897	16758999	BolC6t36716H	0	-	27	102	102	1.0000000
C6	16761097	16761790	BolC6t36717H	0	-	1297	693	693	1.0000000
C6	16771939	16773438	BolC6t36718H	0	+	1	22	1499	0.0146765
C6	16828585	16828744	BolC6t36719H	0	-	94	159	159	1.0000000
C6	16831224	16831467	BolC6t36720H	0	-	23	243	243	1.0000000
C6	16848044	16848236	BolC6t36721H	0	-	16	46	192	0.2395833
C6	16850457	16851813	BolC6t36722H	0	-	6	43	1356	0.0317109
C6	16857811	16859271	BolC6t36723H	0	+	41	126	1460	0.0863014
C6	16880189	16880414	BolC6t36724H	0	+	22	123	225	0.5466667
C6	16883707	16883824	BolC6t36725H	0	+	147	117	117	1.0000000
C6	16892669	16892919	BolC6t36726H	0	+	3	157	250	0.6280000
C6	16907991	16912490	BolC6t36727H	0	+	292	2375	4499	0.5278951
C6	16912696	16913261	BolC6t36728H	0	+	0	0	565	0.0000000
C6	16918370	16919609	BolC6t36729H	0	+	393	1178	1239	0.9507667
C6	16927717	16927909	BolC6t36730H	0	-	165	192	192	1.0000000
C6	16929950	16932345	BolC6t36731H	0	+	428	1652	2395	0.6897703
C6	16946571	16948754	BolC6t36732H	0	-	367	1361	2183	0.6234540
C6	16949746	16955103	BolC6t36733H	0	+	8901	5021	5357	0.9372783
C6	16956841	16957606	BolC6t36734H	0	+	67	501	765	0.6549020
C6	16971553	16973167	BolC6t36735H	0	-	5878	1614	1614	1.0000000
C6	16974718	16977752	BolC6t36736H	0	-	6234	3034	3034	1.0000000
C6	16979558	16980127	BolC6t36737H	0	+	239	569	569	1.0000000
C6	16980209	16980429	BolC6t36738H	0	+	235	220	220	1.0000000
C6	16996898	17004884	BolC6t36739H	0	-	1836	5876	7986	0.7357876
C6	17011812	17012361	BolC6t36740H	0	+	45	462	549	0.8415300
C6	17017289	17017487	BolC6t36741H	0	+	16	198	198	1.0000000
C6	17027082	17027280	BolC6t36742H	0	+	21	198	198	1.0000000
C6	17047935	17048276	BolC6t36743H	0	+	108	191	341	0.5601173
C6	17055651	17058346	BolC6t36744H	0	+	1597	2686	2695	0.9966605
C6	17058843	17059635	BolC6t36745H	0	-	147	792	792	1.0000000
C6	17060305	17060890	BolC6t36746H	0	-	93	585	585	1.0000000
C6	17081310	17082509	BolC6t36747H	0	+	688	1199	1199	1.0000000
C6	17082844	17083656	BolC6t36748H	0	+	143	812	812	1.0000000
C6	17084233	17084414	BolC6t36749H	0	-	168	181	181	1.0000000
C6	17106537	17107365	BolC6t36750H	0	+	59	700	828	0.8454106
C6	17120757	17121212	BolC6t36751H	0	+	0	0	455	0.0000000
C6	17121968	17122250	BolC6t36752H	0	+	50	281	282	0.9964539
C6	17142872	17145357	BolC6t36753H	0	+	1565	2485	2485	1.0000000
C6	17145681	17146447	BolC6t36754H	0	-	663	766	766	1.0000000
C6	17149218	17150179	BolC6t36755H	0	-	1109	961	961	1.0000000
C6	17157366	17157905	BolC6t36756H	0	-	422	539	539	1.0000000
C6	17158577	17159884	BolC6t36757H	0	-	1213	1307	1307	1.0000000
C6	17162219	17162719	BolC6t36758H	0	-	319	500	500	1.0000000
C6	17164246	17168354	BolC6t36759H	0	+	1	40	4108	0.0097371
C6	17170793	17171111	BolC6t36760H	0	-	0	0	318	0.0000000
C6	17172114	17172631	BolC6t36761H	0	-	0	0	517	0.0000000
C6	17173995	17174826	BolC6t36762H	0	-	34	419	831	0.5042118
C6	17176181	17176580	BolC6t36763H	0	-	277	399	399	1.0000000
C6	17177573	17180480	BolC6t36764H	0	+	1984	2907	2907	1.0000000
C6	17185300	17185690	BolC6t36765H	0	-	331	390	390	1.0000000
C6	17186250	17193560	BolC6t36766H	0	+	1176	4111	7310	0.5623803
C6	17189380	17190704	BolC6t36767H	0	-	2	207	1324	0.1563444
C6	17194079	17198545	BolC6t36768H	0	-	1261	3915	4466	0.8766234
C6	17199866	17200645	BolC6t36769H	0	-	301	779	779	1.0000000
C6	17208512	17209150	BolC6t36770H	0	-	391	638	638	1.0000000
C6	17215713	17216519	BolC6t36771H	0	+	998	806	806	1.0000000
C6	17219885	17224599	BolC6t36772H	0	-	809	2055	4714	0.4359355
C6	17224919	17225172	BolC6t36773H	0	-	344	253	253	1.0000000
C6	17247785	17249862	BolC6t36774H	0	+	1522	2058	2077	0.9908522
C6	17251464	17252034	BolC6t36775H	0	+	151	566	570	0.9929824
C6	17267153	17267720	BolC6t36776H	0	-	64	211	567	0.3721340
C6	17274063	17274375	BolC6t36777H	0	+	304	312	312	1.0000000
C6	17283673	17284600	BolC6t36778H	0	+	579	846	927	0.9126214
C6	17325972	17326857	BolC6t36779H	0	+	310	881	885	0.9954802
C6	17346125	17346497	BolC6t36780H	0	+	18	283	372	0.7607527
C6	17351344	17351815	BolC6t36781H	0	+	94	455	471	0.9660297
C6	17352587	17354091	BolC6t36782H	0	-	363	1446	1504	0.9614362
C6	17359109	17360558	BolC6t36783H	0	-	1040	1449	1449	1.0000000
C6	17372453	17373865	BolC6t36784H	0	+	5	31	1412	0.0219547
C6	17376099	17377037	BolC6t36785H	0	+	1154	938	938	1.0000000
C6	17378234	17379087	BolC6t36786H	0	+	114	844	853	0.9894490
C6	17380026	17380569	BolC6t36787H	0	-	52	457	543	0.8416206
C6	17382869	17385098	BolC6t36788H	0	+	1023	2229	2229	1.0000000
C6	17387336	17390630	BolC6t36789H	0	+	1052	2734	3294	0.8299939
C6	17393362	17402129	BolC6t36790H	0	+	1155	6104	8767	0.6962473
C6	17403587	17403767	BolC6t36791H	0	-	1	79	180	0.4388889
C6	17414633	17416128	BolC6t36792H	0	+	289	1236	1495	0.8267559
C6	17438807	17439294	BolC6t36793H	0	+	33	433	487	0.8891171
C6	17444460	17444894	BolC6t36794H	0	+	153	434	434	1.0000000
C6	17447424	17447935	BolC6t36795H	0	-	45	511	511	1.0000000
C6	17448878	17451459	BolC6t36796H	0	-	165	1666	2581	0.6454862
C6	17451465	17455028	BolC6t36797H	0	-	365	2545	3563	0.7142857
C6	17455997	17456382	BolC6t36798H	0	-	7	274	385	0.7116883
C6	17456489	17456660	BolC6t36799H	0	-	0	0	171	0.0000000
C6	17457148	17457388	BolC6t36800H	0	+	149	240	240	1.0000000
C6	17468334	17468742	BolC6t36801H	0	-	127	408	408	1.0000000
C6	17472834	17473071	BolC6t36802H	0	-	17	237	237	1.0000000
C6	17476517	17477758	BolC6t36803H	0	-	89	649	1241	0.5229654
C6	17480645	17482980	BolC6t36804H	0	-	326	1720	2335	0.7366167
C6	17491172	17492360	BolC6t36805H	0	+	1468	1188	1188	1.0000000
C6	17493583	17495092	BolC6t36806H	0	+	515	1509	1509	1.0000000
C6	17495570	17498417	BolC6t36807H	0	-	1462	2845	2847	0.9992975
C6	17500031	17501445	BolC6t36808H	0	-	854	1414	1414	1.0000000
C6	17508641	17508932	BolC6t36809H	0	-	273	291	291	1.0000000
C6	17524212	17524520	BolC6t36810H	0	-	106	308	308	1.0000000
C6	17524975	17525998	BolC6t36811H	0	-	389	1023	1023	1.0000000
C6	17527301	17528659	BolC6t36812H	0	-	975	1358	1358	1.0000000
C6	17564829	17566742	BolC6t36813H	0	-	344	1665	1913	0.8703607
C6	17579970	17582001	BolC6t36814H	0	+	1028	2031	2031	1.0000000
C6	17591326	17591812	BolC6t36815H	0	-	80	417	486	0.8580247
C6	17592545	17594667	BolC6t36816H	0	-	1439	2122	2122	1.0000000
C6	17596545	17598902	BolC6t36817H	0	-	1528	2357	2357	1.0000000
C6	17616882	17617519	BolC6t36818H	0	-	362	637	637	1.0000000
C6	17619870	17620401	BolC6t36819H	0	-	59	440	531	0.8286253
C6	17621439	17623759	BolC6t36820H	0	-	1733	2297	2320	0.9900862
C6	17624105	17628664	BolC6t36821H	0	-	3621	4559	4559	1.0000000
C6	17633521	17636977	BolC6t36822H	0	+	355	1688	3456	0.4884259
C6	17649048	17649240	BolC6t36823H	0	-	61	192	192	1.0000000
C6	17655044	17657569	BolC6t36824H	0	+	429	2129	2525	0.8431683
C6	17657876	17660477	BolC6t36825H	0	+	496	2285	2601	0.8785083
C6	17661045	17664093	BolC6t36826H	0	-	1338	2863	3048	0.9393045
C6	17662765	17663489	BolC6t36827H	0	+	264	684	724	0.9447514
C6	17665031	17666228	BolC6t36828H	0	+	146	1088	1197	0.9089390
C6	17666554	17668487	BolC6t36829H	0	+	511	1933	1933	1.0000000
C6	17673649	17674612	BolC6t36830H	0	+	284	900	963	0.9345794
C6	17677064	17677679	BolC6t36831H	0	-	709	615	615	1.0000000
C6	17680880	17681546	BolC6t36832H	0	-	313	662	666	0.9939940
C6	17684488	17686402	BolC6t36833H	0	+	715	1869	1914	0.9764890
C6	17686901	17687277	BolC6t36834H	0	-	264	376	376	1.0000000
C6	17687342	17689444	BolC6t36835H	0	-	555	2013	2102	0.9576594
C6	17693738	17696628	BolC6t36836H	0	-	1165	2890	2890	1.0000000
C6	17698478	17699219	BolC6t36837H	0	-	600	741	741	1.0000000
C6	17703231	17705164	BolC6t36838H	0	+	716	1873	1933	0.9689602
C6	17705674	17707576	BolC6t36839H	0	+	123	939	1902	0.4936908
C6	17709016	17709601	BolC6t36840H	0	+	150	529	585	0.9042735
C6	17712697	17714094	BolC6t36841H	0	-	903	1397	1397	1.0000000
C6	17724720	17725353	BolC6t36842H	0	-	334	633	633	1.0000000
C6	17725431	17726598	BolC6t36843H	0	-	522	1167	1167	1.0000000
C6	17728538	17728832	BolC6t36844H	0	-	243	294	294	1.0000000
C6	17731570	17732478	BolC6t36845H	0	+	897	908	908	1.0000000
C6	17734630	17735943	BolC6t36846H	0	-	1011	1313	1313	1.0000000
C6	17748101	17750106	BolC6t36847H	0	-	71	832	2005	0.4149626
C6	17771237	17772633	BolC6t36848H	0	-	23	594	1396	0.4255014
C6	17772696	17773016	BolC6t36849H	0	-	2	18	320	0.0562500
C6	17777914	17784226	BolC6t36850H	0	-	731	3856	6312	0.6108999
C6	17789815	17792711	BolC6t36851H	0	+	719	2482	2896	0.8570442
C6	17793249	17803364	BolC6t36852H	0	-	486	4329	10115	0.4279782
C6	17806152	17806380	BolC6t36853H	0	-	96	228	228	1.0000000
C6	17810808	17811764	BolC6t36854H	0	-	432	956	956	1.0000000
C6	17814186	17814633	BolC6t36855H	0	+	325	447	447	1.0000000
C6	17815249	17816002	BolC6t36856H	0	-	157	563	753	0.7476760
C6	17834112	17834943	BolC6t36857H	0	-	3237	831	831	1.0000000
C6	17876494	17877302	BolC6t36858H	0	-	0	0	808	0.0000000
C6	17882146	17882719	BolC6t36859H	0	+	103	359	573	0.6265271
C6	17883103	17884695	BolC6t36860H	0	-	325	1295	1592	0.8134422
C6	17890699	17891744	BolC6t36861H	0	-	192	1005	1045	0.9617225
C6	17892330	17893509	BolC6t36862H	0	-	114	758	1179	0.6429178
C6	17896793	17899793	BolC6t36863H	0	-	461	1421	3000	0.4736667
C6	17902457	17903236	BolC6t36864H	0	+	547	779	779	1.0000000
C6	17905894	17906227	BolC6t36865H	0	+	223	333	333	1.0000000
C6	17911808	17912287	BolC6t36866H	0	+	180	479	479	1.0000000
C6	17912709	17913613	BolC6t36867H	0	-	658	904	904	1.0000000
C6	17916103	17918020	BolC6t36868H	0	-	1038	1917	1917	1.0000000
C6	17953377	17954475	BolC6t36869H	0	-	245	905	1098	0.8242258
C6	17957297	17959790	BolC6t36870H	0	+	437	2418	2493	0.9699157
C6	17959802	17960047	BolC6t36871H	0	+	68	245	245	1.0000000
C6	17960916	17961528	BolC6t36872H	0	-	163	612	612	1.0000000
C6	17971955	17975098	BolC6t36873H	0	-	646	2838	3143	0.9029589
C6	17985710	17986624	BolC6t36874H	0	-	198	914	914	1.0000000
C6	17987201	17987711	BolC6t36875H	0	-	122	429	510	0.8411765
C6	17995698	17996601	BolC6t36876H	0	-	125	739	903	0.8183832
C6	18011171	18012269	BolC6t36877H	0	-	218	927	1098	0.8442623
C6	18016634	18019097	BolC6t36878H	0	+	320	2415	2463	0.9805115
C6	18024961	18025096	BolC6t36879H	0	-	117	135	135	1.0000000
C6	18040552	18040999	BolC6t36880H	0	-	5	292	447	0.6532438
C6	18056639	18057083	BolC6t36881H	0	-	71	436	444	0.9819820
C6	18066311	18066578	BolC6t36882H	0	-	112	267	267	1.0000000
C6	18087265	18087437	BolC6t36883H	0	-	219	172	172	1.0000000
C6	18089722	18091852	BolC6t36884H	0	-	371	1650	2130	0.7746479
C6	18092084	18093929	BolC6t36885H	0	+	392	1351	1845	0.7322493
C6	18095411	18095696	BolC6t36886H	0	-	439	285	285	1.0000000
C6	18098071	18099287	BolC6t36887H	0	+	21	829	1216	0.6817434
C6	18112140	18112916	BolC6t36888H	0	+	501	776	776	1.0000000
C6	18113271	18114815	BolC6t36889H	0	-	596	1371	1544	0.8879533
C6	18117141	18119768	BolC6t36890H	0	-	3447	2627	2627	1.0000000
C6	18125976	18127842	BolC6t36891H	0	-	502	1818	1866	0.9742765
C6	18129882	18131110	BolC6t36892H	0	-	165	1206	1228	0.9820847
C6	18165464	18167105	BolC6t36893H	0	+	1024	1641	1641	1.0000000
C6	18169938	18171548	BolC6t36894H	0	-	402	1324	1610	0.8223603
C6	18182004	18185242	BolC6t36895H	0	+	1278	2688	3238	0.8301421
C6	18187190	18187340	BolC6t36896H	0	+	198	150	150	1.0000000
C6	18201435	18204045	BolC6t36897H	0	-	1605	2610	2610	1.0000000
C6	18220539	18222726	BolC6t36898H	0	-	993	2187	2187	1.0000000
C6	18224708	18229749	BolC6t36899H	0	-	1491	4502	5041	0.8930768
C6	18245558	18248112	BolC6t36900H	0	-	350	1929	2554	0.7552858
C6	18250457	18250806	BolC6t36901H	0	-	39	255	349	0.7306590
C6	18259289	18259859	BolC6t36902H	0	-	0	0	570	0.0000000
C6	18262486	18262645	BolC6t36903H	0	+	167	159	159	1.0000000
C6	18268941	18269241	BolC6t36904H	0	+	6	175	300	0.5833333
C6	18279881	18283118	BolC6t36905H	0	-	2834	3237	3237	1.0000000
C6	18284221	18285335	BolC6t36906H	0	+	471	1114	1114	1.0000000
C6	18285964	18286320	BolC6t36907H	0	-	159	356	356	1.0000000
C6	18288629	18288949	BolC6t36908H	0	-	303	320	320	1.0000000
C6	18315358	18320459	BolC6t36909H	0	+	1096	4437	5101	0.8698294
C6	18324316	18325750	BolC6t36910H	0	-	955	1434	1434	1.0000000
C6	18337870	18339049	BolC6t36911H	0	-	330	1111	1179	0.9423240
C6	18368377	18370915	BolC6t36912H	0	+	656	2120	2538	0.8353034
C6	18380276	18380784	BolC6t36913H	0	-	24	231	508	0.4547244
C6	18382878	18383298	BolC6t36914H	0	-	10	383	420	0.9119048
C6	18385495	18385933	BolC6t36915H	0	-	15	303	438	0.6917808
C6	18386083	18386236	BolC6t36916H	0	-	0	0	153	0.0000000
C6	18387687	18388638	BolC6t36917H	0	-	152	821	951	0.8633018
C6	18402031	18403101	BolC6t36918H	0	+	42	689	1070	0.6439252
C6	18406367	18407074	BolC6t36919H	0	-	38	358	707	0.5063649
C6	18415771	18416033	BolC6t36920H	0	+	75	262	262	1.0000000
C6	18420690	18421078	BolC6t36921H	0	+	101	388	388	1.0000000
C6	18423177	18423399	BolC6t36922H	0	+	202	222	222	1.0000000
C6	18454398	18456054	BolC6t36923H	0	-	849	1656	1656	1.0000000
C6	18460838	18461570	BolC6t36924H	0	+	778	732	732	1.0000000
C6	18489840	18491352	BolC6t36925H	0	-	5	64	1512	0.0423280
C6	18504448	18505101	BolC6t36926H	0	+	798	653	653	1.0000000
C6	18528545	18529422	BolC6t36927H	0	+	128	679	877	0.7742303
C6	18558003	18560149	BolC6t36928H	0	+	534	2109	2146	0.9827586
C6	18582299	18584089	BolC6t36929H	0	+	413	1553	1790	0.8675978
C6	18593536	18594088	BolC6t36930H	0	-	161	552	552	1.0000000
C6	18611272	18614479	BolC6t36931H	0	-	1562	2929	3207	0.9133146
C6	18620922	18621697	BolC6t36932H	0	-	259	710	775	0.9161291
C6	18634666	18651641	BolC6t36933H	0	-	1900	8108	16975	0.4776436
C6	18653703	18657275	BolC6t36934H	0	+	632	2340	3572	0.6550952
C6	18662682	18667966	BolC6t36935H	0	-	1329	4409	5284	0.8344058
C6	18675567	18682454	BolC6t36936H	0	+	1682	5717	6887	0.8301147
C6	18690908	18691530	BolC6t36937H	0	-	122	533	622	0.8569132
C6	18698841	18700664	BolC6t36938H	0	-	135	1259	1823	0.6906199
C6	18732543	18733700	BolC6t36939H	0	+	738	1157	1157	1.0000000
C6	18747287	18748215	BolC6t36940H	0	+	35	594	928	0.6400862
C6	18748762	18748948	BolC6t36941H	0	+	106	184	186	0.9892473
C6	18757525	18757855	BolC6t36942H	0	+	24	78	330	0.2363636
C6	18762462	18762675	BolC6t36943H	0	+	133	213	213	1.0000000
C6	18792893	18794442	BolC6t36944H	0	-	381	1081	1549	0.6978696
C6	18818023	18820010	BolC6t36945H	0	-	826	1885	1987	0.9486663
C6	18847617	18850057	BolC6t36946H	0	-	831	2010	2440	0.8237705
C6	18851212	18851495	BolC6t36947H	0	-	11	265	283	0.9363958
C6	18856773	18857435	BolC6t36948H	0	+	443	662	662	1.0000000
C6	18859950	18860523	BolC6t36949H	0	+	32	466	573	0.8132635
C6	18860394	18871655	BolC6t36950H	0	+	3302	10382	11261	0.9219430
C6	18862037	18862556	BolC6t36951H	0	+	201	519	519	1.0000000
C6	18863278	18870891	BolC6t36952H	0	+	2603	7184	7613	0.9436490
C6	18889526	18889730	BolC6t36953H	0	-	237	204	204	1.0000000
C6	18915864	18917275	BolC6t36954H	0	-	1154	1411	1411	1.0000000
C6	18921371	18927498	BolC6t36955H	0	+	2559	4504	6127	0.7351069
C6	18942223	18944358	BolC6t36956H	0	-	406	1727	2135	0.8088993
C6	18956308	18956464	BolC6t36957H	0	-	110	156	156	1.0000000
C6	18960263	18960842	BolC6t36958H	0	-	210	420	579	0.7253886
C6	18965377	18966224	BolC6t36959H	0	-	204	821	847	0.9693034
C6	18969816	18970303	BolC6t36960H	0	-	76	394	487	0.8090349
C6	18988180	18988471	BolC6t36961H	0	+	180	291	291	1.0000000
C6	19002040	19009629	BolC6t36962H	0	-	2677	6724	7589	0.8860192
C6	19022714	19024308	BolC6t36963H	0	-	201	1475	1594	0.9253451
C6	19029884	19030337	BolC6t36964H	0	-	56	453	453	1.0000000
C6	19038955	19050373	BolC6t36965H	0	-	6123	11234	11418	0.9838851
C6	19064485	19065685	BolC6t36966H	0	-	913	1200	1200	1.0000000
C6	19106450	19107064	BolC6t36967H	0	-	60	614	614	1.0000000
C6	19131501	19132116	BolC6t36968H	0	-	0	0	615	0.0000000
C6	19151103	19153843	BolC6t36969H	0	-	1689	2635	2740	0.9616788
C6	19164165	19168984	BolC6t36970H	0	-	1722	4485	4819	0.9306910
C6	19177116	19182624	BolC6t36971H	0	+	1162	4003	5508	0.7267611
C6	19183688	19185417	BolC6t36972H	0	-	671	1704	1729	0.9855407
C6	19187075	19190419	BolC6t36973H	0	-	2459	3344	3344	1.0000000
C6	19244444	19249214	BolC6t36974H	0	+	3200	4696	4770	0.9844864
C6	19249528	19249924	BolC6t36975H	0	+	557	396	396	1.0000000
C6	19252259	19252985	BolC6t36976H	0	-	545	726	726	1.0000000
C6	19257345	19259672	BolC6t36977H	0	+	1193	2179	2327	0.9363988
C6	19273013	19275512	BolC6t36978H	0	+	46	89	2499	0.0356142
C6	19280708	19282955	BolC6t36979H	0	+	466	1900	2247	0.8455719
C6	19289356	19289869	BolC6t36980H	0	+	451	513	513	1.0000000
C6	19308045	19310075	BolC6t36981H	0	-	1320	2030	2030	1.0000000
C6	19330570	19332742	BolC6t36982H	0	+	2	169	2172	0.0778085
C6	19334550	19336727	BolC6t36983H	0	+	10	395	2177	0.1814424
C6	19357176	19361055	BolC6t36984H	0	-	99	1012	3879	0.2608920
C6	19370108	19372534	BolC6t36985H	0	-	0	0	2426	0.0000000
C6	19383685	19384143	BolC6t36986H	0	+	0	0	458	0.0000000
C6	19384197	19384654	BolC6t36987H	0	-	48	331	457	0.7242888
C6	19409079	19410679	BolC6t36988H	0	-	14	50	1600	0.0312500
C6	19418044	19418838	BolC6t36989H	0	+	28	330	794	0.4156171
C6	19424703	19425984	BolC6t36990H	0	+	2	19	1281	0.0148322
C6	19477870	19478209	BolC6t36991H	0	+	0	0	339	0.0000000
C6	19492904	19493964	BolC6t36992H	0	-	520	1060	1060	1.0000000
C6	19496590	19496844	BolC6t36993H	0	+	264	254	254	1.0000000
C6	19518847	19519338	BolC6t36994H	0	+	534	491	491	1.0000000
C6	19519670	19520895	BolC6t36995H	0	+	896	1225	1225	1.0000000
C6	19533770	19535314	BolC6t36996H	0	-	426	1460	1544	0.9455959
C6	19579150	19579342	BolC6t36997H	0	-	62	192	192	1.0000000
C6	19594278	19594428	BolC6t36998H	0	-	145	150	150	1.0000000
C6	19599189	19620495	BolC6t36999H	0	+	2159	12287	21306	0.5766920
C6	19622431	19622593	BolC6t37000H	0	+	5	68	162	0.4197531
C6	19642533	19642788	BolC6t37001H	0	-	19	255	255	1.0000000
C6	19647915	19648167	BolC6t37002H	0	-	101	252	252	1.0000000
C6	19649223	19652267	BolC6t37003H	0	-	1539	2988	3044	0.9816031
C6	19653123	19654725	BolC6t37004H	0	-	2168	1602	1602	1.0000000
C6	19659057	19661271	BolC6t37005H	0	-	156	1816	2214	0.8202349
C6	19662869	19664856	BolC6t37006H	0	+	372	1556	1987	0.7830901
C6	19689258	19689664	BolC6t37007H	0	+	27	252	406	0.6206896
C6	19689852	19690140	BolC6t37008H	0	-	15	288	288	1.0000000
C6	19704390	19704703	BolC6t37009H	0	+	106	115	313	0.3674121
C6	19708277	19708783	BolC6t37010H	0	-	53	393	506	0.7766798
C6	19710401	19710653	BolC6t37011H	0	+	25	150	252	0.5952381
C6	19712135	19713930	BolC6t37012H	0	+	1086	1613	1795	0.8986073
C6	19715612	19717604	BolC6t37013H	0	-	86	716	1992	0.3594378
C6	19738839	19739868	BolC6t37014H	0	-	27	322	1029	0.3129252
C6	19739913	19740802	BolC6t37015H	0	-	121	701	889	0.7885264
C6	19747650	19749316	BolC6t37016H	0	+	870	1621	1666	0.9729892
C6	19749545	19751218	BolC6t37017H	0	-	751	1597	1673	0.9545726
C6	19767094	19767478	BolC6t37018H	0	-	0	0	384	0.0000000
C6	19770950	19771418	BolC6t37019H	0	+	63	405	468	0.8653846
C6	19777683	19778481	BolC6t37020H	0	-	18	480	798	0.6015037
C6	19807706	19808099	BolC6t37021H	0	+	84	230	393	0.5852417
C6	19830180	19830429	BolC6t37022H	0	-	243	249	249	1.0000000
C6	19832257	19834741	BolC6t37023H	0	+	432	2333	2484	0.9392110
C6	19842649	19843673	BolC6t37024H	0	+	425	998	1024	0.9746094
C6	19844841	19846650	BolC6t37025H	0	-	519	1498	1809	0.8280818
C6	19849435	19854517	BolC6t37026H	0	+	743	3993	5082	0.7857143
C6	19856781	19858648	BolC6t37027H	0	+	567	1700	1867	0.9105517
C6	19872226	19875076	BolC6t37028H	0	-	164	2405	2850	0.8438597
C6	19876212	19876488	BolC6t37029H	0	-	37	276	276	1.0000000
C6	19878335	19880566	BolC6t37030H	0	+	0	0	2231	0.0000000
C6	19896713	19899534	BolC6t37031H	0	+	724	2799	2821	0.9922013
C6	19905096	19912972	BolC6t37032H	0	-	1371	5613	7876	0.7126714
C6	19933002	19934885	BolC6t37033H	0	-	1144	1883	1883	1.0000000
C6	19935991	19942887	BolC6t37034H	0	+	222	2724	6896	0.3950116
C6	19964149	19964311	BolC6t37035H	0	-	2	130	162	0.8024691
C6	19975533	19976552	BolC6t37036H	0	-	343	1001	1019	0.9823356
C6	19978155	19978614	BolC6t37037H	0	+	108	454	459	0.9891068
C6	19998729	20003703	BolC6t37038H	0	+	2354	4806	4974	0.9662244
C6	20007306	20012234	BolC6t37039H	0	+	4293	4928	4928	1.0000000
C6	20015412	20015820	BolC6t37040H	0	+	0	0	408	0.0000000
C6	20032936	20035492	BolC6t37041H	0	+	1335	2528	2556	0.9890454
C6	20045281	20045890	BolC6t37042H	0	-	255	609	609	1.0000000
C6	20046196	20046370	BolC6t37043H	0	+	172	174	174	1.0000000
C6	20056922	20059146	BolC6t37044H	0	-	1480	2224	2224	1.0000000
C6	20063285	20064975	BolC6t37045H	0	-	798	1683	1690	0.9958580
C6	20074809	20075989	BolC6t37046H	0	-	693	1180	1180	1.0000000
C6	20079581	20080488	BolC6t37047H	0	+	596	831	907	0.9162073
C6	20088901	20089258	BolC6t37048H	0	+	263	357	357	1.0000000
C6	20093710	20096948	BolC6t37049H	0	-	271	1463	3238	0.4518221
C6	20098998	20101463	BolC6t37050H	0	-	29	669	2465	0.2713996
C6	20103611	20103713	BolC6t37051H	0	+	92	102	102	1.0000000
C6	20108954	20110943	BolC6t37052H	0	+	313	1870	1989	0.9401709
C6	20119858	20121481	BolC6t37053H	0	+	495	1524	1623	0.9390019
C6	20122028	20124193	BolC6t37054H	0	-	689	1934	2165	0.8933026
C6	20124491	20126016	BolC6t37055H	0	+	667	1525	1525	1.0000000
C6	20126669	20127914	BolC6t37056H	0	-	82	1096	1245	0.8803213
C6	20132319	20132686	BolC6t37057H	0	+	22	331	367	0.9019074
C6	20138066	20140013	BolC6t37058H	0	+	244	1703	1947	0.8746790
C6	20149587	20149890	BolC6t37059H	0	+	201	303	303	1.0000000
C6	20151919	20153308	BolC6t37060H	0	+	188	1002	1389	0.7213823
C6	20161436	20162539	BolC6t37061H	0	-	20	153	1103	0.1387126
C6	20175455	20176376	BolC6t37062H	0	+	47	590	921	0.6406080
C6	20207309	20208647	BolC6t37063H	0	+	688	1338	1338	1.0000000
C6	20212301	20213744	BolC6t37064H	0	-	97	616	1443	0.4268884
C6	20222201	20223002	BolC6t37065H	0	+	141	800	801	0.9987516
C6	20229550	20231629	BolC6t37066H	0	+	263	1613	2079	0.7758538
C6	20250033	20252634	BolC6t37067H	0	+	406	2240	2601	0.8612072
C6	20254532	20254715	BolC6t37068H	0	-	4	84	183	0.4590164
C6	20263170	20284849	BolC6t37069H	0	+	6091	15959	21679	0.7361502
C6	20285343	20285619	BolC6t37070H	0	-	520	276	276	1.0000000
C6	20301881	20304220	BolC6t37071H	0	-	1248	2226	2339	0.9516888
C6	20327668	20328866	BolC6t37072H	0	-	301	1196	1198	0.9983305
C6	20374188	20374986	BolC6t37073H	0	+	662	798	798	1.0000000
C6	20405809	20406061	BolC6t37074H	0	+	111	252	252	1.0000000
C6	20440430	20442116	BolC6t37075H	0	+	590	1686	1686	1.0000000
C6	20454982	20455564	BolC6t37076H	0	+	79	469	582	0.8058419
C6	20455860	20457993	BolC6t37077H	0	-	141	789	2133	0.3699015
C6	20495136	20495998	BolC6t37078H	0	+	44	496	862	0.5754060
C6	20506321	20507712	BolC6t37079H	0	+	827	1391	1391	1.0000000
C6	20518577	20519789	BolC6t37080H	0	-	200	1142	1212	0.9422442
C6	20538466	20538607	BolC6t37081H	0	-	93	141	141	1.0000000
C6	20561529	20563641	BolC6t37082H	0	+	624	1434	2112	0.6789773
C6	20619509	20620459	BolC6t37083H	0	+	878	950	950	1.0000000
C6	20626020	20628246	BolC6t37084H	0	-	479	1701	2226	0.7641509
C6	20646276	20647507	BolC6t37085H	0	-	982	1231	1231	1.0000000
C6	20664276	20664537	BolC6t37086H	0	-	23	247	261	0.9463602
C6	20672923	20673887	BolC6t37087H	0	-	376	964	964	1.0000000
C6	20689950	20695236	BolC6t37088H	0	+	3126	5109	5286	0.9665153
C6	20700188	20702222	BolC6t37089H	0	+	298	620	2034	0.3048181
C6	20709981	20711815	BolC6t37090H	0	+	358	1793	1834	0.9776445
C6	20712562	20714114	BolC6t37091H	0	+	318	1428	1552	0.9201031
C6	20720747	20721537	BolC6t37092H	0	+	1077	790	790	1.0000000
C6	20725863	20726069	BolC6t37093H	0	+	5	107	206	0.5194175
C6	20726139	20727335	BolC6t37094H	0	+	14	495	1196	0.4138796
C6	20732532	20732667	BolC6t37095H	0	-	2	96	135	0.7111111
C6	20752752	20753244	BolC6t37096H	0	+	424	492	492	1.0000000
C6	20774560	20794107	BolC6t37097H	0	-	5985	12544	19547	0.6417353
C6	20794495	20796087	BolC6t37098H	0	-	161	1386	1592	0.8706030
C6	20797350	20798418	BolC6t37099H	0	+	266	1068	1068	1.0000000
C6	20799302	20800005	BolC6t37100H	0	-	177	490	703	0.6970128
C6	20802711	20805396	BolC6t37101H	0	-	398	2351	2685	0.8756052
C6	20810958	20811111	BolC6t37102H	0	+	184	153	153	1.0000000
C6	20820886	20824331	BolC6t37103H	0	+	416	2635	3445	0.7648766
C6	20846386	20848150	BolC6t37104H	0	+	403	1375	1764	0.7794784
C6	20848477	20849692	BolC6t37105H	0	-	555	861	1215	0.7086419
C6	20855571	20865623	BolC6t37106H	0	-	6210	9443	10052	0.9394150
C6	20923019	20924386	BolC6t37107H	0	-	852	1367	1367	1.0000000
C6	20926427	20936429	BolC6t37108H	0	+	1775	7584	10002	0.7582483
C6	20938325	20939383	BolC6t37109H	0	+	421	1058	1058	1.0000000
C6	20959988	20961373	BolC6t37110H	0	-	24	621	1385	0.4483755
C6	20962128	20962767	BolC6t37111H	0	-	55	486	639	0.7605634
C6	20980698	20982174	BolC6t37112H	0	-	460	1476	1476	1.0000000
C6	20984017	20987809	BolC6t37113H	0	+	490	2584	3792	0.6814346
C6	20994674	20996820	BolC6t37114H	0	+	294	1981	2146	0.9231128
C6	21004882	21005687	BolC6t37115H	0	+	305	595	805	0.7391304
C6	21008569	21011329	BolC6t37116H	0	+	35	517	2760	0.1873188
C6	21036978	21037680	BolC6t37117H	0	-	46	542	702	0.7720798
C6	21039004	21040879	BolC6t37118H	0	-	604	1843	1875	0.9829333
C6	21043210	21043477	BolC6t37119H	0	+	211	267	267	1.0000000
C6	21075827	21076587	BolC6t37120H	0	+	290	713	760	0.9381579
C6	21081255	21081627	BolC6t37121H	0	+	2	158	372	0.4247312
C6	21083173	21084076	BolC6t37122H	0	+	251	756	903	0.8372093
C6	21125868	21132146	BolC6t37123H	0	+	1003	3245	6278	0.5168844
C6	21132313	21132657	BolC6t37124H	0	-	84	344	344	1.0000000
C6	21133945	21135151	BolC6t37125H	0	+	596	1172	1206	0.9718076
C6	21143308	21144671	BolC6t37126H	0	-	159	1089	1363	0.7989728
C6	21147456	21148263	BolC6t37127H	0	+	3	175	807	0.2168525
C6	21149659	21151424	BolC6t37128H	0	+	72	813	1765	0.4606232
C6	21165062	21167372	BolC6t37129H	0	-	323	1781	2310	0.7709957
C6	21168477	21169126	BolC6t37130H	0	+	339	649	649	1.0000000
C6	21169825	21173694	BolC6t37131H	0	-	1523	3722	3869	0.9620057
C6	21210963	21213961	BolC6t37132H	0	+	1401	2488	2998	0.8298866
C6	21218430	21219618	BolC6t37133H	0	-	178	994	1188	0.8367003
C6	21229514	21229742	BolC6t37134H	0	+	266	228	228	1.0000000
C6	21233991	21234324	BolC6t37135H	0	+	182	333	333	1.0000000
C6	21243721	21247470	BolC6t37136H	0	+	1688	3568	3749	0.9517205
C6	21248545	21249330	BolC6t37137H	0	-	526	785	785	1.0000000
C6	21250244	21251247	BolC6t37138H	0	-	819	1003	1003	1.0000000
C6	21255443	21256998	BolC6t37139H	0	-	1013	1555	1555	1.0000000
C6	21262440	21262715	BolC6t37140H	0	-	58	268	275	0.9745455
C6	21273432	21276520	BolC6t37141H	0	-	299	2197	3088	0.7114637
C6	21314071	21315472	BolC6t37142H	0	+	308	1040	1401	0.7423269
C6	21332027	21332243	BolC6t37143H	0	+	23	216	216	1.0000000
C6	21339316	21340924	BolC6t37144H	0	+	413	1404	1608	0.8731343
C6	21341742	21353234	BolC6t37145H	0	-	1911	7552	11492	0.6571528
C6	21353332	21354973	BolC6t37146H	0	+	892	1641	1641	1.0000000
C6	21355208	21355958	BolC6t37147H	0	-	153	669	750	0.8920000
C6	21362171	21363708	BolC6t37148H	0	+	226	1142	1537	0.7430059
C6	21364062	21364698	BolC6t37149H	0	-	69	636	636	1.0000000
C6	21365819	21369908	BolC6t37150H	0	+	997	2436	4089	0.5957447
C6	21378858	21381151	BolC6t37151H	0	+	624	2208	2293	0.9629307
C6	21384180	21384919	BolC6t37152H	0	+	418	739	739	1.0000000
C6	21396051	21399053	BolC6t37153H	0	+	1695	2955	3002	0.9843438
C6	21399864	21403011	BolC6t37154H	0	-	253	2135	3147	0.6784239
C6	21404476	21404982	BolC6t37155H	0	+	210	300	506	0.5928854
C6	21415072	21418076	BolC6t37156H	0	+	457	2197	3004	0.7313582
C6	21419591	21420650	BolC6t37157H	0	-	38	912	1059	0.8611898
C6	21420703	21421571	BolC6t37158H	0	-	119	868	868	1.0000000
C6	21422004	21423421	BolC6t37159H	0	-	584	1417	1417	1.0000000
C6	21424307	21425999	BolC6t37160H	0	-	32	551	1692	0.3256501
C6	21431659	21432530	BolC6t37161H	0	-	402	871	871	1.0000000
C6	21444876	21467372	BolC6t37162H	0	+	937	5963	22496	0.2650693
C6	21467471	21468665	BolC6t37163H	0	+	522	1194	1194	1.0000000
C6	21468668	21470439	BolC6t37164H	0	+	911	1771	1771	1.0000000
C6	21481611	21484385	BolC6t37165H	0	-	777	2556	2774	0.9214131
C6	21497378	21497639	BolC6t37166H	0	-	233	261	261	1.0000000
C6	21518733	21521404	BolC6t37167H	0	-	1396	2671	2671	1.0000000
C6	21521928	21522713	BolC6t37168H	0	-	237	784	785	0.9987261
C6	21527144	21528514	BolC6t37169H	0	-	0	0	1370	0.0000000
C6	21538999	21540011	BolC6t37170H	0	+	235	899	1012	0.8883399
C6	21542445	21544343	BolC6t37171H	0	+	640	1898	1898	1.0000000
C6	21565457	21566993	BolC6t37172H	0	-	81	324	1536	0.2109375
C6	21570378	21571089	BolC6t37173H	0	-	522	711	711	1.0000000
C6	21573194	21573823	BolC6t37174H	0	-	0	0	629	0.0000000
C6	21593101	21593933	BolC6t37175H	0	+	0	0	832	0.0000000
C6	21600473	21603800	BolC6t37176H	0	+	1909	3326	3327	0.9996994
C6	21603986	21605318	BolC6t37177H	0	+	2087	1332	1332	1.0000000
C6	21639567	21641967	BolC6t37178H	0	-	1065	2271	2400	0.9462500
C6	21654427	21655853	BolC6t37179H	0	+	20	659	1426	0.4621318
C6	21677533	21677933	BolC6t37180H	0	+	359	400	400	1.0000000
C6	21681774	21682906	BolC6t37181H	0	-	597	1132	1132	1.0000000
C6	21699234	21706794	BolC6t37182H	0	-	3344	6997	7560	0.9255291
C6	21718094	21718807	BolC6t37183H	0	+	176	400	713	0.5610098
C6	21719315	21719642	BolC6t37184H	0	+	371	327	327	1.0000000
C6	21726001	21731489	BolC6t37185H	0	-	1684	4377	5488	0.7975583
C6	21732807	21736290	BolC6t37186H	0	-	682	2466	3483	0.7080103
C6	21744717	21744915	BolC6t37187H	0	+	77	198	198	1.0000000
C6	21753138	21753969	BolC6t37188H	0	-	827	831	831	1.0000000
C6	21768291	21768723	BolC6t37189H	0	-	329	432	432	1.0000000
C6	21828085	21828373	BolC6t37190H	0	-	0	0	288	0.0000000
C6	21864980	21865415	BolC6t37191H	0	-	263	435	435	1.0000000
C6	21873110	21874579	BolC6t37192H	0	+	544	1413	1469	0.9618788
C6	21888393	21889768	BolC6t37193H	0	-	932	1375	1375	1.0000000
C6	21912762	21921175	BolC6t37194H	0	+	3123	7161	8413	0.8511827
C6	21921226	21923974	BolC6t37195H	0	+	1860	2748	2748	1.0000000
C6	21927224	21931436	BolC6t37196H	0	-	748	4096	4212	0.9724596
C6	21932521	21934492	BolC6t37197H	0	+	1771	1943	1971	0.9857940
C6	21959312	21959615	BolC6t37198H	0	+	204	303	303	1.0000000
C6	21962946	21964525	BolC6t37199H	0	-	775	1579	1579	1.0000000
C6	21964578	21967711	BolC6t37200H	0	+	1307	2840	3133	0.9064794
C6	21970485	21972170	BolC6t37201H	0	+	174	1297	1685	0.7697330
C6	21999357	21999938	BolC6t37202H	0	+	0	0	581	0.0000000
C6	22004055	22008419	BolC6t37203H	0	+	709	3178	4364	0.7282310
C6	22016097	22018512	BolC6t37204H	0	+	964	2009	2415	0.8318841
C6	22030036	22031483	BolC6t37205H	0	+	536	1051	1447	0.7263303
C6	22046018	22046949	BolC6t37206H	0	-	75	864	931	0.9280344
C6	22072001	22073129	BolC6t37207H	0	-	680	1128	1128	1.0000000
C6	22073650	22074250	BolC6t37208H	0	+	145	600	600	1.0000000
C6	22074485	22076270	BolC6t37209H	0	-	845	1785	1785	1.0000000
C6	22076667	22076877	BolC6t37210H	0	+	275	210	210	1.0000000
C6	22080478	22084924	BolC6t37211H	0	-	2026	4175	4446	0.9390463
C6	22094078	22097413	BolC6t37212H	0	+	1427	3312	3335	0.9931034
C6	22125478	22128247	BolC6t37213H	0	+	882	2283	2769	0.8244854
C6	22133919	22134041	BolC6t37214H	0	+	197	122	122	1.0000000
C6	22134265	22141160	BolC6t37215H	0	+	1064	5116	6895	0.7419869
C6	22141674	22142765	BolC6t37216H	0	+	434	1091	1091	1.0000000
C6	22144987	22146701	BolC6t37217H	0	+	1258	1714	1714	1.0000000
C6	22151359	22153419	BolC6t37218H	0	-	498	1628	2060	0.7902912
C6	22156307	22157551	BolC6t37219H	0	+	902	1239	1244	0.9959807
C6	22159657	22162115	BolC6t37220H	0	+	751	2227	2458	0.9060212
C6	22165517	22165673	BolC6t37221H	0	+	66	156	156	1.0000000
C6	22165888	22169239	BolC6t37222H	0	+	491	3289	3351	0.9814981
C6	22166789	22167072	BolC6t37223H	0	-	50	283	283	1.0000000
C6	22190550	22192478	BolC6t37224H	0	-	60	1019	1928	0.5285270
C6	22192908	22193272	BolC6t37225H	0	-	256	364	364	1.0000000
C6	22195532	22197141	BolC6t37226H	0	-	595	1554	1609	0.9658173
C6	22203439	22204201	BolC6t37227H	0	-	263	762	762	1.0000000
C6	22208619	22209864	BolC6t37228H	0	+	370	1174	1245	0.9429719
C6	22211352	22216060	BolC6t37229H	0	-	1578	4464	4708	0.9481733
C6	22222984	22223662	BolC6t37230H	0	+	191	678	678	1.0000000
C6	22224098	22224587	BolC6t37231H	0	+	89	489	489	1.0000000
C6	22228708	22231759	BolC6t37232H	0	-	395	2737	3051	0.8970829
C6	22233931	22235704	BolC6t37233H	0	-	500	1668	1773	0.9407783
C6	22236743	22237016	BolC6t37234H	0	-	90	273	273	1.0000000
C6	22239138	22239600	BolC6t37235H	0	-	26	247	462	0.5346320
C6	22245729	22245909	BolC6t37236H	0	+	71	180	180	1.0000000
C6	22248030	22249833	BolC6t37237H	0	-	1346	1803	1803	1.0000000
C6	22259037	22260807	BolC6t37238H	0	-	576	1752	1770	0.9898305
C6	22272165	22273688	BolC6t37239H	0	+	1754	1523	1523	1.0000000
C6	22277685	22281829	BolC6t37240H	0	+	838	3294	4144	0.7948841
C6	22283402	22283642	BolC6t37241H	0	+	2	46	240	0.1916667
C6	22289723	22290232	BolC6t37242H	0	-	36	406	509	0.7976424
C6	22325632	22326258	BolC6t37243H	0	+	6	176	626	0.2811502
C6	22337155	22338065	BolC6t37244H	0	+	225	878	910	0.9648352
C6	22355736	22356137	BolC6t37245H	0	-	32	231	401	0.5760599
C6	22362819	22364433	BolC6t37246H	0	-	333	1424	1614	0.8822801
C6	22365969	22367039	BolC6t37247H	0	-	77	964	1070	0.9009346
C6	22367336	22367990	BolC6t37248H	0	-	113	556	654	0.8501529
C6	22373890	22386746	BolC6t37249H	0	+	2651	10712	12856	0.8332296
C6	22388957	22389167	BolC6t37250H	0	-	50	168	210	0.8000000
C6	22391485	22392334	BolC6t37251H	0	-	265	638	849	0.7514723
C6	22401722	22402295	BolC6t37252H	0	+	181	572	573	0.9982548
C6	22404398	22407732	BolC6t37253H	0	-	3322	3178	3334	0.9532093
C6	22417008	22417305	BolC6t37254H	0	-	205	297	297	1.0000000
C6	22424332	22428196	BolC6t37255H	0	+	1144	3505	3864	0.9070911
C6	22428420	22428779	BolC6t37256H	0	-	586	359	359	1.0000000
C6	22431388	22434304	BolC6t37257H	0	-	327	1999	2916	0.6855281
C6	22458313	22460857	BolC6t37258H	0	-	818	2536	2544	0.9968553
C6	22475217	22477990	BolC6t37259H	0	+	919	2737	2773	0.9870177
C6	22478392	22479135	BolC6t37260H	0	+	223	618	743	0.8317631
C6	22479418	22481796	BolC6t37261H	0	-	1884	2378	2378	1.0000000
C6	22486522	22488752	BolC6t37262H	0	-	542	2113	2230	0.9475336
C6	22508247	22509493	BolC6t37263H	0	-	1434	1246	1246	1.0000000
C6	22523574	22524366	BolC6t37264H	0	-	272	792	792	1.0000000
C6	22524871	22526233	BolC6t37265H	0	+	364	1362	1362	1.0000000
C6	22537034	22538172	BolC6t37266H	0	-	161	1021	1138	0.8971881
C6	22543293	22545381	BolC6t37267H	0	+	549	2013	2088	0.9640805
C6	22548453	22549167	BolC6t37268H	0	+	1100	714	714	1.0000000
C6	22551736	22553145	BolC6t37269H	0	-	359	1409	1409	1.0000000
C6	22553376	22553872	BolC6t37270H	0	-	373	496	496	1.0000000
C6	22554587	22555382	BolC6t37271H	0	-	495	795	795	1.0000000
C6	22555883	22556573	BolC6t37272H	0	+	46	492	690	0.7130435
C6	22568259	22570949	BolC6t37273H	0	-	2062	2690	2690	1.0000000
C6	22571275	22573920	BolC6t37274H	0	+	965	2202	2645	0.8325142
C6	22592142	22592319	BolC6t37275H	0	-	50	177	177	1.0000000
C6	22596149	22598248	BolC6t37276H	0	-	863	2099	2099	1.0000000
C6	22601969	22603261	BolC6t37277H	0	+	340	1292	1292	1.0000000
C6	22606603	22615885	BolC6t37278H	0	+	3506	9194	9282	0.9905193
C6	22620300	22623887	BolC6t37279H	0	+	911	3490	3587	0.9729579
C6	22624803	22625550	BolC6t37280H	0	-	469	747	747	1.0000000
C6	22631819	22634118	BolC6t37281H	0	+	693	2271	2299	0.9878208
C6	22634754	22636612	BolC6t37282H	0	-	1183	1752	1858	0.9429494
C6	22649233	22649587	BolC6t37283H	0	-	233	354	354	1.0000000
C6	22658952	22660374	BolC6t37284H	0	+	698	1422	1422	1.0000000
C6	22677738	22680468	BolC6t37285H	0	+	889	2666	2730	0.9765568
C6	22681436	22685402	BolC6t37286H	0	+	868	3451	3966	0.8701462
C6	22686886	22690473	BolC6t37287H	0	+	432	2516	3587	0.7014218
C6	22693288	22694298	BolC6t37288H	0	-	170	984	1010	0.9742574
C6	22718594	22719815	BolC6t37289H	0	+	161	485	1221	0.3972154
C6	22720502	22721070	BolC6t37290H	0	+	343	568	568	1.0000000
C6	22722839	22726808	BolC6t37291H	0	+	1157	3923	3969	0.9884102
C6	22759273	22762587	BolC6t37292H	0	+	612	2636	3314	0.7954134
C6	22769690	22770176	BolC6t37293H	0	+	119	304	486	0.6255144
C6	22773737	22776587	BolC6t37294H	0	-	708	2413	2850	0.8466667
C6	22809577	22811194	BolC6t37295H	0	-	689	1589	1617	0.9826840
C6	22812469	22812883	BolC6t37296H	0	+	0	0	414	0.0000000
C6	22817316	22817749	BolC6t37297H	0	+	0	0	433	0.0000000
C6	22818023	22818411	BolC6t37298H	0	+	0	0	388	0.0000000
C6	22820653	22823802	BolC6t37299H	0	-	1768	3149	3149	1.0000000
C6	22824171	22826342	BolC6t37300H	0	-	1678	2171	2171	1.0000000
C6	22832236	22834423	BolC6t37301H	0	+	328	1412	2187	0.6456333
C6	22864659	22865884	BolC6t37302H	0	-	615	1225	1225	1.0000000
C6	22872077	22873137	BolC6t37303H	0	+	998	1060	1060	1.0000000
C6	22874673	22875287	BolC6t37304H	0	+	268	614	614	1.0000000
C6	22881028	22882278	BolC6t37305H	0	-	792	1243	1250	0.9944000
C6	22891184	22891442	BolC6t37306H	0	+	5	92	258	0.3565891
C6	22893282	22894162	BolC6t37307H	0	-	1049	880	880	1.0000000
C6	22894833	22894971	BolC6t37308H	0	-	0	0	138	0.0000000
C6	22916167	22916668	BolC6t37309H	0	-	96	417	501	0.8323354
C6	22919553	22920494	BolC6t37310H	0	+	2	25	941	0.0265675
C6	22921722	22921953	BolC6t37311H	0	+	183	231	231	1.0000000
C6	22923106	22925489	BolC6t37312H	0	-	280	2084	2383	0.8745279
C6	22936355	22937856	BolC6t37313H	0	-	554	1490	1501	0.9926715
C6	22946124	22947208	BolC6t37314H	0	-	917	1084	1084	1.0000000
C6	22953495	22954468	BolC6t37315H	0	+	33	489	973	0.5025694
C6	22961080	22962915	BolC6t37316H	0	+	1521	1835	1835	1.0000000
C6	22964622	22965433	BolC6t37317H	0	+	1313	811	811	1.0000000
C6	22980799	22981145	BolC6t37318H	0	+	46	346	346	1.0000000
C6	22981429	22981818	BolC6t37319H	0	+	68	389	389	1.0000000
C6	22993607	22993782	BolC6t37320H	0	+	173	175	175	1.0000000
C6	22993979	22994093	BolC6t37321H	0	+	78	114	114	1.0000000
C6	22995690	22996526	BolC6t37322H	0	+	479	809	836	0.9677033
C6	22998485	22999175	BolC6t37323H	0	-	80	652	690	0.9449275
C6	23004335	23006846	BolC6t37324H	0	+	528	2269	2511	0.9036241
C6	23012229	23013579	BolC6t37325H	0	-	1078	1350	1350	1.0000000
C6	23039006	23040542	BolC6t37326H	0	+	1666	1536	1536	1.0000000
C6	23047474	23053626	BolC6t37327H	0	+	1158	5094	6152	0.8280234
C6	23057724	23058935	BolC6t37328H	0	+	619	1114	1211	0.9199009
C6	23059491	23061794	BolC6t37329H	0	-	1077	2303	2303	1.0000000
C6	23064354	23065098	BolC6t37330H	0	+	100	628	744	0.8440861
C6	23066393	23066928	BolC6t37331H	0	+	29	463	535	0.8654206
C6	23067831	23070120	BolC6t37332H	0	+	852	1734	2289	0.7575361
C6	23070368	23074400	BolC6t37333H	0	-	826	3501	4032	0.8683036
C6	23075854	23076427	BolC6t37334H	0	-	332	573	573	1.0000000
C6	23079136	23080270	BolC6t37335H	0	-	578	1134	1134	1.0000000
C6	23091061	23092485	BolC6t37336H	0	+	78	1070	1424	0.7514045
C6	23094245	23095824	BolC6t37337H	0	+	24	854	1579	0.5408486
C6	23096245	23097095	BolC6t37338H	0	+	103	843	850	0.9917647
C6	23098295	23098640	BolC6t37339H	0	-	73	345	345	1.0000000
C6	23101787	23102271	BolC6t37340H	0	-	54	452	484	0.9338843
C6	23110709	23114776	BolC6t37341H	0	-	1549	4059	4067	0.9980329
C6	23115322	23117486	BolC6t37342H	0	+	440	1673	2164	0.7731054
C6	23120048	23122834	BolC6t37343H	0	+	5	267	2786	0.0958363
C6	23131338	23131632	BolC6t37344H	0	-	271	294	294	1.0000000
C6	23137789	23138296	BolC6t37345H	0	+	1	11	507	0.0216963
C6	23138525	23140974	BolC6t37346H	0	-	1055	2297	2449	0.9379339
C6	23144874	23145246	BolC6t37347H	0	+	342	372	372	1.0000000
C6	23146385	23152113	BolC6t37348H	0	+	598	3186	5728	0.5562151
C6	23163999	23165156	BolC6t37349H	0	+	503	810	1157	0.7000864
C6	23165643	23170928	BolC6t37350H	0	-	1656	4853	5285	0.9182592
C6	23193945	23194849	BolC6t37351H	0	-	554	904	904	1.0000000
C6	23195652	23196213	BolC6t37352H	0	+	233	561	561	1.0000000
C6	23196376	23197262	BolC6t37353H	0	+	295	886	886	1.0000000
C6	23198515	23199136	BolC6t37354H	0	-	163	621	621	1.0000000
C6	23202986	23203295	BolC6t37355H	0	-	210	309	309	1.0000000
C6	23204560	23206742	BolC6t37356H	0	-	1230	2163	2182	0.9912924
C6	23234210	23236484	BolC6t37357H	0	+	985	2274	2274	1.0000000
C6	23236816	23237107	BolC6t37358H	0	+	248	291	291	1.0000000
C6	23238990	23240613	BolC6t37359H	0	+	334	1262	1623	0.7775724
C6	23242587	23243526	BolC6t37360H	0	-	206	921	939	0.9808307
C6	23252093	23252258	BolC6t37361H	0	+	190	165	165	1.0000000
C6	23261105	23261524	BolC6t37362H	0	+	268	419	419	1.0000000
C6	23269229	23271892	BolC6t37363H	0	-	185	1901	2663	0.7138566
C6	23289044	23290606	BolC6t37364H	0	+	564	1554	1562	0.9948784
C6	23299644	23301002	BolC6t37365H	0	-	1093	1358	1358	1.0000000
C6	23303699	23304865	BolC6t37366H	0	-	399	728	1166	0.6243567
C6	23327698	23327818	BolC6t37367H	0	-	219	120	120	1.0000000
C6	23340431	23341728	BolC6t37368H	0	+	1283	1297	1297	1.0000000
C6	23354894	23358740	BolC6t37369H	0	+	3227	3844	3846	0.9994799
C6	23367065	23368007	BolC6t37370H	0	+	647	942	942	1.0000000
C6	23370356	23371330	BolC6t37371H	0	-	647	974	974	1.0000000
C6	23388732	23388834	BolC6t37372H	0	-	130	102	102	1.0000000
C6	23391016	23392021	BolC6t37373H	0	+	604	1005	1005	1.0000000
C6	23397939	23398319	BolC6t37374H	0	+	346	380	380	1.0000000
C6	23398495	23398852	BolC6t37375H	0	-	184	357	357	1.0000000
C6	23404535	23405267	BolC6t37376H	0	+	214	732	732	1.0000000
C6	23412617	23413916	BolC6t37377H	0	+	60	730	1299	0.5619708
C6	23421774	23423751	BolC6t37378H	0	+	772	1977	1977	1.0000000
C6	23423975	23424855	BolC6t37379H	0	-	134	701	880	0.7965909
C6	23428651	23440420	BolC6t37380H	0	+	1837	5700	11769	0.4843232
C6	23462504	23475192	BolC6t37381H	0	+	4956	11360	12688	0.8953342
C6	23490889	23491105	BolC6t37382H	0	-	0	0	216	0.0000000
C6	23491516	23491693	BolC6t37383H	0	+	0	0	177	0.0000000
C6	23506350	23506566	BolC6t37384H	0	-	0	0	216	0.0000000
C6	23506979	23507819	BolC6t37385H	0	+	2	163	840	0.1940476
C6	23521847	23522063	BolC6t37386H	0	-	0	0	216	0.0000000
C6	23522476	23522653	BolC6t37387H	0	+	0	0	177	0.0000000
C6	23533029	23535666	BolC6t37388H	0	+	2570	2637	2637	1.0000000
C6	23548478	23549964	BolC6t37389H	0	+	488	1486	1486	1.0000000
C6	23559423	23560130	BolC6t37390H	0	-	374	707	707	1.0000000
C6	23563507	23564175	BolC6t37391H	0	-	0	0	668	0.0000000
C6	23565853	23567529	BolC6t37392H	0	-	776	1653	1676	0.9862769
C6	23581357	23585990	BolC6t37393H	0	+	1219	3716	4633	0.8020721
C6	23588207	23588663	BolC6t37394H	0	+	318	456	456	1.0000000
C6	23592018	23592734	BolC6t37395H	0	+	0	0	716	0.0000000
C6	23593457	23594525	BolC6t37396H	0	+	0	0	1068	0.0000000
C6	23595014	23595919	BolC6t37397H	0	+	202	320	905	0.3535912
C6	23596413	23599787	BolC6t37398H	0	-	877	2659	3374	0.7880853
C6	23613823	23615713	BolC6t37399H	0	-	1320	1890	1890	1.0000000
C6	23616948	23619283	BolC6t37400H	0	-	1225	2335	2335	1.0000000
C6	23623742	23623934	BolC6t37401H	0	-	21	131	192	0.6822917
C6	23635346	23636687	BolC6t37402H	0	-	2286	1341	1341	1.0000000
C6	23669204	23669609	BolC6t37403H	0	+	268	405	405	1.0000000
C6	23669970	23671993	BolC6t37404H	0	-	957	2023	2023	1.0000000
C6	23673200	23676310	BolC6t37405H	0	-	2193	3110	3110	1.0000000
C6	23693469	23693997	BolC6t37406H	0	+	303	528	528	1.0000000
C6	23714206	23715256	BolC6t37407H	0	+	497	1050	1050	1.0000000
C6	23721782	23721965	BolC6t37408H	0	-	92	183	183	1.0000000
C6	23731492	23731729	BolC6t37409H	0	+	6	84	237	0.3544304
C6	23754046	23756833	BolC6t37410H	0	+	600	2186	2787	0.7843559
C6	23765390	23766665	BolC6t37411H	0	-	1054	1056	1275	0.8282353
C6	23767194	23768919	BolC6t37412H	0	-	1065	1725	1725	1.0000000
C6	23770659	23771121	BolC6t37413H	0	-	2	113	462	0.2445887
C6	23774403	23774976	BolC6t37414H	0	+	64	396	573	0.6910995
C6	23776606	23778015	BolC6t37415H	0	+	113	1087	1409	0.7714691
C6	23798605	23799500	BolC6t37416H	0	+	165	895	895	1.0000000
C6	23802490	23802724	BolC6t37417H	0	-	106	234	234	1.0000000
C6	23811236	23812608	BolC6t37418H	0	-	338	1286	1372	0.9373178
C6	23813828	23817318	BolC6t37419H	0	+	317	2720	3490	0.7793697
C6	23844944	23846033	BolC6t37420H	0	+	307	1005	1089	0.9228650
C6	23885160	23885659	BolC6t37421H	0	+	621	499	499	1.0000000
C6	23891459	23901995	BolC6t37422H	0	+	4710	9561	10536	0.9074602
C6	23914361	23917355	BolC6t37423H	0	+	1401	2844	2994	0.9498998
C6	23926154	23927211	BolC6t37424H	0	+	492	1057	1057	1.0000000
C6	23935859	23936811	BolC6t37425H	0	-	18	724	952	0.7605042
C6	23942928	23944262	BolC6t37426H	0	-	78	921	1334	0.6904048
C6	23945474	23946020	BolC6t37427H	0	-	220	546	546	1.0000000
C6	23947824	23951678	BolC6t37428H	0	+	1945	3681	3854	0.9551116
C6	23954875	23956419	BolC6t37429H	0	-	238	1301	1544	0.8426166
C6	23969967	23970650	BolC6t37430H	0	+	296	683	683	1.0000000
C6	23970704	23971000	BolC6t37431H	0	+	63	273	296	0.9222973
C6	24000449	24005596	BolC6t37432H	0	+	1003	3525	5147	0.6848650
C6	24029037	24030833	BolC6t37433H	0	-	586	1425	1796	0.7934299
C6	24033212	24034068	BolC6t37434H	0	+	1753	856	856	1.0000000
C6	24051455	24053933	BolC6t37435H	0	-	1512	2436	2478	0.9830508
C6	24055249	24055594	BolC6t37436H	0	-	11	334	345	0.9681159
C6	24071767	24071992	BolC6t37437H	0	+	0	0	225	0.0000000
C6	24107154	24108168	BolC6t37438H	0	+	412	1014	1014	1.0000000
C6	24108921	24110028	BolC6t37439H	0	-	371	786	1107	0.7100271
C6	24111091	24111532	BolC6t37440H	0	-	277	362	441	0.8208617
C6	24112308	24112950	BolC6t37441H	0	-	72	571	642	0.8894081
C6	24114093	24115086	BolC6t37442H	0	-	1221	993	993	1.0000000
C6	24118788	24121072	BolC6t37443H	0	+	575	2279	2284	0.9978108
C6	24121824	24122554	BolC6t37444H	0	+	198	719	730	0.9849315
C6	24131260	24133201	BolC6t37445H	0	+	1319	1938	1941	0.9984544
C6	24134511	24136207	BolC6t37446H	0	+	640	1524	1696	0.8985849
C6	24156478	24156664	BolC6t37447H	0	+	108	176	186	0.9462366
C6	24164176	24164428	BolC6t37448H	0	-	0	0	252	0.0000000
C6	24173500	24174612	BolC6t37449H	0	+	602	1025	1112	0.9217626
C6	24175208	24178068	BolC6t37450H	0	-	966	2618	2860	0.9153846
C6	24201228	24202630	BolC6t37451H	0	+	548	1086	1402	0.7746077
C6	24206732	24208788	BolC6t37452H	0	-	109	812	2056	0.3949416
C6	24236456	24237988	BolC6t37453H	0	-	32	508	1532	0.3315927
C6	24238347	24238713	BolC6t37454H	0	-	1	74	366	0.2021858
C6	24257250	24257783	BolC6t37455H	0	+	4	206	533	0.3864916
C6	24259133	24259241	BolC6t37456H	0	-	290	108	108	1.0000000
C6	24259523	24259643	BolC6t37457H	0	-	197	120	120	1.0000000
C6	24259748	24260614	BolC6t37458H	0	-	387	685	866	0.7909931
C6	24266925	24267527	BolC6t37459H	0	+	38	553	602	0.9186047
C6	24270639	24271845	BolC6t37460H	0	-	2	20	1206	0.0165837
C6	24285045	24285972	BolC6t37461H	0	+	255	927	927	1.0000000
C6	24289591	24293154	BolC6t37462H	0	+	395	2573	3563	0.7221442
C6	24296484	24297756	BolC6t37463H	0	+	0	0	1272	0.0000000
C6	24298362	24298815	BolC6t37464H	0	-	2	108	453	0.2384106
C6	24325077	24325249	BolC6t37465H	0	-	0	0	172	0.0000000
C6	24327076	24327244	BolC6t37466H	0	-	24	164	168	0.9761904
C6	24327303	24327475	BolC6t37467H	0	-	13	123	172	0.7151163
C6	24327679	24327895	BolC6t37468H	0	-	8	103	216	0.4768519
C6	24337161	24345893	BolC6t37469H	0	-	3032	8295	8732	0.9499542
C6	24349944	24350112	BolC6t37470H	0	+	56	139	168	0.8273810
C6	24351609	24351750	BolC6t37471H	0	+	169	141	141	1.0000000
C6	24352838	24361253	BolC6t37472H	0	+	1402	6942	8415	0.8249555
C6	24394322	24396374	BolC6t37473H	0	-	77	1109	2052	0.5404484
C6	24399039	24399936	BolC6t37474H	0	-	2	40	897	0.0445931
C6	24401939	24402215	BolC6t37475H	0	+	100	276	276	1.0000000
C6	24410344	24412265	BolC6t37476H	0	+	579	1343	1921	0.6991150
C6	24413676	24415098	BolC6t37477H	0	-	9	43	1422	0.0302391
C6	24445454	24445562	BolC6t37478H	0	-	136	108	108	1.0000000
C6	24455991	24457509	BolC6t37479H	0	+	0	0	1518	0.0000000
C6	24457999	24460699	BolC6t37480H	0	+	213	1857	2700	0.6877778
C6	24466232	24467352	BolC6t37481H	0	+	169	552	1120	0.4928571
C6	24468205	24468586	BolC6t37482H	0	+	310	381	381	1.0000000
C6	24476760	24477285	BolC6t37483H	0	+	11	127	525	0.2419048
C6	24486207	24487405	BolC6t37484H	0	+	349	1197	1198	0.9991653
C6	24489045	24491087	BolC6t37485H	0	+	183	1387	2042	0.6792361
C6	24497969	24498840	BolC6t37486H	0	+	20	627	871	0.7198622
C6	24499126	24499401	BolC6t37487H	0	-	262	275	275	1.0000000
C6	24505713	24506267	BolC6t37488H	0	+	0	0	554	0.0000000
C6	24507154	24507316	BolC6t37489H	0	+	9	124	162	0.7654321
C6	24507580	24507823	BolC6t37490H	0	+	29	243	243	1.0000000
C6	24510239	24511516	BolC6t37491H	0	-	2771	1121	1277	0.8778387
C6	24573619	24575553	BolC6t37492H	0	+	97	1172	1934	0.6059979
C6	24587850	24589989	BolC6t37493H	0	+	359	1817	2139	0.8494624
C6	24595311	24596322	BolC6t37494H	0	+	330	806	1011	0.7972305
C6	24599793	24601230	BolC6t37495H	0	-	803	1437	1437	1.0000000
C6	24602184	24602637	BolC6t37496H	0	+	180	453	453	1.0000000
C6	24623931	24626105	BolC6t37497H	0	+	1084	2110	2174	0.9705612
C6	24628610	24629196	BolC6t37498H	0	+	11	92	586	0.1569966
C6	24633444	24634276	BolC6t37499H	0	+	27	322	832	0.3870192
C6	24639457	24640942	BolC6t37500H	0	-	864	1485	1485	1.0000000
C6	24642589	24644996	BolC6t37501H	0	-	654	2286	2407	0.9497300
C6	24647896	24648529	BolC6t37502H	0	-	147	613	633	0.9684044
C6	24650781	24653539	BolC6t37503H	0	+	1209	2715	2758	0.9844090
C6	24654551	24655083	BolC6t37504H	0	+	210	480	532	0.9022557
C6	24657679	24657916	BolC6t37505H	0	+	65	237	237	1.0000000
C6	24658620	24658869	BolC6t37506H	0	-	378	249	249	1.0000000
C6	24660108	24660429	BolC6t37507H	0	-	113	321	321	1.0000000
C6	24662086	24662335	BolC6t37508H	0	-	25	249	249	1.0000000
C6	24663442	24663668	BolC6t37509H	0	-	281	226	226	1.0000000
C6	24672819	24673619	BolC6t37510H	0	+	156	795	800	0.9937500
C6	24674425	24675819	BolC6t37511H	0	-	1270	1394	1394	1.0000000
C6	24676068	24676329	BolC6t37512H	0	-	444	261	261	1.0000000
C6	24683700	24684785	BolC6t37513H	0	+	264	796	1085	0.7336406
C6	24701295	24702615	BolC6t37514H	0	-	903	1320	1320	1.0000000
C6	24704243	24705092	BolC6t37515H	0	-	972	849	849	1.0000000
C6	24720204	24720366	BolC6t37516H	0	+	223	162	162	1.0000000
C6	24721106	24722312	BolC6t37517H	0	-	1414	1206	1206	1.0000000
C6	24724927	24726637	BolC6t37518H	0	+	1922	1710	1710	1.0000000
C6	24727040	24727466	BolC6t37519H	0	-	281	426	426	1.0000000
C6	24763016	24763783	BolC6t37520H	0	-	56	407	767	0.5306389
C6	24765202	24766675	BolC6t37521H	0	+	124	1087	1473	0.7379498
C6	24771125	24772167	BolC6t37522H	0	-	757	1042	1042	1.0000000
C6	24773947	24776546	BolC6t37523H	0	+	2357	2599	2599	1.0000000
C6	24789563	24795438	BolC6t37524H	0	+	1698	5354	5875	0.9113191
C6	24823106	24824605	BolC6t37525H	0	-	634	1417	1499	0.9452969
C6	24839020	24843697	BolC6t37526H	0	-	2314	4575	4677	0.9781911
C6	24844706	24845442	BolC6t37527H	0	-	155	736	736	1.0000000
C6	24846191	24847782	BolC6t37528H	0	-	1067	1591	1591	1.0000000
C6	24848627	24850992	BolC6t37529H	0	-	769	2340	2365	0.9894292
C6	24853206	24857441	BolC6t37530H	0	+	1224	3463	4235	0.8177096
C6	24872448	24872721	BolC6t37531H	0	-	27	266	273	0.9743590
C6	24874141	24874693	BolC6t37532H	0	-	0	0	552	0.0000000
C6	24877340	24878206	BolC6t37533H	0	+	315	866	866	1.0000000
C6	24889458	24891150	BolC6t37534H	0	+	636	1692	1692	1.0000000
C6	24898192	24899965	BolC6t37535H	0	-	51	1061	1773	0.5984207
C6	24904353	24905434	BolC6t37536H	0	-	452	1081	1081	1.0000000
C6	24919469	24921034	BolC6t37537H	0	+	127	1163	1565	0.7431310
C6	24923771	24928300	BolC6t37538H	0	-	6405	4027	4529	0.8891587
C6	24932975	24933641	BolC6t37539H	0	-	622	666	666	1.0000000
C6	24946288	24949796	BolC6t37540H	0	-	1211	3401	3508	0.9694983
C6	24971887	24973287	BolC6t37541H	0	-	659	1044	1400	0.7457143
C6	24978328	24982969	BolC6t37542H	0	-	2012	4059	4641	0.8745960
C6	24986640	24986832	BolC6t37543H	0	+	31	192	192	1.0000000
C6	25021801	25022263	BolC6t37544H	0	-	292	462	462	1.0000000
C6	25038685	25040319	BolC6t37545H	0	-	550	1570	1634	0.9608323
C6	25041162	25042095	BolC6t37546H	0	-	341	933	933	1.0000000
C6	25043322	25046085	BolC6t37547H	0	-	724	2628	2763	0.9511400
C6	25050784	25053108	BolC6t37548H	0	-	676	1918	2324	0.8253012
C6	25053918	25055134	BolC6t37549H	0	-	781	1216	1216	1.0000000
C6	25058040	25059580	BolC6t37550H	0	+	413	1297	1540	0.8422078
C6	25059767	25061961	BolC6t37551H	0	-	546	714	2194	0.3254330
C6	25063610	25065447	BolC6t37552H	0	+	256	1753	1837	0.9542733
C6	25069090	25070460	BolC6t37553H	0	+	1702	1370	1370	1.0000000
C6	25072250	25072948	BolC6t37554H	0	-	370	698	698	1.0000000
C6	25079969	25081791	BolC6t37555H	0	+	148	1068	1822	0.5861691
C6	25081927	25083355	BolC6t37556H	0	-	275	1376	1428	0.9635854
C6	25130770	25131241	BolC6t37557H	0	-	193	471	471	1.0000000
C6	25140945	25144558	BolC6t37558H	0	+	63	1423	3613	0.3938555
C6	25145915	25146356	BolC6t37559H	0	-	107	362	441	0.8208617
C6	25148207	25149584	BolC6t37560H	0	+	136	1053	1377	0.7647059
C6	25164581	25165434	BolC6t37561H	0	-	15	329	853	0.3856975
C6	25171638	25172536	BolC6t37562H	0	-	5	233	898	0.2594655
C6	25188867	25193001	BolC6t37563H	0	-	1041	3887	4134	0.9402516
C6	25207893	25208604	BolC6t37564H	0	+	316	711	711	1.0000000
C6	25241504	25242802	BolC6t37565H	0	-	278	1298	1298	1.0000000
C6	25246354	25249454	BolC6t37566H	0	-	150	825	3100	0.2661290
C6	25265294	25267214	BolC6t37567H	0	-	36	816	1920	0.4250000
C6	25276192	25277869	BolC6t37568H	0	-	141	1471	1677	0.8771616
C6	25294492	25295525	BolC6t37569H	0	+	176	826	1033	0.7996128
C6	25298415	25300347	BolC6t37570H	0	+	307	1733	1932	0.8969979
C6	25301780	25303049	BolC6t37571H	0	+	264	1269	1269	1.0000000
C6	25316432	25317397	BolC6t37572H	0	+	0	0	965	0.0000000
C6	25322111	25323179	BolC6t37573H	0	+	0	0	1068	0.0000000
C6	25336668	25337081	BolC6t37574H	0	+	0	0	413	0.0000000
C6	25343682	25343808	BolC6t37575H	0	+	9	126	126	1.0000000
C6	25349947	25351545	BolC6t37576H	0	+	0	0	1598	0.0000000
C6	25352213	25353278	BolC6t37577H	0	+	0	0	1065	0.0000000
C6	25361254	25364226	BolC6t37578H	0	+	369	2090	2972	0.7032301
C6	25365496	25368575	BolC6t37579H	0	-	210	1862	3079	0.6047418
C6	25369929	25371576	BolC6t37580H	0	-	346	1647	1647	1.0000000
C6	25375865	25376193	BolC6t37581H	0	+	53	320	328	0.9756098
C6	25395709	25396818	BolC6t37582H	0	+	670	1109	1109	1.0000000
C6	25400897	25401050	BolC6t37583H	0	-	182	153	153	1.0000000
C6	25408828	25409095	BolC6t37584H	0	+	315	267	267	1.0000000
C6	25416836	25417956	BolC6t37585H	0	-	83	659	1120	0.5883929
C6	25431985	25433359	BolC6t37586H	0	+	386	1351	1374	0.9832606
C6	25434182	25434799	BolC6t37587H	0	+	152	617	617	1.0000000
C6	25435693	25440764	BolC6t37588H	0	-	1858	4268	5071	0.8416486
C6	25446712	25447214	BolC6t37589H	0	+	290	502	502	1.0000000
C6	25458851	25460219	BolC6t37590H	0	+	42	195	1368	0.1425439
C6	25466331	25468084	BolC6t37591H	0	+	1043	1744	1753	0.9948660
C6	25485323	25486526	BolC6t37592H	0	+	463	1166	1203	0.9692436
C6	25500222	25500405	BolC6t37593H	0	-	0	0	183	0.0000000
C6	25500747	25503028	BolC6t37594H	0	+	6	561	2281	0.2459448
C6	25524698	25525381	BolC6t37595H	0	-	663	683	683	1.0000000
C6	25534666	25536166	BolC6t37596H	0	+	923	1500	1500	1.0000000
C6	25543852	25545282	BolC6t37597H	0	-	358	910	1430	0.6363636
C6	25547232	25548223	BolC6t37598H	0	-	63	605	991	0.6104944
C6	25552240	25552522	BolC6t37599H	0	+	103	282	282	1.0000000
C6	25552806	25560434	BolC6t37600H	0	-	4661	7628	7628	1.0000000
C6	25585081	25590880	BolC6t37601H	0	-	4370	5799	5799	1.0000000
C6	25593563	25594477	BolC6t37602H	0	-	422	914	914	1.0000000
C6	25595735	25597358	BolC6t37603H	0	-	166	1620	1623	0.9981516
C6	25597550	25597721	BolC6t37604H	0	-	93	171	171	1.0000000
C6	25598905	25602217	BolC6t37605H	0	-	972	3109	3312	0.9387077
C6	25638591	25640091	BolC6t37606H	0	-	1047	1500	1500	1.0000000
C6	25640684	25643412	BolC6t37607H	0	-	749	2387	2728	0.8750000
C6	25659348	25660508	BolC6t37608H	0	-	102	898	1160	0.7741379
C6	25659348	25662038	BolC6t37609H	0	-	243	2236	2690	0.8312268
C6	25690025	25691832	BolC6t37610H	0	+	1087	1807	1807	1.0000000
C6	25705685	25706092	BolC6t37611H	0	+	0	0	407	0.0000000
C6	25713592	25714075	BolC6t37612H	0	+	26	226	483	0.4679089
C6	25776938	25777317	BolC6t37613H	0	-	71	340	379	0.8970976
C6	25778189	25794836	BolC6t37614H	0	-	3548	5674	16647	0.3408422
C6	25804692	25804878	BolC6t37615H	0	+	0	0	186	0.0000000
C6	25806139	25806346	BolC6t37616H	0	+	23	144	207	0.6956522
C6	25830138	25830438	BolC6t37617H	0	-	0	0	300	0.0000000
C6	25831632	25831893	BolC6t37618H	0	+	85	254	261	0.9731801
C6	25832853	25834509	BolC6t37619H	0	-	170	1436	1656	0.8671498
C6	25837234	25838808	BolC6t37620H	0	-	676	1404	1574	0.8919949
C6	25855523	25858299	BolC6t37621H	0	+	2995	2776	2776	1.0000000
C6	25860092	25860956	BolC6t37622H	0	-	648	864	864	1.0000000
C6	25862295	25862717	BolC6t37623H	0	+	0	0	422	0.0000000
C6	25871354	25872279	BolC6t37624H	0	-	29	603	925	0.6518919
C6	25883519	25886440	BolC6t37625H	0	+	468	2476	2921	0.8476549
C6	25902016	25903898	BolC6t37626H	0	+	718	1882	1882	1.0000000
C6	25920985	25923038	BolC6t37627H	0	+	197	1306	2053	0.6361423
C6	25953173	25953398	BolC6t37628H	0	-	491	225	225	1.0000000
C6	25959727	25959913	BolC6t37629H	0	+	1	79	186	0.4247312
C6	25966225	25966521	BolC6t37630H	0	-	281	296	296	1.0000000
C6	25974359	25975379	BolC6t37631H	0	-	711	1020	1020	1.0000000
C6	25985306	25985685	BolC6t37632H	0	+	240	379	379	1.0000000
C6	25994373	25995408	BolC6t37633H	0	+	144	930	1035	0.8985507
C6	25996566	25997577	BolC6t37634H	0	+	705	1011	1011	1.0000000
C6	25999573	25999921	BolC6t37635H	0	+	15	228	348	0.6551724
C6	26001103	26009313	BolC6t37636H	0	-	1297	4003	8210	0.4875761
C6	26001873	26006291	BolC6t37637H	0	+	159	655	4418	0.1482571
C6	26014193	26014636	BolC6t37638H	0	+	208	443	443	1.0000000
C6	26034543	26034843	BolC6t37639H	0	-	110	56	300	0.1866667
C6	26044433	26046023	BolC6t37640H	0	-	99	1006	1590	0.6327044
C6	26047356	26047533	BolC6t37641H	0	+	13	52	177	0.2937853
C6	26048431	26048809	BolC6t37642H	0	+	24	200	378	0.5291005
C6	26055284	26056637	BolC6t37643H	0	-	1070	1353	1353	1.0000000
C6	26057851	26060176	BolC6t37644H	0	-	436	2050	2325	0.8817204
C6	26076625	26076733	BolC6t37645H	0	+	0	0	108	0.0000000
C6	26078508	26078787	BolC6t37646H	0	-	13	191	279	0.6845878
C6	26079472	26084847	BolC6t37647H	0	+	2364	4872	5375	0.9064186
C6	26085364	26086626	BolC6t37648H	0	-	254	978	1262	0.7749604
C6	26088177	26088585	BolC6t37649H	0	-	408	408	408	1.0000000
C6	26090402	26091425	BolC6t37650H	0	+	959	1023	1023	1.0000000
C6	26114474	26116814	BolC6t37651H	0	+	1369	2286	2340	0.9769230
C6	26117591	26117777	BolC6t37652H	0	-	149	186	186	1.0000000
C6	26118053	26119288	BolC6t37653H	0	-	717	1202	1235	0.9732794
C6	26145145	26145352	BolC6t37654H	0	-	198	207	207	1.0000000
C6	26148484	26148703	BolC6t37655H	0	-	1	3	219	0.0136986
C6	26148731	26149099	BolC6t37656H	0	-	95	307	368	0.8342391
C6	26150130	26150645	BolC6t37657H	0	-	71	491	515	0.9533980
C6	26152273	26154085	BolC6t37658H	0	+	635	1774	1812	0.9790287
C6	26172335	26172632	BolC6t37659H	0	+	431	297	297	1.0000000
C6	26178390	26180661	BolC6t37660H	0	-	892	2196	2271	0.9669749
C6	26186615	26187929	BolC6t37661H	0	+	345	1283	1314	0.9764079
C6	26190729	26191799	BolC6t37662H	0	+	169	810	1070	0.7570093
C6	26193667	26195527	BolC6t37663H	0	-	99	887	1860	0.4768817
C6	26199298	26199583	BolC6t37664H	0	+	21	285	285	1.0000000
C6	26200329	26202308	BolC6t37665H	0	+	1090	1979	1979	1.0000000
C6	26203375	26204461	BolC6t37666H	0	+	528	1086	1086	1.0000000
C6	26205810	26206530	BolC6t37667H	0	-	555	720	720	1.0000000
C6	26235867	26239621	BolC6t37668H	0	-	2319	3754	3754	1.0000000
C6	26240201	26241048	BolC6t37669H	0	-	557	847	847	1.0000000
C6	26241769	26244103	BolC6t37670H	0	+	566	2128	2334	0.9117395
C6	26251797	26253597	BolC6t37671H	0	-	384	1656	1800	0.9200000
C6	26259526	26270476	BolC6t37672H	0	-	4124	10501	10950	0.9589955
C6	26279888	26281547	BolC6t37673H	0	+	1481	1659	1659	1.0000000
C6	26281876	26284415	BolC6t37674H	0	-	1594	2498	2539	0.9838519
C6	26291654	26294024	BolC6t37675H	0	-	1624	2370	2370	1.0000000
C6	26294371	26294825	BolC6t37676H	0	-	336	454	454	1.0000000
C6	26295440	26295683	BolC6t37677H	0	-	244	243	243	1.0000000
C6	26302071	26304627	BolC6t37678H	0	-	1415	2555	2556	0.9996088
C6	26305446	26309473	BolC6t37679H	0	-	1064	3041	4027	0.7551527
C6	26309799	26310912	BolC6t37680H	0	-	34	671	1113	0.6028751
C6	26311630	26318827	BolC6t37681H	0	+	2231	6252	7197	0.8686953
C6	26319571	26321004	BolC6t37682H	0	-	1486	1433	1433	1.0000000
C6	26322023	26323798	BolC6t37683H	0	+	783	1770	1775	0.9971831
C6	26325995	26326530	BolC6t37684H	0	-	339	535	535	1.0000000
C6	26331199	26333052	BolC6t37685H	0	-	2067	1697	1853	0.9158122
C6	26335002	26341438	BolC6t37686H	0	-	975	4550	6436	0.7069609
C6	26344304	26353130	BolC6t37687H	0	-	3191	6942	8826	0.7865398
C6	26353948	26355586	BolC6t37688H	0	-	1626	1638	1638	1.0000000
C6	26365490	26365934	BolC6t37689H	0	-	507	444	444	1.0000000
C6	26367044	26370416	BolC6t37690H	0	-	3118	3372	3372	1.0000000
C6	26371222	26373634	BolC6t37691H	0	-	1558	2412	2412	1.0000000
C6	26375597	26376304	BolC6t37692H	0	-	979	707	707	1.0000000
C6	26377885	26378651	BolC6t37693H	0	+	54	441	766	0.5757180
C6	26381016	26381525	BolC6t37694H	0	-	188	509	509	1.0000000
C6	26381854	26382125	BolC6t37695H	0	-	197	271	271	1.0000000
C6	26389082	26394401	BolC6t37696H	0	-	360	1846	5319	0.3470577
C6	26406728	26408746	BolC6t37697H	0	+	460	2004	2018	0.9930624
C6	26410952	26411304	BolC6t37698H	0	-	220	352	352	1.0000000
C6	26411862	26412138	BolC6t37699H	0	-	652	276	276	1.0000000
C6	26425091	26425781	BolC6t37700H	0	-	689	690	690	1.0000000
C6	26431968	26433199	BolC6t37701H	0	-	1405	1231	1231	1.0000000
C6	26436123	26437484	BolC6t37702H	0	+	577	1361	1361	1.0000000
C6	26443217	26443493	BolC6t37703H	0	-	278	276	276	1.0000000
C6	26450569	26453317	BolC6t37704H	0	-	2057	2748	2748	1.0000000
C6	26456997	26458048	BolC6t37705H	0	+	1086	1051	1051	1.0000000
C6	26469859	26470438	BolC6t37706H	0	-	56	496	579	0.8566494
C6	26470597	26470977	BolC6t37707H	0	+	110	380	380	1.0000000
C6	26472211	26474175	BolC6t37708H	0	+	1396	1964	1964	1.0000000
C6	26474593	26477388	BolC6t37709H	0	-	1301	2795	2795	1.0000000
C6	26479295	26482246	BolC6t37710H	0	+	566	2512	2951	0.8512369
C6	26482971	26483719	BolC6t37711H	0	-	605	748	748	1.0000000
C6	26484386	26487137	BolC6t37712H	0	-	525	2583	2751	0.9389313
C6	26491079	26493897	BolC6t37713H	0	+	1122	2110	2818	0.7487580
C6	26494356	26497312	BolC6t37714H	0	-	1216	2914	2956	0.9857916
C6	26544107	26544599	BolC6t37715H	0	+	469	492	492	1.0000000
C6	26553497	26554848	BolC6t37716H	0	+	1052	1351	1351	1.0000000
C6	26567289	26570023	BolC6t37717H	0	+	581	2697	2734	0.9864667
C6	26571008	26571254	BolC6t37718H	0	+	136	246	246	1.0000000
C6	26572009	26573524	BolC6t37719H	0	-	662	1512	1515	0.9980198
C6	26574273	26575221	BolC6t37720H	0	+	70	393	948	0.4145570
C6	26575427	26575685	BolC6t37721H	0	+	17	154	258	0.5968992
C6	26578430	26578631	BolC6t37722H	0	+	66	201	201	1.0000000
C6	26579971	26584442	BolC6t37723H	0	-	1712	4455	4471	0.9964214
C6	26593569	26596414	BolC6t37724H	0	-	1099	2845	2845	1.0000000
C6	26603606	26607044	BolC6t37725H	0	+	1942	3438	3438	1.0000000
C6	26614234	26614595	BolC6t37726H	0	-	0	0	361	0.0000000
C6	26617863	26618548	BolC6t37727H	0	-	0	0	685	0.0000000
C6	26620031	26621543	BolC6t37728H	0	+	888	1512	1512	1.0000000
C6	26626594	26627237	BolC6t37729H	0	+	311	633	643	0.9844479
C6	26627624	26628568	BolC6t37730H	0	-	1213	944	944	1.0000000
C6	26629038	26629824	BolC6t37731H	0	-	97	656	786	0.8346056
C6	26642110	26652189	BolC6t37732H	0	+	4417	7808	10079	0.7746800
C6	26654439	26655869	BolC6t37733H	0	+	1585	1430	1430	1.0000000
C6	26656055	26657874	BolC6t37734H	0	+	1689	1819	1819	1.0000000
C6	26660923	26663728	BolC6t37735H	0	-	1785	2789	2805	0.9942959
C6	26668860	26677987	BolC6t37736H	0	+	3423	7978	9127	0.8741098
C6	26678419	26681998	BolC6t37737H	0	-	1129	3453	3579	0.9647946
C6	26684918	26686345	BolC6t37738H	0	-	503	1427	1427	1.0000000
C6	26687553	26687793	BolC6t37739H	0	-	158	240	240	1.0000000
C6	26688776	26716863	BolC6t37740H	0	-	11031	24760	28087	0.8815466
C6	26705133	26705578	BolC6t37741H	0	+	0	0	445	0.0000000
C6	26733044	26737822	BolC6t37742H	0	-	1386	4673	4778	0.9780243
C6	26738058	26738425	BolC6t37743H	0	-	278	367	367	1.0000000
C6	26741698	26743267	BolC6t37744H	0	-	1192	1569	1569	1.0000000
C6	26744094	26750053	BolC6t37745H	0	-	1517	5370	5959	0.9011579
C6	26751961	26754810	BolC6t37746H	0	+	1343	2849	2849	1.0000000
C6	26755002	26756328	BolC6t37747H	0	-	1164	1326	1326	1.0000000
C6	26756467	26759987	BolC6t37748H	0	-	2035	3491	3520	0.9917614
C6	26764926	26766555	BolC6t37749H	0	+	554	1629	1629	1.0000000
C6	26767705	26781368	BolC6t37750H	0	+	2912	11329	13663	0.8291737
C6	26783231	26785250	BolC6t37751H	0	+	1088	1820	2019	0.9014363
C6	26790314	26795576	BolC6t37752H	0	+	757	4667	5262	0.8869251
C6	26809077	26814622	BolC6t37753H	0	+	1751	4629	5545	0.8348061
C6	26815440	26816978	BolC6t37754H	0	+	869	1538	1538	1.0000000
C6	26817545	26840146	BolC6t37755H	0	-	4422	15756	22601	0.6971373
C6	26821277	26832356	BolC6t37756H	0	+	1341	7660	11079	0.6913981
C6	26840957	26842293	BolC6t37757H	0	+	201	1282	1336	0.9595808
C6	26842855	26844166	BolC6t37758H	0	-	684	1296	1311	0.9885584
C6	26846714	26847017	BolC6t37759H	0	+	45	289	303	0.9537954
C6	26850852	26851260	BolC6t37760H	0	+	140	408	408	1.0000000
C6	26857974	26858426	BolC6t37761H	0	-	22	432	452	0.9557522
C6	26860924	26869905	BolC6t37762H	0	+	2133	7402	8981	0.8241844
C6	26870283	26871332	BolC6t37763H	0	-	947	1049	1049	1.0000000
C6	26875166	26877553	BolC6t37764H	0	+	1787	2387	2387	1.0000000
C6	26877908	26880463	BolC6t37765H	0	-	1180	2522	2555	0.9870842
C6	26885840	26889770	BolC6t37766H	0	-	1625	3862	3930	0.9826972
C6	26900242	26900440	BolC6t37767H	0	-	67	198	198	1.0000000
C6	26906768	26913203	BolC6t37768H	0	+	900	2940	6435	0.4568765
C6	26915405	26915834	BolC6t37769H	0	+	58	420	429	0.9790210
C6	26922946	26923756	BolC6t37770H	0	-	61	596	810	0.7358025
C6	26924086	26924732	BolC6t37771H	0	-	99	597	646	0.9241486
C6	26936470	26938181	BolC6t37772H	0	+	57	843	1711	0.4926943
C6	26938430	26940021	BolC6t37773H	0	-	593	1341	1591	0.8428661
C6	26973725	26974853	BolC6t37774H	0	+	2	19	1128	0.0168440
C6	26986603	26988382	BolC6t37775H	0	+	1122	1697	1779	0.9539067
C6	26993996	26995865	BolC6t37776H	0	+	1493	1869	1869	1.0000000
C6	26996572	26997349	BolC6t37777H	0	-	144	731	777	0.9407979
C6	27001073	27002300	BolC6t37778H	0	-	762	1227	1227	1.0000000
C6	27030068	27031052	BolC6t37779H	0	-	1101	973	984	0.9888211
C6	27035387	27035856	BolC6t37780H	0	-	257	469	469	1.0000000
C6	27035865	27036237	BolC6t37781H	0	-	256	372	372	1.0000000
C6	27046460	27047075	BolC6t37782H	0	+	93	552	615	0.8975610
C6	27047448	27048487	BolC6t37783H	0	-	188	1015	1039	0.9769009
C6	27050161	27051485	BolC6t37784H	0	+	178	1324	1324	1.0000000
C6	27054347	27055415	BolC6t37785H	0	+	513	963	1068	0.9016854
C6	27055695	27056922	BolC6t37786H	0	-	193	831	1227	0.6772616
C6	27061266	27061763	BolC6t37787H	0	-	187	497	497	1.0000000
C6	27097926	27098471	BolC6t37788H	0	-	309	545	545	1.0000000
C6	27109762	27110170	BolC6t37789H	0	-	48	308	408	0.7549019
C6	27111067	27111625	BolC6t37790H	0	-	2	111	558	0.1989247
C6	27113828	27117332	BolC6t37791H	0	+	481	1841	3504	0.5253996
C6	27133035	27133998	BolC6t37792H	0	-	910	963	963	1.0000000
C6	27139380	27140010	BolC6t37793H	0	+	289	630	630	1.0000000
C6	27140345	27144090	BolC6t37794H	0	-	1810	3688	3745	0.9847797
C6	27146175	27147869	BolC6t37795H	0	+	577	1668	1694	0.9846517
C6	27156768	27157369	BolC6t37796H	0	-	296	601	601	1.0000000
C6	27163869	27165846	BolC6t37797H	0	+	497	1727	1977	0.8735458
C6	27171469	27173114	BolC6t37798H	0	-	1059	1645	1645	1.0000000
C6	27179207	27179457	BolC6t37799H	0	-	12	203	250	0.8120000
C6	27183794	27183959	BolC6t37800H	0	-	68	165	165	1.0000000
C6	27188518	27195004	BolC6t37801H	0	-	1574	6013	6486	0.9270737
C6	27198857	27201915	BolC6t37802H	0	+	1068	2849	3058	0.9316547
C6	27208737	27212914	BolC6t37803H	0	+	393	2817	4177	0.6744075
C6	27214734	27215108	BolC6t37804H	0	+	259	374	374	1.0000000
C6	27217174	27217366	BolC6t37805H	0	-	75	192	192	1.0000000
C6	27231088	27231984	BolC6t37806H	0	+	595	896	896	1.0000000
C6	27232644	27235364	BolC6t37807H	0	-	862	2323	2720	0.8540441
C6	27235781	27236060	BolC6t37808H	0	-	53	253	279	0.9068100
C6	27259719	27260127	BolC6t37809H	0	+	168	408	408	1.0000000
C6	27260715	27263994	BolC6t37810H	0	+	1689	3210	3279	0.9789570
C6	27268873	27271183	BolC6t37811H	0	+	1088	2120	2310	0.9177489
C6	27277969	27280851	BolC6t37812H	0	+	1533	2805	2882	0.9732825
C6	27281559	27283861	BolC6t37813H	0	-	1706	2302	2302	1.0000000
C6	27284469	27285260	BolC6t37814H	0	-	722	736	791	0.9304678
C6	27288715	27289189	BolC6t37815H	0	+	2	29	474	0.0611814
C6	27295769	27298827	BolC6t37816H	0	+	1586	2808	3058	0.9182472
C6	27299529	27303446	BolC6t37817H	0	+	1720	3818	3917	0.9747255
C6	27304032	27309943	BolC6t37818H	0	-	1600	4408	5911	0.7457283
C6	27318248	27318437	BolC6t37819H	0	-	74	189	189	1.0000000
C6	27319134	27320103	BolC6t37820H	0	-	244	948	969	0.9783282
C6	27328077	27328803	BolC6t37821H	0	+	344	726	726	1.0000000
C6	27328864	27329129	BolC6t37822H	0	+	166	265	265	1.0000000
C6	27333553	27334555	BolC6t37823H	0	-	362	1002	1002	1.0000000
C6	27339671	27340785	BolC6t37824H	0	-	247	674	1114	0.6050269
C6	27342049	27342736	BolC6t37825H	0	+	249	687	687	1.0000000
C6	27343490	27344667	BolC6t37826H	0	-	265	1173	1177	0.9966015
C6	27346288	27348591	BolC6t37827H	0	+	1244	2160	2303	0.9379071
C6	27350944	27352783	BolC6t37828H	0	+	1268	1804	1839	0.9809679
C6	27352967	27355454	BolC6t37829H	0	-	906	2349	2487	0.9445115
C6	27366485	27375195	BolC6t37830H	0	+	3150	6566	8710	0.7538462
C6	27368313	27368616	BolC6t37831H	0	-	0	0	303	0.0000000
C6	27375506	27375833	BolC6t37832H	0	-	10	93	327	0.2844037
C6	27380680	27381172	BolC6t37833H	0	-	17	401	492	0.8150406
C6	27384831	27385380	BolC6t37834H	0	-	40	389	549	0.7085610
C6	27388292	27388793	BolC6t37835H	0	-	101	202	501	0.4031936
C6	27400494	27401625	BolC6t37836H	0	+	0	0	1131	0.0000000
C6	27416260	27416677	BolC6t37837H	0	-	178	417	417	1.0000000
C6	27424234	27430335	BolC6t37838H	0	+	187	2184	6101	0.3579741
C6	27453693	27453930	BolC6t37839H	0	+	0	0	237	0.0000000
C6	27453996	27454284	BolC6t37840H	0	+	0	0	288	0.0000000
C6	27481338	27481514	BolC6t37841H	0	-	80	176	176	1.0000000
C6	27495638	27496129	BolC6t37842H	0	-	0	0	491	0.0000000
C6	27498391	27499666	BolC6t37843H	0	-	46	284	1275	0.2227451
C6	27502253	27503247	BolC6t37844H	0	+	28	539	994	0.5422535
C6	27503611	27504662	BolC6t37845H	0	-	98	692	1051	0.6584206
C6	27526915	27529311	BolC6t37846H	0	+	1084	1633	2396	0.6815526
C6	27535124	27535334	BolC6t37847H	0	-	220	210	210	1.0000000
C6	27535712	27536012	BolC6t37848H	0	-	113	300	300	1.0000000
C6	27536390	27537481	BolC6t37849H	0	+	612	1091	1091	1.0000000
C6	27540585	27541317	BolC6t37850H	0	+	258	670	732	0.9153005
C6	27543504	27543789	BolC6t37851H	0	-	3	82	285	0.2877193
C6	27570385	27572285	BolC6t37852H	0	+	551	1665	1900	0.8763158
C6	27572689	27575450	BolC6t37853H	0	-	2465	2614	2761	0.9467584
C6	27578788	27579620	BolC6t37854H	0	-	135	450	832	0.5408654
C6	27604251	27605467	BolC6t37855H	0	+	18	393	1216	0.3231908
C6	27622198	27623242	BolC6t37856H	0	+	766	1044	1044	1.0000000
C6	27632818	27633246	BolC6t37857H	0	-	358	428	428	1.0000000
C6	27636616	27637459	BolC6t37858H	0	+	150	696	843	0.8256228
C6	27651157	27652320	BolC6t37859H	0	+	549	1158	1163	0.9957008
C6	27659100	27659958	BolC6t37860H	0	+	510	739	858	0.8613054
C6	27666425	27669016	BolC6t37861H	0	-	1752	2591	2591	1.0000000
C6	27669279	27676254	BolC6t37862H	0	+	1684	3938	6975	0.5645878
C6	27677093	27677571	BolC6t37863H	0	-	435	478	478	1.0000000
C6	27682419	27683520	BolC6t37864H	0	+	1334	1101	1101	1.0000000
C6	27694530	27695771	BolC6t37865H	0	+	1071	1241	1241	1.0000000
C6	27696666	27701654	BolC6t37866H	0	-	1360	4231	4988	0.8482358
C6	27707857	27709168	BolC6t37867H	0	-	767	1311	1311	1.0000000
C6	27709624	27711326	BolC6t37868H	0	+	1332	1686	1702	0.9905993
C6	27719234	27721046	BolC6t37869H	0	+	1168	1812	1812	1.0000000
C6	27721547	27721949	BolC6t37870H	0	-	271	402	402	1.0000000
C6	27729076	27730048	BolC6t37871H	0	-	2451	972	972	1.0000000
C6	27731986	27733240	BolC6t37872H	0	-	596	1254	1254	1.0000000
C6	27754412	27754652	BolC6t37873H	0	+	288	240	240	1.0000000
C6	27758370	27759318	BolC6t37874H	0	-	938	948	948	1.0000000
C6	27765018	27766448	BolC6t37875H	0	+	570	1422	1430	0.9944056
C6	27767115	27770282	BolC6t37876H	0	+	1218	2990	3167	0.9441112
C6	27770920	27772143	BolC6t37877H	0	-	651	1223	1223	1.0000000
C6	27779059	27780751	BolC6t37878H	0	+	806	1599	1692	0.9450355
C6	27782066	27787469	BolC6t37879H	0	-	3281	5396	5403	0.9987044
C6	27788426	27789278	BolC6t37880H	0	+	0	0	852	0.0000000
C6	27792970	27794822	BolC6t37881H	0	+	34	208	1852	0.1123110
C6	27796653	27798060	BolC6t37882H	0	+	790	1407	1407	1.0000000
C6	27798523	27799896	BolC6t37883H	0	-	1236	1373	1373	1.0000000
C6	27800788	27801171	BolC6t37884H	0	-	212	383	383	1.0000000
C6	27803676	27804122	BolC6t37885H	0	-	176	446	446	1.0000000
C6	27804478	27807530	BolC6t37886H	0	+	1363	2814	3052	0.9220183
C6	27810074	27813590	BolC6t37887H	0	+	1262	3340	3516	0.9499431
C6	27821934	27822285	BolC6t37888H	0	-	133	351	351	1.0000000
C6	27822608	27823163	BolC6t37889H	0	-	182	555	555	1.0000000
C6	27824729	27826995	BolC6t37890H	0	+	484	2249	2266	0.9924978
C6	27827324	27828627	BolC6t37891H	0	-	550	1303	1303	1.0000000
C6	27829600	27829961	BolC6t37892H	0	-	140	361	361	1.0000000
C6	27837914	27838287	BolC6t37893H	0	-	344	373	373	1.0000000
C6	27845152	27845494	BolC6t37894H	0	-	158	342	342	1.0000000
C6	27846320	27846449	BolC6t37895H	0	-	2	15	129	0.1162791
C6	27876173	27879984	BolC6t37896H	0	-	248	2167	3811	0.5686172
C6	27882485	27883199	BolC6t37897H	0	-	441	714	714	1.0000000
C6	27884991	27885216	BolC6t37898H	0	-	353	225	225	1.0000000
C6	27926062	27926778	BolC6t37899H	0	-	676	716	716	1.0000000
C6	27930143	27932519	BolC6t37900H	0	+	1831	1644	2376	0.6919192
C6	27935422	27936811	BolC6t37901H	0	+	665	1333	1389	0.9596832
C6	27939001	27940246	BolC6t37902H	0	+	623	1146	1245	0.9204819
C6	27944047	27945863	BolC6t37903H	0	+	644	1738	1816	0.9570485
C6	27958608	27958944	BolC6t37904H	0	+	546	336	336	1.0000000
C6	27959300	27959417	BolC6t37905H	0	+	492	117	117	1.0000000
C6	27970358	27972178	BolC6t37906H	0	-	1375	1820	1820	1.0000000
C6	27974180	27980226	BolC6t37907H	0	+	1132	4909	6046	0.8119418
C6	27998536	28000045	BolC6t37908H	0	-	596	1509	1509	1.0000000
C6	28002328	28003477	BolC6t37909H	0	+	137	1055	1149	0.9181897
C6	28016746	28018118	BolC6t37910H	0	-	587	1372	1372	1.0000000
C6	28018178	28018561	BolC6t37911H	0	-	336	383	383	1.0000000
C6	28027638	28027830	BolC6t37912H	0	+	24	192	192	1.0000000
C6	28029228	28031541	BolC6t37913H	0	+	102	1132	2313	0.4894077
C6	28031743	28032171	BolC6t37914H	0	+	360	428	428	1.0000000
C6	28032363	28035261	BolC6t37915H	0	-	1422	2898	2898	1.0000000
C6	28038851	28039154	BolC6t37916H	0	-	163	303	303	1.0000000
C6	28042845	28043343	BolC6t37917H	0	-	84	498	498	1.0000000
C6	28053032	28073417	BolC6t37918H	0	+	7972	18809	20385	0.9226882
C6	28076563	28077631	BolC6t37919H	0	+	838	1068	1068	1.0000000
C6	28078315	28080604	BolC6t37920H	0	-	717	2224	2289	0.9716033
C6	28081347	28083545	BolC6t37921H	0	-	825	2114	2198	0.9617835
C6	28087380	28087716	BolC6t37922H	0	-	34	279	336	0.8303571
C6	28098183	28100468	BolC6t37923H	0	+	898	2272	2285	0.9943107
C6	28101091	28102532	BolC6t37924H	0	+	1414	1441	1441	1.0000000
C6	28103004	28106946	BolC6t37925H	0	-	1284	3799	3942	0.9637240
C6	28108513	28109863	BolC6t37926H	0	+	622	1346	1350	0.9970371
C6	28114771	28115592	BolC6t37927H	0	+	28	651	821	0.7929354
C6	28133831	28135055	BolC6t37928H	0	+	1147	1224	1224	1.0000000
C6	28140644	28142768	BolC6t37929H	0	+	720	1584	2124	0.7457627
C6	28145373	28146947	BolC6t37930H	0	+	212	1524	1574	0.9682338
C6	28147348	28148845	BolC6t37931H	0	-	1194	1491	1497	0.9959920
C6	28151748	28152612	BolC6t37932H	0	+	318	864	864	1.0000000
C6	28163129	28163685	BolC6t37933H	0	+	427	556	556	1.0000000
C6	28187056	28187783	BolC6t37934H	0	-	1059	727	727	1.0000000
C6	28191676	28192075	BolC6t37935H	0	-	316	399	399	1.0000000
C6	28192530	28192719	BolC6t37936H	0	+	259	189	189	1.0000000
C6	28205607	28206057	BolC6t37937H	0	+	390	450	450	1.0000000
C6	28213727	28216225	BolC6t37938H	0	-	939	1454	2498	0.5820656
C6	28217972	28222937	BolC6t37939H	0	+	451	2582	4965	0.5200403
C6	28227370	28228952	BolC6t37940H	0	+	802	1539	1582	0.9728192
C6	28229417	28232875	BolC6t37941H	0	-	6733	3458	3458	1.0000000
C6	28234586	28235025	BolC6t37942H	0	-	1381	439	439	1.0000000
C6	28236270	28246020	BolC6t37943H	0	+	15735	9348	9750	0.9587692
C6	28248895	28250041	BolC6t37944H	0	+	91	918	1146	0.8010471
C6	28252913	28253366	BolC6t37945H	0	+	1313	453	453	1.0000000
C6	28253528	28254668	BolC6t37946H	0	-	3862	1140	1140	1.0000000
C6	28266603	28269446	BolC6t37947H	0	+	2352	2782	2843	0.9785438
C6	28271424	28272273	BolC6t37948H	0	+	1106	849	849	1.0000000
C6	28275689	28276774	BolC6t37949H	0	-	2659	1085	1085	1.0000000
C6	28283252	28284367	BolC6t37950H	0	+	2410	1115	1115	1.0000000
C6	28285966	28287763	BolC6t37951H	0	-	5526	1797	1797	1.0000000
C6	28290297	28292358	BolC6t37952H	0	-	3024	2061	2061	1.0000000
C6	28292937	28298359	BolC6t37953H	0	-	1817	4994	5422	0.9210624
C6	28299718	28301846	BolC6t37954H	0	-	1025	2033	2128	0.9553571
C6	28307134	28310578	BolC6t37955H	0	-	387	2611	3444	0.7581301
C6	28312210	28313749	BolC6t37956H	0	+	1327	1539	1539	1.0000000
C6	28314065	28317584	BolC6t37957H	0	-	1028	3221	3519	0.9153169
C6	28323253	28324764	BolC6t37958H	0	-	237	1399	1511	0.9258769
C6	28328486	28330581	BolC6t37959H	0	-	2634	2076	2095	0.9909308
C6	28331016	28332352	BolC6t37960H	0	+	182	1257	1336	0.9408683
C6	28335397	28336855	BolC6t37961H	0	-	41	679	1458	0.4657064
C6	28349487	28349904	BolC6t37962H	0	+	77	389	417	0.9328537
C6	28363140	28367672	BolC6t37963H	0	+	1615	4137	4532	0.9128420
C6	28364710	28366596	BolC6t37964H	0	-	303	1717	1886	0.9103923
C6	28369975	28371128	BolC6t37965H	0	+	335	469	1153	0.4067650
C6	28387983	28388214	BolC6t37966H	0	-	18	138	231	0.5974026
C6	28399859	28400236	BolC6t37967H	0	+	302	377	377	1.0000000
C6	28404162	28406995	BolC6t37968H	0	-	822	2512	2833	0.8866925
C6	28443942	28444779	BolC6t37969H	0	+	108	571	837	0.6821983
C6	28477813	28479238	BolC6t37970H	0	-	426	1319	1425	0.9256141
C6	28511671	28512703	BolC6t37971H	0	+	376	962	1032	0.9321706
C6	28513770	28515521	BolC6t37972H	0	-	209	1345	1751	0.7681325
C6	28517542	28517650	BolC6t37973H	0	-	216	108	108	1.0000000
C6	28517746	28520934	BolC6t37974H	0	-	489	2591	3188	0.8127353
C6	28522110	28525282	BolC6t37975H	0	-	2228	3172	3172	1.0000000
C6	28527099	28528464	BolC6t37976H	0	+	256	1287	1365	0.9428571
C6	28529179	28530515	BolC6t37977H	0	+	1540	1336	1336	1.0000000
C6	28530637	28535489	BolC6t37978H	0	-	1641	4560	4852	0.9398186
C6	28538917	28540021	BolC6t37979H	0	+	11	249	1104	0.2255435
C6	28549531	28551513	BolC6t37980H	0	-	27	336	1982	0.1695257
C6	28552774	28553422	BolC6t37981H	0	-	85	640	648	0.9876543
C6	28554576	28557507	BolC6t37982H	0	-	310	1371	2931	0.4677584
C6	28558715	28559189	BolC6t37983H	0	+	107	377	474	0.7953587
C6	28560458	28561929	BolC6t37984H	0	-	926	1324	1471	0.9000680
C6	28562649	28563717	BolC6t37985H	0	+	3145	1068	1068	1.0000000
C6	28563954	28564566	BolC6t37986H	0	-	346	612	612	1.0000000
C6	28568492	28568776	BolC6t37987H	0	-	311	284	284	1.0000000
C6	28573472	28573812	BolC6t37988H	0	+	268	340	340	1.0000000
C6	28574873	28575396	BolC6t37989H	0	+	404	523	523	1.0000000
C6	28577770	28578028	BolC6t37990H	0	-	354	258	258	1.0000000
C6	28580596	28581381	BolC6t37991H	0	-	419	785	785	1.0000000
C6	28593682	28594219	BolC6t37992H	0	-	6	27	537	0.0502793
C6	28597779	28600672	BolC6t37993H	0	-	1535	2741	2893	0.9474594
C6	28604447	28607046	BolC6t37994H	0	+	2388	2599	2599	1.0000000
C6	28608474	28609288	BolC6t37995H	0	+	652	749	814	0.9201474
C6	28609711	28610101	BolC6t37996H	0	+	210	390	390	1.0000000
C6	28610498	28610903	BolC6t37997H	0	-	192	405	405	1.0000000
C6	28614291	28619387	BolC6t37998H	0	-	2363	4227	5096	0.8294741
C6	28636092	28638156	BolC6t37999H	0	-	2010	2006	2064	0.9718992
C6	28641378	28642319	BolC6t38000H	0	-	716	941	941	1.0000000
C6	28652807	28653893	BolC6t38001H	0	-	416	1080	1086	0.9944751
C6	28657342	28657504	BolC6t38002H	0	-	576	162	162	1.0000000
C6	28662072	28662510	BolC6t38003H	0	+	6	69	438	0.1575342
C6	28679236	28680289	BolC6t38004H	0	+	359	1053	1053	1.0000000
C6	28681156	28682539	BolC6t38005H	0	+	132	1031	1383	0.7454808
C6	28699991	28701145	BolC6t38006H	0	+	429	1126	1154	0.9757366
C6	28708132	28708924	BolC6t38007H	0	-	231	738	792	0.9318182
C6	28731059	28733872	BolC6t38008H	0	-	553	2531	2813	0.8997511
C6	28737873	28738371	BolC6t38009H	0	-	218	498	498	1.0000000
C6	28741084	28741908	BolC6t38010H	0	-	587	824	824	1.0000000
C6	28744670	28746898	BolC6t38011H	0	+	1148	2162	2228	0.9703770
C6	28750530	28752295	BolC6t38012H	0	+	1245	1765	1765	1.0000000
C6	28753416	28758627	BolC6t38013H	0	-	932	4632	5211	0.8888889
C6	28762219	28762528	BolC6t38014H	0	-	12	174	309	0.5631068
C6	28780483	28781120	BolC6t38015H	0	+	5	56	637	0.0879121
C6	28809359	28809668	BolC6t38016H	0	+	0	0	309	0.0000000
C6	28823531	28825946	BolC6t38017H	0	-	1337	2415	2415	1.0000000
C6	28850351	28854043	BolC6t38018H	0	-	857	3571	3692	0.9672264
C6	28877031	28877334	BolC6t38019H	0	+	420	303	303	1.0000000
C6	28882936	28883394	BolC6t38020H	0	+	430	458	458	1.0000000
C6	28886217	28887817	BolC6t38021H	0	-	166	1145	1600	0.7156250
C6	28895289	28896533	BolC6t38022H	0	+	139	988	1244	0.7942122
C6	28903338	28903557	BolC6t38023H	0	-	49	219	219	1.0000000
C6	28905322	28905463	BolC6t38024H	0	+	187	141	141	1.0000000
C6	28906333	28912913	BolC6t38025H	0	+	1989	5870	6580	0.8920972
C6	28913666	28914734	BolC6t38026H	0	+	863	1068	1068	1.0000000
C6	28915105	28922411	BolC6t38027H	0	+	3548	6947	7306	0.9508623
C6	28919442	28919868	BolC6t38028H	0	-	105	426	426	1.0000000
C6	28922758	28924651	BolC6t38029H	0	+	702	1859	1893	0.9820391
C6	28925226	28925928	BolC6t38030H	0	+	287	702	702	1.0000000
C6	28926930	28928110	BolC6t38031H	0	-	280	800	1180	0.6779661
C6	28938982	28944975	BolC6t38032H	0	-	3760	5946	5993	0.9921575
C6	28950992	28951654	BolC6t38033H	0	+	34	516	662	0.7794562
C6	28955875	28956784	BolC6t38034H	0	+	858	909	909	1.0000000
C6	28963843	28964062	BolC6t38035H	0	-	38	121	219	0.5525114
C6	28964704	28968502	BolC6t38036H	0	-	1082	3528	3798	0.9289100
C6	29006435	29011480	BolC6t38037H	0	-	724	3559	5045	0.7054510
C6	29013007	29014278	BolC6t38038H	0	+	586	1271	1271	1.0000000
C6	29015549	29017928	BolC6t38039H	0	+	598	1816	2379	0.7633460
C6	29018066	29019227	BolC6t38040H	0	-	414	1161	1161	1.0000000
C6	29019549	29020227	BolC6t38041H	0	+	170	657	678	0.9690266
C6	29020878	29023247	BolC6t38042H	0	+	1500	2336	2369	0.9860701
C6	29023627	29033604	BolC6t38043H	0	-	3470	8763	9977	0.8783202
C6	29035337	29035649	BolC6t38044H	0	-	46	308	312	0.9871795
C6	29042968	29047157	BolC6t38045H	0	+	2540	4019	4189	0.9594175
C6	29047656	29050119	BolC6t38046H	0	-	691	2058	2463	0.8355664
C6	29052061	29053482	BolC6t38047H	0	+	204	1014	1421	0.7135820
C6	29053808	29055842	BolC6t38048H	0	-	1179	2034	2034	1.0000000
C6	29056562	29059771	BolC6t38049H	0	+	1055	2500	3209	0.7790589
C6	29073850	29074802	BolC6t38050H	0	+	606	944	952	0.9915966
C6	29084479	29085400	BolC6t38051H	0	+	330	921	921	1.0000000
C6	29087951	29093337	BolC6t38052H	0	+	1025	5029	5386	0.9337171
C6	29094224	29097733	BolC6t38053H	0	+	2260	3413	3509	0.9726418
C6	29099920	29102106	BolC6t38054H	0	+	1022	2167	2186	0.9913083
C6	29103466	29121666	BolC6t38055H	0	-	1265	12528	18200	0.6883516
C6	29140612	29141946	BolC6t38056H	0	-	1026	1334	1334	1.0000000
C6	29151649	29153131	BolC6t38057H	0	-	613	1465	1482	0.9885290
C6	29160481	29160607	BolC6t38058H	0	-	16	110	126	0.8730159
C6	29170699	29172178	BolC6t38059H	0	-	442	1319	1479	0.8918188
C6	29181509	29182457	BolC6t38060H	0	+	677	948	948	1.0000000
C6	29188046	29189222	BolC6t38061H	0	+	562	1176	1176	1.0000000
C6	29189945	29190161	BolC6t38062H	0	-	274	216	216	1.0000000
C6	29191078	29193099	BolC6t38063H	0	-	1251	2012	2021	0.9955468
C6	29200655	29201638	BolC6t38064H	0	+	511	983	983	1.0000000
C6	29202489	29204476	BolC6t38065H	0	-	833	1987	1987	1.0000000
C6	29207433	29208204	BolC6t38066H	0	+	272	771	771	1.0000000
C6	29211610	29212974	BolC6t38067H	0	-	375	1323	1364	0.9699414
C6	29255339	29257556	BolC6t38068H	0	+	743	1791	2217	0.8078485
C6	29262457	29264023	BolC6t38069H	0	+	926	1566	1566	1.0000000
C6	29264165	29272637	BolC6t38070H	0	+	4969	7963	8472	0.9399197
C6	29279375	29282273	BolC6t38071H	0	+	1495	2866	2898	0.9889579
C6	29282732	29285008	BolC6t38072H	0	-	1571	2276	2276	1.0000000
C6	29291053	29292895	BolC6t38073H	0	-	714	1817	1842	0.9864278
C6	29294309	29294978	BolC6t38074H	0	+	191	565	669	0.8445441
C6	29302224	29303506	BolC6t38075H	0	+	321	1282	1282	1.0000000
C6	29307968	29310027	BolC6t38076H	0	+	1521	1977	2059	0.9601749
C6	29311272	29313562	BolC6t38077H	0	+	903	2290	2290	1.0000000
C6	29314116	29320520	BolC6t38078H	0	-	2957	6239	6404	0.9742349
C6	29323155	29323674	BolC6t38079H	0	-	264	519	519	1.0000000
C6	29325485	29327511	BolC6t38080H	0	-	652	2026	2026	1.0000000
C6	29331752	29333117	BolC6t38081H	0	-	1461	1365	1365	1.0000000
C6	29333975	29339294	BolC6t38082H	0	-	1240	4611	5319	0.8668923
C6	29355753	29357637	BolC6t38083H	0	-	300	1880	1884	0.9978769
C6	29358223	29358589	BolC6t38084H	0	-	314	366	366	1.0000000
C6	29359880	29361004	BolC6t38085H	0	-	362	1124	1124	1.0000000
C6	29363043	29363151	BolC6t38086H	0	-	52	108	108	1.0000000
C6	29364327	29364994	BolC6t38087H	0	-	269	667	667	1.0000000
C6	29369624	29371013	BolC6t38088H	0	+	544	1389	1389	1.0000000
C6	29375773	29376358	BolC6t38089H	0	+	428	585	585	1.0000000
C6	29377042	29379601	BolC6t38090H	0	-	1045	2503	2559	0.9781165
C6	29381256	29381556	BolC6t38091H	0	-	97	300	300	1.0000000
C6	29383291	29383450	BolC6t38092H	0	-	9	155	159	0.9748428
C6	29386967	29387255	BolC6t38093H	0	-	250	288	288	1.0000000
C6	29391975	29394766	BolC6t38094H	0	-	888	2781	2791	0.9964170
C6	29401682	29402279	BolC6t38095H	0	-	353	597	597	1.0000000
C6	29405570	29406233	BolC6t38096H	0	+	328	663	663	1.0000000
C6	29407388	29408194	BolC6t38097H	0	+	522	806	806	1.0000000
C6	29424631	29427437	BolC6t38098H	0	+	1300	2806	2806	1.0000000
C6	29430849	29431350	BolC6t38099H	0	+	585	501	501	1.0000000
C6	29432944	29433196	BolC6t38100H	0	+	508	252	252	1.0000000
C6	29454971	29455566	BolC6t38101H	0	+	323	595	595	1.0000000
C6	29464475	29465573	BolC6t38102H	0	-	166	929	1098	0.8460838
C6	29467291	29475828	BolC6t38103H	0	-	3836	8165	8537	0.9564250
C6	29468883	29469389	BolC6t38104H	0	+	282	506	506	1.0000000
C6	29479243	29483386	BolC6t38105H	0	-	1971	3852	4143	0.9297611
C6	29484154	29486543	BolC6t38106H	0	-	1626	2333	2389	0.9765592
C6	29487197	29491387	BolC6t38107H	0	+	1155	3815	4190	0.9105012
C6	29492189	29493768	BolC6t38108H	0	+	662	1329	1579	0.8416719
C6	29494146	29495729	BolC6t38109H	0	-	601	1560	1583	0.9854707
C6	29496887	29497914	BolC6t38110H	0	+	1091	1027	1027	1.0000000
C6	29511040	29511853	BolC6t38111H	0	+	233	813	813	1.0000000
C6	29516696	29517377	BolC6t38112H	0	-	41	530	681	0.7782673
C6	29521117	29522323	BolC6t38113H	0	+	1040	1134	1206	0.9402985
C6	29525255	29527622	BolC6t38114H	0	+	952	2307	2367	0.9746515
C6	29535839	29535965	BolC6t38115H	0	+	87	126	126	1.0000000
C6	29536371	29538731	BolC6t38116H	0	+	563	2235	2360	0.9470339
C6	29541895	29543432	BolC6t38117H	0	-	26	611	1537	0.3975277
C6	29545726	29548603	BolC6t38118H	0	+	1345	2861	2877	0.9944386
C6	29548773	29549754	BolC6t38119H	0	+	1374	981	981	1.0000000
C6	29548939	29549571	BolC6t38120H	0	+	1011	632	632	1.0000000
C6	29550717	29553522	BolC6t38121H	0	-	1461	2716	2805	0.9682710
C6	29600780	29603738	BolC6t38122H	0	+	2267	2958	2958	1.0000000
C6	29603975	29605459	BolC6t38123H	0	-	1308	1484	1484	1.0000000
C6	29609429	29610266	BolC6t38124H	0	+	713	837	837	1.0000000
C6	29611063	29613597	BolC6t38125H	0	+	1990	2534	2534	1.0000000
C6	29613796	29614454	BolC6t38126H	0	-	303	658	658	1.0000000
C6	29615905	29618047	BolC6t38127H	0	-	615	2142	2142	1.0000000
C6	29625573	29626647	BolC6t38128H	0	+	466	1074	1074	1.0000000
C6	29627328	29629709	BolC6t38129H	0	-	888	2357	2381	0.9899202
C6	29635809	29637672	BolC6t38130H	0	+	140	1468	1863	0.7879764
C6	29640376	29643393	BolC6t38131H	0	+	1994	2690	3017	0.8916142
C6	29651729	29656122	BolC6t38132H	0	-	1343	3912	4393	0.8905076
C6	29664116	29678093	BolC6t38133H	0	+	3013	8875	13977	0.6349717
C6	29680219	29680807	BolC6t38134H	0	-	1433	588	588	1.0000000
C6	29681618	29684022	BolC6t38135H	0	+	1560	2284	2404	0.9500832
C6	29693228	29695866	BolC6t38136H	0	+	1337	2638	2638	1.0000000
C6	29696915	29700759	BolC6t38137H	0	+	2332	3835	3844	0.9976587
C6	29703724	29710702	BolC6t38138H	0	+	2325	6466	6978	0.9266266
C6	29714532	29715748	BolC6t38139H	0	+	41	514	1216	0.4226974
C6	29719543	29721989	BolC6t38140H	0	+	867	2178	2446	0.8904334
C6	29724338	29728803	BolC6t38141H	0	+	1504	4176	4465	0.9352744
C6	29729159	29733982	BolC6t38142H	0	-	1374	4742	4823	0.9832055
C6	29734656	29736620	BolC6t38143H	0	+	1250	1964	1964	1.0000000
C6	29737404	29752773	BolC6t38144H	0	+	997	4554	15369	0.2963108
C6	29756408	29759329	BolC6t38145H	0	+	2069	2921	2921	1.0000000
C6	29763746	29764689	BolC6t38146H	0	+	328	833	943	0.8833510
C6	29765270	29767840	BolC6t38147H	0	-	1535	2570	2570	1.0000000
C6	29768439	29770908	BolC6t38148H	0	-	761	2294	2469	0.9291211
C6	29771803	29773933	BolC6t38149H	0	-	525	1774	2130	0.8328639
C6	29790910	29792406	BolC6t38150H	0	+	124	1178	1496	0.7874331
C6	29829393	29829703	BolC6t38151H	0	-	372	310	310	1.0000000
C6	29832227	29833837	BolC6t38152H	0	+	878	1504	1610	0.9341615
C6	29845972	29846878	BolC6t38153H	0	+	472	906	906	1.0000000
C6	29847225	29849245	BolC6t38154H	0	-	1168	2020	2020	1.0000000
C6	29854508	29854746	BolC6t38155H	0	-	72	236	238	0.9915966
C6	29869981	29871243	BolC6t38156H	0	-	263	940	1262	0.7448494
C6	29876934	29889685	BolC6t38157H	0	+	602	6969	12751	0.5465454
C6	29890067	29892445	BolC6t38158H	0	-	705	2286	2378	0.9613121
C6	29894987	29895224	BolC6t38159H	0	+	96	237	237	1.0000000
C6	29900925	29903450	BolC6t38160H	0	-	996	2440	2525	0.9663366
C6	29904153	29905879	BolC6t38161H	0	+	854	1709	1726	0.9901506
C6	29906677	29907594	BolC6t38162H	0	-	73	446	917	0.4863686
C6	29920565	29921299	BolC6t38163H	0	+	74	594	734	0.8092643
C6	29938639	29938777	BolC6t38164H	0	+	153	138	138	1.0000000
C6	29940597	29941495	BolC6t38165H	0	+	565	898	898	1.0000000
C6	29950752	29952026	BolC6t38166H	0	+	438	1101	1274	0.8642072
C6	29952774	29953203	BolC6t38167H	0	+	140	417	429	0.9720280
C6	29955086	29955496	BolC6t38168H	0	+	3565	410	410	1.0000000
C6	29957041	29958205	BolC6t38169H	0	+	1544	1081	1164	0.9286941
C6	29958393	29958546	BolC6t38170H	0	+	93	153	153	1.0000000
C6	29969832	29974342	BolC6t38171H	0	+	1449	4460	4510	0.9889135
C6	29980879	29983264	BolC6t38172H	0	+	1407	2156	2385	0.9039832
C6	29991018	29991444	BolC6t38173H	0	+	49	351	426	0.8239437
C6	30018697	30019113	BolC6t38174H	0	-	321	416	416	1.0000000
C6	30023260	30024247	BolC6t38175H	0	-	717	987	987	1.0000000
C6	30041601	30041787	BolC6t38176H	0	+	1	6	186	0.0322581
C6	30042558	30045425	BolC6t38177H	0	+	1071	2131	2867	0.7432857
C6	30047258	30047836	BolC6t38178H	0	-	407	578	578	1.0000000
C6	30048664	30049347	BolC6t38179H	0	-	440	683	683	1.0000000
C6	30051196	30052084	BolC6t38180H	0	-	139	888	888	1.0000000
C6	30053403	30054172	BolC6t38181H	0	+	519	769	769	1.0000000
C6	30055046	30057598	BolC6t38182H	0	+	1124	2359	2552	0.9243730
C6	30057818	30058442	BolC6t38183H	0	-	330	624	624	1.0000000
C6	30060919	30063247	BolC6t38184H	0	+	1095	2270	2328	0.9750859
C6	30073148	30075708	BolC6t38185H	0	+	749	2560	2560	1.0000000
C6	30076098	30077883	BolC6t38186H	0	+	1579	1785	1785	1.0000000
C6	30079323	30079947	BolC6t38187H	0	+	127	588	624	0.9423077
C6	30098385	30098487	BolC6t38188H	0	+	0	0	102	0.0000000
C6	30098551	30099107	BolC6t38189H	0	+	4	73	556	0.1312950
C6	30100262	30100397	BolC6t38190H	0	+	45	135	135	1.0000000
C6	30106703	30108135	BolC6t38191H	0	+	125	1270	1432	0.8868715
C6	30118310	30119870	BolC6t38192H	0	+	276	1381	1560	0.8852564
C6	30124659	30132632	BolC6t38193H	0	+	4355	7835	7973	0.9826916
C6	30125491	30126226	BolC6t38194H	0	+	388	735	735	1.0000000
C6	30133051	30136495	BolC6t38195H	0	-	3471	3444	3444	1.0000000
C6	30154073	30155054	BolC6t38196H	0	+	558	948	981	0.9663609
C6	30155640	30158330	BolC6t38197H	0	+	2266	2653	2690	0.9862453
C6	30159696	30163619	BolC6t38198H	0	-	1857	3643	3923	0.9286261
C6	30164063	30165174	BolC6t38199H	0	+	976	1111	1111	1.0000000
C6	30165929	30167528	BolC6t38200H	0	-	1560	1599	1599	1.0000000
C6	30186761	30202614	BolC6t38201H	0	+	4368	10865	15853	0.6853592
C6	30213339	30214716	BolC6t38202H	0	+	204	1191	1377	0.8649238
C6	30228406	30228751	BolC6t38203H	0	+	31	166	345	0.4811594
C6	30234815	30235732	BolC6t38204H	0	-	4	20	917	0.0218103
C6	30243021	30243628	BolC6t38205H	0	-	877	607	607	1.0000000
C6	30245656	30247479	BolC6t38206H	0	+	228	1424	1823	0.7811300
C6	30247761	30249458	BolC6t38207H	0	-	254	1302	1697	0.7672363
C6	30252927	30253122	BolC6t38208H	0	-	103	195	195	1.0000000
C6	30256592	30257552	BolC6t38209H	0	-	126	626	960	0.6520833
C6	30267895	30269311	BolC6t38210H	0	-	1719	1416	1416	1.0000000
C6	30270613	30270793	BolC6t38211H	0	+	182	180	180	1.0000000
C6	30285642	30285960	BolC6t38212H	0	-	64	243	318	0.7641509
C6	30297228	30298549	BolC6t38213H	0	+	685	1309	1321	0.9909160
C6	30304072	30304546	BolC6t38214H	0	-	33	382	474	0.8059072
C6	30308258	30309225	BolC6t38215H	0	+	362	895	967	0.9255429
C6	30321633	30322546	BolC6t38216H	0	+	828	913	913	1.0000000
C6	30323413	30330800	BolC6t38217H	0	+	3544	7266	7387	0.9836199
C6	30327448	30327817	BolC6t38218H	0	-	58	369	369	1.0000000
C6	30352696	30353557	BolC6t38219H	0	+	732	861	861	1.0000000
C6	30356902	30358383	BolC6t38220H	0	-	941	1402	1481	0.9466577
C6	30362625	30364263	BolC6t38221H	0	+	236	1023	1638	0.6245421
C6	30365299	30368958	BolC6t38222H	0	-	3167	3659	3659	1.0000000
C6	30390953	30391109	BolC6t38223H	0	+	147	156	156	1.0000000
C6	30401004	30404111	BolC6t38224H	0	+	1794	3095	3107	0.9961377
C6	30404546	30406662	BolC6t38225H	0	-	1087	2045	2116	0.9664461
C6	30408176	30408687	BolC6t38226H	0	+	145	511	511	1.0000000
C6	30409381	30414861	BolC6t38227H	0	+	2128	4743	5480	0.8655109
C6	30419435	30420246	BolC6t38228H	0	-	151	744	811	0.9173859
C6	30439632	30440292	BolC6t38229H	0	+	263	585	660	0.8863636
C6	30441546	30441891	BolC6t38230H	0	+	51	345	345	1.0000000
C6	30460587	30462799	BolC6t38231H	0	+	1122	2196	2212	0.9927667
C6	30467124	30468171	BolC6t38232H	0	-	470	1047	1047	1.0000000
C6	30477365	30478370	BolC6t38233H	0	-	402	1005	1005	1.0000000
C6	30517389	30518012	BolC6t38234H	0	-	162	595	623	0.9550562
C6	30520143	30522418	BolC6t38235H	0	+	147	1365	2275	0.6000000
C6	30520371	30520899	BolC6t38236H	0	+	8	218	528	0.4128788
C6	30539249	30540204	BolC6t38237H	0	+	548	955	955	1.0000000
C6	30558734	30559418	BolC6t38238H	0	-	472	684	684	1.0000000
C6	30566829	30567210	BolC6t38239H	0	-	4	168	381	0.4409449
C6	30575767	30577027	BolC6t38240H	0	+	242	1103	1260	0.8753968
C6	30578063	30579799	BolC6t38241H	0	+	230	1721	1736	0.9913595
C6	30586574	30587526	BolC6t38242H	0	+	27	506	952	0.5315126
C6	30594129	30594375	BolC6t38243H	0	+	13	246	246	1.0000000
C6	30599565	30600336	BolC6t38244H	0	+	605	771	771	1.0000000
C6	30614233	30614611	BolC6t38245H	0	+	70	378	378	1.0000000
C6	30636187	30639561	BolC6t38246H	0	+	1341	3183	3374	0.9433906
C6	30661508	30664245	BolC6t38247H	0	-	1233	2605	2737	0.9517720
C6	30664850	30666067	BolC6t38248H	0	-	901	1217	1217	1.0000000
C6	30666602	30667892	BolC6t38249H	0	-	607	1290	1290	1.0000000
C6	30672698	30675154	BolC6t38250H	0	+	515	1971	2456	0.8025244
C6	30688634	30689430	BolC6t38251H	0	+	260	730	796	0.9170854
C6	30694667	30696691	BolC6t38252H	0	+	687	1836	2024	0.9071146
C6	30699951	30700690	BolC6t38253H	0	+	388	739	739	1.0000000
C6	30704315	30706437	BolC6t38254H	0	-	43	290	2122	0.1366635
C6	30724133	30728876	BolC6t38255H	0	-	596	3057	4743	0.6445288
C6	30729638	30736915	BolC6t38256H	0	-	676	4910	7277	0.6747286
C6	30737017	30737742	BolC6t38257H	0	-	9	364	725	0.5020689
C6	30737913	30739367	BolC6t38258H	0	-	79	562	1454	0.3865199
C6	30745937	30748790	BolC6t38259H	0	+	932	2510	2853	0.8797757
C6	30750700	30751158	BolC6t38260H	0	+	151	427	458	0.9323144
C6	30752041	30755080	BolC6t38261H	0	-	498	2161	3039	0.7110892
C6	30791553	30793837	BolC6t38262H	0	-	1870	2104	2284	0.9211909
C6	30803187	30805205	BolC6t38263H	0	+	766	2018	2018	1.0000000
C6	30805791	30812930	BolC6t38264H	0	-	937	4985	7139	0.6982771
C6	30821511	30821721	BolC6t38265H	0	-	320	210	210	1.0000000
C6	30821843	30822056	BolC6t38266H	0	-	245	213	213	1.0000000
C6	30826864	30835179	BolC6t38267H	0	-	1178	6023	8315	0.7243536
C6	30838303	30838735	BolC6t38268H	0	+	235	419	432	0.9699074
C6	30862192	30863590	BolC6t38269H	0	+	371	1333	1398	0.9535050
C6	30868340	30868472	BolC6t38270H	0	+	46	132	132	1.0000000
C6	30869101	30872701	BolC6t38271H	0	-	1078	3196	3600	0.8877778
C6	30873372	30873555	BolC6t38272H	0	-	95	183	183	1.0000000
C6	30875345	30877319	BolC6t38273H	0	+	1356	1737	1974	0.8799392
C6	30877982	30879071	BolC6t38274H	0	-	814	1089	1089	1.0000000
C6	30889231	30889927	BolC6t38275H	0	-	586	696	696	1.0000000
C6	30897037	30897355	BolC6t38276H	0	-	3	113	318	0.3553459
C6	30911301	30913234	BolC6t38277H	0	-	254	1804	1933	0.9332644
C6	30915029	30916822	BolC6t38278H	0	-	321	1529	1793	0.8527607
C6	30921422	30921818	BolC6t38279H	0	+	92	156	396	0.3939394
C6	30922756	30926300	BolC6t38280H	0	+	706	2569	3544	0.7248871
C6	30932365	30932951	BolC6t38281H	0	+	444	586	586	1.0000000
C6	30933815	30935752	BolC6t38282H	0	-	751	1509	1937	0.7790397
C6	30941472	30943781	BolC6t38283H	0	-	482	1329	2309	0.5755739
C6	30944331	30944481	BolC6t38284H	0	+	212	150	150	1.0000000
C6	30948042	30950055	BolC6t38285H	0	-	582	1764	2013	0.8763040
C6	30952397	30953549	BolC6t38286H	0	+	277	1008	1152	0.8750000
C6	30954023	30958402	BolC6t38287H	0	+	2900	4379	4379	1.0000000
C6	30964376	30965644	BolC6t38288H	0	+	698	1268	1268	1.0000000
C6	30984038	30984626	BolC6t38289H	0	+	488	588	588	1.0000000
C6	30985962	30986193	BolC6t38290H	0	-	235	231	231	1.0000000
C6	30997391	30998104	BolC6t38291H	0	+	48	521	713	0.7307153
C6	31000982	31001945	BolC6t38292H	0	-	20	538	963	0.5586708
C6	31006359	31006758	BolC6t38293H	0	-	81	338	399	0.8471178
C6	31023741	31024038	BolC6t38294H	0	+	7	90	297	0.3030303
C6	31024448	31024670	BolC6t38295H	0	-	8	193	222	0.8693694
C6	31028971	31029256	BolC6t38296H	0	-	80	285	285	1.0000000
C6	31032006	31032315	BolC6t38297H	0	+	1	42	309	0.1359223
C6	31033795	31034855	BolC6t38298H	0	+	639	1060	1060	1.0000000
C6	31042454	31042667	BolC6t38299H	0	+	397	213	213	1.0000000
C6	31052985	31057765	BolC6t38300H	0	-	2238	4269	4780	0.8930962
C6	31067731	31068844	BolC6t38301H	0	+	2783	1113	1113	1.0000000
C6	31082010	31083117	BolC6t38302H	0	-	115	945	1107	0.8536586
C6	31132149	31134609	BolC6t38303H	0	+	1039	2396	2460	0.9739838
C6	31151703	31154003	BolC6t38304H	0	-	205	1880	2300	0.8173913
C6	31173657	31174614	BolC6t38305H	0	-	74	543	957	0.5673981
C6	31176243	31177227	BolC6t38306H	0	+	394	984	984	1.0000000
C6	31177531	31183602	BolC6t38307H	0	-	936	4226	6071	0.6960962
C6	31200674	31202366	BolC6t38308H	0	+	537	1377	1692	0.8138298
C6	31203104	31203518	BolC6t38309H	0	-	271	414	414	1.0000000
C6	31204971	31207263	BolC6t38310H	0	-	2085	2292	2292	1.0000000
C6	31208771	31210453	BolC6t38311H	0	+	637	1682	1682	1.0000000
C6	31215469	31217170	BolC6t38312H	0	+	665	1662	1701	0.9770723
C6	31229094	31229634	BolC6t38313H	0	+	109	494	540	0.9148148
C6	31259111	31259786	BolC6t38314H	0	-	182	675	675	1.0000000
C6	31265102	31267843	BolC6t38315H	0	+	1173	2662	2741	0.9711784
C6	31274532	31275709	BolC6t38316H	0	+	3556	1177	1177	1.0000000
C6	31279701	31280453	BolC6t38317H	0	+	144	701	752	0.9321808
C6	31288365	31288992	BolC6t38318H	0	-	658	627	627	1.0000000
C6	31298589	31299477	BolC6t38319H	0	-	294	888	888	1.0000000
C6	31303516	31303870	BolC6t38320H	0	+	192	354	354	1.0000000
C6	31303949	31304176	BolC6t38321H	0	+	27	227	227	1.0000000
C6	31306193	31307578	BolC6t38322H	0	+	736	1385	1385	1.0000000
C6	31307966	31308813	BolC6t38323H	0	+	155	840	847	0.9917355
C6	31314387	31315775	BolC6t38324H	0	+	1599	1316	1388	0.9481268
C6	31321863	31323662	BolC6t38325H	0	-	519	1656	1799	0.9205114
C6	31332532	31333402	BolC6t38326H	0	-	208	844	870	0.9701149
C6	31355957	31356519	BolC6t38327H	0	+	205	539	562	0.9590747
C6	31357597	31357885	BolC6t38328H	0	-	438	288	288	1.0000000
C6	31363495	31367249	BolC6t38329H	0	+	724	2722	3754	0.7250932
C6	31370556	31370751	BolC6t38330H	0	-	12	184	195	0.9435897
C6	31371968	31372526	BolC6t38331H	0	-	56	245	558	0.4390681
C6	31383929	31384935	BolC6t38332H	0	-	544	1006	1006	1.0000000
C6	31385291	31386403	BolC6t38333H	0	+	678	1112	1112	1.0000000
C6	31388093	31390845	BolC6t38334H	0	+	238	1901	2752	0.6907703
C6	31413443	31413716	BolC6t38335H	0	+	200	273	273	1.0000000
C6	31415995	31419080	BolC6t38336H	0	+	2302	3082	3085	0.9990276
C6	31421659	31423637	BolC6t38337H	0	+	1646	1978	1978	1.0000000
C6	31425080	31427647	BolC6t38338H	0	+	1475	2567	2567	1.0000000
C6	31431859	31435470	BolC6t38339H	0	-	2109	3528	3611	0.9770147
C6	31438415	31438945	BolC6t38340H	0	-	336	530	530	1.0000000
C6	31439845	31440381	BolC6t38341H	0	-	127	536	536	1.0000000
C6	31460771	31461505	BolC6t38342H	0	+	363	713	734	0.9713897
C6	31462446	31462662	BolC6t38343H	0	-	59	216	216	1.0000000
C6	31486038	31486576	BolC6t38344H	0	-	44	330	538	0.6133829
C6	31487141	31487988	BolC6t38345H	0	-	1328	847	847	1.0000000
C6	31494342	31494576	BolC6t38346H	0	+	294	234	234	1.0000000
C6	31497819	31498998	BolC6t38347H	0	+	779	1179	1179	1.0000000
C6	31500551	31501440	BolC6t38348H	0	-	338	740	889	0.8323960
C6	31502230	31506767	BolC6t38349H	0	-	789	3039	4537	0.6698259
C6	31529329	31532066	BolC6t38350H	0	-	517	2226	2737	0.8132992
C6	31553399	31556639	BolC6t38351H	0	-	2513	3239	3240	0.9996914
C6	31559102	31560235	BolC6t38352H	0	-	902	1133	1133	1.0000000
C6	31568938	31569693	BolC6t38353H	0	-	54	627	755	0.8304636
C6	31569825	31570278	BolC6t38354H	0	-	113	453	453	1.0000000
C6	31573719	31583147	BolC6t38355H	0	-	4452	9079	9428	0.9629826
C6	31588303	31588465	BolC6t38356H	0	+	15	162	162	1.0000000
C6	31589159	31591033	BolC6t38357H	0	-	483	1826	1874	0.9743863
C6	31590747	31590972	BolC6t38358H	0	+	68	225	225	1.0000000
C6	31596136	31596458	BolC6t38359H	0	-	82	300	322	0.9316770
C6	31609351	31610510	BolC6t38360H	0	+	688	1159	1159	1.0000000
C6	31612023	31612146	BolC6t38361H	0	-	192	123	123	1.0000000
C6	31612779	31613242	BolC6t38362H	0	+	58	447	463	0.9654428
C6	31613747	31613954	BolC6t38363H	0	+	6	138	207	0.6666667
C6	31615152	31616274	BolC6t38364H	0	+	602	1116	1122	0.9946524
C6	31618061	31619315	BolC6t38365H	0	+	472	1237	1254	0.9864434
C6	31622875	31623103	BolC6t38366H	0	+	233	228	228	1.0000000
C6	31636001	31636468	BolC6t38367H	0	+	148	403	467	0.8629550
C6	31640121	31640425	BolC6t38368H	0	+	258	304	304	1.0000000
C6	31640658	31641365	BolC6t38369H	0	+	297	707	707	1.0000000
C6	31642518	31643141	BolC6t38370H	0	+	530	623	623	1.0000000
C6	31644821	31645094	BolC6t38371H	0	-	334	273	273	1.0000000
C6	31665845	31666525	BolC6t38372H	0	-	741	680	680	1.0000000
C6	31670982	31671309	BolC6t38373H	0	-	0	0	327	0.0000000
C6	31677842	31678322	BolC6t38374H	0	+	32	338	480	0.7041667
C6	31681241	31682552	BolC6t38375H	0	-	181	859	1311	0.6552250
C6	31693526	31694264	BolC6t38376H	0	-	130	606	738	0.8211382
C6	31718375	31718885	BolC6t38377H	0	-	0	0	510	0.0000000
C6	31739087	31740429	BolC6t38378H	0	+	173	812	1342	0.6050671
C6	31744872	31746268	BolC6t38379H	0	+	845	1396	1396	1.0000000
C6	31757614	31761689	BolC6t38380H	0	+	9168	4024	4075	0.9874846
C6	31768311	31770678	BolC6t38381H	0	+	1622	2367	2367	1.0000000
C6	31776462	31777077	BolC6t38382H	0	-	457	615	615	1.0000000
C6	31800661	31802708	BolC6t38383H	0	+	1411	2047	2047	1.0000000
C6	31804136	31804337	BolC6t38384H	0	-	365	201	201	1.0000000
C6	31819412	31822411	BolC6t38385H	0	-	1248	2999	2999	1.0000000
C6	31819738	31821250	BolC6t38386H	0	-	708	1512	1512	1.0000000
C6	31821355	31822068	BolC6t38387H	0	-	200	713	713	1.0000000
C6	31825387	31825918	BolC6t38388H	0	-	34	365	531	0.6873823
C6	31839679	31839869	BolC6t38389H	0	+	276	190	190	1.0000000
C6	31841407	31842528	BolC6t38390H	0	-	75	856	1121	0.7636039
C6	31845863	31849251	BolC6t38391H	0	+	1672	3368	3388	0.9940968
C6	31852229	31853910	BolC6t38392H	0	+	556	1517	1681	0.9024390
C6	31862978	31863260	BolC6t38393H	0	+	51	111	282	0.3936170
C6	31869337	31870222	BolC6t38394H	0	-	422	885	885	1.0000000
C6	31883220	31884285	BolC6t38395H	0	-	379	1065	1065	1.0000000
C6	31892847	31895720	BolC6t38396H	0	+	952	2734	2873	0.9516185
C6	31896683	31902692	BolC6t38397H	0	-	2355	5210	6009	0.8670328
C6	31909811	31912444	BolC6t38398H	0	+	1360	2618	2633	0.9943030
C6	31916428	31918076	BolC6t38399H	0	+	1283	1648	1648	1.0000000
C6	31918813	31919077	BolC6t38400H	0	-	193	264	264	1.0000000
C6	31919856	31927736	BolC6t38401H	0	-	1474	3659	7880	0.4643401
C6	31933729	31935975	BolC6t38402H	0	-	1266	2083	2246	0.9274265
C6	31938596	31940345	BolC6t38403H	0	+	632	1648	1749	0.9422527
C6	31941360	31941801	BolC6t38404H	0	+	147	441	441	1.0000000
C6	31942451	31943951	BolC6t38405H	0	+	934	1500	1500	1.0000000
C6	31944304	31945785	BolC6t38406H	0	+	478	1176	1481	0.7940581
C6	31947255	31948801	BolC6t38407H	0	-	470	1353	1546	0.8751617
C6	31951393	31952229	BolC6t38408H	0	-	465	836	836	1.0000000
C6	31971813	31972340	BolC6t38409H	0	+	199	479	527	0.9089184
C6	31972768	31973393	BolC6t38410H	0	-	203	298	625	0.4768000
C6	31973820	31974145	BolC6t38411H	0	-	244	325	325	1.0000000
C6	31990044	31990385	BolC6t38412H	0	-	136	341	341	1.0000000
C6	31995236	31995554	BolC6t38413H	0	+	190	318	318	1.0000000
C6	31999046	31999163	BolC6t38414H	0	-	342	117	117	1.0000000
C6	32000301	32001523	BolC6t38415H	0	-	1039	1222	1222	1.0000000
C6	32006068	32007079	BolC6t38416H	0	+	671	1011	1011	1.0000000
C6	32010862	32022950	BolC6t38417H	0	-	1886	6013	12088	0.4974355
C6	32028386	32031513	BolC6t38418H	0	+	1031	2963	3127	0.9475536
C6	32034814	32035990	BolC6t38419H	0	+	232	954	1176	0.8112245
C6	32038403	32039152	BolC6t38420H	0	-	213	749	749	1.0000000
C6	32042057	32042651	BolC6t38421H	0	-	428	594	594	1.0000000
C6	32053823	32057055	BolC6t38422H	0	+	2351	3183	3232	0.9848391
C6	32057755	32067340	BolC6t38423H	0	+	2812	5044	9585	0.5262389
C6	32068295	32069443	BolC6t38424H	0	+	1280	1148	1148	1.0000000
C6	32070712	32072194	BolC6t38425H	0	+	346	1465	1482	0.9885290
C6	32072951	32073641	BolC6t38426H	0	+	378	690	690	1.0000000
C6	32075081	32077566	BolC6t38427H	0	+	582	2294	2485	0.9231389
C6	32079473	32081603	BolC6t38428H	0	-	1162	2130	2130	1.0000000
C6	32083542	32086035	BolC6t38429H	0	-	337	1958	2493	0.7853991
C6	32088442	32091577	BolC6t38430H	0	-	334	2466	3135	0.7866029
C6	32100191	32104310	BolC6t38431H	0	-	2480	4008	4119	0.9730517
C6	32109239	32110853	BolC6t38432H	0	+	950	1614	1614	1.0000000
C6	32111328	32119897	BolC6t38433H	0	-	3472	6975	8569	0.8139806
C6	32141146	32141440	BolC6t38434H	0	+	1	44	294	0.1496599
C6	32147751	32149143	BolC6t38435H	0	-	267	1242	1392	0.8922414
C6	32157546	32157687	BolC6t38436H	0	+	204	141	141	1.0000000
C6	32203441	32218345	BolC6t38437H	0	+	7010	14904	14904	1.0000000
C6	32221185	32222682	BolC6t38438H	0	-	98	774	1497	0.5170341
C6	32224930	32226214	BolC6t38439H	0	-	732	1252	1284	0.9750779
C6	32242900	32243268	BolC6t38440H	0	+	87	290	368	0.7880435
C6	32246269	32248249	BolC6t38441H	0	+	829	1851	1980	0.9348485
C6	32251073	32252864	BolC6t38442H	0	+	235	867	1791	0.4840871
C6	32253342	32253815	BolC6t38443H	0	-	191	473	473	1.0000000
C6	32255931	32256072	BolC6t38444H	0	+	70	141	141	1.0000000
C6	32268446	32270246	BolC6t38445H	0	-	482	1800	1800	1.0000000
C6	32271517	32271906	BolC6t38446H	0	-	570	389	389	1.0000000
C6	32272182	32272930	BolC6t38447H	0	-	111	748	748	1.0000000
C6	32274414	32275789	BolC6t38448H	0	-	622	1375	1375	1.0000000
C6	32276230	32278406	BolC6t38449H	0	-	905	2176	2176	1.0000000
C6	32281920	32282432	BolC6t38450H	0	+	132	512	512	1.0000000
C6	32285566	32317361	BolC6t38451H	0	-	17429	25783	31795	0.8109137
C6	32341164	32341635	BolC6t38452H	0	+	159	471	471	1.0000000
C6	32374963	32376540	BolC6t38453H	0	+	258	969	1577	0.6144578
C6	32377119	32379572	BolC6t38454H	0	-	1397	2453	2453	1.0000000
C6	32380002	32381373	BolC6t38455H	0	-	107	768	1371	0.5601751
C6	32383836	32384535	BolC6t38456H	0	+	526	699	699	1.0000000
C6	32386321	32389434	BolC6t38457H	0	+	1298	3085	3113	0.9910055
C6	32390218	32391073	BolC6t38458H	0	+	557	855	855	1.0000000
C6	32399134	32401641	BolC6t38459H	0	-	357	1849	2507	0.7375349
C6	32403870	32405131	BolC6t38460H	0	-	168	1072	1261	0.8501189
C6	32405775	32410410	BolC6t38461H	0	+	1593	4635	4635	1.0000000
C6	32410855	32412457	BolC6t38462H	0	-	766	1552	1602	0.9687890
C6	32415114	32416081	BolC6t38463H	0	+	91	831	967	0.8593588
C6	32416256	32418139	BolC6t38464H	0	-	1509	1883	1883	1.0000000
C6	32440431	32441745	BolC6t38465H	0	+	920	1314	1314	1.0000000
C6	32442240	32444134	BolC6t38466H	0	-	1055	1894	1894	1.0000000
C6	32444465	32477618	BolC6t38467H	0	+	14770	27687	33153	0.8351281
C6	32462738	32464670	BolC6t38468H	0	-	1990	1932	1932	1.0000000
C6	32478759	32482938	BolC6t38469H	0	+	2859	4048	4179	0.9686528
C6	32483303	32491836	BolC6t38470H	0	+	2150	6032	8533	0.7069026
C6	32517949	32518378	BolC6t38471H	0	-	158	382	429	0.8904429
C6	32536430	32538514	BolC6t38472H	0	-	996	2084	2084	1.0000000
C6	32545736	32546531	BolC6t38473H	0	+	145	704	795	0.8855346
C6	32547154	32547822	BolC6t38474H	0	+	776	625	668	0.9356288
C6	32566619	32568281	BolC6t38475H	0	+	302	1623	1662	0.9765343
C6	32570278	32570380	BolC6t38476H	0	+	145	102	102	1.0000000
C6	32577576	32578631	BolC6t38477H	0	-	830	1055	1055	1.0000000
C6	32582868	32597727	BolC6t38478H	0	-	2366	10080	14859	0.6783767
C6	32590475	32590878	BolC6t38479H	0	-	19	370	403	0.9181141
C6	32605127	32605577	BolC6t38480H	0	-	52	399	450	0.8866667
C6	32613406	32614465	BolC6t38481H	0	-	196	890	1059	0.8404155
C6	32651438	32651582	BolC6t38482H	0	+	144	144	144	1.0000000
C6	32663671	32664199	BolC6t38483H	0	-	0	0	528	0.0000000
C6	32687222	32688917	BolC6t38484H	0	+	390	1538	1695	0.9073746
C6	32690492	32691602	BolC6t38485H	0	-	0	0	1110	0.0000000
C6	32691954	32692524	BolC6t38486H	0	+	58	220	570	0.3859649
C6	32693114	32694217	BolC6t38487H	0	+	28	445	1103	0.4034452
C6	32710580	32714147	BolC6t38488H	0	+	346	1886	3567	0.5287356
C6	32720423	32723328	BolC6t38489H	0	-	1631	2844	2905	0.9790017
C6	32725957	32726667	BolC6t38490H	0	-	230	710	710	1.0000000
C6	32727421	32728834	BolC6t38491H	0	-	219	1209	1413	0.8556263
C6	32731525	32732079	BolC6t38492H	0	+	4	183	554	0.3303249
C6	32733702	32738489	BolC6t38493H	0	+	2669	3905	4787	0.8157510
C6	32739407	32741531	BolC6t38494H	0	+	1142	2019	2124	0.9505650
C6	32742282	32743512	BolC6t38495H	0	+	866	1134	1230	0.9219512
C6	32752788	32756439	BolC6t38496H	0	+	1988	3445	3651	0.9435771
C6	32757271	32758175	BolC6t38497H	0	-	306	520	904	0.5752212
C6	32766445	32766562	BolC6t38498H	0	-	65	117	117	1.0000000
C6	32773497	32774883	BolC6t38499H	0	+	892	1386	1386	1.0000000
C6	32776244	32778219	BolC6t38500H	0	+	811	1790	1975	0.9063291
C6	32779170	32780652	BolC6t38501H	0	-	839	1482	1482	1.0000000
C6	32781642	32784942	BolC6t38502H	0	+	2375	3296	3300	0.9987879
C6	32788882	32791816	BolC6t38503H	0	+	865	2780	2934	0.9475119
C6	32792558	32801317	BolC6t38504H	0	-	1554	4328	8759	0.4941203
C6	32802380	32803354	BolC6t38505H	0	+	726	974	974	1.0000000
C6	32814223	32815060	BolC6t38506H	0	-	3	18	837	0.0215054
C6	32831798	32836685	BolC6t38507H	0	-	3323	4871	4887	0.9967260
C6	32837086	32839595	BolC6t38508H	0	-	1139	2395	2509	0.9545636
C6	32839746	32840043	BolC6t38509H	0	-	221	297	297	1.0000000
C6	32842424	32843850	BolC6t38510H	0	-	467	1424	1426	0.9985975
C6	32847205	32847517	BolC6t38511H	0	-	364	312	312	1.0000000
C6	32852921	32853704	BolC6t38512H	0	+	317	783	783	1.0000000
C6	32872026	32873021	BolC6t38513H	0	+	510	983	995	0.9879397
C6	32883030	32883954	BolC6t38514H	0	+	268	924	924	1.0000000
C6	32886125	32889219	BolC6t38515H	0	-	1206	2603	3094	0.8413057
C6	32889862	32890259	BolC6t38516H	0	-	37	397	397	1.0000000
C6	32893539	32897865	BolC6t38517H	0	-	452	1314	4326	0.3037448
C6	32898458	32904955	BolC6t38518H	0	-	1415	5965	6497	0.9181160
C6	32907177	32910881	BolC6t38519H	0	+	602	3360	3704	0.9071274
C6	32913865	32916706	BolC6t38520H	0	+	922	2760	2841	0.9714889
C6	32921035	32922097	BolC6t38521H	0	+	642	1062	1062	1.0000000
C6	32924408	32925768	BolC6t38522H	0	+	800	1342	1360	0.9867647
C6	32926086	32928462	BolC6t38523H	0	+	1730	2314	2376	0.9739057
C6	32930885	32951103	BolC6t38524H	0	+	8548	16002	20218	0.7914730
C6	32952378	32952987	BolC6t38525H	0	+	505	609	609	1.0000000
C6	32956220	32957114	BolC6t38526H	0	-	3	163	894	0.1823266
C6	32957878	32959831	BolC6t38527H	0	+	797	1894	1953	0.9697900
C6	32963436	32964230	BolC6t38528H	0	+	479	794	794	1.0000000
C6	32966714	32967573	BolC6t38529H	0	-	793	859	859	1.0000000
C6	32972235	32973208	BolC6t38530H	0	+	3486	798	973	0.8201439
C6	32973685	32976155	BolC6t38531H	0	+	6779	2442	2470	0.9886640
C6	32978549	32978846	BolC6t38532H	0	+	216	291	297	0.9797980
C6	32983758	32984028	BolC6t38533H	0	-	174	259	270	0.9592593
C6	32994961	32996214	BolC6t38534H	0	+	436	1192	1253	0.9513168
C6	32997498	32998600	BolC6t38535H	0	+	75	733	1102	0.6651543
C6	33001812	33002083	BolC6t38536H	0	+	31	271	271	1.0000000
C6	33002150	33002541	BolC6t38537H	0	+	41	337	391	0.8618926
C6	33014800	33015654	BolC6t38538H	0	+	1208	854	854	1.0000000
C6	33017360	33018329	BolC6t38539H	0	-	250	921	969	0.9504644
C6	33019215	33022954	BolC6t38540H	0	-	1136	3575	3739	0.9561380
C6	33023255	33023756	BolC6t38541H	0	+	276	501	501	1.0000000
C6	33029023	33029257	BolC6t38542H	0	+	37	158	234	0.6752137
C6	33030067	33031483	BolC6t38543H	0	-	82	975	1416	0.6885593
C6	33052551	33055839	BolC6t38544H	0	-	391	2189	3288	0.6657543
C6	33055907	33057377	BolC6t38545H	0	-	214	1028	1470	0.6993197
C6	33062482	33068007	BolC6t38546H	0	+	3334	5174	5525	0.9364706
C6	33071425	33071603	BolC6t38547H	0	-	302	178	178	1.0000000
C6	33071752	33073795	BolC6t38548H	0	-	240	1688	2043	0.8262359
C6	33075256	33079013	BolC6t38549H	0	-	1170	3630	3757	0.9661964
C6	33084967	33086119	BolC6t38550H	0	-	228	1019	1152	0.8845486
C6	33086840	33090194	BolC6t38551H	0	+	388	2355	3354	0.7021467
C6	33090963	33096364	BolC6t38552H	0	-	707	2029	5401	0.3756712
C6	33099698	33104172	BolC6t38553H	0	+	2147	4301	4474	0.9613321
C6	33105665	33108655	BolC6t38554H	0	-	760	2189	2990	0.7321070
C6	33119505	33123767	BolC6t38555H	0	-	2406	3927	4262	0.9213984
C6	33126179	33146144	BolC6t38556H	0	-	4375	10051	19965	0.5034310
C6	33133265	33134475	BolC6t38557H	0	-	7	284	1210	0.2347107
C6	33136189	33137852	BolC6t38558H	0	-	13	346	1663	0.2080577
C6	33149501	33149846	BolC6t38559H	0	-	0	0	345	0.0000000
C6	33152721	33153147	BolC6t38560H	0	-	63	146	426	0.3427230
C6	33164037	33165702	BolC6t38561H	0	-	194	1291	1665	0.7753754
C6	33195282	33197396	BolC6t38562H	0	+	773	1910	2114	0.9035005
C6	33197985	33199038	BolC6t38563H	0	-	378	898	1053	0.8528015
C6	33202444	33252245	BolC6t38564H	0	+	26769	27464	49801	0.5514749
C6	33209149	33211040	BolC6t38565H	0	-	748	1557	1891	0.8233739
C6	33212878	33213472	BolC6t38566H	0	+	0	0	594	0.0000000
C6	33235698	33241168	BolC6t38567H	0	+	2215	3988	5470	0.7290676
C6	33242052	33243885	BolC6t38568H	0	-	1029	1833	1833	1.0000000
C6	33244554	33248472	BolC6t38569H	0	+	1675	3511	3918	0.8961205
C6	33253752	33255343	BolC6t38570H	0	-	1298	1591	1591	1.0000000
C6	33264099	33296244	BolC6t38571H	0	+	9162	24656	32145	0.7670244
C6	33292251	33292745	BolC6t38572H	0	-	23	366	494	0.7408907
C6	33298623	33299655	BolC6t38573H	0	-	151	961	1032	0.9312016
C6	33303649	33305254	BolC6t38574H	0	-	562	1463	1605	0.9115265
C6	33319067	33320113	BolC6t38575H	0	+	1566	985	1046	0.9416826
C6	33323101	33327276	BolC6t38576H	0	+	181	2072	4175	0.4962874
C6	33333001	33333843	BolC6t38577H	0	+	31	821	842	0.9750594
C6	33336305	33355824	BolC6t38578H	0	+	1316	10771	19519	0.5518213
C6	33346341	33350467	BolC6t38579H	0	+	260	2122	4126	0.5142996
C6	33352257	33353274	BolC6t38580H	0	+	148	1014	1017	0.9970502
C6	33354959	33355977	BolC6t38581H	0	+	110	667	1018	0.6552063
C6	33357659	33358675	BolC6t38582H	0	+	222	1016	1016	1.0000000
C6	33361566	33362308	BolC6t38583H	0	+	1197	742	742	1.0000000
C6	33363571	33366388	BolC6t38584H	0	-	310	2402	2817	0.8526801
C6	33368651	33369408	BolC6t38585H	0	-	215	738	757	0.9749009
C6	33376794	33378110	BolC6t38586H	0	-	47	683	1316	0.5189970
C6	33379534	33380158	BolC6t38587H	0	+	29	226	624	0.3621795
C6	33395800	33397243	BolC6t38588H	0	+	38	667	1443	0.4622315
C6	33398197	33399142	BolC6t38589H	0	-	166	858	945	0.9079365
C6	33400107	33401574	BolC6t38590H	0	-	878	1467	1467	1.0000000
C6	33409258	33409812	BolC6t38591H	0	-	103	548	554	0.9891697
C6	33432317	33433510	BolC6t38592H	0	+	733	1193	1193	1.0000000
C6	33437965	33440738	BolC6t38593H	0	+	1939	2606	2773	0.9397764
C6	33457872	33458271	BolC6t38594H	0	+	405	399	399	1.0000000
C6	33459155	33461033	BolC6t38595H	0	-	38	732	1878	0.3897763
C6	33466069	33468270	BolC6t38596H	0	-	594	1720	2201	0.7814630
C6	33486133	33486490	BolC6t38597H	0	+	18	315	357	0.8823529
C6	33496373	33497954	BolC6t38598H	0	+	947	1581	1581	1.0000000
C6	33498910	33499681	BolC6t38599H	0	-	346	749	771	0.9714656
C6	33507288	33507927	BolC6t38600H	0	+	97	604	639	0.9452269
C6	33508839	33510228	BolC6t38601H	0	-	162	1229	1389	0.8848092
C6	33510818	33511222	BolC6t38602H	0	-	39	355	404	0.8787129
C6	33537931	33540100	BolC6t38603H	0	-	162	1470	2169	0.6777317
C6	33541971	33542205	BolC6t38604H	0	+	253	234	234	1.0000000
C6	33543279	33544874	BolC6t38605H	0	-	2092	1595	1595	1.0000000
C6	33563470	33564820	BolC6t38606H	0	+	394	1327	1350	0.9829630
C6	33593342	33594554	BolC6t38607H	0	+	27	364	1212	0.3003300
C6	33594737	33595040	BolC6t38608H	0	-	0	0	303	0.0000000
C6	33595687	33596014	BolC6t38609H	0	-	0	0	327	0.0000000
C6	33600626	33602537	BolC6t38610H	0	+	608	1868	1911	0.9774987
C6	33602672	33605735	BolC6t38611H	0	-	1314	3063	3063	1.0000000
C6	33636673	33640568	BolC6t38612H	0	+	58	418	3895	0.1073171
C6	33641657	33642091	BolC6t38613H	0	+	197	434	434	1.0000000
C6	33644540	33645076	BolC6t38614H	0	-	583	536	536	1.0000000
C6	33645477	33647297	BolC6t38615H	0	+	428	1441	1820	0.7917582
C6	33659716	33661692	BolC6t38616H	0	-	791	1976	1976	1.0000000
C6	33665066	33667108	BolC6t38617H	0	-	67	787	2042	0.3854065
C6	33668505	33672003	BolC6t38618H	0	-	584	2817	3498	0.8053173
C6	33672744	33683633	BolC6t38619H	0	-	4043	9134	10889	0.8388281
C6	33694311	33695083	BolC6t38620H	0	-	4	94	772	0.1217617
C6	33695672	33696118	BolC6t38621H	0	-	59	84	446	0.1883408
C6	33711271	33721640	BolC6t38622H	0	-	1165	4349	10369	0.4194233
C6	33725589	33727899	BolC6t38623H	0	-	1021	2238	2310	0.9688312
C6	33730898	33732045	BolC6t38624H	0	-	314	663	1147	0.5780296
C6	33733046	33734909	BolC6t38625H	0	-	901	1863	1863	1.0000000
C6	33737405	33737552	BolC6t38626H	0	-	125	147	147	1.0000000
C6	33740529	33741790	BolC6t38627H	0	-	581	1261	1261	1.0000000
C6	33742440	33743219	BolC6t38628H	0	+	516	779	779	1.0000000
C6	33759747	33760362	BolC6t38629H	0	-	605	615	615	1.0000000
C6	33775464	33784285	BolC6t38630H	0	+	2731	7709	8821	0.8739372
C6	33785225	33787668	BolC6t38631H	0	-	540	2235	2443	0.9148588
C6	33789482	33796981	BolC6t38632H	0	-	952	3677	7499	0.4903320
C6	33797174	33797493	BolC6t38633H	0	-	329	319	319	1.0000000
C6	33799308	33800514	BolC6t38634H	0	-	212	1015	1206	0.8416252
C6	33802227	33804394	BolC6t38635H	0	-	298	1695	2167	0.7821873
C6	33861297	33861600	BolC6t38636H	0	+	82	303	303	1.0000000
C6	33862924	33864782	BolC6t38637H	0	+	1010	1823	1858	0.9811625
C6	33865306	33867087	BolC6t38638H	0	-	788	1781	1781	1.0000000
C6	33867849	33870995	BolC6t38639H	0	-	762	2815	3146	0.8947870
C6	33942057	33950818	BolC6t38640H	0	+	113	2198	8761	0.2508846
C6	33953476	33960101	BolC6t38641H	0	-	506	3410	6625	0.5147170
C6	33961768	33964232	BolC6t38642H	0	-	1264	2224	2464	0.9025974
C6	33964683	33965739	BolC6t38643H	0	+	427	1056	1056	1.0000000
C6	33968073	33970883	BolC6t38644H	0	+	1266	2691	2810	0.9576513
C6	33975493	33976353	BolC6t38645H	0	-	7	60	860	0.0697674
C6	33978786	33984271	BolC6t38646H	0	-	28	934	5485	0.1702826
C6	33989149	33989356	BolC6t38647H	0	+	0	0	207	0.0000000
C6	33991941	33996499	BolC6t38648H	0	-	14	125	4558	0.0274243
C6	33998929	33999583	BolC6t38649H	0	-	0	0	654	0.0000000
C6	34038797	34038995	BolC6t38650H	0	-	7	84	198	0.4242424
C6	34057304	34070786	BolC6t38651H	0	-	125	2760	13482	0.2047174
C6	34064476	34066297	BolC6t38652H	0	+	24	723	1821	0.3970346
C6	34082272	34086775	BolC6t38653H	0	-	103	1842	4503	0.4090606
C6	34103646	34103886	BolC6t38654H	0	-	0	0	240	0.0000000
C6	34103867	34104122	BolC6t38655H	0	+	0	0	255	0.0000000
C6	34115626	34118699	BolC6t38656H	0	+	4	290	3073	0.0943703
C6	34123340	34124528	BolC6t38657H	0	+	48	756	1188	0.6363636
C6	34135947	34137377	BolC6t38658H	0	+	0	0	1430	0.0000000
C6	34137683	34139018	BolC6t38659H	0	+	50	815	1335	0.6104869
C6	34144017	34145205	BolC6t38660H	0	+	7	535	1188	0.4503367
C6	34147797	34148205	BolC6t38661H	0	+	138	408	408	1.0000000
C6	34191518	34192975	BolC6t38662H	0	+	36	799	1457	0.5483871
C6	34193241	34194110	BolC6t38663H	0	+	0	0	869	0.0000000
C6	34200036	34201224	BolC6t38664H	0	+	58	458	1188	0.3855219
C6	34245484	34248598	BolC6t38665H	0	+	18	343	3114	0.1101477
C6	34250234	34251284	BolC6t38666H	0	+	269	1014	1050	0.9657143
C6	34257193	34257599	BolC6t38667H	0	-	348	406	406	1.0000000
C6	34258007	34258713	BolC6t38668H	0	+	623	706	706	1.0000000
C6	34259962	34262747	BolC6t38669H	0	-	1307	2715	2785	0.9748654
C6	34285619	34285829	BolC6t38670H	0	-	195	210	210	1.0000000
C6	34302515	34306918	BolC6t38671H	0	+	2756	4394	4403	0.9979559
C6	34310595	34312326	BolC6t38672H	0	+	616	1596	1731	0.9220104
C6	34314335	34316643	BolC6t38673H	0	-	868	2288	2308	0.9913345
C6	34319626	34326441	BolC6t38674H	0	+	3033	6815	6815	1.0000000
C6	34338647	34340684	BolC6t38675H	0	+	554	1936	2037	0.9504173
C6	34340703	34340940	BolC6t38676H	0	+	239	237	237	1.0000000
C6	34341316	34342644	BolC6t38677H	0	-	1313	1328	1328	1.0000000
C6	34344670	34345361	BolC6t38678H	0	+	388	691	691	1.0000000
C6	34346250	34346808	BolC6t38679H	0	-	110	540	558	0.9677419
C6	34352480	34352738	BolC6t38680H	0	-	79	258	258	1.0000000
C6	34366141	34368733	BolC6t38681H	0	-	2179	2592	2592	1.0000000
C6	34369500	34387408	BolC6t38682H	0	-	6164	14962	17908	0.8354925
C6	34371524	34373013	BolC6t38683H	0	+	486	1399	1489	0.9395568
C6	34379565	34380507	BolC6t38684H	0	+	315	942	942	1.0000000
C6	34391938	34393567	BolC6t38685H	0	-	2053	1629	1629	1.0000000
C6	34394762	34396073	BolC6t38686H	0	+	243	1285	1311	0.9801678
C6	34405489	34405897	BolC6t38687H	0	-	386	408	408	1.0000000
C6	34407241	34409106	BolC6t38688H	0	+	159	818	1865	0.4386059
C6	34411481	34411886	BolC6t38689H	0	+	88	87	405	0.2148148
C6	34419915	34422850	BolC6t38690H	0	+	796	2450	2935	0.8347530
C6	34426620	34428821	BolC6t38691H	0	-	2091	2201	2201	1.0000000
C6	34430173	34431036	BolC6t38692H	0	+	556	863	863	1.0000000
C6	34431753	34433187	BolC6t38693H	0	-	1196	1434	1434	1.0000000
C6	34434619	34438154	BolC6t38694H	0	-	1081	3391	3535	0.9592645
C6	34441907	34442563	BolC6t38695H	0	-	379	656	656	1.0000000
C6	34442709	34446139	BolC6t38696H	0	+	2191	3264	3430	0.9516035
C6	34446302	34448255	BolC6t38697H	0	-	190	1763	1953	0.9027138
C6	34458745	34459294	BolC6t38698H	0	+	0	0	549	0.0000000
C6	34460923	34461385	BolC6t38699H	0	-	0	0	462	0.0000000
C6	34462881	34463379	BolC6t38700H	0	-	157	498	498	1.0000000
C6	34463890	34464200	BolC6t38701H	0	+	350	310	310	1.0000000
C6	34466067	34467700	BolC6t38702H	0	+	591	1633	1633	1.0000000
C6	34494518	34494758	BolC6t38703H	0	-	189	240	240	1.0000000
C6	34542477	34543170	BolC6t38704H	0	+	11	450	693	0.6493506
C6	34544172	34544519	BolC6t38705H	0	+	3001	347	347	1.0000000
C6	34546482	34546941	BolC6t38706H	0	+	18	423	459	0.9215686
C6	34557935	34561802	BolC6t38707H	0	-	746	3037	3867	0.7853633
C6	34569065	34572722	BolC6t38708H	0	-	2060	3657	3657	1.0000000
C6	34573151	34576717	BolC6t38709H	0	+	836	3566	3566	1.0000000
C6	34582083	34582817	BolC6t38710H	0	-	500	734	734	1.0000000
C6	34601015	34603086	BolC6t38711H	0	+	777	2051	2071	0.9903429
C6	34605085	34608186	BolC6t38712H	0	-	1060	3094	3101	0.9977427
C6	34614439	34614726	BolC6t38713H	0	+	17	287	287	1.0000000
C6	34615745	34619208	BolC6t38714H	0	-	2019	3135	3463	0.9052845
C6	34622142	34623968	BolC6t38715H	0	-	655	1718	1826	0.9408543
C6	34632960	34634625	BolC6t38716H	0	+	1125	1628	1665	0.9777778
C6	34669354	34671006	BolC6t38717H	0	+	560	1652	1652	1.0000000
C6	34691651	34692284	BolC6t38718H	0	-	174	404	633	0.6382306
C6	34705621	34709337	BolC6t38719H	0	+	1022	3371	3716	0.9071583
C6	34710140	34710328	BolC6t38720H	0	-	152	188	188	1.0000000
C6	34710352	34711125	BolC6t38721H	0	-	84	463	773	0.5989650
C6	34712814	34716454	BolC6t38722H	0	-	759	3271	3640	0.8986264
C6	34719163	34720791	BolC6t38723H	0	-	778	1415	1628	0.8691646
C6	34721848	34722190	BolC6t38724H	0	-	646	342	342	1.0000000
C6	34724680	34727897	BolC6t38725H	0	-	1181	3174	3217	0.9866335
C6	34731684	34736062	BolC6t38726H	0	-	493	3048	4378	0.6962083
C6	34736457	34736898	BolC6t38727H	0	+	98	247	441	0.5600907
C6	34737994	34739153	BolC6t38728H	0	+	433	1124	1159	0.9698015
C6	34746100	34747471	BolC6t38729H	0	+	339	1219	1371	0.8891320
C6	34762991	34763576	BolC6t38730H	0	-	39	403	585	0.6888889
C6	34776059	34778089	BolC6t38731H	0	+	417	2030	2030	1.0000000
C6	34781712	34782116	BolC6t38732H	0	+	524	404	404	1.0000000
C6	34783129	34783459	BolC6t38733H	0	-	232	330	330	1.0000000
C6	34786569	34788844	BolC6t38734H	0	+	1546	2275	2275	1.0000000
C6	34791055	34791367	BolC6t38735H	0	-	35	287	312	0.9198718
C6	34840424	34840775	BolC6t38736H	0	-	9	229	351	0.6524217
C6	34849825	34850275	BolC6t38737H	0	-	2	8	450	0.0177778
C6	34852744	34855104	BolC6t38738H	0	+	1025	2311	2360	0.9792373
C6	34857679	34857916	BolC6t38739H	0	+	48	237	237	1.0000000
C6	34861887	34863233	BolC6t38740H	0	-	179	906	1346	0.6731055
C6	34871313	34873666	BolC6t38741H	0	+	868	1972	2353	0.8380790
C6	34878224	34878677	BolC6t38742H	0	-	377	453	453	1.0000000
C6	34879459	34880321	BolC6t38743H	0	-	516	862	862	1.0000000
C6	34884902	34886733	BolC6t38744H	0	+	683	1831	1831	1.0000000
C6	34887963	34888593	BolC6t38745H	0	-	408	615	630	0.9761904
C6	34891473	34894333	BolC6t38746H	0	-	1569	2821	2860	0.9863636
C6	34905675	34906821	BolC6t38747H	0	-	107	1090	1146	0.9511344
C6	34907675	34908530	BolC6t38748H	0	-	514	855	855	1.0000000
C6	34913638	34915540	BolC6t38749H	0	+	12	214	1902	0.1125131
C6	34920928	34922559	BolC6t38750H	0	+	666	1631	1631	1.0000000
C6	34923497	34923793	BolC6t38751H	0	-	379	296	296	1.0000000
C6	34935202	34935334	BolC6t38752H	0	+	162	132	132	1.0000000
C6	34940783	34941326	BolC6t38753H	0	+	298	427	543	0.7863720
C6	34941901	34944334	BolC6t38754H	0	+	1567	2433	2433	1.0000000
C6	34944740	34950158	BolC6t38755H	0	-	3141	5410	5418	0.9985234
C6	34957393	34957714	BolC6t38756H	0	-	26	98	321	0.3052959
C6	34978436	34979259	BolC6t38757H	0	+	571	797	823	0.9684083
C6	34986487	34987291	BolC6t38758H	0	+	587	753	804	0.9365672
C6	35015618	35016542	BolC6t38759H	0	+	190	893	924	0.9664502
C6	35020354	35021129	BolC6t38760H	0	+	528	775	775	1.0000000
C6	35024358	35025902	BolC6t38761H	0	+	799	1366	1544	0.8847150
C6	35034459	35035220	BolC6t38762H	0	-	402	761	761	1.0000000
C6	35043676	35045539	BolC6t38763H	0	-	340	1592	1863	0.8545357
C6	35052245	35053415	BolC6t38764H	0	+	301	1044	1170	0.8923077
C6	35062649	35063337	BolC6t38765H	0	-	16	111	688	0.1613372
C6	35078137	35078811	BolC6t38766H	0	-	22	41	674	0.0608309
C6	35088010	35088725	BolC6t38767H	0	-	163	715	715	1.0000000
C6	35091253	35092026	BolC6t38768H	0	-	168	726	773	0.9391980
C6	35093356	35097653	BolC6t38769H	0	-	385	2591	4297	0.6029788
C6	35123164	35123392	BolC6t38770H	0	-	342	228	228	1.0000000
C6	35129896	35131293	BolC6t38771H	0	-	207	1130	1397	0.8088762
C6	35176662	35177266	BolC6t38772H	0	-	214	604	604	1.0000000
C6	35188946	35189492	BolC6t38773H	0	+	2	62	546	0.1135531
C6	35196834	35197656	BolC6t38774H	0	-	258	822	822	1.0000000
C6	35200263	35200873	BolC6t38775H	0	+	432	610	610	1.0000000
C6	35201821	35207769	BolC6t38776H	0	-	1079	2223	5948	0.3737391
C6	35220830	35220944	BolC6t38777H	0	-	183	114	114	1.0000000
C6	35225558	35226389	BolC6t38778H	0	+	622	831	831	1.0000000
C6	35236632	35237580	BolC6t38779H	0	-	99	498	948	0.5253165
C6	35243689	35245276	BolC6t38780H	0	-	618	1384	1587	0.8720857
C6	35249832	35254932	BolC6t38781H	0	+	1678	3295	5100	0.6460784
C6	35254993	35256104	BolC6t38782H	0	-	291	1064	1111	0.9576958
C6	35258950	35261467	BolC6t38783H	0	+	1627	2517	2517	1.0000000
C6	35263452	35265426	BolC6t38784H	0	+	544	1972	1974	0.9989868
C6	35270060	35299915	BolC6t38785H	0	+	14935	21617	29855	0.7240663
C6	35284981	35285910	BolC6t38786H	0	+	520	929	929	1.0000000
C6	35285679	35286048	BolC6t38787H	0	+	252	369	369	1.0000000
C6	35290072	35291013	BolC6t38788H	0	+	1020	941	941	1.0000000
C6	35301139	35301982	BolC6t38789H	0	-	227	843	843	1.0000000
C6	35303800	35304172	BolC6t38790H	0	-	7	52	372	0.1397849
C6	35331794	35334053	BolC6t38791H	0	-	744	2091	2259	0.9256308
C6	35349693	35351410	BolC6t38792H	0	+	784	1603	1717	0.9336051
C6	35363565	35364641	BolC6t38793H	0	-	5	88	1076	0.0817844
C6	35367207	35368061	BolC6t38794H	0	-	5	339	854	0.3969555
C6	35368826	35370532	BolC6t38795H	0	-	108	1189	1706	0.6969519
C6	35371750	35374017	BolC6t38796H	0	-	4	337	2267	0.1486546
C6	35375235	35375760	BolC6t38797H	0	-	0	0	525	0.0000000
C6	35376978	35379246	BolC6t38798H	0	-	2	278	2268	0.1225750
C6	35385029	35385539	BolC6t38799H	0	-	216	465	510	0.9117647
C6	35387493	35393230	BolC6t38800H	0	-	3253	4177	5737	0.7280809
C6	35394104	35394597	BolC6t38801H	0	+	0	0	493	0.0000000
C6	35394961	35395162	BolC6t38802H	0	-	42	132	201	0.6567164
C6	35425443	35425800	BolC6t38803H	0	-	174	315	357	0.8823529
C6	35446030	35446717	BolC6t38804H	0	-	427	687	687	1.0000000
C6	35454928	35455955	BolC6t38805H	0	-	54	632	1027	0.6153846
C6	35464276	35467701	BolC6t38806H	0	+	856	2979	3425	0.8697810
C6	35470997	35473875	BolC6t38807H	0	+	15	537	2878	0.1865879
C6	35479546	35482486	BolC6t38808H	0	-	2905	2940	2940	1.0000000
C6	35483117	35483336	BolC6t38809H	0	+	149	219	219	1.0000000
C6	35483388	35485285	BolC6t38810H	0	-	188	966	1897	0.5092251
C6	35485949	35486252	BolC6t38811H	0	+	186	303	303	1.0000000
C6	35523504	35524632	BolC6t38812H	0	-	941	1128	1128	1.0000000
C6	35551168	35556445	BolC6t38813H	0	+	4534	5044	5277	0.9558461
C6	35563116	35565121	BolC6t38814H	0	+	971	1907	2005	0.9511222
C6	35582434	35583238	BolC6t38815H	0	+	2	145	804	0.1803483
C6	35584078	35584670	BolC6t38816H	0	+	203	554	592	0.9358108
C6	35585681	35588690	BolC6t38817H	0	-	1107	2643	3009	0.8783649
C6	35595653	35597055	BolC6t38818H	0	+	713	1402	1402	1.0000000
C6	35601268	35602529	BolC6t38819H	0	-	816	1139	1261	0.9032514
C6	35611817	35614464	BolC6t38820H	0	-	859	2500	2647	0.9444655
C6	35617622	35619290	BolC6t38821H	0	-	1694	1668	1668	1.0000000
C6	35625653	35626849	BolC6t38822H	0	+	943	1196	1196	1.0000000
C6	35638063	35642144	BolC6t38823H	0	+	1811	4066	4081	0.9963244
C6	35643025	35643671	BolC6t38824H	0	-	139	460	646	0.7120743
C6	35646271	35646544	BolC6t38825H	0	-	113	273	273	1.0000000
C6	35659973	35663068	BolC6t38826H	0	+	304	1575	3095	0.5088853
C6	35666606	35667252	BolC6t38827H	0	+	214	646	646	1.0000000
C6	35673701	35674112	BolC6t38828H	0	-	58	411	411	1.0000000
C6	35685128	35685551	BolC6t38829H	0	-	31	335	423	0.7919621
C6	35686622	35688397	BolC6t38830H	0	+	451	1573	1775	0.8861972
C6	35694843	35696284	BolC6t38831H	0	+	433	1104	1441	0.7661346
C6	35714297	35714910	BolC6t38832H	0	+	210	613	613	1.0000000
C6	35720807	35721089	BolC6t38833H	0	-	131	282	282	1.0000000
C6	35727532	35729125	BolC6t38834H	0	-	623	1517	1593	0.9522913
C6	35737669	35737945	BolC6t38835H	0	-	352	276	276	1.0000000
C6	35760553	35772857	BolC6t38836H	0	+	4635	10055	12304	0.8172139
C6	35777578	35777713	BolC6t38837H	0	+	26	135	135	1.0000000
C6	35793131	35796722	BolC6t38838H	0	+	1342	3464	3591	0.9646338
C6	35796973	35797258	BolC6t38839H	0	-	136	285	285	1.0000000
C6	35803152	35803621	BolC6t38840H	0	+	130	469	469	1.0000000
C6	35803990	35804299	BolC6t38841H	0	-	172	309	309	1.0000000
C6	35804975	35805158	BolC6t38842H	0	-	331	183	183	1.0000000
C6	35823949	35824170	BolC6t38843H	0	-	37	221	221	1.0000000
C6	35831474	35836016	BolC6t38844H	0	+	1896	4470	4542	0.9841480
C6	35836259	35839958	BolC6t38845H	0	-	2190	3699	3699	1.0000000
C6	35845314	35845548	BolC6t38846H	0	-	245	234	234	1.0000000
C6	35846895	35847720	BolC6t38847H	0	-	373	825	825	1.0000000
C6	35848054	35849162	BolC6t38848H	0	+	788	1028	1108	0.9277979
C6	35850718	35851493	BolC6t38849H	0	-	88	640	775	0.8258064
C6	35861100	35862164	BolC6t38850H	0	+	251	689	1064	0.6475564
C6	35862302	35862863	BolC6t38851H	0	-	64	547	561	0.9750445
C6	35864065	35866508	BolC6t38852H	0	-	588	2358	2443	0.9652067
C6	35874466	35879624	BolC6t38853H	0	-	1273	4366	5158	0.8464521
C6	35877972	35878233	BolC6t38854H	0	+	0	0	261	0.0000000
C6	35899096	35901928	BolC6t38855H	0	+	384	2338	2832	0.8255650
C6	35916496	35920368	BolC6t38856H	0	+	1636	3348	3872	0.8646694
C6	35945018	35945376	BolC6t38857H	0	+	125	358	358	1.0000000
C6	35945497	35946451	BolC6t38858H	0	+	706	954	954	1.0000000
C6	35948021	35948303	BolC6t38859H	0	-	193	282	282	1.0000000
C6	35955718	35957860	BolC6t38860H	0	+	785	1606	2142	0.7497666
C6	35992070	35993524	BolC6t38861H	0	+	569	1454	1454	1.0000000
C6	36012624	36013512	BolC6t38862H	0	-	267	823	888	0.9268018
C6	36026047	36027046	BolC6t38863H	0	+	645	945	999	0.9459459
C6	36032657	36033089	BolC6t38864H	0	+	236	432	432	1.0000000
C6	36033651	36034566	BolC6t38865H	0	-	256	892	915	0.9748634
C6	36060158	36060510	BolC6t38866H	0	-	22	352	352	1.0000000
C6	36061608	36061875	BolC6t38867H	0	-	0	0	267	0.0000000
C6	36063051	36063549	BolC6t38868H	0	-	417	498	498	1.0000000
C6	36065316	36083091	BolC6t38869H	0	+	8461	16770	17775	0.9434599
C6	36075487	36078202	BolC6t38870H	0	-	330	1868	2715	0.6880295
C6	36078253	36078912	BolC6t38871H	0	-	48	628	659	0.9529590
C6	36083143	36083944	BolC6t38872H	0	-	11	397	801	0.4956305
C6	36085897	36086996	BolC6t38873H	0	+	10	222	1099	0.2020018
C6	36091167	36093357	BolC6t38874H	0	+	281	1253	2190	0.5721461
C6	36099550	36100395	BolC6t38875H	0	+	12	383	845	0.4532544
C6	36104134	36105155	BolC6t38876H	0	-	4	259	1021	0.2536729
C6	36113304	36114444	BolC6t38877H	0	-	37	570	1140	0.5000000
C6	36116521	36116866	BolC6t38878H	0	+	262	345	345	1.0000000
C6	36124552	36127673	BolC6t38879H	0	+	521	2882	3121	0.9234220
C6	36137514	36138064	BolC6t38880H	0	-	466	239	550	0.4345455
C6	36144051	36144264	BolC6t38881H	0	+	40	213	213	1.0000000
C6	36164174	36167816	BolC6t38882H	0	+	135	729	3642	0.2001648
C6	36172122	36175746	BolC6t38883H	0	-	2255	3622	3624	0.9994481
C6	36175907	36177521	BolC6t38884H	0	-	1090	1614	1614	1.0000000
C6	36177530	36178427	BolC6t38885H	0	-	831	897	897	1.0000000
C6	36180056	36181857	BolC6t38886H	0	+	0	0	1801	0.0000000
C6	36184849	36196265	BolC6t38887H	0	+	1250	4936	11416	0.4323756
C6	36197319	36197736	BolC6t38888H	0	+	70	352	417	0.8441247
C6	36200072	36200690	BolC6t38889H	0	-	868	618	618	1.0000000
C6	36209509	36211270	BolC6t38890H	0	+	1007	1673	1761	0.9500284
C6	36246089	36248016	BolC6t38891H	0	-	293	1617	1927	0.8391282
C6	36263493	36265873	BolC6t38892H	0	-	2064	2380	2380	1.0000000
C6	36266279	36267829	BolC6t38893H	0	+	1686	1550	1550	1.0000000
C6	36268468	36271228	BolC6t38894H	0	+	1127	2742	2760	0.9934782
C6	36272295	36275055	BolC6t38895H	0	-	610	2521	2760	0.9134058
C6	36295195	36296563	BolC6t38896H	0	-	1355	1368	1368	1.0000000
C6	36317561	36321673	BolC6t38897H	0	+	667	4029	4112	0.9798152
C6	36326755	36327892	BolC6t38898H	0	-	1189	1137	1137	1.0000000
C6	36367582	36388239	BolC6t38899H	0	+	3900	15981	20657	0.7736360
C6	36424899	36425266	BolC6t38900H	0	+	45	328	367	0.8937330
C6	36426957	36457294	BolC6t38901H	0	+	6245	19674	30337	0.6485150
C6	36434777	36435617	BolC6t38902H	0	+	18	239	840	0.2845238
C6	36458612	36459903	BolC6t38903H	0	-	48	942	1291	0.7296669
C6	36467153	36468653	BolC6t38904H	0	-	332	1326	1500	0.8840000
C6	36468737	36469323	BolC6t38905H	0	-	15	357	586	0.6092150
C6	36493712	36494437	BolC6t38906H	0	+	268	587	725	0.8096552
C6	36494777	36500239	BolC6t38907H	0	-	5029	5291	5462	0.9686928
C6	36500986	36504144	BolC6t38908H	0	+	1635	3151	3158	0.9977834
C6	36504819	36505020	BolC6t38909H	0	-	42	201	201	1.0000000
C6	36508991	36522950	BolC6t38910H	0	+	3163	7821	13959	0.5602837
C6	36526479	36528754	BolC6t38911H	0	-	118	1685	2275	0.7406594
C6	36549943	36551386	BolC6t38912H	0	+	378	1411	1443	0.9778240
C6	36560540	36560663	BolC6t38913H	0	+	166	123	123	1.0000000
C6	36578812	36580259	BolC6t38914H	0	+	335	1381	1447	0.9543884
C6	36580265	36581838	BolC6t38915H	0	+	640	1573	1573	1.0000000
C6	36582484	36582676	BolC6t38916H	0	+	7	108	192	0.5625000
C6	36583872	36584523	BolC6t38917H	0	-	70	651	651	1.0000000
C6	36588530	36590154	BolC6t38918H	0	-	318	1612	1624	0.9926108
C6	36608275	36608743	BolC6t38919H	0	-	1368	468	468	1.0000000
C6	36609563	36610955	BolC6t38920H	0	+	114	990	1392	0.7112069
C6	36627755	36629059	BolC6t38921H	0	-	825	1304	1304	1.0000000
C6	36630291	36633553	BolC6t38922H	0	-	473	2307	3262	0.7072348
C6	36638320	36641059	BolC6t38923H	0	-	973	2551	2739	0.9313618
C6	36642388	36648546	BolC6t38924H	0	+	2947	6118	6158	0.9935044
C6	36653153	36653461	BolC6t38925H	0	-	45	305	308	0.9902598
C6	36653620	36654522	BolC6t38926H	0	+	150	902	902	1.0000000
C6	36655384	36655918	BolC6t38927H	0	+	660	534	534	1.0000000
C6	36658128	36659143	BolC6t38928H	0	+	123	342	1015	0.3369458
C6	36678599	36678881	BolC6t38929H	0	-	190	282	282	1.0000000
C6	36688048	36688772	BolC6t38930H	0	-	331	689	724	0.9516575
C6	36689034	36689523	BolC6t38931H	0	-	186	489	489	1.0000000
C6	36689867	36690119	BolC6t38932H	0	+	169	252	252	1.0000000
C6	36692049	36692334	BolC6t38933H	0	-	109	285	285	1.0000000
C6	36695370	36696874	BolC6t38934H	0	-	9	554	1504	0.3683511
C6	36714331	36714566	BolC6t38935H	0	-	2	154	235	0.6553192
C6	36716683	36717415	BolC6t38936H	0	+	355	728	732	0.9945355
C6	36724405	36725113	BolC6t38937H	0	-	176	665	708	0.9392655
C6	36728049	36730212	BolC6t38938H	0	-	576	1950	2163	0.9015257
C6	36751454	36752072	BolC6t38939H	0	-	0	0	618	0.0000000
C6	36752064	36752816	BolC6t38940H	0	-	4	197	752	0.2619681
C6	36762213	36765478	BolC6t38941H	0	-	44	847	3265	0.2594181
C6	36766827	36767079	BolC6t38942H	0	+	56	227	252	0.9007937
C6	36767429	36768029	BolC6t38943H	0	+	397	600	600	1.0000000
C6	36777391	36779240	BolC6t38944H	0	+	164	1178	1849	0.6371011
C6	36779956	36780707	BolC6t38945H	0	-	657	751	751	1.0000000
C6	36781438	36785833	BolC6t38946H	0	-	1941	3883	4395	0.8835040
C6	36786156	36788015	BolC6t38947H	0	+	386	1851	1859	0.9956966
C6	36795263	36798502	BolC6t38948H	0	-	1708	3204	3239	0.9891942
C6	36799273	36800238	BolC6t38949H	0	+	686	965	965	1.0000000
C6	36810056	36812195	BolC6t38950H	0	+	183	1589	2139	0.7428705
C6	36821282	36825955	BolC6t38951H	0	-	785	3968	4673	0.8491333
C6	36836290	36840200	BolC6t38952H	0	-	460	2703	3910	0.6913043
C6	36851680	36851986	BolC6t38953H	0	-	310	306	306	1.0000000
C6	36860416	36860955	BolC6t38954H	0	-	343	508	539	0.9424861
C6	36863850	36872202	BolC6t38955H	0	+	2715	7923	8352	0.9486350
C6	36874973	36880632	BolC6t38956H	0	+	2556	5483	5659	0.9688991
C6	36882060	36882291	BolC6t38957H	0	-	154	231	231	1.0000000
C6	36883365	36884727	BolC6t38958H	0	-	151	1000	1362	0.7342144
C6	36886096	36886276	BolC6t38959H	0	-	0	0	180	0.0000000
C6	36903855	36909166	BolC6t38960H	0	-	3744	5300	5311	0.9979288
C6	36914167	36915881	BolC6t38961H	0	+	398	1537	1714	0.8967328
C6	36922684	36923478	BolC6t38962H	0	+	576	794	794	1.0000000
C6	36931513	36931738	BolC6t38963H	0	-	105	225	225	1.0000000
C6	36932669	36933079	BolC6t38964H	0	-	4	103	410	0.2512195
C6	36933070	36934089	BolC6t38965H	0	+	441	937	1019	0.9195290
C6	36944594	36945876	BolC6t38966H	0	-	627	1282	1282	1.0000000
C6	36974535	36974901	BolC6t38967H	0	-	393	366	366	1.0000000
C6	36985462	36986083	BolC6t38968H	0	-	331	621	621	1.0000000
C6	36987489	36988109	BolC6t38969H	0	+	36	380	620	0.6129032
C6	36995589	36996465	BolC6t38970H	0	-	23	504	876	0.5753425
C6	36996554	37006546	BolC6t38971H	0	+	2324	5019	9992	0.5023018
C6	36999821	37001627	BolC6t38972H	0	-	0	0	1806	0.0000000
C6	37008707	37009076	BolC6t38973H	0	-	124	369	369	1.0000000
C6	37012243	37017471	BolC6t38974H	0	+	4257	5228	5228	1.0000000
C6	37026852	37027917	BolC6t38975H	0	+	91	836	1065	0.7849765
C6	37030650	37031657	BolC6t38976H	0	+	291	1007	1007	1.0000000
C6	37033991	37034259	BolC6t38977H	0	-	0	0	268	0.0000000
C6	37036899	37040808	BolC6t38978H	0	-	1040	3102	3909	0.7935534
C6	37054160	37058387	BolC6t38979H	0	+	1636	4139	4227	0.9791815
C6	37059228	37065654	BolC6t38980H	0	-	1096	5239	6426	0.8152817
C6	37065851	37066416	BolC6t38981H	0	-	39	237	565	0.4194690
C6	37072987	37075329	BolC6t38982H	0	+	349	2342	2342	1.0000000
C6	37096783	37099520	BolC6t38983H	0	+	1022	2672	2737	0.9762514
C6	37111907	37113549	BolC6t38984H	0	+	454	1521	1642	0.9263094
C6	37114415	37114854	BolC6t38985H	0	-	253	439	439	1.0000000
C6	37121637	37122399	BolC6t38986H	0	-	85	707	762	0.9278215
C6	37122998	37123532	BolC6t38987H	0	+	125	498	534	0.9325843
C6	37124208	37126215	BolC6t38988H	0	-	1204	2007	2007	1.0000000
C6	37129530	37134768	BolC6t38989H	0	+	1388	4682	5238	0.8938526
C6	37142148	37147129	BolC6t38990H	0	-	3480	4953	4981	0.9943786
C6	37163837	37165841	BolC6t38991H	0	-	270	1846	2004	0.9211577
C6	37168559	37169134	BolC6t38992H	0	+	236	497	575	0.8643478
C6	37170567	37175052	BolC6t38993H	0	-	1198	2951	4485	0.6579710
C6	37179290	37179461	BolC6t38994H	0	-	7	156	171	0.9122807
C6	37181372	37183207	BolC6t38995H	0	+	348	1237	1835	0.6741145
C6	37183387	37183993	BolC6t38996H	0	-	267	595	606	0.9818482
C6	37186383	37192922	BolC6t38997H	0	-	1575	5323	6539	0.8140389
C6	37198399	37204390	BolC6t38998H	0	+	1761	5438	5991	0.9076949
C6	37205016	37208755	BolC6t38999H	0	-	591	2853	3739	0.7630382
C6	37214689	37216964	BolC6t39000H	0	+	1881	2189	2275	0.9621978
C6	37226033	37226326	BolC6t39001H	0	-	502	293	293	1.0000000
C6	37226783	37230973	BolC6t39002H	0	-	1763	3957	4190	0.9443914
C6	37233140	37235263	BolC6t39003H	0	-	167	1460	2123	0.6877061
C6	37238463	37244776	BolC6t39004H	0	-	1346	4108	6313	0.6507207
C6	37252464	37261444	BolC6t39005H	0	+	2106	6812	8980	0.7585746
C6	37265198	37266561	BolC6t39006H	0	+	357	1356	1363	0.9948643
C6	37267006	37268937	BolC6t39007H	0	-	1119	1900	1931	0.9839461
C6	37270043	37271533	BolC6t39008H	0	-	979	1490	1490	1.0000000
C6	37274067	37277960	BolC6t39009H	0	+	2193	3893	3893	1.0000000
C6	37279222	37279780	BolC6t39010H	0	-	195	558	558	1.0000000
C6	37282224	37286998	BolC6t39011H	0	+	2014	4500	4774	0.9426058
C6	37287280	37291377	BolC6t39012H	0	-	2198	4066	4097	0.9924335
C6	37293735	37296135	BolC6t39013H	0	+	589	2007	2400	0.8362500
C6	37297782	37336184	BolC6t39014H	0	+	17008	30653	38402	0.7982137
C6	37315345	37316629	BolC6t39015H	0	+	1070	1284	1284	1.0000000
C6	37324191	37325995	BolC6t39016H	0	-	57	713	1804	0.3952328
C6	37337929	37340185	BolC6t39017H	0	-	545	1776	2256	0.7872341
C6	37342002	37345432	BolC6t39018H	0	-	691	2827	3430	0.8241982
C6	37346199	37346505	BolC6t39019H	0	-	50	306	306	1.0000000
C6	37356502	37359376	BolC6t39020H	0	+	2105	2842	2874	0.9888657
C6	37360461	37364644	BolC6t39021H	0	-	1382	4090	4183	0.9777672
C6	37367541	37368238	BolC6t39022H	0	-	163	471	697	0.6757532
C6	37370448	37374517	BolC6t39023H	0	+	1637	3571	4069	0.8776112
C6	37376650	37377624	BolC6t39024H	0	-	499	974	974	1.0000000
C6	37379037	37380093	BolC6t39025H	0	+	650	1056	1056	1.0000000
C6	37380849	37382403	BolC6t39026H	0	-	413	1354	1554	0.8712999
C6	37391050	37391476	BolC6t39027H	0	+	7	215	426	0.5046948
C6	37391607	37398923	BolC6t39028H	0	+	2073	5791	7316	0.7915528
C6	37399404	37400859	BolC6t39029H	0	-	637	1399	1455	0.9615120
C6	37403300	37403947	BolC6t39030H	0	-	147	615	647	0.9505410
C6	37404692	37405748	BolC6t39031H	0	-	275	1056	1056	1.0000000
C6	37406433	37409205	BolC6t39032H	0	+	388	2060	2772	0.7431458
C6	37410502	37411273	BolC6t39033H	0	-	207	721	771	0.9351491
C6	37414009	37414330	BolC6t39034H	0	+	119	321	321	1.0000000
C6	37451557	37454461	BolC6t39035H	0	+	334	2415	2904	0.8316116
C6	37454808	37456829	BolC6t39036H	0	+	20	1016	2021	0.5027214
C6	37459209	37459563	BolC6t39037H	0	-	253	354	354	1.0000000
C6	37460902	37461256	BolC6t39038H	0	-	2	168	354	0.4745763
C6	37462595	37462949	BolC6t39039H	0	-	52	354	354	1.0000000
C6	37464374	37464641	BolC6t39040H	0	-	24	267	267	1.0000000
C6	37465968	37466322	BolC6t39041H	0	-	534	354	354	1.0000000
C6	37467686	37468040	BolC6t39042H	0	-	558	354	354	1.0000000
C6	37470933	37471287	BolC6t39043H	0	-	15	310	354	0.8757062
C6	37472655	37473009	BolC6t39044H	0	-	803	354	354	1.0000000
C6	37475278	37475611	BolC6t39045H	0	-	1537	333	333	1.0000000
C6	37477086	37477269	BolC6t39046H	0	-	20	183	183	1.0000000
C6	37478974	37479097	BolC6t39047H	0	-	76	123	123	1.0000000
C6	37482602	37485561	BolC6t39048H	0	-	261	2428	2959	0.8205475
C6	37486987	37490122	BolC6t39049H	0	+	169	2026	3135	0.6462520
C6	37491022	37491904	BolC6t39050H	0	+	76	400	882	0.4535147
C6	37502464	37504504	BolC6t39051H	0	-	548	1869	2040	0.9161765
C6	37505280	37505697	BolC6t39052H	0	+	311	417	417	1.0000000
C6	37509773	37511826	BolC6t39053H	0	-	670	2053	2053	1.0000000
C6	37512553	37514489	BolC6t39054H	0	-	720	1808	1936	0.9338843
C6	37516724	37518963	BolC6t39055H	0	-	2168	2239	2239	1.0000000
C6	37521491	37555353	BolC6t39056H	0	+	13423	23468	33862	0.6930482
C6	37526102	37527186	BolC6t39057H	0	+	127	874	1084	0.8062730
C6	37529492	37531080	BolC6t39058H	0	+	1485	1588	1588	1.0000000
C6	37565612	37566568	BolC6t39059H	0	-	34	796	956	0.8326360
C6	37568714	37569760	BolC6t39060H	0	+	197	765	1046	0.7313576
C6	37571910	37573320	BolC6t39061H	0	+	432	1269	1410	0.9000000
C6	37605180	37605474	BolC6t39062H	0	+	297	294	294	1.0000000
C6	37610805	37613035	BolC6t39063H	0	-	76	1040	2230	0.4663677
C6	37612822	37615214	BolC6t39064H	0	-	129	1022	2392	0.4272575
C6	37617533	37617995	BolC6t39065H	0	-	18	309	462	0.6688312
C6	37624857	37625754	BolC6t39066H	0	-	332	837	897	0.9331104
C6	37629123	37631334	BolC6t39067H	0	+	751	2199	2211	0.9945726
C6	37631628	37633424	BolC6t39068H	0	-	1054	1796	1796	1.0000000
C6	37641439	37642054	BolC6t39069H	0	-	352	615	615	1.0000000
C6	37646626	37647898	BolC6t39070H	0	+	172	1213	1272	0.9536164
C6	37679551	37680851	BolC6t39071H	0	-	394	1033	1300	0.7946154
C6	37685369	37686635	BolC6t39072H	0	-	507	1266	1266	1.0000000
C6	37687034	37689727	BolC6t39073H	0	+	1796	2535	2693	0.9413294
C6	37690008	37691997	BolC6t39074H	0	-	585	1834	1989	0.9220714
C6	37693628	37702413	BolC6t39075H	0	-	6900	7597	8785	0.8647695
C6	37702606	37704725	BolC6t39076H	0	-	1107	2078	2119	0.9806513
C6	37704767	37706778	BolC6t39077H	0	-	1109	2011	2011	1.0000000
C6	37716564	37718140	BolC6t39078H	0	+	409	1429	1576	0.9067259
C6	37720412	37722407	BolC6t39079H	0	-	617	1622	1995	0.8130326
C6	37724559	37726138	BolC6t39080H	0	-	389	1340	1579	0.8486384
C6	37726675	37729286	BolC6t39081H	0	-	1224	1703	2611	0.6522405
C6	37743092	37743523	BolC6t39082H	0	+	629	430	431	0.9976798
C6	37743529	37743941	BolC6t39083H	0	+	247	407	412	0.9878641
C6	37753742	37755050	BolC6t39084H	0	-	184	911	1308	0.6964832
C6	37820997	37830746	BolC6t39085H	0	+	1420	3681	9749	0.3775772
C6	37823405	37823723	BolC6t39086H	0	-	0	0	318	0.0000000
C6	37831166	37833258	BolC6t39087H	0	-	119	1443	2092	0.6897706
C6	37835033	37835483	BolC6t39088H	0	-	1	34	450	0.0755556
C6	37860403	37860778	BolC6t39089H	0	-	0	0	375	0.0000000
C6	37868576	37870511	BolC6t39090H	0	-	2	102	1935	0.0527132
C6	37886537	37893094	BolC6t39091H	0	+	3013	6557	6557	1.0000000
C6	37893791	37895177	BolC6t39092H	0	+	428	1211	1386	0.8737374
C6	37895848	37897901	BolC6t39093H	0	+	811	1909	2053	0.9298587
C6	37901181	37903386	BolC6t39094H	0	+	729	1900	2205	0.8616780
C6	37903880	37910125	BolC6t39095H	0	+	3108	6123	6245	0.9804644
C6	37906320	37906899	BolC6t39096H	0	-	121	507	579	0.8756477
C6	37911069	37913253	BolC6t39097H	0	+	1668	2184	2184	1.0000000
C6	37914775	37916071	BolC6t39098H	0	-	694	1296	1296	1.0000000
C6	37922551	37925455	BolC6t39099H	0	-	6	417	2904	0.1435950
C6	37939056	37940691	BolC6t39100H	0	-	4	57	1635	0.0348624
C6	37959044	37959149	BolC6t39101H	0	-	95	105	105	1.0000000
C6	37983954	37984980	BolC6t39102H	0	-	460	1026	1026	1.0000000
C6	37986413	37986797	BolC6t39103H	0	+	91	340	384	0.8854167
C6	37987378	37989968	BolC6t39104H	0	-	494	1963	2590	0.7579151
C6	37991184	37993031	BolC6t39105H	0	-	1122	1847	1847	1.0000000
C6	37993054	37994336	BolC6t39106H	0	-	1020	1282	1282	1.0000000
C6	37994458	37994749	BolC6t39107H	0	+	75	196	291	0.6735395
C6	37997879	38000400	BolC6t39108H	0	-	3745	2521	2521	1.0000000
C6	38000830	38005688	BolC6t39109H	0	+	1909	4159	4858	0.8561136
C6	38007092	38008223	BolC6t39110H	0	-	1620	1131	1131	1.0000000
C6	38016366	38020182	BolC6t39111H	0	+	1405	3397	3816	0.8901992
C6	38028246	38031040	BolC6t39112H	0	+	744	2446	2794	0.8754474
C6	38033955	38049685	BolC6t39113H	0	+	2689	9884	15730	0.6283535
C6	38049871	38050153	BolC6t39114H	0	-	6	208	282	0.7375886
C6	38050587	38051690	BolC6t39115H	0	-	4	105	1103	0.0951949
C6	38064972	38109206	BolC6t39116H	0	-	6965	22815	44234	0.5157797
C6	38100780	38101494	BolC6t39117H	0	-	2	19	714	0.0266106
C6	38117692	38118454	BolC6t39118H	0	-	445	762	762	1.0000000
C6	38120107	38120305	BolC6t39119H	0	-	306	198	198	1.0000000
C6	38122538	38123573	BolC6t39120H	0	-	1313	1035	1035	1.0000000
C6	38133915	38134506	BolC6t39121H	0	+	487	557	591	0.9424704
C6	38137398	38138408	BolC6t39122H	0	+	95	999	1010	0.9891089
C6	38158768	38159464	BolC6t39123H	0	+	515	696	696	1.0000000
C6	38159681	38162403	BolC6t39124H	0	-	1120	2686	2722	0.9867744
C6	38165719	38166815	BolC6t39125H	0	+	406	916	1096	0.8357664
C6	38167571	38183290	BolC6t39126H	0	-	5865	15394	15719	0.9793244
C6	38183712	38185215	BolC6t39127H	0	+	702	1503	1503	1.0000000
C6	38186076	38187336	BolC6t39128H	0	+	72	981	1260	0.7785714
C6	38199371	38200085	BolC6t39129H	0	-	107	714	714	1.0000000
C6	38207275	38208522	BolC6t39130H	0	+	181	666	1247	0.5340818
C6	38212259	38216523	BolC6t39131H	0	-	1262	4216	4264	0.9887429
C6	38224320	38224473	BolC6t39132H	0	-	124	153	153	1.0000000
C6	38227546	38228850	BolC6t39133H	0	-	992	1304	1304	1.0000000
C6	38236986	38238057	BolC6t39134H	0	-	1034	1071	1071	1.0000000
C6	38253144	38253267	BolC6t39135H	0	-	41	123	123	1.0000000
C6	38275139	38275599	BolC6t39136H	0	+	2	57	460	0.1239130
C6	38285338	38286419	BolC6t39137H	0	+	0	0	1081	0.0000000
C6	38292432	38295543	BolC6t39138H	0	-	2648	2946	3111	0.9469624
C6	38303649	38305575	BolC6t39139H	0	-	503	1506	1926	0.7819315
C6	38307817	38309826	BolC6t39140H	0	-	232	1739	2009	0.8656048
C6	38324391	38327015	BolC6t39141H	0	-	626	1998	2624	0.7614329
C6	38328459	38333699	BolC6t39142H	0	-	3362	5210	5240	0.9942748
C6	38333779	38338526	BolC6t39143H	0	-	2929	4747	4747	1.0000000
C6	38343933	38344304	BolC6t39144H	0	-	325	371	371	1.0000000
C6	38358711	38359470	BolC6t39145H	0	+	213	756	759	0.9960474
C6	38376542	38377846	BolC6t39146H	0	+	180	1202	1304	0.9217792
C6	38384374	38385048	BolC6t39147H	0	+	602	634	674	0.9406528
C6	38385792	38390154	BolC6t39148H	0	-	1162	3745	4362	0.8585511
C6	38406761	38407181	BolC6t39149H	0	+	84	417	420	0.9928572
C6	38410105	38415532	BolC6t39150H	0	+	1625	4228	5427	0.7790676
C6	38416242	38416554	BolC6t39151H	0	+	447	312	312	1.0000000
C6	38423297	38424917	BolC6t39152H	0	+	867	1620	1620	1.0000000
C6	38425350	38427324	BolC6t39153H	0	-	829	1920	1974	0.9726444
C6	38428556	38428799	BolC6t39154H	0	-	1	40	243	0.1646091
C6	38451932	38453636	BolC6t39155H	0	+	0	0	1704	0.0000000
C6	38460818	38461731	BolC6t39156H	0	+	0	0	913	0.0000000
C6	38504805	38506374	BolC6t39157H	0	+	22	304	1569	0.1937540
C6	38517994	38519654	BolC6t39158H	0	+	463	1194	1660	0.7192771
C6	38520713	38521487	BolC6t39159H	0	-	107	725	774	0.9366925
C6	38522440	38525215	BolC6t39160H	0	-	282	2172	2775	0.7827027
C6	38532083	38533100	BolC6t39161H	0	-	642	1017	1017	1.0000000
C6	38534927	38536198	BolC6t39162H	0	-	15	392	1271	0.3084186
C6	38537067	38538821	BolC6t39163H	0	+	266	1387	1754	0.7907640
C6	38542952	38543775	BolC6t39164H	0	-	261	733	823	0.8906440
C6	38554077	38554353	BolC6t39165H	0	+	5	151	276	0.5471014
C6	38557684	38558665	BolC6t39166H	0	+	128	847	981	0.8634047
C6	38567746	38569495	BolC6t39167H	0	+	770	1489	1749	0.8513436
C6	38573504	38573669	BolC6t39168H	0	+	39	165	165	1.0000000
C6	38574832	38575609	BolC6t39169H	0	-	66	420	777	0.5405405
C6	38582579	38583521	BolC6t39170H	0	-	208	913	942	0.9692144
C6	38586241	38588153	BolC6t39171H	0	+	705	1912	1912	1.0000000
C6	38590921	38593933	BolC6t39172H	0	-	548	1970	3012	0.6540505
C6	38596924	38597188	BolC6t39173H	0	-	0	0	264	0.0000000
C6	38598677	38599978	BolC6t39174H	0	-	181	878	1301	0.6748655
C6	38603120	38604131	BolC6t39175H	0	-	196	1011	1011	1.0000000
C6	38608885	38610226	BolC6t39176H	0	+	617	1285	1341	0.9582401
C6	38610981	38612017	BolC6t39177H	0	+	132	953	1036	0.9198841
C6	38615250	38616327	BolC6t39178H	0	+	98	689	1077	0.6397400
C6	38617780	38618716	BolC6t39179H	0	+	197	884	936	0.9444444
C6	38619182	38619368	BolC6t39180H	0	+	28	160	186	0.8602151
C6	38619646	38622365	BolC6t39181H	0	-	1417	2658	2719	0.9775653
C6	38644187	38644774	BolC6t39182H	0	+	193	587	587	1.0000000
C6	38657858	38658760	BolC6t39183H	0	+	214	902	902	1.0000000
C6	38658505	38659030	BolC6t39184H	0	+	113	478	525	0.9104762
C6	38659637	38661419	BolC6t39185H	0	+	98	852	1782	0.4781145
C6	38672697	38673284	BolC6t39186H	0	+	231	574	587	0.9778535
C6	38699022	38699611	BolC6t39187H	0	+	232	589	589	1.0000000
C6	38719922	38720459	BolC6t39188H	0	+	28	469	537	0.8733706
C6	38757964	38763424	BolC6t39189H	0	+	58	1954	5460	0.3578755
C6	38764930	38765519	BolC6t39190H	0	+	54	440	589	0.7470289
C6	38795587	38795945	BolC6t39191H	0	+	320	358	358	1.0000000
C6	38805497	38806240	BolC6t39192H	0	+	333	743	743	1.0000000
C6	38812000	38818117	BolC6t39193H	0	+	3450	5932	6117	0.9697564
C6	38819091	38820925	BolC6t39194H	0	-	1108	1828	1834	0.9967285
C6	38831184	38833349	BolC6t39195H	0	+	139	1560	2165	0.7205543
C6	38833821	38836178	BolC6t39196H	0	-	406	2074	2357	0.8799321
C6	38836913	38842258	BolC6t39197H	0	-	1631	4978	5345	0.9313377
C6	38847800	38848888	BolC6t39198H	0	+	303	1088	1088	1.0000000
C6	38850387	38852481	BolC6t39199H	0	+	615	1549	2094	0.7397326
C6	38855428	38856010	BolC6t39200H	0	-	89	582	582	1.0000000
C6	38860966	38862864	BolC6t39201H	0	+	693	1794	1898	0.9452055
C6	38877742	38879228	BolC6t39202H	0	+	121	930	1486	0.6258412
C6	38893187	38895301	BolC6t39203H	0	+	587	2068	2114	0.9782403
C6	38903182	38904793	BolC6t39204H	0	-	1897	1611	1611	1.0000000
C6	38909099	38912629	BolC6t39205H	0	+	476	2850	3530	0.8073654
C6	38922746	38925390	BolC6t39206H	0	-	1128	2283	2644	0.8634645
C6	38926354	38928664	BolC6t39207H	0	-	997	2310	2310	1.0000000
C6	38946501	38947311	BolC6t39208H	0	+	94	548	810	0.6765432
C6	38948876	38950751	BolC6t39209H	0	-	40	1123	1875	0.5989333
C6	38965522	38977773	BolC6t39210H	0	-	788	2866	12251	0.2339401
C6	38981508	38981766	BolC6t39211H	0	-	13	232	258	0.8992248
C6	38989176	38989449	BolC6t39212H	0	-	24	196	273	0.7179487
C6	38991442	38992660	BolC6t39213H	0	-	833	1218	1218	1.0000000
C6	38999846	39000662	BolC6t39214H	0	+	5	314	816	0.3848039
C6	39002634	39004052	BolC6t39215H	0	-	34	438	1418	0.3088858
C6	39019123	39019453	BolC6t39216H	0	-	10	212	330	0.6424242
C6	39019768	39020305	BolC6t39217H	0	-	36	266	537	0.4953445
C6	39023647	39023905	BolC6t39218H	0	-	18	233	258	0.9031008
C6	39026630	39027648	BolC6t39219H	0	-	121	979	1018	0.9616896
C6	39036649	39037276	BolC6t39220H	0	-	174	627	627	1.0000000
C6	39043048	39043249	BolC6t39221H	0	+	399	201	201	1.0000000
C6	39043660	39046966	BolC6t39222H	0	-	853	3049	3306	0.9222625
C6	39055884	39060053	BolC6t39223H	0	+	2091	4031	4169	0.9668986
C6	39060644	39061960	BolC6t39224H	0	+	495	1315	1316	0.9992401
C6	39062112	39063470	BolC6t39225H	0	-	376	1224	1358	0.9013255
C6	39064381	39065775	BolC6t39226H	0	-	340	1331	1394	0.9548063
C6	39068238	39069367	BolC6t39227H	0	+	109	784	1129	0.6944199
C6	39073462	39082309	BolC6t39228H	0	+	1798	3943	8847	0.4456878
C6	39083155	39084306	BolC6t39229H	0	-	1149	1151	1151	1.0000000
C6	39088448	39091236	BolC6t39230H	0	+	381	1672	2788	0.5997130
C6	39101855	39102356	BolC6t39231H	0	-	82	229	501	0.4570858
C6	39107526	39110290	BolC6t39232H	0	-	996	2304	2764	0.8335745
C6	39111267	39111629	BolC6t39233H	0	+	0	0	362	0.0000000
C6	39112736	39112931	BolC6t39234H	0	+	27	187	195	0.9589744
C6	39116140	39117629	BolC6t39235H	0	-	623	1489	1489	1.0000000
C6	39118053	39123638	BolC6t39236H	0	-	3874	5301	5585	0.9491495
C6	39134549	39134921	BolC6t39237H	0	+	45	372	372	1.0000000
C6	39135878	39138361	BolC6t39238H	0	+	2209	2426	2483	0.9770439
C6	39139063	39140137	BolC6t39239H	0	+	386	1074	1074	1.0000000
C6	39145984	39161126	BolC6t39240H	0	+	6973	14029	15142	0.9264959
C6	39146899	39148871	BolC6t39241H	0	+	108	1319	1972	0.6688641
C6	39158688	39159660	BolC6t39242H	0	-	325	868	972	0.8930041
C6	39161492	39161816	BolC6t39243H	0	-	26	324	324	1.0000000
C6	39162461	39162889	BolC6t39244H	0	-	143	428	428	1.0000000
C6	39171083	39172881	BolC6t39245H	0	+	344	1574	1798	0.8754171
C6	39174388	39176065	BolC6t39246H	0	-	698	1483	1677	0.8843172
C6	39181039	39187958	BolC6t39247H	0	+	1037	6135	6919	0.8866888
C6	39189153	39190721	BolC6t39248H	0	+	759	1460	1568	0.9311224
C6	39192954	39195371	BolC6t39249H	0	+	768	2397	2417	0.9917253
C6	39200266	39201317	BolC6t39250H	0	+	292	884	1051	0.8411037
C6	39202442	39203440	BolC6t39251H	0	+	1118	998	998	1.0000000
C6	39208314	39208581	BolC6t39252H	0	+	231	267	267	1.0000000
C6	39213303	39215107	BolC6t39253H	0	+	1215	1804	1804	1.0000000
C6	39215901	39219265	BolC6t39254H	0	-	1770	3346	3364	0.9946492
C6	39220231	39221797	BolC6t39255H	0	+	302	1313	1566	0.8384419
C6	39222008	39222801	BolC6t39256H	0	-	709	793	793	1.0000000
C6	39223222	39224341	BolC6t39257H	0	+	816	1119	1119	1.0000000
C6	39228236	39229285	BolC6t39258H	0	+	439	790	1049	0.7530982
C6	39235904	39236684	BolC6t39259H	0	+	660	708	780	0.9076923
C6	39253025	39253700	BolC6t39260H	0	-	208	675	675	1.0000000
C6	39264052	39264769	BolC6t39261H	0	-	67	297	717	0.4142259
C6	39267471	39272300	BolC6t39262H	0	+	3264	4829	4829	1.0000000
C6	39273046	39273343	BolC6t39263H	0	-	39	269	297	0.9057239
C6	39291743	39293854	BolC6t39264H	0	-	1906	2020	2111	0.9568925
C6	39294494	39296940	BolC6t39265H	0	+	296	1919	2446	0.7845462
C6	39300001	39301638	BolC6t39266H	0	-	797	1539	1637	0.9401344
C6	39335103	39338826	BolC6t39267H	0	+	2025	3335	3723	0.8957829
C6	39342715	39344542	BolC6t39268H	0	+	1057	1810	1827	0.9906951
C6	39357569	39362171	BolC6t39269H	0	+	1088	3678	4602	0.7992178
C6	39363179	39364770	BolC6t39270H	0	+	1820	1591	1591	1.0000000
C6	39364932	39365361	BolC6t39271H	0	-	273	429	429	1.0000000
C6	39383956	39384859	BolC6t39272H	0	+	386	903	903	1.0000000
C6	39386712	39387381	BolC6t39273H	0	-	290	669	669	1.0000000
C6	39389145	39390904	BolC6t39274H	0	-	629	1650	1759	0.9380330
C6	39406944	39408702	BolC6t39275H	0	-	517	1737	1758	0.9880546
C6	39414290	39414731	BolC6t39276H	0	+	22	254	441	0.5759637
C6	39419944	39421028	BolC6t39277H	0	+	991	1084	1084	1.0000000
C6	39427674	39428502	BolC6t39278H	0	-	752	828	828	1.0000000
C6	39442467	39442935	BolC6t39279H	0	+	43	352	468	0.7521368
C6	39445069	39445333	BolC6t39280H	0	+	12	264	264	1.0000000
C6	39463971	39465130	BolC6t39281H	0	+	806	1097	1159	0.9465056
C6	39477393	39477564	BolC6t39282H	0	-	187	171	171	1.0000000
C6	39480543	39481454	BolC6t39283H	0	+	118	786	911	0.8627881
C6	39482337	39484175	BolC6t39284H	0	-	171	1462	1838	0.7954298
C6	39490843	39492103	BolC6t39285H	0	+	393	1065	1260	0.8452381
C6	39494007	39494916	BolC6t39286H	0	-	748	909	909	1.0000000
C6	39495005	39495361	BolC6t39287H	0	-	85	255	356	0.7162921
C6	39513705	39517603	BolC6t39288H	0	-	661	2971	3898	0.7621858
C6	39519930	39520065	BolC6t39289H	0	+	144	135	135	1.0000000
C6	39539817	39540474	BolC6t39290H	0	-	488	657	657	1.0000000
C6	39557875	39561404	BolC6t39291H	0	+	371	1805	3529	0.5114763
C6	39563161	39563755	BolC6t39292H	0	+	434	594	594	1.0000000
C6	39564148	39564975	BolC6t39293H	0	-	569	827	827	1.0000000
C6	39565304	39565691	BolC6t39294H	0	+	383	387	387	1.0000000
C6	39567047	39568373	BolC6t39295H	0	-	919	1326	1326	1.0000000
C6	39568821	39568994	BolC6t39296H	0	-	164	173	173	1.0000000
C6	39569105	39570246	BolC6t39297H	0	+	64	487	1141	0.4268186
C6	39574752	39575706	BolC6t39298H	0	+	317	899	954	0.9423480
C6	39579802	39583083	BolC6t39299H	0	+	829	2391	3281	0.7287412
C6	39584271	39584565	BolC6t39300H	0	+	62	277	294	0.9421769
C6	39584875	39585468	BolC6t39301H	0	-	23	443	593	0.7470489
C6	39586957	39588879	BolC6t39302H	0	-	96	822	1922	0.4276795
C6	39589236	39589728	BolC6t39303H	0	+	22	56	492	0.1138211
C6	39594702	39595484	BolC6t39304H	0	+	192	782	782	1.0000000
C6	39595686	39598412	BolC6t39305H	0	-	1057	2670	2726	0.9794571
C6	39599658	39600674	BolC6t39306H	0	+	394	1016	1016	1.0000000
C6	39608894	39610262	BolC6t39307H	0	+	737	1368	1368	1.0000000
C6	39624870	39629098	BolC6t39308H	0	+	2584	4208	4228	0.9952697
C6	39629274	39634190	BolC6t39309H	0	-	1672	4789	4916	0.9741660
C6	39650597	39651450	BolC6t39310H	0	+	441	853	853	1.0000000
C6	39651632	39652368	BolC6t39311H	0	-	363	736	736	1.0000000
C6	39653363	39657011	BolC6t39312H	0	-	620	3063	3648	0.8396382
C6	39678625	39678856	BolC6t39313H	0	-	33	168	231	0.7272727
C6	39680374	39682039	BolC6t39314H	0	-	587	1196	1665	0.7183183
C6	39683006	39683285	BolC6t39315H	0	+	8	192	279	0.6881720
C6	39701594	39701933	BolC6t39316H	0	-	49	193	339	0.5693215
C6	39709039	39709312	BolC6t39317H	0	-	278	273	273	1.0000000
C6	39709410	39709840	BolC6t39318H	0	-	287	430	430	1.0000000
C6	39719849	39720821	BolC6t39319H	0	-	716	972	972	1.0000000
C6	39751760	39752405	BolC6t39320H	0	-	69	159	645	0.2465116
C6	39772249	39773847	BolC6t39321H	0	+	29	636	1598	0.3979975
C6	39777868	39780566	BolC6t39322H	0	+	2358	2698	2698	1.0000000
C6	39786283	39788985	BolC6t39323H	0	-	2203	2698	2702	0.9985196
C6	39789637	39791155	BolC6t39324H	0	+	803	1518	1518	1.0000000
C6	39794646	39795345	BolC6t39325H	0	+	2	147	699	0.2103004
C6	39798560	39799874	BolC6t39326H	0	-	268	1240	1314	0.9436834
C6	39806721	39807683	BolC6t39327H	0	-	1	96	962	0.0997921
C6	39807683	39807869	BolC6t39328H	0	-	14	118	186	0.6344086
C6	39812337	39812769	BolC6t39329H	0	+	23	286	432	0.6620370
C6	39817217	39817388	BolC6t39330H	0	-	344	171	171	1.0000000
C6	39820803	39821943	BolC6t39331H	0	-	219	1113	1140	0.9763158
C6	39827295	39828513	BolC6t39332H	0	-	992	1218	1218	1.0000000
C6	39845507	39846332	BolC6t39333H	0	-	353	779	825	0.9442424
C6	39852464	39855310	BolC6t39334H	0	-	1551	2732	2846	0.9599438
C6	39858148	39858253	BolC6t39335H	0	-	17	48	105	0.4571429
C6	39864248	39865022	BolC6t39336H	0	-	15	390	774	0.5038760
C6	39865873	39866044	BolC6t39337H	0	-	3	2	171	0.0116959
C6	39866439	39867350	BolC6t39338H	0	-	126	729	911	0.8002195
C6	39867402	39867763	BolC6t39339H	0	-	350	361	361	1.0000000
C6	39871147	39871540	BolC6t39340H	0	-	134	393	393	1.0000000
C6	39871917	39874281	BolC6t39341H	0	-	564	2278	2364	0.9636210
C6	39890265	39892264	BolC6t39342H	0	+	1461	1933	1999	0.9669835
C6	39893727	39894717	BolC6t39343H	0	+	451	990	990	1.0000000
C6	39897367	39899605	BolC6t39344H	0	+	226	1720	2238	0.7685434
C6	39900641	39904211	BolC6t39345H	0	-	835	2991	3570	0.8378151
C6	39917781	39919212	BolC6t39346H	0	+	460	1305	1431	0.9119497
C6	39919984	39921233	BolC6t39347H	0	+	168	1222	1249	0.9783827
C6	39922512	39922770	BolC6t39348H	0	-	178	258	258	1.0000000
C6	39931581	39936548	BolC6t39349H	0	-	4642	4967	4967	1.0000000
C6	39937740	39939518	BolC6t39350H	0	+	709	1778	1778	1.0000000
C6	39939804	39942804	BolC6t39351H	0	-	1182	2990	3000	0.9966667
C6	39953271	39953700	BolC6t39352H	0	-	492	429	429	1.0000000
C6	39973576	39975425	BolC6t39353H	0	+	154	1254	1849	0.6782044
C6	39978095	39978380	BolC6t39354H	0	+	232	285	285	1.0000000
C6	39981680	39984248	BolC6t39355H	0	+	1338	2529	2568	0.9848131
C6	39984951	39985970	BolC6t39356H	0	-	158	908	1019	0.8910697
C6	39991834	39995947	BolC6t39357H	0	-	4530	4113	4113	1.0000000
C6	40012281	40013256	BolC6t39358H	0	+	8	302	975	0.3097436
C6	40025159	40026190	BolC6t39359H	0	+	857	1031	1031	1.0000000
C6	40026883	40028150	BolC6t39360H	0	-	100	981	1267	0.7742699
C6	40044363	40046579	BolC6t39361H	0	+	758	2108	2216	0.9512635
C6	40046857	40047187	BolC6t39362H	0	-	28	326	330	0.9878788
C6	40047320	40052703	BolC6t39363H	0	-	1711	4910	5383	0.9121308
C6	40058570	40060587	BolC6t39364H	0	+	1079	2017	2017	1.0000000
C6	40062224	40063995	BolC6t39365H	0	+	1425	1770	1771	0.9994354
C6	40075379	40076559	BolC6t39366H	0	+	734	1180	1180	1.0000000
C6	40077154	40087358	BolC6t39367H	0	-	7803	10204	10204	1.0000000
C6	40096285	40096807	BolC6t39368H	0	-	98	400	522	0.7662835
C6	40101839	40108855	BolC6t39369H	0	-	4162	6732	7016	0.9595211
C6	40112785	40114547	BolC6t39370H	0	-	347	1395	1762	0.7917140
C6	40115524	40115722	BolC6t39371H	0	+	3	22	198	0.1111111
C6	40127867	40130229	BolC6t39372H	0	+	1256	2247	2362	0.9513124
C6	40130518	40131268	BolC6t39373H	0	-	194	750	750	1.0000000
C6	40132407	40138024	BolC6t39374H	0	+	1670	5442	5617	0.9688446
C6	40138278	40140980	BolC6t39375H	0	-	1046	2626	2702	0.9718727
C6	40153356	40154947	BolC6t39376H	0	+	743	1466	1591	0.9214330
C6	40155172	40157008	BolC6t39377H	0	-	1258	1836	1836	1.0000000
C6	40157542	40158549	BolC6t39378H	0	+	593	1007	1007	1.0000000
C6	40159507	40160504	BolC6t39379H	0	+	869	997	997	1.0000000
C6	40164870	40167772	BolC6t39380H	0	+	1747	2885	2902	0.9941420
C6	40171379	40171664	BolC6t39381H	0	+	85	285	285	1.0000000
C6	40171775	40174353	BolC6t39382H	0	+	2858	2578	2578	1.0000000
C6	40174406	40174733	BolC6t39383H	0	+	169	327	327	1.0000000
C6	40176973	40178413	BolC6t39384H	0	-	35	1025	1440	0.7118056
C6	40202911	40205919	BolC6t39385H	0	-	921	2648	3008	0.8803192
C6	40211537	40212542	BolC6t39386H	0	-	626	1005	1005	1.0000000
C6	40214112	40215212	BolC6t39387H	0	+	564	1100	1100	1.0000000
C6	40215638	40218925	BolC6t39388H	0	-	2319	3287	3287	1.0000000
C6	40221400	40221784	BolC6t39389H	0	-	389	384	384	1.0000000
C6	40221988	40223038	BolC6t39390H	0	-	458	1005	1050	0.9571428
C6	40232019	40233006	BolC6t39391H	0	+	103	596	987	0.6038501
C6	40233787	40236322	BolC6t39392H	0	+	446	1847	2535	0.7285996
C6	40238575	40239547	BolC6t39393H	0	+	1003	972	972	1.0000000
C6	40240005	40255356	BolC6t39394H	0	+	7880	14980	15351	0.9758322
C6	40245790	40252573	BolC6t39395H	0	+	4340	6710	6783	0.9892378
C6	40266342	40267753	BolC6t39396H	0	+	49	503	1411	0.3564848
C6	40279207	40279312	BolC6t39397H	0	+	46	105	105	1.0000000
C6	40281961	40283371	BolC6t39398H	0	+	99	1072	1410	0.7602837
C6	40290136	40292297	BolC6t39399H	0	+	1416	1949	2161	0.9018973
C6	40321448	40322370	BolC6t39400H	0	+	179	862	922	0.9349241
C6	40325583	40327951	BolC6t39401H	0	-	478	2119	2368	0.8948480
C6	40359965	40361145	BolC6t39402H	0	+	451	1097	1180	0.9296610
C6	40362332	40363239	BolC6t39403H	0	-	790	906	907	0.9988975
C6	40365296	40367437	BolC6t39404H	0	+	1722	2126	2141	0.9929940
C6	40368379	40369629	BolC6t39405H	0	-	278	933	1250	0.7464000
C6	40379417	40379582	BolC6t39406H	0	-	57	165	165	1.0000000
C6	40383391	40383644	BolC6t39407H	0	+	100	253	253	1.0000000
C6	40388896	40390399	BolC6t39408H	0	+	48	786	1503	0.5229541
C6	40402587	40402947	BolC6t39409H	0	+	0	0	360	0.0000000
C6	40406786	40407130	BolC6t39410H	0	+	78	274	344	0.7965117
C6	40410553	40410784	BolC6t39411H	0	+	222	231	231	1.0000000
C6	40411589	40412645	BolC6t39412H	0	+	32	889	1056	0.8418561
C6	40416714	40417384	BolC6t39413H	0	+	571	670	670	1.0000000
C6	40428171	40428582	BolC6t39414H	0	+	553	411	411	1.0000000
C6	40434219	40434990	BolC6t39415H	0	+	32	397	771	0.5149157
C6	40446553	40447482	BolC6t39416H	0	+	413	927	929	0.9978471
C6	40452640	40462615	BolC6t39417H	0	+	5950	9934	9975	0.9958897
C6	40463250	40465040	BolC6t39418H	0	-	1632	1701	1790	0.9502794
C6	40472532	40473809	BolC6t39419H	0	-	352	1008	1277	0.7893500
C6	40492091	40493557	BolC6t39420H	0	-	586	1309	1466	0.8929059
C6	40494503	40495734	BolC6t39421H	0	+	726	1231	1231	1.0000000
C6	40520715	40521672	BolC6t39422H	0	+	242	735	957	0.7680251
C6	40533176	40534577	BolC6t39423H	0	+	289	1026	1401	0.7323340
C6	40540783	40541887	BolC6t39424H	0	-	803	1104	1104	1.0000000
C6	40542336	40544572	BolC6t39425H	0	+	424	1930	2236	0.8631485
C6	40548689	40549084	BolC6t39426H	0	+	96	395	395	1.0000000
C6	40552570	40553625	BolC6t39427H	0	+	266	1055	1055	1.0000000
C6	40556080	40556575	BolC6t39428H	0	+	435	495	495	1.0000000
C6	40562027	40562570	BolC6t39429H	0	-	71	433	543	0.7974218
C6	40596156	40597534	BolC6t39430H	0	+	116	637	1378	0.4622642
C6	40618461	40620253	BolC6t39431H	0	+	507	1765	1792	0.9849330
C6	40635812	40636137	BolC6t39432H	0	-	344	325	325	1.0000000
C6	40641056	40645265	BolC6t39433H	0	-	1559	3883	4209	0.9225469
C6	40653795	40658227	BolC6t39434H	0	-	3428	4432	4432	1.0000000
C6	40667414	40668592	BolC6t39435H	0	-	403	1170	1178	0.9932088
C6	40669809	40673784	BolC6t39436H	0	-	1001	3456	3975	0.8694339
C6	40681479	40684202	BolC6t39437H	0	+	439	1671	2723	0.6136614
C6	40694275	40695376	BolC6t39438H	0	-	185	1064	1101	0.9663942
C6	40703185	40705707	BolC6t39439H	0	-	28	829	2522	0.3287074
C6	40723291	40727844	BolC6t39440H	0	+	355	2633	4553	0.5783000
C6	40730642	40730840	BolC6t39441H	0	+	8	132	198	0.6666667
C6	40739564	40740348	BolC6t39442H	0	+	58	582	784	0.7423469
C6	40742861	40743927	BolC6t39443H	0	-	1007	1024	1066	0.9606004
C6	40744792	40744963	BolC6t39444H	0	-	39	165	171	0.9649123
C6	40750098	40750644	BolC6t39445H	0	-	25	433	546	0.7930403
C6	40756831	40758225	BolC6t39446H	0	+	843	1335	1394	0.9576758
C6	40761666	40762588	BolC6t39447H	0	-	366	854	922	0.9262473
C6	40766218	40767504	BolC6t39448H	0	-	311	1012	1286	0.7869362
C6	40769136	40769456	BolC6t39449H	0	+	133	270	320	0.8437500
C6	40778960	40779885	BolC6t39450H	0	-	133	712	925	0.7697297
C6	40788922	40789923	BolC6t39451H	0	-	59	788	1001	0.7872128
C6	40795114	40795952	BolC6t39452H	0	-	28	320	838	0.3818616
C6	40802912	40804456	BolC6t39453H	0	-	806	1460	1544	0.9455959
C6	40804872	40806807	BolC6t39454H	0	+	992	1935	1935	1.0000000
C6	40807048	40808762	BolC6t39455H	0	-	498	1542	1714	0.8996499
C6	40815599	40815932	BolC6t39456H	0	-	22	160	333	0.4804805
C6	40824517	40825547	BolC6t39457H	0	-	846	1030	1030	1.0000000
C6	40827822	40829607	BolC6t39458H	0	-	506	1568	1785	0.8784314
C6	40838710	40838962	BolC6t39459H	0	-	18	183	252	0.7261904
C6	40842411	40842954	BolC6t39460H	0	+	291	543	543	1.0000000
C6	40848634	40849524	BolC6t39461H	0	+	609	890	890	1.0000000
C6	40850880	40851598	BolC6t39462H	0	+	299	642	718	0.8941504
C6	40852806	40852998	BolC6t39463H	0	+	0	0	192	0.0000000
C6	40854074	40854853	BolC6t39464H	0	+	164	771	779	0.9897304
C6	40857230	40862631	BolC6t39465H	0	+	2603	5094	5401	0.9431587
C6	40862937	40867165	BolC6t39466H	0	-	1233	3858	4228	0.9124882
C6	40872460	40878368	BolC6t39467H	0	-	1893	5216	5908	0.8828707
C6	40882049	40884370	BolC6t39468H	0	+	189	1516	2321	0.6531667
C6	40887089	40887737	BolC6t39469H	0	+	1	20	648	0.0308642
C6	40891231	40893302	BolC6t39470H	0	+	472	1369	2071	0.6610333
C6	40893722	40895784	BolC6t39471H	0	-	1239	1997	2062	0.9684772
C6	40897762	40898914	BolC6t39472H	0	-	19	271	1152	0.2352431
C6	40904395	40906455	BolC6t39473H	0	-	929	2060	2060	1.0000000
C6	40908096	40908585	BolC6t39474H	0	+	322	489	489	1.0000000
C6	40909303	40911634	BolC6t39475H	0	-	830	2251	2331	0.9656799
C6	40913477	40915990	BolC6t39476H	0	+	1431	2482	2513	0.9876642
C6	40917672	40924577	BolC6t39477H	0	+	3569	6814	6905	0.9868211
C6	40924926	40926555	BolC6t39478H	0	-	1433	1629	1629	1.0000000
C6	40927962	40929108	BolC6t39479H	0	+	304	1027	1146	0.8961605
C6	40937529	40939735	BolC6t39480H	0	+	1207	2016	2206	0.9138713
C6	40959290	40959935	BolC6t39481H	0	-	205	645	645	1.0000000
C6	40962072	40963393	BolC6t39482H	0	+	311	1161	1321	0.8788797
C6	40966882	40972256	BolC6t39483H	0	-	1637	5112	5374	0.9512467
C6	40984207	40986223	BolC6t39484H	0	-	1732	1998	2016	0.9910714
C6	40990921	40996142	BolC6t39485H	0	-	3033	4932	5221	0.9446466
C6	41003404	41003611	BolC6t39486H	0	-	28	207	207	1.0000000
C6	41003668	41003947	BolC6t39487H	0	-	137	279	279	1.0000000
C6	41008959	41009430	BolC6t39488H	0	-	233	471	471	1.0000000
C6	41011870	41012437	BolC6t39489H	0	-	907	567	567	1.0000000
C6	41014564	41017716	BolC6t39490H	0	-	631	2997	3152	0.9508249
C6	41030228	41030964	BolC6t39491H	0	+	501	732	736	0.9945652
C6	41035936	41036206	BolC6t39492H	0	+	166	270	270	1.0000000
C6	41045647	41047716	BolC6t39493H	0	-	414	1614	2069	0.7800870
C6	41055055	41055445	BolC6t39494H	0	-	0	0	390	0.0000000
C6	41063538	41064181	BolC6t39495H	0	-	9	246	643	0.3825817
C6	41068037	41069112	BolC6t39496H	0	-	482	1075	1075	1.0000000
C6	41069552	41074452	BolC6t39497H	0	-	2860	4710	4900	0.9612245
C6	41085188	41087958	BolC6t39498H	0	-	165	909	2770	0.3281589
C6	41094990	41098677	BolC6t39499H	0	+	1176	3085	3687	0.8367236
C6	41099294	41100491	BolC6t39500H	0	-	314	1136	1197	0.9490393
C6	41101894	41105012	BolC6t39501H	0	+	672	2574	3118	0.8255292
C6	41105586	41106111	BolC6t39502H	0	-	394	525	525	1.0000000
C6	41108221	41108359	BolC6t39503H	0	+	128	138	138	1.0000000
C6	41108811	41110091	BolC6t39504H	0	+	318	1280	1280	1.0000000
C6	41115754	41120233	BolC6t39505H	0	+	1521	4005	4479	0.8941728
C6	41121031	41123081	BolC6t39506H	0	-	141	1141	2050	0.5565854
C6	41124244	41125636	BolC6t39507H	0	-	307	1392	1392	1.0000000
C6	41127869	41127974	BolC6t39508H	0	-	221	105	105	1.0000000
C6	41130193	41163476	BolC6t39509H	0	-	5946	25322	33283	0.7608088
C6	41181200	41183083	BolC6t39510H	0	+	2120	1883	1883	1.0000000
C6	41183468	41183708	BolC6t39511H	0	-	351	240	240	1.0000000
C6	41187738	41199680	BolC6t39512H	0	-	2786	7734	11942	0.6476302
C6	41193376	41194447	BolC6t39513H	0	-	24	350	1071	0.3267974
C6	41204317	41210363	BolC6t39514H	0	-	3137	5907	6046	0.9770096
C6	41220722	41221097	BolC6t39515H	0	+	7	187	375	0.4986667
C6	41226051	41228379	BolC6t39516H	0	+	219	1882	2328	0.8084192
C6	41230774	41231332	BolC6t39517H	0	+	46	424	558	0.7598566
C6	41235068	41235778	BolC6t39518H	0	+	1210	701	710	0.9873239
C6	41242269	41244802	BolC6t39519H	0	+	94	1211	2533	0.4780892
C6	41247161	41248578	BolC6t39520H	0	+	173	964	1417	0.6803105
C6	41250721	41252949	BolC6t39521H	0	+	223	2034	2228	0.9129264
C6	41262549	41262786	BolC6t39522H	0	+	217	237	237	1.0000000
C6	41266047	41267768	BolC6t39523H	0	+	507	1151	1721	0.6687972
C6	41268594	41269035	BolC6t39524H	0	-	145	441	441	1.0000000
C6	41269695	41270756	BolC6t39525H	0	+	500	1061	1061	1.0000000
C6	41271603	41274269	BolC6t39526H	0	+	673	2589	2666	0.9711178
C6	41276261	41276828	BolC6t39527H	0	+	158	484	567	0.8536155
C6	41286137	41286579	BolC6t39528H	0	-	0	0	442	0.0000000
C6	41291511	41291805	BolC6t39529H	0	-	2	204	294	0.6938776
C6	41299906	41302021	BolC6t39530H	0	+	421	1468	2115	0.6940898
C6	41305791	41307130	BolC6t39531H	0	+	182	1294	1339	0.9663928
C6	41309723	41310484	BolC6t39532H	0	-	586	761	761	1.0000000
C6	41315539	41317113	BolC6t39533H	0	+	325	1471	1574	0.9345616
C6	41319157	41319447	BolC6t39534H	0	+	13	239	290	0.8241379
C6	41320099	41320685	BolC6t39535H	0	+	46	452	586	0.7713311
C6	41325167	41325419	BolC6t39536H	0	+	57	252	252	1.0000000
C6	41329888	41332016	BolC6t39537H	0	+	1106	2128	2128	1.0000000
C6	41348614	41349199	BolC6t39538H	0	+	478	585	585	1.0000000
C6	41350835	41354679	BolC6t39539H	0	-	1420	3742	3844	0.9734651
C6	41366599	41368506	BolC6t39540H	0	-	255	1846	1907	0.9680126
C6	41375490	41378149	BolC6t39541H	0	-	475	2540	2659	0.9552463
C6	41383161	41384047	BolC6t39542H	0	+	183	722	886	0.8148984
C6	41384298	41386963	BolC6t39543H	0	-	148	2194	2665	0.8232645
C6	41392281	41392500	BolC6t39544H	0	-	225	219	219	1.0000000
C6	41399284	41401932	BolC6t39545H	0	+	251	1673	2648	0.6317976
C6	41404369	41404865	BolC6t39546H	0	-	101	490	496	0.9879032
C6	41416403	41417867	BolC6t39547H	0	+	805	1383	1464	0.9446721
C6	41418520	41419407	BolC6t39548H	0	+	420	874	887	0.9853439
C6	41420285	41423111	BolC6t39549H	0	+	1585	2826	2826	1.0000000
C6	41424335	41425015	BolC6t39550H	0	-	351	680	680	1.0000000
C6	41432698	41432962	BolC6t39551H	0	-	47	217	264	0.8219697
C6	41434655	41435428	BolC6t39552H	0	-	321	725	773	0.9379043
C6	41440388	41441162	BolC6t39553H	0	-	401	774	774	1.0000000
C6	41442484	41443185	BolC6t39554H	0	-	242	701	701	1.0000000
C6	41445687	41449933	BolC6t39555H	0	-	1861	4030	4246	0.9491286
C6	41451700	41451964	BolC6t39556H	0	-	5	196	264	0.7424242
C6	41463065	41463347	BolC6t39557H	0	+	13	191	282	0.6773050
C6	41467944	41469070	BolC6t39558H	0	+	68	494	1126	0.4387212
C6	41470521	41471720	BolC6t39559H	0	-	654	1196	1199	0.9974979
C6	41473633	41475036	BolC6t39560H	0	+	1015	1403	1403	1.0000000
C6	41477304	41479488	BolC6t39561H	0	+	8	342	2184	0.1565934
C6	41508517	41511207	BolC6t39562H	0	+	66	1266	2690	0.4706320
C6	41519216	41521474	BolC6t39563H	0	+	202	1782	2258	0.7891940
C6	41522695	41523127	BolC6t39564H	0	-	48	399	432	0.9236111
C6	41524314	41525316	BolC6t39565H	0	-	520	1002	1002	1.0000000
C6	41526698	41527091	BolC6t39566H	0	-	38	101	393	0.2569975
C6	41528926	41529840	BolC6t39567H	0	-	275	889	914	0.9726477
C6	41550150	41550964	BolC6t39568H	0	-	180	814	814	1.0000000
C6	41567280	41573188	BolC6t39569H	0	+	2264	5779	5908	0.9781652
C6	41574168	41574835	BolC6t39570H	0	-	110	470	667	0.7046477
C6	41576012	41578878	BolC6t39571H	0	-	314	2362	2866	0.8241451
C6	41590500	41590647	BolC6t39572H	0	-	165	147	147	1.0000000
C6	41593194	41597380	BolC6t39573H	0	-	778	3366	4186	0.8041089
C6	41605516	41606230	BolC6t39574H	0	-	405	714	714	1.0000000
C6	41610833	41612395	BolC6t39575H	0	-	393	1532	1562	0.9807938
C6	41612878	41614615	BolC6t39576H	0	-	851	1731	1737	0.9965458
C6	41620231	41621599	BolC6t39577H	0	+	313	1183	1368	0.8647661
C6	41625157	41627767	BolC6t39578H	0	+	1454	2610	2610	1.0000000
C6	41637516	41639587	BolC6t39579H	0	+	436	1900	2071	0.9174312
C6	41639688	41642101	BolC6t39580H	0	+	1190	2258	2413	0.9357646
C6	41645231	41645756	BolC6t39581H	0	-	334	525	525	1.0000000
C6	41648837	41650334	BolC6t39582H	0	-	1443	1392	1497	0.9298597
C6	41652414	41653713	BolC6t39583H	0	-	42	997	1299	0.7675135
C6	41656457	41658270	BolC6t39584H	0	+	385	1722	1813	0.9498069
C6	41659941	41660225	BolC6t39585H	0	+	0	0	284	0.0000000
C6	41666821	41668006	BolC6t39586H	0	-	151	1012	1185	0.8540084
C6	41677460	41678287	BolC6t39587H	0	+	0	0	827	0.0000000
C6	41680606	41680877	BolC6t39588H	0	+	0	0	271	0.0000000
C6	41685650	41695614	BolC6t39589H	0	+	3194	7931	9964	0.7959655
C6	41695993	41698217	BolC6t39590H	0	-	1886	2224	2224	1.0000000
C6	41704401	41707763	BolC6t39591H	0	+	758	2874	3362	0.8548483
C6	41708368	41712212	BolC6t39592H	0	+	818	3505	3844	0.9118106
C6	41712755	41714166	BolC6t39593H	0	+	861	1350	1411	0.9567683
C6	41714440	41715872	BolC6t39594H	0	-	233	1378	1432	0.9622905
C6	41716238	41722273	BolC6t39595H	0	+	1380	5002	6035	0.8288318
C6	41724855	41731833	BolC6t39596H	0	-	1255	4462	6978	0.6394382
C6	41726558	41729643	BolC6t39597H	0	+	216	1229	3085	0.3983793
C6	41732651	41736102	BolC6t39598H	0	-	801	2907	3451	0.8423645
C6	41736807	41739543	BolC6t39599H	0	-	1139	2487	2736	0.9089912
C6	41739924	41741109	BolC6t39600H	0	+	198	1151	1185	0.9713080
C6	41741614	41743418	BolC6t39601H	0	-	734	1333	1804	0.7389135
C6	41750502	41751543	BolC6t39602H	0	-	4	235	1041	0.2257445
C6	41763299	41763738	BolC6t39603H	0	-	9	349	439	0.7949886
C6	41767739	41769493	BolC6t39604H	0	-	182	1485	1754	0.8466362
C6	41771876	41839100	BolC6t39605H	0	+	7811	31159	67224	0.4635101
C6	41810264	41810750	BolC6t39606H	0	-	0	0	486	0.0000000
C6	41817207	41818600	BolC6t39607H	0	+	154	765	1393	0.5491744
C6	41839988	41844550	BolC6t39608H	0	-	3419	4461	4562	0.9778606
C6	41844864	41847111	BolC6t39609H	0	-	679	2088	2247	0.9292390
C6	41847870	41848401	BolC6t39610H	0	+	126	531	531	1.0000000
C6	41848549	41851377	BolC6t39611H	0	-	2020	2828	2828	1.0000000
C6	41853696	41854248	BolC6t39612H	0	+	79	552	552	1.0000000
C6	41854918	41856988	BolC6t39613H	0	-	343	1729	2070	0.8352657
C6	41857520	41859552	BolC6t39614H	0	+	1566	2032	2032	1.0000000
C6	41862494	41862737	BolC6t39615H	0	-	162	243	243	1.0000000
C6	41864215	41864632	BolC6t39616H	0	+	232	408	417	0.9784173
C6	41866161	41869049	BolC6t39617H	0	+	712	2556	2888	0.8850415
C6	41870467	41872891	BolC6t39618H	0	+	363	2074	2424	0.8556105
C6	41873934	41874983	BolC6t39619H	0	+	218	1013	1049	0.9656816
C6	41876412	41879099	BolC6t39620H	0	-	854	2317	2687	0.8623000
C6	41880845	41884336	BolC6t39621H	0	-	249	2462	3491	0.7052420
C6	41899601	41900165	BolC6t39622H	0	-	44	553	564	0.9804965
C6	41905989	41907980	BolC6t39623H	0	+	568	1747	1991	0.8774485
C6	41914711	41916242	BolC6t39624H	0	+	522	1338	1531	0.8739386
C6	41920046	41920163	BolC6t39625H	0	+	50	117	117	1.0000000
C6	41920834	41923856	BolC6t39626H	0	-	466	1729	3022	0.5721377
C6	41939576	41941116	BolC6t39627H	0	+	219	1409	1540	0.9149351
C6	41942090	41942753	BolC6t39628H	0	+	233	663	663	1.0000000
C6	41952787	41954900	BolC6t39629H	0	+	525	1941	2113	0.9185991
C6	41955171	41955645	BolC6t39630H	0	-	325	474	474	1.0000000
C6	41956035	41956437	BolC6t39631H	0	+	156	402	402	1.0000000
C6	41956748	41957769	BolC6t39632H	0	-	901	1021	1021	1.0000000
C6	41959113	41960132	BolC6t39633H	0	+	491	957	1019	0.9391561
C6	41960399	41962958	BolC6t39634H	0	-	282	1866	2559	0.7291911
C6	41967081	41967198	BolC6t39635H	0	-	0	0	117	0.0000000
C6	41972840	41973946	BolC6t39636H	0	-	581	1106	1106	1.0000000
C6	41974169	41975937	BolC6t39637H	0	+	541	1705	1768	0.9643665
C6	41976826	41978527	BolC6t39638H	0	-	484	1458	1701	0.8571429
C6	41981738	41983175	BolC6t39639H	0	-	732	1414	1437	0.9839944
C6	41985591	41989259	BolC6t39640H	0	-	1363	3476	3668	0.9476554
C6	41990425	41997538	BolC6t39641H	0	+	1582	6427	7113	0.9035569
C6	42002419	42006096	BolC6t39642H	0	+	1508	3620	3677	0.9844982
C6	42006469	42008291	BolC6t39643H	0	+	1347	1822	1822	1.0000000
C6	42011328	42011683	BolC6t39644H	0	+	215	303	355	0.8535211
C6	42011953	42013225	BolC6t39645H	0	-	873	1272	1272	1.0000000
C6	42013502	42015563	BolC6t39646H	0	-	1438	1992	2061	0.9665211
C6	42017680	42019126	BolC6t39647H	0	+	133	1167	1446	0.8070539
C6	42020578	42022861	BolC6t39648H	0	-	519	2081	2283	0.9115199
C6	42079605	42081629	BolC6t39649H	0	+	687	1689	2024	0.8344862
C6	42084026	42085943	BolC6t39650H	0	+	1430	1904	1917	0.9932185
C6	42088937	42092972	BolC6t39651H	0	+	1303	2311	4035	0.5727385
C6	42094427	42094922	BolC6t39652H	0	+	263	495	495	1.0000000
C6	42105190	42107074	BolC6t39653H	0	+	1176	1884	1884	1.0000000
C6	42128010	42129802	BolC6t39654H	0	+	192	771	1792	0.4302455
C6	42130774	42132159	BolC6t39655H	0	+	345	1272	1385	0.9184116
C6	42132602	42134295	BolC6t39656H	0	-	997	1693	1693	1.0000000
C6	42135754	42137470	BolC6t39657H	0	-	12	692	1716	0.4032634
C6	42138221	42141527	BolC6t39658H	0	-	899	3013	3306	0.9113733
C6	42152280	42152766	BolC6t39659H	0	+	600	486	486	1.0000000
C6	42153295	42153898	BolC6t39660H	0	+	470	603	603	1.0000000
C6	42161847	42163464	BolC6t39661H	0	+	563	1606	1617	0.9931973
C6	42165850	42167383	BolC6t39662H	0	+	416	1478	1533	0.9641227
C6	42168912	42171732	BolC6t39663H	0	+	167	1622	2820	0.5751773
C6	42175249	42176320	BolC6t39664H	0	+	426	1071	1071	1.0000000
C6	42176783	42177543	BolC6t39665H	0	-	94	616	760	0.8105263
C6	42182769	42183134	BolC6t39666H	0	+	7	186	365	0.5095890
C6	42184660	42187082	BolC6t39667H	0	-	1209	2339	2422	0.9657308
C6	42193402	42197175	BolC6t39668H	0	-	851	3247	3773	0.8605884
C6	42198803	42200879	BolC6t39669H	0	-	1131	2076	2076	1.0000000
C6	42201499	42204811	BolC6t39670H	0	-	1591	3312	3312	1.0000000
C6	42209437	42211124	BolC6t39671H	0	+	1173	1687	1687	1.0000000
C6	42212534	42213518	BolC6t39672H	0	-	38	114	984	0.1158537
C6	42218029	42218603	BolC6t39673H	0	-	137	403	574	0.7020906
C6	42221476	42222069	BolC6t39674H	0	-	384	593	593	1.0000000
C6	42223044	42227150	BolC6t39675H	0	-	1633	3723	4106	0.9067219
C6	42235888	42239624	BolC6t39676H	0	+	1023	2734	3736	0.7317987
C6	42239864	42241759	BolC6t39677H	0	+	1093	1480	1895	0.7810026
C6	42255657	42257757	BolC6t39678H	0	+	623	2039	2100	0.9709524
C6	42268623	42269653	BolC6t39679H	0	+	1190	1030	1030	1.0000000
C6	42272395	42273919	BolC6t39680H	0	+	815	1497	1524	0.9822835
C6	42276326	42277052	BolC6t39681H	0	+	102	726	726	1.0000000
C6	42285049	42288177	BolC6t39682H	0	+	471	2345	3128	0.7496803
C6	42297925	42300376	BolC6t39683H	0	+	1364	2268	2451	0.9253366
C6	42309258	42310191	BolC6t39684H	0	-	268	933	933	1.0000000
C6	42316351	42316471	BolC6t39685H	0	-	73	120	120	1.0000000
C6	42317797	42319288	BolC6t39686H	0	+	824	1286	1491	0.8625084
C6	42326970	42327153	BolC6t39687H	0	-	39	183	183	1.0000000
C6	42332615	42333014	BolC6t39688H	0	+	45	310	399	0.7769424
C6	42345277	42350007	BolC6t39689H	0	+	2394	4729	4730	0.9997886
C6	42352702	42353824	BolC6t39690H	0	+	953	975	1122	0.8689840
C6	42354689	42355270	BolC6t39691H	0	+	180	581	581	1.0000000
C6	42355815	42369052	BolC6t39692H	0	-	6848	13055	13237	0.9862506
C6	42362604	42363261	BolC6t39693H	0	+	136	628	657	0.9558600
C6	42366293	42367863	BolC6t39694H	0	+	316	1417	1570	0.9025478
C6	42369337	42371720	BolC6t39695H	0	-	1197	2241	2383	0.9404113
C6	42384045	42384642	BolC6t39696H	0	+	79	555	597	0.9296482
C6	42398713	42399382	BolC6t39697H	0	+	169	669	669	1.0000000
C6	42410458	42411127	BolC6t39698H	0	+	709	669	669	1.0000000
C6	42413832	42414474	BolC6t39699H	0	+	104	334	642	0.5202492
C6	42428391	42475178	BolC6t39700H	0	+	45990	36537	46787	0.7809221
C6	42433162	42434981	BolC6t39701H	0	+	975	1815	1819	0.9978010
C6	42444039	42444381	BolC6t39702H	0	-	283	342	342	1.0000000
C6	42450679	42451282	BolC6t39703H	0	+	402	603	603	1.0000000
C6	42485427	42485574	BolC6t39704H	0	+	0	0	147	0.0000000
C6	42494123	42494780	BolC6t39705H	0	+	1	110	657	0.1674277
C6	42497049	42497235	BolC6t39706H	0	-	21	90	186	0.4838710
C6	42502535	42503181	BolC6t39707H	0	+	439	646	646	1.0000000
C6	42504711	42504999	BolC6t39708H	0	-	55	170	288	0.5902778
C6	42515094	42515743	BolC6t39709H	0	+	439	649	649	1.0000000
C6	42518065	42521329	BolC6t39710H	0	-	1384	2867	3264	0.8783701
C6	42528698	42529613	BolC6t39711H	0	+	417	915	915	1.0000000
C6	42530666	42531050	BolC6t39712H	0	+	390	384	384	1.0000000
C6	42531321	42535125	BolC6t39713H	0	-	1526	3589	3804	0.9434806
C6	42535457	42537678	BolC6t39714H	0	+	1495	2200	2221	0.9905448
C6	42537941	42540290	BolC6t39715H	0	+	355	1544	2349	0.6573010
C6	42541199	42541841	BolC6t39716H	0	-	211	629	642	0.9797508
C6	42544174	42544798	BolC6t39717H	0	+	343	557	624	0.8926282
C6	42546776	42548086	BolC6t39718H	0	-	424	1310	1310	1.0000000
C6	42548603	42554285	BolC6t39719H	0	+	1701	4229	5682	0.7442802
C6	42557697	42558735	BolC6t39720H	0	-	1592	1038	1038	1.0000000
C6	42562129	42564691	BolC6t39721H	0	-	1597	2307	2562	0.9004684
C6	42570071	42570425	BolC6t39722H	0	-	258	354	354	1.0000000
C6	42575271	42580176	BolC6t39723H	0	-	2816	4817	4905	0.9820591
C6	42581432	42583055	BolC6t39724H	0	-	865	1623	1623	1.0000000
C6	42601946	42603042	BolC6t39725H	0	-	575	1065	1096	0.9717153
C6	42622984	42626449	BolC6t39726H	0	-	1351	3142	3465	0.9067821
C6	42629547	42629829	BolC6t39727H	0	-	275	282	282	1.0000000
C6	42630059	42630317	BolC6t39728H	0	+	47	258	258	1.0000000
C6	42641028	42641514	BolC6t39729H	0	+	41	348	486	0.7160494
C6	42651754	42652554	BolC6t39730H	0	+	326	782	800	0.9775000
C6	42653540	42655245	BolC6t39731H	0	-	374	1192	1705	0.6991202
C6	42662457	42662721	BolC6t39732H	0	-	189	264	264	1.0000000
C6	42662854	42666926	BolC6t39733H	0	-	2406	3811	4072	0.9359037
C6	42669979	42670363	BolC6t39734H	0	+	399	384	384	1.0000000
C6	42670836	42671671	BolC6t39735H	0	-	320	794	835	0.9508982
C6	42673294	42674176	BolC6t39736H	0	+	403	882	882	1.0000000
C6	42675006	42676609	BolC6t39737H	0	-	1186	1547	1603	0.9650655
C6	42678199	42683775	BolC6t39738H	0	+	4605	5527	5576	0.9912124
C6	42684175	42685890	BolC6t39739H	0	-	972	1715	1715	1.0000000
C6	42687159	42688657	BolC6t39740H	0	-	682	1413	1498	0.9432577
C6	42699254	42704149	BolC6t39741H	0	+	2213	4895	4895	1.0000000
C6	42705376	42709395	BolC6t39742H	0	+	1591	3706	4019	0.9221199
C6	42710317	42718534	BolC6t39743H	0	-	3144	7519	8217	0.9150541
C6	42719595	42720159	BolC6t39744H	0	+	159	554	564	0.9822695
C6	42721184	42724544	BolC6t39745H	0	-	591	2677	3360	0.7967262
C6	42728748	42730484	BolC6t39746H	0	+	592	1733	1736	0.9982719
C6	42732249	42733827	BolC6t39747H	0	+	645	1569	1578	0.9942966
C6	42735735	42736773	BolC6t39748H	0	+	501	1038	1038	1.0000000
C6	42737726	42740792	BolC6t39749H	0	-	1093	2855	3066	0.9311807
C6	42741970	42742445	BolC6t39750H	0	+	498	475	475	1.0000000
C6	42744180	42746222	BolC6t39751H	0	-	386	1906	2042	0.9333986
C6	42749412	42753060	BolC6t39752H	0	-	2267	3648	3648	1.0000000
C6	42754623	42756084	BolC6t39753H	0	+	1100	1461	1461	1.0000000
C6	42757192	42758530	BolC6t39754H	0	-	978	1338	1338	1.0000000
C6	42758549	42763832	BolC6t39755H	0	-	2949	5283	5283	1.0000000
C6	42766222	42768338	BolC6t39756H	0	+	1547	2116	2116	1.0000000
C6	42769035	42771094	BolC6t39757H	0	-	2101	2059	2059	1.0000000
C6	42787726	42798297	BolC6t39758H	0	+	1959	6659	10571	0.6299309
C6	42792114	42793482	BolC6t39759H	0	+	376	1368	1368	1.0000000
C6	42800242	42803687	BolC6t39760H	0	+	2384	3445	3445	1.0000000
C6	42821439	42822787	BolC6t39761H	0	+	1174	1348	1348	1.0000000
C6	42822886	42826915	BolC6t39762H	0	+	1693	3643	4029	0.9041946
C6	42828621	42829967	BolC6t39763H	0	-	846	1346	1346	1.0000000
C6	42835881	42839123	BolC6t39764H	0	-	1089	3207	3242	0.9892042
C6	42839933	42840744	BolC6t39765H	0	+	385	811	811	1.0000000
C6	42841309	42843156	BolC6t39766H	0	-	657	1719	1847	0.9306985
C6	42843634	42848110	BolC6t39767H	0	+	736	2443	4476	0.5457998
C6	42849458	42851489	BolC6t39768H	0	+	559	1774	2031	0.8734614
C6	42851760	42854003	BolC6t39769H	0	-	2276	2241	2243	0.9991083
C6	42854643	42855106	BolC6t39770H	0	-	466	463	463	1.0000000
C6	42859525	42859747	BolC6t39771H	0	-	6	135	222	0.6081081
C6	42875413	42876392	BolC6t39772H	0	+	243	769	979	0.7854954
C6	42876644	42879307	BolC6t39773H	0	-	698	2433	2663	0.9136313
C6	42881353	42883248	BolC6t39774H	0	-	1528	1826	1895	0.9635884
C6	42895864	42897885	BolC6t39775H	0	+	197	1337	2021	0.6615537
C6	42898236	42899071	BolC6t39776H	0	-	762	835	835	1.0000000
C6	42899893	42902063	BolC6t39777H	0	-	2070	2160	2170	0.9953917
C6	42903357	42904302	BolC6t39778H	0	-	311	945	945	1.0000000
C6	42905369	42905759	BolC6t39779H	0	-	166	390	390	1.0000000
C6	42907820	42908456	BolC6t39780H	0	-	185	636	636	1.0000000
C6	42925474	42926092	BolC6t39781H	0	-	1364	618	618	1.0000000
C6	42931554	42932739	BolC6t39782H	0	+	16	687	1185	0.5797468
C6	42933673	42934306	BolC6t39783H	0	-	1344	633	633	1.0000000
C6	42936434	42974933	BolC6t39784H	0	-	23672	36512	38499	0.9483883
C6	42945050	42945695	BolC6t39785H	0	-	417	645	645	1.0000000
C6	42951914	42952544	BolC6t39786H	0	-	454	630	630	1.0000000
C6	42956225	42956780	BolC6t39787H	0	-	5	132	555	0.2378378
C6	42962536	42963181	BolC6t39788H	0	-	305	645	645	1.0000000
C6	42969975	42970455	BolC6t39789H	0	+	337	347	480	0.7229167
C6	42975755	42976075	BolC6t39790H	0	-	454	320	320	1.0000000
C6	42977256	42977934	BolC6t39791H	0	-	254	437	678	0.6445428
C6	42979378	42981499	BolC6t39792H	0	+	791	2121	2121	1.0000000
C6	42981928	42982527	BolC6t39793H	0	-	265	538	599	0.8981636
C6	42984244	42987540	BolC6t39794H	0	-	1297	2756	3296	0.8361651
C6	42990023	42993719	BolC6t39795H	0	-	1474	3351	3696	0.9066558
C6	42994933	42997649	BolC6t39796H	0	-	1694	2670	2716	0.9830633
C6	43007837	43009487	BolC6t39797H	0	+	567	1474	1650	0.8933333
C6	43011983	43013219	BolC6t39798H	0	+	888	1236	1236	1.0000000
C6	43024104	43030316	BolC6t39799H	0	+	2669	5572	6212	0.8969736
C6	43031810	43036532	BolC6t39800H	0	+	1499	4475	4722	0.9476917
C6	43059912	43062348	BolC6t39801H	0	+	195	1012	2436	0.4154351
C6	43069298	43070153	BolC6t39802H	0	-	740	855	855	1.0000000
C6	43074029	43074648	BolC6t39803H	0	-	278	619	619	1.0000000
C6	43075805	43076690	BolC6t39804H	0	-	9	195	885	0.2203390
C6	43078045	43078810	BolC6t39805H	0	-	237	757	765	0.9895425
C6	43083460	43086520	BolC6t39806H	0	+	426	2531	3060	0.8271242
C6	43092744	43093071	BolC6t39807H	0	+	44	299	327	0.9143731
C6	43095949	43096494	BolC6t39808H	0	-	391	545	545	1.0000000
C6	43110457	43112299	BolC6t39809H	0	-	421	1708	1842	0.9272530
C6	43127051	43128567	BolC6t39810H	0	+	354	1467	1516	0.9676781
C6	43129191	43129533	BolC6t39811H	0	-	6	149	342	0.4356725
C6	43130766	43131831	BolC6t39812H	0	+	287	1045	1065	0.9812207
C6	43133370	43133850	BolC6t39813H	0	+	95	457	480	0.9520833
C6	43136820	43138285	BolC6t39814H	0	+	211	1393	1465	0.9508532
C6	43138577	43140245	BolC6t39815H	0	-	841	1607	1668	0.9634293
C6	43140511	43145199	BolC6t39816H	0	-	2162	4663	4688	0.9946672
C6	43154477	43157474	BolC6t39817H	0	-	877	2936	2997	0.9796463
C6	43164332	43166068	BolC6t39818H	0	+	889	1725	1736	0.9936636
C6	43167610	43170026	BolC6t39819H	0	-	2750	2404	2416	0.9950331
C6	43174568	43176270	BolC6t39820H	0	+	1	25	1702	0.0146886
C6	43180192	43183138	BolC6t39821H	0	+	1151	2920	2946	0.9911745
C6	43183614	43187680	BolC6t39822H	0	+	1570	3953	4066	0.9722086
C6	43188493	43190594	BolC6t39823H	0	-	781	1959	2101	0.9324132
C6	43192457	43194032	BolC6t39824H	0	+	223	1247	1575	0.7917460
C6	43201201	43203600	BolC6t39825H	0	+	1166	2060	2399	0.8586911
C6	43204085	43205968	BolC6t39826H	0	-	966	1873	1883	0.9946893
C6	43209284	43209578	BolC6t39827H	0	+	192	294	294	1.0000000
C6	43211299	43211509	BolC6t39828H	0	+	124	193	210	0.9190476
C6	43212149	43215660	BolC6t39829H	0	-	1022	3129	3511	0.8911991
C6	43225158	43227887	BolC6t39830H	0	-	603	2043	2729	0.7486259
C6	43228638	43228878	BolC6t39831H	0	-	84	240	240	1.0000000
C6	43230343	43232310	BolC6t39832H	0	+	867	1590	1967	0.8083376
C6	43236441	43237751	BolC6t39833H	0	+	49	994	1310	0.7587786
C6	43243127	43243986	BolC6t39834H	0	-	749	859	859	1.0000000
C6	43245815	43249161	BolC6t39835H	0	+	776	2838	3346	0.8481770
C6	43249811	43254520	BolC6t39836H	0	-	2308	4272	4709	0.9071990
C6	43256171	43259421	BolC6t39837H	0	+	2427	3154	3250	0.9704615
C6	43259989	43260738	BolC6t39838H	0	-	666	749	749	1.0000000
C6	43262453	43265753	BolC6t39839H	0	+	1631	3280	3300	0.9939394
C6	43266493	43267213	BolC6t39840H	0	-	248	660	720	0.9166667
C6	43268412	43271886	BolC6t39841H	0	-	1572	3346	3474	0.9631549
C6	43272868	43281725	BolC6t39842H	0	-	1368	7650	8857	0.8637236
C6	43283724	43284039	BolC6t39843H	0	+	135	309	315	0.9809524
C6	43285923	43290674	BolC6t39844H	0	+	1699	4319	4751	0.9090718
C6	43296124	43296616	BolC6t39845H	0	+	205	492	492	1.0000000
C6	43297140	43305614	BolC6t39846H	0	+	1839	5185	8474	0.6118716
C6	43305797	43306475	BolC6t39847H	0	+	78	669	678	0.9867257
C6	43306809	43307955	BolC6t39848H	0	-	500	1066	1146	0.9301920
C6	43308442	43310455	BolC6t39849H	0	-	287	1606	2013	0.7978142
C6	43312571	43314006	BolC6t39850H	0	-	167	1144	1435	0.7972125
C6	43321833	43324286	BolC6t39851H	0	-	697	2400	2453	0.9783938
C6	43326999	43327437	BolC6t39852H	0	+	457	438	438	1.0000000
C6	43327757	43329997	BolC6t39853H	0	-	367	1251	2240	0.5584822
C6	43331976	43333564	BolC6t39854H	0	+	361	736	1588	0.4634761
C6	43348181	43349216	BolC6t39855H	0	+	544	1035	1035	1.0000000
C6	43359110	43360145	BolC6t39856H	0	+	784	1035	1035	1.0000000
C6	43360407	43361424	BolC6t39857H	0	-	203	1000	1017	0.9832842
C6	43362944	43364714	BolC6t39858H	0	-	258	1497	1770	0.8457627
C6	43375929	43391668	BolC6t39859H	0	-	1482	6815	15739	0.4330008
C6	43378313	43381714	BolC6t39860H	0	+	335	1762	3401	0.5180829
C6	43392763	43393579	BolC6t39861H	0	+	416	816	816	1.0000000
C6	43395714	43396411	BolC6t39862H	0	-	450	697	697	1.0000000
C6	43396810	43399425	BolC6t39863H	0	+	2368	2615	2615	1.0000000
C6	43400708	43403789	BolC6t39864H	0	+	1171	2877	3081	0.9337877
C6	43407897	43419838	BolC6t39865H	0	-	2845	6425	11941	0.5380622
C6	43412619	43415413	BolC6t39866H	0	-	912	1556	2794	0.5569077
C6	43420585	43420948	BolC6t39867H	0	-	555	363	363	1.0000000
C6	43420994	43424733	BolC6t39868H	0	-	1950	3632	3739	0.9713827
C6	43425634	43427395	BolC6t39869H	0	+	1136	1761	1761	1.0000000
C6	43427616	43428617	BolC6t39870H	0	-	340	998	1001	0.9970030
C6	43429785	43431158	BolC6t39871H	0	+	1364	1373	1373	1.0000000
C6	43431811	43434020	BolC6t39872H	0	+	528	1684	2209	0.7623359
C6	43434882	43439514	BolC6t39873H	0	-	688	3646	4632	0.7871330
C6	43440370	43441269	BolC6t39874H	0	-	394	891	899	0.9911012
C6	43441618	43442883	BolC6t39875H	0	+	274	1241	1265	0.9810277
C6	43443229	43446762	BolC6t39876H	0	-	854	3294	3533	0.9323521
C6	43447632	43449194	BolC6t39877H	0	+	261	1133	1562	0.7253521
C6	43449638	43453505	BolC6t39878H	0	-	1442	3676	3867	0.9506077
C6	43455075	43455445	BolC6t39879H	0	-	57	359	370	0.9702703
C6	43455768	43458156	BolC6t39880H	0	-	444	2318	2388	0.9706868
C6	43460788	43464944	BolC6t39881H	0	+	581	3180	4156	0.7651588
C6	43465120	43466318	BolC6t39882H	0	-	571	1198	1198	1.0000000
C6	43466788	43468159	BolC6t39883H	0	+	269	1350	1371	0.9846827
C6	43468555	43470342	BolC6t39884H	0	-	946	1787	1787	1.0000000
C6	43473435	43475102	BolC6t39885H	0	+	1296	1667	1667	1.0000000
C6	43487405	43489187	BolC6t39886H	0	+	442	1782	1782	1.0000000
C6	43500487	43516087	BolC6t39887H	0	-	6873	15294	15600	0.9803846
C6	43516623	43517076	BolC6t39888H	0	-	265	453	453	1.0000000
C6	43521568	43523388	BolC6t39889H	0	+	712	1714	1820	0.9417582
C6	43531498	43531987	BolC6t39890H	0	+	651	489	489	1.0000000
C6	43534438	43535580	BolC6t39891H	0	+	33	232	1142	0.2031524
C6	43539487	43540725	BolC6t39892H	0	-	1038	1238	1238	1.0000000
C6	43544428	43545580	BolC6t39893H	0	+	88	816	1152	0.7083333
C6	43545994	43548779	BolC6t39894H	0	+	2954	2785	2785	1.0000000
C6	43550061	43552125	BolC6t39895H	0	+	604	1997	2064	0.9675388
C6	43552226	43553309	BolC6t39896H	0	-	298	1053	1083	0.9722992
C6	43558579	43559139	BolC6t39897H	0	+	842	560	560	1.0000000
C6	43560686	43565449	BolC6t39898H	0	-	1344	2532	4763	0.5315977
C6	43573528	43573910	BolC6t39899H	0	-	139	382	382	1.0000000
C6	43582208	43583468	BolC6t39900H	0	+	1120	1260	1260	1.0000000
C6	43584125	43587392	BolC6t39901H	0	-	2902	3267	3267	1.0000000
C6	43588694	43590989	BolC6t39902H	0	+	385	2061	2295	0.8980392
C6	43591216	43591987	BolC6t39903H	0	-	703	733	771	0.9507133
C6	43592429	43595129	BolC6t39904H	0	-	725	2643	2700	0.9788889
C6	43601678	43601876	BolC6t39905H	0	+	142	198	198	1.0000000
C6	43607527	43608903	BolC6t39906H	0	+	12	237	1376	0.1722384
C6	43610857	43611178	BolC6t39907H	0	+	0	0	321	0.0000000
C6	43615303	43615588	BolC6t39908H	0	-	38	242	285	0.8491228
C6	43622974	43625107	BolC6t39909H	0	-	117	386	2133	0.1809658
C6	43625310	43627050	BolC6t39910H	0	-	28	117	1740	0.0672414
C6	43631107	43635679	BolC6t39911H	0	+	2353	4452	4572	0.9737533
C6	43636299	43637006	BolC6t39912H	0	+	42	513	707	0.7256011
C6	43637624	43639901	BolC6t39913H	0	-	381	1915	2277	0.8410189
C6	43644268	43646482	BolC6t39914H	0	+	318	2200	2214	0.9936766
C6	43647132	43647756	BolC6t39915H	0	-	206	621	624	0.9951923
C6	43647771	43652073	BolC6t39916H	0	-	1292	3552	4302	0.8256625
C6	43664479	43664830	BolC6t39917H	0	+	15	31	351	0.0883191
C6	43668615	43671388	BolC6t39918H	0	+	393	2084	2773	0.7515326
C6	43671903	43675025	BolC6t39919H	0	-	550	2348	3122	0.7520820
C6	43677942	43679721	BolC6t39920H	0	-	240	1573	1779	0.8842046
C6	43680928	43681964	BolC6t39921H	0	-	167	906	1036	0.8745174
C6	43683680	43686572	BolC6t39922H	0	-	495	2503	2892	0.8654910
C6	43687174	43687659	BolC6t39923H	0	-	330	485	485	1.0000000
C6	43692175	43694445	BolC6t39924H	0	+	454	1833	2270	0.8074890
C6	43695677	43696800	BolC6t39925H	0	+	216	861	1123	0.7666963
C6	43697071	43697948	BolC6t39926H	0	-	836	877	877	1.0000000
C6	43698458	43699545	BolC6t39927H	0	-	627	1087	1087	1.0000000
C6	43701405	43702839	BolC6t39928H	0	+	273	1434	1434	1.0000000
C6	43703169	43705705	BolC6t39929H	0	-	1761	2479	2536	0.9775237
C6	43708110	43708218	BolC6t39930H	0	-	307	108	108	1.0000000
C6	43709458	43710052	BolC6t39931H	0	+	94	594	594	1.0000000
C6	43713709	43714543	BolC6t39932H	0	+	332	830	834	0.9952039
C6	43716118	43717318	BolC6t39933H	0	-	971	1200	1200	1.0000000
C6	43719581	43722865	BolC6t39934H	0	-	2920	3284	3284	1.0000000
C6	43725696	43726505	BolC6t39935H	0	-	96	704	809	0.8702101
C6	43727468	43727936	BolC6t39936H	0	-	30	468	468	1.0000000
C6	43731927	43732820	BolC6t39937H	0	+	226	826	893	0.9249720
C6	43733304	43737307	BolC6t39938H	0	-	1816	4000	4003	0.9992506
C6	43739985	43741062	BolC6t39939H	0	+	698	1077	1077	1.0000000
C6	43743162	43747188	BolC6t39940H	0	+	1603	3501	4026	0.8695976
C6	43754005	43754408	BolC6t39941H	0	+	115	403	403	1.0000000
C6	43755312	43757064	BolC6t39942H	0	-	1773	1752	1752	1.0000000
C6	43764251	43765269	BolC6t39943H	0	+	754	1018	1018	1.0000000
C6	43765762	43768124	BolC6t39944H	0	-	1843	2362	2362	1.0000000
C6	43769377	43772171	BolC6t39945H	0	-	1967	2794	2794	1.0000000
C6	43772716	43774748	BolC6t39946H	0	-	1074	2003	2032	0.9857283
C6	43775651	43779389	BolC6t39947H	0	-	2594	3738	3738	1.0000000
C6	43787917	43792759	BolC6t39948H	0	+	1977	4369	4842	0.9023131
C6	43793214	43794831	BolC6t39949H	0	-	1142	1617	1617	1.0000000
C6	43796367	43796769	BolC6t39950H	0	+	269	402	402	1.0000000
C6	43797491	43800248	BolC6t39951H	0	-	1123	2757	2757	1.0000000
C6	43800978	43804840	BolC6t39952H	0	+	2551	3862	3862	1.0000000
C6	43805541	43808301	BolC6t39953H	0	-	1239	2491	2760	0.9025362
C6	43821126	43822023	BolC6t39954H	0	+	362	897	897	1.0000000
C6	43829235	43829514	BolC6t39955H	0	-	27	159	279	0.5698925
C6	43834863	43836675	BolC6t39956H	0	+	490	1395	1812	0.7698675
C6	43837759	43838577	BolC6t39957H	0	+	10	16	818	0.0195599
C6	43838824	43840264	BolC6t39958H	0	+	490	1402	1440	0.9736111
C6	43841095	43842509	BolC6t39959H	0	+	498	1357	1414	0.9596888
C6	43843523	43845069	BolC6t39960H	0	+	1276	1546	1546	1.0000000
C6	43847708	43848493	BolC6t39961H	0	-	2	20	785	0.0254777
C6	43853589	43854008	BolC6t39962H	0	+	362	419	419	1.0000000
C6	43862425	43862868	BolC6t39963H	0	+	168	415	443	0.9367946
C6	43874145	43874688	BolC6t39964H	0	+	253	394	543	0.7255985
C6	43876940	43880526	BolC6t39965H	0	-	1730	2568	3586	0.7161182
C6	43880699	43881086	BolC6t39966H	0	+	312	387	387	1.0000000
C6	43894367	43899481	BolC6t39967H	0	+	2657	4898	5114	0.9577630
C6	43900038	43901890	BolC6t39968H	0	-	1005	1815	1852	0.9800216
C6	43902610	43903112	BolC6t39969H	0	+	235	472	502	0.9402391
C6	43905250	43906015	BolC6t39970H	0	+	674	765	765	1.0000000
C6	43908057	43908183	BolC6t39971H	0	+	191	126	126	1.0000000
C6	43916263	43917364	BolC6t39972H	0	+	1052	1101	1101	1.0000000
C6	43918992	43920729	BolC6t39973H	0	-	880	1737	1737	1.0000000
C6	43925660	43927473	BolC6t39974H	0	+	885	1795	1813	0.9900717
C6	43930967	43931315	BolC6t39975H	0	-	608	348	348	1.0000000
C6	43933528	43937072	BolC6t39976H	0	+	2390	3544	3544	1.0000000
C6	43938209	43940291	BolC6t39977H	0	-	460	1460	2082	0.7012488
C6	43943269	43944953	BolC6t39978H	0	-	394	1429	1684	0.8485748
C6	43946053	43946646	BolC6t39979H	0	+	53	385	593	0.6492411
C6	43948779	43950763	BolC6t39980H	0	+	1908	1876	1984	0.9455645
C6	43951068	43953195	BolC6t39981H	0	-	160	1430	2127	0.6723084
C6	43965303	43965675	BolC6t39982H	0	-	309	372	372	1.0000000
C6	43973889	43974670	BolC6t39983H	0	+	137	778	781	0.9961588
C6	43990212	43991494	BolC6t39984H	0	+	122	803	1282	0.6263651
C6	43991511	43991959	BolC6t39985H	0	+	220	328	448	0.7321429
C6	43993416	43995895	BolC6t39986H	0	+	1504	2479	2479	1.0000000
C6	44009515	44009839	BolC6t39987H	0	+	223	324	324	1.0000000
C6	44013394	44014015	BolC6t39988H	0	+	438	621	621	1.0000000
C6	44015385	44017212	BolC6t39989H	0	-	1351	1775	1827	0.9715381
C6	44029859	44031259	BolC6t39990H	0	-	10	352	1400	0.2514286
C6	44040629	44043040	BolC6t39991H	0	+	558	2342	2411	0.9713812
C6	44049768	44051035	BolC6t39992H	0	+	155	1259	1267	0.9936859
C6	44053299	44053791	BolC6t39993H	0	-	164	492	492	1.0000000
C6	44055189	44057779	BolC6t39994H	0	-	1072	2590	2590	1.0000000
C6	44068611	44068938	BolC6t39995H	0	+	30	103	327	0.3149847
C6	44082747	44083185	BolC6t39996H	0	-	49	387	438	0.8835617
C6	44099723	44101382	BolC6t39997H	0	-	235	1326	1659	0.7992766
C6	44105395	44108821	BolC6t39998H	0	-	344	2579	3426	0.7527729
C6	44110181	44115456	BolC6t39999H	0	+	1975	4972	5275	0.9425592
C6	44115950	44116617	BolC6t40000H	0	-	90	182	667	0.2728636
C6	44117032	44119668	BolC6t40001H	0	-	1000	2553	2636	0.9685129
C6	44121145	44121910	BolC6t40002H	0	-	179	765	765	1.0000000
C6	44122645	44123625	BolC6t40003H	0	+	866	968	980	0.9877551
C6	44127377	44129652	BolC6t40004H	0	+	537	2149	2275	0.9446154
C6	44132941	44133211	BolC6t40005H	0	+	135	270	270	1.0000000
C6	44134135	44134795	BolC6t40006H	0	-	64	236	660	0.3575757
C6	44135748	44139042	BolC6t40007H	0	-	1625	3278	3294	0.9951427
C6	44139589	44139754	BolC6t40008H	0	-	1	63	165	0.3818182
C6	44143428	44143897	BolC6t40009H	0	-	55	421	469	0.8976546
C6	44152695	44153819	BolC6t40010H	0	-	379	1124	1124	1.0000000
C6	44155485	44159685	BolC6t40011H	0	+	1797	3758	4200	0.8947619
C6	44162381	44163274	BolC6t40012H	0	+	475	886	893	0.9921613
C6	44163583	44166173	BolC6t40013H	0	-	920	2124	2590	0.8200772
C6	44174989	44176636	BolC6t40014H	0	+	635	1464	1647	0.8888889
C6	44179276	44179645	BolC6t40015H	0	+	216	341	369	0.9241192
C6	44180333	44183369	BolC6t40016H	0	-	459	2319	3036	0.7638340
C6	44201882	44202112	BolC6t40017H	0	+	120	230	230	1.0000000
C6	44202377	44202758	BolC6t40018H	0	+	111	381	381	1.0000000
C6	44206887	44208128	BolC6t40019H	0	+	483	1220	1241	0.9830782
C6	44208836	44214953	BolC6t40020H	0	-	2835	6026	6117	0.9851235
C6	44215387	44217021	BolC6t40021H	0	-	1446	1513	1634	0.9259486
C6	44218544	44218977	BolC6t40022H	0	+	124	356	433	0.8221709
C6	44220343	44220694	BolC6t40023H	0	+	350	351	351	1.0000000
C6	44222659	44224538	BolC6t40024H	0	+	855	1875	1879	0.9978712
C6	44238745	44241349	BolC6t40025H	0	+	1255	2161	2604	0.8298771
C6	44245394	44246128	BolC6t40026H	0	+	562	734	734	1.0000000
C6	44246721	44247864	BolC6t40027H	0	+	1307	1143	1143	1.0000000
C6	44248667	44251145	BolC6t40028H	0	-	1487	2478	2478	1.0000000
C6	44252248	44254513	BolC6t40029H	0	-	1314	2249	2265	0.9929360
C6	44255797	44256956	BolC6t40030H	0	-	4	219	1159	0.1889560
C6	44257765	44258471	BolC6t40031H	0	-	2	108	706	0.1529745
C6	44259822	44260012	BolC6t40032H	0	+	265	190	190	1.0000000
C6	44260050	44264333	BolC6t40033H	0	+	2395	3735	4283	0.8720523
C6	44281168	44284024	BolC6t40034H	0	+	111	1233	2856	0.4317227
C6	44284489	44286380	BolC6t40035H	0	+	845	1820	1891	0.9624537
C6	44289986	44290340	BolC6t40036H	0	-	0	0	354	0.0000000
C6	44290676	44291247	BolC6t40037H	0	+	86	458	571	0.8021016
C6	44294035	44295625	BolC6t40038H	0	-	67	616	1590	0.3874214
C6	44300683	44301298	BolC6t40039H	0	-	275	602	615	0.9788618
C6	44304108	44304903	BolC6t40040H	0	+	10	358	795	0.4503145
C6	44306628	44307980	BolC6t40041H	0	-	170	1222	1352	0.9038461
C6	44309203	44310286	BolC6t40042H	0	-	75	881	1083	0.8134811
C6	44314284	44314797	BolC6t40043H	0	-	66	436	513	0.8499025
C6	44315644	44317798	BolC6t40044H	0	-	440	1999	2154	0.9280409
C6	44319219	44320635	BolC6t40045H	0	-	92	1192	1416	0.8418079
C6	44321133	44322531	BolC6t40046H	0	+	262	1325	1398	0.9477826
C6	44323840	44326273	BolC6t40047H	0	+	924	2433	2433	1.0000000
C6	44337377	44340900	BolC6t40048H	0	+	953	3091	3523	0.8773772
C6	44341001	44341103	BolC6t40049H	0	+	161	102	102	1.0000000
C6	44341275	44343532	BolC6t40050H	0	-	1054	2257	2257	1.0000000
C6	44344230	44347114	BolC6t40051H	0	-	491	2571	2884	0.8914702
C6	44349445	44351526	BolC6t40052H	0	-	862	1968	2081	0.9456992
C6	44352686	44353417	BolC6t40053H	0	-	131	614	731	0.8399453
C6	44356631	44357027	BolC6t40054H	0	+	132	267	396	0.6742424
C6	44357603	44358225	BolC6t40055H	0	+	538	622	622	1.0000000
C6	44359255	44359936	BolC6t40056H	0	-	69	531	681	0.7797357
C6	44361459	44362218	BolC6t40057H	0	-	346	759	759	1.0000000
C6	44363267	44364545	BolC6t40058H	0	-	398	1204	1278	0.9420970
C6	44365069	44365498	BolC6t40059H	0	-	27	337	429	0.7855478
C6	44368512	44369430	BolC6t40060H	0	-	138	911	918	0.9923747
C6	44381140	44384944	BolC6t40061H	0	-	2446	3676	3804	0.9663512
C6	44390974	44393272	BolC6t40062H	0	+	976	2270	2298	0.9878155
C6	44393702	44396261	BolC6t40063H	0	-	1173	2558	2559	0.9996092
C6	44397424	44400961	BolC6t40064H	0	-	1778	3433	3537	0.9705966
C6	44402007	44402310	BolC6t40065H	0	+	412	303	303	1.0000000
C6	44403826	44404237	BolC6t40066H	0	+	63	411	411	1.0000000
C6	44408281	44410430	BolC6t40067H	0	+	1597	2149	2149	1.0000000
C6	44408281	44411653	BolC6t40068H	0	+	2364	3372	3372	1.0000000
C6	44413122	44414177	BolC6t40069H	0	+	1190	1055	1055	1.0000000
C6	44415485	44431485	BolC6t40070H	0	-	838	5216	16000	0.3260000
C6	44426501	44428295	BolC6t40071H	0	-	368	1429	1794	0.7965440
C6	44441435	44443537	BolC6t40072H	0	-	21	448	2102	0.2131304
C6	44451389	44462027	BolC6t40073H	0	-	157	2557	10638	0.2403647
C6	44457724	44459638	BolC6t40074H	0	+	3	27	1914	0.0141066
C6	44465473	44466097	BolC6t40075H	0	-	243	558	624	0.8942308
C6	44466701	44468736	BolC6t40076H	0	-	752	2011	2035	0.9882064
C6	44470647	44473117	BolC6t40077H	0	+	378	2421	2470	0.9801620
C6	44473952	44475062	BolC6t40078H	0	-	486	1110	1110	1.0000000
C6	44480251	44483637	BolC6t40079H	0	+	958	2778	3386	0.8204371
C6	44484396	44487555	BolC6t40080H	0	-	1651	3105	3159	0.9829060
C6	44489510	44491322	BolC6t40081H	0	-	669	1790	1812	0.9878587
C6	44492987	44496340	BolC6t40082H	0	-	750	3188	3353	0.9507903
C6	44498623	44501441	BolC6t40083H	0	+	688	2791	2818	0.9904187
C6	44501562	44504327	BolC6t40084H	0	-	1793	2718	2765	0.9830018
C6	44504721	44506294	BolC6t40085H	0	+	1375	1573	1573	1.0000000
C6	44512926	44513499	BolC6t40086H	0	+	177	573	573	1.0000000
C6	44519835	44521875	BolC6t40087H	0	-	185	1513	2040	0.7416667
C6	44529077	44532551	BolC6t40088H	0	-	2142	3474	3474	1.0000000
C6	44536273	44544166	BolC6t40089H	0	-	4956	7819	7893	0.9906246
C6	44546050	44546386	BolC6t40090H	0	-	255	336	336	1.0000000
C6	44547283	44547637	BolC6t40091H	0	-	234	354	354	1.0000000
C6	44550027	44552684	BolC6t40092H	0	-	1677	2657	2657	1.0000000
C6	44554388	44554855	BolC6t40093H	0	-	173	467	467	1.0000000
C6	44556431	44558110	BolC6t40094H	0	+	479	1586	1679	0.9446099
C6	44559019	44560561	BolC6t40095H	0	+	1048	1542	1542	1.0000000
C6	44560955	44562680	BolC6t40096H	0	-	1700	1725	1725	1.0000000
C6	44563757	44565374	BolC6t40097H	0	-	352	1468	1617	0.9078541
C6	44569584	44571570	BolC6t40098H	0	+	468	1885	1986	0.9491440
C6	44577663	44578539	BolC6t40099H	0	+	161	717	876	0.8184931
C6	44581925	44584730	BolC6t40100H	0	-	976	2636	2805	0.9397504
C6	44587316	44589191	BolC6t40101H	0	+	826	1725	1875	0.9200000
C6	44589455	44591151	BolC6t40102H	0	-	189	1067	1696	0.6291274
C6	44591757	44595696	BolC6t40103H	0	-	1467	3539	3939	0.8984514
C6	44602782	44603763	BolC6t40104H	0	-	90	418	981	0.4260958
C6	44606297	44606702	BolC6t40105H	0	+	223	361	405	0.8913580
C6	44622385	44626081	BolC6t40106H	0	+	1545	3687	3696	0.9975649
C6	44631059	44632130	BolC6t40107H	0	+	111	679	1071	0.6339869
C6	44636495	44636963	BolC6t40108H	0	+	13	377	468	0.8055556
C6	44649877	44650328	BolC6t40109H	0	+	401	451	451	1.0000000
C6	44650331	44650526	BolC6t40110H	0	+	218	195	195	1.0000000
C6	44654788	44654983	BolC6t40111H	0	+	98	195	195	1.0000000
C6	44659516	44662199	BolC6t40112H	0	+	461	2514	2683	0.9370108
C6	44662945	44668227	BolC6t40113H	0	+	2326	5282	5282	1.0000000
C6	44668651	44669161	BolC6t40114H	0	-	189	493	510	0.9666666
C6	44670671	44671214	BolC6t40115H	0	-	199	543	543	1.0000000
C6	44672546	44674451	BolC6t40116H	0	-	711	1860	1905	0.9763780
C6	44676293	44678343	BolC6t40117H	0	-	811	1969	2050	0.9604878
C6	44680768	44682938	BolC6t40118H	0	-	1099	1915	2170	0.8824885
C6	44683351	44685318	BolC6t40119H	0	-	711	1838	1967	0.9344179
C6	44701549	44708479	BolC6t40120H	0	+	3349	6361	6930	0.9178932
C6	44716011	44717043	BolC6t40121H	0	-	835	1032	1032	1.0000000
C6	44717713	44718534	BolC6t40122H	0	+	524	821	821	1.0000000
C6	44718810	44720515	BolC6t40123H	0	-	126	1161	1705	0.6809384
C6	44727842	44728427	BolC6t40124H	0	+	167	560	585	0.9572650
C6	44729945	44730451	BolC6t40125H	0	-	30	171	506	0.3379447
C6	44731974	44732802	BolC6t40126H	0	-	482	828	828	1.0000000
C6	44741535	44743672	BolC6t40127H	0	+	513	2035	2137	0.9522696
C6	44754803	44756774	BolC6t40128H	0	-	291	1362	1971	0.6910198
C6	44768089	44770205	BolC6t40129H	0	+	506	2028	2116	0.9584121
C6	44771686	44773731	BolC6t40130H	0	-	1794	1924	2045	0.9408313
C6	44780860	44781688	BolC6t40131H	0	-	132	798	828	0.9637681
C6	44788153	44789752	BolC6t40132H	0	-	1208	1599	1599	1.0000000
C6	44795602	44800824	BolC6t40133H	0	+	1312	5054	5222	0.9678284
C6	44802694	44803595	BolC6t40134H	0	-	136	720	901	0.7991121
C6	44804877	44805195	BolC6t40135H	0	-	0	0	318	0.0000000
C6	44808838	44809146	BolC6t40136H	0	-	11	243	308	0.7889611
C6	44814402	44814712	BolC6t40137H	0	-	73	297	310	0.9580645
C6	44818556	44819558	BolC6t40138H	0	+	649	1002	1002	1.0000000
C6	44820419	44821178	BolC6t40139H	0	-	41	419	759	0.5520422
C6	44823091	44823376	BolC6t40140H	0	-	306	285	285	1.0000000
C6	44825208	44827362	BolC6t40141H	0	-	770	2027	2154	0.9410399
C6	44829443	44830643	BolC6t40142H	0	-	763	1200	1200	1.0000000
C6	44836606	44838949	BolC6t40143H	0	+	671	2046	2343	0.8732395
C6	44847565	44849348	BolC6t40144H	0	+	722	1696	1783	0.9512058
C6	44850181	44851957	BolC6t40145H	0	-	948	1776	1776	1.0000000
C6	44853046	44854579	BolC6t40146H	0	-	481	1483	1533	0.9673842
C6	44856929	44857196	BolC6t40147H	0	-	173	267	267	1.0000000
C6	44865109	44868199	BolC6t40148H	0	+	1423	2943	3090	0.9524272
C6	44869975	44871529	BolC6t40149H	0	+	187	1422	1554	0.9150579
C6	44871700	44873088	BolC6t40150H	0	-	588	1388	1388	1.0000000
C6	44876494	44877567	BolC6t40151H	0	-	68	675	1073	0.6290774
C6	44878703	44879778	BolC6t40152H	0	-	136	700	1075	0.6511628
C6	44881553	44881784	BolC6t40153H	0	-	151	231	231	1.0000000
C6	44898362	44899381	BolC6t40154H	0	-	329	715	1019	0.7016683
C6	44901972	44905491	BolC6t40155H	0	-	533	2998	3519	0.8519466
C6	44909782	44910508	BolC6t40156H	0	-	241	726	726	1.0000000
C6	44917722	44920403	BolC6t40157H	0	-	827	2578	2681	0.9615815
C6	44927265	44929468	BolC6t40158H	0	+	1120	2203	2203	1.0000000
C6	44931914	44933546	BolC6t40159H	0	-	566	1557	1632	0.9540441
C6	44941252	44943454	BolC6t40160H	0	-	1012	2061	2202	0.9359673
C6	44945337	44948501	BolC6t40161H	0	-	808	2977	3164	0.9408976
C6	44954318	44959252	BolC6t40162H	0	-	1820	4615	4934	0.9353466
C6	44963308	44964192	BolC6t40163H	0	+	76	714	884	0.8076923
C6	44964529	44972385	BolC6t40164H	0	-	1477	5671	7856	0.7218686
C6	44974845	44978773	BolC6t40165H	0	+	643	3116	3928	0.7932791
C6	44979282	44984996	BolC6t40166H	0	+	1907	5224	5714	0.9142457
C6	44985327	44985695	BolC6t40167H	0	-	134	368	368	1.0000000
C6	44990906	44992518	BolC6t40168H	0	+	2001	1573	1612	0.9758065
C6	44992810	44995223	BolC6t40169H	0	-	1080	2236	2413	0.9266473
C6	45003875	45004070	BolC6t40170H	0	-	0	0	195	0.0000000
C6	45005754	45006051	BolC6t40171H	0	-	88	297	297	1.0000000
C6	45008578	45008821	BolC6t40172H	0	-	0	0	243	0.0000000
C6	45009393	45011276	BolC6t40173H	0	-	902	1849	1883	0.9819437
C6	45012947	45013643	BolC6t40174H	0	+	104	587	696	0.8433908
C6	45014212	45016074	BolC6t40175H	0	-	377	1685	1862	0.9049409
C6	45017050	45019302	BolC6t40176H	0	+	646	2238	2252	0.9937833
C6	45021620	45025055	BolC6t40177H	0	+	736	3299	3435	0.9604076
C6	45028476	45030334	BolC6t40178H	0	+	549	1683	1858	0.9058127
C6	45031946	45034640	BolC6t40179H	0	+	1434	2626	2694	0.9747587
C6	45035478	45037018	BolC6t40180H	0	+	457	1253	1540	0.8136364
C6	45037881	45040512	BolC6t40181H	0	-	833	2524	2631	0.9593310
C6	45046171	45047499	BolC6t40182H	0	+	710	1328	1328	1.0000000
C6	45047848	45052769	BolC6t40183H	0	-	1959	3773	4921	0.7667141
C6	45058808	45059703	BolC6t40184H	0	+	13	287	895	0.3206704
C6	45063081	45064433	BolC6t40185H	0	-	0	0	1352	0.0000000
C6	45072390	45072739	BolC6t40186H	0	-	0	0	349	0.0000000
C6	45083701	45084406	BolC6t40187H	0	+	0	0	705	0.0000000
C6	45087796	45089146	BolC6t40188H	0	-	1	63	1350	0.0466667
C6	45097090	45097439	BolC6t40189H	0	-	0	0	349	0.0000000
C6	45107475	45108621	BolC6t40190H	0	+	605	1030	1146	0.8987784
C6	45109572	45111079	BolC6t40191H	0	+	259	1066	1507	0.7073656
C6	45111722	45111881	BolC6t40192H	0	-	63	159	159	1.0000000
C6	45119400	45122706	BolC6t40193H	0	-	260	2397	3306	0.7250454
C6	45133165	45134154	BolC6t40194H	0	+	593	989	989	1.0000000
C6	45134609	45135392	BolC6t40195H	0	-	232	783	783	1.0000000
C6	45139121	45145361	BolC6t40196H	0	+	2174	5070	6240	0.8125000
C6	45146346	45148467	BolC6t40197H	0	-	242	1759	2121	0.8293258
C6	45150784	45152002	BolC6t40198H	0	+	268	1208	1218	0.9917898
C6	45154913	45157137	BolC6t40199H	0	+	246	1881	2224	0.8457734
C6	45159944	45161067	BolC6t40200H	0	-	160	997	1123	0.8878005
C6	45166390	45168274	BolC6t40201H	0	-	412	1877	1884	0.9962845
C6	45171079	45172329	BolC6t40202H	0	-	1181	1250	1250	1.0000000
C6	45172503	45172862	BolC6t40203H	0	-	457	359	359	1.0000000
C6	45179869	45180231	BolC6t40204H	0	-	254	362	362	1.0000000
C6	45190417	45190947	BolC6t40205H	0	+	124	530	530	1.0000000
C6	45194003	45196504	BolC6t40206H	0	+	851	2326	2501	0.9300280
C6	45197003	45202167	BolC6t40207H	0	+	3507	5015	5164	0.9711464
C6	45202948	45203882	BolC6t40208H	0	-	640	934	934	1.0000000
C6	45207170	45211343	BolC6t40209H	0	+	1732	4030	4173	0.9657321
C6	45212017	45212128	BolC6t40210H	0	-	6	39	111	0.3513514
C6	45213773	45216700	BolC6t40211H	0	-	157	1824	2927	0.6231636
C6	45226749	45228800	BolC6t40212H	0	-	456	1480	2051	0.7215992
C6	45235078	45235330	BolC6t40213H	0	-	12	55	252	0.2182540
C6	45245032	45248033	BolC6t40214H	0	+	330	2577	3001	0.8587137
C6	45248861	45252009	BolC6t40215H	0	+	1696	3148	3148	1.0000000
C6	45253351	45254394	BolC6t40216H	0	+	0	0	1043	0.0000000
C6	45255969	45256851	BolC6t40217H	0	+	591	882	882	1.0000000
C6	45260872	45261703	BolC6t40218H	0	+	484	800	831	0.9626955
C6	45263537	45265447	BolC6t40219H	0	+	716	1910	1910	1.0000000
C6	45265622	45269632	BolC6t40220H	0	-	1676	3687	4010	0.9194514
C6	45273368	45274017	BolC6t40221H	0	-	89	409	649	0.6302003
C6	45274111	45274774	BolC6t40222H	0	-	37	317	663	0.4781297
C6	45275809	45276514	BolC6t40223H	0	-	72	617	705	0.8751773
C6	45277516	45278222	BolC6t40224H	0	-	23	608	706	0.8611898
C6	45287256	45290375	BolC6t40225H	0	+	2090	2523	3119	0.8089131
C6	45307338	45308325	BolC6t40226H	0	+	127	618	987	0.6261398
C6	45311082	45313578	BolC6t40227H	0	-	1986	2496	2496	1.0000000
C6	45322995	45325510	BolC6t40228H	0	+	197	1933	2515	0.7685885
C6	45330651	45330924	BolC6t40229H	0	-	297	273	273	1.0000000
C6	45338382	45339348	BolC6t40230H	0	+	67	760	966	0.7867495
C6	45342535	45343522	BolC6t40231H	0	+	739	987	987	1.0000000
C6	45344772	45348167	BolC6t40232H	0	-	1901	3284	3395	0.9673049
C6	45352439	45354489	BolC6t40233H	0	-	1429	2045	2050	0.9975610
C6	45367355	45369625	BolC6t40234H	0	+	480	1745	2270	0.7687225
C6	45386676	45387441	BolC6t40235H	0	+	81	724	765	0.9464052
C6	45388681	45394672	BolC6t40236H	0	-	3643	5870	5991	0.9798030
C6	45395775	45396954	BolC6t40237H	0	+	569	1159	1179	0.9830365
C6	45398123	45400827	BolC6t40238H	0	-	2324	2574	2704	0.9519231
C6	45402741	45404114	BolC6t40239H	0	-	1729	1295	1373	0.9431901
C6	45410712	45415163	BolC6t40240H	0	+	2328	3880	4451	0.8717142
C6	45416093	45419322	BolC6t40241H	0	-	2357	3184	3229	0.9860638
C6	45433833	45434315	BolC6t40242H	0	-	0	0	482	0.0000000
C6	45437265	45438414	BolC6t40243H	0	+	123	1093	1149	0.9512619
C6	45439528	45442018	BolC6t40244H	0	+	1143	2284	2490	0.9172691
C6	45443301	45445628	BolC6t40245H	0	+	610	2143	2327	0.9209282
C6	45446620	45451300	BolC6t40246H	0	+	2865	4678	4680	0.9995726
C6	45451465	45452672	BolC6t40247H	0	-	1152	1207	1207	1.0000000
C6	45454878	45457256	BolC6t40248H	0	+	827	2236	2378	0.9402860
C6	45458195	45459059	BolC6t40249H	0	-	400	864	864	1.0000000
C6	45461071	45462132	BolC6t40250H	0	-	118	689	1061	0.6493874
C6	45462528	45463347	BolC6t40251H	0	-	117	785	819	0.9584860
C6	45463853	45465360	BolC6t40252H	0	-	852	1507	1507	1.0000000
C6	45472306	45474232	BolC6t40253H	0	-	426	1465	1926	0.7606438
C6	45478919	45480291	BolC6t40254H	0	-	105	1065	1372	0.7762390
C6	45487509	45487824	BolC6t40255H	0	+	4	117	315	0.3714286
C6	45489662	45491722	BolC6t40256H	0	+	944	2034	2060	0.9873787
C6	45494523	45496187	BolC6t40257H	0	-	698	1624	1664	0.9759616
C6	45509979	45510830	BolC6t40258H	0	-	665	851	851	1.0000000
C6	45511539	45513003	BolC6t40259H	0	-	456	1340	1464	0.9153005
C6	45517404	45520129	BolC6t40260H	0	+	2585	2725	2725	1.0000000
C6	45522910	45524978	BolC6t40261H	0	-	1160	2027	2068	0.9801741
C6	45525687	45526324	BolC6t40262H	0	-	215	542	637	0.8508634
C6	45527119	45528537	BolC6t40263H	0	-	170	803	1418	0.5662906
C6	45529295	45529819	BolC6t40264H	0	+	0	0	524	0.0000000
C6	45532405	45535564	BolC6t40265H	0	-	695	2860	3159	0.9053498
C6	45537760	45540204	BolC6t40266H	0	+	448	2200	2444	0.9001637
C6	45540679	45545152	BolC6t40267H	0	-	1653	4378	4473	0.9787614
C6	45555447	45557121	BolC6t40268H	0	+	608	1647	1674	0.9838710
C6	45558037	45559170	BolC6t40269H	0	+	309	1052	1133	0.9285084
C6	45559406	45562208	BolC6t40270H	0	-	1592	2753	2802	0.9825125
C6	45563491	45565457	BolC6t40271H	0	-	521	1547	1966	0.7868769
C6	45565698	45569885	BolC6t40272H	0	+	3097	4187	4187	1.0000000
C6	45569984	45570536	BolC6t40273H	0	+	304	552	552	1.0000000
C6	45570838	45576809	BolC6t40274H	0	-	1547	3913	5971	0.6553341
C6	45576977	45581025	BolC6t40275H	0	+	2599	4048	4048	1.0000000
C6	45581920	45583984	BolC6t40276H	0	+	871	2022	2064	0.9796512
C6	45586829	45588741	BolC6t40277H	0	-	903	1912	1912	1.0000000
C6	45591432	45593213	BolC6t40278H	0	-	171	1079	1781	0.6058394
C6	45596021	45597802	BolC6t40279H	0	-	122	1117	1781	0.6271757
C6	45600149	45604654	BolC6t40280H	0	-	3342	4225	4505	0.9378468
C6	45607490	45608726	BolC6t40281H	0	+	314	1236	1236	1.0000000
C6	45609740	45611863	BolC6t40282H	0	-	1455	2092	2123	0.9853980
C6	45613941	45614411	BolC6t40283H	0	-	800	470	470	1.0000000
C6	45615272	45616126	BolC6t40284H	0	+	653	854	854	1.0000000
C6	45652941	45654567	BolC6t40285H	0	-	552	1626	1626	1.0000000
C6	45655271	45656147	BolC6t40286H	0	-	839	876	876	1.0000000
C6	45657134	45658840	BolC6t40287H	0	-	416	1679	1706	0.9841735
C6	45664658	45665598	BolC6t40288H	0	+	1068	940	940	1.0000000
C6	45667014	45667572	BolC6t40289H	0	-	286	558	558	1.0000000
C6	45669676	45671301	BolC6t40290H	0	-	625	1607	1625	0.9889231
C6	45672941	45673716	BolC6t40291H	0	+	653	775	775	1.0000000
C6	45674082	45674594	BolC6t40292H	0	-	474	512	512	1.0000000
C6	45678845	45680318	BolC6t40293H	0	-	240	1137	1473	0.7718941
C6	45682972	45684723	BolC6t40294H	0	+	2212	1751	1751	1.0000000
C6	45685305	45687226	BolC6t40295H	0	-	559	1799	1921	0.9364914
C6	45688317	45689392	BolC6t40296H	0	+	450	994	1075	0.9246511
C6	45691037	45694735	BolC6t40297H	0	+	2260	3698	3698	1.0000000
C6	45697564	45699991	BolC6t40298H	0	+	2365	2427	2427	1.0000000
C6	45704344	45708584	BolC6t40299H	0	+	1755	4144	4240	0.9773585
C6	45709222	45715872	BolC6t40300H	0	-	2575	5918	6650	0.8899248
C6	45715974	45721213	BolC6t40301H	0	-	2051	4778	5239	0.9120061
C6	45724969	45729281	BolC6t40302H	0	+	2908	4227	4312	0.9802876
C6	45729449	45732772	BolC6t40303H	0	-	347	3089	3323	0.9295817
C6	45736367	45738298	BolC6t40304H	0	-	613	1595	1931	0.8259969
C6	45743258	45749925	BolC6t40305H	0	-	1030	4366	6667	0.6548672
C6	45750673	45752518	BolC6t40306H	0	-	1182	1845	1845	1.0000000
C6	45752825	45755414	BolC6t40307H	0	-	503	2520	2589	0.9733488
C6	45785007	45785251	BolC6t40308H	0	-	109	244	244	1.0000000
C6	45786046	45788660	BolC6t40309H	0	-	2000	2614	2614	1.0000000
C6	45792796	45793488	BolC6t40310H	0	+	327	603	692	0.8713873
C6	45795558	45796707	BolC6t40311H	0	+	274	1049	1149	0.9129678
C6	45798606	45799278	BolC6t40312H	0	-	200	640	672	0.9523810
C6	45799895	45801602	BolC6t40313H	0	-	127	926	1707	0.5424722
C6	45802182	45805183	BolC6t40314H	0	-	1522	2824	3001	0.9410197
C6	45805862	45810355	BolC6t40315H	0	+	536	1907	4493	0.4244380
C6	45815285	45816450	BolC6t40316H	0	+	436	1004	1165	0.8618026
C6	45823837	45825064	BolC6t40317H	0	-	725	1227	1227	1.0000000
C6	45826919	45827351	BolC6t40318H	0	+	120	432	432	1.0000000
C6	45828674	45832758	BolC6t40319H	0	-	1060	4002	4084	0.9799216
C6	45834780	45835580	BolC6t40320H	0	-	230	784	800	0.9800000
C6	45838984	45839242	BolC6t40321H	0	-	100	258	258	1.0000000
C6	45847155	45848128	BolC6t40322H	0	+	169	771	973	0.7923946
C6	45849663	45850874	BolC6t40323H	0	+	193	1070	1211	0.8835673
C6	45851077	45851643	BolC6t40324H	0	-	433	566	566	1.0000000
C6	45858206	45858568	BolC6t40325H	0	-	45	344	362	0.9502763
C6	45861820	45862837	BolC6t40326H	0	+	110	1005	1017	0.9882006
C6	45895193	45897620	BolC6t40327H	0	-	1422	2265	2427	0.9332509
C6	45897755	45898877	BolC6t40328H	0	+	560	1122	1122	1.0000000
C6	45902370	45902889	BolC6t40329H	0	+	306	519	519	1.0000000
C6	45903730	45905948	BolC6t40330H	0	+	1021	2154	2218	0.9711452
C6	45906666	45906903	BolC6t40331H	0	-	69	237	237	1.0000000
C6	45907271	45918437	BolC6t40332H	0	-	1798	4510	11166	0.4039047
C6	45919502	45919736	BolC6t40333H	0	-	383	234	234	1.0000000
C6	45925813	45926003	BolC6t40334H	0	-	119	190	190	1.0000000
C6	45927794	45929607	BolC6t40335H	0	+	501	1718	1813	0.9476007
C6	45929928	45942813	BolC6t40336H	0	-	1698	9264	12885	0.7189755
C6	45944011	45945685	BolC6t40337H	0	+	545	1494	1674	0.8924731
C6	45946018	45946332	BolC6t40338H	0	-	230	314	314	1.0000000
C6	45948478	45950001	BolC6t40339H	0	+	101	1004	1523	0.6592252
C6	45950698	45952334	BolC6t40340H	0	+	472	1225	1636	0.7487775
C6	45953431	45955205	BolC6t40341H	0	+	984	1715	1774	0.9667418
C6	45955633	45963942	BolC6t40342H	0	-	1232	5451	8309	0.6560356
C6	45969426	45971031	BolC6t40343H	0	-	727	1605	1605	1.0000000
C6	45975795	45979653	BolC6t40344H	0	+	1981	3787	3858	0.9815967
C6	45980002	45981018	BolC6t40345H	0	-	479	1000	1016	0.9842520
C6	45981422	45986668	BolC6t40346H	0	+	2028	4743	5246	0.9041174
C6	45987130	45988673	BolC6t40347H	0	-	927	1543	1543	1.0000000
C6	45989720	45991265	BolC6t40348H	0	-	469	1188	1545	0.7689320
C6	45994830	45997496	BolC6t40349H	0	+	607	2381	2666	0.8930983
C6	46002359	46003956	BolC6t40350H	0	-	44	821	1597	0.5140889
C6	46007681	46012311	BolC6t40351H	0	-	3067	4397	4630	0.9496760
C6	46013049	46016764	BolC6t40352H	0	+	2604	3715	3715	1.0000000
C6	46017215	46019345	BolC6t40353H	0	-	725	2032	2130	0.9539906
C6	46022711	46023038	BolC6t40354H	0	+	5	247	327	0.7553517
C6	46043461	46043635	BolC6t40355H	0	+	277	174	174	1.0000000
C6	46044091	46046151	BolC6t40356H	0	-	1196	2035	2060	0.9878641
C6	46048485	46050550	BolC6t40357H	0	-	898	2065	2065	1.0000000
C6	46051282	46055845	BolC6t40358H	0	-	1464	3838	4563	0.8411133
C6	46057440	46061228	BolC6t40359H	0	+	431	1521	3788	0.4015312
C6	46061663	46063566	BolC6t40360H	0	-	364	1828	1903	0.9605885
C6	46067354	46070613	BolC6t40361H	0	+	1283	3259	3259	1.0000000
C6	46071160	46075106	BolC6t40362H	0	-	1200	3324	3946	0.8423720
C6	46076058	46077962	BolC6t40363H	0	-	1001	1904	1904	1.0000000
C6	46079539	46083412	BolC6t40364H	0	-	2823	3873	3873	1.0000000
C6	46085222	46085507	BolC6t40365H	0	+	174	285	285	1.0000000
C6	46086621	46088176	BolC6t40366H	0	-	271	1555	1555	1.0000000
C6	46088591	46091147	BolC6t40367H	0	-	509	2442	2556	0.9553990
C6	46092819	46097360	BolC6t40368H	0	+	2272	4389	4541	0.9665272
C6	46097499	46100311	BolC6t40369H	0	-	684	2556	2812	0.9089616
C6	46101870	46103854	BolC6t40370H	0	+	375	1779	1984	0.8966734
C6	46104080	46105940	BolC6t40371H	0	-	558	1840	1860	0.9892473
C6	46107615	46109808	BolC6t40372H	0	+	1019	2148	2193	0.9794801
C6	46110400	46111390	BolC6t40373H	0	-	637	990	990	1.0000000
C6	46112635	46116204	BolC6t40374H	0	+	370	2619	3569	0.7338190
C6	46118347	46119037	BolC6t40375H	0	+	50	634	690	0.9188406
C6	46119397	46119606	BolC6t40376H	0	-	137	209	209	1.0000000
C6	46121515	46122905	BolC6t40377H	0	+	233	1298	1390	0.9338130
C6	46123236	46123839	BolC6t40378H	0	-	145	525	603	0.8706468
C6	46124158	46126205	BolC6t40379H	0	-	87	786	2047	0.3839765
C6	46127235	46135031	BolC6t40380H	0	+	1348	4505	7796	0.5778604
C6	46137137	46138720	BolC6t40381H	0	+	752	1583	1583	1.0000000
C6	46138978	46140695	BolC6t40382H	0	-	718	1715	1717	0.9988352
C6	46184582	46187657	BolC6t40383H	0	+	768	2260	3075	0.7349594
C6	46187977	46189824	BolC6t40384H	0	-	641	1688	1847	0.9139144
C6	46191157	46194554	BolC6t40385H	0	-	1668	3367	3397	0.9911687
C6	46195869	46196697	BolC6t40386H	0	-	112	674	828	0.8140097
C6	46197911	46198073	BolC6t40387H	0	-	187	162	162	1.0000000
C6	46199306	46201813	BolC6t40388H	0	-	1070	2488	2507	0.9924212
C6	46202653	46203356	BolC6t40389H	0	+	432	703	703	1.0000000
C6	46208000	46209450	BolC6t40390H	0	+	20	226	1450	0.1558621
C6	46210075	46210588	BolC6t40391H	0	-	687	513	513	1.0000000
C6	46212766	46213423	BolC6t40392H	0	+	28	511	657	0.7777778
C6	46216929	46217960	BolC6t40393H	0	-	200	972	1031	0.9427740
C6	46218360	46220508	BolC6t40394H	0	+	1988	2148	2148	1.0000000
C6	46220801	46222798	BolC6t40395H	0	+	1341	1997	1997	1.0000000
C6	46223030	46224043	BolC6t40396H	0	-	1046	1013	1013	1.0000000
C6	46225388	46226629	BolC6t40397H	0	+	384	1231	1241	0.9919420
C6	46227580	46235878	BolC6t40398H	0	-	7335	8298	8298	1.0000000
C6	46230855	46231429	BolC6t40399H	0	+	622	574	574	1.0000000
C6	46232222	46232980	BolC6t40400H	0	-	825	758	758	1.0000000
C6	46237491	46239714	BolC6t40401H	0	+	1339	2148	2223	0.9662618
C6	46240504	46244248	BolC6t40402H	0	+	1106	3461	3744	0.9244124
C6	46244825	46248059	BolC6t40403H	0	-	1855	3142	3234	0.9715523
C6	46248952	46250632	BolC6t40404H	0	+	406	1622	1680	0.9654762
C6	46251095	46253029	BolC6t40405H	0	-	736	1909	1934	0.9870734
C6	46253824	46255996	BolC6t40406H	0	+	631	2052	2172	0.9447514
C6	46256622	46258126	BolC6t40407H	0	+	709	1504	1504	1.0000000
C6	46258416	46260485	BolC6t40408H	0	-	1340	2015	2069	0.9739004
C6	46260903	46262235	BolC6t40409H	0	+	257	1071	1332	0.8040541
C6	46263099	46265741	BolC6t40410H	0	+	861	2452	2642	0.9280848
C6	46267182	46269106	BolC6t40411H	0	+	356	1775	1924	0.9225572
C6	46270198	46270453	BolC6t40412H	0	+	52	255	255	1.0000000
C6	46271905	46272439	BolC6t40413H	0	-	15	336	534	0.6292135
C6	46276742	46278188	BolC6t40414H	0	-	120	945	1446	0.6535270
C6	46278717	46280576	BolC6t40415H	0	+	643	1664	1859	0.8951049
C6	46280657	46281286	BolC6t40416H	0	-	178	610	629	0.9697933
C6	46281986	46284044	BolC6t40417H	0	+	318	1605	2058	0.7798834
C6	46285149	46288050	BolC6t40418H	0	-	1059	2901	2901	1.0000000
C6	46289119	46291387	BolC6t40419H	0	-	890	1874	2268	0.8262787
C6	46293966	46296271	BolC6t40420H	0	+	738	1801	2305	0.7813449
C6	46322552	46323056	BolC6t40421H	0	+	44	403	504	0.7996032
C6	46324710	46325790	BolC6t40422H	0	-	453	1042	1080	0.9648148
C6	46331437	46333978	BolC6t40423H	0	-	1254	2541	2541	1.0000000
C6	46335166	46341745	BolC6t40424H	0	+	3141	6394	6579	0.9718802
C6	46345340	46346299	BolC6t40425H	0	+	106	561	959	0.5849844
C6	46355047	46357350	BolC6t40426H	0	-	731	2108	2303	0.9153278
C6	46357952	46360114	BolC6t40427H	0	-	1424	2162	2162	1.0000000
C6	46371633	46373354	BolC6t40428H	0	+	957	1721	1721	1.0000000
C6	46377865	46378243	BolC6t40429H	0	+	139	378	378	1.0000000
C6	46379400	46380780	BolC6t40430H	0	-	281	1311	1380	0.9500000
C6	46381366	46383613	BolC6t40431H	0	-	430	2112	2247	0.9399199
C6	46386160	46386532	BolC6t40432H	0	-	56	331	372	0.8897849
C6	46390060	46391343	BolC6t40433H	0	+	490	1283	1283	1.0000000
C6	46392736	46393450	BolC6t40434H	0	-	245	656	714	0.9187675
C6	46397385	46406019	BolC6t40435H	0	+	89	1476	8634	0.1709521
C6	46411783	46412511	BolC6t40436H	0	-	14	439	728	0.6030220
C6	46425327	46426580	BolC6t40437H	0	+	228	1048	1253	0.8363926
C6	46439267	46440669	BolC6t40438H	0	-	39	356	1402	0.2539230
C6	46441944	46442197	BolC6t40439H	0	-	7	212	253	0.8379447
C6	46445615	46449120	BolC6t40440H	0	+	2055	3367	3505	0.9606277
C6	46449765	46452465	BolC6t40441H	0	+	1146	2454	2700	0.9088889
C6	46453922	46454780	BolC6t40442H	0	+	67	549	858	0.6398602
C6	46454905	46459945	BolC6t40443H	0	-	2271	4988	5040	0.9896826
C6	46460492	46464925	BolC6t40444H	0	-	2431	4433	4433	1.0000000
C6	46466641	46467755	BolC6t40445H	0	+	143	817	1114	0.7333932
C6	46468278	46469456	BolC6t40446H	0	-	467	1178	1178	1.0000000
C6	46473711	46474431	BolC6t40447H	0	+	285	720	720	1.0000000
C7	6247	6469	BolC7t40448H	0	-	5253	222	222	1.0000000
C7	15877	16099	BolC7t40449H	0	-	35774	222	222	1.0000000
C7	25548	25770	BolC7t40450H	0	-	43	222	222	1.0000000
C7	35230	35452	BolC7t40451H	0	-	212	222	222	1.0000000
C7	64284	74189	BolC7t40452H	0	-	3470	7735	9905	0.7809187
C7	148925	186874	BolC7t40453H	0	+	2710	14369	37949	0.3786398
C7	177009	247505	BolC7t40454H	0	-	4456	11621	70496	0.1648462
C7	885747	885900	BolC7t40455H	0	+	17	55	153	0.3594771
C7	2402229	2402964	BolC7t40456H	0	+	88	453	735	0.6163265
C7	2448813	2449548	BolC7t40457H	0	+	6	154	735	0.2095238
C7	2485018	2487413	BolC7t40458H	0	+	487	1939	2395	0.8096033
C7	2488821	2489028	BolC7t40459H	0	+	19	148	207	0.7149758
C7	2494617	2495704	BolC7t40460H	0	+	283	840	1087	0.7727691
C7	2497662	2498631	BolC7t40461H	0	+	108	681	969	0.7027864
C7	2499225	2499919	BolC7t40462H	0	-	389	694	694	1.0000000
C7	2513475	2522463	BolC7t40463H	0	-	11073	8776	8988	0.9764130
C7	2523150	2523330	BolC7t40464H	0	+	0	0	180	0.0000000
C7	2523969	2526225	BolC7t40465H	0	-	890	2098	2256	0.9299645
C7	2526621	2527548	BolC7t40466H	0	+	710	927	927	1.0000000
C7	2528276	2529578	BolC7t40467H	0	-	633	1302	1302	1.0000000
C7	2539949	2541173	BolC7t40468H	0	-	430	1224	1224	1.0000000
C7	2541505	2542668	BolC7t40469H	0	+	560	1163	1163	1.0000000
C7	2547277	2548824	BolC7t40470H	0	+	111	741	1547	0.4789916
C7	2549570	2550350	BolC7t40471H	0	-	529	773	780	0.9910256
C7	2554492	2554926	BolC7t40472H	0	-	56	395	434	0.9101382
C7	2561873	2563721	BolC7t40473H	0	-	550	1848	1848	1.0000000
C7	2590823	2591282	BolC7t40474H	0	+	4	231	459	0.5032680
C7	2594801	2597165	BolC7t40475H	0	+	165	1649	2364	0.6975465
C7	2605152	2606573	BolC7t40476H	0	+	841	1421	1421	1.0000000
C7	2606794	2607288	BolC7t40477H	0	+	440	494	494	1.0000000
C7	2610627	2644470	BolC7t40478H	0	+	20239	13184	33843	0.3895636
C7	2615227	2647190	BolC7t40479H	0	-	20244	12773	31963	0.3996183
C7	2662406	2664816	BolC7t40480H	0	+	1652	2409	2410	0.9995850
C7	2713088	2715096	BolC7t40481H	0	-	436	1941	2008	0.9666334
C7	2724669	2726708	BolC7t40482H	0	+	586	1927	2039	0.9450711
C7	2730743	2731116	BolC7t40483H	0	-	38	329	373	0.8820375
C7	2732836	2733422	BolC7t40484H	0	+	31	253	586	0.4317406
C7	2758984	2759357	BolC7t40485H	0	-	5	291	373	0.7801608
C7	2763319	2771426	BolC7t40486H	0	+	4066	4469	8107	0.5512520
C7	2779228	2780797	BolC7t40487H	0	-	913	1551	1569	0.9885277
C7	2795180	2797774	BolC7t40488H	0	-	2174	2417	2594	0.9317656
C7	2804598	2810029	BolC7t40489H	0	-	1443	4150	5431	0.7641318
C7	2814413	2816802	BolC7t40490H	0	-	67	1496	2389	0.6262034
C7	2846484	2847026	BolC7t40491H	0	-	214	542	542	1.0000000
C7	2861813	2863823	BolC7t40492H	0	+	2	19	2010	0.0094527
C7	2864883	2865180	BolC7t40493H	0	+	0	0	297	0.0000000
C7	2874052	2874683	BolC7t40494H	0	+	271	631	631	1.0000000
C7	2875270	2876679	BolC7t40495H	0	+	279	1336	1409	0.9481902
C7	2877342	2878011	BolC7t40496H	0	-	325	669	669	1.0000000
C7	2879182	2881933	BolC7t40497H	0	+	633	2195	2751	0.7978917
C7	2883117	2884526	BolC7t40498H	0	-	551	1409	1409	1.0000000
C7	2885199	2885868	BolC7t40499H	0	+	270	669	669	1.0000000
C7	2891986	2892663	BolC7t40500H	0	-	407	677	677	1.0000000
C7	2892993	2893862	BolC7t40501H	0	+	477	869	869	1.0000000
C7	2894583	2897587	BolC7t40502H	0	+	247	2050	3004	0.6824234
C7	2897995	2901192	BolC7t40503H	0	+	1414	3061	3197	0.9574601
C7	2901927	2902239	BolC7t40504H	0	+	339	312	312	1.0000000
C7	2912750	2913659	BolC7t40505H	0	+	233	784	909	0.8624862
C7	2933803	2936135	BolC7t40506H	0	+	239	2106	2332	0.9030875
C7	2938239	2938909	BolC7t40507H	0	+	1646	670	670	1.0000000
C7	2938982	2940142	BolC7t40508H	0	+	19	494	1160	0.4258621
C7	2941884	2944223	BolC7t40509H	0	-	853	2339	2339	1.0000000
C7	2945451	2947053	BolC7t40510H	0	-	211	1456	1602	0.9088639
C7	2948242	2949078	BolC7t40511H	0	+	14	35	836	0.0418660
C7	2953422	2954886	BolC7t40512H	0	+	1355	1464	1464	1.0000000
C7	2955266	2957027	BolC7t40513H	0	-	86	865	1761	0.4911982
C7	2960340	2960776	BolC7t40514H	0	+	152	270	436	0.6192660
C7	2961241	2961475	BolC7t40515H	0	+	190	234	234	1.0000000
C7	2962492	2972802	BolC7t40516H	0	+	1289	4156	10310	0.4031038
C7	2973439	3012535	BolC7t40517H	0	-	3592	13008	39096	0.3327194
C7	3005863	3007352	BolC7t40518H	0	-	115	845	1489	0.5674950
C7	3028407	3030880	BolC7t40519H	0	+	258	1685	2473	0.6813587
C7	3031935	3036732	BolC7t40520H	0	-	835	2822	4797	0.5882844
C7	3039352	3041041	BolC7t40521H	0	+	500	1285	1689	0.7608052
C7	3041966	3045034	BolC7t40522H	0	+	622	1599	3068	0.5211864
C7	3069180	3086415	BolC7t40523H	0	+	5298	15544	17235	0.9018857
C7	3092021	3094651	BolC7t40524H	0	+	83	1941	2630	0.7380228
C7	3097017	3099219	BolC7t40525H	0	+	639	2137	2202	0.9704814
C7	3102015	3103112	BolC7t40526H	0	+	578	1097	1097	1.0000000
C7	3131261	3138013	BolC7t40527H	0	-	1989	6643	6752	0.9838566
C7	3188496	3188856	BolC7t40528H	0	+	5	228	360	0.6333333
C7	3192099	3192886	BolC7t40529H	0	+	164	787	787	1.0000000
C7	3200169	3208104	BolC7t40530H	0	-	2550	7702	7935	0.9706364
C7	3230110	3231220	BolC7t40531H	0	+	183	1110	1110	1.0000000
C7	3263717	3263957	BolC7t40532H	0	-	0	0	240	0.0000000
C7	3267421	3281789	BolC7t40533H	0	+	3208	9618	14368	0.6694042
C7	3282214	3283697	BolC7t40534H	0	-	270	1289	1483	0.8691841
C7	3290152	3293335	BolC7t40535H	0	+	791	2894	3183	0.9092051
C7	3297027	3303822	BolC7t40536H	0	+	473	3069	6795	0.4516556
C7	3325509	3327803	BolC7t40537H	0	+	1194	2157	2294	0.9402790
C7	3367290	3368897	BolC7t40538H	0	+	698	1607	1607	1.0000000
C7	3369559	3371584	BolC7t40539H	0	-	860	1991	2025	0.9832098
C7	3378883	3379078	BolC7t40540H	0	+	5	154	195	0.7897436
C7	3384031	3399129	BolC7t40541H	0	+	3467	6874	15098	0.4552921
C7	3386001	3386850	BolC7t40542H	0	+	14	417	849	0.4911661
C7	3392466	3393423	BolC7t40543H	0	-	190	562	957	0.5872518
C7	3399881	3401378	BolC7t40544H	0	-	758	1368	1497	0.9138277
C7	3414540	3416090	BolC7t40545H	0	+	5	82	1550	0.0529032
C7	3422861	3423567	BolC7t40546H	0	+	479	706	706	1.0000000
C7	3424402	3432830	BolC7t40547H	0	+	954	4127	8428	0.4896773
C7	3465883	3470205	BolC7t40548H	0	+	705	2882	4322	0.6668209
C7	3475874	3477062	BolC7t40549H	0	-	471	1133	1188	0.9537037
C7	3481925	3482813	BolC7t40550H	0	-	350	821	888	0.9245495
C7	3497060	3497668	BolC7t40551H	0	-	207	457	608	0.7516447
C7	3498171	3511247	BolC7t40552H	0	-	1090	5502	13076	0.4207709
C7	3511343	3511972	BolC7t40553H	0	-	24	425	629	0.6756757
C7	3511985	3512898	BolC7t40554H	0	-	48	667	913	0.7305586
C7	3514159	3514312	BolC7t40555H	0	-	0	0	153	0.0000000
C7	3524770	3524972	BolC7t40556H	0	-	200	202	202	1.0000000
C7	3529780	3529954	BolC7t40557H	0	-	0	0	174	0.0000000
C7	3550974	3551130	BolC7t40558H	0	+	0	0	156	0.0000000
C7	3552676	3555750	BolC7t40559H	0	-	1005	2210	3074	0.7189330
C7	3597467	3597752	BolC7t40560H	0	-	84	285	285	1.0000000
C7	3602156	3602327	BolC7t40561H	0	+	49	19	171	0.1111111
C7	3606547	3607250	BolC7t40562H	0	+	0	0	703	0.0000000
C7	3615662	3618819	BolC7t40563H	0	+	433	1744	3157	0.5524232
C7	3629506	3634354	BolC7t40564H	0	+	1963	3660	4848	0.7549505
C7	3637194	3638373	BolC7t40565H	0	+	248	1009	1179	0.8558100
C7	3655775	3656102	BolC7t40566H	0	+	213	327	327	1.0000000
C7	3717306	3717843	BolC7t40567H	0	+	333	537	537	1.0000000
C7	3724449	3725106	BolC7t40568H	0	+	45	445	657	0.6773211
C7	3727386	3727923	BolC7t40569H	0	+	28	345	537	0.6424581
C7	3731764	3734113	BolC7t40570H	0	-	49	786	2349	0.3346105
C7	3738647	3739071	BolC7t40571H	0	+	13	262	424	0.6179245
C7	3744217	3744684	BolC7t40572H	0	+	335	426	467	0.9122056
C7	3753932	3757873	BolC7t40573H	0	+	2837	3795	3941	0.9629536
C7	3773386	3774418	BolC7t40574H	0	+	555	909	1032	0.8808140
C7	3783011	3783810	BolC7t40575H	0	-	16	210	799	0.2628285
C7	3793265	3794483	BolC7t40576H	0	-	906	1218	1218	1.0000000
C7	3815149	3818182	BolC7t40577H	0	+	192	1286	3033	0.4240026
C7	3820575	3821454	BolC7t40578H	0	+	0	0	879	0.0000000
C7	3831855	3833046	BolC7t40579H	0	-	30	316	1191	0.2653233
C7	3834816	3839493	BolC7t40580H	0	+	2806	4400	4677	0.9407740
C7	3841832	3842396	BolC7t40581H	0	+	326	564	564	1.0000000
C7	3869540	3874074	BolC7t40582H	0	+	2066	3507	4534	0.7734892
C7	3875078	3878130	BolC7t40583H	0	+	751	2531	3052	0.8292922
C7	3878688	3881793	BolC7t40584H	0	-	616	2766	3105	0.8908213
C7	3884921	3888619	BolC7t40585H	0	-	242	694	3698	0.1876690
C7	3899200	3900283	BolC7t40586H	0	+	8	62	1083	0.0572484
C7	3902053	3904200	BolC7t40587H	0	-	597	2009	2147	0.9357243
C7	3910680	3912321	BolC7t40588H	0	-	547	1452	1641	0.8848263
C7	3919591	3919807	BolC7t40589H	0	-	71	216	216	1.0000000
C7	3921172	3924131	BolC7t40590H	0	-	1403	2907	2959	0.9824265
C7	3931001	3931491	BolC7t40591H	0	+	158	490	490	1.0000000
C7	3931613	3931823	BolC7t40592H	0	+	121	210	210	1.0000000
C7	3946595	3947478	BolC7t40593H	0	-	3	206	883	0.2332956
C7	3947599	3947812	BolC7t40594H	0	-	31	192	213	0.9014084
C7	3957057	3967366	BolC7t40595H	0	+	803	7049	10309	0.6837715
C7	3968964	3969876	BolC7t40596H	0	-	195	912	912	1.0000000
C7	3977252	3977393	BolC7t40597H	0	+	135	141	141	1.0000000
C7	3989692	3990460	BolC7t40598H	0	-	91	589	768	0.7669271
C7	3992440	3993067	BolC7t40599H	0	-	3907	627	627	1.0000000
C7	4017184	4017766	BolC7t40600H	0	-	116	543	582	0.9329897
C7	4017949	4020037	BolC7t40601H	0	-	659	1266	2088	0.6063218
C7	4039978	4041172	BolC7t40602H	0	-	203	685	1194	0.5737019
C7	4098174	4101369	BolC7t40603H	0	+	539	1610	3195	0.5039124
C7	4107417	4107896	BolC7t40604H	0	+	1	126	479	0.2630480
C7	4107967	4108941	BolC7t40605H	0	+	4	199	974	0.2043121
C7	4109087	4109555	BolC7t40606H	0	-	0	0	468	0.0000000
C7	4112907	4113584	BolC7t40607H	0	+	129	550	677	0.8124077
C7	4119174	4119450	BolC7t40608H	0	+	4	22	276	0.0797101
C7	4155179	4156253	BolC7t40609H	0	-	100	805	1074	0.7495344
C7	4179748	4179985	BolC7t40610H	0	+	209	237	237	1.0000000
C7	4194698	4195280	BolC7t40611H	0	-	532	582	582	1.0000000
C7	4204876	4207228	BolC7t40612H	0	+	156	1215	2352	0.5165817
C7	4208204	4209060	BolC7t40613H	0	-	510	847	856	0.9894860
C7	4214990	4216180	BolC7t40614H	0	+	33	561	1190	0.4714286
C7	4229756	4230575	BolC7t40615H	0	+	428	819	819	1.0000000
C7	4237695	4238061	BolC7t40616H	0	+	277	366	366	1.0000000
C7	4239357	4240145	BolC7t40617H	0	-	625	788	788	1.0000000
C7	4242244	4242445	BolC7t40618H	0	-	196	201	201	1.0000000
C7	4243678	4257244	BolC7t40619H	0	+	30408	8873	13566	0.6540616
C7	4275709	4277083	BolC7t40620H	0	-	686	1374	1374	1.0000000
C7	4297024	4297192	BolC7t40621H	0	+	66	168	168	1.0000000
C7	4320833	4321490	BolC7t40622H	0	-	303	657	657	1.0000000
C7	4326911	4327181	BolC7t40623H	0	-	4	107	270	0.3962963
C7	4328594	4329095	BolC7t40624H	0	+	473	501	501	1.0000000
C7	4329800	4331010	BolC7t40625H	0	-	154	929	1210	0.7677686
C7	4332510	4333683	BolC7t40626H	0	-	612	1173	1173	1.0000000
C7	4333892	4334817	BolC7t40627H	0	+	842	925	925	1.0000000
C7	4335255	4338619	BolC7t40628H	0	-	1587	2965	3364	0.8813912
C7	4341264	4342302	BolC7t40629H	0	-	570	1000	1038	0.9633911
C7	4342707	4344511	BolC7t40630H	0	+	1307	1804	1804	1.0000000
C7	4345392	4345884	BolC7t40631H	0	+	436	492	492	1.0000000
C7	4374344	4375448	BolC7t40632H	0	+	852	1104	1104	1.0000000
C7	4378799	4379801	BolC7t40633H	0	+	868	1002	1002	1.0000000
C7	4380038	4380413	BolC7t40634H	0	+	343	375	375	1.0000000
C7	4392137	4396457	BolC7t40635H	0	-	3260	4320	4320	1.0000000
C7	4397200	4398789	BolC7t40636H	0	+	8	122	1589	0.0767778
C7	4412431	4414445	BolC7t40637H	0	-	72	1003	2014	0.4980139
C7	4417228	4418398	BolC7t40638H	0	+	105	598	1170	0.5111111
C7	4419668	4432074	BolC7t40639H	0	+	658	6296	12406	0.5074964
C7	4436713	4437598	BolC7t40640H	0	+	88	786	885	0.8881356
C7	4455883	4458808	BolC7t40641H	0	+	325	2263	2925	0.7736752
C7	4460691	4461305	BolC7t40642H	0	+	31	589	614	0.9592834
C7	4470373	4473174	BolC7t40643H	0	-	1928	2801	2801	1.0000000
C7	4474414	4476272	BolC7t40644H	0	-	1632	1858	1858	1.0000000
C7	4477215	4477458	BolC7t40645H	0	-	13	123	243	0.5061728
C7	4511510	4512719	BolC7t40646H	0	-	6	161	1209	0.1331679
C7	4515005	4517136	BolC7t40647H	0	-	920	2131	2131	1.0000000
C7	4552825	4553152	BolC7t40648H	0	-	6	171	327	0.5229358
C7	4555439	4555712	BolC7t40649H	0	-	7	128	273	0.4688645
C7	4570982	4571261	BolC7t40650H	0	-	68	279	279	1.0000000
C7	4585272	4585551	BolC7t40651H	0	-	81	279	279	1.0000000
C7	4591995	4592274	BolC7t40652H	0	-	198	279	279	1.0000000
C7	4605837	4606956	BolC7t40653H	0	+	129	993	1119	0.8873994
C7	4607574	4610582	BolC7t40654H	0	-	634	2040	3008	0.6781915
C7	4644170	4648447	BolC7t40655H	0	+	1003	3029	4277	0.7082067
C7	4651123	4653102	BolC7t40656H	0	-	424	1651	1979	0.8342597
C7	4657760	4658248	BolC7t40657H	0	+	185	488	488	1.0000000
C7	4658903	4660018	BolC7t40658H	0	-	691	1115	1115	1.0000000
C7	4661128	4661674	BolC7t40659H	0	+	305	546	546	1.0000000
C7	4666116	4666777	BolC7t40660H	0	+	102	644	661	0.9742814
C7	4669320	4670141	BolC7t40661H	0	+	2	59	821	0.0718636
C7	4684805	4685535	BolC7t40662H	0	-	552	730	730	1.0000000
C7	4688810	4691374	BolC7t40663H	0	-	1180	2481	2564	0.9676287
C7	4692723	4693414	BolC7t40664H	0	+	504	691	691	1.0000000
C7	4695921	4696203	BolC7t40665H	0	-	186	282	282	1.0000000
C7	4696284	4698295	BolC7t40666H	0	+	1365	2011	2011	1.0000000
C7	4703105	4703957	BolC7t40667H	0	+	510	852	852	1.0000000
C7	4709288	4710230	BolC7t40668H	0	-	772	942	942	1.0000000
C7	4712821	4714065	BolC7t40669H	0	-	178	1036	1244	0.8327974
C7	4751855	4752245	BolC7t40670H	0	-	31	277	390	0.7102564
C7	4753885	4756756	BolC7t40671H	0	-	365	2594	2871	0.9035180
C7	4761580	4764499	BolC7t40672H	0	-	1745	2900	2919	0.9934909
C7	4776348	4776849	BolC7t40673H	0	+	391	501	501	1.0000000
C7	4799825	4799963	BolC7t40674H	0	+	187	138	138	1.0000000
C7	4840076	4873601	BolC7t40675H	0	+	14990	32316	33525	0.9639373
C7	4875791	4876247	BolC7t40676H	0	+	46	456	456	1.0000000
C7	4880129	4880500	BolC7t40677H	0	+	4	19	371	0.0512129
C7	4885610	4886194	BolC7t40678H	0	+	711	584	584	1.0000000
C7	4885936	4886466	BolC7t40679H	0	+	297	530	530	1.0000000
C7	4889687	4895283	BolC7t40680H	0	+	374	3259	5596	0.5823803
C7	4895894	4897331	BolC7t40681H	0	-	524	1407	1437	0.9791232
C7	4899429	4900396	BolC7t40682H	0	-	627	967	967	1.0000000
C7	4903790	4906437	BolC7t40683H	0	-	1995	2431	2647	0.9183982
C7	4908862	4910651	BolC7t40684H	0	-	31	305	1789	0.1704863
C7	4911901	4912132	BolC7t40685H	0	+	19	231	231	1.0000000
C7	4912508	4913278	BolC7t40686H	0	+	17	301	770	0.3909091
C7	4914732	4921488	BolC7t40687H	0	+	2125	5279	6756	0.7813795
C7	4922951	4925033	BolC7t40688H	0	-	862	1921	2082	0.9226705
C7	4925242	4926452	BolC7t40689H	0	+	714	1127	1210	0.9314049
C7	4933086	4959524	BolC7t40690H	0	-	4892	18548	26438	0.7015659
C7	4949689	4950428	BolC7t40691H	0	-	5	23	739	0.0311231
C7	4960696	4961569	BolC7t40692H	0	-	0	0	873	0.0000000
C7	4978638	4998089	BolC7t40693H	0	+	6059	16192	19451	0.8324507
C7	5007392	5007863	BolC7t40694H	0	+	213	471	471	1.0000000
C7	5014275	5014560	BolC7t40695H	0	-	194	285	285	1.0000000
C7	5016049	5017157	BolC7t40696H	0	-	663	1108	1108	1.0000000
C7	5018351	5018924	BolC7t40697H	0	+	541	573	573	1.0000000
C7	5021202	5022135	BolC7t40698H	0	-	600	933	933	1.0000000
C7	5052589	5055390	BolC7t40699H	0	+	131	1482	2801	0.5290967
C7	5055364	5057271	BolC7t40700H	0	-	325	1666	1907	0.8736235
C7	5062707	5063417	BolC7t40701H	0	-	15	179	710	0.2521127
C7	5077923	5080726	BolC7t40702H	0	+	1438	2732	2803	0.9746700
C7	5081127	5083646	BolC7t40703H	0	-	1949	2405	2519	0.9547439
C7	5099237	5100150	BolC7t40704H	0	-	742	913	913	1.0000000
C7	5101364	5101848	BolC7t40705H	0	+	381	484	484	1.0000000
C7	5102992	5103500	BolC7t40706H	0	+	369	508	508	1.0000000
C7	5105701	5105956	BolC7t40707H	0	-	82	255	255	1.0000000
C7	5126627	5127817	BolC7t40708H	0	-	1001	1190	1190	1.0000000
C7	5128146	5128482	BolC7t40709H	0	-	337	336	336	1.0000000
C7	5130129	5130465	BolC7t40710H	0	-	223	336	336	1.0000000
C7	5144204	5144615	BolC7t40711H	0	-	170	411	411	1.0000000
C7	5172198	5172538	BolC7t40712H	0	+	117	340	340	1.0000000
C7	5249153	5249412	BolC7t40713H	0	+	218	259	259	1.0000000
C7	5249433	5251755	BolC7t40714H	0	+	755	2302	2322	0.9913867
C7	5249949	5250294	BolC7t40715H	0	-	67	325	345	0.9420290
C7	5251794	5252514	BolC7t40716H	0	+	346	720	720	1.0000000
C7	5257127	5258185	BolC7t40717H	0	+	776	1058	1058	1.0000000
C7	5289905	5291111	BolC7t40718H	0	+	423	1178	1206	0.9767827
C7	5302964	5303975	BolC7t40719H	0	+	741	1011	1011	1.0000000
C7	5305289	5306347	BolC7t40720H	0	-	543	1058	1058	1.0000000
C7	5308078	5308317	BolC7t40721H	0	+	116	239	239	1.0000000
C7	5313269	5313604	BolC7t40722H	0	-	102	335	335	1.0000000
C7	5317471	5321885	BolC7t40723H	0	-	3404	4335	4414	0.9821024
C7	5322047	5323641	BolC7t40724H	0	-	1522	1594	1594	1.0000000
C7	5347954	5351366	BolC7t40725H	0	+	1164	2691	3412	0.7886870
C7	5356175	5356580	BolC7t40726H	0	+	294	405	405	1.0000000
C7	5357331	5361580	BolC7t40727H	0	-	1783	3842	4249	0.9042128
C7	5365064	5365274	BolC7t40728H	0	-	261	210	210	1.0000000
C7	5379117	5379517	BolC7t40729H	0	+	315	400	400	1.0000000
C7	5379735	5380695	BolC7t40730H	0	+	693	960	960	1.0000000
C7	5396297	5396984	BolC7t40731H	0	-	314	687	687	1.0000000
C7	5399407	5400405	BolC7t40732H	0	+	660	998	998	1.0000000
C7	5402878	5403570	BolC7t40733H	0	-	885	692	692	1.0000000
C7	5410772	5418084	BolC7t40734H	0	-	2575	6341	7312	0.8672046
C7	5424134	5427484	BolC7t40735H	0	-	3641	3339	3350	0.9967164
C7	5440571	5441901	BolC7t40736H	0	-	553	1192	1330	0.8962406
C7	5465501	5466911	BolC7t40737H	0	+	1767	1410	1410	1.0000000
C7	5474375	5474891	BolC7t40738H	0	-	175	516	516	1.0000000
C7	5483107	5485737	BolC7t40739H	0	+	450	2216	2630	0.8425856
C7	5486129	5487821	BolC7t40740H	0	-	785	1623	1692	0.9592199
C7	5498050	5511541	BolC7t40741H	0	-	3851	11054	13491	0.8193610
C7	5504551	5505693	BolC7t40742H	0	+	502	1142	1142	1.0000000
C7	5513809	5514190	BolC7t40743H	0	-	2	17	381	0.0446194
C7	5521929	5523064	BolC7t40744H	0	-	190	886	1135	0.7806168
C7	5564203	5564569	BolC7t40745H	0	-	288	366	366	1.0000000
C7	5570074	5571824	BolC7t40746H	0	+	261	1280	1750	0.7314286
C7	5608584	5610026	BolC7t40747H	0	+	4	162	1442	0.1123440
C7	5629515	5634941	BolC7t40748H	0	-	1038	4450	5426	0.8201253
C7	5701084	5701384	BolC7t40749H	0	+	655	300	300	1.0000000
C7	5701652	5701895	BolC7t40750H	0	-	261	243	243	1.0000000
C7	5757473	5758463	BolC7t40751H	0	-	647	990	990	1.0000000
C7	5766207	5768719	BolC7t40752H	0	+	309	1812	2512	0.7213376
C7	5769973	5770423	BolC7t40753H	0	-	152	450	450	1.0000000
C7	5773669	5775994	BolC7t40754H	0	+	472	2075	2325	0.8924731
C7	5777693	5780527	BolC7t40755H	0	-	1655	2577	2834	0.9093155
C7	5783940	5784626	BolC7t40756H	0	-	0	0	686	0.0000000
C7	5785008	5786328	BolC7t40757H	0	+	0	0	1320	0.0000000
C7	5787560	5790311	BolC7t40758H	0	-	60	688	2751	0.2500909
C7	5808715	5816026	BolC7t40759H	0	+	99	1032	7311	0.1411572
C7	5816373	5816769	BolC7t40760H	0	+	0	0	396	0.0000000
C7	5819989	5820519	BolC7t40761H	0	-	0	0	530	0.0000000
C7	5821128	5821814	BolC7t40762H	0	+	0	0	686	0.0000000
C7	5829072	5831264	BolC7t40763H	0	+	836	1914	2192	0.8731752
C7	5833370	5834479	BolC7t40764H	0	+	199	1006	1109	0.9071235
C7	5857563	5861298	BolC7t40765H	0	+	1765	3371	3735	0.9025435
C7	5864856	5865439	BolC7t40766H	0	+	14	221	583	0.3790738
C7	5874283	5874778	BolC7t40767H	0	+	0	0	495	0.0000000
C7	5875509	5875716	BolC7t40768H	0	+	0	0	207	0.0000000
C7	5877222	5877594	BolC7t40769H	0	+	337	372	372	1.0000000
C7	5887752	5890898	BolC7t40770H	0	-	1747	3060	3146	0.9726637
C7	5896472	5896989	BolC7t40771H	0	-	4	63	517	0.1218569
C7	5897100	5897367	BolC7t40772H	0	-	2	28	267	0.1048689
C7	5907059	5909165	BolC7t40773H	0	+	360	2106	2106	1.0000000
C7	5912757	5913453	BolC7t40774H	0	-	287	696	696	1.0000000
C7	5917532	5918228	BolC7t40775H	0	-	843	696	696	1.0000000
C7	5939563	5939998	BolC7t40776H	0	-	41	435	435	1.0000000
C7	5940681	5941002	BolC7t40777H	0	-	7	237	321	0.7383177
C7	5966633	5968048	BolC7t40778H	0	+	90	249	1415	0.1759717
C7	5992829	5992946	BolC7t40779H	0	-	0	0	117	0.0000000
C7	6008016	6008286	BolC7t40780H	0	+	239	221	270	0.8185185
C7	6018187	6018508	BolC7t40781H	0	+	12	78	321	0.2429907
C7	6021043	6023853	BolC7t40782H	0	-	694	2382	2810	0.8476868
C7	6027326	6027524	BolC7t40783H	0	+	411	198	198	1.0000000
C7	6052302	6054805	BolC7t40784H	0	-	1136	2076	2503	0.8294047
C7	6071137	6073331	BolC7t40785H	0	-	1583	2194	2194	1.0000000
C7	6083499	6083757	BolC7t40786H	0	+	341	258	258	1.0000000
C7	6084950	6086227	BolC7t40787H	0	+	713	1277	1277	1.0000000
C7	6117842	6118713	BolC7t40788H	0	+	28	574	871	0.6590126
C7	6249514	6251029	BolC7t40789H	0	-	839	1339	1515	0.8838284
C7	6261313	6262648	BolC7t40790H	0	-	697	1335	1335	1.0000000
C7	6263550	6266376	BolC7t40791H	0	-	1228	2792	2826	0.9879689
C7	6267922	6268081	BolC7t40792H	0	+	116	159	159	1.0000000
C7	6316306	6316717	BolC7t40793H	0	-	336	411	411	1.0000000
C7	6317329	6317829	BolC7t40794H	0	-	156	500	500	1.0000000
C7	6321211	6323831	BolC7t40795H	0	+	1051	2392	2620	0.9129771
C7	6325936	6326692	BolC7t40796H	0	-	54	755	756	0.9986773
C7	6326940	6327408	BolC7t40797H	0	-	64	466	468	0.9957265
C7	6348221	6348757	BolC7t40798H	0	+	948	536	536	1.0000000
C7	6348918	6349318	BolC7t40799H	0	+	304	400	400	1.0000000
C7	6354762	6355790	BolC7t40800H	0	-	703	1028	1028	1.0000000
C7	6357671	6360117	BolC7t40801H	0	-	1554	2446	2446	1.0000000
C7	6360135	6361051	BolC7t40802H	0	-	760	916	916	1.0000000
C7	6365219	6365708	BolC7t40803H	0	+	26	320	489	0.6543967
C7	6369785	6371851	BolC7t40804H	0	-	257	1246	2066	0.6030978
C7	6390667	6391897	BolC7t40805H	0	+	129	845	1230	0.6869919
C7	6393162	6393373	BolC7t40806H	0	+	50	211	211	1.0000000
C7	6413384	6414563	BolC7t40807H	0	-	247	967	1179	0.8201866
C7	6420263	6421343	BolC7t40808H	0	-	11	287	1080	0.2657408
C7	6426568	6426742	BolC7t40809H	0	+	130	174	174	1.0000000
C7	6430435	6432071	BolC7t40810H	0	-	1357	1636	1636	1.0000000
C7	6454470	6456077	BolC7t40811H	0	+	94	1060	1607	0.6596142
C7	6460361	6462657	BolC7t40812H	0	-	27	516	2296	0.2247387
C7	6467662	6468034	BolC7t40813H	0	-	371	372	372	1.0000000
C7	6477511	6478528	BolC7t40814H	0	+	634	1017	1017	1.0000000
C7	6482339	6482635	BolC7t40815H	0	-	287	296	296	1.0000000
C7	6500366	6501260	BolC7t40816H	0	-	167	746	894	0.8344519
C7	6513220	6513986	BolC7t40817H	0	-	98	766	766	1.0000000
C7	6536119	6536632	BolC7t40818H	0	-	292	513	513	1.0000000
C7	6539970	6540405	BolC7t40819H	0	-	274	435	435	1.0000000
C7	6556211	6556874	BolC7t40820H	0	-	566	663	663	1.0000000
C7	6563252	6564793	BolC7t40821H	0	+	49	960	1541	0.6229721
C7	6566744	6566897	BolC7t40822H	0	+	161	153	153	1.0000000
C7	6581101	6582583	BolC7t40823H	0	-	55	1011	1482	0.6821862
C7	6603641	6605561	BolC7t40824H	0	+	815	1920	1920	1.0000000
C7	6609024	6609969	BolC7t40825H	0	-	479	886	945	0.9375662
C7	6621986	6622907	BolC7t40826H	0	-	45	578	921	0.6275787
C7	6626178	6626673	BolC7t40827H	0	-	34	443	495	0.8949495
C7	6626733	6627096	BolC7t40828H	0	-	6	21	363	0.0578512
C7	6650285	6652777	BolC7t40829H	0	+	95	915	2492	0.3671750
C7	6661275	6661458	BolC7t40830H	0	+	214	183	183	1.0000000
C7	6745642	6746007	BolC7t40831H	0	+	302	365	365	1.0000000
C7	6752161	6752734	BolC7t40832H	0	+	65	448	573	0.7818499
C7	6753711	6757247	BolC7t40833H	0	-	135	1219	3536	0.3447398
C7	6757301	6757694	BolC7t40834H	0	-	169	393	393	1.0000000
C7	6760297	6760450	BolC7t40835H	0	+	0	0	153	0.0000000
C7	6767279	6767537	BolC7t40836H	0	+	225	258	258	1.0000000
C7	6810265	6811009	BolC7t40837H	0	+	750	744	744	1.0000000
C7	6828740	6828863	BolC7t40838H	0	+	164	123	123	1.0000000
C7	6829320	6831109	BolC7t40839H	0	-	660	1639	1789	0.9161543
C7	6831646	6831940	BolC7t40840H	0	-	319	294	294	1.0000000
C7	6832301	6832610	BolC7t40841H	0	+	172	309	309	1.0000000
C7	6832946	6834155	BolC7t40842H	0	-	641	1205	1209	0.9966915
C7	6861274	6862285	BolC7t40843H	0	+	626	1007	1011	0.9960435
C7	6923632	6924426	BolC7t40844H	0	-	433	794	794	1.0000000
C7	6943843	6944257	BolC7t40845H	0	-	433	414	414	1.0000000
C7	6949713	6950337	BolC7t40846H	0	+	197	624	624	1.0000000
C7	6951768	6951879	BolC7t40847H	0	+	234	111	111	1.0000000
C7	6952632	6954265	BolC7t40848H	0	-	75	787	1633	0.4819351
C7	6967223	6970958	BolC7t40849H	0	-	2120	3643	3735	0.9753681
C7	6971217	6971403	BolC7t40850H	0	+	63	186	186	1.0000000
C7	6976811	6977232	BolC7t40851H	0	-	474	421	421	1.0000000
C7	6980988	6981237	BolC7t40852H	0	+	2	27	249	0.1084337
C7	7000854	7001295	BolC7t40853H	0	-	168	441	441	1.0000000
C7	7005160	7005343	BolC7t40854H	0	-	140	183	183	1.0000000
C7	7007904	7009337	BolC7t40855H	0	+	10	151	1433	0.1053733
C7	7014844	7014949	BolC7t40856H	0	+	13	41	105	0.3904762
C7	7043057	7044312	BolC7t40857H	0	+	592	1255	1255	1.0000000
C7	7044565	7045924	BolC7t40858H	0	-	440	1359	1359	1.0000000
C7	7052063	7052327	BolC7t40859H	0	+	249	264	264	1.0000000
C7	7075931	7076540	BolC7t40860H	0	-	124	331	609	0.5435140
C7	7082847	7084042	BolC7t40861H	0	-	945	1195	1195	1.0000000
C7	7090000	7090736	BolC7t40862H	0	-	656	736	736	1.0000000
C7	7108708	7110243	BolC7t40863H	0	-	409	1460	1535	0.9511400
C7	7119234	7120034	BolC7t40864H	0	-	433	800	800	1.0000000
C7	7123516	7124739	BolC7t40865H	0	-	577	1223	1223	1.0000000
C7	7126492	7128249	BolC7t40866H	0	+	867	1721	1757	0.9795105
C7	7129024	7132768	BolC7t40867H	0	-	1340	3445	3744	0.9201389
C7	7190369	7191424	BolC7t40868H	0	+	132	470	1055	0.4454976
C7	7195162	7197937	BolC7t40869H	0	-	653	2739	2775	0.9870270
C7	7200183	7202142	BolC7t40870H	0	-	389	1513	1959	0.7723328
C7	7203694	7205199	BolC7t40871H	0	-	93	924	1505	0.6139535
C7	7280701	7281478	BolC7t40872H	0	+	5	333	777	0.4285714
C7	7374348	7374618	BolC7t40873H	0	+	44	251	270	0.9296296
C7	7376034	7376806	BolC7t40874H	0	+	440	764	772	0.9896373
C7	7377846	7378131	BolC7t40875H	0	+	38	256	285	0.8982456
C7	7392606	7393876	BolC7t40876H	0	+	428	1187	1270	0.9346457
C7	7395495	7395648	BolC7t40877H	0	+	2	56	153	0.3660131
C7	7405108	7407257	BolC7t40878H	0	+	659	1457	2149	0.6779898
C7	7424114	7424567	BolC7t40879H	0	-	41	78	453	0.1721854
C7	7437538	7439088	BolC7t40880H	0	+	835	1368	1550	0.8825806
C7	7485954	7487635	BolC7t40881H	0	-	5	144	1681	0.0856633
C7	7495271	7497818	BolC7t40882H	0	-	1940	2547	2547	1.0000000
C7	7498744	7499671	BolC7t40883H	0	-	1038	927	927	1.0000000
C7	7519378	7520285	BolC7t40884H	0	+	450	907	907	1.0000000
C7	7537840	7540334	BolC7t40885H	0	-	3144	2494	2494	1.0000000
C7	7558124	7560268	BolC7t40886H	0	+	328	1528	2144	0.7126865
C7	7562778	7563542	BolC7t40887H	0	-	22	604	764	0.7905759
C7	7571548	7572151	BolC7t40888H	0	-	151	603	603	1.0000000
C7	7572622	7572937	BolC7t40889H	0	-	75	315	315	1.0000000
C7	7583897	7585433	BolC7t40890H	0	-	366	824	1536	0.5364583
C7	7586183	7587706	BolC7t40891H	0	-	654	1514	1523	0.9940906
C7	7622737	7630227	BolC7t40892H	0	+	3451	7473	7490	0.9977303
C7	7658970	7659332	BolC7t40893H	0	-	38	358	362	0.9889503
C7	7661850	7662832	BolC7t40894H	0	-	57	551	982	0.5610998
C7	7669292	7669523	BolC7t40895H	0	-	99	231	231	1.0000000
C7	7680204	7680972	BolC7t40896H	0	-	4568	768	768	1.0000000
C7	7688357	7688684	BolC7t40897H	0	-	1	10	327	0.0305810
C7	7713461	7714611	BolC7t40898H	0	-	629	1150	1150	1.0000000
C7	7715881	7716682	BolC7t40899H	0	-	21	474	801	0.5917603
C7	7726210	7726539	BolC7t40900H	0	+	450	329	329	1.0000000
C7	7736215	7737596	BolC7t40901H	0	+	631	1341	1381	0.9710355
C7	7737737	7738241	BolC7t40902H	0	-	40	482	504	0.9563492
C7	7766160	7769143	BolC7t40903H	0	-	763	2369	2983	0.7941669
C7	7819299	7820568	BolC7t40904H	0	+	793	1269	1269	1.0000000
C7	7823332	7823950	BolC7t40905H	0	+	234	609	618	0.9854369
C7	7824068	7824334	BolC7t40906H	0	+	116	266	266	1.0000000
C7	7827985	7830078	BolC7t40907H	0	+	289	1608	2093	0.7682752
C7	7863880	7864854	BolC7t40908H	0	+	244	974	974	1.0000000
C7	7892427	7893516	BolC7t40909H	0	+	995	1089	1089	1.0000000
C7	7916289	7916466	BolC7t40910H	0	-	273	177	177	1.0000000
C7	7918899	7920096	BolC7t40911H	0	+	435	1110	1197	0.9273183
C7	7940331	7941351	BolC7t40912H	0	-	1055	1020	1020	1.0000000
C7	7946519	7947261	BolC7t40913H	0	-	10	409	742	0.5512130
C7	7961687	7964973	BolC7t40914H	0	+	1673	3225	3286	0.9814364
C7	7972004	7975035	BolC7t40915H	0	+	941	2469	3031	0.8145826
C7	7976179	7976431	BolC7t40916H	0	-	159	252	252	1.0000000
C7	7985992	7986868	BolC7t40917H	0	+	179	832	876	0.9497717
C7	7988675	7988912	BolC7t40918H	0	-	198	237	237	1.0000000
C7	7997116	7997855	BolC7t40919H	0	+	345	686	739	0.9282815
C7	8018008	8018197	BolC7t40920H	0	+	93	184	189	0.9735450
C7	8022165	8022815	BolC7t40921H	0	+	312	650	650	1.0000000
C7	8023642	8024506	BolC7t40922H	0	-	6	169	864	0.1956019
C7	8031346	8033636	BolC7t40923H	0	+	1271	2250	2290	0.9825327
C7	8055105	8055582	BolC7t40924H	0	+	147	451	477	0.9454927
C7	8059533	8065171	BolC7t40925H	0	+	2805	5349	5638	0.9487407
C7	8066483	8079087	BolC7t40926H	0	+	1060	5701	12604	0.4523167
C7	8080743	8081199	BolC7t40927H	0	+	182	456	456	1.0000000
C7	8090913	8094039	BolC7t40928H	0	+	321	2605	3126	0.8333333
C7	8095065	8095743	BolC7t40929H	0	+	3	165	678	0.2433628
C7	8097264	8098912	BolC7t40930H	0	-	56	672	1648	0.4077670
C7	8098883	8112717	BolC7t40931H	0	-	2809	9807	13834	0.7089056
C7	8100269	8100788	BolC7t40932H	0	-	30	104	519	0.2003854
C7	8101094	8101762	BolC7t40933H	0	-	13	186	668	0.2784431
C7	8110242	8110585	BolC7t40934H	0	+	19	109	343	0.3177842
C7	8110981	8111815	BolC7t40935H	0	-	5	140	834	0.1678657
C7	8112261	8115189	BolC7t40936H	0	-	21	1158	2928	0.3954918
C7	8123743	8125335	BolC7t40937H	0	-	929	1592	1592	1.0000000
C7	8132510	8133200	BolC7t40938H	0	-	90	677	690	0.9811594
C7	8136413	8141900	BolC7t40939H	0	-	432	3190	5487	0.5813742
C7	8150363	8151715	BolC7t40940H	0	-	185	1139	1352	0.8424556
C7	8162932	8164617	BolC7t40941H	0	+	577	1483	1685	0.8801187
C7	8165257	8166233	BolC7t40942H	0	-	73	689	976	0.7059426
C7	8183524	8184534	BolC7t40943H	0	-	240	1010	1010	1.0000000
C7	8185803	8186302	BolC7t40944H	0	-	21	381	499	0.7635270
C7	8219532	8221452	BolC7t40945H	0	+	804	1920	1920	1.0000000
C7	8241092	8241270	BolC7t40946H	0	+	407	178	178	1.0000000
C7	8245916	8246846	BolC7t40947H	0	-	73	884	930	0.9505376
C7	8255265	8258164	BolC7t40948H	0	+	3266	2899	2899	1.0000000
C7	8262895	8263198	BolC7t40949H	0	+	568	303	303	1.0000000
C7	8271244	8271457	BolC7t40950H	0	+	266	213	213	1.0000000
C7	8289747	8292827	BolC7t40951H	0	-	763	2381	3080	0.7730520
C7	8307403	8308313	BolC7t40952H	0	-	561	910	910	1.0000000
C7	8314283	8317554	BolC7t40953H	0	-	416	1677	3271	0.5126873
C7	8318989	8320164	BolC7t40954H	0	-	43	616	1175	0.5242553
C7	8328901	8329084	BolC7t40955H	0	+	174	183	183	1.0000000
C7	8335522	8337554	BolC7t40956H	0	-	835	1924	2032	0.9468504
C7	8345543	8346068	BolC7t40957H	0	+	23	466	525	0.8876190
C7	8347189	8349092	BolC7t40958H	0	-	794	1903	1903	1.0000000
C7	8384580	8387134	BolC7t40959H	0	+	1116	2554	2554	1.0000000
C7	8390915	8394094	BolC7t40960H	0	+	1093	2891	3179	0.9094055
C7	8395139	8396297	BolC7t40961H	0	+	168	1040	1158	0.8981002
C7	8408639	8413703	BolC7t40962H	0	+	1517	4530	5064	0.8945498
C7	8409990	8410768	BolC7t40963H	0	+	63	720	778	0.9254498
C7	8419318	8422313	BolC7t40964H	0	-	1523	2254	2995	0.7525876
C7	8436856	8442094	BolC7t40965H	0	+	1300	2807	5238	0.5358915
C7	8442698	8442908	BolC7t40966H	0	-	0	0	210	0.0000000
C7	8443588	8445456	BolC7t40967H	0	-	107	912	1868	0.4882227
C7	8451037	8451853	BolC7t40968H	0	-	205	773	816	0.9473040
C7	8452804	8453684	BolC7t40969H	0	+	757	880	880	1.0000000
C7	8471239	8474092	BolC7t40970H	0	+	1680	2609	2853	0.9144760
C7	8477363	8479253	BolC7t40971H	0	+	725	1876	1890	0.9925926
C7	8479657	8481788	BolC7t40972H	0	+	600	1646	2131	0.7724073
C7	8515522	8517045	BolC7t40973H	0	-	618	1359	1523	0.8923178
C7	8522745	8523006	BolC7t40974H	0	-	23	223	261	0.8544061
C7	8523335	8524506	BolC7t40975H	0	-	190	757	1171	0.6464560
C7	8527223	8528017	BolC7t40976H	0	+	456	794	794	1.0000000
C7	8539161	8541404	BolC7t40977H	0	+	1449	2243	2243	1.0000000
C7	8582608	8584769	BolC7t40978H	0	-	37	518	2161	0.2397038
C7	8597584	8597830	BolC7t40979H	0	+	0	0	246	0.0000000
C7	8626871	8627227	BolC7t40980H	0	+	262	356	356	1.0000000
C7	8689005	8691013	BolC7t40981H	0	-	3205	2008	2008	1.0000000
C7	8721818	8724917	BolC7t40982H	0	+	71	1585	3099	0.5114553
C7	8754734	8755540	BolC7t40983H	0	-	675	806	806	1.0000000
C7	8764468	8779147	BolC7t40984H	0	+	4239	10117	14679	0.6892159
C7	8798983	8799178	BolC7t40985H	0	+	139	195	195	1.0000000
C7	8802334	8802901	BolC7t40986H	0	+	45	208	567	0.3668430
C7	8819298	8820444	BolC7t40987H	0	+	678	821	1146	0.7164049
C7	8824191	8827583	BolC7t40988H	0	-	475	1543	3392	0.4548939
C7	8828267	8830027	BolC7t40989H	0	+	340	1172	1760	0.6659091
C7	8831397	8837962	BolC7t40990H	0	-	2057	5289	6565	0.8056359
C7	8847342	8849068	BolC7t40991H	0	-	1214	1726	1726	1.0000000
C7	8856757	8858610	BolC7t40992H	0	-	615	1563	1853	0.8434970
C7	8872647	8872863	BolC7t40993H	0	+	61	216	216	1.0000000
C7	8883923	8884880	BolC7t40994H	0	-	392	957	957	1.0000000
C7	8890589	8890874	BolC7t40995H	0	+	2	34	285	0.1192982
C7	8892353	8893914	BolC7t40996H	0	-	490	1545	1561	0.9897501
C7	8894045	8904020	BolC7t40997H	0	-	2003	6414	9975	0.6430075
C7	8914409	8915517	BolC7t40998H	0	-	301	974	1108	0.8790614
C7	8931908	8933824	BolC7t40999H	0	-	477	1916	1916	1.0000000
C7	8939716	8939968	BolC7t41000H	0	+	282	252	252	1.0000000
C7	8948756	8950342	BolC7t41001H	0	-	111	1399	1586	0.8820933
C7	8988141	8988882	BolC7t41002H	0	+	408	741	741	1.0000000
C7	8988981	8990040	BolC7t41003H	0	+	450	944	1059	0.8914070
C7	8995904	8996198	BolC7t41004H	0	-	1699	294	294	1.0000000
C7	9022300	9022435	BolC7t41005H	0	+	140	135	135	1.0000000
C7	9023099	9023542	BolC7t41006H	0	+	390	443	443	1.0000000
C7	9031807	9032239	BolC7t41007H	0	+	153	432	432	1.0000000
C7	9042171	9044121	BolC7t41008H	0	-	963	1950	1950	1.0000000
C7	9060933	9061386	BolC7t41009H	0	+	0	0	453	0.0000000
C7	9062883	9063234	BolC7t41010H	0	+	0	0	351	0.0000000
C7	9063541	9064143	BolC7t41011H	0	-	23	331	602	0.5498339
C7	9066225	9068877	BolC7t41012H	0	+	1726	2652	2652	1.0000000
C7	9068989	9069343	BolC7t41013H	0	+	273	354	354	1.0000000
C7	9069678	9069780	BolC7t41014H	0	+	137	102	102	1.0000000
C7	9070174	9071643	BolC7t41015H	0	-	1128	1420	1469	0.9666440
C7	9072744	9073857	BolC7t41016H	0	-	365	1113	1113	1.0000000
C7	9084007	9087185	BolC7t41017H	0	-	878	2819	3178	0.8870358
C7	9088412	9093006	BolC7t41018H	0	-	2163	4466	4594	0.9721376
C7	9094814	9095909	BolC7t41019H	0	+	38	319	1095	0.2913242
C7	9095976	9096732	BolC7t41020H	0	+	30	645	756	0.8531746
C7	9105861	9106179	BolC7t41021H	0	-	272	318	318	1.0000000
C7	9121267	9122305	BolC7t41022H	0	-	1173	1038	1038	1.0000000
C7	9124332	9126018	BolC7t41023H	0	+	927	1360	1686	0.8066429
C7	9138310	9139098	BolC7t41024H	0	+	0	0	788	0.0000000
C7	9147180	9147369	BolC7t41025H	0	-	210	189	189	1.0000000
C7	9147722	9147981	BolC7t41026H	0	-	168	259	259	1.0000000
C7	9152916	9153999	BolC7t41027H	0	+	39	357	1083	0.3296399
C7	9178844	9180106	BolC7t41028H	0	-	206	1257	1262	0.9960380
C7	9188040	9188226	BolC7t41029H	0	+	1	132	186	0.7096774
C7	9188535	9188646	BolC7t41030H	0	+	1	13	111	0.1171171
C7	9195170	9196540	BolC7t41031H	0	+	10	49	1370	0.0357664
C7	9199201	9200911	BolC7t41032H	0	+	8	86	1710	0.0502924
C7	9201167	9201442	BolC7t41033H	0	-	274	275	275	1.0000000
C7	9234689	9236530	BolC7t41034H	0	+	129	1553	1841	0.8435633
C7	9249513	9251727	BolC7t41035H	0	+	529	1211	2214	0.5469738
C7	9262370	9263042	BolC7t41036H	0	+	142	672	672	1.0000000
C7	9263616	9264165	BolC7t41037H	0	-	125	549	549	1.0000000
C7	9266067	9266760	BolC7t41038H	0	+	227	693	693	1.0000000
C7	9275683	9276379	BolC7t41039H	0	-	96	606	696	0.8706896
C7	9277598	9277832	BolC7t41040H	0	-	58	225	234	0.9615384
C7	9278689	9278848	BolC7t41041H	0	-	53	159	159	1.0000000
C7	9282205	9282487	BolC7t41042H	0	-	79	282	282	1.0000000
C7	9282891	9283782	BolC7t41043H	0	-	165	891	891	1.0000000
C7	9296831	9299704	BolC7t41044H	0	+	948	2664	2873	0.9272537
C7	9301177	9301939	BolC7t41045H	0	+	88	626	762	0.8215223
C7	9309572	9311450	BolC7t41046H	0	-	212	1306	1878	0.6954207
C7	9323464	9323752	BolC7t41047H	0	+	119	288	288	1.0000000
C7	9325152	9325287	BolC7t41048H	0	+	132	135	135	1.0000000
C7	9338141	9339464	BolC7t41049H	0	-	31	570	1323	0.4308390
C7	9343394	9346546	BolC7t41050H	0	+	713	2154	3152	0.6833757
C7	9356526	9359370	BolC7t41051H	0	-	539	1878	2844	0.6603376
C7	9361773	9363339	BolC7t41052H	0	+	899	1566	1566	1.0000000
C7	9364552	9366118	BolC7t41053H	0	-	385	1517	1566	0.9687101
C7	9368022	9370105	BolC7t41054H	0	+	111	1215	2083	0.5832933
C7	9372006	9373550	BolC7t41055H	0	-	286	1240	1544	0.8031088
C7	9386247	9386592	BolC7t41056H	0	-	144	342	345	0.9913043
C7	9388417	9388663	BolC7t41057H	0	+	35	246	246	1.0000000
C7	9389381	9390005	BolC7t41058H	0	+	92	527	624	0.8445513
C7	9392172	9392334	BolC7t41059H	0	+	0	0	162	0.0000000
C7	9429005	9436495	BolC7t41060H	0	-	173	4334	7490	0.5786382
C7	9451493	9451974	BolC7t41061H	0	-	1	14	481	0.0291060
C7	9497884	9498268	BolC7t41062H	0	-	93	245	384	0.6380208
C7	9519416	9520208	BolC7t41063H	0	-	7	183	792	0.2310606
C7	9521899	9522103	BolC7t41064H	0	+	126	204	204	1.0000000
C7	9523436	9524216	BolC7t41065H	0	-	2	14	780	0.0179487
C7	9539699	9540941	BolC7t41066H	0	-	88	468	1242	0.3768116
C7	9619487	9619589	BolC7t41067H	0	-	6	102	102	1.0000000
C7	9631572	9631818	BolC7t41068H	0	-	201	246	246	1.0000000
C7	9695547	9698610	BolC7t41069H	0	+	202	2104	3063	0.6869082
C7	9698979	9700416	BolC7t41070H	0	+	28	693	1437	0.4822547
C7	9703534	9706111	BolC7t41071H	0	-	363	1795	2577	0.6965464
C7	9718308	9718876	BolC7t41072H	0	+	2	126	568	0.2218310
C7	9724498	9729560	BolC7t41073H	0	-	516	3478	5062	0.6870802
C7	9735000	9741089	BolC7t41074H	0	-	634	4707	6089	0.7730333
C7	9741844	9743142	BolC7t41075H	0	+	300	1062	1298	0.8181818
C7	9761042	9762558	BolC7t41076H	0	+	847	1516	1516	1.0000000
C7	9767136	9767373	BolC7t41077H	0	+	193	237	237	1.0000000
C7	9770220	9770442	BolC7t41078H	0	+	307	222	222	1.0000000
C7	9772219	9774695	BolC7t41079H	0	+	421	2389	2476	0.9648627
C7	9798418	9799033	BolC7t41080H	0	-	753	615	615	1.0000000
C7	9799759	9800520	BolC7t41081H	0	+	1198	761	761	1.0000000
C7	9822443	9822641	BolC7t41082H	0	-	69	198	198	1.0000000
C7	9837166	9837322	BolC7t41083H	0	+	172	156	156	1.0000000
C7	9839848	9840260	BolC7t41084H	0	+	1	106	412	0.2572815
C7	9853297	9853504	BolC7t41085H	0	+	0	0	207	0.0000000
C7	9859033	9859267	BolC7t41086H	0	+	167	234	234	1.0000000
C7	9859834	9860606	BolC7t41087H	0	+	13	440	772	0.5699482
C7	9875361	9876116	BolC7t41088H	0	-	10	136	755	0.1801324
C7	9884170	9885178	BolC7t41089H	0	-	32	589	1008	0.5843254
C7	9887692	9897826	BolC7t41090H	0	+	3140	8195	10134	0.8086639
C7	9898277	9900585	BolC7t41091H	0	-	815	2088	2308	0.9046794
C7	9915880	9916087	BolC7t41092H	0	+	133	207	207	1.0000000
C7	9935517	9936589	BolC7t41093H	0	+	278	1046	1072	0.9757463
C7	9937424	9939429	BolC7t41094H	0	+	1002	1637	2005	0.8164589
C7	9948009	9948686	BolC7t41095H	0	-	1283	677	677	1.0000000
C7	9966178	9968197	BolC7t41096H	0	+	421	2019	2019	1.0000000
C7	9974598	9976261	BolC7t41097H	0	+	339	1489	1663	0.8953698
C7	9977177	9979394	BolC7t41098H	0	+	1146	1810	2217	0.8164186
C7	9997907	9999466	BolC7t41099H	0	+	843	1538	1559	0.9865298
C7	10020694	10022327	BolC7t41100H	0	+	930	1633	1633	1.0000000
C7	10032221	10034243	BolC7t41101H	0	+	102	1118	2022	0.5529179
C7	10049192	10049617	BolC7t41102H	0	-	352	425	425	1.0000000
C7	10067116	10069277	BolC7t41103H	0	+	327	1003	2161	0.4641370
C7	10070186	10072983	BolC7t41104H	0	-	145	1394	2797	0.4983911
C7	10087452	10088314	BolC7t41105H	0	-	62	476	862	0.5522042
C7	10089082	10090341	BolC7t41106H	0	-	147	713	1259	0.5663225
C7	10091913	10092467	BolC7t41107H	0	+	225	554	554	1.0000000
C7	10130607	10131875	BolC7t41108H	0	+	355	911	1268	0.7184542
C7	10131956	10133992	BolC7t41109H	0	+	342	1356	2036	0.6660118
C7	10144971	10145673	BolC7t41110H	0	+	286	702	702	1.0000000
C7	10145931	10146444	BolC7t41111H	0	-	282	513	513	1.0000000
C7	10147617	10149858	BolC7t41112H	0	-	1322	2223	2241	0.9919679
C7	10148550	10149132	BolC7t41113H	0	+	436	582	582	1.0000000
C7	10149925	10150381	BolC7t41114H	0	-	223	456	456	1.0000000
C7	10153465	10154864	BolC7t41115H	0	-	82	1006	1399	0.7190850
C7	10155598	10158700	BolC7t41116H	0	+	35	464	3102	0.1495809
C7	10168214	10188876	BolC7t41117H	0	-	4977	18169	20662	0.8793437
C7	10191613	10201373	BolC7t41118H	0	+	318	4274	9760	0.4379098
C7	10203208	10206691	BolC7t41119H	0	-	933	3218	3483	0.9239162
C7	10210753	10212245	BolC7t41120H	0	-	106	600	1492	0.4021448
C7	10312133	10313635	BolC7t41121H	0	+	84	689	1502	0.4587217
C7	10353969	10354116	BolC7t41122H	0	-	225	147	147	1.0000000
C7	10354206	10354629	BolC7t41123H	0	-	409	423	423	1.0000000
C7	10377706	10377862	BolC7t41124H	0	+	124	156	156	1.0000000
C7	10383357	10383806	BolC7t41125H	0	-	50	306	449	0.6815145
C7	10386481	10387029	BolC7t41126H	0	-	26	413	548	0.7536497
C7	10392185	10394538	BolC7t41127H	0	+	142	1457	2353	0.6192095
C7	10401448	10402625	BolC7t41128H	0	-	11	312	1177	0.2650807
C7	10409273	10411145	BolC7t41129H	0	-	106	1468	1872	0.7841880
C7	10411763	10413934	BolC7t41130H	0	-	1584	1904	2171	0.8770152
C7	10432784	10433111	BolC7t41131H	0	+	123	327	327	1.0000000
C7	10434999	10435680	BolC7t41132H	0	-	460	681	681	1.0000000
C7	10439299	10440015	BolC7t41133H	0	+	8	209	716	0.2918994
C7	10452805	10454629	BolC7t41134H	0	+	342	1196	1824	0.6557018
C7	10456375	10459495	BolC7t41135H	0	-	2145	3120	3120	1.0000000
C7	10508386	10509483	BolC7t41136H	0	+	931	1097	1097	1.0000000
C7	10515182	10515760	BolC7t41137H	0	-	409	578	578	1.0000000
C7	10537915	10539533	BolC7t41138H	0	+	524	1573	1618	0.9721879
C7	10551194	10557097	BolC7t41139H	0	+	2139	5619	5903	0.9518889
C7	10558255	10560079	BolC7t41140H	0	+	5	387	1824	0.2121710
C7	10563491	10563802	BolC7t41141H	0	+	133	189	311	0.6077170
C7	10571258	10574174	BolC7t41142H	0	+	762	2396	2916	0.8216735
C7	10590359	10590647	BolC7t41143H	0	+	95	193	288	0.6701389
C7	10597669	10599236	BolC7t41144H	0	+	198	1217	1567	0.7766433
C7	10606341	10606494	BolC7t41145H	0	-	42	153	153	1.0000000
C7	10633806	10634033	BolC7t41146H	0	-	241	227	227	1.0000000
C7	10634107	10634986	BolC7t41147H	0	+	284	855	879	0.9726962
C7	10637799	10639301	BolC7t41148H	0	-	233	1128	1502	0.7509987
C7	10642009	10643768	BolC7t41149H	0	-	843	1645	1759	0.9351904
C7	10657209	10657477	BolC7t41150H	0	+	34	268	268	1.0000000
C7	10668585	10668843	BolC7t41151H	0	-	178	258	258	1.0000000
C7	10671631	10672242	BolC7t41152H	0	-	1612	610	611	0.9983633
C7	10672525	10672822	BolC7t41153H	0	-	3429	297	297	1.0000000
C7	10673817	10674090	BolC7t41154H	0	-	359	273	273	1.0000000
C7	10678802	10679459	BolC7t41155H	0	-	4978	657	657	1.0000000
C7	10681935	10683459	BolC7t41156H	0	-	168	752	1524	0.4934383
C7	10696101	10698829	BolC7t41157H	0	+	766	2631	2728	0.9644428
C7	10701763	10702482	BolC7t41158H	0	-	103	647	719	0.8998609
C7	10727208	10730821	BolC7t41159H	0	+	596	2972	3613	0.8225851
C7	10747442	10748671	BolC7t41160H	0	-	679	1229	1229	1.0000000
C7	10754303	10757553	BolC7t41161H	0	+	2179	3250	3250	1.0000000
C7	10767946	10772725	BolC7t41162H	0	-	695	2611	4779	0.5463486
C7	10795760	10796211	BolC7t41163H	0	-	33	422	451	0.9356984
C7	10797672	10801004	BolC7t41164H	0	+	555	3183	3332	0.9552821
C7	10801356	10801872	BolC7t41165H	0	+	166	516	516	1.0000000
C7	10805032	10805590	BolC7t41166H	0	-	63	544	558	0.9749104
C7	10805804	10806489	BolC7t41167H	0	-	84	650	685	0.9489051
C7	10806567	10806762	BolC7t41168H	0	-	12	144	195	0.7384616
C7	10811293	10812991	BolC7t41169H	0	-	1991	1698	1698	1.0000000
C7	10834769	10835965	BolC7t41170H	0	-	274	787	1196	0.6580268
C7	10836080	10837848	BolC7t41171H	0	+	1066	1768	1768	1.0000000
C7	10839418	10840193	BolC7t41172H	0	+	927	775	775	1.0000000
C7	10844004	10844136	BolC7t41173H	0	-	262	132	132	1.0000000
C7	10850979	10851192	BolC7t41174H	0	+	470	213	213	1.0000000
C7	10854504	10855260	BolC7t41175H	0	-	15	155	756	0.2050264
C7	10857197	10857647	BolC7t41176H	0	-	499	450	450	1.0000000
C7	10858523	10860323	BolC7t41177H	0	-	773	1668	1800	0.9266667
C7	10865535	10866454	BolC7t41178H	0	+	718	919	919	1.0000000
C7	10867977	10868205	BolC7t41179H	0	-	80	228	228	1.0000000
C7	10891643	10893193	BolC7t41180H	0	+	917	1550	1550	1.0000000
C7	10996885	10997392	BolC7t41181H	0	-	442	507	507	1.0000000
C7	11008746	11008953	BolC7t41182H	0	-	1	41	207	0.1980676
C7	11012805	11013800	BolC7t41183H	0	-	527	995	995	1.0000000
C7	11025107	11027474	BolC7t41184H	0	+	1082	2219	2367	0.9374736
C7	11028349	11029877	BolC7t41185H	0	+	780	1488	1528	0.9738220
C7	11038529	11038881	BolC7t41186H	0	+	16	254	352	0.7215909
C7	11045352	11045677	BolC7t41187H	0	-	1	33	325	0.1015385
C7	11049308	11050071	BolC7t41188H	0	-	0	0	763	0.0000000
C7	11051682	11052445	BolC7t41189H	0	+	0	0	763	0.0000000
C7	11055377	11055729	BolC7t41190H	0	+	8	97	352	0.2755682
C7	11060590	11060833	BolC7t41191H	0	-	0	0	243	0.0000000
C7	11078953	11079889	BolC7t41192H	0	-	109	363	936	0.3878205
C7	11084353	11085766	BolC7t41193H	0	-	110	845	1413	0.5980184
C7	11097884	11098145	BolC7t41194H	0	+	561	261	261	1.0000000
C7	11116191	11137010	BolC7t41195H	0	+	1714	9683	20819	0.4651040
C7	11137391	11137714	BolC7t41196H	0	+	7	214	323	0.6625387
C7	11153470	11154955	BolC7t41197H	0	+	158	563	1485	0.3791246
C7	11155188	11156027	BolC7t41198H	0	-	165	762	839	0.9082241
C7	11166989	11168796	BolC7t41199H	0	+	0	0	1807	0.0000000
C7	11187764	11187995	BolC7t41200H	0	-	9	86	231	0.3722944
C7	11189321	11202579	BolC7t41201H	0	-	477	3941	13258	0.2972545
C7	11212355	11212770	BolC7t41202H	0	+	138	415	415	1.0000000
C7	11215642	11234497	BolC7t41203H	0	+	8457	14313	18855	0.7591090
C7	11234900	11239873	BolC7t41204H	0	-	1035	2923	4973	0.5877740
C7	11253110	11263503	BolC7t41205H	0	+	45922	10373	10393	0.9980756
C7	11263818	11264071	BolC7t41206H	0	+	133	253	253	1.0000000
C7	11284379	11287635	BolC7t41207H	0	+	1007	2418	3256	0.7426290
C7	11293922	11294132	BolC7t41208H	0	+	486	210	210	1.0000000
C7	11326109	11326316	BolC7t41209H	0	-	270	207	207	1.0000000
C7	11327985	11328180	BolC7t41210H	0	-	21	132	195	0.6769231
C7	11338277	11338878	BolC7t41211H	0	-	438	601	601	1.0000000
C7	11343801	11346280	BolC7t41212H	0	+	668	2237	2479	0.9023800
C7	11356553	11361324	BolC7t41213H	0	-	432	2649	4771	0.5552295
C7	11362209	11364680	BolC7t41214H	0	-	429	2390	2471	0.9672198
C7	11366500	11368197	BolC7t41215H	0	+	576	1247	1697	0.7348261
C7	11375254	11375745	BolC7t41216H	0	-	85	478	491	0.9735234
C7	11384568	11384754	BolC7t41217H	0	+	138	186	186	1.0000000
C7	11395593	11396701	BolC7t41218H	0	+	332	1075	1108	0.9702166
C7	11397725	11398670	BolC7t41219H	0	+	391	945	945	1.0000000
C7	11427200	11429443	BolC7t41220H	0	+	1172	2243	2243	1.0000000
C7	11435585	11436626	BolC7t41221H	0	+	283	1041	1041	1.0000000
C7	11438077	11439656	BolC7t41222H	0	+	1284	1579	1579	1.0000000
C7	11440136	11440463	BolC7t41223H	0	+	307	327	327	1.0000000
C7	11441123	11441649	BolC7t41224H	0	-	302	526	526	1.0000000
C7	11456970	11457615	BolC7t41225H	0	-	227	530	645	0.8217054
C7	11460986	11463073	BolC7t41226H	0	-	409	1774	2087	0.8500240
C7	11463924	11464227	BolC7t41227H	0	+	67	213	303	0.7029703
C7	11468236	11470281	BolC7t41228H	0	+	548	1783	2045	0.8718826
C7	11473055	11474911	BolC7t41229H	0	-	246	1585	1856	0.8539871
C7	11478988	11479450	BolC7t41230H	0	-	368	462	462	1.0000000
C7	11482619	11484043	BolC7t41231H	0	+	969	1424	1424	1.0000000
C7	11487236	11487867	BolC7t41232H	0	-	604	631	631	1.0000000
C7	11488631	11491634	BolC7t41233H	0	+	3290	3003	3003	1.0000000
C7	11492711	11494607	BolC7t41234H	0	-	181	1397	1896	0.7368143
C7	11526809	11528806	BolC7t41235H	0	-	149	1577	1997	0.7896845
C7	11546454	11548155	BolC7t41236H	0	+	1271	1701	1701	1.0000000
C7	11559443	11559705	BolC7t41237H	0	+	0	0	262	0.0000000
C7	11560468	11561143	BolC7t41238H	0	-	20	558	675	0.8266667
C7	11570105	11570463	BolC7t41239H	0	-	92	309	358	0.8631285
C7	11575803	11576065	BolC7t41240H	0	+	3	133	262	0.5076336
C7	11577006	11580158	BolC7t41241H	0	-	272	1322	3152	0.4194162
C7	11622436	11623418	BolC7t41242H	0	-	25	228	982	0.2321792
C7	11630019	11630307	BolC7t41243H	0	+	427	288	288	1.0000000
C7	11674685	11674832	BolC7t41244H	0	+	131	147	147	1.0000000
C7	11684875	11687270	BolC7t41245H	0	+	1097	2395	2395	1.0000000
C7	11695169	11696576	BolC7t41246H	0	+	431	1389	1407	0.9872068
C7	11697348	11700270	BolC7t41247H	0	-	962	1746	2922	0.5975359
C7	11713826	11717363	BolC7t41248H	0	-	1157	2989	3537	0.8450664
C7	11721353	11721542	BolC7t41249H	0	-	21	154	189	0.8148148
C7	11733524	11733986	BolC7t41250H	0	-	3436	462	462	1.0000000
C7	11740500	11741606	BolC7t41251H	0	+	692	1106	1106	1.0000000
C7	11743732	11745345	BolC7t41252H	0	-	24	669	1613	0.4147551
C7	11747471	11747812	BolC7t41253H	0	+	151	341	341	1.0000000
C7	11749151	11754272	BolC7t41254H	0	-	1576	4537	5121	0.8859597
C7	11757610	11758714	BolC7t41255H	0	+	17	20	1104	0.0181159
C7	11759198	11759461	BolC7t41256H	0	-	51	263	263	1.0000000
C7	11767380	11768034	BolC7t41257H	0	+	0	0	654	0.0000000
C7	11780055	11781757	BolC7t41258H	0	+	35	678	1702	0.3983549
C7	11874320	11875492	BolC7t41259H	0	-	102	682	1172	0.5819113
C7	11889805	11890162	BolC7t41260H	0	-	11	241	357	0.6750700
C7	11891648	11892766	BolC7t41261H	0	+	119	1000	1118	0.8944544
C7	11901790	11902102	BolC7t41262H	0	-	283	312	312	1.0000000
C7	11906501	11906687	BolC7t41263H	0	-	232	186	186	1.0000000
C7	11969572	11970522	BolC7t41264H	0	-	285	862	950	0.9073684
C7	11974379	11975906	BolC7t41265H	0	-	502	1244	1527	0.8146693
C7	12125395	12125735	BolC7t41266H	0	-	82	302	340	0.8882353
C7	12126583	12129936	BolC7t41267H	0	+	1883	3353	3353	1.0000000
C7	12130736	12130907	BolC7t41268H	0	-	34	155	171	0.9064327
C7	12148097	12148457	BolC7t41269H	0	-	76	360	360	1.0000000
C7	12154331	12154685	BolC7t41270H	0	-	65	354	354	1.0000000
C7	12177020	12177173	BolC7t41271H	0	-	36	153	153	1.0000000
C7	12182775	12183234	BolC7t41272H	0	+	400	459	459	1.0000000
C7	12204784	12206078	BolC7t41273H	0	+	2	77	1294	0.0595054
C7	12232791	12235324	BolC7t41274H	0	+	127	1200	2533	0.4737465
C7	12247740	12248262	BolC7t41275H	0	+	114	522	522	1.0000000
C7	12250936	12252484	BolC7t41276H	0	+	93	651	1548	0.4205426
C7	12259087	12261093	BolC7t41277H	0	-	502	1688	2006	0.8414755
C7	12262042	12262828	BolC7t41278H	0	+	464	786	786	1.0000000
C7	12282983	12283403	BolC7t41279H	0	-	345	420	420	1.0000000
C7	12308784	12309267	BolC7t41280H	0	-	285	483	483	1.0000000
C7	12325821	12327255	BolC7t41281H	0	-	0	0	1434	0.0000000
C7	12364224	12365474	BolC7t41282H	0	+	18	403	1250	0.3224000
C7	12366660	12369124	BolC7t41283H	0	-	503	1169	2464	0.4744318
C7	12388954	12389769	BolC7t41284H	0	+	270	815	815	1.0000000
C7	12389991	12390264	BolC7t41285H	0	+	47	209	273	0.7655678
C7	12398722	12400543	BolC7t41286H	0	-	433	1787	1821	0.9813290
C7	12416977	12419934	BolC7t41287H	0	-	313	2055	2957	0.6949611
C7	12463982	12464330	BolC7t41288H	0	-	78	348	348	1.0000000
C7	12466641	12466779	BolC7t41289H	0	+	44	138	138	1.0000000
C7	12468842	12470387	BolC7t41290H	0	-	589	1545	1545	1.0000000
C7	12476565	12477042	BolC7t41291H	0	-	109	477	477	1.0000000
C7	12477603	12478317	BolC7t41292H	0	-	126	714	714	1.0000000
C7	12478768	12479063	BolC7t41293H	0	-	454	295	295	1.0000000
C7	12484537	12486976	BolC7t41294H	0	+	167	1814	2439	0.7437474
C7	12499694	12500806	BolC7t41295H	0	+	781	1112	1112	1.0000000
C7	12508378	12511214	BolC7t41296H	0	-	917	2098	2836	0.7397743
C7	12542947	12543562	BolC7t41297H	0	-	13	93	615	0.1512195
C7	12548724	12548940	BolC7t41298H	0	-	180	216	216	1.0000000
C7	12565881	12568216	BolC7t41299H	0	-	797	2231	2335	0.9554604
C7	12579682	12580114	BolC7t41300H	0	+	221	432	432	1.0000000
C7	12614946	12615538	BolC7t41301H	0	+	480	592	592	1.0000000
C7	12616120	12616639	BolC7t41302H	0	-	232	519	519	1.0000000
C7	12617556	12617724	BolC7t41303H	0	-	19	153	168	0.9107143
C7	12634590	12636683	BolC7t41304H	0	-	669	2093	2093	1.0000000
C7	12690481	12692923	BolC7t41305H	0	+	127	1287	2442	0.5270270
C7	12695634	12695808	BolC7t41306H	0	-	210	174	174	1.0000000
C7	12706999	12715399	BolC7t41307H	0	+	3787	6106	8400	0.7269047
C7	12707731	12708415	BolC7t41308H	0	+	263	665	684	0.9722222
C7	12715476	12715683	BolC7t41309H	0	+	152	207	207	1.0000000
C7	12720660	12721110	BolC7t41310H	0	+	24	443	450	0.9844444
C7	12723216	12723525	BolC7t41311H	0	-	50	239	309	0.7734628
C7	12728368	12743094	BolC7t41312H	0	-	6103	12256	14726	0.8322694
C7	12732822	12733716	BolC7t41313H	0	+	75	848	894	0.9485459
C7	12761973	12762126	BolC7t41314H	0	-	4	86	153	0.5620915
C7	12763223	12763823	BolC7t41315H	0	+	85	442	600	0.7366667
C7	12840777	12843565	BolC7t41316H	0	+	867	2788	2788	1.0000000
C7	12845228	12847627	BolC7t41317H	0	+	393	2399	2399	1.0000000
C7	12848753	12848990	BolC7t41318H	0	+	124	237	237	1.0000000
C7	12849459	12849998	BolC7t41319H	0	+	194	539	539	1.0000000
C7	12863022	12867852	BolC7t41320H	0	+	2862	4755	4830	0.9844720
C7	12870632	12872484	BolC7t41321H	0	+	590	1155	1852	0.6236501
C7	12872718	12877814	BolC7t41322H	0	-	422	2996	5096	0.5879121
C7	12923882	12924344	BolC7t41323H	0	-	29	125	462	0.2705628
C7	12936127	12936379	BolC7t41324H	0	+	183	252	252	1.0000000
C7	12970255	12971626	BolC7t41325H	0	-	148	912	1371	0.6652079
C7	12995884	13007750	BolC7t41326H	0	-	4821	10755	11866	0.9063711
C7	13012555	13016063	BolC7t41327H	0	-	1476	3231	3508	0.9210376
C7	13036056	13038245	BolC7t41328H	0	+	1907	2189	2189	1.0000000
C7	13038531	13038777	BolC7t41329H	0	-	147	246	246	1.0000000
C7	13039898	13042485	BolC7t41330H	0	-	88	890	2587	0.3440278
C7	13052273	13053529	BolC7t41331H	0	-	709	1256	1256	1.0000000
C7	13055222	13055707	BolC7t41332H	0	+	286	485	485	1.0000000
C7	13057814	13058765	BolC7t41333H	0	-	725	951	951	1.0000000
C7	13062190	13062541	BolC7t41334H	0	+	220	351	351	1.0000000
C7	13321652	13321940	BolC7t41335H	0	+	107	288	288	1.0000000
C7	13322264	13323062	BolC7t41336H	0	+	122	777	798	0.9736842
C7	13323863	13324448	BolC7t41337H	0	-	12	152	585	0.2598291
C7	13325507	13325828	BolC7t41338H	0	+	286	321	321	1.0000000
C7	14333351	14333972	BolC7t41339H	0	-	352	621	621	1.0000000
C7	14339791	14340016	BolC7t41340H	0	+	8	187	225	0.8311111
C7	14352624	14353138	BolC7t41341H	0	-	371	514	514	1.0000000
C7	14353095	14353485	BolC7t41342H	0	-	243	390	390	1.0000000
C7	14375329	14377536	BolC7t41343H	0	+	162	1124	2207	0.5092886
C7	14404724	14405081	BolC7t41344H	0	+	2	67	357	0.1876751
C7	14405144	14407392	BolC7t41345H	0	-	103	1178	2248	0.5240213
C7	14411831	14412434	BolC7t41346H	0	+	290	440	603	0.7296849
C7	14484128	14485084	BolC7t41347H	0	-	64	546	956	0.5711297
C7	14492551	14495793	BolC7t41348H	0	+	1850	3242	3242	1.0000000
C7	14523194	14523536	BolC7t41349H	0	-	376	342	342	1.0000000
C7	14552071	14554878	BolC7t41350H	0	+	290	1834	2807	0.6533666
C7	14555371	14556939	BolC7t41351H	0	-	64	909	1568	0.5797194
C7	14561397	14562204	BolC7t41352H	0	+	521	807	807	1.0000000
C7	14564745	14566072	BolC7t41353H	0	+	616	1327	1327	1.0000000
C7	14616907	14618292	BolC7t41354H	0	-	1185	1385	1385	1.0000000
C7	14618606	14618973	BolC7t41355H	0	+	73	367	367	1.0000000
C7	14633728	14640360	BolC7t41356H	0	-	1705	6148	6632	0.9270205
C7	14634825	14635201	BolC7t41357H	0	-	38	355	376	0.9441490
C7	14638817	14639454	BolC7t41358H	0	-	237	633	637	0.9937206
C7	14646913	14647658	BolC7t41359H	0	-	233	745	745	1.0000000
C7	14673363	14677450	BolC7t41360H	0	-	665	3539	4087	0.8659163
C7	14677748	14679356	BolC7t41361H	0	+	68	777	1608	0.4832090
C7	14695475	14696753	BolC7t41362H	0	-	562	1165	1278	0.9115806
C7	14717494	14718155	BolC7t41363H	0	-	254	661	661	1.0000000
C7	14717713	14717923	BolC7t41364H	0	+	131	210	210	1.0000000
C7	14739049	14739232	BolC7t41365H	0	-	157	183	183	1.0000000
C7	14752841	14755271	BolC7t41366H	0	-	217	2144	2430	0.8823045
C7	14756847	14758890	BolC7t41367H	0	-	445	1171	2043	0.5731767
C7	14774648	14775340	BolC7t41368H	0	-	235	692	692	1.0000000
C7	14775696	14776189	BolC7t41369H	0	+	130	493	493	1.0000000
C7	14791955	14792171	BolC7t41370H	0	-	0	0	216	0.0000000
C7	14792784	14794469	BolC7t41371H	0	+	16	478	1685	0.2836795
C7	14796581	14797225	BolC7t41372H	0	+	234	644	644	1.0000000
C7	14813677	14813920	BolC7t41373H	0	+	0	0	243	0.0000000
C7	14815451	14815884	BolC7t41374H	0	-	60	417	433	0.9630485
C7	14820422	14820527	BolC7t41375H	0	-	12	105	105	1.0000000
C7	14867453	14867924	BolC7t41376H	0	+	180	457	471	0.9702760
C7	14872819	14874886	BolC7t41377H	0	-	1969	2067	2067	1.0000000
C7	14877049	14877892	BolC7t41378H	0	-	937	843	843	1.0000000
C7	14885366	14887791	BolC7t41379H	0	+	126	1649	2425	0.6800000
C7	14891007	14892721	BolC7t41380H	0	-	1832	1714	1714	1.0000000
C7	14895406	14896702	BolC7t41381H	0	+	115	871	1296	0.6720679
C7	14897115	14898748	BolC7t41382H	0	-	394	1537	1633	0.9412125
C7	14917122	14917380	BolC7t41383H	0	+	0	0	258	0.0000000
C7	14919792	14920179	BolC7t41384H	0	-	21	219	387	0.5658914
C7	14921176	14923218	BolC7t41385H	0	-	227	1286	2042	0.6297747
C7	14939564	14940273	BolC7t41386H	0	+	594	709	709	1.0000000
C7	14940680	14941352	BolC7t41387H	0	+	564	672	672	1.0000000
C7	14963060	14963415	BolC7t41388H	0	-	344	355	355	1.0000000
C7	14963222	14965780	BolC7t41389H	0	-	1289	2146	2558	0.8389367
C7	14978511	14980390	BolC7t41390H	0	-	0	0	1879	0.0000000
C7	15000447	15002463	BolC7t41391H	0	-	95	877	2016	0.4350199
C7	15026753	15027466	BolC7t41392H	0	+	504	713	713	1.0000000
C7	15030056	15039491	BolC7t41393H	0	-	3086	9049	9435	0.9590885
C7	15052009	15052207	BolC7t41394H	0	+	38	198	198	1.0000000
C7	15055631	15056412	BolC7t41395H	0	+	428	781	781	1.0000000
C7	15068177	15069046	BolC7t41396H	0	-	218	480	869	0.5523590
C7	15086505	15087105	BolC7t41397H	0	-	155	600	600	1.0000000
C7	15089175	15089475	BolC7t41398H	0	-	5	176	300	0.5866666
C7	15089715	15089988	BolC7t41399H	0	+	23	273	273	1.0000000
C7	15095381	15095696	BolC7t41400H	0	+	56	315	315	1.0000000
C7	15118397	15121411	BolC7t41401H	0	-	1911	3014	3014	1.0000000
C7	15136825	15136990	BolC7t41402H	0	-	84	160	165	0.9696970
C7	15145899	15150524	BolC7t41403H	0	-	2031	4197	4625	0.9074594
C7	15199796	15200285	BolC7t41404H	0	+	311	489	489	1.0000000
C7	15200574	15202503	BolC7t41405H	0	-	721	1587	1929	0.8227060
C7	15205822	15206104	BolC7t41406H	0	-	240	282	282	1.0000000
C7	15284688	15284943	BolC7t41407H	0	-	512	255	255	1.0000000
C7	15313038	15314013	BolC7t41408H	0	-	681	975	975	1.0000000
C7	15519754	15520519	BolC7t41409H	0	+	13	531	765	0.6941177
C7	15522024	15523181	BolC7t41410H	0	+	351	1157	1157	1.0000000
C7	15524455	15524806	BolC7t41411H	0	-	48	351	351	1.0000000
C7	15525911	15526251	BolC7t41412H	0	-	80	340	340	1.0000000
C7	15542853	15544401	BolC7t41413H	0	-	230	1527	1548	0.9864341
C7	15546229	15547303	BolC7t41414H	0	-	11	338	1074	0.3147114
C7	15569770	15570671	BolC7t41415H	0	+	88	649	901	0.7203107
C7	15571262	15571875	BolC7t41416H	0	+	164	613	613	1.0000000
C7	15614206	15616147	BolC7t41417H	0	+	55	930	1941	0.4791345
C7	15740022	15740593	BolC7t41418H	0	+	40	129	571	0.2259194
C7	15763506	15763707	BolC7t41419H	0	+	204	201	201	1.0000000
C7	15780369	15780747	BolC7t41420H	0	-	233	378	378	1.0000000
C7	15783394	15785354	BolC7t41421H	0	+	60	759	1960	0.3872449
C7	15787748	15789206	BolC7t41422H	0	+	293	1196	1458	0.8203018
C7	15792586	15795783	BolC7t41423H	0	+	187	966	3197	0.3021583
C7	15807776	15807926	BolC7t41424H	0	-	93	150	150	1.0000000
C7	15819389	15830760	BolC7t41425H	0	+	216	1790	11371	0.1574180
C7	15833415	15835446	BolC7t41426H	0	+	146	1355	2031	0.6671590
C7	15852291	15852759	BolC7t41427H	0	+	836	468	468	1.0000000
C7	15855864	15856243	BolC7t41428H	0	+	336	379	379	1.0000000
C7	15870779	15871487	BolC7t41429H	0	+	262	378	708	0.5338983
C7	15880145	15882604	BolC7t41430H	0	-	1582	2459	2459	1.0000000
C7	15895209	15895419	BolC7t41431H	0	-	6	210	210	1.0000000
C7	15998338	16007040	BolC7t41432H	0	+	824	4627	8702	0.5317168
C7	15998981	16002875	BolC7t41433H	0	-	649	2579	3894	0.6623010
C7	16009754	16010015	BolC7t41434H	0	+	4	67	261	0.2567050
C7	16013632	16015999	BolC7t41435H	0	+	252	1245	2367	0.5259823
C7	16054432	16055224	BolC7t41436H	0	+	337	792	792	1.0000000
C7	16057944	16063037	BolC7t41437H	0	+	200	1170	5093	0.2297271
C7	16065802	16066129	BolC7t41438H	0	+	108	327	327	1.0000000
C7	16066215	16067720	BolC7t41439H	0	+	1085	1505	1505	1.0000000
C7	16079402	16080454	BolC7t41440H	0	+	3168	1052	1052	1.0000000
C7	16081460	16082775	BolC7t41441H	0	+	949	1315	1315	1.0000000
C7	16103846	16104219	BolC7t41442H	0	+	28	299	373	0.8016086
C7	16119146	16120946	BolC7t41443H	0	-	67	687	1800	0.3816667
C7	16122824	16123575	BolC7t41444H	0	-	9	202	751	0.2689747
C7	16138593	16140642	BolC7t41445H	0	-	123	1018	2049	0.4968277
C7	16147491	16149550	BolC7t41446H	0	-	835	1860	2059	0.9033511
C7	16150744	16151368	BolC7t41447H	0	-	168	624	624	1.0000000
C7	16157398	16159207	BolC7t41448H	0	-	240	1691	1809	0.9347706
C7	16197462	16197893	BolC7t41449H	0	-	64	386	431	0.8955917
C7	16230008	16230426	BolC7t41450H	0	+	222	418	418	1.0000000
C7	16230707	16231851	BolC7t41451H	0	-	71	695	1144	0.6075175
C7	16232413	16233631	BolC7t41452H	0	+	215	910	1218	0.7471265
C7	16288467	16288861	BolC7t41453H	0	+	18	177	394	0.4492386
C7	16290993	16302959	BolC7t41454H	0	+	2466	9907	11966	0.8279291
C7	16343200	16344022	BolC7t41455H	0	+	379	822	822	1.0000000
C7	16353062	16353715	BolC7t41456H	0	+	70	653	653	1.0000000
C7	16353946	16354291	BolC7t41457H	0	+	76	345	345	1.0000000
C7	16355514	16357081	BolC7t41458H	0	-	118	1460	1567	0.9317167
C7	16362170	16364224	BolC7t41459H	0	+	517	1919	2054	0.9342746
C7	16364491	16366086	BolC7t41460H	0	-	215	1317	1595	0.8257053
C7	16387361	16389209	BolC7t41461H	0	-	376	1782	1848	0.9642857
C7	16394068	16394926	BolC7t41462H	0	+	247	685	858	0.7983683
C7	16397434	16397857	BolC7t41463H	0	+	5	106	423	0.2505910
C7	16402302	16403196	BolC7t41464H	0	+	1196	894	894	1.0000000
C7	16414380	16414818	BolC7t41465H	0	+	38	182	438	0.4155251
C7	16428178	16429248	BolC7t41466H	0	-	669	1070	1070	1.0000000
C7	16431594	16431959	BolC7t41467H	0	-	139	365	365	1.0000000
C7	16433549	16433918	BolC7t41468H	0	+	358	369	369	1.0000000
C7	16434186	16434450	BolC7t41469H	0	+	257	264	264	1.0000000
C7	16437224	16437476	BolC7t41470H	0	-	159	252	252	1.0000000
C7	16454458	16457379	BolC7t41471H	0	+	652	2566	2921	0.8784663
C7	16457930	16458032	BolC7t41472H	0	+	71	102	102	1.0000000
C7	16465890	16472255	BolC7t41473H	0	+	955	3880	6365	0.6095837
C7	16502094	16503509	BolC7t41474H	0	+	885	1261	1415	0.8911661
C7	16512815	16513749	BolC7t41475H	0	-	543	934	934	1.0000000
C7	16515495	16516290	BolC7t41476H	0	-	25	159	795	0.2000000
C7	16517935	16520097	BolC7t41477H	0	-	452	1379	2162	0.6378353
C7	16522693	16522843	BolC7t41478H	0	+	0	0	150	0.0000000
C7	16524967	16526297	BolC7t41479H	0	+	147	1099	1330	0.8263158
C7	16527239	16527994	BolC7t41480H	0	-	94	736	755	0.9748344
C7	16537665	16539309	BolC7t41481H	0	+	129	908	1644	0.5523114
C7	16550659	16552357	BolC7t41482H	0	+	392	1582	1698	0.9316843
C7	16552647	16557531	BolC7t41483H	0	-	754	2195	4884	0.4494267
C7	16567434	16567572	BolC7t41484H	0	+	228	138	138	1.0000000
C7	16571427	16572030	BolC7t41485H	0	+	1007	603	603	1.0000000
C7	16579589	16580072	BolC7t41486H	0	+	42	216	483	0.4472050
C7	16580765	16585763	BolC7t41487H	0	-	447	3200	4998	0.6402561
C7	16592522	16593437	BolC7t41488H	0	-	30	386	915	0.4218579
C7	16604727	16605862	BolC7t41489H	0	+	0	0	1135	0.0000000
C7	16606025	16607815	BolC7t41490H	0	-	0	0	1790	0.0000000
C7	16629258	16630153	BolC7t41491H	0	+	0	0	895	0.0000000
C7	16630316	16632104	BolC7t41492H	0	-	9	181	1788	0.1012304
C7	16652753	16653650	BolC7t41493H	0	+	0	0	897	0.0000000
C7	16653855	16654104	BolC7t41494H	0	-	0	0	249	0.0000000
C7	16654186	16654517	BolC7t41495H	0	-	0	0	331	0.0000000
C7	16695715	16697451	BolC7t41496H	0	-	90	635	1736	0.3657834
C7	16697661	16699246	BolC7t41497H	0	+	4	19	1585	0.0119874
C7	16781022	16781529	BolC7t41498H	0	-	11	321	507	0.6331361
C7	16794808	16795407	BolC7t41499H	0	+	264	428	599	0.7145242
C7	16803225	16803979	BolC7t41500H	0	+	249	381	754	0.5053051
C7	16977721	16978517	BolC7t41501H	0	+	477	100	796	0.1256281
C7	17015086	17015365	BolC7t41502H	0	-	0	0	279	0.0000000
C7	17015450	17015852	BolC7t41503H	0	-	0	0	402	0.0000000
C7	17032344	17034078	BolC7t41504H	0	+	0	0	1734	0.0000000
C7	17037085	17037211	BolC7t41505H	0	+	0	0	126	0.0000000
C7	17037381	17037753	BolC7t41506H	0	+	0	0	372	0.0000000
C7	17039809	17039995	BolC7t41507H	0	-	0	0	186	0.0000000
C7	17090030	17090990	BolC7t41508H	0	-	2	26	960	0.0270833
C7	17140822	17141131	BolC7t41509H	0	+	0	0	309	0.0000000
C7	17141230	17141604	BolC7t41510H	0	+	2	161	374	0.4304813
C7	17142664	17143846	BolC7t41511H	0	-	2	53	1182	0.0448393
C7	17158073	17158302	BolC7t41512H	0	+	0	0	229	0.0000000
C7	17189789	17191939	BolC7t41513H	0	+	415	1551	2150	0.7213954
C7	17202619	17206742	BolC7t41514H	0	+	383	3112	4123	0.7547902
C7	17232317	17234432	BolC7t41515H	0	+	58	858	2115	0.4056738
C7	17253984	17255849	BolC7t41516H	0	+	4	129	1865	0.0691689
C7	17255978	17256908	BolC7t41517H	0	-	16	454	930	0.4881721
C7	17262053	17262561	BolC7t41518H	0	-	167	508	508	1.0000000
C7	17269793	17271383	BolC7t41519H	0	+	512	1480	1590	0.9308176
C7	17281086	17282953	BolC7t41520H	0	-	322	1643	1867	0.8800215
C7	17293148	17294179	BolC7t41521H	0	-	528	1031	1031	1.0000000
C7	17307468	17308437	BolC7t41522H	0	-	96	869	969	0.8968008
C7	17333337	17334954	BolC7t41523H	0	-	562	1126	1617	0.6963513
C7	17335876	17338328	BolC7t41524H	0	-	668	2236	2452	0.9119086
C7	17348385	17351045	BolC7t41525H	0	+	2204	2660	2660	1.0000000
C7	17351309	17354274	BolC7t41526H	0	-	512	2114	2965	0.7129848
C7	17358265	17359897	BolC7t41527H	0	+	319	1593	1632	0.9761029
C7	17360619	17361530	BolC7t41528H	0	-	53	581	911	0.6377607
C7	17432406	17432882	BolC7t41529H	0	-	436	476	476	1.0000000
C7	17442079	17443089	BolC7t41530H	0	+	466	1010	1010	1.0000000
C7	17489455	17490782	BolC7t41531H	0	-	225	1054	1327	0.7942728
C7	17514104	17521621	BolC7t41532H	0	+	105	1661	7517	0.2209658
C7	17522815	17523718	BolC7t41533H	0	+	38	667	903	0.7386490
C7	17528464	17548120	BolC7t41534H	0	-	10362	16404	19656	0.8345543
C7	17536090	17536413	BolC7t41535H	0	+	339	323	323	1.0000000
C7	17536480	17536672	BolC7t41536H	0	+	272	192	192	1.0000000
C7	17548233	17550963	BolC7t41537H	0	-	834	1945	2730	0.7124542
C7	17565111	17566927	BolC7t41538H	0	-	287	1635	1816	0.9003304
C7	17567547	17570097	BolC7t41539H	0	-	881	2550	2550	1.0000000
C7	17570624	17571080	BolC7t41540H	0	+	0	0	456	0.0000000
C7	17572776	17573001	BolC7t41541H	0	+	26	152	225	0.6755555
C7	17580491	17584416	BolC7t41542H	0	-	2759	3925	3925	1.0000000
C7	17590122	17590503	BolC7t41543H	0	-	0	0	381	0.0000000
C7	17593915	17594083	BolC7t41544H	0	-	26	93	168	0.5535714
C7	17603150	17604628	BolC7t41545H	0	+	99	997	1478	0.6745602
C7	17605816	17605978	BolC7t41546H	0	-	213	162	162	1.0000000
C7	17607760	17609584	BolC7t41547H	0	-	1019	1739	1824	0.9533991
C7	17611888	17617957	BolC7t41548H	0	+	2018	5247	6069	0.8645576
C7	17656451	17660211	BolC7t41549H	0	-	1592	3687	3760	0.9805851
C7	17683841	17689650	BolC7t41550H	0	+	201	1381	5809	0.2377346
C7	17693460	17693640	BolC7t41551H	0	+	0	0	180	0.0000000
C7	17707248	17707516	BolC7t41552H	0	+	96	268	268	1.0000000
C7	17715158	17716462	BolC7t41553H	0	-	108	968	1304	0.7423313
C7	17719917	17721320	BolC7t41554H	0	+	50	420	1403	0.2993585
C7	17731621	17731891	BolC7t41555H	0	+	255	270	270	1.0000000
C7	17739940	17742115	BolC7t41556H	0	+	877	2120	2175	0.9747127
C7	17742701	17744500	BolC7t41557H	0	-	190	1313	1799	0.7298499
C7	17751425	17752637	BolC7t41558H	0	-	63	182	1212	0.1501650
C7	17770661	17771768	BolC7t41559H	0	+	437	1107	1107	1.0000000
C7	17783563	17784084	BolC7t41560H	0	+	341	521	521	1.0000000
C7	17800172	17801930	BolC7t41561H	0	+	453	1510	1758	0.8589306
C7	17802407	17804171	BolC7t41562H	0	-	367	1527	1764	0.8656462
C7	17819074	17825822	BolC7t41563H	0	-	101	1850	6748	0.2741553
C7	17820837	17821197	BolC7t41564H	0	-	46	360	360	1.0000000
C7	17821196	17822187	BolC7t41565H	0	-	32	353	991	0.3562059
C7	17821815	17822046	BolC7t41566H	0	-	0	0	231	0.0000000
C7	17822211	17822615	BolC7t41567H	0	-	0	0	404	0.0000000
C7	17823071	17823686	BolC7t41568H	0	-	0	0	615	0.0000000
C7	17846017	17846801	BolC7t41569H	0	-	678	784	784	1.0000000
C7	17855750	17858114	BolC7t41570H	0	-	951	2036	2364	0.8612521
C7	17860319	17861262	BolC7t41571H	0	-	289	865	943	0.9172853
C7	17882381	17882684	BolC7t41572H	0	+	9	216	303	0.7128713
C7	17893090	17893954	BolC7t41573H	0	+	408	864	864	1.0000000
C7	17898487	17898921	BolC7t41574H	0	+	502	434	434	1.0000000
C7	17900487	17900937	BolC7t41575H	0	+	319	443	450	0.9844444
C7	17906950	17909549	BolC7t41576H	0	-	186	1662	2599	0.6394767
C7	17921736	17924951	BolC7t41577H	0	+	549	2203	3215	0.6852255
C7	17930747	17931989	BolC7t41578H	0	-	137	901	1242	0.7254428
C7	17933059	17934356	BolC7t41579H	0	-	260	1160	1297	0.8943716
C7	17935276	17936745	BolC7t41580H	0	+	68	835	1469	0.5684139
C7	17949981	17950782	BolC7t41581H	0	-	7	196	801	0.2446941
C7	17967935	17968185	BolC7t41582H	0	-	179	250	250	1.0000000
C7	17970120	17978963	BolC7t41583H	0	+	1041	5732	8843	0.6481963
C7	17979743	17980643	BolC7t41584H	0	-	671	865	900	0.9611111
C7	17981187	17982346	BolC7t41585H	0	+	674	1159	1159	1.0000000
C7	17991709	17992533	BolC7t41586H	0	+	656	824	824	1.0000000
C7	17998759	18001450	BolC7t41587H	0	-	273	1854	2691	0.6889632
C7	18013879	18015180	BolC7t41588H	0	-	579	1225	1301	0.9415834
C7	18015437	18016361	BolC7t41589H	0	+	474	924	924	1.0000000
C7	18017776	18019538	BolC7t41590H	0	-	167	1204	1762	0.6833144
C7	18026264	18026545	BolC7t41591H	0	-	221	281	281	1.0000000
C7	18027010	18027301	BolC7t41592H	0	-	64	291	291	1.0000000
C7	18030408	18031669	BolC7t41593H	0	-	0	0	1261	0.0000000
C7	18108673	18109105	BolC7t41594H	0	+	147	432	432	1.0000000
C7	18124357	18124841	BolC7t41595H	0	+	389	484	484	1.0000000
C7	18127994	18128357	BolC7t41596H	0	+	73	354	363	0.9752066
C7	18129329	18129982	BolC7t41597H	0	-	24	604	653	0.9249617
C7	18130132	18135812	BolC7t41598H	0	-	575	4750	5680	0.8362676
C7	18145131	18145410	BolC7t41599H	0	+	51	201	279	0.7204301
C7	18171300	18171573	BolC7t41600H	0	-	317	273	273	1.0000000
C7	18183558	18183741	BolC7t41601H	0	-	8	149	183	0.8142077
C7	18201281	18201581	BolC7t41602H	0	-	111	300	300	1.0000000
C7	18203918	18204743	BolC7t41603H	0	+	0	0	825	0.0000000
C7	18217305	18217925	BolC7t41604H	0	+	246	595	620	0.9596774
C7	18223552	18224677	BolC7t41605H	0	-	274	1125	1125	1.0000000
C7	18228911	18229316	BolC7t41606H	0	+	334	405	405	1.0000000
C7	18231172	18236233	BolC7t41607H	0	-	1706	4701	5061	0.9288678
C7	18242203	18242386	BolC7t41608H	0	+	103	183	183	1.0000000
C7	18242655	18243732	BolC7t41609H	0	+	336	621	1077	0.5766017
C7	18245560	18246610	BolC7t41610H	0	-	20	442	1050	0.4209524
C7	18273639	18275007	BolC7t41611H	0	+	232	1171	1368	0.8559942
C7	18307303	18310973	BolC7t41612H	0	+	860	2785	3670	0.7588556
C7	18327368	18329831	BolC7t41613H	0	-	99	1577	2463	0.6402761
C7	18355065	18356037	BolC7t41614H	0	-	6	20	972	0.0205761
C7	18370034	18370473	BolC7t41615H	0	+	9	188	439	0.4282460
C7	18371041	18371948	BolC7t41616H	0	+	56	823	907	0.9073870
C7	18381252	18383566	BolC7t41617H	0	+	426	1890	2314	0.8167675
C7	18388825	18390340	BolC7t41618H	0	+	462	1225	1515	0.8085809
C7	18401639	18402131	BolC7t41619H	0	+	35	260	492	0.5284553
C7	18403882	18404419	BolC7t41620H	0	+	374	537	537	1.0000000
C7	18406120	18406306	BolC7t41621H	0	+	0	0	186	0.0000000
C7	18409311	18409537	BolC7t41622H	0	+	9	146	226	0.6460177
C7	18417456	18418568	BolC7t41623H	0	+	429	1103	1112	0.9919065
C7	18437963	18439752	BolC7t41624H	0	+	0	0	1789	0.0000000
C7	18441676	18442090	BolC7t41625H	0	+	6	199	414	0.4806763
C7	18442970	18444782	BolC7t41626H	0	-	0	0	1812	0.0000000
C7	18449754	18450937	BolC7t41627H	0	-	753	1183	1183	1.0000000
C7	18458135	18460177	BolC7t41628H	0	+	713	1408	2042	0.6895201
C7	18460500	18461499	BolC7t41629H	0	+	104	790	999	0.7907908
C7	18461695	18462922	BolC7t41630H	0	-	265	1184	1227	0.9649552
C7	18466442	18466936	BolC7t41631H	0	+	675	494	494	1.0000000
C7	18475220	18477230	BolC7t41632H	0	+	1276	1515	2010	0.7537314
C7	18486007	18487354	BolC7t41633H	0	-	231	1284	1347	0.9532294
C7	18491527	18492326	BolC7t41634H	0	+	0	0	799	0.0000000
C7	18497156	18497473	BolC7t41635H	0	+	272	317	317	1.0000000
C7	18497687	18498046	BolC7t41636H	0	+	354	359	359	1.0000000
C7	18525604	18526785	BolC7t41637H	0	+	52	619	1181	0.5241321
C7	18527053	18528194	BolC7t41638H	0	+	434	1076	1141	0.9430324
C7	18536282	18539118	BolC7t41639H	0	-	472	2790	2836	0.9837800
C7	18539850	18541956	BolC7t41640H	0	+	289	1425	2106	0.6766382
C7	18544309	18546836	BolC7t41641H	0	-	105	2110	2527	0.8349822
C7	18557260	18559812	BolC7t41642H	0	-	930	2512	2552	0.9843260
C7	18592865	18594888	BolC7t41643H	0	+	294	1567	2023	0.7745922
C7	18607103	18607682	BolC7t41644H	0	+	95	579	579	1.0000000
C7	18618926	18619955	BolC7t41645H	0	-	148	778	1029	0.7560738
C7	18625373	18629958	BolC7t41646H	0	-	130	1921	4585	0.4189749
C7	18633932	18637451	BolC7t41647H	0	-	429	1557	3519	0.4424552
C7	18638432	18638903	BolC7t41648H	0	+	285	471	471	1.0000000
C7	18648401	18648794	BolC7t41649H	0	-	195	393	393	1.0000000
C7	18651909	18653635	BolC7t41650H	0	+	824	1707	1726	0.9889919
C7	18670910	18671716	BolC7t41651H	0	+	240	806	806	1.0000000
C7	18671759	18672370	BolC7t41652H	0	+	161	572	611	0.9361702
C7	18672716	18673370	BolC7t41653H	0	+	161	654	654	1.0000000
C7	18678008	18680397	BolC7t41654H	0	-	227	2187	2389	0.9154458
C7	18705309	18707574	BolC7t41655H	0	+	104	1311	2265	0.5788080
C7	18709975	18710668	BolC7t41656H	0	-	19	281	693	0.4054834
C7	18716522	18716957	BolC7t41657H	0	+	380	435	435	1.0000000
C7	18727609	18729072	BolC7t41658H	0	+	562	1463	1463	1.0000000
C7	18733264	18734413	BolC7t41659H	0	+	419	1055	1149	0.9181897
C7	18737562	18737709	BolC7t41660H	0	-	169	147	147	1.0000000
C7	18741459	18744333	BolC7t41661H	0	+	1371	2830	2874	0.9846903
C7	18786849	18787918	BolC7t41662H	0	-	374	1015	1069	0.9494855
C7	18793951	18794053	BolC7t41663H	0	-	124	102	102	1.0000000
C7	18809925	18811531	BolC7t41664H	0	-	784	1477	1606	0.9196762
C7	18814623	18814977	BolC7t41665H	0	-	19	159	354	0.4491525
C7	18815389	18815521	BolC7t41666H	0	-	8	40	132	0.3030303
C7	18815825	18816188	BolC7t41667H	0	-	12	225	363	0.6198347
C7	18831853	18834393	BolC7t41668H	0	+	39	1008	2540	0.3968504
C7	18837109	18838745	BolC7t41669H	0	-	87	1065	1636	0.6509780
C7	18850084	18853375	BolC7t41670H	0	+	570	2249	3291	0.6833789
C7	18853500	18854982	BolC7t41671H	0	-	63	851	1482	0.5742240
C7	18865300	18866641	BolC7t41672H	0	+	1015	1341	1341	1.0000000
C7	18872146	18878242	BolC7t41673H	0	+	4361	5598	6096	0.9183071
C7	18879050	18880867	BolC7t41674H	0	+	1119	1619	1817	0.8910292
C7	18881788	18882138	BolC7t41675H	0	-	256	350	350	1.0000000
C7	18891737	18891866	BolC7t41676H	0	+	401	129	129	1.0000000
C7	18921595	18921908	BolC7t41677H	0	-	180	313	313	1.0000000
C7	18938796	18939099	BolC7t41678H	0	+	485	303	303	1.0000000
C7	18999986	19001501	BolC7t41679H	0	+	84	766	1515	0.5056106
C7	19002255	19002957	BolC7t41680H	0	+	937	702	702	1.0000000
C7	19009219	19009568	BolC7t41681H	0	+	7	158	349	0.4527221
C7	19026323	19035444	BolC7t41682H	0	+	3914	7012	9121	0.7687753
C7	19038576	19039343	BolC7t41683H	0	+	6	220	767	0.2868318
C7	19040421	19043878	BolC7t41684H	0	-	23	752	3457	0.2175297
C7	19045317	19046706	BolC7t41685H	0	+	0	0	1389	0.0000000
C7	19046758	19047110	BolC7t41686H	0	+	0	0	352	0.0000000
C7	19050356	19051123	BolC7t41687H	0	+	0	0	767	0.0000000
C7	19052202	19056077	BolC7t41688H	0	-	39	906	3875	0.2338064
C7	19066038	19066491	BolC7t41689H	0	-	13	146	453	0.3222958
C7	19077203	19077587	BolC7t41690H	0	-	48	325	384	0.8463542
C7	19108799	19111605	BolC7t41691H	0	+	537	2630	2806	0.9372773
C7	19116148	19116454	BolC7t41692H	0	+	216	306	306	1.0000000
C7	19121306	19122057	BolC7t41693H	0	+	27	405	751	0.5392810
C7	19130087	19133104	BolC7t41694H	0	+	1225	2851	3017	0.9449785
C7	19133581	19134093	BolC7t41695H	0	-	20	338	512	0.6601562
C7	19142185	19168999	BolC7t41696H	0	-	7224	19116	26814	0.7129112
C7	19156503	19156815	BolC7t41697H	0	-	110	312	312	1.0000000
C7	19158366	19159671	BolC7t41698H	0	-	670	1305	1305	1.0000000
C7	19175534	19200369	BolC7t41699H	0	+	4564	19701	24835	0.7932756
C7	19202942	19203219	BolC7t41700H	0	-	292	260	277	0.9386281
C7	19207224	19207365	BolC7t41701H	0	+	5	121	141	0.8581560
C7	19208210	19209689	BolC7t41702H	0	+	29	302	1479	0.2041920
C7	19210827	19211159	BolC7t41703H	0	+	2	203	332	0.6114458
C7	19213480	19213735	BolC7t41704H	0	-	0	0	255	0.0000000
C7	19219337	19220193	BolC7t41705H	0	+	63	249	856	0.2908879
C7	19220771	19220921	BolC7t41706H	0	+	60	149	150	0.9933333
C7	19221047	19221467	BolC7t41707H	0	+	9	265	420	0.6309524
C7	19224471	19224756	BolC7t41708H	0	+	168	243	285	0.8526316
C7	19225358	19225472	BolC7t41709H	0	+	48	114	114	1.0000000
C7	19225582	19225999	BolC7t41710H	0	+	4248	417	417	1.0000000
C7	19226068	19226479	BolC7t41711H	0	+	679	411	411	1.0000000
C7	19227608	19227776	BolC7t41712H	0	-	1701	168	168	1.0000000
C7	19229181	19229316	BolC7t41713H	0	-	5	65	135	0.4814815
C7	19230565	19230697	BolC7t41714H	0	+	3	103	132	0.7803030
C7	19230737	19230863	BolC7t41715H	0	-	1	29	126	0.2301587
C7	19231119	19231656	BolC7t41716H	0	-	9	216	537	0.4022346
C7	19232071	19232589	BolC7t41717H	0	-	1336	336	518	0.6486486
C7	19233072	19233814	BolC7t41718H	0	+	274	458	742	0.6172507
C7	19234260	19235171	BolC7t41719H	0	+	55	462	911	0.5071350
C7	19236238	19237678	BolC7t41720H	0	-	3972	1369	1440	0.9506944
C7	19239221	19240306	BolC7t41721H	0	+	61	663	1085	0.6110599
C7	19242081	19242444	BolC7t41722H	0	+	96	161	363	0.4435262
C7	19242508	19243147	BolC7t41723H	0	+	2	136	639	0.2128326
C7	19247882	19248131	BolC7t41724H	0	+	1186	218	249	0.8755020
C7	19249804	19250259	BolC7t41725H	0	+	915	455	455	1.0000000
C7	19250311	19251334	BolC7t41726H	0	+	442	797	1023	0.7790811
C7	19253222	19254715	BolC7t41727H	0	+	399	1302	1493	0.8720697
C7	19255617	19255806	BolC7t41728H	0	-	1	5	189	0.0264550
C7	19257539	19258859	BolC7t41729H	0	-	4832	1309	1320	0.9916667
C7	19262263	19262368	BolC7t41730H	0	+	5	100	105	0.9523810
C7	19264804	19265614	BolC7t41731H	0	+	26222	810	810	1.0000000
C7	19265688	19266723	BolC7t41732H	0	+	6002	1035	1035	1.0000000
C7	19268353	19269536	BolC7t41733H	0	+	15067	1183	1183	1.0000000
C7	19270150	19270861	BolC7t41734H	0	+	1072	711	711	1.0000000
C7	19271033	19271807	BolC7t41735H	0	+	3391	774	774	1.0000000
C7	19275444	19276779	BolC7t41736H	0	-	174	1118	1335	0.8374532
C7	19283610	19284392	BolC7t41737H	0	-	31	587	782	0.7506394
C7	19521871	19522093	BolC7t41738H	0	-	184	222	222	1.0000000
C7	19617084	19617726	BolC7t41739H	0	+	149	642	642	1.0000000
C7	19635180	19635381	BolC7t41740H	0	+	177	199	201	0.9900498
C7	19662929	19663037	BolC7t41741H	0	-	0	0	108	0.0000000
C7	19666667	19666871	BolC7t41742H	0	+	0	0	204	0.0000000
C7	19671198	19671690	BolC7t41743H	0	+	0	0	492	0.0000000
C7	19674890	19676108	BolC7t41744H	0	+	31	380	1218	0.3119869
C7	19679055	19679313	BolC7t41745H	0	-	3	103	258	0.3992248
C7	19679707	19681813	BolC7t41746H	0	+	8	339	2106	0.1609687
C7	19681940	19682411	BolC7t41747H	0	+	0	0	471	0.0000000
C7	19714250	19715507	BolC7t41748H	0	-	11	275	1257	0.2187749
C7	19731483	19732035	BolC7t41749H	0	+	118	552	552	1.0000000
C7	19734034	19735025	BolC7t41750H	0	-	82	916	991	0.9243189
C7	19738316	19739197	BolC7t41751H	0	+	1	30	881	0.0340522
C7	19742833	19743280	BolC7t41752H	0	-	0	0	447	0.0000000
C7	19743431	19745012	BolC7t41753H	0	-	70	802	1581	0.5072739
C7	19746875	19747756	BolC7t41754H	0	-	21	254	881	0.2883087
C7	19752725	19759657	BolC7t41755H	0	+	1868	4802	6932	0.6927294
C7	19770444	19770729	BolC7t41756H	0	+	0	0	285	0.0000000
C7	19785230	19785530	BolC7t41757H	0	+	496	300	300	1.0000000
C7	19798788	19799750	BolC7t41758H	0	-	67	505	962	0.5249480
C7	19803478	19804046	BolC7t41759H	0	-	34	272	568	0.4788733
C7	19805283	19805554	BolC7t41760H	0	-	7	159	271	0.5867159
C7	19837882	19838158	BolC7t41761H	0	+	2	90	276	0.3260870
C7	19884932	19886534	BolC7t41762H	0	-	149	887	1602	0.5536829
C7	19887319	19888060	BolC7t41763H	0	+	101	675	741	0.9109312
C7	19888157	19889039	BolC7t41764H	0	-	93	799	882	0.9058957
C7	19890045	19891971	BolC7t41765H	0	-	196	1178	1926	0.6116303
C7	19892429	19895460	BolC7t41766H	0	-	1091	2812	3031	0.9277466
C7	19899266	19899511	BolC7t41767H	0	-	451	245	245	1.0000000
C7	19902645	19904628	BolC7t41768H	0	-	294	1497	1983	0.7549168
C7	19909597	19910308	BolC7t41769H	0	-	11	161	711	0.2264416
C7	19912089	19912584	BolC7t41770H	0	+	9	20	495	0.0404040
C7	19922630	19925709	BolC7t41771H	0	-	2349	2958	3079	0.9607015
C7	19983693	19984038	BolC7t41772H	0	+	10	158	345	0.4579710
C7	19984536	19984748	BolC7t41773H	0	+	25	212	212	1.0000000
C7	19994829	19994970	BolC7t41774H	0	-	77	141	141	1.0000000
C7	19995482	19995899	BolC7t41775H	0	-	185	417	417	1.0000000
C7	20011515	20011677	BolC7t41776H	0	+	137	162	162	1.0000000
C7	20021904	20022231	BolC7t41777H	0	+	51	327	327	1.0000000
C7	20036279	20037996	BolC7t41778H	0	-	441	1660	1717	0.9668025
C7	20049866	20051012	BolC7t41779H	0	+	127	863	1146	0.7530541
C7	20110718	20111259	BolC7t41780H	0	+	3	165	541	0.3049908
C7	20162167	20169332	BolC7t41781H	0	+	985	5441	7165	0.7593859
C7	20169344	20171045	BolC7t41782H	0	+	873	1701	1701	1.0000000
C7	20172696	20172864	BolC7t41783H	0	-	217	168	168	1.0000000
C7	20177607	20177921	BolC7t41784H	0	-	468	314	314	1.0000000
C7	20191642	20192406	BolC7t41785H	0	-	522	764	764	1.0000000
C7	20201362	20202692	BolC7t41786H	0	-	662	1330	1330	1.0000000
C7	20213056	20214287	BolC7t41787H	0	-	660	1231	1231	1.0000000
C7	20220937	20221738	BolC7t41788H	0	+	57	537	801	0.6704120
C7	20227732	20228255	BolC7t41789H	0	+	139	523	523	1.0000000
C7	20229303	20229798	BolC7t41790H	0	+	104	489	495	0.9878788
C7	20229999	20230587	BolC7t41791H	0	+	71	582	588	0.9897959
C7	20233380	20235727	BolC7t41792H	0	+	2175	2347	2347	1.0000000
C7	20236462	20238085	BolC7t41793H	0	-	752	1623	1623	1.0000000
C7	20241262	20241439	BolC7t41794H	0	+	193	177	177	1.0000000
C7	20242354	20245790	BolC7t41795H	0	-	2367	3371	3436	0.9810827
C7	20247980	20248623	BolC7t41796H	0	+	604	643	643	1.0000000
C7	20251013	20253152	BolC7t41797H	0	+	793	2139	2139	1.0000000
C7	20254811	20256609	BolC7t41798H	0	-	654	1798	1798	1.0000000
C7	20267169	20268182	BolC7t41799H	0	-	247	788	1013	0.7778875
C7	20269836	20273751	BolC7t41800H	0	+	815	1941	3915	0.4957854
C7	20275227	20278165	BolC7t41801H	0	-	98	1610	2938	0.5479918
C7	20299688	20301892	BolC7t41802H	0	-	296	1641	2204	0.7445554
C7	20303621	20305533	BolC7t41803H	0	-	95	1022	1912	0.5345188
C7	20308053	20309733	BolC7t41804H	0	+	311	940	1680	0.5595238
C7	20352914	20354672	BolC7t41805H	0	+	9	131	1758	0.0745165
C7	20364735	20364870	BolC7t41806H	0	+	2	98	135	0.7259259
C7	20379353	20380909	BolC7t41807H	0	+	118	849	1556	0.5456298
C7	20385073	20385298	BolC7t41808H	0	+	7	31	225	0.1377778
C7	20400079	20402547	BolC7t41809H	0	+	187	898	2468	0.3638574
C7	20409319	20417418	BolC7t41810H	0	-	4374	7439	8099	0.9185085
C7	20434182	20437760	BolC7t41811H	0	+	178	2248	3578	0.6282840
C7	20439433	20443856	BolC7t41812H	0	-	1990	4109	4423	0.9290075
C7	20456226	20456530	BolC7t41813H	0	-	20	244	304	0.8026316
C7	20471010	20473825	BolC7t41814H	0	-	1372	2419	2815	0.8593251
C7	20485587	20490279	BolC7t41815H	0	+	1482	3648	4692	0.7774936
C7	20490559	20492143	BolC7t41816H	0	-	328	994	1584	0.6275253
C7	20504017	20506797	BolC7t41817H	0	+	944	2436	2780	0.8762590
C7	20514439	20514988	BolC7t41818H	0	-	637	549	549	1.0000000
C7	20547905	20548346	BolC7t41819H	0	-	474	441	441	1.0000000
C7	20573262	20573847	BolC7t41820H	0	-	419	585	585	1.0000000
C7	20615465	20616480	BolC7t41821H	0	+	16	560	1015	0.5517241
C7	20617161	20627800	BolC7t41822H	0	+	4975	10499	10639	0.9868408
C7	20618859	20627321	BolC7t41823H	0	+	4522	8462	8462	1.0000000
C7	20698753	20700571	BolC7t41824H	0	-	1319	1729	1818	0.9510451
C7	20716755	20717040	BolC7t41825H	0	-	206	285	285	1.0000000
C7	20728421	20729792	BolC7t41826H	0	-	136	881	1371	0.6425967
C7	20758959	20760171	BolC7t41827H	0	-	590	1068	1212	0.8811881
C7	20768395	20771312	BolC7t41828H	0	-	2578	2917	2917	1.0000000
C7	20772431	20774743	BolC7t41829H	0	-	1481	2312	2312	1.0000000
C7	20803928	20805038	BolC7t41830H	0	+	1136	1110	1110	1.0000000
C7	20805683	20806215	BolC7t41831H	0	+	788	532	532	1.0000000
C7	20823246	20825587	BolC7t41832H	0	+	608	1505	2341	0.6428877
C7	20826668	20827022	BolC7t41833H	0	-	0	0	354	0.0000000
C7	20835421	20835700	BolC7t41834H	0	+	73	274	279	0.9820789
C7	20852505	20853688	BolC7t41835H	0	-	162	1070	1183	0.9044802
C7	20860438	20862440	BolC7t41836H	0	-	161	1215	2002	0.6068931
C7	20869212	20869323	BolC7t41837H	0	+	130	111	111	1.0000000
C7	20882662	20884673	BolC7t41838H	0	+	892	2011	2011	1.0000000
C7	20884917	20887798	BolC7t41839H	0	-	1395	2881	2881	1.0000000
C7	20890986	20892621	BolC7t41840H	0	-	5	272	1635	0.1663609
C7	20893550	20897831	BolC7t41841H	0	+	320	2175	4281	0.5080588
C7	20909141	20911956	BolC7t41842H	0	-	460	1973	2815	0.7008881
C7	20921431	20924281	BolC7t41843H	0	+	1024	2580	2850	0.9052632
C7	20925154	20926202	BolC7t41844H	0	-	162	789	1048	0.7528626
C7	20977111	20977414	BolC7t41845H	0	-	223	303	303	1.0000000
C7	20986309	20986510	BolC7t41846H	0	-	272	201	201	1.0000000
C7	20996367	20998563	BolC7t41847H	0	+	949	2105	2196	0.9585610
C7	20999570	21001075	BolC7t41848H	0	+	703	1450	1505	0.9634551
C7	21011227	21016768	BolC7t41849H	0	+	727	3642	5541	0.6572821
C7	21022994	21023879	BolC7t41850H	0	+	21	487	885	0.5502825
C7	21028489	21031103	BolC7t41851H	0	+	1996	2614	2614	1.0000000
C7	21032954	21033888	BolC7t41852H	0	+	235	933	934	0.9989293
C7	21037882	21043546	BolC7t41853H	0	-	1322	4880	5664	0.8615819
C7	21212501	21212636	BolC7t41854H	0	+	4	78	135	0.5777778
C7	21233071	21234070	BolC7t41855H	0	-	88	464	999	0.4644645
C7	21253786	21253978	BolC7t41856H	0	-	197	192	192	1.0000000
C7	21261083	21262783	BolC7t41857H	0	-	814	1700	1700	1.0000000
C7	21265762	21265909	BolC7t41858H	0	+	143	147	147	1.0000000
C7	21269263	21270241	BolC7t41859H	0	-	218	978	978	1.0000000
C7	21280671	21282232	BolC7t41860H	0	-	373	1407	1561	0.9013453
C7	21283047	21283149	BolC7t41861H	0	-	479	102	102	1.0000000
C7	21284047	21290102	BolC7t41862H	0	-	3094	5712	6055	0.9433526
C7	21294949	21300321	BolC7t41863H	0	-	2640	4936	5372	0.9188384
C7	21311761	21314102	BolC7t41864H	0	-	931	1914	2341	0.8175993
C7	21314573	21314880	BolC7t41865H	0	+	156	307	307	1.0000000
C7	21316633	21320765	BolC7t41866H	0	-	1496	4029	4132	0.9750726
C7	21329965	21334023	BolC7t41867H	0	-	933	2611	4058	0.6434204
C7	21344638	21346921	BolC7t41868H	0	+	92	1095	2283	0.4796320
C7	21351183	21353867	BolC7t41869H	0	-	836	2357	2684	0.8781669
C7	21373561	21373816	BolC7t41870H	0	-	84	221	255	0.8666667
C7	21398529	21399774	BolC7t41871H	0	+	171	959	1245	0.7702811
C7	21402297	21404360	BolC7t41872H	0	+	335	1542	2063	0.7474552
C7	21416040	21416154	BolC7t41873H	0	+	29	114	114	1.0000000
C7	21419324	21421565	BolC7t41874H	0	-	49	993	2241	0.4431058
C7	21454074	21454872	BolC7t41875H	0	+	2	19	798	0.0238095
C7	21463438	21464616	BolC7t41876H	0	-	110	486	1178	0.4125637
C7	21469994	21470997	BolC7t41877H	0	+	28	171	1003	0.1704885
C7	21474477	21474693	BolC7t41878H	0	+	4	179	216	0.8287037
C7	21492459	21492573	BolC7t41879H	0	+	18	114	114	1.0000000
C7	21525037	21525417	BolC7t41880H	0	-	293	380	380	1.0000000
C7	21527603	21529344	BolC7t41881H	0	-	958	1741	1741	1.0000000
C7	21547771	21547876	BolC7t41882H	0	+	0	0	105	0.0000000
C7	21566191	21570581	BolC7t41883H	0	+	223	1887	4390	0.4298405
C7	21571198	21623518	BolC7t41884H	0	-	7220	30770	52320	0.5881116
C7	21589049	21589456	BolC7t41885H	0	-	204	407	407	1.0000000
C7	21598744	21599315	BolC7t41886H	0	-	48	287	571	0.5026270
C7	21616276	21616807	BolC7t41887H	0	-	4	20	531	0.0376648
C7	21625154	21625334	BolC7t41888H	0	-	1	41	180	0.2277778
C7	21652020	21652586	BolC7t41889H	0	+	478	566	566	1.0000000
C7	21656606	21656969	BolC7t41890H	0	+	463	363	363	1.0000000
C7	21658084	21658555	BolC7t41891H	0	+	0	0	471	0.0000000
C7	21663138	21663940	BolC7t41892H	0	-	592	802	802	1.0000000
C7	21696731	21698483	BolC7t41893H	0	+	840	1752	1752	1.0000000
C7	21722863	21728815	BolC7t41894H	0	+	377	4264	5952	0.7163978
C7	21730302	21733652	BolC7t41895H	0	-	676	2038	3350	0.6083582
C7	21736835	21738183	BolC7t41896H	0	+	4	131	1348	0.0971810
C7	21739335	21739680	BolC7t41897H	0	+	30	328	345	0.9507247
C7	21750860	21752010	BolC7t41898H	0	+	768	1143	1150	0.9939131
C7	21752528	21753784	BolC7t41899H	0	-	401	1133	1256	0.9020700
C7	21758833	21759567	BolC7t41900H	0	-	347	734	734	1.0000000
C7	21768154	21770618	BolC7t41901H	0	-	1220	2464	2464	1.0000000
C7	21773104	21774806	BolC7t41902H	0	+	402	1213	1702	0.7126909
C7	21774882	21777852	BolC7t41903H	0	-	291	2179	2970	0.7336701
C7	21778512	21778911	BolC7t41904H	0	-	359	399	399	1.0000000
C7	21779146	21781285	BolC7t41905H	0	-	585	1630	2139	0.7620384
C7	21781644	21782363	BolC7t41906H	0	-	655	719	719	1.0000000
C7	21784000	21784609	BolC7t41907H	0	+	532	609	609	1.0000000
C7	21785580	21788267	BolC7t41908H	0	-	355	2158	2687	0.8031262
C7	21790984	21791660	BolC7t41909H	0	-	257	676	676	1.0000000
C7	21793184	21793715	BolC7t41910H	0	+	243	531	531	1.0000000
C7	21795608	21795740	BolC7t41911H	0	-	56	132	132	1.0000000
C7	21817068	21819458	BolC7t41912H	0	-	935	2219	2390	0.9284519
C7	21832991	21834107	BolC7t41913H	0	-	121	720	1116	0.6451613
C7	21848888	21852196	BolC7t41914H	0	-	1315	2218	3308	0.6704957
C7	21862290	21864703	BolC7t41915H	0	+	2311	2413	2413	1.0000000
C7	21864890	21867214	BolC7t41916H	0	-	324	1779	2324	0.7654905
C7	21868042	21872324	BolC7t41917H	0	-	566	3294	4282	0.7692667
C7	21873354	21873942	BolC7t41918H	0	+	59	426	588	0.7244898
C7	21883126	21884284	BolC7t41919H	0	-	25	374	1158	0.3229706
C7	21918608	21919134	BolC7t41920H	0	-	2	149	526	0.2832700
C7	21922229	21922337	BolC7t41921H	0	+	17	108	108	1.0000000
C7	21958035	21958746	BolC7t41922H	0	+	2	104	711	0.1462729
C7	21965155	21965572	BolC7t41923H	0	+	72	303	417	0.7266187
C7	21967070	21967469	BolC7t41924H	0	-	269	399	399	1.0000000
C7	21975332	21976911	BolC7t41925H	0	+	1431	1579	1579	1.0000000
C7	21982786	21984902	BolC7t41926H	0	+	24	620	2116	0.2930057
C7	21993624	21994122	BolC7t41927H	0	+	183	498	498	1.0000000
C7	21996312	21996883	BolC7t41928H	0	+	444	571	571	1.0000000
C7	21997511	21997865	BolC7t41929H	0	-	876	354	354	1.0000000
C7	22002063	22002815	BolC7t41930H	0	-	693	752	752	1.0000000
C7	22005541	22005758	BolC7t41931H	0	+	0	0	217	0.0000000
C7	22009230	22010451	BolC7t41932H	0	+	256	1187	1221	0.9721540
C7	22010917	22012245	BolC7t41933H	0	-	505	1206	1328	0.9081326
C7	22014288	22015071	BolC7t41934H	0	+	219	773	783	0.9872286
C7	22024172	22024490	BolC7t41935H	0	+	228	318	318	1.0000000
C7	22030002	22031496	BolC7t41936H	0	+	632	1257	1494	0.8413655
C7	22035552	22044516	BolC7t41937H	0	-	310	1485	8964	0.1656626
C7	22050297	22050831	BolC7t41938H	0	+	227	534	534	1.0000000
C7	22051436	22053469	BolC7t41939H	0	+	1145	1968	2033	0.9680275
C7	22054124	22054388	BolC7t41940H	0	-	109	264	264	1.0000000
C7	22061680	22061950	BolC7t41941H	0	+	89	266	270	0.9851852
C7	22088946	22089570	BolC7t41942H	0	-	320	624	624	1.0000000
C7	22095996	22100959	BolC7t41943H	0	+	4391	4963	4963	1.0000000
C7	22105186	22108775	BolC7t41944H	0	-	782	1829	3589	0.5096127
C7	22110633	22110870	BolC7t41945H	0	-	10	218	237	0.9198312
C7	22135593	22138085	BolC7t41946H	0	+	328	2088	2492	0.8378812
C7	22141892	22143755	BolC7t41947H	0	+	55	588	1863	0.3156200
C7	22146181	22147279	BolC7t41948H	0	+	606	1098	1098	1.0000000
C7	22147790	22148006	BolC7t41949H	0	+	7	65	216	0.3009259
C7	22149940	22150707	BolC7t41950H	0	+	14	467	767	0.6088657
C7	22153207	22154212	BolC7t41951H	0	-	227	554	1005	0.5512438
C7	22216828	22217058	BolC7t41952H	0	+	2	24	230	0.1043478
C7	22218421	22218913	BolC7t41953H	0	+	6	23	492	0.0467480
C7	22241635	22243059	BolC7t41954H	0	+	78	588	1424	0.4129213
C7	22250125	22251713	BolC7t41955H	0	-	1396	1366	1588	0.8602015
C7	22271538	22272896	BolC7t41956H	0	+	455	1294	1358	0.9528719
C7	22274150	22275116	BolC7t41957H	0	+	4	118	966	0.1221532
C7	22279048	22279235	BolC7t41958H	0	-	5	38	187	0.2032086
C7	22280339	22280997	BolC7t41959H	0	-	690	658	658	1.0000000
C7	22301698	22302296	BolC7t41960H	0	+	20	359	598	0.6003345
C7	22302784	22303431	BolC7t41961H	0	+	51	277	647	0.4281298
C7	22304631	22304814	BolC7t41962H	0	+	316	183	183	1.0000000
C7	22316824	22317209	BolC7t41963H	0	+	30	235	385	0.6103896
C7	22317282	22317991	BolC7t41964H	0	+	149	476	709	0.6713681
C7	22333085	22334145	BolC7t41965H	0	-	174	919	1060	0.8669811
C7	22357383	22357905	BolC7t41966H	0	-	676	522	522	1.0000000
C7	22362357	22362775	BolC7t41967H	0	-	204	418	418	1.0000000
C7	22366743	22368664	BolC7t41968H	0	+	293	1829	1921	0.9521083
C7	22372301	22376721	BolC7t41969H	0	+	1153	4157	4420	0.9404978
C7	22414250	22415015	BolC7t41970H	0	-	0	0	765	0.0000000
C7	22420957	22422440	BolC7t41971H	0	-	1239	1483	1483	1.0000000
C7	22436142	22437127	BolC7t41972H	0	-	2966	985	985	1.0000000
C7	22438466	22439835	BolC7t41973H	0	+	244	478	1369	0.3491600
C7	22440570	22442431	BolC7t41974H	0	+	499	1438	1861	0.7727029
C7	22444621	22445251	BolC7t41975H	0	+	273	630	630	1.0000000
C7	22445669	22446940	BolC7t41976H	0	-	96	1034	1271	0.8135327
C7	22453321	22454580	BolC7t41977H	0	-	777	1259	1259	1.0000000
C7	22455328	22457733	BolC7t41978H	0	-	927	2370	2405	0.9854470
C7	22469218	22469980	BolC7t41979H	0	-	38	563	762	0.7388452
C7	22477181	22478985	BolC7t41980H	0	-	511	1724	1804	0.9556541
C7	22480165	22480395	BolC7t41981H	0	+	420	230	230	1.0000000
C7	22488626	22488953	BolC7t41982H	0	-	78	327	327	1.0000000
C7	22501251	22501674	BolC7t41983H	0	+	3	131	423	0.3096927
C7	22510790	22511452	BolC7t41984H	0	-	522	662	662	1.0000000
C7	22512473	22515755	BolC7t41985H	0	+	1351	3125	3282	0.9521633
C7	22531350	22535073	BolC7t41986H	0	+	641	2763	3723	0.7421435
C7	22541739	22541853	BolC7t41987H	0	-	0	0	114	0.0000000
C7	22541952	22542117	BolC7t41988H	0	+	0	0	165	0.0000000
C7	22544124	22545462	BolC7t41989H	0	+	105	1127	1338	0.8423020
C7	22554008	22554624	BolC7t41990H	0	+	368	616	616	1.0000000
C7	22557904	22560192	BolC7t41991H	0	-	1521	2288	2288	1.0000000
C7	22561580	22562015	BolC7t41992H	0	-	0	0	435	0.0000000
C7	22584140	22586712	BolC7t41993H	0	-	436	1848	2572	0.7185070
C7	22588133	22589056	BolC7t41994H	0	-	36	561	923	0.6078007
C7	22601437	22603850	BolC7t41995H	0	+	1071	1936	2413	0.8023208
C7	22629780	22630983	BolC7t41996H	0	-	180	784	1203	0.6517041
C7	22631053	22631361	BolC7t41997H	0	-	27	140	308	0.4545455
C7	22633354	22634950	BolC7t41998H	0	-	976	1596	1596	1.0000000
C7	22637757	22639264	BolC7t41999H	0	+	12	201	1507	0.1333776
C7	22641737	22642228	BolC7t42000H	0	+	58	163	491	0.3319755
C7	22656466	22657340	BolC7t42001H	0	-	445	863	874	0.9874142
C7	22690874	22691513	BolC7t42002H	0	-	508	639	639	1.0000000
C7	22692469	22694471	BolC7t42003H	0	-	836	1956	2002	0.9770230
C7	22727301	22727448	BolC7t42004H	0	-	117	147	147	1.0000000
C7	22733563	22735746	BolC7t42005H	0	-	852	2131	2183	0.9761795
C7	22756459	22756966	BolC7t42006H	0	-	4	185	507	0.3648915
C7	22759157	22759442	BolC7t42007H	0	-	34	252	285	0.8842105
C7	22761345	22764459	BolC7t42008H	0	+	853	2855	3114	0.9168273
C7	22765235	22765501	BolC7t42009H	0	+	142	266	266	1.0000000
C7	22769475	22770594	BolC7t42010H	0	+	141	837	1119	0.7479893
C7	22771226	22771574	BolC7t42011H	0	-	0	0	348	0.0000000
C7	22773760	22792649	BolC7t42012H	0	+	4901	11769	18889	0.6230611
C7	22832293	22841690	BolC7t42013H	0	+	2393	7333	9397	0.7803555
C7	22884736	22885180	BolC7t42014H	0	+	140	444	444	1.0000000
C7	22893410	22894500	BolC7t42015H	0	+	692	1090	1090	1.0000000
C7	22895707	22901999	BolC7t42016H	0	-	1500	4934	6292	0.7841704
C7	22914616	22918872	BolC7t42017H	0	+	1316	4043	4256	0.9499530
C7	22919489	22925024	BolC7t42018H	0	-	959	4307	5535	0.7781391
C7	22934018	22941953	BolC7t42019H	0	-	1496	5213	7935	0.6569628
C7	22944169	22946945	BolC7t42020H	0	-	23	716	2776	0.2579251
C7	22949304	22950621	BolC7t42021H	0	-	163	854	1317	0.6484435
C7	22961349	22963518	BolC7t42022H	0	-	1170	2169	2169	1.0000000
C7	22974053	22974425	BolC7t42023H	0	-	0	0	372	0.0000000
C7	22976272	22984364	BolC7t42024H	0	-	1551	6253	8092	0.7727385
C7	22986383	22987976	BolC7t42025H	0	+	33	152	1593	0.0954175
C7	23016447	23016798	BolC7t42026H	0	+	133	351	351	1.0000000
C7	23020424	23025853	BolC7t42027H	0	-	301	1139	5429	0.2097992
C7	23028056	23029163	BolC7t42028H	0	-	775	1107	1107	1.0000000
C7	23030242	23032587	BolC7t42029H	0	+	1301	2345	2345	1.0000000
C7	23042460	23044159	BolC7t42030H	0	+	496	1641	1699	0.9658623
C7	23047541	23050249	BolC7t42031H	0	-	1532	2696	2708	0.9955687
C7	23065640	23066092	BolC7t42032H	0	-	77	355	452	0.7853982
C7	23089330	23089600	BolC7t42033H	0	+	220	270	270	1.0000000
C7	23090208	23090349	BolC7t42034H	0	-	62	141	141	1.0000000
C7	23091321	23092578	BolC7t42035H	0	-	230	898	1257	0.7143993
C7	23106110	23106722	BolC7t42036H	0	-	291	612	612	1.0000000
C7	23134954	23136009	BolC7t42037H	0	-	105	714	1055	0.6767772
C7	23152532	23153033	BolC7t42038H	0	-	221	501	501	1.0000000
C7	23161776	23165182	BolC7t42039H	0	-	2416	3256	3406	0.9559601
C7	23167184	23169432	BolC7t42040H	0	-	52	496	2248	0.2206406
C7	23175869	23176895	BolC7t42041H	0	+	2391	1026	1026	1.0000000
C7	23179672	23180076	BolC7t42042H	0	+	1210	404	404	1.0000000
C7	23181566	23184149	BolC7t42043H	0	-	3813	2428	2583	0.9399922
C7	23192431	23194630	BolC7t42044H	0	-	986	1916	2199	0.8713052
C7	23273315	23274547	BolC7t42045H	0	-	1212	1232	1232	1.0000000
C7	23289274	23293899	BolC7t42046H	0	-	1987	4445	4625	0.9610811
C7	23299013	23300314	BolC7t42047H	0	-	173	768	1301	0.5903152
C7	23308679	23309789	BolC7t42048H	0	-	810	1110	1110	1.0000000
C7	23315304	23316821	BolC7t42049H	0	+	14	159	1517	0.1048121
C7	23335744	23336008	BolC7t42050H	0	+	416	264	264	1.0000000
C7	23336556	23337276	BolC7t42051H	0	-	332	715	720	0.9930556
C7	23342043	23342756	BolC7t42052H	0	+	98	683	713	0.9579242
C7	23348458	23348830	BolC7t42053H	0	+	0	0	372	0.0000000
C7	23369851	23371942	BolC7t42054H	0	-	104	562	2091	0.2687709
C7	23372722	23373676	BolC7t42055H	0	-	452	954	954	1.0000000
C7	23376428	23376590	BolC7t42056H	0	-	172	162	162	1.0000000
C7	23385421	23392874	BolC7t42057H	0	+	1312	5186	7453	0.6958272
C7	23393277	23394081	BolC7t42058H	0	-	17	286	804	0.3557214
C7	23397723	23398143	BolC7t42059H	0	-	83	420	420	1.0000000
C7	23415751	23418918	BolC7t42060H	0	+	452	2221	3167	0.7012946
C7	23421177	23422820	BolC7t42061H	0	-	1157	1593	1643	0.9695678
C7	23430389	23430954	BolC7t42062H	0	-	378	565	565	1.0000000
C7	23440325	23441317	BolC7t42063H	0	-	953	992	992	1.0000000
C7	23445427	23445941	BolC7t42064H	0	-	103	514	514	1.0000000
C7	23454927	23455863	BolC7t42065H	0	-	649	936	936	1.0000000
C7	23461193	23461765	BolC7t42066H	0	+	394	572	572	1.0000000
C7	23462998	23463151	BolC7t42067H	0	-	138	153	153	1.0000000
C7	23464690	23465482	BolC7t42068H	0	-	75	416	792	0.5252525
C7	23479069	23497544	BolC7t42069H	0	+	6645	15095	18475	0.8170500
C7	23519964	23521449	BolC7t42070H	0	-	335	1192	1485	0.8026936
C7	23531260	23531791	BolC7t42071H	0	+	36	467	531	0.8794727
C7	23536193	23548440	BolC7t42072H	0	+	972	7866	12247	0.6422797
C7	23561555	23570955	BolC7t42073H	0	+	2077	7219	9400	0.7679787
C7	23617949	23626822	BolC7t42074H	0	+	8718	8526	8873	0.9608926
C7	23626798	23628397	BolC7t42075H	0	+	639	1380	1599	0.8630394
C7	23629428	23629779	BolC7t42076H	0	+	74	328	351	0.9344729
C7	23662035	23662639	BolC7t42077H	0	-	0	0	604	0.0000000
C7	23666461	23667142	BolC7t42078H	0	+	82	301	681	0.4419971
C7	23667284	23669349	BolC7t42079H	0	+	804	1903	2065	0.9215496
C7	23696056	23704793	BolC7t42080H	0	+	1347	4786	8737	0.5477853
C7	23705009	23706561	BolC7t42081H	0	-	1410	1552	1552	1.0000000
C7	23714707	23716078	BolC7t42082H	0	-	269	1371	1371	1.0000000
C7	23759808	23763595	BolC7t42083H	0	+	211	1593	3787	0.4206496
C7	23762421	23763045	BolC7t42084H	0	+	19	426	624	0.6826923
C7	23788957	23795799	BolC7t42085H	0	+	3847	5713	6842	0.8349898
C7	23796345	23797018	BolC7t42086H	0	-	153	598	673	0.8885587
C7	23800072	23802335	BolC7t42087H	0	+	507	2080	2263	0.9191339
C7	23816304	23817066	BolC7t42088H	0	+	17	235	762	0.3083990
C7	23818254	23819299	BolC7t42089H	0	+	60	968	1045	0.9263158
C7	23822831	23824365	BolC7t42090H	0	-	8	259	1534	0.1688396
C7	23829831	23831566	BolC7t42091H	0	-	105	1169	1735	0.6737752
C7	23845976	23846511	BolC7t42092H	0	+	414	535	535	1.0000000
C7	23863987	23864398	BolC7t42093H	0	+	207	411	411	1.0000000
C7	23888044	23891714	BolC7t42094H	0	-	728	2826	3670	0.7700272
C7	23893081	23894604	BolC7t42095H	0	-	887	1523	1523	1.0000000
C7	23904714	23905565	BolC7t42096H	0	-	2020	851	851	1.0000000
C7	23909213	23910188	BolC7t42097H	0	-	610	915	975	0.9384615
C7	23916908	23918135	BolC7t42098H	0	-	136	1183	1227	0.9641402
C7	23922658	23922766	BolC7t42099H	0	-	0	0	108	0.0000000
C7	23929857	23930707	BolC7t42100H	0	-	11	230	850	0.2705882
C7	23930977	23931085	BolC7t42101H	0	-	5	80	108	0.7407407
C7	23938238	23939465	BolC7t42102H	0	-	9	536	1227	0.4368378
C7	23946627	23946966	BolC7t42103H	0	-	0	0	339	0.0000000
C7	23947128	23947852	BolC7t42104H	0	-	74	674	724	0.9309392
C7	23955827	23956225	BolC7t42105H	0	-	0	0	398	0.0000000
C7	23961299	23963553	BolC7t42106H	0	-	1255	2190	2254	0.9716060
C7	23967845	23969594	BolC7t42107H	0	-	943	1749	1749	1.0000000
C7	23970798	23972207	BolC7t42108H	0	-	312	1409	1409	1.0000000
C7	23972621	23972921	BolC7t42109H	0	+	113	300	300	1.0000000
C7	23973541	23973952	BolC7t42110H	0	-	150	387	411	0.9416059
C7	23984996	23986544	BolC7t42111H	0	-	133	683	1548	0.4412145
C7	23992145	23992784	BolC7t42112H	0	+	437	633	639	0.9906103
C7	23999968	24000789	BolC7t42113H	0	-	431	821	821	1.0000000
C7	24001477	24001856	BolC7t42114H	0	-	163	379	379	1.0000000
C7	24030573	24030783	BolC7t42115H	0	-	4	128	210	0.6095238
C7	24046008	24046170	BolC7t42116H	0	-	0	0	162	0.0000000
C7	24047395	24048223	BolC7t42117H	0	-	607	828	828	1.0000000
C7	24051068	24051594	BolC7t42118H	0	-	1053	526	526	1.0000000
C7	24053538	24056259	BolC7t42119H	0	+	529	2234	2721	0.8210217
C7	24056661	24058194	BolC7t42120H	0	-	240	1458	1533	0.9510763
C7	24060167	24060701	BolC7t42121H	0	+	293	534	534	1.0000000
C7	24061087	24065565	BolC7t42122H	0	-	1008	3757	4478	0.8389906
C7	24101527	24102235	BolC7t42123H	0	+	120	388	708	0.5480226
C7	24129891	24132654	BolC7t42124H	0	+	1792	2763	2763	1.0000000
C7	24134599	24139250	BolC7t42125H	0	+	4038	4617	4651	0.9926897
C7	24145950	24148086	BolC7t42126H	0	-	1212	2136	2136	1.0000000
C7	24149775	24150708	BolC7t42127H	0	+	266	875	933	0.9378349
C7	24164638	24164962	BolC7t42128H	0	-	28	260	324	0.8024691
C7	24177181	24178802	BolC7t42129H	0	-	589	1467	1621	0.9049969
C7	24179749	24180286	BolC7t42130H	0	-	379	537	537	1.0000000
C7	24209490	24210345	BolC7t42131H	0	-	393	855	855	1.0000000
C7	24216530	24216659	BolC7t42132H	0	+	120	129	129	1.0000000
C7	24217463	24218027	BolC7t42133H	0	+	297	564	564	1.0000000
C7	24219567	24219741	BolC7t42134H	0	+	342	174	174	1.0000000
C7	24236258	24237398	BolC7t42135H	0	-	1179	1140	1140	1.0000000
C7	24238605	24239077	BolC7t42136H	0	+	793	472	472	1.0000000
C7	24240995	24241619	BolC7t42137H	0	+	997	624	624	1.0000000
C7	24241979	24242847	BolC7t42138H	0	-	434	862	868	0.9930875
C7	24242852	24243748	BolC7t42139H	0	-	432	674	896	0.7522321
C7	24249391	24249595	BolC7t42140H	0	+	119	204	204	1.0000000
C7	24252841	24255395	BolC7t42141H	0	+	1766	2554	2554	1.0000000
C7	24269837	24287166	BolC7t42142H	0	-	1990	10193	17329	0.5882047
C7	24270665	24270983	BolC7t42143H	0	+	10	209	318	0.6572327
C7	24289148	24289712	BolC7t42144H	0	-	0	0	564	0.0000000
C7	24290750	24291839	BolC7t42145H	0	-	598	1089	1089	1.0000000
C7	24295489	24302719	BolC7t42146H	0	-	4983	7230	7230	1.0000000
C7	24304272	24304530	BolC7t42147H	0	+	180	258	258	1.0000000
C7	24309032	24310322	BolC7t42148H	0	-	161	730	1290	0.5658914
C7	24313314	24313848	BolC7t42149H	0	-	11	247	534	0.4625468
C7	24367101	24367635	BolC7t42150H	0	+	2	136	534	0.2546816
C7	24373170	24376517	BolC7t42151H	0	-	1201	2737	3347	0.8177472
C7	24380416	24380799	BolC7t42152H	0	-	389	383	383	1.0000000
C7	24396474	24397311	BolC7t42153H	0	-	6	278	837	0.3321386
C7	24398406	24402152	BolC7t42154H	0	-	607	2153	3746	0.5747464
C7	24407817	24408393	BolC7t42155H	0	-	9	257	576	0.4461806
C7	24421680	24422712	BolC7t42156H	0	+	137	994	1032	0.9631783
C7	24429199	24430545	BolC7t42157H	0	+	40	324	1346	0.2407132
C7	24430985	24431875	BolC7t42158H	0	+	464	834	890	0.9370787
C7	24432968	24435156	BolC7t42159H	0	-	1060	1984	2188	0.9067641
C7	24447123	24456113	BolC7t42160H	0	+	3242	7223	8990	0.8034483
C7	24448453	24448915	BolC7t42161H	0	-	401	462	462	1.0000000
C7	24452753	24453623	BolC7t42162H	0	-	329	539	870	0.6195402
C7	24456890	24457364	BolC7t42163H	0	-	330	474	474	1.0000000
C7	24458318	24459423	BolC7t42164H	0	-	817	1105	1105	1.0000000
C7	24464322	24465056	BolC7t42165H	0	-	450	734	734	1.0000000
C7	24474791	24478927	BolC7t42166H	0	-	3204	4136	4136	1.0000000
C7	24479522	24480369	BolC7t42167H	0	-	519	847	847	1.0000000
C7	24480511	24480703	BolC7t42168H	0	-	109	192	192	1.0000000
C7	24513180	24513437	BolC7t42169H	0	+	9	72	257	0.2801556
C7	24534291	24534606	BolC7t42170H	0	+	0	0	315	0.0000000
C7	24538249	24538564	BolC7t42171H	0	+	0	0	315	0.0000000
C7	24596999	24597176	BolC7t42172H	0	-	89	177	177	1.0000000
C7	24607962	24608780	BolC7t42173H	0	+	11	550	818	0.6723716
C7	24608779	24609440	BolC7t42174H	0	+	59	558	661	0.8441755
C7	24609618	24610256	BolC7t42175H	0	+	71	480	638	0.7523511
C7	24625726	24627525	BolC7t42176H	0	+	443	1762	1799	0.9794330
C7	24634057	24635193	BolC7t42177H	0	+	513	1136	1136	1.0000000
C7	24638457	24641284	BolC7t42178H	0	-	13	515	2827	0.1821719
C7	24644242	24648456	BolC7t42179H	0	+	3227	4214	4214	1.0000000
C7	24654764	24655195	BolC7t42180H	0	-	4	297	431	0.6890951
C7	24656403	24656514	BolC7t42181H	0	-	159	91	111	0.8198198
C7	24662135	24663801	BolC7t42182H	0	+	995	1666	1666	1.0000000
C7	24665213	24667230	BolC7t42183H	0	+	811	2017	2017	1.0000000
C7	24668243	24670189	BolC7t42184H	0	+	1904	1946	1946	1.0000000
C7	24670778	24671511	BolC7t42185H	0	+	182	733	733	1.0000000
C7	24672082	24672412	BolC7t42186H	0	-	100	275	330	0.8333333
C7	24684527	24686055	BolC7t42187H	0	-	1336	1528	1528	1.0000000
C7	24686683	24687875	BolC7t42188H	0	-	472	1182	1192	0.9916108
C7	24688089	24688341	BolC7t42189H	0	-	276	222	252	0.8809524
C7	24705442	24705853	BolC7t42190H	0	+	82	349	411	0.8491484
C7	24711201	24711921	BolC7t42191H	0	+	87	430	720	0.5972222
C7	24712990	24714447	BolC7t42192H	0	-	93	784	1457	0.5380920
C7	24721632	24724820	BolC7t42193H	0	-	360	2505	3188	0.7857591
C7	24737077	24737602	BolC7t42194H	0	-	718	525	525	1.0000000
C7	24757766	24758565	BolC7t42195H	0	+	662	799	799	1.0000000
C7	24762874	24763517	BolC7t42196H	0	+	591	643	643	1.0000000
C7	24765097	24765718	BolC7t42197H	0	-	0	0	621	0.0000000
C7	24766962	24768758	BolC7t42198H	0	-	0	0	1796	0.0000000
C7	24784793	24786597	BolC7t42199H	0	+	206	1312	1804	0.7272727
C7	24790239	24795922	BolC7t42200H	0	+	987	3922	5683	0.6901284
C7	24809394	24809577	BolC7t42201H	0	-	0	0	183	0.0000000
C7	24857981	24858287	BolC7t42202H	0	-	12	23	306	0.0751634
C7	24871565	24872072	BolC7t42203H	0	+	135	453	507	0.8934911
C7	24882565	24883108	BolC7t42204H	0	-	206	543	543	1.0000000
C7	24905580	24910200	BolC7t42205H	0	-	1480	4271	4620	0.9244589
C7	24941018	24941594	BolC7t42206H	0	+	483	576	576	1.0000000
C7	24942457	24942643	BolC7t42207H	0	-	203	186	186	1.0000000
C7	24945289	24945424	BolC7t42208H	0	+	19	135	135	1.0000000
C7	24968503	24972643	BolC7t42209H	0	+	1025	3044	4140	0.7352657
C7	24974503	24977652	BolC7t42210H	0	+	980	3140	3149	0.9971420
C7	24977559	24977762	BolC7t42211H	0	+	186	203	203	1.0000000
C7	24984036	24985377	BolC7t42212H	0	-	126	528	1341	0.3937360
C7	24990140	24990242	BolC7t42213H	0	+	147	102	102	1.0000000
C7	24993113	24993628	BolC7t42214H	0	-	704	515	515	1.0000000
C7	24997894	24998268	BolC7t42215H	0	+	0	0	374	0.0000000
C7	25001561	25003169	BolC7t42216H	0	+	144	1075	1608	0.6685323
C7	25010896	25012685	BolC7t42217H	0	-	1286	1755	1789	0.9809949
C7	25012762	25014879	BolC7t42218H	0	+	1820	2103	2117	0.9933869
C7	25042033	25043378	BolC7t42219H	0	+	124	806	1345	0.5992565
C7	25051157	25051904	BolC7t42220H	0	+	48	658	747	0.8808568
C7	25060116	25079937	BolC7t42221H	0	-	7961	15696	19821	0.7918874
C7	25095419	25098558	BolC7t42222H	0	+	1167	2809	3139	0.8948710
C7	25103426	25103573	BolC7t42223H	0	+	0	0	147	0.0000000
C7	25106173	25106464	BolC7t42224H	0	-	26	291	291	1.0000000
C7	25112137	25113267	BolC7t42225H	0	+	26	575	1130	0.5088496
C7	25114687	25116353	BolC7t42226H	0	-	1405	1666	1666	1.0000000
C7	25121971	25122697	BolC7t42227H	0	-	31	534	726	0.7355372
C7	25133153	25133696	BolC7t42228H	0	+	288	543	543	1.0000000
C7	25141707	25141875	BolC7t42229H	0	+	202	168	168	1.0000000
C7	25169797	25172679	BolC7t42230H	0	-	275	1178	2882	0.4087439
C7	25190166	25191675	BolC7t42231H	0	+	738	1453	1509	0.9628893
C7	25192132	25194049	BolC7t42232H	0	-	461	1724	1917	0.8993219
C7	25215227	25217123	BolC7t42233H	0	-	715	1457	1896	0.7684599
C7	25225425	25226330	BolC7t42234H	0	-	4	299	905	0.3303867
C7	25236116	25237425	BolC7t42235H	0	+	1214	1309	1309	1.0000000
C7	25238549	25243876	BolC7t42236H	0	-	3690	5237	5327	0.9831049
C7	25272197	25272437	BolC7t42237H	0	+	91	240	240	1.0000000
C7	25277272	25278266	BolC7t42238H	0	-	467	961	994	0.9668008
C7	25279714	25280690	BolC7t42239H	0	+	114	667	976	0.6834016
C7	25283366	25284926	BolC7t42240H	0	+	1436	1560	1560	1.0000000
C7	25294651	25294936	BolC7t42241H	0	-	396	285	285	1.0000000
C7	25307425	25307979	BolC7t42242H	0	-	459	554	554	1.0000000
C7	25311303	25311517	BolC7t42243H	0	+	160	214	214	1.0000000
C7	25321065	25321843	BolC7t42244H	0	-	55	596	778	0.7660668
C7	25324724	25326533	BolC7t42245H	0	-	1074	1809	1809	1.0000000
C7	25326992	25328292	BolC7t42246H	0	-	1531	1300	1300	1.0000000
C7	25329889	25332193	BolC7t42247H	0	-	786	1951	2304	0.8467882
C7	25341981	25342851	BolC7t42248H	0	+	58	482	870	0.5540230
C7	25345116	25349900	BolC7t42249H	0	-	1529	4449	4784	0.9299749
C7	25350600	25359244	BolC7t42250H	0	-	4032	6524	8644	0.7547432
C7	25362286	25365173	BolC7t42251H	0	-	1833	2841	2887	0.9840665
C7	25376329	25377127	BolC7t42252H	0	-	680	798	798	1.0000000
C7	25377388	25377556	BolC7t42253H	0	+	114	168	168	1.0000000
C7	25386080	25386447	BolC7t42254H	0	-	205	367	367	1.0000000
C7	25387144	25387775	BolC7t42255H	0	-	4	20	631	0.0316957
C7	25400939	25401481	BolC7t42256H	0	-	443	542	542	1.0000000
C7	25433360	25433678	BolC7t42257H	0	+	83	318	318	1.0000000
C7	25436557	25436995	BolC7t42258H	0	-	902	359	438	0.8196347
C7	25463874	25464558	BolC7t42259H	0	+	401	684	684	1.0000000
C7	25465472	25467027	BolC7t42260H	0	-	540	1109	1555	0.7131833
C7	25468476	25473196	BolC7t42261H	0	+	1722	4059	4720	0.8599576
C7	25473273	25473753	BolC7t42262H	0	-	201	480	480	1.0000000
C7	25474566	25475529	BolC7t42263H	0	+	792	963	963	1.0000000
C7	25481879	25482974	BolC7t42264H	0	+	418	1095	1095	1.0000000
C7	25489479	25490108	BolC7t42265H	0	-	544	629	629	1.0000000
C7	25491065	25494416	BolC7t42266H	0	+	1138	3351	3351	1.0000000
C7	25546623	25547130	BolC7t42267H	0	+	415	507	507	1.0000000
C7	25550298	25552226	BolC7t42268H	0	-	368	1811	1928	0.9393154
C7	25560146	25563243	BolC7t42269H	0	-	171	1893	3097	0.6112367
C7	25579378	25580275	BolC7t42270H	0	-	331	834	897	0.9297659
C7	25585130	25587329	BolC7t42271H	0	-	965	2122	2199	0.9649841
C7	25596293	25596452	BolC7t42272H	0	-	92	159	159	1.0000000
C7	25601771	25603581	BolC7t42273H	0	+	857	1697	1810	0.9375691
C7	25608182	25608734	BolC7t42274H	0	-	506	552	552	1.0000000
C7	25611262	25612292	BolC7t42275H	0	+	224	866	1030	0.8407767
C7	25613635	25614493	BolC7t42276H	0	-	177	858	858	1.0000000
C7	25619531	25619825	BolC7t42277H	0	-	374	294	294	1.0000000
C7	25621568	25630442	BolC7t42278H	0	-	6609	7488	8874	0.8438134
C7	25642339	25643834	BolC7t42279H	0	+	581	1318	1495	0.8816053
C7	25644414	25645078	BolC7t42280H	0	+	684	664	664	1.0000000
C7	25646214	25646835	BolC7t42281H	0	-	432	621	621	1.0000000
C7	25649369	25651103	BolC7t42282H	0	-	185	1378	1734	0.7946944
C7	25652399	25655562	BolC7t42283H	0	-	2192	3146	3163	0.9946253
C7	25655899	25657393	BolC7t42284H	0	-	765	1494	1494	1.0000000
C7	25657553	25658099	BolC7t42285H	0	+	90	546	546	1.0000000
C7	25675448	25676706	BolC7t42286H	0	+	1126	1258	1258	1.0000000
C7	25682575	25684019	BolC7t42287H	0	+	715	1435	1444	0.9937673
C7	25684778	25685796	BolC7t42288H	0	+	656	1018	1018	1.0000000
C7	25688187	25689737	BolC7t42289H	0	+	542	1550	1550	1.0000000
C7	25692519	25693942	BolC7t42290H	0	+	444	1423	1423	1.0000000
C7	25694723	25696158	BolC7t42291H	0	-	490	1330	1435	0.9268293
C7	25704687	25705764	BolC7t42292H	0	+	767	1077	1077	1.0000000
C7	25706188	25708201	BolC7t42293H	0	-	1133	1884	2013	0.9359165
C7	25711829	25712060	BolC7t42294H	0	-	375	231	231	1.0000000
C7	25713120	25716940	BolC7t42295H	0	-	1116	3565	3820	0.9332461
C7	25718449	25719361	BolC7t42296H	0	+	674	912	912	1.0000000
C7	25719728	25720799	BolC7t42297H	0	-	741	1071	1071	1.0000000
C7	25721751	25722144	BolC7t42298H	0	-	319	393	393	1.0000000
C7	25723811	25725855	BolC7t42299H	0	-	217	1296	2044	0.6340509
C7	25744817	25745593	BolC7t42300H	0	-	192	684	776	0.8814433
C7	25753317	25753653	BolC7t42301H	0	-	491	336	336	1.0000000
C7	25769837	25772569	BolC7t42302H	0	+	1365	2644	2732	0.9677892
C7	25772795	25774355	BolC7t42303H	0	-	145	1171	1560	0.7506410
C7	25797870	25798044	BolC7t42304H	0	+	0	0	174	0.0000000
C7	25798983	25799133	BolC7t42305H	0	-	0	0	150	0.0000000
C7	25807000	25807378	BolC7t42306H	0	-	30	354	378	0.9365079
C7	25814026	25814497	BolC7t42307H	0	-	123	471	471	1.0000000
C7	25815416	25821170	BolC7t42308H	0	-	2913	5621	5754	0.9768856
C7	25829094	25832115	BolC7t42309H	0	+	1188	2933	3021	0.9708706
C7	25832734	25835765	BolC7t42310H	0	+	893	2911	3031	0.9604091
C7	25835995	25836994	BolC7t42311H	0	-	1296	999	999	1.0000000
C7	25837510	25839855	BolC7t42312H	0	+	2193	2345	2345	1.0000000
C7	25843236	25845359	BolC7t42313H	0	-	361	1743	2123	0.8210080
C7	25856877	25858045	BolC7t42314H	0	+	599	1136	1168	0.9726027
C7	25858809	25859019	BolC7t42315H	0	+	279	210	210	1.0000000
C7	25863194	25864098	BolC7t42316H	0	+	640	904	904	1.0000000
C7	25871356	25872113	BolC7t42317H	0	-	515	757	757	1.0000000
C7	25871949	25872219	BolC7t42318H	0	+	240	270	270	1.0000000
C7	25888560	25889058	BolC7t42319H	0	-	0	0	498	0.0000000
C7	25898177	25898813	BolC7t42320H	0	+	794	636	636	1.0000000
C7	25904531	25905257	BolC7t42321H	0	-	327	698	726	0.9614325
C7	25906077	25918192	BolC7t42322H	0	+	6165	11968	12115	0.9878663
C7	25921569	25922292	BolC7t42323H	0	-	159	573	723	0.7925311
C7	25928325	25930742	BolC7t42324H	0	+	613	2070	2417	0.8564336
C7	25931100	25933941	BolC7t42325H	0	-	1673	2836	2841	0.9982401
C7	25938684	25938792	BolC7t42326H	0	-	31	108	108	1.0000000
C7	25939236	25941809	BolC7t42327H	0	+	941	2434	2573	0.9459774
C7	25942435	25944981	BolC7t42328H	0	-	1317	2546	2546	1.0000000
C7	25946645	25947005	BolC7t42329H	0	+	5	96	360	0.2666667
C7	25950018	25951275	BolC7t42330H	0	+	163	892	1257	0.7096261
C7	25960291	25960658	BolC7t42331H	0	+	6	56	367	0.1525886
C7	25981870	25984036	BolC7t42332H	0	+	397	2006	2166	0.9261311
C7	25985659	25985914	BolC7t42333H	0	-	152	255	255	1.0000000
C7	25990428	25991328	BolC7t42334H	0	-	15	495	900	0.5500000
C7	26014598	26014805	BolC7t42335H	0	+	201	207	207	1.0000000
C7	26015647	26016202	BolC7t42336H	0	-	62	490	555	0.8828829
C7	26017565	26018207	BolC7t42337H	0	-	53	317	642	0.4937695
C7	26034218	26037115	BolC7t42338H	0	+	202	2305	2897	0.7956507
C7	26037570	26037822	BolC7t42339H	0	+	0	0	252	0.0000000
C7	26039190	26039573	BolC7t42340H	0	-	11	299	383	0.7806789
C7	26051180	26054863	BolC7t42341H	0	-	172	2732	3683	0.7417866
C7	26059922	26062678	BolC7t42342H	0	+	78	719	2756	0.2608853
C7	26076719	26079284	BolC7t42343H	0	+	1036	2405	2565	0.9376218
C7	26079775	26082749	BolC7t42344H	0	-	1499	2974	2974	1.0000000
C7	26090895	26097440	BolC7t42345H	0	-	7628	6540	6545	0.9992360
C7	26097539	26099292	BolC7t42346H	0	-	686	1720	1753	0.9811751
C7	26107453	26108639	BolC7t42347H	0	+	261	1186	1186	1.0000000
C7	26123778	26124924	BolC7t42348H	0	+	330	902	1146	0.7870855
C7	26125560	26126983	BolC7t42349H	0	-	998	1423	1423	1.0000000
C7	26130061	26130305	BolC7t42350H	0	+	65	244	244	1.0000000
C7	26141622	26141814	BolC7t42351H	0	-	111	192	192	1.0000000
C7	26143687	26143885	BolC7t42352H	0	+	206	198	198	1.0000000
C7	26146089	26146484	BolC7t42353H	0	-	383	395	395	1.0000000
C7	26153116	26153355	BolC7t42354H	0	-	239	239	239	1.0000000
C7	26172082	26173667	BolC7t42355H	0	+	1194	1585	1585	1.0000000
C7	26184702	26187446	BolC7t42356H	0	+	927	2460	2744	0.8965015
C7	26188349	26188889	BolC7t42357H	0	+	335	538	540	0.9962963
C7	26190596	26190818	BolC7t42358H	0	-	46	222	222	1.0000000
C7	26196963	26198639	BolC7t42359H	0	+	469	1676	1676	1.0000000
C7	26200816	26201306	BolC7t42360H	0	-	219	490	490	1.0000000
C7	26212481	26212721	BolC7t42361H	0	+	240	240	240	1.0000000
C7	26218152	26218476	BolC7t42362H	0	+	293	324	324	1.0000000
C7	26254399	26254702	BolC7t42363H	0	+	212	303	303	1.0000000
C7	26257547	26259401	BolC7t42364H	0	-	1154	1854	1854	1.0000000
C7	26275533	26276895	BolC7t42365H	0	+	824	1344	1362	0.9867842
C7	26285003	26286557	BolC7t42366H	0	+	1780	1554	1554	1.0000000
C7	26296126	26297793	BolC7t42367H	0	-	1548	1667	1667	1.0000000
C7	26307671	26309774	BolC7t42368H	0	-	539	1836	2103	0.8730385
C7	26310722	26311290	BolC7t42369H	0	+	2	58	568	0.1021127
C7	26320164	26321043	BolC7t42370H	0	-	365	879	879	1.0000000
C7	26337480	26337720	BolC7t42371H	0	-	217	240	240	1.0000000
C7	26349721	26349922	BolC7t42372H	0	-	100	201	201	1.0000000
C7	26359676	26359946	BolC7t42373H	0	+	0	0	270	0.0000000
C7	26389666	26391012	BolC7t42374H	0	-	33	831	1346	0.6173849
C7	26399457	26400169	BolC7t42375H	0	+	86	589	712	0.8272472
C7	26416942	26425044	BolC7t42376H	0	-	2566	7166	8102	0.8844730
C7	26432069	26432546	BolC7t42377H	0	-	82	477	477	1.0000000
C7	26435176	26435702	BolC7t42378H	0	-	109	526	526	1.0000000
C7	26446182	26448075	BolC7t42379H	0	+	1352	1893	1893	1.0000000
C7	26451706	26452051	BolC7t42380H	0	+	9	126	345	0.3652174
C7	26458855	26459125	BolC7t42381H	0	+	5	129	270	0.4777778
C7	26464863	26465696	BolC7t42382H	0	-	1156	833	833	1.0000000
C7	26488607	26489957	BolC7t42383H	0	-	180	1152	1350	0.8533334
C7	26504324	26504627	BolC7t42384H	0	-	14	197	303	0.6501650
C7	26516964	26519774	BolC7t42385H	0	+	1789	2810	2810	1.0000000
C7	26522138	26523596	BolC7t42386H	0	-	303	1231	1458	0.8443072
C7	26538352	26538532	BolC7t42387H	0	+	5	131	180	0.7277778
C7	26539169	26540055	BolC7t42388H	0	-	4	252	886	0.2844244
C7	26541055	26541412	BolC7t42389H	0	+	376	357	357	1.0000000
C7	26547668	26549095	BolC7t42390H	0	+	692	1427	1427	1.0000000
C7	26559354	26561306	BolC7t42391H	0	+	1909	1952	1952	1.0000000
C7	26577627	26579026	BolC7t42392H	0	+	611	1399	1399	1.0000000
C7	26585857	26586320	BolC7t42393H	0	+	216	463	463	1.0000000
C7	26586306	26586520	BolC7t42394H	0	+	59	214	214	1.0000000
C7	26586379	26586590	BolC7t42395H	0	+	52	211	211	1.0000000
C7	26588350	26588691	BolC7t42396H	0	+	0	0	341	0.0000000
C7	26595141	26596820	BolC7t42397H	0	-	1142	1590	1679	0.9469923
C7	26597242	26600897	BolC7t42398H	0	-	2220	3463	3655	0.9474692
C7	26601346	26604119	BolC7t42399H	0	-	2106	2773	2773	1.0000000
C7	26616031	26621081	BolC7t42400H	0	+	1556	4610	5050	0.9128713
C7	26639331	26639679	BolC7t42401H	0	-	506	348	348	1.0000000
C7	26644550	26644985	BolC7t42402H	0	+	0	0	435	0.0000000
C7	26647819	26649295	BolC7t42403H	0	+	13	374	1476	0.2533875
C7	26654567	26654954	BolC7t42404H	0	+	349	387	387	1.0000000
C7	26665253	26665784	BolC7t42405H	0	-	374	531	531	1.0000000
C7	26668483	26668985	BolC7t42406H	0	-	44	502	502	1.0000000
C7	26671476	26672729	BolC7t42407H	0	+	4	150	1253	0.1197127
C7	26687160	26687582	BolC7t42408H	0	-	242	422	422	1.0000000
C7	26688028	26688256	BolC7t42409H	0	+	215	228	228	1.0000000
C7	26704861	26705593	BolC7t42410H	0	-	556	732	732	1.0000000
C7	26705824	26706128	BolC7t42411H	0	-	193	304	304	1.0000000
C7	26711313	26711577	BolC7t42412H	0	+	10	37	264	0.1401515
C7	26711663	26712430	BolC7t42413H	0	+	146	727	767	0.9478487
C7	26714697	26718102	BolC7t42414H	0	-	78	739	3405	0.2170338
C7	26724329	26725338	BolC7t42415H	0	-	594	1009	1009	1.0000000
C7	26728314	26730380	BolC7t42416H	0	-	25	598	2066	0.2894482
C7	26734501	26734892	BolC7t42417H	0	-	138	391	391	1.0000000
C7	26747143	26748214	BolC7t42418H	0	-	459	1071	1071	1.0000000
C7	26751801	26752338	BolC7t42419H	0	-	19	275	537	0.5121043
C7	26754251	26755016	BolC7t42420H	0	-	113	753	765	0.9843137
C7	26758087	26758441	BolC7t42421H	0	-	113	354	354	1.0000000
C7	26759952	26760186	BolC7t42422H	0	-	26	234	234	1.0000000
C7	26762223	26765159	BolC7t42423H	0	-	1095	2936	2936	1.0000000
C7	26766729	26769650	BolC7t42424H	0	+	1318	2745	2921	0.9397467
C7	26770085	26780345	BolC7t42425H	0	-	4923	9851	10260	0.9601365
C7	26789407	26789854	BolC7t42426H	0	+	78	447	447	1.0000000
C7	26790390	26791010	BolC7t42427H	0	+	28	583	620	0.9403226
C7	26807090	26807404	BolC7t42428H	0	-	356	314	314	1.0000000
C7	26811575	26812010	BolC7t42429H	0	+	735	435	435	1.0000000
C7	26813199	26814228	BolC7t42430H	0	-	759	1029	1029	1.0000000
C7	26816279	26819095	BolC7t42431H	0	-	739	2688	2816	0.9545454
C7	26819831	26819972	BolC7t42432H	0	+	67	141	141	1.0000000
C7	26841032	26842845	BolC7t42433H	0	-	321	1249	1813	0.6889134
C7	26844364	26845038	BolC7t42434H	0	+	194	465	674	0.6899110
C7	26863259	26863367	BolC7t42435H	0	+	8	5	108	0.0462963
C7	26883460	26887060	BolC7t42436H	0	+	309	800	3600	0.2222222
C7	26889731	26890687	BolC7t42437H	0	-	37	545	956	0.5700837
C7	26898416	26898596	BolC7t42438H	0	-	282	180	180	1.0000000
C7	26927271	26927469	BolC7t42439H	0	-	12	176	198	0.8888889
C7	26927558	26928739	BolC7t42440H	0	-	278	1113	1181	0.9424217
C7	26965784	26970184	BolC7t42441H	0	+	22	822	4400	0.1868182
C7	26980755	26980920	BolC7t42442H	0	+	1	4	165	0.0242424
C7	26988499	26989289	BolC7t42443H	0	+	0	0	790	0.0000000
C7	26994355	26994947	BolC7t42444H	0	-	158	312	592	0.5270270
C7	27004199	27005116	BolC7t42445H	0	+	5	313	917	0.3413304
C7	27011946	27012338	BolC7t42446H	0	-	0	0	392	0.0000000
C7	27025960	27026535	BolC7t42447H	0	+	28	30	575	0.0521739
C7	27028472	27032827	BolC7t42448H	0	+	146	885	4355	0.2032147
C7	27040320	27041883	BolC7t42449H	0	+	319	1027	1563	0.6570697
C7	27059905	27060695	BolC7t42450H	0	+	0	0	790	0.0000000
C7	27074658	27075836	BolC7t42451H	0	+	0	0	1178	0.0000000
C7	27077434	27077919	BolC7t42452H	0	-	0	0	485	0.0000000
C7	27078005	27078266	BolC7t42453H	0	-	0	0	261	0.0000000
C7	27090909	27092204	BolC7t42454H	0	-	1280	1238	1295	0.9559845
C7	27111719	27111833	BolC7t42455H	0	+	2	14	114	0.1228070
C7	27124288	27124580	BolC7t42456H	0	+	7	177	292	0.6061644
C7	27125645	27126458	BolC7t42457H	0	+	767	789	813	0.9704797
C7	27126773	27128144	BolC7t42458H	0	-	737	1371	1371	1.0000000
C7	27131995	27132820	BolC7t42459H	0	+	592	825	825	1.0000000
C7	27137866	27148123	BolC7t42460H	0	+	3439	8490	10257	0.8277274
C7	27150378	27151136	BolC7t42461H	0	-	22	425	758	0.5606860
C7	27156763	27157804	BolC7t42462H	0	+	1051	1041	1041	1.0000000
C7	27158241	27158733	BolC7t42463H	0	+	445	492	492	1.0000000
C7	27162413	27162551	BolC7t42464H	0	+	80	138	138	1.0000000
C7	27163680	27164952	BolC7t42465H	0	+	108	1024	1272	0.8050314
C7	27165569	27168545	BolC7t42466H	0	-	1318	2731	2976	0.9176747
C7	27189842	27200713	BolC7t42467H	0	+	7981	10871	10871	1.0000000
C7	27215853	27220382	BolC7t42468H	0	+	2187	4434	4529	0.9790241
C7	27221025	27221488	BolC7t42469H	0	+	245	463	463	1.0000000
C7	27229809	27237910	BolC7t42470H	0	-	678	4426	8101	0.5463523
C7	27242644	27243178	BolC7t42471H	0	-	360	534	534	1.0000000
C7	27243852	27244817	BolC7t42472H	0	-	427	965	965	1.0000000
C7	27245220	27246451	BolC7t42473H	0	+	674	1231	1231	1.0000000
C7	27247479	27248764	BolC7t42474H	0	+	1298	1285	1285	1.0000000
C7	27251097	27251553	BolC7t42475H	0	+	38	400	456	0.8771930
C7	27256954	27257410	BolC7t42476H	0	+	606	398	456	0.8728070
C7	27261317	27262217	BolC7t42477H	0	-	891	900	900	1.0000000
C7	27266351	27267005	BolC7t42478H	0	-	107	634	654	0.9694189
C7	27267480	27269783	BolC7t42479H	0	-	676	1996	2303	0.8666956
C7	27294044	27294421	BolC7t42480H	0	-	81	377	377	1.0000000
C7	27294656	27294791	BolC7t42481H	0	-	28	135	135	1.0000000
C7	27302609	27303711	BolC7t42482H	0	-	82	924	1102	0.8384755
C7	27303934	27304788	BolC7t42483H	0	-	312	854	854	1.0000000
C7	27307169	27307753	BolC7t42484H	0	-	551	584	584	1.0000000
C7	27319008	27326661	BolC7t42485H	0	+	1017	5370	7653	0.7016856
C7	27420727	27422203	BolC7t42486H	0	-	1180	1476	1476	1.0000000
C7	27427126	27428646	BolC7t42487H	0	-	1061	1520	1520	1.0000000
C7	27457787	27458428	BolC7t42488H	0	+	154	495	641	0.7722309
C7	27489686	27490597	BolC7t42489H	0	+	130	910	911	0.9989023
C7	27506728	27507156	BolC7t42490H	0	+	425	428	428	1.0000000
C7	27520992	27522141	BolC7t42491H	0	-	357	1149	1149	1.0000000
C7	27558758	27559278	BolC7t42492H	0	+	894	520	520	1.0000000
C7	27559823	27562302	BolC7t42493H	0	+	3049	2435	2479	0.9822509
C7	27582951	27585701	BolC7t42494H	0	+	428	2212	2750	0.8043636
C7	27598707	27600075	BolC7t42495H	0	+	409	1368	1368	1.0000000
C7	27608967	27610453	BolC7t42496H	0	-	232	1486	1486	1.0000000
C7	27609897	27610218	BolC7t42497H	0	-	58	321	321	1.0000000
C7	27616651	27617041	BolC7t42498H	0	-	311	390	390	1.0000000
C7	27618324	27618642	BolC7t42499H	0	-	158	318	318	1.0000000
C7	27625241	27626695	BolC7t42500H	0	+	677	1255	1454	0.8631362
C7	27626038	27626353	BolC7t42501H	0	-	399	315	315	1.0000000
C7	27628458	27629879	BolC7t42502H	0	+	546	1275	1421	0.8972555
C7	27629931	27630567	BolC7t42503H	0	+	15	208	636	0.3270440
C7	27635166	27638109	BolC7t42504H	0	-	273	1736	2943	0.5898743
C7	27641745	27642039	BolC7t42505H	0	-	148	294	294	1.0000000
C7	27644283	27644526	BolC7t42506H	0	+	26	208	243	0.8559671
C7	27649174	27649852	BolC7t42507H	0	+	507	678	678	1.0000000
C7	27652447	27655965	BolC7t42508H	0	+	595	2698	3518	0.7669130
C7	27656114	27660042	BolC7t42509H	0	-	1892	3110	3928	0.7917515
C7	27665768	27670219	BolC7t42510H	0	-	2086	3587	4451	0.8058863
C7	27695579	27695926	BolC7t42511H	0	+	13	261	347	0.7521614
C7	27696254	27697419	BolC7t42512H	0	-	175	699	1165	0.6000000
C7	27697819	27702922	BolC7t42513H	0	-	1425	4080	5103	0.7995297
C7	27704803	27706591	BolC7t42514H	0	-	511	1617	1788	0.9043624
C7	27706673	27707789	BolC7t42515H	0	-	270	975	1116	0.8736559
C7	27717394	27719738	BolC7t42516H	0	+	557	2070	2344	0.8831058
C7	27721073	27722247	BolC7t42517H	0	+	590	1120	1174	0.9540034
C7	27725319	27727316	BolC7t42518H	0	-	274	971	1997	0.4862293
C7	27727960	27730681	BolC7t42519H	0	+	1053	2700	2721	0.9922823
C7	27731894	27735066	BolC7t42520H	0	+	857	2987	3172	0.9416772
C7	27736154	27736743	BolC7t42521H	0	+	233	589	589	1.0000000
C7	27741207	27741566	BolC7t42522H	0	+	208	359	359	1.0000000
C7	27742460	27744653	BolC7t42523H	0	+	1541	2193	2193	1.0000000
C7	27747884	27749033	BolC7t42524H	0	+	145	901	1149	0.7841601
C7	27750373	27751808	BolC7t42525H	0	+	1227	1435	1435	1.0000000
C7	27759970	27760447	BolC7t42526H	0	+	9	303	477	0.6352201
C7	27766539	27767791	BolC7t42527H	0	+	532	1230	1252	0.9824281
C7	27771112	27772209	BolC7t42528H	0	-	583	1097	1097	1.0000000
C7	27775349	27777078	BolC7t42529H	0	+	591	1729	1729	1.0000000
C7	27784372	27786329	BolC7t42530H	0	-	213	1739	1957	0.8886050
C7	27791449	27792186	BolC7t42531H	0	+	33	334	737	0.4531886
C7	27794962	27795166	BolC7t42532H	0	-	6	170	204	0.8333333
C7	27797553	27799588	BolC7t42533H	0	-	36	1128	2035	0.5542998
C7	27803521	27803948	BolC7t42534H	0	+	0	0	427	0.0000000
C7	27823332	27824618	BolC7t42535H	0	+	1844	1286	1286	1.0000000
C7	27827377	27828584	BolC7t42536H	0	+	910	1207	1207	1.0000000
C7	27839110	27839996	BolC7t42537H	0	+	568	886	886	1.0000000
C7	27844196	27849797	BolC7t42538H	0	-	1109	5107	5601	0.9118015
C7	27850624	27851692	BolC7t42539H	0	+	1061	1068	1068	1.0000000
C7	27858316	27858933	BolC7t42540H	0	-	1062	617	617	1.0000000
C7	27860537	27861673	BolC7t42541H	0	+	1003	1136	1136	1.0000000
C7	27862066	27862186	BolC7t42542H	0	+	154	120	120	1.0000000
C7	27876020	27876654	BolC7t42543H	0	+	535	634	634	1.0000000
C7	27880935	27882081	BolC7t42544H	0	+	325	1146	1146	1.0000000
C7	27882279	27883276	BolC7t42545H	0	-	345	997	997	1.0000000
C7	27886608	27887144	BolC7t42546H	0	-	114	480	536	0.8955224
C7	27888553	27890861	BolC7t42547H	0	-	1180	2119	2308	0.9181109
C7	27891839	27893237	BolC7t42548H	0	+	726	1398	1398	1.0000000
C7	27893709	27894248	BolC7t42549H	0	-	118	523	539	0.9703154
C7	27895544	27897509	BolC7t42550H	0	-	912	1830	1965	0.9312977
C7	27897601	27901734	BolC7t42551H	0	-	3041	4133	4133	1.0000000
C7	27930186	27930894	BolC7t42552H	0	-	411	708	708	1.0000000
C7	27943128	27943299	BolC7t42553H	0	-	232	171	171	1.0000000
C7	27943467	27943719	BolC7t42554H	0	-	358	252	252	1.0000000
C7	27956259	27960612	BolC7t42555H	0	+	742	3004	4353	0.6900988
C7	27961240	27962967	BolC7t42556H	0	-	856	1727	1727	1.0000000
C7	27963406	27971129	BolC7t42557H	0	+	1127	6366	7723	0.8242911
C7	27971881	27995004	BolC7t42558H	0	+	3995	17455	23123	0.7548761
C7	27998707	27999896	BolC7t42559H	0	+	128	667	1189	0.5609756
C7	28018889	28020392	BolC7t42560H	0	-	478	1503	1503	1.0000000
C7	28022563	28023115	BolC7t42561H	0	-	33	326	552	0.5905797
C7	28025030	28026758	BolC7t42562H	0	-	628	1508	1728	0.8726852
C7	28029353	28031568	BolC7t42563H	0	-	1380	2215	2215	1.0000000
C7	28034786	28036929	BolC7t42564H	0	-	1036	2138	2143	0.9976668
C7	28036954	28039541	BolC7t42565H	0	-	1358	2587	2587	1.0000000
C7	28050357	28050555	BolC7t42566H	0	-	20	136	198	0.6868687
C7	28051492	28051690	BolC7t42567H	0	-	118	198	198	1.0000000
C7	28055946	28057582	BolC7t42568H	0	-	307	1288	1636	0.7872860
C7	28059649	28060120	BolC7t42569H	0	-	112	471	471	1.0000000
C7	28061572	28062070	BolC7t42570H	0	+	84	468	498	0.9397590
C7	28075489	28083032	BolC7t42571H	0	+	1227	3198	7543	0.4239692
C7	28084214	28084655	BolC7t42572H	0	-	104	441	441	1.0000000
C7	28085938	28086840	BolC7t42573H	0	+	916	902	902	1.0000000
C7	28087524	28089078	BolC7t42574H	0	+	367	1446	1554	0.9305019
C7	28089512	28096707	BolC7t42575H	0	-	2453	6863	7195	0.9538568
C7	28097116	28098695	BolC7t42576H	0	-	1240	1579	1579	1.0000000
C7	28106328	28106964	BolC7t42577H	0	+	303	616	636	0.9685535
C7	28163350	28163713	BolC7t42578H	0	-	142	363	363	1.0000000
C7	28165740	28173825	BolC7t42579H	0	-	2465	6483	8085	0.8018553
C7	28169846	28170612	BolC7t42580H	0	-	278	766	766	1.0000000
C7	28186943	28211450	BolC7t42581H	0	+	9061	16839	24507	0.6871098
C7	28218768	28219330	BolC7t42582H	0	-	1077	562	562	1.0000000
C7	28237083	28242419	BolC7t42583H	0	-	1197	2608	5336	0.4887556
C7	28244851	28244980	BolC7t42584H	0	+	72	129	129	1.0000000
C7	28245386	28245876	BolC7t42585H	0	+	133	490	490	1.0000000
C7	28253404	28253986	BolC7t42586H	0	-	8	301	582	0.5171821
C7	28255170	28255419	BolC7t42587H	0	-	40	249	249	1.0000000
C7	28266942	28267535	BolC7t42588H	0	-	869	593	593	1.0000000
C7	28269660	28270201	BolC7t42589H	0	-	476	541	541	1.0000000
C7	28289564	28291458	BolC7t42590H	0	+	1288	1894	1894	1.0000000
C7	28292319	28292665	BolC7t42591H	0	+	128	346	346	1.0000000
C7	28302533	28302725	BolC7t42592H	0	-	229	192	192	1.0000000
C7	28303537	28303852	BolC7t42593H	0	-	280	315	315	1.0000000
C7	28304836	28305303	BolC7t42594H	0	-	458	467	467	1.0000000
C7	28324152	28324571	BolC7t42595H	0	+	417	419	419	1.0000000
C7	28354803	28367659	BolC7t42596H	0	+	3827	9756	12856	0.7588674
C7	28372961	28375432	BolC7t42597H	0	+	430	1797	2471	0.7272359
C7	28393783	28394026	BolC7t42598H	0	+	623	243	243	1.0000000
C7	28403306	28403690	BolC7t42599H	0	+	240	384	384	1.0000000
C7	28403759	28404924	BolC7t42600H	0	+	207	561	1165	0.4815451
C7	28406535	28406643	BolC7t42601H	0	+	40	108	108	1.0000000
C7	28420276	28420791	BolC7t42602H	0	-	737	515	515	1.0000000
C7	28426918	28427545	BolC7t42603H	0	+	140	627	627	1.0000000
C7	28435366	28436188	BolC7t42604H	0	-	2009	822	822	1.0000000
C7	28440465	28440900	BolC7t42605H	0	-	211	435	435	1.0000000
C7	28443253	28445458	BolC7t42606H	0	-	592	2124	2205	0.9632653
C7	28453898	28454285	BolC7t42607H	0	-	76	353	387	0.9121447
C7	28459850	28460484	BolC7t42608H	0	-	80	427	634	0.6735016
C7	28471066	28471824	BolC7t42609H	0	-	4	55	758	0.0725594
C7	28476244	28476712	BolC7t42610H	0	+	159	468	468	1.0000000
C7	28483927	28485581	BolC7t42611H	0	+	1339	1654	1654	1.0000000
C7	28499723	28508891	BolC7t42612H	0	+	2544	7404	9168	0.8075916
C7	28509862	28512095	BolC7t42613H	0	-	1121	2141	2233	0.9587998
C7	28517936	28519616	BolC7t42614H	0	-	857	1610	1680	0.9583333
C7	28532504	28532864	BolC7t42615H	0	-	258	360	360	1.0000000
C7	28546164	28546561	BolC7t42616H	0	-	27	252	397	0.6347607
C7	28548411	28550233	BolC7t42617H	0	+	1389	1822	1822	1.0000000
C7	28550628	28551405	BolC7t42618H	0	-	240	706	777	0.9086229
C7	28552764	28553220	BolC7t42619H	0	+	654	456	456	1.0000000
C7	28553756	28555062	BolC7t42620H	0	-	1101	1306	1306	1.0000000
C7	28557396	28557787	BolC7t42621H	0	+	77	391	391	1.0000000
C7	28583624	28584017	BolC7t42622H	0	-	193	393	393	1.0000000
C7	28584527	28584692	BolC7t42623H	0	-	182	165	165	1.0000000
C7	28584826	28585188	BolC7t42624H	0	-	346	362	362	1.0000000
C7	28586287	28588241	BolC7t42625H	0	+	745	1850	1954	0.9467759
C7	28588439	28589123	BolC7t42626H	0	-	403	684	684	1.0000000
C7	28632289	28635616	BolC7t42627H	0	+	703	2339	3327	0.7030358
C7	28639209	28640486	BolC7t42628H	0	+	263	1276	1277	0.9992169
C7	28640695	28644138	BolC7t42629H	0	-	1477	3422	3443	0.9939007
C7	28645801	28647224	BolC7t42630H	0	+	17	569	1423	0.3998595
C7	28674190	28675202	BolC7t42631H	0	-	429	1012	1012	1.0000000
C7	28698122	28703202	BolC7t42632H	0	+	1051	3972	5080	0.7818897
C7	28712315	28713584	BolC7t42633H	0	+	163	1150	1269	0.9062254
C7	28713910	28714384	BolC7t42634H	0	-	24	189	474	0.3987342
C7	28740223	28742313	BolC7t42635H	0	+	133	371	2090	0.1775120
C7	28745889	28746541	BolC7t42636H	0	-	2	8	652	0.0122699
C7	28750865	28756034	BolC7t42637H	0	+	1024	4057	5169	0.7848713
C7	28756300	28756769	BolC7t42638H	0	+	435	469	469	1.0000000
C7	28766314	28767649	BolC7t42639H	0	+	484	1312	1335	0.9827715
C7	28773275	28774561	BolC7t42640H	0	-	199	704	1286	0.5474339
C7	28807016	28809761	BolC7t42641H	0	+	769	2083	2745	0.7588342
C7	28833452	28834223	BolC7t42642H	0	+	18	528	771	0.6848249
C7	28837430	28837571	BolC7t42643H	0	-	116	141	141	1.0000000
C7	28838174	28838414	BolC7t42644H	0	+	259	240	240	1.0000000
C7	28842349	28842541	BolC7t42645H	0	+	2	30	192	0.1562500
C7	28842700	28843336	BolC7t42646H	0	-	2	180	636	0.2830189
C7	28852727	28853024	BolC7t42647H	0	+	90	213	297	0.7171717
C7	28858767	28860429	BolC7t42648H	0	+	818	1662	1662	1.0000000
C7	28870285	28871356	BolC7t42649H	0	-	427	1071	1071	1.0000000
C7	28873546	28874821	BolC7t42650H	0	-	709	1275	1275	1.0000000
C7	28875867	28876110	BolC7t42651H	0	-	210	243	243	1.0000000
C7	28878269	28878374	BolC7t42652H	0	+	19	105	105	1.0000000
C7	28883603	28884671	BolC7t42653H	0	-	609	1068	1068	1.0000000
C7	28885164	28889387	BolC7t42654H	0	-	1538	2596	4223	0.6147289
C7	28890596	28891478	BolC7t42655H	0	+	495	882	882	1.0000000
C7	28891521	28896438	BolC7t42656H	0	+	3049	4681	4917	0.9520032
C7	28905348	28906175	BolC7t42657H	0	+	1209	827	827	1.0000000
C7	28908610	28908992	BolC7t42658H	0	+	0	0	382	0.0000000
C7	28920390	28921305	BolC7t42659H	0	+	2	167	915	0.1825137
C7	28923180	28923399	BolC7t42660H	0	-	328	219	219	1.0000000
C7	28928474	28930094	BolC7t42661H	0	+	1258	1620	1620	1.0000000
C7	28930646	28931890	BolC7t42662H	0	-	516	1191	1244	0.9573955
C7	28942621	28942879	BolC7t42663H	0	+	2	78	258	0.3023256
C7	28950630	28952424	BolC7t42664H	0	+	171	1060	1794	0.5908584
C7	28959845	28960832	BolC7t42665H	0	-	572	987	987	1.0000000
C7	28992532	28998563	BolC7t42666H	0	+	2203	5305	6031	0.8796220
C7	29003154	29005373	BolC7t42667H	0	+	2455	2219	2219	1.0000000
C7	29027670	29029774	BolC7t42668H	0	-	581	1986	2104	0.9439163
C7	29034756	29034966	BolC7t42669H	0	-	277	210	210	1.0000000
C7	29037897	29038911	BolC7t42670H	0	-	491	1014	1014	1.0000000
C7	29043078	29046933	BolC7t42671H	0	+	1823	3855	3855	1.0000000
C7	29047877	29049211	BolC7t42672H	0	-	928	1334	1334	1.0000000
C7	29051431	29051809	BolC7t42673H	0	+	360	378	378	1.0000000
C7	29052807	29053498	BolC7t42674H	0	-	134	665	691	0.9623734
C7	29065575	29067719	BolC7t42675H	0	-	1219	1953	2144	0.9109142
C7	29086555	29086864	BolC7t42676H	0	+	65	309	309	1.0000000
C7	29088382	29088759	BolC7t42677H	0	-	0	0	377	0.0000000
C7	29090579	29091077	BolC7t42678H	0	-	113	290	498	0.5823293
C7	29096160	29097117	BolC7t42679H	0	-	544	957	957	1.0000000
C7	29145136	29145311	BolC7t42680H	0	-	11	147	175	0.8400000
C7	29146926	29148588	BolC7t42681H	0	-	686	1609	1662	0.9681107
C7	29156581	29156867	BolC7t42682H	0	-	115	241	286	0.8426573
C7	29158871	29161071	BolC7t42683H	0	+	520	1969	2200	0.8950000
C7	29162772	29162955	BolC7t42684H	0	-	130	183	183	1.0000000
C7	29164040	29165646	BolC7t42685H	0	+	189	601	1606	0.3742217
C7	29167151	29167857	BolC7t42686H	0	+	45	249	706	0.3526912
C7	29167954	29169046	BolC7t42687H	0	+	94	611	1092	0.5595238
C7	29175172	29183804	BolC7t42688H	0	-	390	2925	8632	0.3388554
C7	29192441	29192555	BolC7t42689H	0	-	4	89	114	0.7807018
C7	29198577	29198679	BolC7t42690H	0	-	0	0	102	0.0000000
C7	29198987	29199326	BolC7t42691H	0	-	1	2	339	0.0058997
C7	29203278	29203392	BolC7t42692H	0	-	0	0	114	0.0000000
C7	29215653	29221283	BolC7t42693H	0	+	716	2064	5630	0.3666075
C7	29228465	29229250	BolC7t42694H	0	-	6	43	785	0.0547771
C7	29254846	29256970	BolC7t42695H	0	+	941	1506	2124	0.7090396
C7	29263261	29264785	BolC7t42696H	0	-	327	1524	1524	1.0000000
C7	29265578	29265938	BolC7t42697H	0	+	586	360	360	1.0000000
C7	29282836	29286674	BolC7t42698H	0	-	175	736	3838	0.1917665
C7	29299039	29301023	BolC7t42699H	0	+	144	1633	1984	0.8230847
C7	29307382	29308642	BolC7t42700H	0	-	51	936	1260	0.7428572
C7	29332848	29336054	BolC7t42701H	0	+	1430	3135	3206	0.9778540
C7	29358205	29359561	BolC7t42702H	0	+	192	1135	1356	0.8370206
C7	29363911	29365217	BolC7t42703H	0	+	960	1306	1306	1.0000000
C7	29365674	29365785	BolC7t42704H	0	-	146	111	111	1.0000000
C7	29365931	29368834	BolC7t42705H	0	-	1653	2903	2903	1.0000000
C7	29386109	29386883	BolC7t42706H	0	-	451	774	774	1.0000000
C7	29393949	29394765	BolC7t42707H	0	-	353	816	816	1.0000000
C7	29394818	29395346	BolC7t42708H	0	-	394	528	528	1.0000000
C7	29412080	29413634	BolC7t42709H	0	+	1356	1554	1554	1.0000000
C7	29416704	29426902	BolC7t42710H	0	+	145	3040	10198	0.2980977
C7	29448772	29451785	BolC7t42711H	0	+	690	2543	3013	0.8440093
C7	29452309	29452561	BolC7t42712H	0	+	473	252	252	1.0000000
C7	29453360	29453942	BolC7t42713H	0	-	590	567	582	0.9742268
C7	29460753	29462108	BolC7t42714H	0	+	109	887	1355	0.6546125
C7	29463835	29464186	BolC7t42715H	0	+	227	351	351	1.0000000
C7	29467388	29469937	BolC7t42716H	0	+	1976	2549	2549	1.0000000
C7	29470889	29471003	BolC7t42717H	0	-	262	114	114	1.0000000
C7	29476043	29476715	BolC7t42718H	0	-	130	605	672	0.9002976
C7	29518158	29519194	BolC7t42719H	0	+	0	0	1036	0.0000000
C7	29521667	29521984	BolC7t42720H	0	-	0	0	317	0.0000000
C7	29523634	29524174	BolC7t42721H	0	-	5	50	540	0.0925926
C7	29546327	29548672	BolC7t42722H	0	+	172	1545	2345	0.6588486
C7	29556034	29556772	BolC7t42723H	0	-	34	555	738	0.7520325
C7	29595823	29596573	BolC7t42724H	0	+	537	750	750	1.0000000
C7	29621109	29622199	BolC7t42725H	0	+	253	1026	1090	0.9412844
C7	29625166	29625812	BolC7t42726H	0	-	0	0	646	0.0000000
C7	29636284	29636907	BolC7t42727H	0	-	430	623	623	1.0000000
C7	29642418	29644872	BolC7t42728H	0	-	1118	2382	2454	0.9706602
C7	29645608	29645779	BolC7t42729H	0	-	297	171	171	1.0000000
C7	29646072	29647351	BolC7t42730H	0	-	898	1271	1279	0.9937451
C7	29648640	29649261	BolC7t42731H	0	-	530	621	621	1.0000000
C7	29650176	29652827	BolC7t42732H	0	-	2167	2651	2651	1.0000000
C7	29655425	29656348	BolC7t42733H	0	-	890	923	923	1.0000000
C7	29658451	29664075	BolC7t42734H	0	-	1696	5269	5624	0.9368777
C7	29683720	29683930	BolC7t42735H	0	+	4	96	210	0.4571429
C7	29707236	29707452	BolC7t42736H	0	+	217	216	216	1.0000000
C7	29718180	29718390	BolC7t42737H	0	+	10	209	210	0.9952381
C7	29732961	29733778	BolC7t42738H	0	+	20	385	817	0.4712362
C7	29740819	29741342	BolC7t42739H	0	-	30	516	523	0.9866157
C7	29742530	29742641	BolC7t42740H	0	+	103	111	111	1.0000000
C7	29744454	29744583	BolC7t42741H	0	+	301	129	129	1.0000000
C7	29770900	29771956	BolC7t42742H	0	+	395	1056	1056	1.0000000
C7	29777389	29777764	BolC7t42743H	0	+	12	348	375	0.9280000
C7	29784077	29786497	BolC7t42744H	0	-	1089	2388	2420	0.9867769
C7	29796854	29797478	BolC7t42745H	0	+	125	624	624	1.0000000
C7	29825663	29826416	BolC7t42746H	0	+	98	699	753	0.9282869
C7	29838915	29840327	BolC7t42747H	0	-	802	1382	1412	0.9787536
C7	29846857	29848267	BolC7t42748H	0	+	653	1398	1410	0.9914894
C7	29849725	29850434	BolC7t42749H	0	-	73	667	709	0.9407616
C7	29857780	29864419	BolC7t42750H	0	-	2177	5667	6639	0.8535924
C7	29861633	29862494	BolC7t42751H	0	+	100	827	861	0.9605110
C7	29872920	29873290	BolC7t42752H	0	+	20	325	370	0.8783784
C7	29877062	29877696	BolC7t42753H	0	-	1629	634	634	1.0000000
C7	29891117	29892662	BolC7t42754H	0	-	48	669	1545	0.4330097
C7	29901491	29903701	BolC7t42755H	0	+	1204	2034	2210	0.9203620
C7	29916045	29916920	BolC7t42756H	0	+	616	875	875	1.0000000
C7	29917919	29920346	BolC7t42757H	0	+	894	2295	2427	0.9456119
C7	29921478	29923846	BolC7t42758H	0	+	442	2065	2368	0.8720439
C7	29925860	29927027	BolC7t42759H	0	-	89	1034	1167	0.8860326
C7	29946927	29947140	BolC7t42760H	0	+	3	126	213	0.5915493
C7	29953653	29953755	BolC7t42761H	0	-	16	102	102	1.0000000
C7	29962662	29974417	BolC7t42762H	0	-	2095	4638	11755	0.3945555
C7	29978085	29978349	BolC7t42763H	0	-	12	60	264	0.2272727
C7	29992525	29996577	BolC7t42764H	0	-	3345	4052	4052	1.0000000
C7	29996664	29996905	BolC7t42765H	0	-	340	241	241	1.0000000
C7	30003120	30003387	BolC7t42766H	0	+	0	0	267	0.0000000
C7	30017604	30017994	BolC7t42767H	0	+	494	390	390	1.0000000
C7	30018713	30018916	BolC7t42768H	0	-	79	203	203	1.0000000
C7	30019024	30020512	BolC7t42769H	0	-	597	1488	1488	1.0000000
C7	30020583	30022392	BolC7t42770H	0	-	605	1809	1809	1.0000000
C7	30039261	30040044	BolC7t42771H	0	+	252	771	783	0.9846743
C7	30052560	30053684	BolC7t42772H	0	+	727	1124	1124	1.0000000
C7	30065700	30068000	BolC7t42773H	0	+	1893	2300	2300	1.0000000
C7	30072586	30074648	BolC7t42774H	0	-	1145	2062	2062	1.0000000
C7	30079439	30081092	BolC7t42775H	0	+	799	1653	1653	1.0000000
C7	30097047	30097302	BolC7t42776H	0	-	278	255	255	1.0000000
C7	30106210	30106375	BolC7t42777H	0	+	428	165	165	1.0000000
C7	30109475	30110103	BolC7t42778H	0	-	523	628	628	1.0000000
C7	30117862	30118048	BolC7t42779H	0	-	170	186	186	1.0000000
C7	30120080	30120308	BolC7t42780H	0	-	241	228	228	1.0000000
C7	30123193	30124266	BolC7t42781H	0	+	602	1073	1073	1.0000000
C7	30125175	30125451	BolC7t42782H	0	+	180	276	276	1.0000000
C7	30127589	30127787	BolC7t42783H	0	-	121	187	198	0.9444444
C7	30130463	30132066	BolC7t42784H	0	+	0	0	1603	0.0000000
C7	30141965	30142411	BolC7t42785H	0	-	69	446	446	1.0000000
C7	30144764	30145689	BolC7t42786H	0	+	743	912	925	0.9859459
C7	30147427	30147547	BolC7t42787H	0	-	170	120	120	1.0000000
C7	30148528	30150263	BolC7t42788H	0	-	54	1026	1735	0.5913545
C7	30187797	30188801	BolC7t42789H	0	-	91	1004	1004	1.0000000
C7	30189008	30189119	BolC7t42790H	0	-	34	111	111	1.0000000
C7	30189464	30189581	BolC7t42791H	0	-	42	117	117	1.0000000
C7	30192577	30193939	BolC7t42792H	0	+	72	894	1362	0.6563877
C7	30205318	30205501	BolC7t42793H	0	+	0	0	183	0.0000000
C7	30219775	30269003	BolC7t42794H	0	+	2285	19013	49228	0.3862233
C7	30237988	30238707	BolC7t42795H	0	+	25	384	719	0.5340751
C7	30246357	30247941	BolC7t42796H	0	+	0	0	1584	0.0000000
C7	30275106	30275493	BolC7t42797H	0	-	84	379	387	0.9793282
C7	30279881	30280037	BolC7t42798H	0	+	0	0	156	0.0000000
C7	30280452	30280653	BolC7t42799H	0	-	0	0	201	0.0000000
C7	30281343	30282330	BolC7t42800H	0	+	108	819	987	0.8297873
C7	30288409	30290016	BolC7t42801H	0	+	788	1594	1607	0.9919104
C7	30298675	30300164	BolC7t42802H	0	-	88	624	1489	0.4190732
C7	30311365	30314187	BolC7t42803H	0	+	1455	2818	2822	0.9985825
C7	30316870	30317806	BolC7t42804H	0	-	18	671	936	0.7168803
C7	30336231	30336956	BolC7t42805H	0	+	489	725	725	1.0000000
C7	30342570	30344318	BolC7t42806H	0	+	1254	1748	1748	1.0000000
C7	30349672	30350035	BolC7t42807H	0	+	97	363	363	1.0000000
C7	30350536	30350788	BolC7t42808H	0	-	2	140	252	0.5555556
C7	30351335	30352726	BolC7t42809H	0	-	48	871	1391	0.6261683
C7	30354126	30356835	BolC7t42810H	0	-	34	833	2709	0.3074935
C7	30357331	30357891	BolC7t42811H	0	-	48	390	560	0.6964286
C7	30359979	30361421	BolC7t42812H	0	+	782	1393	1442	0.9660194
C7	30361868	30363214	BolC7t42813H	0	-	208	1335	1346	0.9918277
C7	30363969	30364491	BolC7t42814H	0	+	619	522	522	1.0000000
C7	30368977	30369572	BolC7t42815H	0	-	452	595	595	1.0000000
C7	30386998	30388194	BolC7t42816H	0	+	313	1090	1196	0.9113712
C7	30389599	30391621	BolC7t42817H	0	+	978	1385	2022	0.6849654
C7	30398603	30398900	BolC7t42818H	0	-	121	297	297	1.0000000
C7	30404580	30407931	BolC7t42819H	0	-	1154	3076	3351	0.9179350
C7	30408861	30410297	BolC7t42820H	0	+	1151	1436	1436	1.0000000
C7	30410754	30415415	BolC7t42821H	0	-	1733	4594	4661	0.9856254
C7	30418736	30419375	BolC7t42822H	0	+	433	639	639	1.0000000
C7	30428959	30429777	BolC7t42823H	0	-	98	314	818	0.3838631
C7	30431227	30432282	BolC7t42824H	0	-	170	1035	1055	0.9810427
C7	30432918	30434110	BolC7t42825H	0	-	150	437	1192	0.3666107
C7	30435239	30436232	BolC7t42826H	0	-	896	989	993	0.9959718
C7	30448628	30448931	BolC7t42827H	0	+	38	259	303	0.8547855
C7	30457706	30458975	BolC7t42828H	0	-	207	624	1269	0.4917258
C7	30463071	30466112	BolC7t42829H	0	+	2221	3011	3041	0.9901348
C7	30469862	30471178	BolC7t42830H	0	+	880	1258	1316	0.9559271
C7	30471496	30474454	BolC7t42831H	0	-	977	2849	2958	0.9631508
C7	30492665	30498065	BolC7t42832H	0	-	2770	5241	5400	0.9705555
C7	30513094	30514135	BolC7t42833H	0	+	240	837	1041	0.8040346
C7	30514506	30515232	BolC7t42834H	0	-	646	726	726	1.0000000
C7	30515483	30517077	BolC7t42835H	0	+	1172	1558	1594	0.9774153
C7	30521172	30521785	BolC7t42836H	0	+	3	23	613	0.0375204
C7	30525535	30526435	BolC7t42837H	0	+	215	857	900	0.9522222
C7	30538839	30541698	BolC7t42838H	0	+	1354	2848	2859	0.9961525
C7	30543048	30543492	BolC7t42839H	0	-	226	429	444	0.9662162
C7	30546022	30546429	BolC7t42840H	0	-	471	407	407	1.0000000
C7	30553300	30557141	BolC7t42841H	0	+	1930	3682	3841	0.9586045
C7	30559441	30559716	BolC7t42842H	0	+	7	87	275	0.3163636
C7	30561870	30562659	BolC7t42843H	0	+	237	789	789	1.0000000
C7	30563639	30563990	BolC7t42844H	0	+	102	348	351	0.9914530
C7	30564918	30568123	BolC7t42845H	0	+	4112	3205	3205	1.0000000
C7	30573855	30574649	BolC7t42846H	0	+	544	794	794	1.0000000
C7	30614568	30615662	BolC7t42847H	0	+	47	456	1094	0.4168190
C7	30625439	30630543	BolC7t42848H	0	+	310	2195	5104	0.4300549
C7	30630843	30631347	BolC7t42849H	0	+	199	498	504	0.9880952
C7	30633026	30633770	BolC7t42850H	0	-	713	744	744	1.0000000
C7	30635369	30637433	BolC7t42851H	0	+	334	1929	2064	0.9345930
C7	30638133	30640991	BolC7t42852H	0	-	991	2594	2858	0.9076277
C7	30646143	30648229	BolC7t42853H	0	+	1232	2086	2086	1.0000000
C7	30649187	30651230	BolC7t42854H	0	+	967	2043	2043	1.0000000
C7	30652839	30653755	BolC7t42855H	0	+	212	865	916	0.9443231
C7	30654760	30659096	BolC7t42856H	0	+	2021	3622	4336	0.8353321
C7	30689863	30689965	BolC7t42857H	0	+	136	102	102	1.0000000
C7	30690048	30690219	BolC7t42858H	0	+	120	171	171	1.0000000
C7	30690560	30691124	BolC7t42859H	0	-	21	172	564	0.3049645
C7	30699523	30700081	BolC7t42860H	0	-	30	450	558	0.8064516
C7	30710807	30719718	BolC7t42861H	0	-	1121	6579	8911	0.7383010
C7	30715969	30717070	BolC7t42862H	0	+	231	943	1101	0.8564941
C7	30730394	30732681	BolC7t42863H	0	+	2064	2287	2287	1.0000000
C7	30736222	30736798	BolC7t42864H	0	-	950	576	576	1.0000000
C7	30740511	30741204	BolC7t42865H	0	-	265	693	693	1.0000000
C7	30744909	30745278	BolC7t42866H	0	+	82	369	369	1.0000000
C7	30746406	30749383	BolC7t42867H	0	-	1406	2643	2977	0.8878065
C7	30750127	30751449	BolC7t42868H	0	+	1132	1322	1322	1.0000000
C7	30751864	30753003	BolC7t42869H	0	-	687	1064	1139	0.9341528
C7	30756183	30759190	BolC7t42870H	0	-	528	2959	3007	0.9840372
C7	30765060	30765651	BolC7t42871H	0	+	141	591	591	1.0000000
C7	30779479	30786557	BolC7t42872H	0	-	522	1443	7078	0.2038711
C7	30780626	30781817	BolC7t42873H	0	+	0	0	1191	0.0000000
C7	30787142	30791459	BolC7t42874H	0	+	3305	4317	4317	1.0000000
C7	30792508	30793519	BolC7t42875H	0	+	739	1011	1011	1.0000000
C7	30793920	30795836	BolC7t42876H	0	-	1010	1916	1916	1.0000000
C7	30798130	30800159	BolC7t42877H	0	-	1329	2024	2029	0.9975357
C7	30800828	30802162	BolC7t42878H	0	-	1168	1334	1334	1.0000000
C7	30810356	30818950	BolC7t42879H	0	+	2009	7014	8594	0.8161508
C7	30812839	30813730	BolC7t42880H	0	+	162	891	891	1.0000000
C7	30814582	30815284	BolC7t42881H	0	+	36	407	702	0.5797721
C7	30816932	30817535	BolC7t42882H	0	-	94	603	603	1.0000000
C7	30819975	30821001	BolC7t42883H	0	+	707	1026	1026	1.0000000
C7	30829260	30829833	BolC7t42884H	0	-	59	542	573	0.9458988
C7	30852164	30853257	BolC7t42885H	0	-	465	1093	1093	1.0000000
C7	30854164	30854724	BolC7t42886H	0	-	40	560	560	1.0000000
C7	30856350	30856530	BolC7t42887H	0	-	56	180	180	1.0000000
C7	30862178	30864694	BolC7t42888H	0	+	838	2442	2516	0.9705882
C7	30865315	30866060	BolC7t42889H	0	-	617	745	745	1.0000000
C7	30868524	30875441	BolC7t42890H	0	-	270	2443	6917	0.3531878
C7	30898960	30900631	BolC7t42891H	0	+	79	752	1671	0.4500299
C7	30915059	30915308	BolC7t42892H	0	+	439	249	249	1.0000000
C7	30919548	30920576	BolC7t42893H	0	-	56	517	1028	0.5029183
C7	30924399	30924612	BolC7t42894H	0	+	50	213	213	1.0000000
C7	30934337	30934877	BolC7t42895H	0	-	265	540	540	1.0000000
C7	30938042	30938634	BolC7t42896H	0	+	364	592	592	1.0000000
C7	30940932	30944043	BolC7t42897H	0	+	2380	3111	3111	1.0000000
C7	30955814	30959438	BolC7t42898H	0	-	1656	3603	3624	0.9942053
C7	30974344	30975379	BolC7t42899H	0	-	482	1035	1035	1.0000000
C7	31003149	31004393	BolC7t42900H	0	+	828	1244	1244	1.0000000
C7	31008398	31008848	BolC7t42901H	0	+	87	390	450	0.8666667
C7	31037253	31037986	BolC7t42902H	0	-	31	256	733	0.3492497
C7	31063474	31064958	BolC7t42903H	0	+	879	1484	1484	1.0000000
C7	31085614	31086844	BolC7t42904H	0	+	252	1230	1230	1.0000000
C7	31094047	31094389	BolC7t42905H	0	-	273	342	342	1.0000000
C7	31122499	31122703	BolC7t42906H	0	+	129	204	204	1.0000000
C7	31144537	31147064	BolC7t42907H	0	+	1878	2527	2527	1.0000000
C7	31151915	31154305	BolC7t42908H	0	+	2558	2390	2390	1.0000000
C7	31169041	31171783	BolC7t42909H	0	+	848	2533	2742	0.9237782
C7	31188816	31190440	BolC7t42910H	0	+	829	1473	1624	0.9070197
C7	31195855	31195972	BolC7t42911H	0	-	331	117	117	1.0000000
C7	31203371	31204283	BolC7t42912H	0	+	54	583	912	0.6392544
C7	31219550	31220462	BolC7t42913H	0	-	2	44	912	0.0482456
C7	31226711	31228591	BolC7t42914H	0	+	842	1880	1880	1.0000000
C7	31244891	31245095	BolC7t42915H	0	+	163	204	204	1.0000000
C7	31252458	31252932	BolC7t42916H	0	-	150	474	474	1.0000000
C7	31253754	31254321	BolC7t42917H	0	+	141	567	567	1.0000000
C7	31258827	31260614	BolC7t42918H	0	-	471	1610	1787	0.9009513
C7	31267673	31268003	BolC7t42919H	0	-	209	330	330	1.0000000
C7	31298553	31298712	BolC7t42920H	0	+	166	159	159	1.0000000
C7	31310695	31316206	BolC7t42921H	0	+	4157	5442	5511	0.9874796
C7	31319204	31319402	BolC7t42922H	0	-	3	146	198	0.7373737
C7	31345446	31359869	BolC7t42923H	0	+	8712	14129	14423	0.9796159
C7	31365253	31370669	BolC7t42924H	0	+	2418	5282	5416	0.9752585
C7	31376869	31384466	BolC7t42925H	0	-	2747	6157	7597	0.8104515
C7	31377846	31378408	BolC7t42926H	0	+	82	562	562	1.0000000
C7	31389679	31392464	BolC7t42927H	0	-	2447	2785	2785	1.0000000
C7	31398302	31402909	BolC7t42928H	0	+	2094	4457	4607	0.9674408
C7	31404015	31405314	BolC7t42929H	0	-	660	1299	1299	1.0000000
C7	31406320	31408024	BolC7t42930H	0	+	245	1501	1704	0.8808686
C7	31416637	31424602	BolC7t42931H	0	+	4411	7706	7965	0.9674827
C7	31446574	31450524	BolC7t42932H	0	+	2366	3950	3950	1.0000000
C7	31510346	31511258	BolC7t42933H	0	+	382	848	912	0.9298246
C7	31522962	31528223	BolC7t42934H	0	-	1796	4789	5261	0.9102832
C7	31535736	31541391	BolC7t42935H	0	-	4235	5592	5655	0.9888594
C7	31545384	31547510	BolC7t42936H	0	-	967	2073	2126	0.9750705
C7	31550447	31552746	BolC7t42937H	0	-	2055	2299	2299	1.0000000
C7	31561586	31562008	BolC7t42938H	0	-	5	340	422	0.8056872
C7	31562032	31563565	BolC7t42939H	0	-	337	1249	1533	0.8147423
C7	31566172	31566913	BolC7t42940H	0	-	25	577	741	0.7786775
C7	31591626	31593963	BolC7t42941H	0	+	1270	2313	2337	0.9897304
C7	31599659	31601893	BolC7t42942H	0	+	883	2234	2234	1.0000000
C7	31603966	31605433	BolC7t42943H	0	-	159	1059	1467	0.7218814
C7	31619694	31620558	BolC7t42944H	0	+	305	864	864	1.0000000
C7	31629681	31629816	BolC7t42945H	0	-	44	135	135	1.0000000
C7	31634586	31636233	BolC7t42946H	0	+	1325	1647	1647	1.0000000
C7	31637082	31637958	BolC7t42947H	0	+	609	876	876	1.0000000
C7	31648153	31648763	BolC7t42948H	0	+	8	91	610	0.1491803
C7	31649807	31651589	BolC7t42949H	0	-	355	1628	1782	0.9135802
C7	31653501	31653744	BolC7t42950H	0	-	252	243	243	1.0000000
C7	31660203	31662486	BolC7t42951H	0	+	742	2225	2283	0.9745948
C7	31665382	31666273	BolC7t42952H	0	+	115	798	891	0.8956229
C7	31668272	31670935	BolC7t42953H	0	-	888	2495	2663	0.9369133
C7	31671579	31673628	BolC7t42954H	0	-	673	2049	2049	1.0000000
C7	31678883	31679527	BolC7t42955H	0	-	1457	644	644	1.0000000
C7	31686340	31687190	BolC7t42956H	0	-	545	811	850	0.9541177
C7	31722862	31723355	BolC7t42957H	0	-	239	493	493	1.0000000
C7	31727033	31750326	BolC7t42958H	0	+	2152	8405	23293	0.3608380
C7	31738432	31759368	BolC7t42959H	0	+	5739	12878	20936	0.6151127
C7	31759649	31760552	BolC7t42960H	0	-	441	903	903	1.0000000
C7	31814784	31818676	BolC7t42961H	0	+	1617	3261	3892	0.8378726
C7	31819924	31822701	BolC7t42962H	0	-	1195	2774	2777	0.9989197
C7	31839080	31839620	BolC7t42963H	0	+	107	466	540	0.8629630
C7	31843562	31850978	BolC7t42964H	0	+	3923	7188	7416	0.9692557
C7	31848300	31849587	BolC7t42965H	0	-	698	1287	1287	1.0000000
C7	31850106	31850534	BolC7t42966H	0	+	553	428	428	1.0000000
C7	31851114	31852678	BolC7t42967H	0	-	703	1555	1564	0.9942455
C7	31853452	31855183	BolC7t42968H	0	+	656	1548	1731	0.8942808
C7	31857485	31858433	BolC7t42969H	0	-	152	680	948	0.7172996
C7	31861925	31864634	BolC7t42970H	0	+	843	2591	2709	0.9564415
C7	31867450	31868399	BolC7t42971H	0	-	0	0	949	0.0000000
C7	31868404	31868838	BolC7t42972H	0	+	0	0	434	0.0000000
C7	31872255	31875401	BolC7t42973H	0	-	279	1994	3146	0.6338207
C7	31885065	31885626	BolC7t42974H	0	+	96	474	561	0.8449198
C7	31894826	31896227	BolC7t42975H	0	+	359	1218	1401	0.8693790
C7	31904284	31904780	BolC7t42976H	0	+	72	496	496	1.0000000
C7	31914815	31916803	BolC7t42977H	0	+	959	1800	1988	0.9054326
C7	31917785	31919090	BolC7t42978H	0	+	1196	1305	1305	1.0000000
C7	31919694	31921116	BolC7t42979H	0	+	597	1422	1422	1.0000000
C7	31922102	31923262	BolC7t42980H	0	+	405	1139	1160	0.9818966
C7	31923571	31925446	BolC7t42981H	0	-	906	1875	1875	1.0000000
C7	31939464	31939956	BolC7t42982H	0	-	301	492	492	1.0000000
C7	31977280	31977490	BolC7t42983H	0	+	0	0	210	0.0000000
C7	31978575	31978806	BolC7t42984H	0	-	3	121	231	0.5238096
C7	31988930	31990077	BolC7t42985H	0	+	446	1130	1147	0.9851787
C7	31990730	31991737	BolC7t42986H	0	+	167	968	1007	0.9612711
C7	31991978	32000106	BolC7t42987H	0	-	2326	7233	8128	0.8898868
C7	32003993	32005034	BolC7t42988H	0	-	690	1041	1041	1.0000000
C7	32009811	32010201	BolC7t42989H	0	-	217	390	390	1.0000000
C7	32015240	32015897	BolC7t42990H	0	-	228	616	657	0.9375951
C7	32037555	32038111	BolC7t42991H	0	+	217	556	556	1.0000000
C7	32039310	32042764	BolC7t42992H	0	+	2384	3454	3454	1.0000000
C7	32051229	32052396	BolC7t42993H	0	-	651	1163	1167	0.9965724
C7	32063711	32064280	BolC7t42994H	0	+	259	498	569	0.8752197
C7	32064725	32065813	BolC7t42995H	0	-	549	1088	1088	1.0000000
C7	32071732	32072422	BolC7t42996H	0	+	14	611	690	0.8855072
C7	32076464	32077580	BolC7t42997H	0	+	96	999	1116	0.8951613
C7	32091695	32092235	BolC7t42998H	0	+	25	444	540	0.8222222
C7	32109833	32110322	BolC7t42999H	0	-	42	336	489	0.6871166
C7	32110579	32112240	BolC7t43000H	0	+	416	1490	1661	0.8970500
C7	32136240	32136510	BolC7t43001H	0	-	69	218	270	0.8074074
C7	32141278	32141845	BolC7t43002H	0	-	104	497	567	0.8765432
C7	32145002	32145285	BolC7t43003H	0	-	102	283	283	1.0000000
C7	32151972	32152758	BolC7t43004H	0	+	378	786	786	1.0000000
C7	32153044	32155624	BolC7t43005H	0	-	1313	2580	2580	1.0000000
C7	32162855	32163515	BolC7t43006H	0	+	377	660	660	1.0000000
C7	32163875	32165382	BolC7t43007H	0	-	1229	1507	1507	1.0000000
C7	32170954	32173288	BolC7t43008H	0	-	1024	2295	2334	0.9832905
C7	32175261	32179473	BolC7t43009H	0	-	2589	4212	4212	1.0000000
C7	32181315	32181727	BolC7t43010H	0	+	28	278	412	0.6747573
C7	32184952	32186987	BolC7t43011H	0	+	1320	2035	2035	1.0000000
C7	32191009	32197796	BolC7t43012H	0	-	883	3850	6787	0.5672609
C7	32198217	32200107	BolC7t43013H	0	+	1409	1817	1890	0.9613757
C7	32200874	32202646	BolC7t43014H	0	-	1554	1772	1772	1.0000000
C7	32207354	32208365	BolC7t43015H	0	-	60	621	1011	0.6142433
C7	32212700	32213029	BolC7t43016H	0	+	425	329	329	1.0000000
C7	32223852	32225181	BolC7t43017H	0	+	544	1243	1329	0.9352897
C7	32225964	32229061	BolC7t43018H	0	+	1167	2874	3097	0.9279948
C7	32241622	32242219	BolC7t43019H	0	+	24	413	597	0.6917923
C7	32245100	32245256	BolC7t43020H	0	+	188	156	156	1.0000000
C7	32245663	32247793	BolC7t43021H	0	-	644	2130	2130	1.0000000
C7	32257737	32258025	BolC7t43022H	0	-	13	191	288	0.6631944
C7	32270927	32271158	BolC7t43023H	0	-	3	57	231	0.2467532
C7	32278297	32278691	BolC7t43024H	0	-	294	394	394	1.0000000
C7	32290131	32290437	BolC7t43025H	0	-	6	213	306	0.6960784
C7	32301076	32301376	BolC7t43026H	0	-	60	101	300	0.3366667
C7	32302000	32305048	BolC7t43027H	0	-	1248	2735	3048	0.8973097
C7	32308782	32310619	BolC7t43028H	0	-	440	1697	1837	0.9237888
C7	32313045	32313712	BolC7t43029H	0	-	61	310	667	0.4647676
C7	32327534	32329199	BolC7t43030H	0	+	84	736	1665	0.4420421
C7	32330342	32331383	BolC7t43031H	0	+	322	798	1041	0.7665706
C7	32332615	32335266	BolC7t43032H	0	-	679	2492	2651	0.9400226
C7	32341162	32341715	BolC7t43033H	0	-	256	553	553	1.0000000
C7	32343011	32344808	BolC7t43034H	0	-	467	1773	1797	0.9866444
C7	32351514	32354879	BolC7t43035H	0	-	1816	3343	3365	0.9934621
C7	32355836	32359763	BolC7t43036H	0	-	891	3164	3927	0.8057041
C7	32374081	32393089	BolC7t43037H	0	-	3576	11814	19008	0.6215278
C7	32393779	32395047	BolC7t43038H	0	-	205	1174	1268	0.9258675
C7	32396917	32398385	BolC7t43039H	0	+	685	1468	1468	1.0000000
C7	32398599	32400257	BolC7t43040H	0	-	1076	1658	1658	1.0000000
C7	32401123	32403057	BolC7t43041H	0	-	352	1898	1934	0.9813857
C7	32405535	32418584	BolC7t43042H	0	-	4473	12849	13049	0.9846731
C7	32432213	32433659	BolC7t43043H	0	-	487	1446	1446	1.0000000
C7	32441654	32444231	BolC7t43044H	0	+	1644	2577	2577	1.0000000
C7	32452157	32454082	BolC7t43045H	0	+	1118	1925	1925	1.0000000
C7	32456249	32459326	BolC7t43046H	0	+	2253	3077	3077	1.0000000
C7	32458699	32459191	BolC7t43047H	0	+	365	492	492	1.0000000
C7	32465762	32466830	BolC7t43048H	0	+	104	839	1068	0.7855805
C7	32467028	32469005	BolC7t43049H	0	-	325	1779	1977	0.8998483
C7	32478397	32481673	BolC7t43050H	0	-	1848	3276	3276	1.0000000
C7	32485369	32493206	BolC7t43051H	0	-	4911	7837	7837	1.0000000
C7	32507352	32510602	BolC7t43052H	0	+	2438	2998	3250	0.9224615
C7	32511622	32512051	BolC7t43053H	0	-	302	429	429	1.0000000
C7	32524668	32526234	BolC7t43054H	0	-	451	1351	1566	0.8627076
C7	32530426	32532736	BolC7t43055H	0	-	662	2189	2310	0.9476190
C7	32538016	32541976	BolC7t43056H	0	+	3351	3960	3960	1.0000000
C7	32551350	32552940	BolC7t43057H	0	+	525	1507	1590	0.9477987
C7	32570105	32570914	BolC7t43058H	0	+	238	809	809	1.0000000
C7	32572102	32573816	BolC7t43059H	0	+	785	1636	1714	0.9544924
C7	32575504	32577218	BolC7t43060H	0	+	724	1714	1714	1.0000000
C7	32577300	32578167	BolC7t43061H	0	-	481	816	867	0.9411765
C7	32583459	32584521	BolC7t43062H	0	-	390	1053	1062	0.9915254
C7	32590262	32591624	BolC7t43063H	0	+	1333	1362	1362	1.0000000
C7	32592001	32594303	BolC7t43064H	0	+	1459	2301	2302	0.9995656
C7	32595348	32597594	BolC7t43065H	0	+	1574	2246	2246	1.0000000
C7	32598632	32602863	BolC7t43066H	0	+	1693	4185	4231	0.9891279
C7	32615706	32615973	BolC7t43067H	0	+	364	267	267	1.0000000
C7	32628045	32628780	BolC7t43068H	0	+	431	735	735	1.0000000
C7	32634546	32635050	BolC7t43069H	0	+	348	504	504	1.0000000
C7	32642805	32645560	BolC7t43070H	0	+	1351	2755	2755	1.0000000
C7	32645935	32647863	BolC7t43071H	0	-	2773	1928	1928	1.0000000
C7	32656558	32659768	BolC7t43072H	0	+	2063	3210	3210	1.0000000
C7	32660088	32661125	BolC7t43073H	0	-	1032	1037	1037	1.0000000
C7	32661719	32663212	BolC7t43074H	0	-	686	1395	1493	0.9343603
C7	32669718	32674076	BolC7t43075H	0	-	2171	4328	4358	0.9931161
C7	32690920	32691037	BolC7t43076H	0	-	66	117	117	1.0000000
C7	32699550	32701013	BolC7t43077H	0	-	610	1406	1463	0.9610389
C7	32732629	32732863	BolC7t43078H	0	+	284	234	234	1.0000000
C7	32735643	32738488	BolC7t43079H	0	+	1607	2800	2845	0.9841828
C7	32739019	32740494	BolC7t43080H	0	-	520	1343	1475	0.9105085
C7	32742497	32743017	BolC7t43081H	0	+	349	520	520	1.0000000
C7	32771369	32774090	BolC7t43082H	0	+	1063	2721	2721	1.0000000
C7	32776614	32778613	BolC7t43083H	0	-	1510	1999	1999	1.0000000
C7	32780510	32781847	BolC7t43084H	0	+	928	1337	1337	1.0000000
C7	32782981	32798076	BolC7t43085H	0	-	6313	14426	15095	0.9556807
C7	32803221	32809003	BolC7t43086H	0	-	2159	5091	5782	0.8804912
C7	32813561	32814123	BolC7t43087H	0	-	480	562	562	1.0000000
C7	32822329	32827192	BolC7t43088H	0	-	3255	4596	4863	0.9450956
C7	32827686	32829236	BolC7t43089H	0	+	932	1550	1550	1.0000000
C7	32843112	32844751	BolC7t43090H	0	-	1104	1590	1639	0.9701037
C7	32846213	32846716	BolC7t43091H	0	+	820	503	503	1.0000000
C7	32858778	32860297	BolC7t43092H	0	+	2	117	1519	0.0770244
C7	32863014	32864429	BolC7t43093H	0	+	1277	1415	1415	1.0000000
C7	32870864	32871158	BolC7t43094H	0	+	122	294	294	1.0000000
C7	32879040	32879610	BolC7t43095H	0	-	424	570	570	1.0000000
C7	32880609	32881270	BolC7t43096H	0	+	196	661	661	1.0000000
C7	32886287	32887390	BolC7t43097H	0	-	109	534	1103	0.4841342
C7	32893037	32894147	BolC7t43098H	0	-	241	735	1110	0.6621622
C7	32895627	32896179	BolC7t43099H	0	-	2	130	552	0.2355072
C7	32897053	32897434	BolC7t43100H	0	+	198	381	381	1.0000000
C7	32897628	32898024	BolC7t43101H	0	-	252	396	396	1.0000000
C7	32912492	32912711	BolC7t43102H	0	-	155	219	219	1.0000000
C7	32914861	32915158	BolC7t43103H	0	-	71	258	297	0.8686869
C7	32958129	32958441	BolC7t43104H	0	+	0	0	312	0.0000000
C7	32962512	32963618	BolC7t43105H	0	-	304	479	1106	0.4330922
C7	32966911	32967205	BolC7t43106H	0	-	4	14	294	0.0476190
C7	32969618	32974953	BolC7t43107H	0	+	2572	4636	5335	0.8689784
C7	32984325	32987674	BolC7t43108H	0	-	2545	3349	3349	1.0000000
C7	33003206	33003380	BolC7t43109H	0	+	73	174	174	1.0000000
C7	33022613	33023315	BolC7t43110H	0	-	750	702	702	1.0000000
C7	33024692	33029585	BolC7t43111H	0	-	1947	4823	4893	0.9856939
C7	33036835	33038657	BolC7t43112H	0	-	1053	1822	1822	1.0000000
C7	33043393	33049660	BolC7t43113H	0	-	1376	4228	6267	0.6746449
C7	33057381	33065319	BolC7t43114H	0	+	3987	7027	7938	0.8852355
C7	33067276	33068946	BolC7t43115H	0	-	55	1142	1670	0.6838323
C7	33079483	33079648	BolC7t43116H	0	-	80	165	165	1.0000000
C7	33081067	33081587	BolC7t43117H	0	+	95	501	520	0.9634615
C7	33081602	33082334	BolC7t43118H	0	+	36	497	732	0.6789618
C7	33083942	33084080	BolC7t43119H	0	+	17	138	138	1.0000000
C7	33092886	33094559	BolC7t43120H	0	+	207	1105	1673	0.6604902
C7	33106295	33108385	BolC7t43121H	0	-	139	1234	2090	0.5904306
C7	33117497	33117695	BolC7t43122H	0	-	205	198	198	1.0000000
C7	33122321	33124321	BolC7t43123H	0	-	491	1724	2000	0.8620000
C7	33125188	33126193	BolC7t43124H	0	-	281	991	1005	0.9860697
C7	33129427	33129814	BolC7t43125H	0	-	66	378	387	0.9767442
C7	33131936	33133428	BolC7t43126H	0	-	14	594	1492	0.3981233
C7	33133511	33134451	BolC7t43127H	0	-	14	317	940	0.3372341
C7	33138347	33138776	BolC7t43128H	0	+	7	107	429	0.2494172
C7	33156837	33157813	BolC7t43129H	0	-	71	599	976	0.6137295
C7	33171606	33172432	BolC7t43130H	0	+	1868	826	826	1.0000000
C7	33177980	33178661	BolC7t43131H	0	+	697	613	681	0.9001468
C7	33183307	33184474	BolC7t43132H	0	+	782	1097	1167	0.9400172
C7	33198444	33200024	BolC7t43133H	0	-	1070	1580	1580	1.0000000
C7	33217354	33217573	BolC7t43134H	0	-	241	219	219	1.0000000
C7	33217644	33219348	BolC7t43135H	0	+	1495	1687	1704	0.9900235
C7	33226456	33226603	BolC7t43136H	0	+	157	147	147	1.0000000
C7	33230269	33231703	BolC7t43137H	0	-	858	1434	1434	1.0000000
C7	33245313	33245983	BolC7t43138H	0	+	737	670	670	1.0000000
C7	33246792	33248021	BolC7t43139H	0	-	797	1229	1229	1.0000000
C7	33249115	33249292	BolC7t43140H	0	-	168	177	177	1.0000000
C7	33249429	33250641	BolC7t43141H	0	-	795	1211	1212	0.9991749
C7	33266735	33271623	BolC7t43142H	0	+	2104	4511	4888	0.9228724
C7	33274831	33275242	BolC7t43143H	0	-	2	80	411	0.1946472
C7	33277753	33278161	BolC7t43144H	0	+	34	277	408	0.6789216
C7	33302479	33302656	BolC7t43145H	0	-	184	177	177	1.0000000
C7	33349338	33353471	BolC7t43146H	0	+	2847	4101	4133	0.9922574
C7	33355456	33355651	BolC7t43147H	0	+	21	166	195	0.8512821
C7	33384463	33386979	BolC7t43148H	0	+	1434	2463	2516	0.9789348
C7	33392635	33392752	BolC7t43149H	0	+	126	117	117	1.0000000
C7	33408437	33411059	BolC7t43150H	0	+	2524	2622	2622	1.0000000
C7	33427601	33432611	BolC7t43151H	0	-	3511	4598	5010	0.9177645
C7	33440795	33443459	BolC7t43152H	0	-	1701	1764	2664	0.6621622
C7	33448332	33449638	BolC7t43153H	0	+	1017	1306	1306	1.0000000
C7	33452145	33452568	BolC7t43154H	0	+	81	308	423	0.7281324
C7	33453566	33453767	BolC7t43155H	0	+	155	201	201	1.0000000
C7	33455648	33455879	BolC7t43156H	0	+	160	231	231	1.0000000
C7	33457747	33459689	BolC7t43157H	0	-	1074	1942	1942	1.0000000
C7	33460521	33460803	BolC7t43158H	0	-	120	282	282	1.0000000
C7	33498611	33501568	BolC7t43159H	0	+	1375	2088	2957	0.7061211
C7	33503031	33503586	BolC7t43160H	0	+	381	555	555	1.0000000
C7	33503904	33507941	BolC7t43161H	0	-	1027	3553	4037	0.8801090
C7	33512152	33513076	BolC7t43162H	0	-	0	0	924	0.0000000
C7	33563995	33568404	BolC7t43163H	0	+	1982	4402	4409	0.9984123
C7	33569311	33571222	BolC7t43164H	0	+	942	1909	1911	0.9989534
C7	33587485	33587896	BolC7t43165H	0	-	114	409	411	0.9951338
C7	33602379	33602622	BolC7t43166H	0	-	0	0	243	0.0000000
C7	33603826	33604738	BolC7t43167H	0	+	225	803	912	0.8804824
C7	33604947	33606365	BolC7t43168H	0	+	338	1333	1418	0.9400564
C7	33612438	33613698	BolC7t43169H	0	-	63	903	1260	0.7166666
C7	33623253	33624013	BolC7t43170H	0	+	41	45	760	0.0592105
C7	33625379	33629063	BolC7t43171H	0	-	762	3192	3684	0.8664495
C7	33643678	33646323	BolC7t43172H	0	-	1884	2645	2645	1.0000000
C7	33673479	33673773	BolC7t43173H	0	-	14	111	294	0.3775510
C7	33675181	33676692	BolC7t43174H	0	-	87	1014	1511	0.6710787
C7	33720250	33720672	BolC7t43175H	0	-	93	386	422	0.9146919
C7	33749540	33759718	BolC7t43176H	0	-	4024	9284	10178	0.9121635
C7	33771364	33777045	BolC7t43177H	0	-	4102	4552	5681	0.8012674
C7	33800663	33802600	BolC7t43178H	0	+	1521	1937	1937	1.0000000
C7	33803901	33806129	BolC7t43179H	0	-	1760	2228	2228	1.0000000
C7	33809635	33809950	BolC7t43180H	0	+	17	134	315	0.4253968
C7	33829621	33831003	BolC7t43181H	0	-	305	979	1382	0.7083936
C7	33837691	33838264	BolC7t43182H	0	+	363	573	573	1.0000000
C7	33839718	33842969	BolC7t43183H	0	+	1490	2896	3251	0.8908028
C7	33843531	33844895	BolC7t43184H	0	-	823	1348	1364	0.9882698
C7	33846817	33847809	BolC7t43185H	0	+	0	0	992	0.0000000
C7	33854072	33854255	BolC7t43186H	0	-	128	183	183	1.0000000
C7	33854705	33855002	BolC7t43187H	0	-	19	191	297	0.6430976
C7	33890985	33891690	BolC7t43188H	0	+	644	705	705	1.0000000
C7	33892012	33892876	BolC7t43189H	0	+	788	864	864	1.0000000
C7	33908176	33909371	BolC7t43190H	0	+	135	699	1195	0.5849372
C7	33909379	33915512	BolC7t43191H	0	+	1469	5803	6133	0.9461927
C7	33931973	33932138	BolC7t43192H	0	+	211	165	165	1.0000000
C7	33935585	33937329	BolC7t43193H	0	+	208	1450	1744	0.8314220
C7	33938026	33942047	BolC7t43194H	0	+	1147	3799	4021	0.9447898
C7	33942372	33943812	BolC7t43195H	0	-	1015	1440	1440	1.0000000
C7	33959141	33959561	BolC7t43196H	0	+	320	420	420	1.0000000
C7	33969510	33969744	BolC7t43197H	0	-	34	182	234	0.7777778
C7	33980910	33983485	BolC7t43198H	0	+	1043	2450	2575	0.9514563
C7	33984347	33985232	BolC7t43199H	0	-	744	885	885	1.0000000
C7	33987336	33987441	BolC7t43200H	0	+	45	105	105	1.0000000
C7	33990806	33991892	BolC7t43201H	0	+	271	1086	1086	1.0000000
C7	33992436	33995061	BolC7t43202H	0	-	1528	2625	2625	1.0000000
C7	34010795	34011602	BolC7t43203H	0	-	141	534	807	0.6617100
C7	34011928	34013836	BolC7t43204H	0	+	716	1636	1908	0.8574423
C7	34015755	34018098	BolC7t43205H	0	-	427	2053	2343	0.8762271
C7	34020687	34020898	BolC7t43206H	0	+	199	211	211	1.0000000
C7	34020997	34021729	BolC7t43207H	0	+	524	732	732	1.0000000
C7	34025975	34026407	BolC7t43208H	0	+	238	432	432	1.0000000
C7	34048382	34048514	BolC7t43209H	0	-	32	132	132	1.0000000
C7	34055568	34055853	BolC7t43210H	0	+	69	267	285	0.9368421
C7	34071191	34071926	BolC7t43211H	0	+	5	95	735	0.1292517
C7	34133181	34133462	BolC7t43212H	0	-	888	281	281	1.0000000
C7	34133763	34133925	BolC7t43213H	0	-	258	162	162	1.0000000
C7	34153751	34154513	BolC7t43214H	0	+	141	705	762	0.9251968
C7	34192622	34198968	BolC7t43215H	0	+	2430	6004	6346	0.9461078
C7	34213746	34215754	BolC7t43216H	0	+	633	1883	2008	0.9377490
C7	34267305	34269058	BolC7t43217H	0	-	1017	1753	1753	1.0000000
C7	34280598	34284933	BolC7t43218H	0	+	212	1960	4335	0.4521338
C7	34291478	34294597	BolC7t43219H	0	+	196	1445	3119	0.4632895
C7	34300705	34301842	BolC7t43220H	0	-	151	1100	1137	0.9674582
C7	34394343	34395870	BolC7t43221H	0	-	468	1421	1527	0.9305828
C7	34412639	34416136	BolC7t43222H	0	+	2546	3497	3497	1.0000000
C7	34416701	34419606	BolC7t43223H	0	-	3717	2905	2905	1.0000000
C7	34437939	34438968	BolC7t43224H	0	-	67	995	1029	0.9669582
C7	34455556	34455891	BolC7t43225H	0	+	0	0	335	0.0000000
C7	34456510	34459703	BolC7t43226H	0	-	2334	3193	3193	1.0000000
C7	34479257	34479359	BolC7t43227H	0	-	106	102	102	1.0000000
C7	34482569	34484161	BolC7t43228H	0	-	1077	1592	1592	1.0000000
C7	34489668	34490581	BolC7t43229H	0	-	725	913	913	1.0000000
C7	34498245	34498458	BolC7t43230H	0	+	39	148	213	0.6948357
C7	34536960	34538201	BolC7t43231H	0	+	948	1201	1241	0.9677680
C7	34538884	34540337	BolC7t43232H	0	-	1046	1453	1453	1.0000000
C7	34557353	34558833	BolC7t43233H	0	-	1481	1480	1480	1.0000000
C7	34563505	34565278	BolC7t43234H	0	-	591	1639	1773	0.9244219
C7	34565805	34567411	BolC7t43235H	0	+	1042	1606	1606	1.0000000
C7	34567697	34569337	BolC7t43236H	0	-	335	1640	1640	1.0000000
C7	34578543	34578753	BolC7t43237H	0	+	3	130	210	0.6190476
C7	34593467	34594400	BolC7t43238H	0	+	151	933	933	1.0000000
C7	34620423	34623281	BolC7t43239H	0	-	311	2237	2858	0.7827152
C7	34623660	34624138	BolC7t43240H	0	-	121	478	478	1.0000000
C7	34643881	34644766	BolC7t43241H	0	-	0	0	885	0.0000000
C7	34651393	34656636	BolC7t43242H	0	-	1280	3880	5243	0.7400343
C7	34659043	34660687	BolC7t43243H	0	-	140	745	1644	0.4531630
C7	34662347	34663649	BolC7t43244H	0	-	979	1302	1302	1.0000000
C7	34665507	34667889	BolC7t43245H	0	-	762	2342	2382	0.9832074
C7	34686458	34687680	BolC7t43246H	0	-	203	755	1222	0.6178396
C7	34688266	34688779	BolC7t43247H	0	+	227	513	513	1.0000000
C7	34702145	34705008	BolC7t43248H	0	-	461	2102	2863	0.7341949
C7	34715607	34716129	BolC7t43249H	0	-	391	522	522	1.0000000
C7	34747122	34748900	BolC7t43250H	0	+	1373	1778	1778	1.0000000
C7	34753870	34755481	BolC7t43251H	0	-	1209	1611	1611	1.0000000
C7	34771649	34773397	BolC7t43252H	0	-	1529	1748	1748	1.0000000
C7	34774902	34775451	BolC7t43253H	0	+	155	536	549	0.9763206
C7	34776271	34777289	BolC7t43254H	0	-	36	486	1018	0.4774067
C7	34808089	34808605	BolC7t43255H	0	+	20	459	516	0.8895349
C7	34823578	34824370	BolC7t43256H	0	-	31	736	792	0.9292929
C7	34828819	34830222	BolC7t43257H	0	+	260	1329	1403	0.9472559
C7	34832012	34832598	BolC7t43258H	0	-	637	586	586	1.0000000
C7	34835052	34835877	BolC7t43259H	0	+	329	765	825	0.9272727
C7	34843415	34843610	BolC7t43260H	0	+	257	195	195	1.0000000
C7	34872687	34874072	BolC7t43261H	0	+	766	1385	1385	1.0000000
C7	34881726	34919446	BolC7t43262H	0	+	11900	35507	37720	0.9413309
C7	34926213	34927022	BolC7t43263H	0	+	1956	809	809	1.0000000
C7	34928617	34930689	BolC7t43264H	0	+	560	1941	2072	0.9367760
C7	34932332	34933839	BolC7t43265H	0	-	1301	1507	1507	1.0000000
C7	34947286	34947825	BolC7t43266H	0	-	296	539	539	1.0000000
C7	34948401	34948792	BolC7t43267H	0	+	402	391	391	1.0000000
C7	34948896	34949499	BolC7t43268H	0	-	555	603	603	1.0000000
C7	34953808	34954133	BolC7t43269H	0	-	67	325	325	1.0000000
C7	34957077	34960444	BolC7t43270H	0	+	639	3000	3367	0.8910009
C7	34960552	34960906	BolC7t43271H	0	-	396	354	354	1.0000000
C7	34961558	34962894	BolC7t43272H	0	-	520	1322	1336	0.9895210
C7	34963674	34967054	BolC7t43273H	0	-	2641	3380	3380	1.0000000
C7	34979245	34980815	BolC7t43274H	0	+	1024	1570	1570	1.0000000
C7	34987141	34987985	BolC7t43275H	0	+	833	844	844	1.0000000
C7	34990284	34991025	BolC7t43276H	0	-	304	741	741	1.0000000
C7	34992654	34994076	BolC7t43277H	0	-	145	1032	1422	0.7257384
C7	35015216	35016395	BolC7t43278H	0	-	578	1167	1179	0.9898219
C7	35033716	35034079	BolC7t43279H	0	+	384	363	363	1.0000000
C7	35041060	35041541	BolC7t43280H	0	-	8	347	481	0.7214137
C7	35041526	35052140	BolC7t43281H	0	+	3900	9531	10614	0.8979650
C7	35055994	35057961	BolC7t43282H	0	-	296	1191	1967	0.6054906
C7	35061787	35064095	BolC7t43283H	0	-	103	1260	2308	0.5459272
C7	35082097	35086276	BolC7t43284H	0	-	1039	3467	4179	0.8296243
C7	35086706	35089021	BolC7t43285H	0	+	985	2315	2315	1.0000000
C7	35089546	35090620	BolC7t43286H	0	+	62	868	1074	0.8081937
C7	35092441	35094707	BolC7t43287H	0	-	683	1723	2266	0.7603707
C7	35096496	35096829	BolC7t43288H	0	+	81	333	333	1.0000000
C7	35099579	35101118	BolC7t43289H	0	+	840	1500	1539	0.9746588
C7	35107288	35108098	BolC7t43290H	0	+	104	810	810	1.0000000
C7	35111355	35111995	BolC7t43291H	0	-	535	640	640	1.0000000
C7	35121621	35123777	BolC7t43292H	0	+	664	1949	2156	0.9039889
C7	35142502	35146313	BolC7t43293H	0	-	706	2560	3811	0.6717397
C7	35156878	35160672	BolC7t43294H	0	+	2279	3794	3794	1.0000000
C7	35161128	35161836	BolC7t43295H	0	-	257	708	708	1.0000000
C7	35173058	35180453	BolC7t43296H	0	-	661	4320	7395	0.5841785
C7	35179691	35180270	BolC7t43297H	0	-	214	579	579	1.0000000
C7	35184749	35193695	BolC7t43298H	0	-	445	4911	8946	0.5489604
C7	35195627	35209861	BolC7t43299H	0	-	1469	11272	14234	0.7919067
C7	35211683	35212765	BolC7t43300H	0	+	780	1082	1082	1.0000000
C7	35213063	35214020	BolC7t43301H	0	-	697	957	957	1.0000000
C7	35215280	35215764	BolC7t43302H	0	+	10	20	484	0.0413223
C7	35218657	35222319	BolC7t43303H	0	-	2569	3556	3662	0.9710541
C7	35222827	35228882	BolC7t43304H	0	+	3141	5918	6055	0.9773741
C7	35230241	35232634	BolC7t43305H	0	+	1766	2393	2393	1.0000000
C7	35235283	35238115	BolC7t43306H	0	-	802	2603	2832	0.9191384
C7	35257131	35259886	BolC7t43307H	0	+	934	2731	2755	0.9912885
C7	35261735	35262584	BolC7t43308H	0	+	210	570	849	0.6713781
C7	35289149	35293033	BolC7t43309H	0	-	454	2801	3884	0.7211637
C7	35299918	35300348	BolC7t43310H	0	-	368	430	430	1.0000000
C7	35311831	35313685	BolC7t43311H	0	-	212	1522	1854	0.8209277
C7	35316327	35317537	BolC7t43312H	0	+	131	1105	1210	0.9132231
C7	35321775	35322799	BolC7t43313H	0	+	789	1024	1024	1.0000000
C7	35328656	35328908	BolC7t43314H	0	-	88	230	252	0.9126984
C7	35339545	35341738	BolC7t43315H	0	-	934	1950	2193	0.8891929
C7	35346828	35349692	BolC7t43316H	0	-	686	2521	2864	0.8802374
C7	35362854	35363823	BolC7t43317H	0	-	117	887	969	0.9153767
C7	35372864	35374340	BolC7t43318H	0	+	1007	1476	1476	1.0000000
C7	35382913	35384130	BolC7t43319H	0	+	30	816	1217	0.6705012
C7	35384696	35385515	BolC7t43320H	0	-	30	437	819	0.5335776
C7	35386428	35386911	BolC7t43321H	0	+	2	20	483	0.0414079
C7	35389240	35392641	BolC7t43322H	0	-	2959	1151	3401	0.3384299
C7	35404500	35406466	BolC7t43323H	0	+	941	1966	1966	1.0000000
C7	35407750	35408938	BolC7t43324H	0	-	492	1181	1188	0.9941077
C7	35412988	35414465	BolC7t43325H	0	+	1140	1477	1477	1.0000000
C7	35418460	35418565	BolC7t43326H	0	-	300	105	105	1.0000000
C7	35425907	35430625	BolC7t43327H	0	+	1988	4275	4718	0.9061043
C7	35431044	35433498	BolC7t43328H	0	-	1609	2449	2454	0.9979625
C7	35434405	35437114	BolC7t43329H	0	-	1218	2222	2709	0.8202289
C7	35443536	35468425	BolC7t43330H	0	-	10717	20665	24889	0.8302864
C7	35447608	35448402	BolC7t43331H	0	-	120	767	794	0.9659950
C7	35450611	35451754	BolC7t43332H	0	-	168	896	1143	0.7839020
C7	35490155	35490398	BolC7t43333H	0	+	213	243	243	1.0000000
C7	35492935	35499516	BolC7t43334H	0	+	3037	6501	6581	0.9878438
C7	35521962	35522994	BolC7t43335H	0	-	6	57	1032	0.0552326
C7	35527366	35527849	BolC7t43336H	0	-	0	0	483	0.0000000
C7	35528819	35538168	BolC7t43337H	0	-	29	51	9349	0.0054551
C7	35542968	35550599	BolC7t43338H	0	+	370	2582	7631	0.3383567
C7	35561476	35562694	BolC7t43339H	0	-	0	0	1218	0.0000000
C7	35562979	35565380	BolC7t43340H	0	+	858	1199	2401	0.4993753
C7	35566431	35571845	BolC7t43341H	0	-	1635	3931	5414	0.7260805
C7	35577195	35578029	BolC7t43342H	0	+	108	780	834	0.9352518
C7	35581168	35581479	BolC7t43343H	0	-	19	311	311	1.0000000
C7	35600611	35601994	BolC7t43344H	0	-	77	594	1383	0.4295011
C7	35608358	35617329	BolC7t43345H	0	-	4686	8971	8971	1.0000000
C7	35662372	35662690	BolC7t43346H	0	-	0	0	318	0.0000000
C7	35664288	35664733	BolC7t43347H	0	-	0	0	445	0.0000000
C7	35665889	35666048	BolC7t43348H	0	-	0	0	159	0.0000000
C7	35667618	35667924	BolC7t43349H	0	+	269	306	306	1.0000000
C7	35688087	35688207	BolC7t43350H	0	+	2	114	120	0.9500000
C7	35692415	35692888	BolC7t43351H	0	-	0	0	473	0.0000000
C7	35719843	35720230	BolC7t43352H	0	-	0	0	387	0.0000000
C7	35734633	35735588	BolC7t43353H	0	+	4	20	955	0.0209424
C7	35742780	35743098	BolC7t43354H	0	-	1	68	318	0.2138365
C7	35744697	35745142	BolC7t43355H	0	-	0	0	445	0.0000000
C7	35746297	35746456	BolC7t43356H	0	-	4	16	159	0.1006289
C7	35748408	35748558	BolC7t43357H	0	+	19	87	150	0.5800000
C7	35813823	35813982	BolC7t43358H	0	-	0	0	159	0.0000000
C7	35855703	35856090	BolC7t43359H	0	-	0	0	387	0.0000000
C7	35870880	35871835	BolC7t43360H	0	+	0	0	955	0.0000000
C7	35873319	35873637	BolC7t43361H	0	-	0	0	318	0.0000000
C7	35891996	35892221	BolC7t43362H	0	-	0	0	225	0.0000000
C7	35892782	35893227	BolC7t43363H	0	-	0	0	445	0.0000000
C7	35893962	35894544	BolC7t43364H	0	-	7	85	582	0.1460481
C7	35906842	35916874	BolC7t43365H	0	-	4508	9926	10032	0.9894338
C7	35943486	35946705	BolC7t43366H	0	-	2130	3219	3219	1.0000000
C7	35957346	35959737	BolC7t43367H	0	+	1674	2391	2391	1.0000000
C7	35960991	35963844	BolC7t43368H	0	-	1294	2709	2853	0.9495268
C7	35965163	35965992	BolC7t43369H	0	+	784	829	829	1.0000000
C7	35977072	35978622	BolC7t43370H	0	-	1050	1550	1550	1.0000000
C7	35985210	35987022	BolC7t43371H	0	-	940	1662	1812	0.9172186
C7	35995682	35996303	BolC7t43372H	0	-	3	83	621	0.1336554
C7	36005182	36007603	BolC7t43373H	0	-	122	1885	2421	0.7786039
C7	36010077	36012029	BolC7t43374H	0	-	599	1632	1952	0.8360656
C7	36043510	36048979	BolC7t43375H	0	-	2742	5059	5469	0.9250320
C7	36046614	36047271	BolC7t43376H	0	+	861	657	657	1.0000000
C7	36055856	36056255	BolC7t43377H	0	-	42	187	399	0.4686717
C7	36061337	36063245	BolC7t43378H	0	-	559	1856	1908	0.9727463
C7	36093400	36095294	BolC7t43379H	0	-	856	1871	1894	0.9878564
C7	36099824	36100007	BolC7t43380H	0	-	212	183	183	1.0000000
C7	36101390	36102370	BolC7t43381H	0	+	183	934	980	0.9530612
C7	36131655	36133266	BolC7t43382H	0	-	161	1257	1611	0.7802607
C7	36159803	36163167	BolC7t43383H	0	-	1070	3177	3364	0.9444114
C7	36173382	36175124	BolC7t43384H	0	-	938	1481	1742	0.8501722
C7	36177019	36178044	BolC7t43385H	0	+	110	1012	1025	0.9873171
C7	36180223	36181369	BolC7t43386H	0	-	64	1041	1146	0.9083770
C7	36193557	36194024	BolC7t43387H	0	+	37	182	467	0.3897216
C7	36194416	36194583	BolC7t43388H	0	+	0	0	167	0.0000000
C7	36195364	36195649	BolC7t43389H	0	-	43	285	285	1.0000000
C7	36218778	36219931	BolC7t43390H	0	+	413	1143	1153	0.9913270
C7	36230165	36231056	BolC7t43391H	0	-	748	891	891	1.0000000
C7	36233192	36235186	BolC7t43392H	0	+	1004	1994	1994	1.0000000
C7	36237017	36237929	BolC7t43393H	0	-	746	912	912	1.0000000
C7	36244343	36244684	BolC7t43394H	0	+	348	341	341	1.0000000
C7	36245307	36247467	BolC7t43395H	0	-	1129	2160	2160	1.0000000
C7	36251146	36251895	BolC7t43396H	0	+	28	609	749	0.8130841
C7	36257779	36258001	BolC7t43397H	0	+	465	222	222	1.0000000
C7	36262278	36266350	BolC7t43398H	0	+	4050	4072	4072	1.0000000
C7	36266867	36270854	BolC7t43399H	0	-	1881	3552	3987	0.8908954
C7	36275075	36282017	BolC7t43400H	0	-	2516	6296	6942	0.9069433
C7	36283934	36286301	BolC7t43401H	0	-	286	1752	2367	0.7401775
C7	36294436	36294790	BolC7t43402H	0	-	212	354	354	1.0000000
C7	36296446	36297981	BolC7t43403H	0	-	490	1320	1535	0.8599349
C7	36315686	36317134	BolC7t43404H	0	-	994	1448	1448	1.0000000
C7	36317635	36319131	BolC7t43405H	0	-	773	1496	1496	1.0000000
C7	36321590	36322109	BolC7t43406H	0	-	867	519	519	1.0000000
C7	36322138	36323268	BolC7t43407H	0	-	893	1130	1130	1.0000000
C7	36340380	36341679	BolC7t43408H	0	+	700	1299	1299	1.0000000
C7	36344782	36345256	BolC7t43409H	0	+	217	381	474	0.8037975
C7	36345857	36349082	BolC7t43410H	0	-	2693	3146	3225	0.9755039
C7	36353459	36354589	BolC7t43411H	0	-	1216	1130	1130	1.0000000
C7	36358716	36360646	BolC7t43412H	0	+	1547	1930	1930	1.0000000
C7	36367855	36368342	BolC7t43413H	0	+	744	487	487	1.0000000
C7	36369782	36370757	BolC7t43414H	0	+	1197	975	975	1.0000000
C7	36372602	36374523	BolC7t43415H	0	+	600	1895	1921	0.9864654
C7	36386722	36388005	BolC7t43416H	0	-	492	1158	1283	0.9025721
C7	36397750	36398584	BolC7t43417H	0	+	682	813	834	0.9748201
C7	36404145	36404499	BolC7t43418H	0	+	150	354	354	1.0000000
C7	36407694	36407829	BolC7t43419H	0	+	185	135	135	1.0000000
C7	36409526	36409880	BolC7t43420H	0	+	141	354	354	1.0000000
C7	36411268	36411622	BolC7t43421H	0	+	71	354	354	1.0000000
C7	36415798	36416152	BolC7t43422H	0	+	249	354	354	1.0000000
C7	36419354	36419708	BolC7t43423H	0	+	248	354	354	1.0000000
C7	36421129	36421483	BolC7t43424H	0	+	80	354	354	1.0000000
C7	36422909	36423263	BolC7t43425H	0	+	32	286	354	0.8079096
C7	36424698	36425052	BolC7t43426H	0	+	153	354	354	1.0000000
C7	36426487	36426841	BolC7t43427H	0	+	0	0	354	0.0000000
C7	36428276	36428630	BolC7t43428H	0	+	23	178	354	0.5028248
C7	36430065	36430236	BolC7t43429H	0	+	21	171	171	1.0000000
C7	36431856	36432210	BolC7t43430H	0	+	669	354	354	1.0000000
C7	36433645	36433999	BolC7t43431H	0	+	408	354	354	1.0000000
C7	36435434	36435788	BolC7t43432H	0	+	56	354	354	1.0000000
C7	36437221	36437575	BolC7t43433H	0	+	88	354	354	1.0000000
C7	36439009	36439363	BolC7t43434H	0	+	5	350	354	0.9887006
C7	36440801	36441155	BolC7t43435H	0	+	120	354	354	1.0000000
C7	36442595	36442727	BolC7t43436H	0	+	42	132	132	1.0000000
C7	36444388	36444520	BolC7t43437H	0	+	14	132	132	1.0000000
C7	36446178	36446532	BolC7t43438H	0	+	259	354	354	1.0000000
C7	36458830	36462360	BolC7t43439H	0	-	2310	3530	3530	1.0000000
C7	36474248	36475187	BolC7t43440H	0	+	184	924	939	0.9840255
C7	36477244	36477888	BolC7t43441H	0	-	197	372	644	0.5776398
C7	36479415	36480564	BolC7t43442H	0	-	654	1149	1149	1.0000000
C7	36485918	36486687	BolC7t43443H	0	+	535	769	769	1.0000000
C7	36496351	36496617	BolC7t43444H	0	-	23	266	266	1.0000000
C7	36496905	36502303	BolC7t43445H	0	+	1250	4629	5398	0.8575398
C7	36513663	36516581	BolC7t43446H	0	-	1478	2781	2918	0.9530500
C7	36543086	36548843	BolC7t43447H	0	+	1471	5148	5757	0.8942158
C7	36552637	36556156	BolC7t43448H	0	-	839	3349	3519	0.9516908
C7	36563566	36565009	BolC7t43449H	0	+	127	759	1443	0.5259875
C7	36565822	36567062	BolC7t43450H	0	-	645	1240	1240	1.0000000
C7	36567752	36568312	BolC7t43451H	0	-	70	207	560	0.3696429
C7	36576101	36576323	BolC7t43452H	0	+	126	222	222	1.0000000
C7	36581763	36582255	BolC7t43453H	0	+	321	492	492	1.0000000
C7	36589196	36590345	BolC7t43454H	0	-	192	908	1149	0.7902524
C7	36599306	36599435	BolC7t43455H	0	-	47	129	129	1.0000000
C7	36599489	36602591	BolC7t43456H	0	-	305	2326	3102	0.7498388
C7	36604629	36605348	BolC7t43457H	0	-	136	566	719	0.7872044
C7	36613394	36613883	BolC7t43458H	0	-	11	36	489	0.0736196
C7	36619083	36619311	BolC7t43459H	0	-	15	228	228	1.0000000
C7	36621985	36622282	BolC7t43460H	0	-	314	297	297	1.0000000
C7	36635876	36636793	BolC7t43461H	0	-	27	298	917	0.3249727
C7	36644579	36646319	BolC7t43462H	0	+	1216	1740	1740	1.0000000
C7	36657116	36659863	BolC7t43463H	0	+	1466	2747	2747	1.0000000
C7	36662062	36663537	BolC7t43464H	0	-	661	1473	1475	0.9986441
C7	36665837	36666478	BolC7t43465H	0	+	308	641	641	1.0000000
C7	36667242	36672026	BolC7t43466H	0	+	1027	3508	4784	0.7332776
C7	36677776	36678787	BolC7t43467H	0	-	251	991	1011	0.9802176
C7	36691110	36691836	BolC7t43468H	0	+	13	182	726	0.2506887
C7	36692971	36693625	BolC7t43469H	0	+	96	422	654	0.6452599
C7	36693709	36695128	BolC7t43470H	0	-	137	1044	1419	0.7357294
C7	36697464	36699985	BolC7t43471H	0	+	573	2426	2521	0.9623165
C7	36700650	36700890	BolC7t43472H	0	-	36	118	240	0.4916667
C7	36708425	36709101	BolC7t43473H	0	-	661	676	676	1.0000000
C7	36714101	36714272	BolC7t43474H	0	+	69	171	171	1.0000000
C7	36717474	36717742	BolC7t43475H	0	-	241	268	268	1.0000000
C7	36733895	36734921	BolC7t43476H	0	-	543	900	1026	0.8771930
C7	36737044	36737410	BolC7t43477H	0	+	0	0	366	0.0000000
C7	36743638	36744802	BolC7t43478H	0	-	703	1164	1164	1.0000000
C7	36750518	36752795	BolC7t43479H	0	-	1215	2214	2277	0.9723320
C7	36760224	36762682	BolC7t43480H	0	-	1263	2302	2458	0.9365337
C7	36765358	36774677	BolC7t43481H	0	-	445	2752	9319	0.2953106
C7	36787029	36787903	BolC7t43482H	0	-	9	420	874	0.4805492
C7	36799306	36800054	BolC7t43483H	0	-	1	29	748	0.0387701
C7	36800187	36800741	BolC7t43484H	0	-	0	0	554	0.0000000
C7	36804565	36805067	BolC7t43485H	0	+	69	158	502	0.3147410
C7	36819758	36820274	BolC7t43486H	0	-	26	350	516	0.6782946
C7	36820514	36820888	BolC7t43487H	0	-	937	374	374	1.0000000
C7	36825832	36826915	BolC7t43488H	0	+	4	249	1083	0.2299169
C7	36828901	36829018	BolC7t43489H	0	-	269	117	117	1.0000000
C7	36832831	36833388	BolC7t43490H	0	-	8	128	557	0.2298025
C7	36837146	36841999	BolC7t43491H	0	-	2182	4700	4853	0.9684731
C7	36850379	36871593	BolC7t43492H	0	+	1903	12262	21214	0.5780145
C7	36855714	36856071	BolC7t43493H	0	-	58	357	357	1.0000000
C7	36879939	36880242	BolC7t43494H	0	-	199	303	303	1.0000000
C7	36887125	36887560	BolC7t43495H	0	-	7	181	435	0.4160919
C7	36890419	36894140	BolC7t43496H	0	-	353	2133	3721	0.5732330
C7	36915485	36916980	BolC7t43497H	0	-	728	1375	1495	0.9197325
C7	36943851	36946327	BolC7t43498H	0	+	1134	2373	2476	0.9584007
C7	36948342	36951990	BolC7t43499H	0	-	1948	3571	3648	0.9788926
C7	36954433	36957018	BolC7t43500H	0	-	673	2573	2585	0.9953578
C7	36966313	36966526	BolC7t43501H	0	-	121	213	213	1.0000000
C7	36969374	36971494	BolC7t43502H	0	-	1178	2120	2120	1.0000000
C7	36975161	36975593	BolC7t43503H	0	-	1423	407	432	0.9421296
C7	36975646	36985292	BolC7t43504H	0	-	520	3101	9646	0.3214804
C7	36985438	36987699	BolC7t43505H	0	+	753	2212	2261	0.9783282
C7	36988916	36991768	BolC7t43506H	0	-	1814	2787	2852	0.9772090
C7	36999225	36999603	BolC7t43507H	0	+	86	378	378	1.0000000
C7	37008568	37009324	BolC7t43508H	0	-	49	598	756	0.7910053
C7	37010673	37011126	BolC7t43509H	0	+	0	0	453	0.0000000
C7	37027863	37030406	BolC7t43510H	0	-	1823	2543	2543	1.0000000
C7	37040324	37043469	BolC7t43511H	0	-	1251	2894	3145	0.9201908
C7	37055058	37055861	BolC7t43512H	0	+	226	803	803	1.0000000
C7	37057776	37061110	BolC7t43513H	0	+	885	3302	3334	0.9904019
C7	37078877	37081689	BolC7t43514H	0	-	2035	2812	2812	1.0000000
C7	37086705	37091253	BolC7t43515H	0	+	2257	4386	4548	0.9643800
C7	37092512	37094673	BolC7t43516H	0	+	1043	2118	2161	0.9801018
C7	37096380	37099172	BolC7t43517H	0	+	1347	2792	2792	1.0000000
C7	37101295	37101752	BolC7t43518H	0	-	453	457	457	1.0000000
C7	37109997	37112121	BolC7t43519H	0	+	251	1630	2124	0.7674199
C7	37112779	37127848	BolC7t43520H	0	+	8934	13469	15069	0.8938218
C7	37129399	37129627	BolC7t43521H	0	+	30	213	228	0.9342105
C7	37131434	37131593	BolC7t43522H	0	-	3	58	159	0.3647799
C7	37133911	37134872	BolC7t43523H	0	+	560	961	961	1.0000000
C7	37137196	37137529	BolC7t43524H	0	+	275	333	333	1.0000000
C7	37144145	37145295	BolC7t43525H	0	-	4	40	1150	0.0347826
C7	37146701	37148572	BolC7t43526H	0	+	667	1671	1871	0.8931053
C7	37151376	37151689	BolC7t43527H	0	+	35	278	313	0.8881789
C7	37154937	37155769	BolC7t43528H	0	+	415	832	832	1.0000000
C7	37174435	37176843	BolC7t43529H	0	+	564	1796	2408	0.7458472
C7	37177125	37179261	BolC7t43530H	0	-	273	1272	2136	0.5955056
C7	37199009	37200128	BolC7t43531H	0	+	89	846	1119	0.7560322
C7	37201229	37204010	BolC7t43532H	0	-	157	1863	2781	0.6699029
C7	37213657	37214684	BolC7t43533H	0	-	313	1023	1027	0.9961051
C7	37215899	37216415	BolC7t43534H	0	+	6	224	516	0.4341085
C7	37216672	37216894	BolC7t43535H	0	+	0	0	222	0.0000000
C7	37226434	37228904	BolC7t43536H	0	+	1014	2440	2470	0.9878542
C7	37235252	37236116	BolC7t43537H	0	+	52	314	864	0.3634259
C7	37248916	37250584	BolC7t43538H	0	+	415	1389	1668	0.8327338
C7	37264282	37264570	BolC7t43539H	0	-	214	288	288	1.0000000
C7	37269694	37314129	BolC7t43540H	0	+	17137	39237	44435	0.8830202
C7	37315451	37316630	BolC7t43541H	0	-	631	1179	1179	1.0000000
C7	37346284	37348815	BolC7t43542H	0	+	192	1482	2531	0.5855393
C7	37356511	37357702	BolC7t43543H	0	+	455	1177	1191	0.9882452
C7	37357998	37361360	BolC7t43544H	0	-	1996	3121	3362	0.9283165
C7	37361939	37363780	BolC7t43545H	0	-	1399	1841	1841	1.0000000
C7	37370385	37372122	BolC7t43546H	0	+	302	1177	1737	0.6776051
C7	37389929	37390563	BolC7t43547H	0	-	27	487	634	0.7681388
C7	37392596	37393289	BolC7t43548H	0	+	10	314	693	0.4531024
C7	37398377	37399025	BolC7t43549H	0	-	154	543	648	0.8379630
C7	37403333	37403731	BolC7t43550H	0	+	347	398	398	1.0000000
C7	37406828	37407939	BolC7t43551H	0	-	924	1111	1111	1.0000000
C7	37408328	37409305	BolC7t43552H	0	-	85	688	977	0.7041965
C7	37425559	37472518	BolC7t43553H	0	+	18630	37722	46959	0.8032965
C7	37429835	37430171	BolC7t43554H	0	+	183	336	336	1.0000000
C7	37468625	37469078	BolC7t43555H	0	+	684	453	453	1.0000000
C7	37500202	37502111	BolC7t43556H	0	+	563	1747	1909	0.9151388
C7	37505926	37507052	BolC7t43557H	0	+	654	1126	1126	1.0000000
C7	37507486	37508856	BolC7t43558H	0	-	551	1344	1370	0.9810219
C7	37510130	37511891	BolC7t43559H	0	+	1127	1644	1761	0.9335605
C7	37512654	37513736	BolC7t43560H	0	+	472	1082	1082	1.0000000
C7	37522118	37523045	BolC7t43561H	0	+	571	921	927	0.9935275
C7	37523798	37526417	BolC7t43562H	0	+	0	0	2619	0.0000000
C7	37531168	37532551	BolC7t43563H	0	+	0	0	1383	0.0000000
C7	37535130	37536703	BolC7t43564H	0	+	100	254	1573	0.1614749
C7	37537546	37538140	BolC7t43565H	0	+	0	0	594	0.0000000
C7	37538957	37539375	BolC7t43566H	0	+	286	418	418	1.0000000
C7	37541342	37541774	BolC7t43567H	0	-	124	409	432	0.9467593
C7	37542221	37544009	BolC7t43568H	0	+	560	1541	1788	0.8618568
C7	37559461	37560245	BolC7t43569H	0	+	24	187	784	0.2385204
C7	37561137	37562040	BolC7t43570H	0	+	46	540	903	0.5980067
C7	37565789	37567484	BolC7t43571H	0	-	0	0	1695	0.0000000
C7	37597537	37601649	BolC7t43572H	0	+	1041	3596	4112	0.8745136
C7	37637224	37637841	BolC7t43573H	0	-	403	617	617	1.0000000
C7	37639598	37640207	BolC7t43574H	0	-	246	609	609	1.0000000
C7	37642231	37642568	BolC7t43575H	0	-	397	337	337	1.0000000
C7	37644334	37644943	BolC7t43576H	0	-	88	579	609	0.9507389
C7	37646999	37649678	BolC7t43577H	0	-	754	2561	2679	0.9559537
C7	37655105	37656089	BolC7t43578H	0	-	239	984	984	1.0000000
C7	37656626	37657235	BolC7t43579H	0	-	366	609	609	1.0000000
C7	37659263	37659599	BolC7t43580H	0	-	354	336	336	1.0000000
C7	37662561	37662853	BolC7t43581H	0	-	131	292	292	1.0000000
C7	37665561	37665870	BolC7t43582H	0	-	27	309	309	1.0000000
C7	37666431	37667287	BolC7t43583H	0	-	19	511	856	0.5969626
C7	37668712	37670151	BolC7t43584H	0	-	139	1335	1439	0.9277276
C7	37671683	37672292	BolC7t43585H	0	-	92	609	609	1.0000000
C7	37674020	37674629	BolC7t43586H	0	-	189	609	609	1.0000000
C7	37676395	37679392	BolC7t43587H	0	-	621	2084	2997	0.6953620
C7	37681155	37681764	BolC7t43588H	0	-	128	607	609	0.9967159
C7	37708745	37709141	BolC7t43589H	0	-	235	396	396	1.0000000
C7	37709434	37709737	BolC7t43590H	0	+	319	303	303	1.0000000
C7	37715896	37719268	BolC7t43591H	0	+	1926	3372	3372	1.0000000
C7	37720668	37722882	BolC7t43592H	0	+	1282	2181	2214	0.9850948
C7	37723310	37723859	BolC7t43593H	0	-	218	533	549	0.9708561
C7	37726952	37727819	BolC7t43594H	0	+	0	0	867	0.0000000
C7	37728415	37728993	BolC7t43595H	0	+	287	578	578	1.0000000
C7	37730056	37730739	BolC7t43596H	0	+	114	460	683	0.6734993
C7	37752052	37752683	BolC7t43597H	0	-	221	631	631	1.0000000
C7	37753720	37754747	BolC7t43598H	0	+	153	944	1027	0.9191821
C7	37756008	37756508	BolC7t43599H	0	+	225	493	500	0.9860000
C7	37757038	37757274	BolC7t43600H	0	-	306	236	236	1.0000000
C7	37761179	37761740	BolC7t43601H	0	-	47	467	561	0.8324420
C7	37775677	37776265	BolC7t43602H	0	-	49	362	588	0.6156462
C7	37777069	37778062	BolC7t43603H	0	-	196	755	993	0.7603223
C7	37782879	37783134	BolC7t43604H	0	+	370	249	255	0.9764706
C7	37792703	37799958	BolC7t43605H	0	+	2688	6927	7255	0.9547898
C7	37806815	37807685	BolC7t43606H	0	-	709	870	870	1.0000000
C7	37807953	37808948	BolC7t43607H	0	+	489	995	995	1.0000000
C7	37812094	37812704	BolC7t43608H	0	+	17	346	610	0.5672131
C7	37814117	37818191	BolC7t43609H	0	-	1138	2706	4074	0.6642120
C7	37839017	37839209	BolC7t43610H	0	+	215	192	192	1.0000000
C7	37842053	37842871	BolC7t43611H	0	+	724	818	818	1.0000000
C7	37842944	37843619	BolC7t43612H	0	+	449	675	675	1.0000000
C7	37845275	37850397	BolC7t43613H	0	-	2686	5021	5122	0.9802811
C7	37874968	37875241	BolC7t43614H	0	+	342	273	273	1.0000000
C7	37877458	37878596	BolC7t43615H	0	+	515	1138	1138	1.0000000
C7	37883702	37884338	BolC7t43616H	0	-	259	636	636	1.0000000
C7	37889482	37890822	BolC7t43617H	0	+	340	906	1340	0.6761194
C7	37920795	37921657	BolC7t43618H	0	+	424	862	862	1.0000000
C7	37924949	37925665	BolC7t43619H	0	+	320	716	716	1.0000000
C7	37926281	37927976	BolC7t43620H	0	-	335	1614	1695	0.9522124
C7	37935482	37936154	BolC7t43621H	0	-	678	672	672	1.0000000
C7	37936289	37944166	BolC7t43622H	0	-	6140	7873	7877	0.9994922
C7	37954049	37956107	BolC7t43623H	0	-	709	1199	2058	0.5826045
C7	37964414	37967442	BolC7t43624H	0	+	1975	3028	3028	1.0000000
C7	37972930	37973515	BolC7t43625H	0	-	256	582	585	0.9948718
C7	37982346	37983345	BolC7t43626H	0	+	61	231	999	0.2312312
C7	37986964	37988122	BolC7t43627H	0	+	589	1158	1158	1.0000000
C7	37989107	37990908	BolC7t43628H	0	-	1037	1773	1801	0.9844531
C7	37991929	37993350	BolC7t43629H	0	-	1543	1421	1421	1.0000000
C7	37994467	37995382	BolC7t43630H	0	-	131	676	915	0.7387978
C7	37998442	37998691	BolC7t43631H	0	+	201	249	249	1.0000000
C7	37999114	37999303	BolC7t43632H	0	+	2	24	189	0.1269841
C7	38005421	38006946	BolC7t43633H	0	+	1254	1525	1525	1.0000000
C7	38010019	38011884	BolC7t43634H	0	-	784	1852	1865	0.9930295
C7	38015940	38016609	BolC7t43635H	0	-	337	669	669	1.0000000
C7	38020720	38023861	BolC7t43636H	0	+	2035	3141	3141	1.0000000
C7	38024533	38025081	BolC7t43637H	0	-	514	548	548	1.0000000
C7	38027601	38028362	BolC7t43638H	0	-	622	761	761	1.0000000
C7	38029610	38030078	BolC7t43639H	0	+	372	468	468	1.0000000
C7	38044644	38045032	BolC7t43640H	0	-	630	388	388	1.0000000
C7	38049489	38050422	BolC7t43641H	0	+	504	933	933	1.0000000
C7	38065366	38067081	BolC7t43642H	0	+	282	1499	1715	0.8740525
C7	38088217	38089491	BolC7t43643H	0	+	875	1274	1274	1.0000000
C7	38093749	38095481	BolC7t43644H	0	+	1045	1732	1732	1.0000000
C7	38095918	38102729	BolC7t43645H	0	+	3811	6811	6811	1.0000000
C7	38103716	38105150	BolC7t43646H	0	-	1116	1434	1434	1.0000000
C7	38107962	38109075	BolC7t43647H	0	-	1377	1113	1113	1.0000000
C7	38122645	38127964	BolC7t43648H	0	+	2161	4893	5319	0.9199098
C7	38129935	38131639	BolC7t43649H	0	+	650	1609	1704	0.9442489
C7	38131754	38133349	BolC7t43650H	0	-	424	1373	1595	0.8608150
C7	38139367	38140780	BolC7t43651H	0	-	405	1065	1413	0.7537155
C7	38141754	38143148	BolC7t43652H	0	+	1360	1352	1394	0.9698709
C7	38143376	38144204	BolC7t43653H	0	-	498	823	828	0.9939613
C7	38160338	38161843	BolC7t43654H	0	+	122	1312	1505	0.8717608
C7	38164857	38170465	BolC7t43655H	0	+	1490	4334	5608	0.7728245
C7	38181604	38183123	BolC7t43656H	0	-	522	1439	1519	0.9473338
C7	38185882	38186149	BolC7t43657H	0	+	118	267	267	1.0000000
C7	38192828	38194845	BolC7t43658H	0	+	471	1465	2017	0.7263262
C7	38195310	38196050	BolC7t43659H	0	-	172	648	740	0.8756757
C7	38198401	38200514	BolC7t43660H	0	-	1588	2031	2113	0.9611926
C7	38201614	38201977	BolC7t43661H	0	-	409	363	363	1.0000000
C7	38203723	38206510	BolC7t43662H	0	-	601	2143	2787	0.7689272
C7	38214945	38216912	BolC7t43663H	0	-	1475	1967	1967	1.0000000
C7	38217843	38218960	BolC7t43664H	0	-	743	1117	1117	1.0000000
C7	38220818	38221383	BolC7t43665H	0	-	280	558	565	0.9876106
C7	38222222	38223247	BolC7t43666H	0	-	480	1025	1025	1.0000000
C7	38229932	38230469	BolC7t43667H	0	-	69	508	537	0.9459963
C7	38231236	38232780	BolC7t43668H	0	-	860	1544	1544	1.0000000
C7	38243851	38244431	BolC7t43669H	0	-	257	580	580	1.0000000
C7	38246016	38246359	BolC7t43670H	0	+	90	343	343	1.0000000
C7	38248519	38248980	BolC7t43671H	0	+	351	461	461	1.0000000
C7	38254815	38255397	BolC7t43672H	0	+	0	0	582	0.0000000
C7	38262110	38265441	BolC7t43673H	0	-	2371	3102	3331	0.9312519
C7	38271784	38274636	BolC7t43674H	0	+	1268	2671	2852	0.9365358
C7	38274917	38276133	BolC7t43675H	0	-	629	1216	1216	1.0000000
C7	38276743	38285761	BolC7t43676H	0	+	2184	7565	9018	0.8388778
C7	38286410	38289558	BolC7t43677H	0	+	599	2361	3148	0.7500000
C7	38291095	38291818	BolC7t43678H	0	+	247	720	723	0.9958506
C7	38292284	38294280	BolC7t43679H	0	-	1354	1996	1996	1.0000000
C7	38315171	38333234	BolC7t43680H	0	+	16479	16158	18063	0.8945358
C7	38317593	38324064	BolC7t43681H	0	-	9233	6471	6471	1.0000000
C7	38327191	38331939	BolC7t43682H	0	+	2553	2928	4748	0.6166807
C7	38333472	38335424	BolC7t43683H	0	-	759	1952	1952	1.0000000
C7	38338563	38340635	BolC7t43684H	0	+	939	2058	2072	0.9932432
C7	38341321	38342539	BolC7t43685H	0	+	607	1218	1218	1.0000000
C7	38344037	38346028	BolC7t43686H	0	+	208	1709	1991	0.8583626
C7	38346450	38348149	BolC7t43687H	0	-	751	1594	1699	0.9381989
C7	38349199	38351452	BolC7t43688H	0	+	102	684	2253	0.3035952
C7	38351999	38352275	BolC7t43689H	0	-	250	276	276	1.0000000
C7	38354839	38358581	BolC7t43690H	0	+	1281	3465	3742	0.9259754
C7	38359645	38360208	BolC7t43691H	0	-	60	468	563	0.8312611
C7	38365382	38366763	BolC7t43692H	0	-	1017	1381	1381	1.0000000
C7	38367388	38369444	BolC7t43693H	0	+	1570	2056	2056	1.0000000
C7	38369995	38371103	BolC7t43694H	0	+	89	666	1108	0.6010830
C7	38374045	38381179	BolC7t43695H	0	+	6519	7057	7134	0.9892066
C7	38382621	38388708	BolC7t43696H	0	+	2184	5907	6087	0.9704288
C7	38389442	38390754	BolC7t43697H	0	-	605	1312	1312	1.0000000
C7	38391026	38391588	BolC7t43698H	0	+	330	562	562	1.0000000
C7	38394431	38400164	BolC7t43699H	0	-	2078	5303	5733	0.9249957
C7	38406214	38406679	BolC7t43700H	0	+	111	465	465	1.0000000
C7	38409895	38411983	BolC7t43701H	0	-	678	1980	2088	0.9482759
C7	38412400	38413719	BolC7t43702H	0	-	705	1313	1319	0.9954511
C7	38433953	38436218	BolC7t43703H	0	+	291	1507	2265	0.6653422
C7	38437379	38438214	BolC7t43704H	0	+	865	835	835	1.0000000
C7	38438433	38440846	BolC7t43705H	0	-	653	2190	2413	0.9075839
C7	38442255	38445088	BolC7t43706H	0	+	2330	2833	2833	1.0000000
C7	38451152	38452319	BolC7t43707H	0	-	756	1167	1167	1.0000000
C7	38458162	38460244	BolC7t43708H	0	-	1142	2062	2082	0.9903939
C7	38460842	38462627	BolC7t43709H	0	+	894	1785	1785	1.0000000
C7	38463161	38464282	BolC7t43710H	0	-	672	1121	1121	1.0000000
C7	38473473	38474274	BolC7t43711H	0	-	543	801	801	1.0000000
C7	38475388	38475865	BolC7t43712H	0	-	523	477	477	1.0000000
C7	38492414	38492842	BolC7t43713H	0	-	177	428	428	1.0000000
C7	38508428	38509633	BolC7t43714H	0	+	695	1205	1205	1.0000000
C7	38509845	38515499	BolC7t43715H	0	-	1652	5516	5654	0.9755925
C7	38522062	38522290	BolC7t43716H	0	+	51	208	228	0.9122807
C7	38522789	38524701	BolC7t43717H	0	+	1631	1861	1912	0.9733264
C7	38525278	38525846	BolC7t43718H	0	+	242	568	568	1.0000000
C7	38528306	38529737	BolC7t43719H	0	+	1046	1431	1431	1.0000000
C7	38536693	38537479	BolC7t43720H	0	-	613	543	786	0.6908397
C7	38538361	38539195	BolC7t43721H	0	+	162	834	834	1.0000000
C7	38542145	38552672	BolC7t43722H	0	+	6473	9943	10527	0.9445236
C7	38563603	38571800	BolC7t43723H	0	+	1118	6559	8197	0.8001708
C7	38575344	38577077	BolC7t43724H	0	+	822	169	1733	0.0975188
C7	38577427	38577961	BolC7t43725H	0	-	1899	534	534	1.0000000
C7	38579437	38582200	BolC7t43726H	0	-	5253	2762	2763	0.9996381
C7	38580851	38581753	BolC7t43727H	0	-	2311	902	902	1.0000000
C7	38585444	38585759	BolC7t43728H	0	+	0	0	315	0.0000000
C7	38588020	38588356	BolC7t43729H	0	-	113	336	336	1.0000000
C7	38598698	38599535	BolC7t43730H	0	+	220	783	837	0.9354839
C7	38606952	38611348	BolC7t43731H	0	-	1400	2988	4396	0.6797088
C7	38625617	38625989	BolC7t43732H	0	+	146	372	372	1.0000000
C7	38640127	38644792	BolC7t43733H	0	-	2106	4637	4665	0.9939979
C7	38645864	38648163	BolC7t43734H	0	-	918	2296	2299	0.9986951
C7	38652274	38657172	BolC7t43735H	0	-	1082	3211	4898	0.6555737
C7	38661659	38664929	BolC7t43736H	0	+	1552	2955	3270	0.9036697
C7	38665824	38666336	BolC7t43737H	0	+	362	512	512	1.0000000
C7	38675569	38680968	BolC7t43738H	0	-	965	3095	5399	0.5732543
C7	38685320	38685467	BolC7t43739H	0	+	12	147	147	1.0000000
C7	38716561	38719564	BolC7t43740H	0	+	559	2620	3003	0.8724609
C7	38722131	38723404	BolC7t43741H	0	+	5	274	1273	0.2152396
C7	38724408	38724558	BolC7t43742H	0	+	0	0	150	0.0000000
C7	38732298	38733369	BolC7t43743H	0	+	63	747	1071	0.6974790
C7	38745461	38747013	BolC7t43744H	0	-	434	1151	1552	0.7416237
C7	38749007	38749202	BolC7t43745H	0	-	336	195	195	1.0000000
C7	38751831	38752152	BolC7t43746H	0	-	8	68	321	0.2118380
C7	38753646	38755407	BolC7t43747H	0	-	213	1503	1761	0.8534923
C7	38777087	38777658	BolC7t43748H	0	+	504	571	571	1.0000000
C7	38785278	38786214	BolC7t43749H	0	-	135	649	936	0.6933761
C7	38787633	38788056	BolC7t43750H	0	-	89	423	423	1.0000000
C7	38789815	38790862	BolC7t43751H	0	+	608	1035	1047	0.9885387
C7	38791372	38792207	BolC7t43752H	0	-	477	835	835	1.0000000
C7	38793300	38793495	BolC7t43753H	0	+	197	195	195	1.0000000
C7	38797243	38797390	BolC7t43754H	0	+	60	147	147	1.0000000
C7	38811833	38812551	BolC7t43755H	0	+	678	718	718	1.0000000
C7	38824586	38825094	BolC7t43756H	0	+	176	508	508	1.0000000
C7	38825526	38827014	BolC7t43757H	0	-	1341	1488	1488	1.0000000
C7	38834430	38836170	BolC7t43758H	0	-	346	1653	1740	0.9500000
C7	38847477	38848041	BolC7t43759H	0	-	82	353	564	0.6258865
C7	38852156	38855578	BolC7t43760H	0	+	757	2802	3422	0.8188194
C7	38856227	38856944	BolC7t43761H	0	+	178	664	717	0.9260809
C7	38862106	38862745	BolC7t43762H	0	-	9	375	639	0.5868545
C7	38873608	38874511	BolC7t43763H	0	-	29	774	903	0.8571429
C7	38874852	38882595	BolC7t43764H	0	+	1220	3878	7743	0.5008395
C7	38885997	38887541	BolC7t43765H	0	-	312	1325	1544	0.8581606
C7	38893986	38895010	BolC7t43766H	0	-	106	648	1024	0.6328125
C7	38920542	38921514	BolC7t43767H	0	-	33	361	972	0.3713992
C7	38937939	38940302	BolC7t43768H	0	+	771	2357	2363	0.9974608
C7	38941171	38945437	BolC7t43769H	0	-	2621	4209	4266	0.9866385
C7	38953435	38955936	BolC7t43770H	0	-	1092	2477	2501	0.9904038
C7	38972332	38973283	BolC7t43771H	0	+	413	951	951	1.0000000
C7	38995171	38995423	BolC7t43772H	0	-	153	252	252	1.0000000
C7	39001356	39004220	BolC7t43773H	0	+	1519	2864	2864	1.0000000
C7	39010746	39012130	BolC7t43774H	0	+	623	1361	1384	0.9833815
C7	39015620	39019242	BolC7t43775H	0	+	1887	3314	3622	0.9149641
C7	39020417	39020933	BolC7t43776H	0	-	804	516	516	1.0000000
C7	39046691	39050745	BolC7t43777H	0	+	39	301	4054	0.0742477
C7	39052510	39054049	BolC7t43778H	0	-	93	1038	1539	0.6744639
C7	39067193	39072757	BolC7t43779H	0	+	3456	5259	5564	0.9451833
C7	39076583	39078935	BolC7t43780H	0	-	807	2138	2352	0.9090136
C7	39094383	39094806	BolC7t43781H	0	+	371	423	423	1.0000000
C7	39094895	39095306	BolC7t43782H	0	+	514	411	411	1.0000000
C7	39097189	39100115	BolC7t43783H	0	-	1800	2926	2926	1.0000000
C7	39146027	39147039	BolC7t43784H	0	+	280	985	1012	0.9733202
C7	39170031	39175084	BolC7t43785H	0	-	1419	4203	5053	0.8317831
C7	39197632	39199530	BolC7t43786H	0	+	328	1674	1898	0.8819810
C7	39200722	39202123	BolC7t43787H	0	+	636	1377	1401	0.9828694
C7	39202220	39209609	BolC7t43788H	0	-	2805	7152	7389	0.9679253
C7	39223424	39225257	BolC7t43789H	0	-	1393	1833	1833	1.0000000
C7	39226051	39228489	BolC7t43790H	0	-	1944	2388	2438	0.9794914
C7	39236326	39239233	BolC7t43791H	0	+	1087	2670	2907	0.9184726
C7	39245808	39249034	BolC7t43792H	0	+	1240	3008	3226	0.9324241
C7	39250141	39250761	BolC7t43793H	0	-	206	579	620	0.9338710
C7	39254090	39254862	BolC7t43794H	0	+	211	706	772	0.9145077
C7	39269110	39271703	BolC7t43795H	0	+	756	2501	2593	0.9645199
C7	39302174	39305585	BolC7t43796H	0	-	451	2788	3411	0.8173556
C7	39311854	39314658	BolC7t43797H	0	+	1896	2779	2804	0.9910842
C7	39321096	39322421	BolC7t43798H	0	+	1411	1325	1325	1.0000000
C7	39332659	39335019	BolC7t43799H	0	-	1722	2360	2360	1.0000000
C7	39346758	39346965	BolC7t43800H	0	+	27	207	207	1.0000000
C7	39348937	39351361	BolC7t43801H	0	+	1124	2384	2424	0.9834983
C7	39355582	39355891	BolC7t43802H	0	+	135	309	309	1.0000000
C7	39366730	39369068	BolC7t43803H	0	+	917	2290	2338	0.9794697
C7	39369711	39371280	BolC7t43804H	0	+	522	1349	1569	0.8597833
C7	39376652	39380617	BolC7t43805H	0	+	253	2334	3965	0.5886507
C7	39421108	39423933	BolC7t43806H	0	-	428	2335	2825	0.8265487
C7	39437336	39437696	BolC7t43807H	0	+	150	360	360	1.0000000
C7	39452063	39452621	BolC7t43808H	0	+	229	558	558	1.0000000
C7	39473103	39475305	BolC7t43809H	0	-	1295	2175	2202	0.9877384
C7	39481026	39481672	BolC7t43810H	0	-	0	0	646	0.0000000
C7	39492377	39496971	BolC7t43811H	0	-	1096	3950	4594	0.8598171
C7	39497974	39498949	BolC7t43812H	0	-	150	879	975	0.9015385
C7	39502988	39504069	BolC7t43813H	0	+	1	4	1081	0.0037003
C7	39513355	39514579	BolC7t43814H	0	-	357	1209	1224	0.9877451
C7	39515255	39515484	BolC7t43815H	0	-	115	229	229	1.0000000
C7	39518166	39518631	BolC7t43816H	0	-	0	0	465	0.0000000
C7	39520472	39522286	BolC7t43817H	0	-	939	1777	1814	0.9796031
C7	39541012	39541396	BolC7t43818H	0	+	29	278	384	0.7239583
C7	39555239	39558254	BolC7t43819H	0	-	461	2485	3015	0.8242123
C7	39580490	39581636	BolC7t43820H	0	-	589	1146	1146	1.0000000
C7	39584891	39586073	BolC7t43821H	0	-	408	1173	1182	0.9923858
C7	39588144	39589313	BolC7t43822H	0	-	644	1121	1169	0.9589393
C7	39590221	39596982	BolC7t43823H	0	-	407	3946	6761	0.5836415
C7	39612255	39612526	BolC7t43824H	0	+	297	247	271	0.9114391
C7	39614587	39619688	BolC7t43825H	0	-	568	3511	5101	0.6882964
C7	39622055	39622538	BolC7t43826H	0	-	0	0	483	0.0000000
C7	39623505	39624907	BolC7t43827H	0	-	4	116	1402	0.0827389
C7	39626044	39627050	BolC7t43828H	0	-	1221	1006	1006	1.0000000
C7	39633097	39635717	BolC7t43829H	0	-	1992	2620	2620	1.0000000
C7	39639286	39640371	BolC7t43830H	0	-	1600	1085	1085	1.0000000
C7	39647797	39649002	BolC7t43831H	0	+	495	1189	1205	0.9867220
C7	39650124	39652124	BolC7t43832H	0	+	1073	1543	2000	0.7715000
C7	39652846	39654780	BolC7t43833H	0	+	1406	1918	1934	0.9917270
C7	39660897	39661077	BolC7t43834H	0	+	260	180	180	1.0000000
C7	39682702	39685494	BolC7t43835H	0	+	901	2485	2792	0.8900430
C7	39690221	39692330	BolC7t43836H	0	+	1183	2099	2109	0.9952584
C7	39717259	39721462	BolC7t43837H	0	+	465	3120	4203	0.7423269
C7	39726220	39727318	BolC7t43838H	0	+	339	1070	1098	0.9744991
C7	39732242	39739304	BolC7t43839H	0	+	3264	6915	7062	0.9791844
C7	39745513	39747714	BolC7t43840H	0	-	1786	2129	2201	0.9672876
C7	39748754	39750140	BolC7t43841H	0	+	480	1354	1386	0.9769120
C7	39750761	39752454	BolC7t43842H	0	-	738	1516	1693	0.8954518
C7	39769700	39771542	BolC7t43843H	0	+	417	1678	1842	0.9109663
C7	39771886	39773746	BolC7t43844H	0	-	1471	1860	1860	1.0000000
C7	39774259	39775618	BolC7t43845H	0	+	631	1359	1359	1.0000000
C7	39780278	39781178	BolC7t43846H	0	+	802	900	900	1.0000000
C7	39781547	39784238	BolC7t43847H	0	-	450	2420	2691	0.8992940
C7	39787022	39787519	BolC7t43848H	0	-	157	453	497	0.9114688
C7	39788821	39789060	BolC7t43849H	0	+	122	239	239	1.0000000
C7	39792090	39793734	BolC7t43850H	0	-	0	0	1644	0.0000000
C7	39798192	39800358	BolC7t43851H	0	+	601	2113	2166	0.9755309
C7	39800942	39802928	BolC7t43852H	0	-	1272	1986	1986	1.0000000
C7	39811475	39811637	BolC7t43853H	0	+	3	127	162	0.7839506
C7	39812958	39813330	BolC7t43854H	0	-	580	372	372	1.0000000
C7	39814333	39814489	BolC7t43855H	0	-	26	156	156	1.0000000
C7	39815738	39815909	BolC7t43856H	0	-	7	130	171	0.7602339
C7	39817270	39818605	BolC7t43857H	0	-	191	984	1335	0.7370787
C7	39819955	39820222	BolC7t43858H	0	-	0	0	267	0.0000000
C7	39820324	39820591	BolC7t43859H	0	-	0	0	267	0.0000000
C7	39821429	39821534	BolC7t43860H	0	-	0	0	105	0.0000000
C7	39826640	39828879	BolC7t43861H	0	-	1410	2239	2239	1.0000000
C7	39830142	39831606	BolC7t43862H	0	+	149	1349	1464	0.9214481
C7	39855860	39856475	BolC7t43863H	0	-	131	615	615	1.0000000
C7	39861555	39865041	BolC7t43864H	0	-	741	2474	3486	0.7096959
C7	39872401	39873751	BolC7t43865H	0	+	305	1350	1350	1.0000000
C7	39898761	39901908	BolC7t43866H	0	-	733	3147	3147	1.0000000
C7	39907792	39908971	BolC7t43867H	0	-	259	1135	1179	0.9626802
C7	39914436	39916139	BolC7t43868H	0	-	675	1513	1703	0.8884322
C7	39917623	39919982	BolC7t43869H	0	-	1094	2136	2359	0.9054684
C7	39921708	39922289	BolC7t43870H	0	+	615	581	581	1.0000000
C7	39929399	39930368	BolC7t43871H	0	+	295	738	969	0.7616099
C7	39934306	39936467	BolC7t43872H	0	-	1542	2161	2161	1.0000000
C7	39937193	39939250	BolC7t43873H	0	+	1319	2033	2057	0.9883325
C7	39941883	39947175	BolC7t43874H	0	+	932	2503	5292	0.4729781
C7	39949941	39950856	BolC7t43875H	0	-	255	915	915	1.0000000
C7	39974466	39976263	BolC7t43876H	0	+	1164	1797	1797	1.0000000
C7	39977710	39979727	BolC7t43877H	0	+	722	1915	2017	0.9494299
C7	39991835	39992294	BolC7t43878H	0	+	352	459	459	1.0000000
C7	40003604	40004424	BolC7t43879H	0	-	97	783	820	0.9548780
C7	40015426	40015807	BolC7t43880H	0	+	1	23	381	0.0603675
C7	40016455	40017552	BolC7t43881H	0	-	24	402	1097	0.3664540
C7	40024904	40025141	BolC7t43882H	0	-	3	18	237	0.0759494
C7	40032406	40033792	BolC7t43883H	0	-	119	1115	1386	0.8044733
C7	40034244	40036057	BolC7t43884H	0	-	400	1627	1813	0.8974076
C7	40036356	40038312	BolC7t43885H	0	-	983	1921	1956	0.9821063
C7	40040276	40044440	BolC7t43886H	0	-	1959	3898	4164	0.9361191
C7	40059895	40060492	BolC7t43887H	0	+	74	523	597	0.8760469
C7	40072483	40077278	BolC7t43888H	0	-	1794	4138	4795	0.8629823
C7	40080528	40085816	BolC7t43889H	0	-	2208	5183	5288	0.9801437
C7	40088110	40088623	BolC7t43890H	0	+	335	513	513	1.0000000
C7	40105269	40106246	BolC7t43891H	0	+	189	781	977	0.7993858
C7	40130889	40131863	BolC7t43892H	0	-	941	974	974	1.0000000
C7	40144777	40145518	BolC7t43893H	0	-	283	573	741	0.7732794
C7	40148024	40148288	BolC7t43894H	0	+	276	264	264	1.0000000
C7	40155312	40157249	BolC7t43895H	0	-	774	1937	1937	1.0000000
C7	40160092	40161517	BolC7t43896H	0	-	685	1338	1425	0.9389474
C7	40162184	40164689	BolC7t43897H	0	-	516	1629	2505	0.6502994
C7	40165857	40167918	BolC7t43898H	0	+	481	1975	2061	0.9582727
C7	40168102	40169797	BolC7t43899H	0	-	618	1675	1695	0.9882006
C7	40170713	40172795	BolC7t43900H	0	+	47	807	2082	0.3876081
C7	40180718	40181252	BolC7t43901H	0	-	126	384	534	0.7191011
C7	40182365	40182764	BolC7t43902H	0	-	67	328	399	0.8220552
C7	40188893	40191867	BolC7t43903H	0	-	1116	2933	2974	0.9862139
C7	40192085	40195934	BolC7t43904H	0	-	1960	3374	3849	0.8765913
C7	40196005	40196712	BolC7t43905H	0	+	320	707	707	1.0000000
C7	40198595	40198934	BolC7t43906H	0	-	219	339	339	1.0000000
C7	40203780	40204559	BolC7t43907H	0	-	471	779	779	1.0000000
C7	40208874	40211540	BolC7t43908H	0	+	992	2622	2666	0.9834959
C7	40233697	40236017	BolC7t43909H	0	+	479	2000	2320	0.8620690
C7	40243190	40244237	BolC7t43910H	0	+	176	890	1047	0.8500478
C7	40256205	40257490	BolC7t43911H	0	+	874	1285	1285	1.0000000
C7	40258991	40259748	BolC7t43912H	0	-	536	757	757	1.0000000
C7	40262043	40262511	BolC7t43913H	0	+	253	468	468	1.0000000
C7	40263244	40264919	BolC7t43914H	0	-	1052	1675	1675	1.0000000
C7	40266417	40268177	BolC7t43915H	0	-	736	1760	1760	1.0000000
C7	40269105	40275531	BolC7t43916H	0	+	3470	6426	6426	1.0000000
C7	40276398	40276797	BolC7t43917H	0	+	552	399	399	1.0000000
C7	40277106	40277991	BolC7t43918H	0	-	450	822	885	0.9288136
C7	40289054	40291181	BolC7t43919H	0	-	1152	2055	2127	0.9661495
C7	40293960	40296025	BolC7t43920H	0	+	460	1993	2065	0.9651332
C7	40296558	40298124	BolC7t43921H	0	+	123	1163	1566	0.7426565
C7	40299085	40304298	BolC7t43922H	0	-	3264	5213	5213	1.0000000
C7	40306303	40308152	BolC7t43923H	0	-	758	1825	1849	0.9870200
C7	40317832	40318946	BolC7t43924H	0	-	780	991	1114	0.8895870
C7	40319727	40320889	BolC7t43925H	0	+	1151	1162	1162	1.0000000
C7	40330662	40332421	BolC7t43926H	0	+	1856	1759	1759	1.0000000
C7	40335925	40342241	BolC7t43927H	0	+	2823	5173	6316	0.8190311
C7	40337579	40338368	BolC7t43928H	0	+	451	766	789	0.9708492
C7	40342445	40342795	BolC7t43929H	0	-	0	0	350	0.0000000
C7	40343245	40343515	BolC7t43930H	0	-	0	0	270	0.0000000
C7	40354445	40355761	BolC7t43931H	0	+	715	1316	1316	1.0000000
C7	40357420	40357954	BolC7t43932H	0	+	69	334	534	0.6254682
C7	40358771	40360401	BolC7t43933H	0	-	111	610	1630	0.3742331
C7	40366944	40367571	BolC7t43934H	0	+	0	0	627	0.0000000
C7	40379107	40381893	BolC7t43935H	0	+	8	176	2786	0.0631730
C7	40404498	40450683	BolC7t43936H	0	+	2968	11575	46185	0.2506225
C7	40429403	40429709	BolC7t43937H	0	+	0	0	306	0.0000000
C7	40450855	40452619	BolC7t43938H	0	+	0	0	1764	0.0000000
C7	40458442	40459386	BolC7t43939H	0	-	97	864	944	0.9152542
C7	40468009	40469229	BolC7t43940H	0	+	2	172	1220	0.1409836
C7	40469433	40469783	BolC7t43941H	0	-	0	0	350	0.0000000
C7	40470232	40470502	BolC7t43942H	0	-	0	0	270	0.0000000
C7	40480863	40481397	BolC7t43943H	0	+	10	161	534	0.3014981
C7	40482915	40485149	BolC7t43944H	0	-	120	940	2234	0.4207699
C7	40490480	40490895	BolC7t43945H	0	+	1	61	415	0.1469879
C7	40498034	40498696	BolC7t43946H	0	+	68	503	662	0.7598187
C7	40503507	40504431	BolC7t43947H	0	+	0	0	924	0.0000000
C7	40534516	40537353	BolC7t43948H	0	+	21	112	2837	0.0394783
C7	40552545	40553332	BolC7t43949H	0	+	0	0	787	0.0000000
C7	40555933	40556149	BolC7t43950H	0	+	0	0	216	0.0000000
C7	40557194	40557380	BolC7t43951H	0	-	0	0	186	0.0000000
C7	40566460	40568252	BolC7t43952H	0	+	1250	1792	1792	1.0000000
C7	40580194	40581578	BolC7t43953H	0	+	790	1384	1384	1.0000000
C7	40583604	40587218	BolC7t43954H	0	+	2265	3552	3614	0.9828445
C7	40587526	40589419	BolC7t43955H	0	+	567	1840	1893	0.9720021
C7	40592244	40594188	BolC7t43956H	0	+	636	1793	1944	0.9223251
C7	40597908	40598211	BolC7t43957H	0	+	74	303	303	1.0000000
C7	40615464	40620129	BolC7t43958H	0	+	3006	4665	4665	1.0000000
C7	40632039	40635830	BolC7t43959H	0	+	1934	3770	3791	0.9944606
C7	40641064	40641217	BolC7t43960H	0	+	106	153	153	1.0000000
C7	40642388	40642615	BolC7t43961H	0	-	53	227	227	1.0000000
C7	40642855	40643396	BolC7t43962H	0	+	178	541	541	1.0000000
C7	40659024	40659153	BolC7t43963H	0	-	157	129	129	1.0000000
C7	40671536	40671662	BolC7t43964H	0	+	78	107	126	0.8492063
C7	40696156	40696669	BolC7t43965H	0	+	38	329	513	0.6413255
C7	40707967	40708961	BolC7t43966H	0	+	1006	994	994	1.0000000
C7	40709525	40714699	BolC7t43967H	0	-	1910	4641	5174	0.8969849
C7	40761568	40763989	BolC7t43968H	0	+	1540	2095	2421	0.8653449
C7	40794784	40795984	BolC7t43969H	0	+	440	1200	1200	1.0000000
C7	40798447	40800374	BolC7t43970H	0	+	265	1507	1927	0.7820446
C7	40806525	40807348	BolC7t43971H	0	+	179	697	823	0.8469016
C7	40810721	40811210	BolC7t43972H	0	+	126	476	489	0.9734151
C7	40812666	40812900	BolC7t43973H	0	+	28	234	234	1.0000000
C7	40814091	40819203	BolC7t43974H	0	-	2405	5054	5112	0.9886541
C7	40835300	40835666	BolC7t43975H	0	-	404	366	366	1.0000000
C7	40861042	40863643	BolC7t43976H	0	-	963	2512	2601	0.9657824
C7	40883460	40883742	BolC7t43977H	0	-	396	282	282	1.0000000
C7	40883804	40884027	BolC7t43978H	0	-	151	219	223	0.9820628
C7	40884122	40885415	BolC7t43979H	0	-	764	1293	1293	1.0000000
C7	40905279	40906077	BolC7t43980H	0	+	364	632	798	0.7919800
C7	40938671	40938914	BolC7t43981H	0	-	154	243	243	1.0000000
C7	40950365	40951662	BolC7t43982H	0	-	708	1297	1297	1.0000000
C7	40954642	40954918	BolC7t43983H	0	-	65	231	276	0.8369565
C7	40963215	40966088	BolC7t43984H	0	+	3381	2714	2873	0.9446571
C7	40974248	40976084	BolC7t43985H	0	-	110	1470	1836	0.8006536
C7	40979717	40981493	BolC7t43986H	0	+	1583	1776	1776	1.0000000
C7	40981976	40986711	BolC7t43987H	0	+	2319	4511	4735	0.9526927
C7	40987958	40989314	BolC7t43988H	0	+	315	1216	1356	0.8967552
C7	41016529	41017828	BolC7t43989H	0	+	206	968	1299	0.7451886
C7	41019807	41019987	BolC7t43990H	0	-	40	118	180	0.6555555
C7	41032773	41032896	BolC7t43991H	0	+	52	123	123	1.0000000
C7	41058611	41059037	BolC7t43992H	0	-	334	426	426	1.0000000
C7	41064001	41064109	BolC7t43993H	0	-	112	108	108	1.0000000
C7	41081591	41082626	BolC7t43994H	0	+	267	985	1035	0.9516908
C7	41086245	41086775	BolC7t43995H	0	-	0	0	530	0.0000000
C7	41087085	41087955	BolC7t43996H	0	+	180	857	870	0.9850575
C7	41095069	41095931	BolC7t43997H	0	+	159	836	862	0.9698376
C7	41096774	41108606	BolC7t43998H	0	-	4554	8194	11832	0.6925287
C7	41108717	41109582	BolC7t43999H	0	+	802	865	865	1.0000000
C7	41123805	41126161	BolC7t44000H	0	+	778	2328	2356	0.9881154
C7	41136736	41199837	BolC7t44001H	0	-	12279	42357	63101	0.6712572
C7	41139407	41146659	BolC7t44002H	0	+	1076	5257	7252	0.7249035
C7	41155033	41155492	BolC7t44003H	0	-	13	356	459	0.7755991
C7	41170266	41171774	BolC7t44004H	0	-	113	567	1508	0.3759947
C7	41178763	41179126	BolC7t44005H	0	-	3	115	363	0.3168044
C7	41196142	41198298	BolC7t44006H	0	-	48	584	2156	0.2708720
C7	41219953	41220638	BolC7t44007H	0	+	797	685	685	1.0000000
C7	41231517	41232830	BolC7t44008H	0	-	1254	1313	1313	1.0000000
C7	41233124	41233289	BolC7t44009H	0	-	231	165	165	1.0000000
C7	41252569	41303148	BolC7t44010H	0	+	3678	24023	50579	0.4749600
C7	41256138	41259300	BolC7t44011H	0	-	125	1278	3162	0.4041746
C7	41287648	41287899	BolC7t44012H	0	+	172	139	251	0.5537848
C7	41305469	41310765	BolC7t44013H	0	-	57	1542	5296	0.2911631
C7	41309347	41309665	BolC7t44014H	0	-	0	0	318	0.0000000
C7	41322169	41322581	BolC7t44015H	0	-	0	0	412	0.0000000
C7	41323961	41325061	BolC7t44016H	0	-	6	307	1100	0.2790909
C7	41328679	41330618	BolC7t44017H	0	+	2546	1939	1939	1.0000000
C7	41332260	41337929	BolC7t44018H	0	-	1100	4529	5669	0.7989063
C7	41339388	41339828	BolC7t44019H	0	-	514	440	440	1.0000000
C7	41340241	41342200	BolC7t44020H	0	+	909	1959	1959	1.0000000
C7	41342948	41343467	BolC7t44021H	0	-	472	519	519	1.0000000
C7	41377327	41377919	BolC7t44022H	0	-	206	592	592	1.0000000
C7	41394369	41394525	BolC7t44023H	0	+	21	156	156	1.0000000
C7	41396036	41396270	BolC7t44024H	0	+	13	206	234	0.8803419
C7	41404949	41406316	BolC7t44025H	0	+	734	1354	1367	0.9904901
C7	41418153	41420085	BolC7t44026H	0	+	1500	1932	1932	1.0000000
C7	41425166	41425409	BolC7t44027H	0	-	87	243	243	1.0000000
C7	41427370	41428272	BolC7t44028H	0	+	638	891	902	0.9878049
C7	41434789	41435785	BolC7t44029H	0	+	1018	996	996	1.0000000
C7	41435950	41437068	BolC7t44030H	0	-	946	1118	1118	1.0000000
C7	41444521	41445316	BolC7t44031H	0	-	77	764	795	0.9610063
C7	41449950	41450688	BolC7t44032H	0	+	154	725	738	0.9823848
C7	41452071	41452482	BolC7t44033H	0	+	269	411	411	1.0000000
C7	41453837	41455218	BolC7t44034H	0	-	310	1276	1381	0.9239681
C7	41474908	41476914	BolC7t44035H	0	+	789	1923	2006	0.9586241
C7	41477880	41479391	BolC7t44036H	0	+	1183	1511	1511	1.0000000
C7	41481414	41487483	BolC7t44037H	0	+	4319	6069	6069	1.0000000
C7	41493104	41493407	BolC7t44038H	0	+	27	291	303	0.9603961
C7	41506148	41508429	BolC7t44039H	0	+	974	2206	2281	0.9671197
C7	41509179	41509518	BolC7t44040H	0	+	115	339	339	1.0000000
C7	41511846	41513563	BolC7t44041H	0	+	1252	1717	1717	1.0000000
C7	41521396	41523881	BolC7t44042H	0	+	76	1383	2485	0.5565392
C7	41530833	41533278	BolC7t44043H	0	-	1107	2360	2445	0.9652352
C7	41533779	41536953	BolC7t44044H	0	-	424	2047	3174	0.6449276
C7	41545211	41546353	BolC7t44045H	0	-	3	169	1142	0.1479860
C7	41547290	41547657	BolC7t44046H	0	+	333	335	367	0.9128065
C7	41569784	41574162	BolC7t44047H	0	-	3379	4143	4378	0.9463225
C7	41574391	41574598	BolC7t44048H	0	-	268	207	207	1.0000000
C7	41578601	41579072	BolC7t44049H	0	+	181	471	471	1.0000000
C7	41580969	41581443	BolC7t44050H	0	-	407	474	474	1.0000000
C7	41586236	41587897	BolC7t44051H	0	-	669	1653	1661	0.9951836
C7	41593101	41606629	BolC7t44052H	0	+	3251	9184	13528	0.6788883
C7	41613813	41615411	BolC7t44053H	0	-	516	1454	1598	0.9098874
C7	41620610	41622491	BolC7t44054H	0	+	95	1173	1881	0.6236045
C7	41632094	41635658	BolC7t44055H	0	-	1419	3432	3564	0.9629630
C7	41656434	41657171	BolC7t44056H	0	+	258	737	737	1.0000000
C7	41657940	41660241	BolC7t44057H	0	-	745	2267	2301	0.9852238
C7	41660617	41662387	BolC7t44058H	0	-	438	1672	1770	0.9446328
C7	41668046	41669795	BolC7t44059H	0	-	200	1501	1749	0.8582047
C7	41675914	41677292	BolC7t44060H	0	+	908	1378	1378	1.0000000
C7	41679320	41689396	BolC7t44061H	0	-	2359	6397	10076	0.6348749
C7	41689939	41690494	BolC7t44062H	0	-	22	141	555	0.2540540
C7	41690974	41694020	BolC7t44063H	0	+	2967	3046	3046	1.0000000
C7	41695059	41697206	BolC7t44064H	0	-	173	1608	2147	0.7489520
C7	41703361	41704444	BolC7t44065H	0	-	97	662	1083	0.6112650
C7	41711634	41711952	BolC7t44066H	0	-	244	318	318	1.0000000
C7	41712384	41715144	BolC7t44067H	0	+	2213	2760	2760	1.0000000
C7	41716983	41719384	BolC7t44068H	0	+	1089	1926	2401	0.8021657
C7	41719756	41721576	BolC7t44069H	0	-	634	1805	1820	0.9917582
C7	41722602	41723016	BolC7t44070H	0	+	92	414	414	1.0000000
C7	41724220	41725695	BolC7t44071H	0	+	874	1475	1475	1.0000000
C7	41728529	41731043	BolC7t44072H	0	+	477	1637	2514	0.6511536
C7	41740643	41742811	BolC7t44073H	0	+	332	1645	2168	0.7587638
C7	41744757	41745744	BolC7t44074H	0	+	229	987	987	1.0000000
C7	41747236	41747874	BolC7t44075H	0	-	230	638	638	1.0000000
C7	41770088	41770310	BolC7t44076H	0	+	51	221	222	0.9954955
C7	41784462	41785535	BolC7t44077H	0	-	185	837	1073	0.7800559
C7	41796610	41800612	BolC7t44078H	0	-	420	2984	4002	0.7456272
C7	41806361	41808538	BolC7t44079H	0	+	754	2001	2177	0.9191548
C7	41810025	41811357	BolC7t44080H	0	+	555	1268	1332	0.9519520
C7	41812140	41817861	BolC7t44081H	0	-	1380	4384	5721	0.7662996
C7	41830804	41842961	BolC7t44082H	0	-	2844	7764	12157	0.6386444
C7	41839930	41840860	BolC7t44083H	0	-	69	693	930	0.7451613
C7	41840942	41841111	BolC7t44084H	0	-	57	110	169	0.6508875
C7	41873269	41877051	BolC7t44085H	0	+	460	2690	3782	0.7112639
C7	41878458	41878596	BolC7t44086H	0	+	3	8	138	0.0579710
C7	41878820	41879268	BolC7t44087H	0	+	3	267	448	0.5959821
C7	41879673	41881032	BolC7t44088H	0	-	349	924	1359	0.6799117
C7	41881843	41883391	BolC7t44089H	0	+	705	1519	1548	0.9812661
C7	41883602	41885908	BolC7t44090H	0	-	1797	2306	2306	1.0000000
C7	41886638	41888663	BolC7t44091H	0	+	1317	2025	2025	1.0000000
C7	41889454	41890486	BolC7t44092H	0	-	373	947	1032	0.9176357
C7	41893518	41895149	BolC7t44093H	0	+	256	1420	1631	0.8706315
C7	41896237	41897293	BolC7t44094H	0	+	444	1056	1056	1.0000000
C7	41898992	41905329	BolC7t44095H	0	+	2566	5891	6337	0.9296197
C7	41906604	41908384	BolC7t44096H	0	-	806	1780	1780	1.0000000
C7	41911960	41913445	BolC7t44097H	0	-	827	1485	1485	1.0000000
C7	41914794	41916178	BolC7t44098H	0	+	67	721	1384	0.5209538
C7	41919786	41920910	BolC7t44099H	0	-	119	934	1124	0.8309609
C7	41927164	41928971	BolC7t44100H	0	-	59	900	1807	0.4980631
C7	41942699	41942990	BolC7t44101H	0	+	91	291	291	1.0000000
C7	41945181	41948707	BolC7t44102H	0	-	763	2702	3526	0.7663074
C7	41972245	41972533	BolC7t44103H	0	+	0	0	288	0.0000000
C7	41975541	41976801	BolC7t44104H	0	+	33	777	1260	0.6166667
C7	41986762	41987490	BolC7t44105H	0	-	0	0	728	0.0000000
C7	41989295	42012953	BolC7t44106H	0	+	1907	6505	23658	0.2749598
C7	42002169	42002678	BolC7t44107H	0	-	0	0	509	0.0000000
C7	42013270	42013678	BolC7t44108H	0	-	227	408	408	1.0000000
C7	42016971	42017373	BolC7t44109H	0	-	359	402	402	1.0000000
C7	42030262	42031209	BolC7t44110H	0	+	14	394	947	0.4160507
C7	42033621	42034030	BolC7t44111H	0	-	55	328	409	0.8019560
C7	42040139	42040544	BolC7t44112H	0	-	185	394	405	0.9728395
C7	42044577	42047104	BolC7t44113H	0	-	1310	2357	2527	0.9327266
C7	42048947	42050995	BolC7t44114H	0	-	2066	2048	2048	1.0000000
C7	42051495	42054284	BolC7t44115H	0	-	1683	2789	2789	1.0000000
C7	42055130	42056582	BolC7t44116H	0	+	1359	1452	1452	1.0000000
C7	42058498	42063139	BolC7t44117H	0	+	2408	4425	4641	0.9534583
C7	42064433	42066601	BolC7t44118H	0	-	812	2143	2168	0.9884686
C7	42067480	42069365	BolC7t44119H	0	-	907	1880	1885	0.9973475
C7	42080108	42082374	BolC7t44120H	0	-	1057	2205	2266	0.9730803
C7	42083077	42085806	BolC7t44121H	0	+	806	2690	2729	0.9857091
C7	42086835	42087633	BolC7t44122H	0	+	324	798	798	1.0000000
C7	42088520	42089126	BolC7t44123H	0	+	476	606	606	1.0000000
C7	42089336	42092038	BolC7t44124H	0	-	1492	2536	2702	0.9385640
C7	42093384	42094338	BolC7t44125H	0	-	366	954	954	1.0000000
C7	42105325	42105466	BolC7t44126H	0	-	39	141	141	1.0000000
C7	42106923	42108261	BolC7t44127H	0	+	492	1200	1338	0.8968610
C7	42109176	42109386	BolC7t44128H	0	+	88	210	210	1.0000000
C7	42109778	42114187	BolC7t44129H	0	-	883	3420	4409	0.7756861
C7	42116510	42117506	BolC7t44130H	0	-	197	948	996	0.9518072
C7	42123173	42124450	BolC7t44131H	0	+	671	1277	1277	1.0000000
C7	42125139	42126001	BolC7t44132H	0	-	236	760	862	0.8816705
C7	42126329	42128082	BolC7t44133H	0	+	191	1564	1753	0.8921849
C7	42128909	42130205	BolC7t44134H	0	-	318	1261	1296	0.9729939
C7	42157053	42159783	BolC7t44135H	0	+	693	2595	2730	0.9505494
C7	42160053	42162985	BolC7t44136H	0	-	1532	2906	2932	0.9911323
C7	42163177	42165202	BolC7t44137H	0	+	177	1555	2025	0.7679012
C7	42165444	42168907	BolC7t44138H	0	-	1395	3334	3463	0.9627491
C7	42172707	42173350	BolC7t44139H	0	-	73	426	643	0.6625195
C7	42174575	42176467	BolC7t44140H	0	-	904	1892	1892	1.0000000
C7	42187216	42189092	BolC7t44141H	0	-	589	1767	1876	0.9418976
C7	42191239	42193286	BolC7t44142H	0	-	1096	1961	2047	0.9579873
C7	42204398	42205247	BolC7t44143H	0	+	142	750	849	0.8833922
C7	42210805	42211165	BolC7t44144H	0	+	146	360	360	1.0000000
C7	42214352	42214832	BolC7t44145H	0	+	88	480	480	1.0000000
C7	42217418	42217661	BolC7t44146H	0	+	3	168	243	0.6913580
C7	42232399	42235726	BolC7t44147H	0	+	1823	3141	3327	0.9440938
C7	42238026	42239150	BolC7t44148H	0	+	550	1119	1124	0.9955516
C7	42261983	42264377	BolC7t44149H	0	-	1561	2394	2394	1.0000000
C7	42271770	42273570	BolC7t44150H	0	+	188	1291	1800	0.7172222
C7	42280117	42283464	BolC7t44151H	0	-	1833	3282	3347	0.9805796
C7	42290100	42291717	BolC7t44152H	0	-	468	1617	1617	1.0000000
C7	42294253	42300218	BolC7t44153H	0	+	1159	4849	5965	0.8129086
C7	42300646	42300835	BolC7t44154H	0	-	153	189	189	1.0000000
C7	42302224	42302377	BolC7t44155H	0	-	164	153	153	1.0000000
C7	42303494	42303992	BolC7t44156H	0	-	3	80	498	0.1606426
C7	42307657	42309419	BolC7t44157H	0	-	252	1415	1762	0.8030647
C7	42310964	42316913	BolC7t44158H	0	+	4624	5949	5949	1.0000000
C7	42323054	42324463	BolC7t44159H	0	+	606	1409	1409	1.0000000
C7	42324920	42325439	BolC7t44160H	0	-	211	519	519	1.0000000
C7	42325829	42326173	BolC7t44161H	0	-	403	344	344	1.0000000
C7	42326588	42327531	BolC7t44162H	0	-	197	869	943	0.9215270
C7	42334669	42335515	BolC7t44163H	0	+	819	846	846	1.0000000
C7	42338279	42340936	BolC7t44164H	0	-	465	2376	2657	0.8942416
C7	42343593	42346368	BolC7t44165H	0	+	590	1981	2775	0.7138739
C7	42346893	42347268	BolC7t44166H	0	-	28	319	375	0.8506666
C7	42350659	42350976	BolC7t44167H	0	-	108	317	317	1.0000000
C7	42353943	42361755	BolC7t44168H	0	+	2091	6327	7812	0.8099079
C7	42363499	42365133	BolC7t44169H	0	-	985	1605	1634	0.9822521
C7	42372811	42375489	BolC7t44170H	0	-	1047	2440	2678	0.9111277
C7	42377576	42379990	BolC7t44171H	0	+	558	1987	2414	0.8231152
C7	42381294	42381903	BolC7t44172H	0	-	2	21	609	0.0344828
C7	42392739	42392994	BolC7t44173H	0	+	0	0	255	0.0000000
C7	42397543	42427747	BolC7t44174H	0	+	2789	14734	30204	0.4878162
C7	42439423	42439546	BolC7t44175H	0	-	8	116	123	0.9430894
C7	42439954	42440213	BolC7t44176H	0	+	0	0	259	0.0000000
C7	42445581	42446020	BolC7t44177H	0	+	44	114	439	0.2596811
C7	42451909	42454615	BolC7t44178H	0	+	325	1552	2706	0.5735403
C7	42465467	42466248	BolC7t44179H	0	+	416	738	781	0.9449424
C7	42474196	42474670	BolC7t44180H	0	-	188	410	474	0.8649789
C7	42474767	42476589	BolC7t44181H	0	-	1073	1468	1822	0.8057080
C7	42491895	42497408	BolC7t44182H	0	-	1411	4650	5513	0.8434609
C7	42504074	42505668	BolC7t44183H	0	+	837	1594	1594	1.0000000
C7	42507095	42512821	BolC7t44184H	0	-	1673	5242	5726	0.9154733
C7	42515349	42517491	BolC7t44185H	0	-	1308	2113	2142	0.9864612
C7	42520044	42522473	BolC7t44186H	0	-	795	2105	2429	0.8666118
C7	42534493	42535614	BolC7t44187H	0	+	1088	1121	1121	1.0000000
C7	42540609	42587567	BolC7t44188H	0	+	20529	43274	46958	0.9215469
C7	42544741	42545151	BolC7t44189H	0	-	21	276	410	0.6731707
C7	42554087	42554891	BolC7t44190H	0	+	235	804	804	1.0000000
C7	42568242	42569457	BolC7t44191H	0	+	1005	1215	1215	1.0000000
C7	42576545	42577100	BolC7t44192H	0	+	466	555	555	1.0000000
C7	42600539	42600827	BolC7t44193H	0	+	0	0	288	0.0000000
C7	42618419	42622805	BolC7t44194H	0	+	2872	4386	4386	1.0000000
C7	42623724	42624066	BolC7t44195H	0	+	405	342	342	1.0000000
C7	42627738	42630761	BolC7t44196H	0	+	2732	3002	3023	0.9930533
C7	42639137	42639536	BolC7t44197H	0	+	543	399	399	1.0000000
C7	42675416	42683768	BolC7t44198H	0	+	6409	8075	8352	0.9668343
C7	42690745	42691673	BolC7t44199H	0	+	229	821	928	0.8846983
C7	42692377	42695654	BolC7t44200H	0	-	1155	3070	3277	0.9368325
C7	42696966	42698922	BolC7t44201H	0	-	1195	1956	1956	1.0000000
C7	42701854	42701977	BolC7t44202H	0	-	135	123	123	1.0000000
C7	42703056	42704980	BolC7t44203H	0	-	1397	1924	1924	1.0000000
C7	42709983	42710545	BolC7t44204H	0	-	210	562	562	1.0000000
C7	42712380	42712488	BolC7t44205H	0	-	119	108	108	1.0000000
C7	42715193	42715643	BolC7t44206H	0	-	0	0	450	0.0000000
C7	42718681	42718903	BolC7t44207H	0	-	104	222	222	1.0000000
C7	42727265	42729738	BolC7t44208H	0	+	702	1860	2473	0.7521229
C7	42758898	42760011	BolC7t44209H	0	-	472	1008	1113	0.9056604
C7	42766867	42768575	BolC7t44210H	0	-	77	746	1708	0.4367681
C7	42778345	42781134	BolC7t44211H	0	+	801	2268	2789	0.8131947
C7	42783911	42784487	BolC7t44212H	0	+	454	576	576	1.0000000
C7	42785904	42786483	BolC7t44213H	0	+	548	579	579	1.0000000
C7	42786811	42789008	BolC7t44214H	0	+	1831	2108	2197	0.9594902
C7	42790342	42791072	BolC7t44215H	0	-	733	730	730	1.0000000
C7	42802380	42807106	BolC7t44216H	0	+	2866	4726	4726	1.0000000
C7	42808846	42809605	BolC7t44217H	0	+	543	759	759	1.0000000
C7	42811225	42812537	BolC7t44218H	0	-	1017	1312	1312	1.0000000
C7	42817618	42817901	BolC7t44219H	0	+	409	283	283	1.0000000
C7	42819305	42820562	BolC7t44220H	0	-	629	1229	1257	0.9777247
C7	42839340	42840881	BolC7t44221H	0	-	979	1541	1541	1.0000000
C7	42850594	42860209	BolC7t44222H	0	-	2990	8130	9615	0.8455538
C7	42865041	42867296	BolC7t44223H	0	-	1239	2205	2255	0.9778271
C7	42868649	42870679	BolC7t44224H	0	-	2478	2030	2030	1.0000000
C7	42887372	42887564	BolC7t44225H	0	-	361	192	192	1.0000000
C7	42888303	42889149	BolC7t44226H	0	-	120	516	846	0.6099291
C7	42903592	42905329	BolC7t44227H	0	-	2816	1737	1737	1.0000000
C7	42906544	42908601	BolC7t44228H	0	-	557	1835	2057	0.8920758
C7	42911201	42912347	BolC7t44229H	0	+	525	1065	1146	0.9293194
C7	42920672	42922893	BolC7t44230H	0	+	508	1702	2221	0.7663215
C7	42932701	42934483	BolC7t44231H	0	+	1449	1782	1782	1.0000000
C7	42936269	42938082	BolC7t44232H	0	-	331	1155	1813	0.6370656
C7	42944453	42961810	BolC7t44233H	0	+	4750	15394	17357	0.8869044
C7	42964151	42983827	BolC7t44234H	0	+	5462	14683	19676	0.7462391
C7	42971329	42973019	BolC7t44235H	0	+	864	1690	1690	1.0000000
C7	42973488	42973800	BolC7t44236H	0	-	282	312	312	1.0000000
C7	42974219	42974747	BolC7t44237H	0	+	99	528	528	1.0000000
C7	42989021	42992223	BolC7t44238H	0	+	761	2870	3202	0.8963148
C7	43004255	43007576	BolC7t44239H	0	+	1671	3308	3321	0.9960855
C7	43009958	43012638	BolC7t44240H	0	+	1413	2551	2680	0.9518657
C7	43018074	43018512	BolC7t44241H	0	-	1651	438	438	1.0000000
C7	43021065	43022431	BolC7t44242H	0	-	849	1366	1366	1.0000000
C7	43031189	43031738	BolC7t44243H	0	+	461	549	549	1.0000000
C7	43032472	43034103	BolC7t44244H	0	-	344	1489	1631	0.9129369
C7	43045818	43048932	BolC7t44245H	0	+	630	2833	3114	0.9097624
C7	43049792	43050449	BolC7t44246H	0	+	269	657	657	1.0000000
C7	43051704	43052796	BolC7t44247H	0	-	720	1092	1092	1.0000000
C7	43056989	43057172	BolC7t44248H	0	+	227	183	183	1.0000000
C7	43057632	43062852	BolC7t44249H	0	-	1762	4221	5220	0.8086207
C7	43097107	43098873	BolC7t44250H	0	+	2391	1766	1766	1.0000000
C7	43099938	43124430	BolC7t44251H	0	-	2307	14382	24492	0.5872121
C7	43100681	43104385	BolC7t44252H	0	-	117	1758	3704	0.4746220
C7	43136068	43136392	BolC7t44253H	0	-	34	316	324	0.9753087
C7	43154330	43154691	BolC7t44254H	0	+	46	357	361	0.9889197
C7	43154787	43169180	BolC7t44255H	0	-	325	3802	14393	0.2641562
C7	43159565	43161199	BolC7t44256H	0	+	109	535	1634	0.3274174
C7	43169529	43170877	BolC7t44257H	0	+	72	551	1348	0.4087537
C7	43186625	43190522	BolC7t44258H	0	-	374	2220	3897	0.5696689
C7	43193288	43229153	BolC7t44259H	0	-	8117	21172	35865	0.5903248
C7	43205112	43205988	BolC7t44260H	0	-	627	876	876	1.0000000
C7	43230967	43232755	BolC7t44261H	0	-	766	1788	1788	1.0000000
C7	43238648	43239338	BolC7t44262H	0	+	323	690	690	1.0000000
C7	43239370	43240147	BolC7t44263H	0	+	689	777	777	1.0000000
C7	43241175	43241795	BolC7t44264H	0	-	560	620	620	1.0000000
C7	43243409	43245037	BolC7t44265H	0	-	1055	1628	1628	1.0000000
C7	43246943	43248835	BolC7t44266H	0	-	1036	1892	1892	1.0000000
C7	43252001	43252343	BolC7t44267H	0	+	124	342	342	1.0000000
C7	43263797	43265396	BolC7t44268H	0	+	587	1599	1599	1.0000000
C7	43287844	43288578	BolC7t44269H	0	-	19	625	734	0.8514987
C7	43289523	43302421	BolC7t44270H	0	-	3258	9793	12898	0.7592650
C7	43303790	43304252	BolC7t44271H	0	-	169	462	462	1.0000000
C7	43305887	43307363	BolC7t44272H	0	+	395	1398	1476	0.9471545
C7	43313333	43313486	BolC7t44273H	0	-	266	153	153	1.0000000
C7	43320503	43321997	BolC7t44274H	0	+	1057	1430	1494	0.9571620
C7	43325390	43327289	BolC7t44275H	0	+	838	1808	1899	0.9520801
C7	43329764	43329899	BolC7t44276H	0	-	0	0	135	0.0000000
C7	43330730	43332391	BolC7t44277H	0	-	140	382	1661	0.2299819
C7	43332814	43334503	BolC7t44278H	0	-	872	1689	1689	1.0000000
C7	43334954	43337504	BolC7t44279H	0	+	1881	2550	2550	1.0000000
C7	43338467	43338707	BolC7t44280H	0	+	143	240	240	1.0000000
C7	43339163	43344646	BolC7t44281H	0	+	3631	5483	5483	1.0000000
C7	43348797	43349310	BolC7t44282H	0	+	313	513	513	1.0000000
C7	43349977	43352029	BolC7t44283H	0	+	694	2030	2052	0.9892787
C7	43352950	43356596	BolC7t44284H	0	+	1345	3646	3646	1.0000000
C7	43356880	43359128	BolC7t44285H	0	-	509	1943	2248	0.8643239
C7	43370575	43371640	BolC7t44286H	0	-	306	905	1065	0.8497652
C7	43372471	43374557	BolC7t44287H	0	-	1291	2002	2086	0.9597315
C7	43383746	43385734	BolC7t44288H	0	-	636	1857	1988	0.9341046
C7	43387610	43389840	BolC7t44289H	0	+	950	2105	2230	0.9439462
C7	43391572	43392656	BolC7t44290H	0	+	396	1067	1084	0.9843174
C7	43404542	43405787	BolC7t44291H	0	+	392	1245	1245	1.0000000
C7	43428042	43428231	BolC7t44292H	0	+	60	189	189	1.0000000
C7	43443927	43444478	BolC7t44293H	0	-	666	551	551	1.0000000
C7	43463258	43464599	BolC7t44294H	0	-	328	1183	1341	0.8821775
C7	43466886	43468196	BolC7t44295H	0	-	98	713	1310	0.5442748
C7	43473379	43479550	BolC7t44296H	0	-	1728	5801	6171	0.9400421
C7	43493357	43493645	BolC7t44297H	0	+	261	288	288	1.0000000
C7	43502200	43502905	BolC7t44298H	0	+	34	487	705	0.6907802
C7	43503900	43504128	BolC7t44299H	0	+	2	53	228	0.2324561
C7	43506653	43513209	BolC7t44300H	0	+	3149	6390	6556	0.9746797
C7	43516898	43518403	BolC7t44301H	0	+	168	1017	1505	0.6757475
C7	43521625	43523722	BolC7t44302H	0	-	1326	2097	2097	1.0000000
C7	43546637	43546940	BolC7t44303H	0	+	12	105	303	0.3465346
C7	43572578	43573106	BolC7t44304H	0	-	497	528	528	1.0000000
C7	43573701	43573815	BolC7t44305H	0	-	177	114	114	1.0000000
C7	43575930	43577956	BolC7t44306H	0	+	2645	2026	2026	1.0000000
C7	43588071	43589091	BolC7t44307H	0	-	135	960	1020	0.9411765
C7	43595216	43602830	BolC7t44308H	0	+	2208	6977	7614	0.9163383
C7	43603886	43616505	BolC7t44309H	0	-	7083	11636	12619	0.9221016
C7	43617363	43618763	BolC7t44310H	0	-	168	869	1400	0.6207143
C7	43620532	43621596	BolC7t44311H	0	-	944	1064	1064	1.0000000
C7	43627330	43629618	BolC7t44312H	0	+	1336	2288	2288	1.0000000
C7	43630118	43630447	BolC7t44313H	0	-	248	329	329	1.0000000
C7	43631484	43633615	BolC7t44314H	0	-	1073	2019	2131	0.9474425
C7	43637507	43638576	BolC7t44315H	0	+	978	1069	1069	1.0000000
C7	43644733	43644997	BolC7t44316H	0	-	39	241	264	0.9128788
C7	43662279	43662640	BolC7t44317H	0	+	346	361	361	1.0000000
C7	43669565	43670726	BolC7t44318H	0	+	1046	1161	1161	1.0000000
C7	43676834	43678019	BolC7t44319H	0	+	951	1185	1185	1.0000000
C7	43678581	43679607	BolC7t44320H	0	-	1099	1026	1026	1.0000000
C7	43680216	43681893	BolC7t44321H	0	+	1440	1677	1677	1.0000000
C7	43682832	43683349	BolC7t44322H	0	-	402	517	517	1.0000000
C7	43697104	43697293	BolC7t44323H	0	-	329	189	189	1.0000000
C7	43707934	43708207	BolC7t44324H	0	-	175	273	273	1.0000000
C7	43710768	43711053	BolC7t44325H	0	-	178	285	285	1.0000000
C7	43714217	43714502	BolC7t44326H	0	-	261	285	285	1.0000000
C7	43717440	43719857	BolC7t44327H	0	-	911	2345	2417	0.9702110
C7	43723594	43723957	BolC7t44328H	0	-	8	143	363	0.3939394
C7	43728163	43728938	BolC7t44329H	0	-	856	775	775	1.0000000
C7	43730599	43732878	BolC7t44330H	0	+	1063	2275	2279	0.9982448
C7	43733305	43734983	BolC7t44331H	0	-	309	1666	1678	0.9928486
C7	43735468	43736880	BolC7t44332H	0	-	1019	1412	1412	1.0000000
C7	43738138	43738384	BolC7t44333H	0	+	217	246	246	1.0000000
C7	43744473	43746598	BolC7t44334H	0	+	298	1635	2125	0.7694117
C7	43747649	43748711	BolC7t44335H	0	+	97	870	1062	0.8192090
C7	43749277	43749619	BolC7t44336H	0	+	36	319	342	0.9327486
C7	43750383	43751139	BolC7t44337H	0	+	316	756	756	1.0000000
C7	43752211	43752836	BolC7t44338H	0	+	123	520	625	0.8320000
C7	43753184	43754474	BolC7t44339H	0	-	687	1280	1290	0.9922481
C7	43754865	43756958	BolC7t44340H	0	+	891	2042	2093	0.9756331
C7	43757426	43758098	BolC7t44341H	0	+	185	672	672	1.0000000
C7	43761527	43761867	BolC7t44342H	0	+	329	340	340	1.0000000
C7	43762436	43766889	BolC7t44343H	0	+	2493	4349	4453	0.9766449
C7	43767283	43768315	BolC7t44344H	0	-	434	996	1032	0.9651163
C7	43769056	43770152	BolC7t44345H	0	-	962	1067	1096	0.9735401
C7	43776158	43777169	BolC7t44346H	0	-	406	1011	1011	1.0000000
C7	43783918	43785862	BolC7t44347H	0	+	580	1413	1944	0.7268519
C7	43786698	43787846	BolC7t44348H	0	-	264	1054	1148	0.9181185
C7	43789038	43789239	BolC7t44349H	0	+	164	201	201	1.0000000
C7	43789444	43792054	BolC7t44350H	0	-	1357	2610	2610	1.0000000
C7	43794605	43795767	BolC7t44351H	0	-	1185	1052	1162	0.9053356
C7	43828156	43828763	BolC7t44352H	0	-	1	3	607	0.0049423
C7	43828966	43835522	BolC7t44353H	0	-	955	3933	6556	0.5999085
C7	43833884	43834262	BolC7t44354H	0	+	2	135	378	0.3571429
C7	43840598	43841969	BolC7t44355H	0	+	279	1035	1371	0.7549234
C7	43848156	43850059	BolC7t44356H	0	+	891	1903	1903	1.0000000
C7	43851832	43852180	BolC7t44357H	0	+	715	348	348	1.0000000
C7	43864021	43866491	BolC7t44358H	0	+	5003	2470	2470	1.0000000
C7	43874316	43874516	BolC7t44359H	0	+	374	200	200	1.0000000
C7	43892638	43894921	BolC7t44360H	0	+	567	2185	2283	0.9570740
C7	43900634	43900799	BolC7t44361H	0	+	0	0	165	0.0000000
C7	43920017	43920176	BolC7t44362H	0	+	9	148	159	0.9308176
C7	43922954	43924312	BolC7t44363H	0	-	441	1262	1358	0.9293078
C7	43952040	43953354	BolC7t44364H	0	+	343	1312	1314	0.9984779
C7	43954651	43959057	BolC7t44365H	0	-	3196	4331	4406	0.9829777
C7	43960679	43961384	BolC7t44366H	0	-	389	705	705	1.0000000
C7	43984058	43984376	BolC7t44367H	0	+	8	136	318	0.4276730
C7	43984387	43985914	BolC7t44368H	0	+	267	1004	1527	0.6574984
C7	43992332	43992500	BolC7t44369H	0	+	40	135	168	0.8035714
C7	43997248	43999854	BolC7t44370H	0	+	333	2131	2606	0.8177283
C7	44016376	44018007	BolC7t44371H	0	+	499	1489	1631	0.9129369
C7	44049714	44054583	BolC7t44372H	0	+	1100	3847	4869	0.7901006
C7	44057978	44058561	BolC7t44373H	0	-	50	548	583	0.9399657
C7	44076900	44077294	BolC7t44374H	0	-	3	75	394	0.1903553
C7	44083057	44087206	BolC7t44375H	0	+	2577	4071	4149	0.9812003
C7	44087972	44091150	BolC7t44376H	0	-	1542	3031	3178	0.9537445
C7	44096851	44099764	BolC7t44377H	0	+	251	1863	2913	0.6395469
C7	44111515	44113373	BolC7t44378H	0	+	721	1851	1858	0.9962325
C7	44113815	44115754	BolC7t44379H	0	-	820	1897	1939	0.9783394
C7	44120945	44122049	BolC7t44380H	0	-	40	537	1104	0.4864130
C7	44131213	44131681	BolC7t44381H	0	+	76	330	468	0.7051282
C7	44133129	44133525	BolC7t44382H	0	+	0	0	396	0.0000000
C7	44160955	44161474	BolC7t44383H	0	+	40	251	519	0.4836223
C7	44164752	44165151	BolC7t44384H	0	-	68	319	399	0.7994987
C7	44178902	44180012	BolC7t44385H	0	+	769	1110	1110	1.0000000
C7	44181989	44184213	BolC7t44386H	0	-	240	1315	2224	0.5912770
C7	44193370	44195218	BolC7t44387H	0	+	1135	1848	1848	1.0000000
C7	44195623	44202190	BolC7t44388H	0	-	2235	5512	6567	0.8393483
C7	44207846	44212911	BolC7t44389H	0	+	1632	4604	5065	0.9089832
C7	44213776	44214410	BolC7t44390H	0	+	190	607	634	0.9574133
C7	44218800	44220820	BolC7t44391H	0	+	1250	2020	2020	1.0000000
C7	44227332	44230356	BolC7t44392H	0	-	2511	2992	3024	0.9894180
C7	44241441	44242760	BolC7t44393H	0	-	1075	1319	1319	1.0000000
C7	44243011	44244778	BolC7t44394H	0	+	1351	1767	1767	1.0000000
C7	44247282	44249610	BolC7t44395H	0	+	1479	2328	2328	1.0000000
C7	44249816	44250847	BolC7t44396H	0	-	900	1031	1031	1.0000000
C7	44251966	44253271	BolC7t44397H	0	-	334	1034	1305	0.7923372
C7	44254348	44255369	BolC7t44398H	0	+	543	1002	1021	0.9813908
C7	44256125	44258546	BolC7t44399H	0	+	297	2158	2421	0.8913672
C7	44261562	44265985	BolC7t44400H	0	+	1710	4197	4423	0.9489034
C7	44275853	44276390	BolC7t44401H	0	-	22	338	537	0.6294227
C7	44286730	44290733	BolC7t44402H	0	-	1718	3945	4003	0.9855109
C7	44291165	44293305	BolC7t44403H	0	-	558	1935	2140	0.9042056
C7	44295071	44295899	BolC7t44404H	0	+	155	779	828	0.9408212
C7	44296579	44298300	BolC7t44405H	0	-	954	1721	1721	1.0000000
C7	44299001	44302230	BolC7t44406H	0	-	2028	3229	3229	1.0000000
C7	44303400	44304675	BolC7t44407H	0	+	191	1015	1275	0.7960784
C7	44305753	44308924	BolC7t44408H	0	+	233	2424	3171	0.7644276
C7	44315676	44319626	BolC7t44409H	0	+	856	3392	3950	0.8587342
C7	44319933	44320735	BolC7t44410H	0	-	384	802	802	1.0000000
C7	44333281	44334773	BolC7t44411H	0	-	30	716	1492	0.4798928
C7	44335758	44337386	BolC7t44412H	0	-	222	1412	1628	0.8673218
C7	44343433	44344030	BolC7t44413H	0	-	4	239	597	0.4003350
C7	44357249	44370361	BolC7t44414H	0	-	1956	8880	13112	0.6772422
C7	44365937	44366229	BolC7t44415H	0	-	0	0	292	0.0000000
C7	44372337	44383567	BolC7t44416H	0	+	1792	4030	11230	0.3588602
C7	44384051	44386586	BolC7t44417H	0	-	1194	2448	2535	0.9656805
C7	44387055	44388561	BolC7t44418H	0	+	695	1506	1506	1.0000000
C7	44389289	44390735	BolC7t44419H	0	-	482	1446	1446	1.0000000
C7	44394037	44395663	BolC7t44420H	0	-	4	420	1626	0.2583026
C7	44397521	44398493	BolC7t44421H	0	-	173	811	972	0.8343621
C7	44435343	44435754	BolC7t44422H	0	+	325	411	411	1.0000000
C7	44439353	44439721	BolC7t44423H	0	+	339	368	368	1.0000000
C7	44441170	44441800	BolC7t44424H	0	+	730	630	630	1.0000000
C7	44442199	44442613	BolC7t44425H	0	-	247	414	414	1.0000000
C7	44443923	44446354	BolC7t44426H	0	+	805	2429	2431	0.9991773
C7	44446681	44454814	BolC7t44427H	0	-	2429	6482	8133	0.7969999
C7	44456699	44465897	BolC7t44428H	0	+	4056	8582	9198	0.9330289
C7	44459152	44459891	BolC7t44429H	0	-	380	739	739	1.0000000
C7	44459503	44461631	BolC7t44430H	0	+	1004	2128	2128	1.0000000
C7	44466778	44468507	BolC7t44431H	0	+	780	1540	1729	0.8906882
C7	44469694	44472388	BolC7t44432H	0	+	829	2694	2694	1.0000000
C7	44473256	44475572	BolC7t44433H	0	-	994	2256	2316	0.9740933
C7	44477802	44483599	BolC7t44434H	0	+	961	5090	5797	0.8780404
C7	44498551	44502055	BolC7t44435H	0	+	1697	3498	3504	0.9982877
C7	44505414	44510091	BolC7t44436H	0	-	1086	4319	4677	0.9234552
C7	44511009	44513080	BolC7t44437H	0	+	1674	2071	2071	1.0000000
C7	44513726	44514349	BolC7t44438H	0	+	194	623	623	1.0000000
C7	44516290	44516518	BolC7t44439H	0	+	309	228	228	1.0000000
C7	44520902	44521598	BolC7t44440H	0	+	85	696	696	1.0000000
C7	44527644	44532535	BolC7t44441H	0	+	1438	4007	4891	0.8192599
C7	44533069	44534477	BolC7t44442H	0	-	730	1288	1408	0.9147727
C7	44535342	44536128	BolC7t44443H	0	-	125	555	786	0.7061068
C7	44539127	44540914	BolC7t44444H	0	+	1383	1787	1787	1.0000000
C7	44543316	44545684	BolC7t44445H	0	+	727	2228	2368	0.9408784
C7	44549581	44552300	BolC7t44446H	0	-	1528	2633	2719	0.9683707
C7	44553279	44554386	BolC7t44447H	0	-	851	1107	1107	1.0000000
C7	44554795	44556175	BolC7t44448H	0	+	667	1367	1380	0.9905797
C7	44558073	44560254	BolC7t44449H	0	+	805	1867	2181	0.8560293
C7	44561056	44562885	BolC7t44450H	0	-	872	1811	1829	0.9901586
C7	44568496	44570743	BolC7t44451H	0	+	2222	2247	2247	1.0000000
C7	44571927	44572815	BolC7t44452H	0	-	486	888	888	1.0000000
C7	44574003	44575226	BolC7t44453H	0	-	815	1223	1223	1.0000000
C7	44583949	44585216	BolC7t44454H	0	+	118	856	1267	0.6756117
C7	44586070	44587469	BolC7t44455H	0	-	609	1399	1399	1.0000000
C7	44589951	44592459	BolC7t44456H	0	-	1661	2427	2508	0.9677033
C7	44596936	44599312	BolC7t44457H	0	+	2162	2376	2376	1.0000000
C7	44600271	44601967	BolC7t44458H	0	+	444	1696	1696	1.0000000
C7	44602131	44606025	BolC7t44459H	0	-	1425	3701	3894	0.9504366
C7	44606980	44610174	BolC7t44460H	0	-	2574	3194	3194	1.0000000
C7	44610455	44611266	BolC7t44461H	0	+	747	811	811	1.0000000
C7	44611532	44613612	BolC7t44462H	0	-	470	1666	2080	0.8009616
C7	44619939	44621615	BolC7t44463H	0	-	834	1676	1676	1.0000000
C7	44624330	44626748	BolC7t44464H	0	-	1941	2418	2418	1.0000000
C7	44628012	44629267	BolC7t44465H	0	-	598	1255	1255	1.0000000
C7	44636034	44636983	BolC7t44466H	0	+	651	949	949	1.0000000
C7	44641137	44643072	BolC7t44467H	0	-	1151	1922	1935	0.9932817
C7	44654854	44655373	BolC7t44468H	0	+	377	519	519	1.0000000
C7	44657219	44657578	BolC7t44469H	0	+	95	357	359	0.9944290
C7	44657775	44659725	BolC7t44470H	0	-	136	1246	1950	0.6389744
C7	44669803	44670736	BolC7t44471H	0	+	265	904	933	0.9689175
C7	44673432	44673702	BolC7t44472H	0	-	169	254	270	0.9407408
C7	44673754	44676861	BolC7t44473H	0	+	1976	3065	3107	0.9864821
C7	44677186	44677645	BolC7t44474H	0	-	204	459	459	1.0000000
C7	44680478	44680924	BolC7t44475H	0	-	166	446	446	1.0000000
C7	44682609	44682825	BolC7t44476H	0	-	210	216	216	1.0000000
C7	44685044	44685587	BolC7t44477H	0	+	24	543	543	1.0000000
C7	44690068	44690425	BolC7t44478H	0	-	177	357	357	1.0000000
C7	44693369	44693738	BolC7t44479H	0	-	166	344	369	0.9322493
C7	44694297	44694797	BolC7t44480H	0	-	47	479	500	0.9580000
C7	44696772	44697259	BolC7t44481H	0	+	78	487	487	1.0000000
C7	44697580	44698551	BolC7t44482H	0	+	164	967	971	0.9958805
C7	44699496	44702945	BolC7t44483H	0	+	1913	3449	3449	1.0000000
C7	44706950	44708749	BolC7t44484H	0	-	707	1761	1799	0.9788771
C7	44716707	44717034	BolC7t44485H	0	-	303	327	327	1.0000000
C7	44719203	44720369	BolC7t44486H	0	+	355	1166	1166	1.0000000
C7	44721504	44722307	BolC7t44487H	0	+	586	803	803	1.0000000
C7	44722794	44726000	BolC7t44488H	0	+	3420	3206	3206	1.0000000
C7	44726407	44733405	BolC7t44489H	0	-	4365	6095	6998	0.8709632
C7	44735427	44736507	BolC7t44490H	0	+	196	1057	1080	0.9787037
C7	44739607	44740744	BolC7t44491H	0	-	596	1137	1137	1.0000000
C7	44751279	44751752	BolC7t44492H	0	-	211	392	473	0.8287526
C7	44760965	44761722	BolC7t44493H	0	+	171	440	757	0.5812417
C7	44764924	44766539	BolC7t44494H	0	+	86	1271	1615	0.7869969
C7	44766635	44770799	BolC7t44495H	0	-	3681	4138	4164	0.9937560
C7	44768087	44769636	BolC7t44496H	0	+	1549	1549	1549	1.0000000
C7	44773072	44773696	BolC7t44497H	0	-	320	582	624	0.9326923
C7	44774779	44778776	BolC7t44498H	0	-	1487	3831	3997	0.9584689
C7	44782947	44784603	BolC7t44499H	0	+	62	809	1656	0.4885266
C7	44799450	44799992	BolC7t44500H	0	+	1	106	542	0.1955720
C7	44803041	44803200	BolC7t44501H	0	-	0	0	159	0.0000000
C7	44806020	44806434	BolC7t44502H	0	+	230	408	414	0.9855072
C7	44809531	44811461	BolC7t44503H	0	+	708	1743	1930	0.9031088
C7	44822198	44823981	BolC7t44504H	0	+	1407	1783	1783	1.0000000
C7	44828195	44828604	BolC7t44505H	0	-	728	409	409	1.0000000
C7	44830730	44833474	BolC7t44506H	0	+	1671	2487	2744	0.9063411
C7	44837987	44838852	BolC7t44507H	0	+	197	740	865	0.8554913
C7	44846366	44846861	BolC7t44508H	0	-	14	344	495	0.6949495
C7	44854565	44854973	BolC7t44509H	0	+	0	0	408	0.0000000
C7	44856039	44856734	BolC7t44510H	0	+	10	302	695	0.4345324
C7	44865767	44866331	BolC7t44511H	0	-	334	564	564	1.0000000
C7	44875578	44877390	BolC7t44512H	0	-	893	1542	1812	0.8509934
C7	44886360	44888719	BolC7t44513H	0	-	800	1782	2359	0.7554048
C7	44897905	44899098	BolC7t44514H	0	-	565	1179	1193	0.9882649
C7	44900268	44904436	BolC7t44515H	0	-	1550	3213	4168	0.7708733
C7	44909328	44910549	BolC7t44516H	0	-	145	1221	1221	1.0000000
C7	44912947	44913394	BolC7t44517H	0	-	65	447	447	1.0000000
C7	44925888	44926740	BolC7t44518H	0	+	502	852	852	1.0000000
C7	44927477	44935537	BolC7t44519H	0	-	434	3731	8060	0.4629032
C7	44937440	44945530	BolC7t44520H	0	-	2962	5795	8090	0.7163165
C7	44948789	44949218	BolC7t44521H	0	-	89	422	429	0.9836830
C7	44952422	44952615	BolC7t44522H	0	+	156	193	193	1.0000000
C7	44952858	44953172	BolC7t44523H	0	+	232	314	314	1.0000000
C7	44954181	44955910	BolC7t44524H	0	+	782	1673	1729	0.9676113
C7	44964670	44966717	BolC7t44525H	0	+	557	1871	2047	0.9140205
C7	44971530	44971773	BolC7t44526H	0	-	0	0	243	0.0000000
C7	44982498	44985436	BolC7t44527H	0	+	1611	2726	2938	0.9278421
C7	44986015	44986561	BolC7t44528H	0	-	262	546	546	1.0000000
C7	44988236	44988658	BolC7t44529H	0	-	336	422	422	1.0000000
C7	44989088	44992854	BolC7t44530H	0	-	2410	3766	3766	1.0000000
C7	44993391	44994375	BolC7t44531H	0	-	224	746	984	0.7581301
C7	44995443	45002612	BolC7t44532H	0	+	3477	6350	7169	0.8857581
C7	45002906	45005729	BolC7t44533H	0	-	566	1955	2823	0.6925257
C7	45008043	45008556	BolC7t44534H	0	+	84	399	513	0.7777778
C7	45015503	45017301	BolC7t44535H	0	-	1056	1798	1798	1.0000000
C7	45029492	45030846	BolC7t44536H	0	-	485	1223	1354	0.9032496
C7	45037763	45040067	BolC7t44537H	0	+	967	2201	2304	0.9552951
C7	45040902	45042012	BolC7t44538H	0	-	229	1046	1110	0.9423423
C7	45042717	45043859	BolC7t44539H	0	-	772	1142	1142	1.0000000
C7	45044801	45044939	BolC7t44540H	0	-	76	138	138	1.0000000
C7	45048260	45050242	BolC7t44541H	0	+	261	932	1982	0.4702321
C7	45072747	45073298	BolC7t44542H	0	+	1631	551	551	1.0000000
C7	45088434	45088797	BolC7t44543H	0	+	194	359	363	0.9889807
C7	45088869	45089137	BolC7t44544H	0	+	317	268	268	1.0000000
C7	45097249	45099262	BolC7t44545H	0	-	153	1176	2013	0.5842027
C7	45099546	45099732	BolC7t44546H	0	-	223	186	186	1.0000000
C7	45101139	45104293	BolC7t44547H	0	-	1010	3041	3154	0.9641725
C7	45108081	45109617	BolC7t44548H	0	+	454	1441	1536	0.9381511
C7	45110629	45110872	BolC7t44549H	0	-	407	243	243	1.0000000
C7	45115056	45116876	BolC7t44550H	0	+	995	1820	1820	1.0000000
C7	45117632	45118572	BolC7t44551H	0	+	482	940	940	1.0000000
C7	45119078	45119884	BolC7t44552H	0	-	541	806	806	1.0000000
C7	45120709	45121506	BolC7t44553H	0	-	70	446	797	0.5595985
C7	45122462	45125449	BolC7t44554H	0	+	260	2113	2987	0.7073987
C7	45129414	45130043	BolC7t44555H	0	+	260	570	629	0.9062003
C7	45131215	45132508	BolC7t44556H	0	+	203	1066	1293	0.8244393
C7	45139385	45140559	BolC7t44557H	0	-	396	845	1174	0.7197615
C7	45143083	45144050	BolC7t44558H	0	+	119	714	967	0.7383661
C7	45148009	45162555	BolC7t44559H	0	+	3193	8908	14546	0.6124020
C7	45171666	45172365	BolC7t44560H	0	-	425	699	699	1.0000000
C7	45174965	45176114	BolC7t44561H	0	+	566	1149	1149	1.0000000
C7	45176258	45176965	BolC7t44562H	0	-	430	707	707	1.0000000
C7	45180385	45182427	BolC7t44563H	0	+	1288	2042	2042	1.0000000
C7	45183485	45190411	BolC7t44564H	0	-	1466	5027	6926	0.7258158
C7	45184227	45184848	BolC7t44565H	0	-	228	621	621	1.0000000
C7	45197973	45200214	BolC7t44566H	0	+	807	1967	2241	0.8777332
C7	45201136	45202456	BolC7t44567H	0	-	242	1222	1320	0.9257576
C7	45209602	45210181	BolC7t44568H	0	+	9	188	579	0.3246978
C7	45215925	45223922	BolC7t44569H	0	-	4008	7080	7997	0.8853320
C7	45231143	45233442	BolC7t44570H	0	+	851	2158	2299	0.9386690
C7	45236601	45239654	BolC7t44571H	0	+	1879	2995	3053	0.9810023
C7	45247113	45248982	BolC7t44572H	0	-	901	1828	1869	0.9780631
C7	45250271	45251153	BolC7t44573H	0	-	221	807	882	0.9149660
C7	45268774	45269561	BolC7t44574H	0	+	399	787	787	1.0000000
C7	45271280	45273322	BolC7t44575H	0	+	806	2042	2042	1.0000000
C7	45276129	45277009	BolC7t44576H	0	+	219	760	880	0.8636364
C7	45280441	45283308	BolC7t44577H	0	+	920	2636	2867	0.9194280
C7	45284340	45285974	BolC7t44578H	0	+	777	1475	1634	0.9026928
C7	45286625	45286781	BolC7t44579H	0	-	214	156	156	1.0000000
C7	45287416	45288160	BolC7t44580H	0	+	74	697	744	0.9368280
C7	45288359	45299432	BolC7t44581H	0	-	2618	7974	11073	0.7201300
C7	45299982	45301587	BolC7t44582H	0	-	586	1474	1605	0.9183801
C7	45305736	45307656	BolC7t44583H	0	-	695	1920	1920	1.0000000
C7	45309815	45311893	BolC7t44584H	0	-	1013	2078	2078	1.0000000
C7	45312473	45314712	BolC7t44585H	0	+	996	2239	2239	1.0000000
C7	45316867	45317170	BolC7t44586H	0	+	3	160	303	0.5280528
C7	45323655	45326297	BolC7t44587H	0	+	956	2502	2642	0.9470099
C7	45327090	45334050	BolC7t44588H	0	+	3251	6637	6960	0.9535919
C7	45342323	45342689	BolC7t44589H	0	+	303	366	366	1.0000000
C7	45348065	45350319	BolC7t44590H	0	+	1843	2254	2254	1.0000000
C7	45352504	45356385	BolC7t44591H	0	+	1504	3698	3881	0.9528472
C7	45357217	45360477	BolC7t44592H	0	+	1525	3255	3260	0.9984663
C7	45361340	45363299	BolC7t44593H	0	+	707	1884	1959	0.9617152
C7	45363839	45368276	BolC7t44594H	0	+	2041	3884	4437	0.8753662
C7	45374058	45374187	BolC7t44595H	0	+	192	129	129	1.0000000
C7	45376330	45378169	BolC7t44596H	0	-	395	1744	1839	0.9483415
C7	45401726	45407984	BolC7t44597H	0	+	545	3771	6258	0.6025887
C7	45426642	45429062	BolC7t44598H	0	-	495	2350	2420	0.9710744
C7	45430814	45433096	BolC7t44599H	0	-	726	2203	2282	0.9653813
C7	45433603	45435197	BolC7t44600H	0	-	574	1594	1594	1.0000000
C7	45435438	45447463	BolC7t44601H	0	+	5298	10106	12025	0.8404158
C7	45451959	45452305	BolC7t44602H	0	-	262	346	346	1.0000000
C7	45462258	45463170	BolC7t44603H	0	+	312	903	912	0.9901316
C7	45491943	45492665	BolC7t44604H	0	+	168	722	722	1.0000000
C7	45495691	45496222	BolC7t44605H	0	+	492	531	531	1.0000000
C7	45500347	45500584	BolC7t44606H	0	+	183	237	237	1.0000000
C7	45506571	45506700	BolC7t44607H	0	+	152	129	129	1.0000000
C7	45507370	45509903	BolC7t44608H	0	+	408	1629	2533	0.6431109
C7	45510948	45512383	BolC7t44609H	0	+	1266	1435	1435	1.0000000
C7	45521627	45521828	BolC7t44610H	0	-	239	201	201	1.0000000
C7	45523752	45525236	BolC7t44611H	0	+	996	1484	1484	1.0000000
C7	45532912	45533101	BolC7t44612H	0	+	145	189	189	1.0000000
C7	45533299	45533914	BolC7t44613H	0	+	160	615	615	1.0000000
C7	45534250	45543592	BolC7t44614H	0	-	1896	7198	9342	0.7704988
C7	45549186	45549787	BolC7t44615H	0	-	2	59	601	0.0981697
C7	45550063	45550480	BolC7t44616H	0	-	0	0	417	0.0000000
C7	45554669	45555788	BolC7t44617H	0	+	766	1119	1119	1.0000000
C7	45556091	45556757	BolC7t44618H	0	-	432	666	666	1.0000000
C7	45561323	45561875	BolC7t44619H	0	+	0	0	552	0.0000000
C7	45566224	45568186	BolC7t44620H	0	+	475	1902	1962	0.9694189
C7	45569066	45570675	BolC7t44621H	0	-	518	1609	1609	1.0000000
C7	45573915	45574098	BolC7t44622H	0	+	236	183	183	1.0000000
C7	45574736	45578833	BolC7t44623H	0	+	994	3843	4097	0.9380034
C7	45579703	45583836	BolC7t44624H	0	+	2258	3976	4133	0.9620131
C7	45585732	45590460	BolC7t44625H	0	+	2200	4629	4728	0.9790609
C7	45590560	45593377	BolC7t44626H	0	+	1686	2817	2817	1.0000000
C7	45593695	45596152	BolC7t44627H	0	-	1539	2457	2457	1.0000000
C7	45596733	45597306	BolC7t44628H	0	-	297	573	573	1.0000000
C7	45605139	45606312	BolC7t44629H	0	-	6	218	1173	0.1858483
C7	45606821	45607985	BolC7t44630H	0	+	483	983	1164	0.8445017
C7	45611226	45611474	BolC7t44631H	0	-	30	161	248	0.6491935
C7	45633293	45634304	BolC7t44632H	0	-	13	530	1011	0.5242335
C7	45645850	45646559	BolC7t44633H	0	+	397	709	709	1.0000000
C7	45647073	45648432	BolC7t44634H	0	-	398	1359	1359	1.0000000
C7	45649192	45651903	BolC7t44635H	0	-	2035	2614	2711	0.9642199
C7	45653340	45659488	BolC7t44636H	0	-	2763	5017	6148	0.8160377
C7	45660022	45661152	BolC7t44637H	0	+	899	1111	1130	0.9831858
C7	45661782	45664699	BolC7t44638H	0	+	2459	2917	2917	1.0000000
C7	45665766	45666287	BolC7t44639H	0	-	111	521	521	1.0000000
C7	45669462	45669618	BolC7t44640H	0	+	201	156	156	1.0000000
C7	45670878	45671413	BolC7t44641H	0	+	292	535	535	1.0000000
C7	45678408	45678753	BolC7t44642H	0	+	11	179	345	0.5188406
C7	45679121	45680546	BolC7t44643H	0	+	627	1379	1425	0.9677193
C7	45681024	45682788	BolC7t44644H	0	-	725	1482	1764	0.8401361
C7	45687520	45688883	BolC7t44645H	0	+	1101	1363	1363	1.0000000
C7	45689789	45690906	BolC7t44646H	0	-	933	1117	1117	1.0000000
C7	45693471	45695918	BolC7t44647H	0	-	374	1830	2447	0.7478545
C7	45697800	45698652	BolC7t44648H	0	+	12	272	852	0.3192488
C7	45698902	45699268	BolC7t44649H	0	-	6	14	366	0.0382514
C7	45708377	45708689	BolC7t44650H	0	+	140	312	312	1.0000000
C7	45732587	45732722	BolC7t44651H	0	+	302	135	135	1.0000000
C7	45733647	45733959	BolC7t44652H	0	+	101	312	312	1.0000000
C7	45735237	45737842	BolC7t44653H	0	-	644	2191	2605	0.8410749
C7	45741894	45748095	BolC7t44654H	0	+	2732	6096	6201	0.9830673
C7	45750567	45750972	BolC7t44655H	0	-	50	314	405	0.7753087
C7	45751976	45752694	BolC7t44656H	0	-	142	663	718	0.9233983
C7	45753521	45757653	BolC7t44657H	0	-	1069	4008	4132	0.9699903
C7	45767291	45767635	BolC7t44658H	0	+	0	0	344	0.0000000
C7	45769773	45771391	BolC7t44659H	0	-	579	1608	1618	0.9938195
C7	45773140	45774271	BolC7t44660H	0	-	243	992	1131	0.8770999
C7	45777110	45777535	BolC7t44661H	0	-	70	425	425	1.0000000
C7	45777630	45780224	BolC7t44662H	0	-	616	1441	2594	0.5555127
C7	45780358	45782932	BolC7t44663H	0	-	491	2517	2574	0.9778555
C7	45786920	45787278	BolC7t44664H	0	+	407	358	358	1.0000000
C7	45796950	45797580	BolC7t44665H	0	+	455	620	630	0.9841270
C7	45797812	45803191	BolC7t44666H	0	-	2324	5113	5379	0.9505484
C7	45803437	45807798	BolC7t44667H	0	-	2862	4361	4361	1.0000000
C7	45810407	45814516	BolC7t44668H	0	-	1636	3812	4109	0.9277197
C7	45815681	45817482	BolC7t44669H	0	-	733	1779	1801	0.9877846
C7	45831929	45833767	BolC7t44670H	0	+	292	1589	1838	0.8645267
C7	45834998	45836019	BolC7t44671H	0	+	131	308	1021	0.3016650
C7	45839597	45840739	BolC7t44672H	0	+	1039	1142	1142	1.0000000
C7	45854139	45854889	BolC7t44673H	0	-	0	0	750	0.0000000
C7	45856932	45859091	BolC7t44674H	0	-	0	0	2159	0.0000000
C7	45874808	45876965	BolC7t44675H	0	+	0	0	2157	0.0000000
C7	45879010	45880479	BolC7t44676H	0	+	248	869	1469	0.5915589
C7	45886778	45889189	BolC7t44677H	0	-	1649	2411	2411	1.0000000
C7	45897450	45897675	BolC7t44678H	0	-	126	225	225	1.0000000
C7	45897814	45898864	BolC7t44679H	0	-	600	1050	1050	1.0000000
C7	45899551	45899788	BolC7t44680H	0	-	331	237	237	1.0000000
C7	45903789	45905798	BolC7t44681H	0	+	2017	2009	2009	1.0000000
C7	45907068	45910064	BolC7t44682H	0	+	2607	2996	2996	1.0000000
C7	45913515	45915479	BolC7t44683H	0	+	1325	1964	1964	1.0000000
C7	45916886	45918347	BolC7t44684H	0	-	321	1185	1461	0.8110883
C7	45918814	45920290	BolC7t44685H	0	+	485	1395	1476	0.9451219
C7	45925342	45926314	BolC7t44686H	0	-	963	972	972	1.0000000
C7	45929387	45929648	BolC7t44687H	0	+	241	261	261	1.0000000
C7	45949733	45950342	BolC7t44688H	0	-	480	609	609	1.0000000
C7	45952179	45952810	BolC7t44689H	0	+	17	212	631	0.3359746
C7	45954094	45954494	BolC7t44690H	0	+	78	400	400	1.0000000
C7	45954917	45955232	BolC7t44691H	0	-	135	304	315	0.9650794
C7	45960657	45961785	BolC7t44692H	0	-	135	762	1128	0.6755319
C7	45964026	45964985	BolC7t44693H	0	-	989	959	959	1.0000000
C7	45977768	45979068	BolC7t44694H	0	+	180	1125	1300	0.8653846
C7	45988393	45990757	BolC7t44695H	0	-	343	2221	2364	0.9395093
C7	45993173	45996257	BolC7t44696H	0	+	2389	3037	3084	0.9847600
C7	45997049	45997739	BolC7t44697H	0	-	638	690	690	1.0000000
C7	46002371	46003737	BolC7t44698H	0	+	886	1366	1366	1.0000000
C7	46006991	46008518	BolC7t44699H	0	-	390	1341	1527	0.8781925
C7	46010360	46010768	BolC7t44700H	0	-	408	408	408	1.0000000
C7	46011630	46014562	BolC7t44701H	0	-	1302	2870	2932	0.9788540
C7	46015894	46016194	BolC7t44702H	0	-	101	279	300	0.9300000
C7	46017465	46019232	BolC7t44703H	0	-	797	1577	1767	0.8924731
C7	46022006	46025225	BolC7t44704H	0	+	781	3134	3219	0.9735943
C7	46025878	46026112	BolC7t44705H	0	-	116	234	234	1.0000000
C7	46028490	46030117	BolC7t44706H	0	-	743	1555	1627	0.9557468
C7	46042626	46050698	BolC7t44707H	0	+	1270	4229	8072	0.5239098
C7	46073564	46075852	BolC7t44708H	0	-	727	1883	2288	0.8229895
C7	46079220	46081494	BolC7t44709H	0	-	300	1890	2274	0.8311346
C7	46091454	46096378	BolC7t44710H	0	-	2563	4558	4924	0.9256702
C7	46098648	46099687	BolC7t44711H	0	+	237	978	1039	0.9412897
C7	46106504	46107482	BolC7t44712H	0	+	152	716	978	0.7321063
C7	46113441	46114436	BolC7t44713H	0	+	385	881	995	0.8854271
C7	46120127	46122593	BolC7t44714H	0	+	389	1611	2466	0.6532847
C7	46139048	46141009	BolC7t44715H	0	+	328	1646	1961	0.8393677
C7	46141276	46142299	BolC7t44716H	0	-	86	936	1023	0.9149560
C7	46145078	46145958	BolC7t44717H	0	+	534	876	880	0.9954545
C7	46146738	46149496	BolC7t44718H	0	-	1480	2666	2758	0.9666425
C7	46181019	46182684	BolC7t44719H	0	+	1036	1268	1665	0.7615616
C7	46184307	46184892	BolC7t44720H	0	+	13	269	585	0.4598291
C7	46185557	46185938	BolC7t44721H	0	-	71	327	381	0.8582677
C7	46186551	46187016	BolC7t44722H	0	+	5	203	465	0.4365591
C7	46188305	46188662	BolC7t44723H	0	-	12	248	357	0.6946779
C7	46189165	46189639	BolC7t44724H	0	+	166	470	474	0.9915612
C7	46190589	46192806	BolC7t44725H	0	+	400	1844	2217	0.8317546
C7	46193300	46195496	BolC7t44726H	0	-	316	1505	2196	0.6853369
C7	46196489	46198339	BolC7t44727H	0	+	886	1767	1850	0.9551351
C7	46198617	46200139	BolC7t44728H	0	-	758	1522	1522	1.0000000
C7	46208516	46210799	BolC7t44729H	0	+	1387	2207	2283	0.9667104
C7	46213891	46220156	BolC7t44730H	0	-	2994	5927	6265	0.9460495
C7	46217227	46229722	BolC7t44731H	0	-	5456	11529	12495	0.9226891
C7	46221290	46221824	BolC7t44732H	0	-	244	534	534	1.0000000
C7	46234542	46236929	BolC7t44733H	0	-	1171	2212	2387	0.9266862
C7	46237797	46238897	BolC7t44734H	0	-	257	836	1100	0.7600000
C7	46242816	46246414	BolC7t44735H	0	-	2269	3598	3598	1.0000000
C7	46247727	46248567	BolC7t44736H	0	+	1233	840	840	1.0000000
C7	46260813	46261335	BolC7t44737H	0	+	413	522	522	1.0000000
C7	46265497	46266694	BolC7t44738H	0	+	48	437	1197	0.3650794
C7	46271894	46274044	BolC7t44739H	0	+	734	1818	2150	0.8455814
C7	46274776	46274962	BolC7t44740H	0	-	84	186	186	1.0000000
C7	46288464	46289142	BolC7t44741H	0	+	335	678	678	1.0000000
C7	46301440	46304708	BolC7t44742H	0	-	1490	3246	3268	0.9932681
C7	46308807	46311724	BolC7t44743H	0	+	869	2669	2917	0.9149811
C7	46312544	46315086	BolC7t44744H	0	+	746	2375	2542	0.9343037
C7	46315398	46316130	BolC7t44745H	0	-	180	732	732	1.0000000
C7	46316857	46319080	BolC7t44746H	0	+	894	1991	2223	0.8956365
C7	46333692	46333926	BolC7t44747H	0	+	144	234	234	1.0000000
C7	46347554	46350440	BolC7t44748H	0	+	780	2027	2886	0.7023562
C7	46375984	46377986	BolC7t44749H	0	+	453	1665	2002	0.8316683
C7	46381396	46381947	BolC7t44750H	0	+	0	0	551	0.0000000
C7	46384940	46385051	BolC7t44751H	0	-	39	111	111	1.0000000
C7	46387568	46388886	BolC7t44752H	0	+	200	1028	1318	0.7799696
C7	46390615	46391885	BolC7t44753H	0	-	640	1267	1270	0.9976378
C7	46392650	46393547	BolC7t44754H	0	-	541	897	897	1.0000000
C7	46394293	46395550	BolC7t44755H	0	-	263	1162	1257	0.9244232
C7	46397818	46398220	BolC7t44756H	0	+	0	0	402	0.0000000
C7	46403998	46404610	BolC7t44757H	0	+	293	612	612	1.0000000
C7	46405482	46406679	BolC7t44758H	0	+	620	1197	1197	1.0000000
C7	46406863	46410972	BolC7t44759H	0	-	2254	3911	4109	0.9518131
C7	46412023	46413591	BolC7t44760H	0	+	360	1422	1568	0.9068878
C7	46413785	46415039	BolC7t44761H	0	-	553	1254	1254	1.0000000
C7	46423785	46424509	BolC7t44762H	0	-	11	233	724	0.3218232
C7	46428104	46432662	BolC7t44763H	0	+	4609	4558	4558	1.0000000
C7	46433087	46435475	BolC7t44764H	0	-	1397	2388	2388	1.0000000
C7	46434817	46435475	BolC7t44765H	0	-	610	658	658	1.0000000
C7	46437542	46439505	BolC7t44766H	0	+	1745	1963	1963	1.0000000
C7	46442335	46444423	BolC7t44767H	0	-	1839	2088	2088	1.0000000
C7	46452727	46453416	BolC7t44768H	0	+	300	689	689	1.0000000
C7	46454058	46456058	BolC7t44769H	0	-	574	1968	2000	0.9840000
C7	46458768	46461696	BolC7t44770H	0	-	933	2807	2928	0.9586748
C7	46463346	46466323	BolC7t44771H	0	+	1160	2853	2977	0.9583473
C7	46466904	46467945	BolC7t44772H	0	-	217	738	1041	0.7089337
C7	46472557	46473805	BolC7t44773H	0	-	682	1248	1248	1.0000000
C7	46484059	46485388	BolC7t44774H	0	+	59	503	1329	0.3784800
C7	46487106	46490368	BolC7t44775H	0	+	624	2877	3262	0.8819742
C7	46493283	46494434	BolC7t44776H	0	+	687	1151	1151	1.0000000
C7	46496715	46496976	BolC7t44777H	0	+	215	261	261	1.0000000
C7	46499120	46500133	BolC7t44778H	0	-	149	875	1013	0.8637710
C7	46504610	46504781	BolC7t44779H	0	+	179	171	171	1.0000000
C7	46505378	46506455	BolC7t44780H	0	-	527	1048	1077	0.9730734
C7	46509432	46511424	BolC7t44781H	0	+	680	1843	1992	0.9252008
C7	46511623	46514028	BolC7t44782H	0	-	914	2200	2405	0.9147609
C7	46515656	46520193	BolC7t44783H	0	-	1008	4228	4537	0.9318933
C7	46528567	46529188	BolC7t44784H	0	-	236	621	621	1.0000000
C7	46532248	46532653	BolC7t44785H	0	-	40	147	405	0.3629630
C7	46536063	46538002	BolC7t44786H	0	-	3527	1939	1939	1.0000000
C7	46541689	46546443	BolC7t44787H	0	+	2068	4467	4754	0.9396298
C7	46549285	46549909	BolC7t44788H	0	+	4	23	624	0.0368590
C7	46550291	46551641	BolC7t44789H	0	+	10	331	1350	0.2451852
C7	46559698	46566234	BolC7t44790H	0	+	3571	6462	6536	0.9886781
C7	46566769	46568505	BolC7t44791H	0	-	808	1736	1736	1.0000000
C7	46572914	46573556	BolC7t44792H	0	+	355	642	642	1.0000000
C7	46576561	46576871	BolC7t44793H	0	+	2	164	310	0.5290322
C7	46584610	46585925	BolC7t44794H	0	-	664	1291	1315	0.9817491
C7	46605351	46606041	BolC7t44795H	0	+	294	690	690	1.0000000
C7	46612864	46614064	BolC7t44796H	0	-	655	1200	1200	1.0000000
C7	46618622	46620175	BolC7t44797H	0	+	140	564	1553	0.3631681
C7	46620880	46622455	BolC7t44798H	0	-	260	1349	1575	0.8565080
C7	46627195	46627615	BolC7t44799H	0	+	63	224	420	0.5333334
C7	46632664	46634266	BolC7t44800H	0	-	404	1305	1602	0.8146067
C7	46645383	46646751	BolC7t44801H	0	+	665	1330	1368	0.9722222
C7	46649660	46651884	BolC7t44802H	0	-	1716	2224	2224	1.0000000
C7	46653058	46653715	BolC7t44803H	0	+	525	657	657	1.0000000
C7	46654453	46656538	BolC7t44804H	0	-	1171	2085	2085	1.0000000
C7	46663204	46664918	BolC7t44805H	0	-	229	1562	1714	0.9113185
C7	46668884	46669751	BolC7t44806H	0	+	496	848	867	0.9780853
C7	46672574	46673402	BolC7t44807H	0	+	163	783	828	0.9456522
C7	46674454	46674952	BolC7t44808H	0	-	231	498	498	1.0000000
C7	46675103	46681680	BolC7t44809H	0	+	2209	6192	6577	0.9414627
C7	46682182	46683746	BolC7t44810H	0	-	212	1483	1564	0.9482097
C7	46686894	46687308	BolC7t44811H	0	-	160	320	414	0.7729468
C7	46719995	46720719	BolC7t44812H	0	-	348	630	724	0.8701658
C7	46727836	46730682	BolC7t44813H	0	+	1124	2133	2846	0.7494729
C7	46745362	46746147	BolC7t44814H	0	+	390	785	785	1.0000000
C7	46749168	46749971	BolC7t44815H	0	+	113	803	803	1.0000000
C7	46749985	46750906	BolC7t44816H	0	+	13	307	921	0.3333333
C7	46755282	46756530	BolC7t44817H	0	-	261	1248	1248	1.0000000
C7	46762932	46764606	BolC7t44818H	0	+	622	1616	1674	0.9653525
C7	46767089	46767428	BolC7t44819H	0	-	562	339	339	1.0000000
C7	46767497	46773470	BolC7t44820H	0	-	1025	2953	5973	0.4943914
C7	46781449	46781782	BolC7t44821H	0	-	217	333	333	1.0000000
C7	46783772	46788272	BolC7t44822H	0	+	3151	4500	4500	1.0000000
C7	46788909	46790838	BolC7t44823H	0	-	782	1929	1929	1.0000000
C7	46808634	46810412	BolC7t44824H	0	-	530	1598	1778	0.8987626
C7	46811661	46816891	BolC7t44825H	0	+	2211	4437	5230	0.8483748
C7	46817321	46818489	BolC7t44826H	0	-	406	1138	1168	0.9743150
C7	46819468	46820570	BolC7t44827H	0	-	360	1048	1102	0.9509982
C7	46825487	46843937	BolC7t44828H	0	+	6078	15348	18450	0.8318699
C7	46849903	46861477	BolC7t44829H	0	+	5711	10360	11574	0.8951097
C7	46862005	46874369	BolC7t44830H	0	-	9053	11934	12364	0.9652216
C7	46876120	46883314	BolC7t44831H	0	+	2481	4915	7194	0.6832082
C7	46879317	46881501	BolC7t44832H	0	-	138	1735	2184	0.7944139
C7	46895325	46895607	BolC7t44833H	0	+	397	282	282	1.0000000
C7	46908557	46910076	BolC7t44834H	0	-	1569	1519	1519	1.0000000
C7	46911704	46914362	BolC7t44835H	0	+	1997	2658	2658	1.0000000
C7	46917934	46918366	BolC7t44836H	0	-	233	432	432	1.0000000
C7	46931206	46932644	BolC7t44837H	0	+	826	1438	1438	1.0000000
C7	46935163	46937259	BolC7t44838H	0	+	947	2096	2096	1.0000000
C7	46968340	46968643	BolC7t44839H	0	+	3	29	303	0.0957096
C7	46969083	46970816	BolC7t44840H	0	+	331	1353	1733	0.7807271
C7	46976863	46977236	BolC7t44841H	0	+	46	373	373	1.0000000
C7	46981883	46982096	BolC7t44842H	0	+	1	116	213	0.5446010
C7	46983880	46985467	BolC7t44843H	0	-	2022	1587	1587	1.0000000
C7	46987357	46994905	BolC7t44844H	0	-	4149	6965	7548	0.9227610
C7	47003429	47004575	BolC7t44845H	0	+	195	713	1146	0.6221641
C7	47010672	47013043	BolC7t44846H	0	+	1547	2371	2371	1.0000000
C7	47014060	47014609	BolC7t44847H	0	-	354	549	549	1.0000000
C7	47021627	47024445	BolC7t44848H	0	+	1329	2718	2818	0.9645138
C7	47028962	47032029	BolC7t44849H	0	+	878	2964	3067	0.9664167
C7	47036034	47037106	BolC7t44850H	0	+	40	749	1072	0.6986941
C7	47047987	47048977	BolC7t44851H	0	+	33	498	990	0.5030303
C7	47052515	47053528	BolC7t44852H	0	+	149	773	1013	0.7630799
C7	47055769	47057896	BolC7t44853H	0	+	223	730	2127	0.3432064
C7	47058021	47058731	BolC7t44854H	0	+	105	571	710	0.8042253
C7	47065029	47066022	BolC7t44855H	0	+	9	24	993	0.0241692
C7	47078939	47079957	BolC7t44856H	0	+	36	507	1018	0.4980354
C7	47083038	47084316	BolC7t44857H	0	-	0	0	1278	0.0000000
C7	47087098	47088010	BolC7t44858H	0	+	0	0	912	0.0000000
C7	47093752	47094861	BolC7t44859H	0	+	966	1109	1109	1.0000000
C7	47102008	47103375	BolC7t44860H	0	+	91	444	1367	0.3247988
C7	47108489	47109717	BolC7t44861H	0	+	475	1228	1228	1.0000000
C7	47111278	47113525	BolC7t44862H	0	+	1313	2237	2247	0.9955496
C7	47124731	47127445	BolC7t44863H	0	-	1447	2622	2714	0.9661017
C7	47130223	47131223	BolC7t44864H	0	-	649	1000	1000	1.0000000
C7	47132887	47135942	BolC7t44865H	0	-	1325	3044	3055	0.9963993
C7	47137047	47146267	BolC7t44866H	0	-	3344	9033	9220	0.9797180
C7	47147106	47148576	BolC7t44867H	0	+	774	1470	1470	1.0000000
C7	47158467	47161079	BolC7t44868H	0	+	1298	2526	2612	0.9670750
C7	47161712	47162862	BolC7t44869H	0	-	944	1150	1150	1.0000000
C7	47163261	47163486	BolC7t44870H	0	+	388	225	225	1.0000000
C7	47164727	47164838	BolC7t44871H	0	+	91	111	111	1.0000000
C7	47168973	47170594	BolC7t44872H	0	-	1208	1621	1621	1.0000000
C7	47172743	47176256	BolC7t44873H	0	-	1891	3513	3513	1.0000000
C7	47177541	47179769	BolC7t44874H	0	+	1897	2216	2228	0.9946140
C7	47189895	47198878	BolC7t44875H	0	+	6007	8267	8983	0.9202939
C7	47206920	47207649	BolC7t44876H	0	+	12	233	729	0.3196159
C7	47214750	47216192	BolC7t44877H	0	+	813	1410	1442	0.9778086
C7	47220177	47221986	BolC7t44878H	0	+	504	1684	1809	0.9309011
C7	47222224	47225806	BolC7t44879H	0	-	2106	3582	3582	1.0000000
C7	47237210	47245452	BolC7t44880H	0	-	5573	7903	8242	0.9588692
C7	47247501	47248611	BolC7t44881H	0	+	1287	1110	1110	1.0000000
C7	47249235	47249585	BolC7t44882H	0	-	388	350	350	1.0000000
C7	47253583	47256201	BolC7t44883H	0	+	699	2452	2618	0.9365928
C7	47271937	47276362	BolC7t44884H	0	+	1523	3683	4425	0.8323164
C7	47276974	47278564	BolC7t44885H	0	-	528	1558	1590	0.9798742
C7	47278995	47282213	BolC7t44886H	0	+	1752	3100	3218	0.9633313
C7	47285635	47286949	BolC7t44887H	0	+	322	1106	1314	0.8417047
C7	47287540	47288031	BolC7t44888H	0	-	468	491	491	1.0000000
C7	47288859	47289261	BolC7t44889H	0	+	562	402	402	1.0000000
C7	47292200	47294380	BolC7t44890H	0	+	829	1910	2180	0.8761468
C7	47297406	47299222	BolC7t44891H	0	+	409	1454	1816	0.8006608
C7	47299509	47303133	BolC7t44892H	0	+	230	1099	3624	0.3032561
C7	47301398	47302726	BolC7t44893H	0	+	37	435	1328	0.3275602
C7	47305251	47308462	BolC7t44894H	0	+	211	2737	3211	0.8523824
C7	47310452	47313925	BolC7t44895H	0	+	1815	3447	3473	0.9925137
C7	47318015	47319739	BolC7t44896H	0	+	370	1356	1724	0.7865430
C7	47320796	47323374	BolC7t44897H	0	+	2361	2578	2578	1.0000000
C7	47324695	47326064	BolC7t44898H	0	+	719	1284	1369	0.9379109
C7	47339186	47341619	BolC7t44899H	0	+	340	2154	2433	0.8853267
C7	47342493	47343480	BolC7t44900H	0	-	108	592	987	0.5997974
C7	47343850	47346343	BolC7t44901H	0	-	920	2493	2493	1.0000000
C7	47353124	47354989	BolC7t44902H	0	+	970	1865	1865	1.0000000
C7	47357943	47359838	BolC7t44903H	0	-	1892	1895	1895	1.0000000
C7	47376085	47377441	BolC7t44904H	0	+	526	1276	1356	0.9410030
C7	47377745	47382589	BolC7t44905H	0	-	3316	4431	4844	0.9147399
C7	47382743	47383194	BolC7t44906H	0	-	180	431	451	0.9556541
C7	47384204	47388293	BolC7t44907H	0	-	1963	3722	4089	0.9102470
C7	47388403	47388710	BolC7t44908H	0	-	408	307	307	1.0000000
C7	47388817	47393169	BolC7t44909H	0	-	1779	4287	4352	0.9850643
C7	47403859	47408323	BolC7t44910H	0	+	1073	4007	4464	0.8976254
C7	47410964	47413199	BolC7t44911H	0	-	616	2113	2235	0.9454139
C7	47415432	47417953	BolC7t44912H	0	-	962	2323	2521	0.9214597
C7	47420748	47422815	BolC7t44913H	0	+	3119	2067	2067	1.0000000
C7	47429148	47432071	BolC7t44914H	0	+	2370	2923	2923	1.0000000
C7	47432553	47436927	BolC7t44915H	0	-	2346	4374	4374	1.0000000
C7	47437452	47438154	BolC7t44916H	0	+	361	640	702	0.9116809
C7	47438249	47441826	BolC7t44917H	0	-	3759	3577	3577	1.0000000
C7	47442808	47445618	BolC7t44918H	0	-	2395	2759	2810	0.9818505
C7	47449987	47450677	BolC7t44919H	0	+	432	690	690	1.0000000
C7	47460787	47462520	BolC7t44920H	0	+	74	622	1733	0.3589152
C7	47470219	47471431	BolC7t44921H	0	+	577	1161	1212	0.9579208
C7	47483724	47486107	BolC7t44922H	0	+	740	2245	2383	0.9420898
C7	47487615	47489200	BolC7t44923H	0	+	741	1523	1585	0.9608833
C7	47491629	47492263	BolC7t44924H	0	+	398	634	634	1.0000000
C7	47492454	47495510	BolC7t44925H	0	-	1619	3022	3056	0.9888743
C7	47496041	47498878	BolC7t44926H	0	-	1622	2814	2837	0.9918929
C7	47499833	47501207	BolC7t44927H	0	+	1188	1374	1374	1.0000000
C7	47501781	47503371	BolC7t44928H	0	-	947	1464	1590	0.9207547
C7	47504245	47505398	BolC7t44929H	0	-	542	1153	1153	1.0000000
C7	47507901	47508909	BolC7t44930H	0	+	156	724	1008	0.7182540
C7	47512768	47514409	BolC7t44931H	0	+	951	1624	1641	0.9896405
C7	47514695	47520504	BolC7t44932H	0	-	3699	5795	5809	0.9975899
C7	47521299	47521446	BolC7t44933H	0	-	387	147	147	1.0000000
C7	47521729	47522610	BolC7t44934H	0	-	518	881	881	1.0000000
C7	47522904	47523119	BolC7t44935H	0	-	248	215	215	1.0000000
C7	47526155	47529588	BolC7t44936H	0	+	1574	2865	3433	0.8345470
C7	47542393	47546917	BolC7t44937H	0	+	2288	4348	4524	0.9610963
C7	47550831	47551980	BolC7t44938H	0	+	945	1095	1149	0.9530026
C7	47552438	47554202	BolC7t44939H	0	-	470	1634	1764	0.9263039
C7	47557509	47558405	BolC7t44940H	0	+	759	896	896	1.0000000
C7	47558881	47562362	BolC7t44941H	0	+	903	2389	3481	0.6862971
C7	47565618	47566260	BolC7t44942H	0	+	487	642	642	1.0000000
C7	47569881	47570061	BolC7t44943H	0	-	221	180	180	1.0000000
C7	47574247	47574889	BolC7t44944H	0	+	180	642	642	1.0000000
C7	47594485	47595127	BolC7t44945H	0	+	4	265	642	0.4127726
C7	47604757	47605399	BolC7t44946H	0	+	89	487	642	0.7585670
C7	47607842	47608481	BolC7t44947H	0	+	598	639	639	1.0000000
C7	47608896	47613184	BolC7t44948H	0	-	2584	4252	4288	0.9916045
C7	47613513	47615860	BolC7t44949H	0	+	1049	2347	2347	1.0000000
C7	47616193	47617336	BolC7t44950H	0	-	992	1143	1143	1.0000000
C7	47619918	47620638	BolC7t44951H	0	-	565	720	720	1.0000000
C7	47622908	47624893	BolC7t44952H	0	-	724	1892	1985	0.9531486
C7	47625782	47627833	BolC7t44953H	0	-	1213	2051	2051	1.0000000
C7	47636888	47639115	BolC7t44954H	0	-	1693	2227	2227	1.0000000
C7	47639763	47641616	BolC7t44955H	0	+	666	1853	1853	1.0000000
C7	47641841	47643717	BolC7t44956H	0	-	1168	1864	1876	0.9936034
C7	47645820	47650435	BolC7t44957H	0	+	1257	4160	4615	0.9014084
C7	47652590	47653613	BolC7t44958H	0	+	513	1023	1023	1.0000000
C7	47656267	47661605	BolC7t44959H	0	-	2387	5143	5338	0.9634694
C7	47666025	47666663	BolC7t44960H	0	+	14	365	638	0.5721003
C7	47672453	47673643	BolC7t44961H	0	-	734	1190	1190	1.0000000
C7	47673944	47675565	BolC7t44962H	0	-	1342	1621	1621	1.0000000
C7	47676299	47678511	BolC7t44963H	0	-	1098	2212	2212	1.0000000
C7	47678937	47695971	BolC7t44964H	0	-	1992	8188	17034	0.4806857
C7	47702481	47703312	BolC7t44965H	0	-	673	831	831	1.0000000
C7	47710197	47715549	BolC7t44966H	0	+	1322	4871	5352	0.9101270
C7	47715999	47716857	BolC7t44967H	0	-	411	858	858	1.0000000
C7	47722879	47724773	BolC7t44968H	0	+	572	1722	1894	0.9091869
C7	47725250	47726296	BolC7t44969H	0	+	290	977	1046	0.9340344
C7	47727674	47731851	BolC7t44970H	0	+	2521	4150	4177	0.9935361
C7	47732305	47733612	BolC7t44971H	0	+	835	1307	1307	1.0000000
C7	47735923	47736085	BolC7t44972H	0	-	134	162	162	1.0000000
C7	47740903	47741056	BolC7t44973H	0	+	0	0	153	0.0000000
C7	47753155	47754099	BolC7t44974H	0	-	70	341	944	0.3612288
C7	47757981	47758782	BolC7t44975H	0	-	146	639	801	0.7977528
C7	47760667	47761414	BolC7t44976H	0	-	8	218	747	0.2918340
C7	47761952	47765178	BolC7t44977H	0	-	4	346	3226	0.1072536
C7	47777924	47808411	BolC7t44978H	0	-	2855	11983	30487	0.3930528
C7	47813834	47815094	BolC7t44979H	0	+	799	1140	1260	0.9047619
C7	47816790	47817363	BolC7t44980H	0	+	147	450	573	0.7853403
C7	47817576	47818309	BolC7t44981H	0	-	716	733	733	1.0000000
C7	47842058	47842265	BolC7t44982H	0	-	1	49	207	0.2367150
C7	47843116	47844004	BolC7t44983H	0	+	91	487	888	0.5484234
C7	47848044	47849658	BolC7t44984H	0	+	683	1614	1614	1.0000000
C7	47851199	47851524	BolC7t44985H	0	+	267	325	325	1.0000000
C7	47851958	47853913	BolC7t44986H	0	-	1033	1955	1955	1.0000000
C7	47854726	47855847	BolC7t44987H	0	-	99	771	1121	0.6877788
C7	47872883	47874898	BolC7t44988H	0	+	292	1295	2015	0.6426799
C7	47894943	47898200	BolC7t44989H	0	-	747	2802	3257	0.8603009
C7	47898973	47902160	BolC7t44990H	0	-	2459	3187	3187	1.0000000
C7	47908505	47908917	BolC7t44991H	0	+	281	412	412	1.0000000
C7	47913594	47917102	BolC7t44992H	0	-	2493	3171	3508	0.9039339
C7	47930744	47932891	BolC7t44993H	0	-	683	2124	2147	0.9892874
C7	47934533	47940879	BolC7t44994H	0	-	1549	5511	6346	0.8684211
C7	47941395	47943919	BolC7t44995H	0	+	1679	2524	2524	1.0000000
C7	47944052	47944944	BolC7t44996H	0	-	374	890	892	0.9977579
C7	47958505	47959600	BolC7t44997H	0	-	108	579	1095	0.5287671
C7	47971346	47974367	BolC7t44998H	0	+	2195	3021	3021	1.0000000
C7	47979399	47980667	BolC7t44999H	0	-	702	1268	1268	1.0000000
C7	47988563	47991119	BolC7t45000H	0	+	805	2496	2556	0.9765258
C7	47991131	47992434	BolC7t45001H	0	+	1750	1303	1303	1.0000000
C7	47992731	47994601	BolC7t45002H	0	-	1059	1864	1870	0.9967914
C7	47995285	47998344	BolC7t45003H	0	-	1447	2775	3059	0.9071592
C7	47998744	48000912	BolC7t45004H	0	-	804	2127	2168	0.9810886
C7	48016682	48019258	BolC7t45005H	0	-	1491	2372	2576	0.9208075
C7	48021343	48023160	BolC7t45006H	0	-	618	1669	1817	0.9185470
C7	48024422	48025284	BolC7t45007H	0	+	520	862	862	1.0000000
C7	48026263	48028124	BolC7t45008H	0	+	729	1574	1861	0.8457819
C7	48028160	48030208	BolC7t45009H	0	+	1203	1822	2048	0.8896484
C7	48033302	48045386	BolC7t45010H	0	+	6347	11746	12084	0.9720291
C7	48050711	48053875	BolC7t45011H	0	+	938	3005	3164	0.9497471
C7	48055646	48056955	BolC7t45012H	0	+	360	1278	1309	0.9763178
C7	48057389	48057653	BolC7t45013H	0	-	227	264	264	1.0000000
C7	48059182	48059710	BolC7t45014H	0	+	218	528	528	1.0000000
C7	48060336	48062579	BolC7t45015H	0	+	2452	2243	2243	1.0000000
C7	48062940	48066346	BolC7t45016H	0	-	1281	3149	3406	0.9245449
C7	48068866	48070234	BolC7t45017H	0	+	397	1368	1368	1.0000000
C7	48070474	48077406	BolC7t45018H	0	-	2152	5908	6932	0.8522793
C7	48084210	48088981	BolC7t45019H	0	+	1694	4475	4771	0.9379585
C7	48101576	48103936	BolC7t45020H	0	+	325	1730	2360	0.7330508
C7	48104561	48108467	BolC7t45021H	0	-	2159	3902	3906	0.9989759
C7	48110304	48111279	BolC7t45022H	0	-	120	866	975	0.8882051
C7	48114956	48115363	BolC7t45023H	0	+	87	376	407	0.9238330
C7	48115819	48117271	BolC7t45024H	0	-	105	1184	1452	0.8154270
C7	48122989	48125121	BolC7t45025H	0	+	1797	2132	2132	1.0000000
C7	48125922	48127627	BolC7t45026H	0	-	1619	1705	1705	1.0000000
C7	48131325	48131481	BolC7t45027H	0	-	216	156	156	1.0000000
C7	48138532	48139908	BolC7t45028H	0	-	472	1339	1376	0.9731104
C7	48163675	48164773	BolC7t45029H	0	-	185	1093	1098	0.9954463
C7	48172111	48172516	BolC7t45030H	0	-	663	405	405	1.0000000
C7	48177005	48178157	BolC7t45031H	0	-	21	450	1152	0.3906250
C7	48184375	48185492	BolC7t45032H	0	+	96	1067	1117	0.9552373
C7	48188322	48189372	BolC7t45033H	0	+	664	1050	1050	1.0000000
C7	48192518	48194982	BolC7t45034H	0	-	2182	2464	2464	1.0000000
C7	48207347	48210726	BolC7t45035H	0	+	3617	3379	3379	1.0000000
C7	48211173	48217701	BolC7t45036H	0	-	1733	4890	6528	0.7490809
C7	48218304	48220555	BolC7t45037H	0	-	454	1966	2251	0.8733896
C7	48222412	48222691	BolC7t45038H	0	-	2	23	279	0.0824373
C7	48223458	48223665	BolC7t45039H	0	+	11	102	207	0.4927536
C7	48226054	48227347	BolC7t45040H	0	-	284	1084	1293	0.8383604
C7	48228489	48229317	BolC7t45041H	0	+	165	630	828	0.7608696
C7	48230798	48234057	BolC7t45042H	0	-	630	2863	3259	0.8784903
C7	48242549	48243553	BolC7t45043H	0	+	1276	1004	1004	1.0000000
C7	48243926	48245750	BolC7t45044H	0	-	976	1812	1824	0.9934211
C7	48246386	48248654	BolC7t45045H	0	-	813	2173	2268	0.9581129
C7	48251338	48255394	BolC7t45046H	0	+	2808	3951	4056	0.9741125
C7	48256810	48260474	BolC7t45047H	0	+	723	3592	3664	0.9803494
C7	48263394	48266567	BolC7t45048H	0	+	919	3099	3173	0.9766783
C7	48268378	48272689	BolC7t45049H	0	+	2184	3840	4311	0.8907446
C7	48273283	48275606	BolC7t45050H	0	-	615	2230	2323	0.9599656
C7	48275897	48278518	BolC7t45051H	0	+	650	2332	2621	0.8897367
C7	48279166	48279763	BolC7t45052H	0	-	44	389	597	0.6515913
C7	48280712	48281483	BolC7t45053H	0	-	112	466	771	0.6044099
C7	48284641	48286155	BolC7t45054H	0	+	454	1509	1514	0.9966975
C7	48288585	48289729	BolC7t45055H	0	+	167	1043	1144	0.9117133
C7	48289982	48290732	BolC7t45056H	0	-	241	706	750	0.9413334
C7	48292067	48294016	BolC7t45057H	0	+	1703	1949	1949	1.0000000
C7	48308979	48309303	BolC7t45058H	0	+	163	324	324	1.0000000
C7	48316387	48317114	BolC7t45059H	0	+	194	471	727	0.6478680
C7	48317684	48318104	BolC7t45060H	0	-	50	364	420	0.8666667
C7	48331593	48331998	BolC7t45061H	0	+	42	376	405	0.9283950
C7	48333768	48336310	BolC7t45062H	0	-	798	2337	2542	0.9193549
C7	48336916	48341061	BolC7t45063H	0	-	1126	3666	4145	0.8844391
C7	48341354	48345944	BolC7t45064H	0	+	1956	3202	4590	0.6976035
C7	48354242	48360728	BolC7t45065H	0	+	108	1917	6486	0.2955597
C7	48360879	48365127	BolC7t45066H	0	-	321	3249	4248	0.7648305
C7	48365831	48369957	BolC7t45067H	0	+	1064	3311	4126	0.8024721
C7	48370105	48370720	BolC7t45068H	0	-	121	550	615	0.8943089
C7	48381043	48384086	BolC7t45069H	0	+	775	2584	3043	0.8491620
C7	48385342	48385813	BolC7t45070H	0	+	685	471	471	1.0000000
C7	48389419	48389617	BolC7t45071H	0	+	131	198	198	1.0000000
C7	48393048	48394728	BolC7t45072H	0	-	423	1495	1680	0.8898810
C7	48397790	48402507	BolC7t45073H	0	+	1537	3568	4717	0.7564130
C7	48405208	48406297	BolC7t45074H	0	-	224	1089	1089	1.0000000
C7	48411803	48412861	BolC7t45075H	0	+	423	953	1058	0.9007561
C7	48413278	48414688	BolC7t45076H	0	-	1133	1410	1410	1.0000000
C7	48416396	48417460	BolC7t45077H	0	+	997	1064	1064	1.0000000
C7	48418022	48418463	BolC7t45078H	0	+	143	397	441	0.9002268
C7	48419615	48421649	BolC7t45079H	0	-	888	1929	2034	0.9483776
C7	48425414	48426053	BolC7t45080H	0	+	145	610	639	0.9546166
C7	48439021	48439836	BolC7t45081H	0	+	240	815	815	1.0000000
C7	48446453	48447908	BolC7t45082H	0	-	111	987	1455	0.6783505
C7	48451031	48452289	BolC7t45083H	0	-	875	1258	1258	1.0000000
C7	48454808	48455681	BolC7t45084H	0	-	230	873	873	1.0000000
C7	48475919	48477144	BolC7t45085H	0	-	255	1134	1225	0.9257143
C7	48482750	48485556	BolC7t45086H	0	-	1382	2775	2806	0.9889522
C7	48486497	48508077	BolC7t45087H	0	-	6280	16785	21580	0.7778035
C7	48493350	48495468	BolC7t45088H	0	-	440	1644	2118	0.7762040
C7	48496244	48497387	BolC7t45089H	0	+	55	670	1143	0.5861768
C7	48498559	48501025	BolC7t45090H	0	-	721	2078	2466	0.8426602
C7	48513621	48514158	BolC7t45091H	0	-	3	137	537	0.2551211
C7	48517161	48518550	BolC7t45092H	0	+	144	882	1389	0.6349892
C7	48521731	48522004	BolC7t45093H	0	+	8	132	273	0.4835165
C7	48525059	48525358	BolC7t45094H	0	+	584	299	299	1.0000000
C7	48536433	48537162	BolC7t45095H	0	+	207	676	729	0.9272977
C7	48537386	48539519	BolC7t45096H	0	-	964	2131	2133	0.9990624
C7	48540800	48541939	BolC7t45097H	0	-	197	1055	1139	0.9262511
C7	48547896	48549740	BolC7t45098H	0	-	716	1777	1844	0.9636660
C7	48550442	48552973	BolC7t45099H	0	+	722	2282	2531	0.9016199
C7	48554213	48554432	BolC7t45100H	0	+	26	219	219	1.0000000
C7	48556091	48557135	BolC7t45101H	0	-	1214	1022	1044	0.9789272
C7	48558518	48559988	BolC7t45102H	0	-	330	1453	1470	0.9884354
C7	48599098	48600062	BolC7t45103H	0	+	1435	964	964	1.0000000
C7	48605562	48607035	BolC7t45104H	0	-	247	1049	1473	0.7121521
C7	48612350	48613811	BolC7t45105H	0	-	57	244	1461	0.1670089
C7	48620077	48623257	BolC7t45106H	0	-	652	2471	3180	0.7770440
C7	48624899	48625871	BolC7t45107H	0	-	251	759	972	0.7808642
C7	48630013	48631030	BolC7t45108H	0	+	95	898	1017	0.8829892
C7	48640237	48640503	BolC7t45109H	0	+	0	0	266	0.0000000
C7	48640724	48641135	BolC7t45110H	0	+	0	0	411	0.0000000
C7	48664220	48664514	BolC7t45111H	0	+	330	294	294	1.0000000
C7	48671445	48672057	BolC7t45112H	0	+	20	315	612	0.5147059
C7	48675365	48675848	BolC7t45113H	0	+	30	471	483	0.9751553
C7	48682417	48682888	BolC7t45114H	0	-	55	400	471	0.8492569
C7	48698668	48699286	BolC7t45115H	0	-	186	555	618	0.8980582
C7	48702936	48703966	BolC7t45116H	0	-	571	1030	1030	1.0000000
C7	48709937	48711053	BolC7t45117H	0	+	886	1116	1116	1.0000000
C7	48748585	48749764	BolC7t45118H	0	+	383	1029	1179	0.8727735
C7	48754629	48755367	BolC7t45119H	0	+	238	738	738	1.0000000
C7	48757511	48757922	BolC7t45120H	0	+	144	411	411	1.0000000
C7	48761473	48762935	BolC7t45121H	0	+	965	1462	1462	1.0000000
C7	48766318	48770734	BolC7t45122H	0	-	3407	4416	4416	1.0000000
C7	48787502	48788258	BolC7t45123H	0	+	414	755	756	0.9986773
C7	48792420	48793932	BolC7t45124H	0	+	394	1407	1512	0.9305556
C7	48794423	48798917	BolC7t45125H	0	-	2802	4448	4494	0.9897642
C7	48799407	48800029	BolC7t45126H	0	+	538	622	622	1.0000000
C7	48802457	48803230	BolC7t45127H	0	-	772	773	773	1.0000000
C7	48812109	48816867	BolC7t45128H	0	+	3901	4567	4758	0.9598571
C7	48823129	48824687	BolC7t45129H	0	-	133	844	1558	0.5417202
C7	48828028	48830036	BolC7t45130H	0	-	120	1571	2008	0.7823705
C7	48834114	48835523	BolC7t45131H	0	-	1422	1409	1409	1.0000000
C7	48837713	48839181	BolC7t45132H	0	-	670	1468	1468	1.0000000
C7	48840081	48845676	BolC7t45133H	0	-	1432	4819	5595	0.8613048
C7	48848239	48852114	BolC7t45134H	0	+	3695	3858	3875	0.9956129
C7	48852165	48853315	BolC7t45135H	0	+	570	1105	1150	0.9608696
C7	48857598	48861859	BolC7t45136H	0	+	2299	4197	4261	0.9849800
C7	48862257	48863343	BolC7t45137H	0	-	150	902	1086	0.8305709
C7	48865499	48866452	BolC7t45138H	0	-	173	953	953	1.0000000
C7	48867739	48868414	BolC7t45139H	0	-	281	675	675	1.0000000
C7	48872132	48873522	BolC7t45140H	0	+	445	1270	1390	0.9136690
C7	48875296	48876618	BolC7t45141H	0	+	785	1322	1322	1.0000000
C7	48877668	48880337	BolC7t45142H	0	+	1623	2655	2669	0.9947546
C7	48881500	48881674	BolC7t45143H	0	+	81	174	174	1.0000000
C7	48886816	48887761	BolC7t45144H	0	-	541	945	945	1.0000000
C7	48888550	48889619	BolC7t45145H	0	+	1103	1069	1069	1.0000000
C7	48889873	48892788	BolC7t45146H	0	-	1786	2688	2915	0.9221269
C7	48901742	48901877	BolC7t45147H	0	-	87	135	135	1.0000000
C7	48904628	48905722	BolC7t45148H	0	+	837	1094	1094	1.0000000
C7	48907458	48907848	BolC7t45149H	0	-	155	360	390	0.9230769
C7	48909960	48910794	BolC7t45150H	0	-	51	333	834	0.3992806
C7	48914236	48915076	BolC7t45151H	0	-	89	681	840	0.8107143
C7	48917926	48918268	BolC7t45152H	0	+	180	342	342	1.0000000
C7	48918730	48920440	BolC7t45153H	0	+	932	1710	1710	1.0000000
C7	48922075	48924760	BolC7t45154H	0	-	723	2685	2685	1.0000000
C7	48925906	48927902	BolC7t45155H	0	-	1100	1996	1996	1.0000000
C7	48930142	48930523	BolC7t45156H	0	-	63	226	381	0.5931758
C7	48930832	48932053	BolC7t45157H	0	-	50	444	1221	0.3636364
C7	48933463	48933968	BolC7t45158H	0	-	13	368	505	0.7287129
C7	48934798	48939755	BolC7t45159H	0	-	1971	4957	4957	1.0000000
C7	48950442	48953365	BolC7t45160H	0	+	799	2762	2923	0.9449196
C7	48954573	48954906	BolC7t45161H	0	+	63	333	333	1.0000000
C7	48956459	48956832	BolC7t45162H	0	+	28	324	373	0.8686327
C7	48956912	48957093	BolC7t45163H	0	+	7	181	181	1.0000000
C7	48964667	48965741	BolC7t45164H	0	-	46	939	1074	0.8743017
C7	48966265	48966888	BolC7t45165H	0	-	2	163	623	0.2616372
C7	48968496	48969535	BolC7t45166H	0	-	302	891	1039	0.8575553
C7	48974117	48974528	BolC7t45167H	0	+	88	334	411	0.8126521
C7	48976432	48979776	BolC7t45168H	0	+	1347	3339	3344	0.9985048
C7	48982562	48983093	BolC7t45169H	0	-	0	0	531	0.0000000
C7	48987038	48988098	BolC7t45170H	0	-	221	776	1060	0.7320755
C7	48994270	48994390	BolC7t45171H	0	+	118	120	120	1.0000000
C7	48996836	48998070	BolC7t45172H	0	+	436	1093	1234	0.8857374
C7	48998571	48999131	BolC7t45173H	0	-	159	560	560	1.0000000
C7	49000572	49003611	BolC7t45174H	0	-	872	2674	3039	0.8798947
C7	49005770	49007352	BolC7t45175H	0	-	1377	1582	1582	1.0000000
C7	49008291	49010492	BolC7t45176H	0	-	1844	2201	2201	1.0000000
C7	49010993	49012371	BolC7t45177H	0	-	637	1334	1378	0.9680697
C7	49021223	49023514	BolC7t45178H	0	+	870	2291	2291	1.0000000
C7	49029790	49033191	BolC7t45179H	0	+	1554	3243	3401	0.9535431
C7	49033758	49034849	BolC7t45180H	0	-	930	1091	1091	1.0000000
C7	49035778	49040230	BolC7t45181H	0	-	2344	4297	4452	0.9651842
C7	49041987	49042868	BolC7t45182H	0	-	951	881	881	1.0000000
C7	49049814	49051122	BolC7t45183H	0	+	22	458	1308	0.3501529
C7	49061638	49075698	BolC7t45184H	0	+	602	7065	14060	0.5024893
C7	49075776	49079690	BolC7t45185H	0	+	1574	3139	3914	0.8019928
C7	49079774	49081070	BolC7t45186H	0	+	398	1275	1296	0.9837963
C7	49085975	49087853	BolC7t45187H	0	-	809	1878	1878	1.0000000
C7	49090710	49091220	BolC7t45188H	0	+	571	510	510	1.0000000
C7	49092745	49094094	BolC7t45189H	0	-	59	637	1349	0.4722016
C7	49103831	49104098	BolC7t45190H	0	-	0	0	267	0.0000000
C7	49107394	49109673	BolC7t45191H	0	+	619	2255	2279	0.9894691
C7	49109819	49110272	BolC7t45192H	0	-	389	453	453	1.0000000
C7	49110600	49112358	BolC7t45193H	0	+	1599	1758	1758	1.0000000
C7	49112615	49114495	BolC7t45194H	0	-	1049	1880	1880	1.0000000
C7	49115864	49118991	BolC7t45195H	0	+	620	2826	3127	0.9037416
C7	49123233	49126219	BolC7t45196H	0	+	2421	2986	2986	1.0000000
C7	49128215	49128763	BolC7t45197H	0	+	547	548	548	1.0000000
C7	49130068	49130440	BolC7t45198H	0	-	130	372	372	1.0000000
C7	49133500	49134473	BolC7t45199H	0	+	483	973	973	1.0000000
C7	49134769	49136272	BolC7t45200H	0	-	1324	1503	1503	1.0000000
C7	49139788	49147184	BolC7t45201H	0	+	2318	6401	7396	0.8654678
C7	49147499	49151331	BolC7t45202H	0	-	2946	3832	3832	1.0000000
C7	49152456	49153989	BolC7t45203H	0	-	1097	1533	1533	1.0000000
C7	49154686	49155694	BolC7t45204H	0	+	207	1008	1008	1.0000000
C7	49156055	49156830	BolC7t45205H	0	-	623	775	775	1.0000000
C7	49157089	49158825	BolC7t45206H	0	-	1805	1736	1736	1.0000000
C7	49159450	49160594	BolC7t45207H	0	+	943	1144	1144	1.0000000
C7	49161260	49162496	BolC7t45208H	0	-	150	869	1236	0.7030745
C7	49167975	49169158	BolC7t45209H	0	+	1220	1183	1183	1.0000000
C7	49170521	49171930	BolC7t45210H	0	-	573	1409	1409	1.0000000
C7	49174495	49185668	BolC7t45211H	0	+	3668	10548	11173	0.9440616
C7	49186749	49187472	BolC7t45212H	0	+	59	516	723	0.7136930
C7	49191491	49193170	BolC7t45213H	0	-	347	1641	1679	0.9773675
C7	49199958	49201230	BolC7t45214H	0	-	26	425	1272	0.3341195
C7	49206125	49207028	BolC7t45215H	0	+	164	873	903	0.9667774
C7	49210351	49210978	BolC7t45216H	0	+	80	282	627	0.4497608
C7	49215544	49218689	BolC7t45217H	0	-	1161	2982	3145	0.9481717
C7	49233957	49236242	BolC7t45218H	0	-	611	2131	2285	0.9326040
C7	49240211	49240436	BolC7t45219H	0	+	1	26	225	0.1155556
C7	49246720	49247107	BolC7t45220H	0	+	0	0	387	0.0000000
C7	49247346	49247645	BolC7t45221H	0	+	2	19	299	0.0635452
C7	49248540	49255426	BolC7t45222H	0	-	496	2020	6886	0.2933488
C7	49257537	49263443	BolC7t45223H	0	-	759	3987	5906	0.6750762
C7	49270216	49288036	BolC7t45224H	0	+	4818	14976	17820	0.8404040
C7	49278909	49279641	BolC7t45225H	0	-	554	732	732	1.0000000
C7	49290151	49292588	BolC7t45226H	0	-	2274	2437	2437	1.0000000
C7	49295150	49296209	BolC7t45227H	0	+	449	1059	1059	1.0000000
C7	49296911	49297319	BolC7t45228H	0	-	88	408	408	1.0000000
C7	49305287	49315856	BolC7t45229H	0	+	4660	8495	10569	0.8037657
C7	49313045	49314536	BolC7t45230H	0	-	44	84	1491	0.0563380
C7	49321513	49323705	BolC7t45231H	0	+	463	2151	2192	0.9812956
C7	49324744	49326329	BolC7t45232H	0	+	582	1585	1585	1.0000000
C7	49327372	49328921	BolC7t45233H	0	+	557	1549	1549	1.0000000
C7	49330847	49332414	BolC7t45234H	0	+	293	1377	1567	0.8787492
C7	49357908	49360556	BolC7t45235H	0	+	1433	2294	2648	0.8663142
C7	49361028	49366768	BolC7t45236H	0	-	1427	3197	5740	0.5569686
C7	49369941	49371079	BolC7t45237H	0	+	617	1138	1138	1.0000000
C7	49374826	49377354	BolC7t45238H	0	+	590	2057	2528	0.8136867
C7	49377629	49377908	BolC7t45239H	0	-	267	279	279	1.0000000
C7	49378410	49378584	BolC7t45240H	0	-	69	174	174	1.0000000
C7	49379504	49380977	BolC7t45241H	0	-	127	887	1473	0.6021724
C7	49382816	49383848	BolC7t45242H	0	+	915	1032	1032	1.0000000
C7	49384306	49389731	BolC7t45243H	0	-	1423	5135	5425	0.9465438
C7	49391483	49394016	BolC7t45244H	0	-	1899	2493	2533	0.9842085
C7	49396893	49397818	BolC7t45245H	0	+	420	925	925	1.0000000
C7	49399742	49402596	BolC7t45246H	0	+	558	2703	2854	0.9470918
C7	49414963	49415926	BolC7t45247H	0	-	281	805	963	0.8359294
C7	49450528	49452521	BolC7t45248H	0	+	1300	1883	1993	0.9448068
C7	49454891	49456722	BolC7t45249H	0	+	467	1619	1831	0.8842162
C7	49460942	49461251	BolC7t45250H	0	+	0	0	309	0.0000000
C7	49464257	49464665	BolC7t45251H	0	+	360	408	408	1.0000000
C7	49466362	49466662	BolC7t45252H	0	-	1	156	300	0.5200000
C7	49487599	49487881	BolC7t45253H	0	+	156	282	282	1.0000000
C7	49488486	49490513	BolC7t45254H	0	+	794	1969	2027	0.9713863
C7	49492444	49493251	BolC7t45255H	0	+	323	807	807	1.0000000
C7	49495731	49495983	BolC7t45256H	0	-	0	0	252	0.0000000
C7	49497778	49499062	BolC7t45257H	0	-	646	1284	1284	1.0000000
C7	49500426	49502056	BolC7t45258H	0	+	13	318	1630	0.1950920
C7	49503643	49506280	BolC7t45259H	0	+	0	0	2637	0.0000000
C7	49508468	49509831	BolC7t45260H	0	+	0	0	1363	0.0000000
C7	49511889	49512607	BolC7t45261H	0	+	27	223	718	0.3105850
C7	49521989	49522673	BolC7t45262H	0	-	356	684	684	1.0000000
C7	49526828	49527458	BolC7t45263H	0	-	261	539	630	0.8555555
C7	49528253	49530014	BolC7t45264H	0	-	659	1589	1761	0.9023282
C7	49530420	49530789	BolC7t45265H	0	-	4	247	369	0.6693767
C7	49534210	49534774	BolC7t45266H	0	+	18	480	564	0.8510638
C7	49538666	49539002	BolC7t45267H	0	+	68	336	336	1.0000000
C7	49540540	49541480	BolC7t45268H	0	-	651	940	940	1.0000000
C7	49549674	49551584	BolC7t45269H	0	+	1033	1910	1910	1.0000000
C7	49552463	49556163	BolC7t45270H	0	+	1026	3482	3700	0.9410811
C7	49561558	49564897	BolC7t45271H	0	+	1826	3296	3339	0.9871219
C7	49565632	49567151	BolC7t45272H	0	-	118	911	1519	0.5997367
C7	49568674	49570910	BolC7t45273H	0	+	159	1298	2236	0.5805009
C7	49575408	49578198	BolC7t45274H	0	+	2514	2790	2790	1.0000000
C7	49578950	49583422	BolC7t45275H	0	-	306	2677	4472	0.5986136
C7	49587570	49592952	BolC7t45276H	0	+	362	3035	5382	0.5639167
C7	49593348	49596683	BolC7t45277H	0	+	1099	3077	3335	0.9226387
C7	49598895	49603137	BolC7t45278H	0	-	2577	4218	4242	0.9943423
C7	49607006	49608015	BolC7t45279H	0	+	627	948	1009	0.9395441
C7	49608359	49609635	BolC7t45280H	0	-	398	1276	1276	1.0000000
C7	49620431	49621691	BolC7t45281H	0	+	725	1260	1260	1.0000000
C7	49643569	49645132	BolC7t45282H	0	-	874	1554	1563	0.9942418
C7	49665768	49666293	BolC7t45283H	0	+	304	525	525	1.0000000
C7	49670001	49671393	BolC7t45284H	0	+	808	1392	1392	1.0000000
C7	49671645	49673172	BolC7t45285H	0	-	1114	1507	1527	0.9869024
C7	49679190	49682659	BolC7t45286H	0	-	1227	2975	3469	0.8575959
C7	49685256	49686783	BolC7t45287H	0	+	1424	1527	1527	1.0000000
C7	49691336	49694225	BolC7t45288H	0	+	1876	2873	2889	0.9944618
C7	49695639	49696396	BolC7t45289H	0	-	477	684	757	0.9035667
C7	49697714	49700561	BolC7t45290H	0	-	865	2671	2847	0.9381806
C7	49702374	49706158	BolC7t45291H	0	-	1144	3173	3784	0.8385307
C7	49706841	49709918	BolC7t45292H	0	-	1005	2909	3077	0.9454014
C7	49714382	49715931	BolC7t45293H	0	-	377	1058	1549	0.6830213
C7	49722608	49725449	BolC7t45294H	0	-	1658	2643	2841	0.9303063
C7	49725689	49727032	BolC7t45295H	0	+	1520	1343	1343	1.0000000
C7	49728607	49729279	BolC7t45296H	0	+	410	672	672	1.0000000
C7	49730069	49734849	BolC7t45297H	0	-	1815	4527	4780	0.9470711
C7	49735153	49736555	BolC7t45298H	0	+	565	1284	1402	0.9158345
C7	49736710	49737184	BolC7t45299H	0	-	8	344	474	0.7257384
C7	49737420	49738426	BolC7t45300H	0	-	197	1006	1006	1.0000000
C7	49743566	49745476	BolC7t45301H	0	+	120	900	1910	0.4712042
C7	49758656	49759696	BolC7t45302H	0	+	748	1040	1040	1.0000000
C7	49766677	49767463	BolC7t45303H	0	+	595	786	786	1.0000000
C7	49768695	49769858	BolC7t45304H	0	+	1074	1163	1163	1.0000000
C7	49775217	49776404	BolC7t45305H	0	+	397	1187	1187	1.0000000
C7	49777127	49778378	BolC7t45306H	0	+	1189	1251	1251	1.0000000
C7	49778536	49779082	BolC7t45307H	0	-	167	501	546	0.9175824
C7	49779274	49781804	BolC7t45308H	0	-	1316	2530	2530	1.0000000
C7	49787669	49789194	BolC7t45309H	0	+	669	1525	1525	1.0000000
C7	49789470	49790511	BolC7t45310H	0	-	1272	1041	1041	1.0000000
C7	49791262	49792373	BolC7t45311H	0	-	1114	1111	1111	1.0000000
C7	49797187	49797565	BolC7t45312H	0	+	38	127	378	0.3359788
C7	49798714	49798876	BolC7t45313H	0	+	6	162	162	1.0000000
C7	49800226	49800646	BolC7t45314H	0	+	242	420	420	1.0000000
C7	49802604	49803291	BolC7t45315H	0	+	458	687	687	1.0000000
C7	49813853	49817238	BolC7t45316H	0	+	376	1886	3385	0.5571640
C7	49820280	49821728	BolC7t45317H	0	-	533	1403	1448	0.9689227
C7	49830767	49831112	BolC7t45318H	0	-	177	345	345	1.0000000
C7	49834043	49834289	BolC7t45319H	0	-	67	177	246	0.7195122
C7	49835773	49837227	BolC7t45320H	0	-	828	1385	1454	0.9525447
C7	49838064	49838823	BolC7t45321H	0	+	288	759	759	1.0000000
C7	49840024	49840661	BolC7t45322H	0	-	484	637	637	1.0000000
C7	49840715	49840990	BolC7t45323H	0	-	66	275	275	1.0000000
C7	49849485	49850716	BolC7t45324H	0	-	1269	939	1231	0.7627945
C7	49854741	49855445	BolC7t45325H	0	-	90	704	704	1.0000000
C7	49858060	49860412	BolC7t45326H	0	-	1590	2306	2352	0.9804422
C7	49862436	49863327	BolC7t45327H	0	-	326	849	891	0.9528620
C7	49864994	49866042	BolC7t45328H	0	-	900	1048	1048	1.0000000
C7	49866191	49872231	BolC7t45329H	0	-	3487	3189	6040	0.5279801
C7	49872748	49878097	BolC7t45330H	0	+	1965	4332	5349	0.8098710
C7	49882063	49882666	BolC7t45331H	0	-	570	546	603	0.9054726
C7	49889948	49891611	BolC7t45332H	0	-	912	1651	1663	0.9927841
C7	49894032	49895308	BolC7t45333H	0	+	1094	1276	1276	1.0000000
C7	49904024	49905122	BolC7t45334H	0	-	234	1014	1098	0.9234973
C7	49911093	49911334	BolC7t45335H	0	-	4	94	241	0.3900415
C7	49911766	49913206	BolC7t45336H	0	-	2	90	1440	0.0625000
C7	49921230	49923648	BolC7t45337H	0	+	1189	2323	2418	0.9607114
C7	49924982	49928848	BolC7t45338H	0	+	383	2323	3866	0.6008795
C7	49929246	49929721	BolC7t45339H	0	-	301	475	475	1.0000000
C7	49933480	49935475	BolC7t45340H	0	-	1281	1995	1995	1.0000000
C7	49936164	49936275	BolC7t45341H	0	-	143	111	111	1.0000000
C7	49938350	49939535	BolC7t45342H	0	-	898	1185	1185	1.0000000
C7	49941206	49941350	BolC7t45343H	0	+	259	144	144	1.0000000
C7	49942520	49944267	BolC7t45344H	0	-	884	1703	1747	0.9748139
C7	49976839	49978305	BolC7t45345H	0	+	0	0	1466	0.0000000
C7	49979400	49980516	BolC7t45346H	0	+	12	271	1116	0.2428315
C7	49984005	49984551	BolC7t45347H	0	-	251	546	546	1.0000000
C7	49989866	49992758	BolC7t45348H	0	-	1855	2875	2892	0.9941217
C7	49996262	49996772	BolC7t45349H	0	-	233	510	510	1.0000000
C7	49999651	50001184	BolC7t45350H	0	+	341	1423	1533	0.9282452
C7	50002074	50012305	BolC7t45351H	0	-	1351	6294	10231	0.6151891
C7	50013741	50014257	BolC7t45352H	0	+	156	516	516	1.0000000
C7	50020773	50021737	BolC7t45353H	0	-	654	933	964	0.9678423
C7	50024484	50025618	BolC7t45354H	0	-	0	0	1134	0.0000000
C7	50030869	50032360	BolC7t45355H	0	+	1520	1491	1491	1.0000000
C7	50034377	50036583	BolC7t45356H	0	-	549	1835	2206	0.8318223
C7	50038710	50039844	BolC7t45357H	0	-	0	0	1134	0.0000000
C7	50040808	50042954	BolC7t45358H	0	-	2354	2146	2146	1.0000000
C7	50048146	50050478	BolC7t45359H	0	-	1141	2212	2332	0.9485420
C7	50050836	50053215	BolC7t45360H	0	+	1103	2341	2379	0.9840269
C7	50064599	50066200	BolC7t45361H	0	-	150	1450	1601	0.9056839
C7	50068710	50073078	BolC7t45362H	0	+	1049	3546	4368	0.8118132
C7	50073492	50080389	BolC7t45363H	0	-	1781	4396	6897	0.6373786
C7	50084470	50088071	BolC7t45364H	0	+	2611	3601	3601	1.0000000
C7	50090011	50090245	BolC7t45365H	0	+	172	234	234	1.0000000
C7	50090809	50092781	BolC7t45366H	0	-	1429	1972	1972	1.0000000
C7	50102787	50103046	BolC7t45367H	0	+	153	259	259	1.0000000
C7	50103550	50105451	BolC7t45368H	0	-	263	1715	1901	0.9021568
C7	50108434	50110674	BolC7t45369H	0	-	1439	2240	2240	1.0000000
C7	50112148	50113286	BolC7t45370H	0	-	714	1138	1138	1.0000000
C7	50113663	50114232	BolC7t45371H	0	+	430	569	569	1.0000000
C7	50115520	50117192	BolC7t45372H	0	-	489	1672	1672	1.0000000
C7	50119298	50119830	BolC7t45373H	0	+	169	520	532	0.9774436
C7	50120258	50122587	BolC7t45374H	0	-	1306	2329	2329	1.0000000
C7	50124592	50126818	BolC7t45375H	0	+	709	2126	2226	0.9550764
C7	50128422	50129545	BolC7t45376H	0	+	308	1037	1123	0.9234194
C7	50132573	50134636	BolC7t45377H	0	+	1069	2061	2063	0.9990305
C7	50136267	50139853	BolC7t45378H	0	+	1435	3395	3586	0.9467373
C7	50140660	50142021	BolC7t45379H	0	-	598	1361	1361	1.0000000
C7	50143548	50143982	BolC7t45380H	0	+	311	434	434	1.0000000
C7	50146171	50147256	BolC7t45381H	0	-	514	1050	1085	0.9677419
C7	50148210	50148516	BolC7t45382H	0	-	15	262	306	0.8562092
C7	50164314	50165169	BolC7t45383H	0	+	387	855	855	1.0000000
C7	50166947	50167391	BolC7t45384H	0	-	0	0	444	0.0000000
C7	50173377	50173560	BolC7t45385H	0	+	202	183	183	1.0000000
C7	50176785	50177903	BolC7t45386H	0	+	681	1115	1118	0.9973167
C7	50178926	50180523	BolC7t45387H	0	-	318	1479	1597	0.9261115
C7	50181067	50181939	BolC7t45388H	0	-	483	872	872	1.0000000
C7	50182832	50184311	BolC7t45389H	0	-	1276	1479	1479	1.0000000
C7	50184856	50186614	BolC7t45390H	0	+	993	1752	1758	0.9965870
C7	50187054	50188540	BolC7t45391H	0	-	1195	1486	1486	1.0000000
C7	50189412	50190705	BolC7t45392H	0	+	282	1203	1293	0.9303944
C7	50191263	50193019	BolC7t45393H	0	-	473	1633	1756	0.9299545
C7	50193985	50194192	BolC7t45394H	0	-	157	207	207	1.0000000
C7	50196191	50199907	BolC7t45395H	0	+	3249	3716	3716	1.0000000
C7	50204498	50209009	BolC7t45396H	0	+	2816	4511	4511	1.0000000
C7	50209934	50212746	BolC7t45397H	0	+	1267	2759	2812	0.9811522
C7	50213209	50214706	BolC7t45398H	0	+	1096	1497	1497	1.0000000
C7	50215764	50216154	BolC7t45399H	0	+	479	390	390	1.0000000
C7	50218418	50219053	BolC7t45400H	0	-	185	520	635	0.8188977
C7	50237351	50238549	BolC7t45401H	0	-	699	1198	1198	1.0000000
C7	50245385	50246528	BolC7t45402H	0	+	502	817	1143	0.7147856
C7	50247670	50247988	BolC7t45403H	0	-	222	318	318	1.0000000
C7	50266127	50267446	BolC7t45404H	0	-	1198	1319	1319	1.0000000
C7	50282218	50282626	BolC7t45405H	0	-	50	313	408	0.7671568
C7	50284127	50284534	BolC7t45406H	0	-	0	0	407	0.0000000
C7	50286038	50288357	BolC7t45407H	0	-	38	735	2319	0.3169470
C7	50292786	50293196	BolC7t45408H	0	-	71	384	410	0.9365854
C7	50294711	50295655	BolC7t45409H	0	-	575	922	944	0.9766949
C7	50294711	50310190	BolC7t45410H	0	-	7495	14403	15479	0.9304864
C7	50297715	50298139	BolC7t45411H	0	-	184	367	424	0.8655660
C7	50311394	50312731	BolC7t45412H	0	+	958	1331	1337	0.9955124
C7	50313129	50315652	BolC7t45413H	0	-	2170	2523	2523	1.0000000
C7	50316561	50317484	BolC7t45414H	0	+	218	923	923	1.0000000
C7	50321379	50322880	BolC7t45415H	0	+	33	196	1501	0.1305796
C7	50323084	50323296	BolC7t45416H	0	+	34	180	212	0.8490566
C7	50323784	50324099	BolC7t45417H	0	+	175	286	315	0.9079365
C7	50324082	50325319	BolC7t45418H	0	+	695	1226	1237	0.9911075
C7	50327040	50327409	BolC7t45419H	0	-	88	328	369	0.8888889
C7	50331707	50333075	BolC7t45420H	0	+	809	1368	1368	1.0000000
C7	50351574	50354660	BolC7t45421H	0	+	1067	3007	3086	0.9744005
C7	50354826	50356002	BolC7t45422H	0	-	334	1139	1176	0.9685374
C7	50356756	50358249	BolC7t45423H	0	-	594	1451	1493	0.9718687
C7	50377279	50384753	BolC7t45424H	0	+	3921	7474	7474	1.0000000
C7	50388775	50389657	BolC7t45425H	0	-	14	356	882	0.4036281
C7	50410652	50411273	BolC7t45426H	0	+	1	91	621	0.1465378
C7	50419921	50420188	BolC7t45427H	0	-	296	267	267	1.0000000
C7	50420252	50422277	BolC7t45428H	0	+	522	1937	2025	0.9565432
C7	50422553	50424227	BolC7t45429H	0	-	1671	1674	1674	1.0000000
C7	50424707	50425283	BolC7t45430H	0	+	60	169	576	0.2934028
C7	50431072	50434474	BolC7t45431H	0	+	1281	3329	3402	0.9785420
C7	50438283	50440873	BolC7t45432H	0	+	1241	2471	2590	0.9540541
C7	50448554	50450176	BolC7t45433H	0	+	584	1621	1622	0.9993834
C7	50453360	50454752	BolC7t45434H	0	-	460	1392	1392	1.0000000
C7	50455548	50456442	BolC7t45435H	0	-	235	764	894	0.8545861
C7	50462758	50470754	BolC7t45436H	0	+	3591	6983	7996	0.8733116
C7	50468801	50469335	BolC7t45437H	0	+	556	534	534	1.0000000
C7	50471132	50472424	BolC7t45438H	0	-	1189	1292	1292	1.0000000
C7	50476509	50478746	BolC7t45439H	0	+	474	1996	2237	0.8922665
C7	50482295	50483418	BolC7t45440H	0	-	101	944	1123	0.8406055
C7	50495694	50499295	BolC7t45441H	0	-	1399	3071	3601	0.8528187
C7	50502079	50503952	BolC7t45442H	0	-	81	963	1873	0.5141484
C7	50506599	50509860	BolC7t45443H	0	-	785	2820	3261	0.8647654
C7	50518941	50519265	BolC7t45444H	0	+	60	282	324	0.8703704
C7	50541754	50544674	BolC7t45445H	0	-	1583	2544	2920	0.8712329
C7	50560949	50561512	BolC7t45446H	0	-	255	563	563	1.0000000
C7	50567627	50568031	BolC7t45447H	0	-	231	404	404	1.0000000
C7	50587462	50592681	BolC7t45448H	0	+	406	2416	5219	0.4629239
C7	50593279	50595258	BolC7t45449H	0	-	275	1603	1979	0.8100051
C7	50596349	50597555	BolC7t45450H	0	+	581	1206	1206	1.0000000
C7	50599363	50601263	BolC7t45451H	0	+	189	1695	1900	0.8921053
C7	50601860	50608796	BolC7t45452H	0	-	3874	6916	6936	0.9971165
C7	50609964	50610632	BolC7t45453H	0	-	253	668	668	1.0000000
C7	50621598	50623050	BolC7t45454H	0	+	497	1356	1452	0.9338843
C7	50626434	50627503	BolC7t45455H	0	-	1452	1069	1069	1.0000000
C7	50633028	50634155	BolC7t45456H	0	+	160	780	1127	0.6921029
C7	50642296	50643984	BolC7t45457H	0	+	934	1628	1688	0.9644549
C7	50644623	50645840	BolC7t45458H	0	+	438	1217	1217	1.0000000
C7	50646137	50647091	BolC7t45459H	0	-	1150	953	954	0.9989518
C7	50648915	50654306	BolC7t45460H	0	-	5056	5341	5391	0.9907253
C7	50656412	50659880	BolC7t45461H	0	-	1212	2783	3468	0.8024798
C7	50661303	50663717	BolC7t45462H	0	-	976	2131	2414	0.8827672
C7	50665943	50666384	BolC7t45463H	0	+	65	436	441	0.9886621
C7	50667078	50669073	BolC7t45464H	0	-	351	1176	1995	0.5894737
C7	50696205	50697957	BolC7t45465H	0	+	39	734	1752	0.4189498
C7	50700735	50702849	BolC7t45466H	0	-	1458	2114	2114	1.0000000
C7	50703856	50704198	BolC7t45467H	0	-	280	342	342	1.0000000
C7	50713036	50714161	BolC7t45468H	0	-	233	1051	1125	0.9342222
C7	50722603	50722924	BolC7t45469H	0	+	230	321	321	1.0000000
C7	50723271	50723538	BolC7t45470H	0	-	39	230	267	0.8614232
C7	50749434	50750413	BolC7t45471H	0	-	81	728	979	0.7436159
C7	50754274	50754538	BolC7t45472H	0	+	35	102	264	0.3863636
C7	50754988	50757132	BolC7t45473H	0	-	1115	2144	2144	1.0000000
C7	50758407	50759930	BolC7t45474H	0	-	485	1523	1523	1.0000000
C7	50760812	50764521	BolC7t45475H	0	+	989	3275	3709	0.8829873
C7	50766542	50766680	BolC7t45476H	0	+	156	138	138	1.0000000
C7	50778756	50778993	BolC7t45477H	0	+	23	203	237	0.8565401
C7	50785494	50785731	BolC7t45478H	0	+	139	237	237	1.0000000
C7	50789166	50789445	BolC7t45479H	0	+	3	55	279	0.1971326
C7	50792316	50794167	BolC7t45480H	0	-	224	1110	1851	0.5996758
C7	50795199	50797425	BolC7t45481H	0	+	772	2001	2226	0.8989218
C7	50801230	50801637	BolC7t45482H	0	+	413	407	407	1.0000000
C7	50807323	50808113	BolC7t45483H	0	+	191	730	790	0.9240506
C7	50809747	50812062	BolC7t45484H	0	-	197	1952	2315	0.8431966
C7	50813694	50816887	BolC7t45485H	0	-	1561	3026	3193	0.9476981
C7	50823360	50826222	BolC7t45486H	0	+	1814	2799	2862	0.9779874
C7	50827813	50828791	BolC7t45487H	0	+	483	970	978	0.9918200
C7	50834459	50835035	BolC7t45488H	0	+	94	475	576	0.8246528
C7	50840679	50840958	BolC7t45489H	0	+	10	166	279	0.5949821
C7	50850785	50852270	BolC7t45490H	0	+	1056	1485	1485	1.0000000
C7	50855424	50856775	BolC7t45491H	0	+	1271	1351	1351	1.0000000
C7	50859647	50860105	BolC7t45492H	0	+	492	458	458	1.0000000
C7	50860796	50861654	BolC7t45493H	0	+	129	734	858	0.8554779
C7	50867514	50867871	BolC7t45494H	0	+	362	357	357	1.0000000
C7	50869591	50870274	BolC7t45495H	0	-	249	683	683	1.0000000
C7	50869753	50871633	BolC7t45496H	0	-	348	1799	1880	0.9569149
C7	50879493	50881078	BolC7t45497H	0	+	1423	1585	1585	1.0000000
C7	50888288	50889109	BolC7t45498H	0	+	310	821	821	1.0000000
C7	50890416	50891867	BolC7t45499H	0	+	532	1443	1451	0.9944866
C7	50892318	50896194	BolC7t45500H	0	-	840	3366	3876	0.8684211
C7	50897669	50899924	BolC7t45501H	0	-	736	2065	2255	0.9157428
C7	50900845	50901681	BolC7t45502H	0	-	42	687	836	0.8217703
C7	50904999	50908452	BolC7t45503H	0	-	2249	3453	3453	1.0000000
C7	50913451	50916653	BolC7t45504H	0	+	830	2752	3202	0.8594629
C7	50919119	50920205	BolC7t45505H	0	-	625	1079	1086	0.9935544
C7	50922277	50923540	BolC7t45506H	0	-	529	1263	1263	1.0000000
C7	50928454	50928718	BolC7t45507H	0	+	5	137	264	0.5189394
C7	50932291	50934110	BolC7t45508H	0	+	777	1819	1819	1.0000000
C7	50941528	50943301	BolC7t45509H	0	+	561	1773	1773	1.0000000
C7	50948682	50948997	BolC7t45510H	0	+	46	315	315	1.0000000
C7	50949508	50949721	BolC7t45511H	0	+	142	213	213	1.0000000
C7	50950677	50952467	BolC7t45512H	0	+	1658	1790	1790	1.0000000
C7	50962197	50964272	BolC7t45513H	0	+	1133	1885	2075	0.9084337
C7	50967349	50967673	BolC7t45514H	0	-	851	324	324	1.0000000
C7	50974421	50975470	BolC7t45515H	0	+	877	1049	1049	1.0000000
C7	50983315	50983789	BolC7t45516H	0	+	0	0	474	0.0000000
C7	50985886	50987092	BolC7t45517H	0	-	117	1206	1206	1.0000000
C7	50988535	50989229	BolC7t45518H	0	+	122	652	694	0.9394813
C7	50990339	50991894	BolC7t45519H	0	-	1061	1554	1555	0.9993569
C7	51000153	51000483	BolC7t45520H	0	+	221	330	330	1.0000000
C7	51002546	51004682	BolC7t45521H	0	-	1178	1980	2136	0.9269663
C7	51005404	51010481	BolC7t45522H	0	-	2789	5077	5077	1.0000000
C7	51011650	51013170	BolC7t45523H	0	-	451	1467	1520	0.9651316
C7	51013657	51016171	BolC7t45524H	0	-	521	2233	2514	0.8882259
C7	51020343	51020785	BolC7t45525H	0	+	39	409	442	0.9253393
C7	51020847	51021088	BolC7t45526H	0	+	3	46	241	0.1908714
C7	51043623	51045974	BolC7t45527H	0	-	477	2127	2351	0.9047214
C7	51058491	51061022	BolC7t45528H	0	-	953	1674	2531	0.6613986
C7	51061504	51062881	BolC7t45529H	0	+	1276	1377	1377	1.0000000
C7	51070649	51073258	BolC7t45530H	0	+	2132	2609	2609	1.0000000
C7	51076233	51078490	BolC7t45531H	0	-	476	2149	2257	0.9521489
C7	51079456	51082190	BolC7t45532H	0	+	1090	2371	2734	0.8672275
C7	51082676	51085529	BolC7t45533H	0	-	789	2691	2853	0.9432177
C7	51109866	51111864	BolC7t45534H	0	+	295	1860	1998	0.9309309
C7	51135736	51135895	BolC7t45535H	0	+	290	159	159	1.0000000
C7	51142369	51143749	BolC7t45536H	0	+	356	1364	1380	0.9884058
C7	51145326	51149125	BolC7t45537H	0	-	822	3022	3799	0.7954725
C7	51164336	51164843	BolC7t45538H	0	-	85	444	507	0.8757396
C7	51170444	51174530	BolC7t45539H	0	+	2229	4086	4086	1.0000000
C7	51176536	51183272	BolC7t45540H	0	+	937	5185	6736	0.7697446
C7	51183406	51184855	BolC7t45541H	0	-	222	1120	1449	0.7729468
C7	51186233	51187251	BolC7t45542H	0	-	93	577	1018	0.5667976
C7	51189921	51237136	BolC7t45543H	0	-	19252	42886	47215	0.9083130
C7	51190627	51194746	BolC7t45544H	0	+	1941	3487	4119	0.8465647
C7	51195286	51201560	BolC7t45545H	0	+	2143	5817	6274	0.9271597
C7	51205578	51207192	BolC7t45546H	0	+	839	1614	1614	1.0000000
C7	51222283	51223063	BolC7t45547H	0	+	485	780	780	1.0000000
C7	51223069	51225538	BolC7t45548H	0	+	1157	2469	2469	1.0000000
C7	51239410	51251758	BolC7t45549H	0	+	5350	10590	12348	0.8576288
C7	51254002	51255289	BolC7t45550H	0	-	697	1287	1287	1.0000000
C7	51258887	51260189	BolC7t45551H	0	-	1121	1302	1302	1.0000000
C7	51262850	51264113	BolC7t45552H	0	-	379	892	1263	0.7062550
C7	51266318	51267258	BolC7t45553H	0	-	540	937	940	0.9968085
C7	51270742	51271971	BolC7t45554H	0	+	30	651	1229	0.5296990
C7	51273303	51273624	BolC7t45555H	0	+	45	321	321	1.0000000
C7	51283728	51284931	BolC7t45556H	0	+	205	769	1203	0.6392353
C7	51290197	51291726	BolC7t45557H	0	+	59	968	1529	0.6330935
C7	51299372	51300431	BolC7t45558H	0	-	43	624	1059	0.5892351
C7	51314078	51321334	BolC7t45559H	0	-	876	2300	7256	0.3169791
C7	51322271	51323855	BolC7t45560H	0	-	605	1546	1584	0.9760101
C7	51333714	51336940	BolC7t45561H	0	+	627	2293	3226	0.7107874
C7	51338339	51338645	BolC7t45562H	0	+	545	306	306	1.0000000
C7	51339681	51339954	BolC7t45563H	0	+	323	273	273	1.0000000
C7	51345277	51346008	BolC7t45564H	0	+	611	731	731	1.0000000
C7	51348794	51352124	BolC7t45565H	0	+	1375	3302	3330	0.9915916
C7	51365132	51368981	BolC7t45566H	0	+	3846	3849	3849	1.0000000
C7	51370404	51372070	BolC7t45567H	0	+	786	1389	1666	0.8337335
C7	51375100	51376368	BolC7t45568H	0	+	923	1268	1268	1.0000000
C7	51377233	51378358	BolC7t45569H	0	-	65	617	1125	0.5484444
C7	51379982	51381694	BolC7t45570H	0	+	787	1708	1712	0.9976636
C7	51382002	51383791	BolC7t45571H	0	-	1330	1789	1789	1.0000000
C7	51384034	51384949	BolC7t45572H	0	+	470	915	915	1.0000000
C7	51385074	51386828	BolC7t45573H	0	-	492	1728	1754	0.9851767
C7	51388032	51388308	BolC7t45574H	0	-	5	114	276	0.4130435
C7	51393204	51396305	BolC7t45575H	0	+	1247	2892	3101	0.9326024
C7	51398271	51398616	BolC7t45576H	0	-	191	345	345	1.0000000
C7	51399701	51399998	BolC7t45577H	0	-	300	291	297	0.9797980
C7	51400096	51407076	BolC7t45578H	0	-	4969	6448	6980	0.9237822
C7	51412558	51412726	BolC7t45579H	0	-	177	168	168	1.0000000
C7	51418063	51423413	BolC7t45580H	0	-	3752	5192	5350	0.9704673
C7	51443577	51445183	BolC7t45581H	0	+	716	1606	1606	1.0000000
C7	51460859	51464180	BolC7t45582H	0	+	232	1914	3321	0.5763324
C7	51465323	51466227	BolC7t45583H	0	+	0	0	904	0.0000000
C7	51482943	51489843	BolC7t45584H	0	+	2410	6741	6900	0.9769565
C7	51490505	51491933	BolC7t45585H	0	+	144	1274	1428	0.8921568
C7	51492897	51493904	BolC7t45586H	0	+	419	1007	1007	1.0000000
C7	51494609	51495029	BolC7t45587H	0	+	182	385	420	0.9166667
C7	51496684	51503070	BolC7t45588H	0	-	2761	6386	6386	1.0000000
C7	51504205	51504647	BolC7t45589H	0	-	194	442	442	1.0000000
C7	51504651	51505043	BolC7t45590H	0	-	180	392	392	1.0000000
C7	51506410	51506971	BolC7t45591H	0	-	186	561	561	1.0000000
C7	51508106	51508467	BolC7t45592H	0	+	73	361	361	1.0000000
C7	51509125	51510760	BolC7t45593H	0	-	667	1635	1635	1.0000000
C7	51512130	51512652	BolC7t45594H	0	+	430	522	522	1.0000000
C7	51516380	51517988	BolC7t45595H	0	+	108	1289	1608	0.8016169
C7	51524989	51526609	BolC7t45596H	0	+	259	1552	1620	0.9580247
C7	51527445	51536142	BolC7t45597H	0	-	6394	8689	8697	0.9990801
C7	51537916	51539669	BolC7t45598H	0	+	108	1569	1753	0.8950371
C7	51548196	51549333	BolC7t45599H	0	-	299	1128	1137	0.9920844
C7	51550938	51552792	BolC7t45600H	0	+	404	1677	1854	0.9045308
C7	51552979	51554616	BolC7t45601H	0	-	1531	1589	1637	0.9706781
C7	51556013	51557388	BolC7t45602H	0	+	1462	1375	1375	1.0000000
C7	51561840	51564219	BolC7t45603H	0	+	128	1714	2379	0.7204708
C7	51571103	51571541	BolC7t45604H	0	+	249	438	438	1.0000000
C7	51575857	51576478	BolC7t45605H	0	+	77	346	621	0.5571659
C7	51579110	51579368	BolC7t45606H	0	+	38	162	258	0.6279070
C7	51580641	51580996	BolC7t45607H	0	+	195	355	355	1.0000000
C7	51581897	51582996	BolC7t45608H	0	+	582	1099	1099	1.0000000
C7	51584050	51588308	BolC7t45609H	0	+	1421	3702	4258	0.8694223
C7	51590100	51597213	BolC7t45610H	0	+	3617	7099	7113	0.9980318
C7	51597303	51597828	BolC7t45611H	0	-	272	525	525	1.0000000
C7	51599050	51599723	BolC7t45612H	0	+	275	673	673	1.0000000
C7	51611625	51614414	BolC7t45613H	0	+	110	1714	2789	0.6145572
C7	51620009	51623126	BolC7t45614H	0	-	783	2666	3117	0.8553096
C7	51625814	51627383	BolC7t45615H	0	+	366	1490	1569	0.9496495
C7	51629195	51632437	BolC7t45616H	0	+	156	1533	3242	0.4728563
C7	51633746	51635256	BolC7t45617H	0	-	78	567	1510	0.3754967
C7	51638829	51642519	BolC7t45618H	0	+	1586	3502	3690	0.9490515
C7	51643530	51646221	BolC7t45619H	0	-	479	2276	2691	0.8457822
C7	51649254	51653060	BolC7t45620H	0	-	1478	3747	3806	0.9844981
C7	51664826	51666032	BolC7t45621H	0	-	768	1206	1206	1.0000000
C7	51684153	51685010	BolC7t45622H	0	+	407	857	857	1.0000000
C7	51691030	51692695	BolC7t45623H	0	-	872	1594	1665	0.9573573
C7	51694693	51696496	BolC7t45624H	0	-	954	1638	1803	0.9084858
C7	51700740	51701844	BolC7t45625H	0	+	0	0	1104	0.0000000
C7	51706723	51707125	BolC7t45626H	0	+	30	339	402	0.8432836
C7	51707453	51710954	BolC7t45627H	0	-	254	2385	3501	0.6812339
C7	51723077	51726725	BolC7t45628H	0	-	302	2391	3648	0.6554276
C7	51729426	51731119	BolC7t45629H	0	-	375	1642	1693	0.9698759
C7	51732135	51736733	BolC7t45630H	0	+	1493	4354	4598	0.9469334
C7	51737363	51739369	BolC7t45631H	0	-	369	1799	2006	0.8968096
C7	51746077	51752136	BolC7t45632H	0	-	1310	5370	6059	0.8862849
C7	51752834	51753474	BolC7t45633H	0	+	407	591	640	0.9234375
C7	51754007	51754442	BolC7t45634H	0	+	74	410	435	0.9425287
C7	51760368	51761500	BolC7t45635H	0	+	14	392	1132	0.3462898
C7	51772862	51776609	BolC7t45636H	0	+	369	2892	3747	0.7718174
C7	51777550	51780317	BolC7t45637H	0	+	1664	2763	2767	0.9985544
C7	51788766	51790247	BolC7t45638H	0	+	927	1481	1481	1.0000000
C7	51793577	51794859	BolC7t45639H	0	-	844	1282	1282	1.0000000
C7	51795527	51796344	BolC7t45640H	0	-	335	817	817	1.0000000
C7	51799301	51802622	BolC7t45641H	0	-	1576	2746	3321	0.8268594
C7	51822765	51842700	BolC7t45642H	0	-	4329	11762	19935	0.5900176
C7	51825813	51826224	BolC7t45643H	0	+	131	411	411	1.0000000
C7	51849797	51850157	BolC7t45644H	0	-	1	42	360	0.1166667
C7	51855632	51856568	BolC7t45645H	0	+	494	925	936	0.9882479
C7	51856865	51862345	BolC7t45646H	0	-	1578	5390	5480	0.9835767
C7	51871812	51872481	BolC7t45647H	0	-	634	669	669	1.0000000
C7	51874828	51876319	BolC7t45648H	0	+	2055	1465	1491	0.9825621
C7	51876924	51881613	BolC7t45649H	0	-	4666	4656	4689	0.9929622
C7	51890015	51890123	BolC7t45650H	0	+	88	108	108	1.0000000
C7	51890277	51890751	BolC7t45651H	0	+	122	402	474	0.8481013
C7	51892276	51893250	BolC7t45652H	0	+	531	961	974	0.9866530
C7	51893644	51895225	BolC7t45653H	0	-	295	1544	1581	0.9765971
C7	51896748	51899258	BolC7t45654H	0	-	1583	2036	2510	0.8111554
C7	51907317	51908223	BolC7t45655H	0	-	0	0	906	0.0000000
C7	51918527	51928082	BolC7t45656H	0	-	2308	5332	9555	0.5580325
C7	51929044	51930682	BolC7t45657H	0	-	698	1390	1638	0.8485959
C7	51934456	51934843	BolC7t45658H	0	+	69	378	387	0.9767442
C7	51935048	51935234	BolC7t45659H	0	+	231	186	186	1.0000000
C7	51942160	51943897	BolC7t45660H	0	-	965	1645	1737	0.9470351
C7	51948898	51949234	BolC7t45661H	0	-	528	336	336	1.0000000
C7	51951419	51953534	BolC7t45662H	0	+	366	1723	2115	0.8146572
C7	51954321	51959335	BolC7t45663H	0	-	885	4417	5014	0.8809334
C7	51973101	51974217	BolC7t45664H	0	+	21	564	1116	0.5053763
C7	51993718	51994033	BolC7t45665H	0	+	0	0	315	0.0000000
C7	52003688	52003871	BolC7t45666H	0	+	0	0	183	0.0000000
C7	52004165	52004969	BolC7t45667H	0	-	0	0	804	0.0000000
C7	52011628	52012567	BolC7t45668H	0	-	307	790	939	0.8413206
C7	52017883	52018198	BolC7t45669H	0	+	0	0	315	0.0000000
C7	52018296	52019420	BolC7t45670H	0	-	0	0	1124	0.0000000
C7	52032076	52032391	BolC7t45671H	0	+	0	0	315	0.0000000
C7	52032907	52033614	BolC7t45672H	0	-	0	0	707	0.0000000
C7	52058660	52058975	BolC7t45673H	0	+	0	0	315	0.0000000
C7	52059801	52060193	BolC7t45674H	0	-	0	0	392	0.0000000
C7	52085534	52087020	BolC7t45675H	0	+	31	313	1486	0.2106326
C7	52091636	52093526	BolC7t45676H	0	+	147	1042	1890	0.5513228
C7	52097057	52097522	BolC7t45677H	0	-	0	0	465	0.0000000
C7	52108332	52110250	BolC7t45678H	0	-	168	1632	1918	0.8508863
C7	52116876	52119862	BolC7t45679H	0	-	1813	2986	2986	1.0000000
C7	52120164	52121206	BolC7t45680H	0	+	671	1042	1042	1.0000000
C7	52121938	52123075	BolC7t45681H	0	-	1073	1137	1137	1.0000000
C7	52127485	52128329	BolC7t45682H	0	+	251	798	844	0.9454976
C7	52128983	52131280	BolC7t45683H	0	-	871	2297	2297	1.0000000
C7	52135424	52137141	BolC7t45684H	0	+	646	1717	1717	1.0000000
C7	52140361	52140730	BolC7t45685H	0	-	20	365	369	0.9891599
C7	52142779	52144566	BolC7t45686H	0	-	1125	1511	1787	0.8455512
C7	52147834	52148374	BolC7t45687H	0	-	553	540	540	1.0000000
C7	52150758	52153901	BolC7t45688H	0	-	190	1868	3143	0.5943366
C7	52170851	52171976	BolC7t45689H	0	+	257	995	1125	0.8844444
C7	52172651	52174070	BolC7t45690H	0	+	707	1419	1419	1.0000000
C7	52174446	52174849	BolC7t45691H	0	-	120	365	403	0.9057072
C7	52178338	52179680	BolC7t45692H	0	+	323	768	1342	0.5722802
C7	52180056	52181655	BolC7t45693H	0	-	329	1470	1599	0.9193246
C7	52188962	52189217	BolC7t45694H	0	-	71	255	255	1.0000000
C7	52202236	52202695	BolC7t45695H	0	+	26	389	459	0.8474945
C7	52208942	52210235	BolC7t45696H	0	-	94	1055	1293	0.8159319
C7	52231106	52232684	BolC7t45697H	0	+	192	1275	1578	0.8079848
C7	52236936	52237053	BolC7t45698H	0	+	69	117	117	1.0000000
C7	52237944	52238550	BolC7t45699H	0	+	301	595	606	0.9818482
C7	52240364	52240967	BolC7t45700H	0	+	107	603	603	1.0000000
C7	52242490	52242939	BolC7t45701H	0	+	6	280	449	0.6236080
C7	52244960	52245830	BolC7t45702H	0	-	314	856	870	0.9839081
C7	52248707	52252450	BolC7t45703H	0	-	1827	3681	3743	0.9834358
C7	52252596	52253095	BolC7t45704H	0	-	88	496	499	0.9939880
C7	52256396	52256955	BolC7t45705H	0	-	646	559	559	1.0000000
C7	52257556	52258963	BolC7t45706H	0	-	57	817	1407	0.5806681
C7	52268514	52270687	BolC7t45707H	0	-	169	1337	2173	0.6152784
C7	52290089	52290813	BolC7t45708H	0	+	89	430	724	0.5939227
C7	52291175	52292230	BolC7t45709H	0	+	0	0	1055	0.0000000
C7	52292503	52292875	BolC7t45710H	0	-	37	81	372	0.2177419
C7	52296673	52297042	BolC7t45711H	0	-	265	369	369	1.0000000
C7	52307232	52308750	BolC7t45712H	0	-	710	1461	1518	0.9624506
C7	52310493	52310634	BolC7t45713H	0	+	49	141	141	1.0000000
C7	52320996	52321971	BolC7t45714H	0	+	51	923	975	0.9466667
C7	52324755	52329603	BolC7t45715H	0	-	2735	4842	4848	0.9987624
C7	52326328	52327561	BolC7t45716H	0	+	1219	1233	1233	1.0000000
C7	52337491	52340597	BolC7t45717H	0	+	1478	3030	3106	0.9755312
C7	52341052	52342216	BolC7t45718H	0	-	136	1086	1164	0.9329897
C7	52343328	52345018	BolC7t45719H	0	+	290	1607	1690	0.9508876
C7	52346507	52347524	BolC7t45720H	0	+	113	841	1017	0.8269420
C7	52348854	52351488	BolC7t45721H	0	+	535	2299	2634	0.8728170
C7	52352383	52353481	BolC7t45722H	0	-	786	1098	1098	1.0000000
C7	52354888	52356736	BolC7t45723H	0	+	1188	1848	1848	1.0000000
C7	52357322	52364204	BolC7t45724H	0	-	5289	6467	6882	0.9396977
C7	52371335	52381173	BolC7t45725H	0	-	2931	6807	9838	0.6919089
C7	52381958	52386390	BolC7t45726H	0	+	794	3907	4432	0.8815433
C7	52387691	52388891	BolC7t45727H	0	-	293	1146	1200	0.9550000
C7	52403528	52403819	BolC7t45728H	0	+	130	184	291	0.6323024
C7	52412883	52414422	BolC7t45729H	0	+	1407	1534	1539	0.9967511
C7	52419498	52422890	BolC7t45730H	0	+	2282	3392	3392	1.0000000
C7	52425982	52426309	BolC7t45731H	0	-	2	4	327	0.0122324
C7	52430196	52432743	BolC7t45732H	0	+	3244	2547	2547	1.0000000
C7	52434435	52437502	BolC7t45733H	0	+	4042	3067	3067	1.0000000
C7	52443077	52445095	BolC7t45734H	0	+	1615	2018	2018	1.0000000
C7	52447210	52447465	BolC7t45735H	0	+	67	255	255	1.0000000
C7	52459175	52459493	BolC7t45736H	0	-	179	318	318	1.0000000
C7	52460967	52463496	BolC7t45737H	0	-	269	2277	2529	0.9003559
C7	52466184	52467421	BolC7t45738H	0	+	1	2	1237	0.0016168
C7	52489355	52490297	BolC7t45739H	0	-	48	380	942	0.4033970
C7	52492705	52493218	BolC7t45740H	0	+	0	0	513	0.0000000
C7	52493696	52494365	BolC7t45741H	0	+	0	0	669	0.0000000
C7	52514573	52517400	BolC7t45742H	0	-	2496	2827	2827	1.0000000
C7	52531950	52532502	BolC7t45743H	0	+	42	312	552	0.5652174
C7	52536726	52538426	BolC7t45744H	0	+	169	1154	1700	0.6788235
C7	52543404	52546068	BolC7t45745H	0	-	1169	2452	2664	0.9204204
C7	52547721	52574239	BolC7t45746H	0	-	9486	17416	26518	0.6567615
C7	52554409	52554919	BolC7t45747H	0	-	0	0	510	0.0000000
C7	52556362	52557206	BolC7t45748H	0	+	509	844	844	1.0000000
C7	52568443	52571008	BolC7t45749H	0	+	3123	2565	2565	1.0000000
C7	52574982	52591738	BolC7t45750H	0	-	6972	15030	16756	0.8969921
C7	52577479	52577841	BolC7t45751H	0	-	187	362	362	1.0000000
C7	52593136	52595709	BolC7t45752H	0	-	794	2376	2573	0.9234357
C7	52599210	52602246	BolC7t45753H	0	-	1774	3036	3036	1.0000000
C7	52602935	52605609	BolC7t45754H	0	+	1333	2672	2674	0.9992521
C7	52605669	52606922	BolC7t45755H	0	+	652	1253	1253	1.0000000
C7	52608066	52611518	BolC7t45756H	0	+	1737	3362	3452	0.9739282
C7	52612775	52614002	BolC7t45757H	0	+	781	1227	1227	1.0000000
C7	52614778	52615834	BolC7t45758H	0	-	431	1046	1056	0.9905303
C7	52616687	52623215	BolC7t45759H	0	-	1861	5688	6528	0.8713235
C7	52622036	52622672	BolC7t45760H	0	-	57	450	636	0.7075472
C7	52626053	52626181	BolC7t45761H	0	-	359	128	128	1.0000000
C7	52626127	52626381	BolC7t45762H	0	-	573	254	254	1.0000000
C7	52628632	52631135	BolC7t45763H	0	-	302	1268	2503	0.5065921
C7	52631297	52634763	BolC7t45764H	0	-	782	2620	3466	0.7559146
C7	52633158	52634229	BolC7t45765H	0	-	59	517	1071	0.4827264
C7	52635785	52636925	BolC7t45766H	0	+	270	1042	1140	0.9140351
C7	52638555	52639552	BolC7t45767H	0	+	388	895	997	0.8976931
C7	52647182	52649897	BolC7t45768H	0	+	799	2584	2715	0.9517496
C7	52650247	52650955	BolC7t45769H	0	-	396	708	708	1.0000000
C7	52653770	52654421	BolC7t45770H	0	-	284	651	651	1.0000000
C7	52655778	52655928	BolC7t45771H	0	+	70	107	150	0.7133333
C7	52658291	52662768	BolC7t45772H	0	-	1630	3977	4477	0.8883181
C7	52663226	52664663	BolC7t45773H	0	+	937	1382	1437	0.9617258
C7	52665100	52667395	BolC7t45774H	0	-	790	1922	2295	0.8374728
C7	52678299	52681017	BolC7t45775H	0	+	438	2141	2718	0.7877116
C7	52691417	52692940	BolC7t45776H	0	-	1063	1523	1523	1.0000000
C7	52702376	52702790	BolC7t45777H	0	-	280	414	414	1.0000000
C7	52704414	52705459	BolC7t45778H	0	-	892	1045	1045	1.0000000
C7	52709119	52710247	BolC7t45779H	0	+	182	1059	1128	0.9388298
C7	52711838	52712015	BolC7t45780H	0	-	137	177	177	1.0000000
C7	52712621	52712783	BolC7t45781H	0	-	214	162	162	1.0000000
C7	52721248	52722095	BolC7t45782H	0	+	63	768	847	0.9067296
C7	52731020	52731816	BolC7t45783H	0	+	0	0	796	0.0000000
C7	52747197	52747500	BolC7t45784H	0	+	26	295	303	0.9735973
C7	52750495	52753023	BolC7t45785H	0	-	76	1430	2528	0.5656645
C7	52760018	52761074	BolC7t45786H	0	+	1746	1056	1056	1.0000000
C7	52767334	52769075	BolC7t45787H	0	-	11	67	1741	0.0384836
C7	52775784	52777883	BolC7t45788H	0	+	1156	1952	2099	0.9299666
C7	52790883	52792621	BolC7t45789H	0	-	72	690	1738	0.3970081
C7	52795158	52795798	BolC7t45790H	0	+	180	596	640	0.9312500
C7	52817199	52819544	BolC7t45791H	0	+	517	2142	2345	0.9134328
C7	52822853	52824037	BolC7t45792H	0	+	473	1131	1184	0.9552365
C7	52825068	52827857	BolC7t45793H	0	-	683	2623	2789	0.9404805
C7	52828212	52829930	BolC7t45794H	0	-	1565	1718	1718	1.0000000
C7	52834529	52835137	BolC7t45795H	0	-	585	608	608	1.0000000
C7	52836154	52841251	BolC7t45796H	0	+	1798	4647	5097	0.9117128
C7	52853917	52860640	BolC7t45797H	0	-	727	4641	6723	0.6903168
C7	52865279	52865843	BolC7t45798H	0	-	34	513	564	0.9095744
C7	52870289	52874044	BolC7t45799H	0	-	1160	3576	3755	0.9523302
C7	52880270	52880834	BolC7t45800H	0	+	524	564	564	1.0000000
C7	52895897	52896848	BolC7t45801H	0	+	143	389	951	0.4090431
C7	52897001	52905000	BolC7t45802H	0	-	5176	7370	7999	0.9213651
C7	52912917	52914514	BolC7t45803H	0	+	1678	1597	1597	1.0000000
C7	52921688	52923679	BolC7t45804H	0	+	464	1820	1991	0.9141135
C7	52937972	52938896	BolC7t45805H	0	+	543	924	924	1.0000000
C7	52940386	52940668	BolC7t45806H	0	+	276	282	282	1.0000000
C7	52952400	52952927	BolC7t45807H	0	+	779	527	527	1.0000000
C7	52955029	52956853	BolC7t45808H	0	+	861	1795	1824	0.9841009
C7	52957893	52959051	BolC7t45809H	0	-	1183	1158	1158	1.0000000
C7	52965269	52968384	BolC7t45810H	0	-	1385	2552	3115	0.8192616
C7	52969044	52971660	BolC7t45811H	0	+	875	2481	2616	0.9483945
C7	52981923	52982271	BolC7t45812H	0	+	17	151	348	0.4339080
C7	52983570	52984164	BolC7t45813H	0	-	167	493	594	0.8299663
C7	52988503	52989031	BolC7t45814H	0	-	549	528	528	1.0000000
C7	52990225	52991508	BolC7t45815H	0	+	612	1218	1283	0.9493375
C7	52992580	52992884	BolC7t45816H	0	+	444	304	304	1.0000000
C7	52993092	52993826	BolC7t45817H	0	+	1440	734	734	1.0000000
C7	52998192	53000411	BolC7t45818H	0	+	910	2105	2219	0.9486255
C7	53001006	53001600	BolC7t45819H	0	-	420	594	594	1.0000000
C7	53002173	53003266	BolC7t45820H	0	+	586	1043	1093	0.9542543
C7	53019159	53021037	BolC7t45821H	0	+	623	1615	1878	0.8599574
C7	53029100	53038209	BolC7t45822H	0	+	2285	5327	9109	0.5848063
C7	53031484	53032039	BolC7t45823H	0	+	2	156	555	0.2810811
C7	53038675	53040194	BolC7t45824H	0	-	667	1457	1519	0.9591837
C7	53055333	53059060	BolC7t45825H	0	+	1399	3492	3727	0.9369466
C7	53060424	53060679	BolC7t45826H	0	+	188	255	255	1.0000000
C7	53062161	53064940	BolC7t45827H	0	+	1408	2700	2779	0.9715725
C7	53075804	53078285	BolC7t45828H	0	+	307	1605	2481	0.6469166
C7	53104421	53105845	BolC7t45829H	0	+	187	1114	1424	0.7823034
C7	53108708	53109001	BolC7t45830H	0	+	344	293	293	1.0000000
C7	53111559	53114253	BolC7t45831H	0	+	529	2245	2694	0.8333333
C7	53115381	53115955	BolC7t45832H	0	+	118	537	574	0.9355401
C7	53118699	53120153	BolC7t45833H	0	+	1301	1454	1454	1.0000000
C7	53120926	53122789	BolC7t45834H	0	+	1002	1863	1863	1.0000000
C7	53123938	53125250	BolC7t45835H	0	-	846	1312	1312	1.0000000
C7	53125851	53129366	BolC7t45836H	0	-	828	2936	3515	0.8352774
C7	53129545	53133224	BolC7t45837H	0	-	2498	3679	3679	1.0000000
C7	53135411	53136390	BolC7t45838H	0	-	377	935	979	0.9550562
C7	53138522	53139743	BolC7t45839H	0	+	511	1221	1221	1.0000000
C7	53140702	53142108	BolC7t45840H	0	-	1303	1406	1406	1.0000000
C7	53144281	53146183	BolC7t45841H	0	+	376	1545	1902	0.8123028
C7	53146708	53149330	BolC7t45842H	0	-	610	2284	2622	0.8710908
C7	53151443	53153877	BolC7t45843H	0	-	1127	2293	2434	0.9420707
C7	53159040	53161558	BolC7t45844H	0	-	1760	2499	2518	0.9924543
C7	53162981	53163344	BolC7t45845H	0	+	190	362	363	0.9972452
C7	53166250	53166914	BolC7t45846H	0	-	421	664	664	1.0000000
C7	53168292	53171252	BolC7t45847H	0	+	834	2768	2960	0.9351351
C7	53176749	53179070	BolC7t45848H	0	-	1046	2213	2321	0.9534683
C7	53183400	53185007	BolC7t45849H	0	+	385	1565	1607	0.9738643
C7	53188030	53188300	BolC7t45850H	0	+	630	270	270	1.0000000
C7	53191465	53192451	BolC7t45851H	0	+	542	986	986	1.0000000
C7	53195895	53196706	BolC7t45852H	0	-	279	687	811	0.8471023
C7	53197630	53200331	BolC7t45853H	0	-	925	2684	2701	0.9937060
C7	53200807	53201938	BolC7t45854H	0	+	199	1064	1131	0.9407604
C7	53202496	53206119	BolC7t45855H	0	-	852	2787	3623	0.7692520
C7	53206942	53208567	BolC7t45856H	0	-	778	1329	1625	0.8178462
C7	53209591	53217112	BolC7t45857H	0	-	2660	3884	7521	0.5164207
C7	53228470	53231221	BolC7t45858H	0	+	1753	2640	2751	0.9596511
C7	53231636	53236148	BolC7t45859H	0	-	1422	4187	4512	0.9279699
C7	53237641	53238260	BolC7t45860H	0	+	580	619	619	1.0000000
C7	53238698	53243822	BolC7t45861H	0	-	3576	5124	5124	1.0000000
C7	53245905	53247105	BolC7t45862H	0	+	829	1200	1200	1.0000000
C7	53247557	53254839	BolC7t45863H	0	-	2379	6768	7282	0.9294150
C7	53264783	53267980	BolC7t45864H	0	-	550	2990	3197	0.9352518
C7	53271546	53277087	BolC7t45865H	0	+	716	3650	5541	0.6587259
C7	53278341	53281841	BolC7t45866H	0	+	608	2736	3500	0.7817143
C7	53282245	53285294	BolC7t45867H	0	-	1700	3049	3049	1.0000000
C7	53289355	53290787	BolC7t45868H	0	-	559	1402	1432	0.9790503
C7	53300665	53303693	BolC7t45869H	0	+	1466	2878	3028	0.9504623
C7	53304471	53306749	BolC7t45870H	0	-	1688	2278	2278	1.0000000
C7	53309185	53309830	BolC7t45871H	0	-	336	490	645	0.7596899
C7	53310164	53312373	BolC7t45872H	0	+	708	802	2209	0.3630602
C7	53314245	53315688	BolC7t45873H	0	-	972	1370	1443	0.9494110
C7	53316287	53320364	BolC7t45874H	0	-	734	2757	4077	0.6762325
C7	53320988	53323094	BolC7t45875H	0	+	715	2105	2106	0.9995252
C7	53323523	53324462	BolC7t45876H	0	-	1125	939	939	1.0000000
C7	53325324	53326285	BolC7t45877H	0	-	583	905	961	0.9417273
C7	53327274	53330508	BolC7t45878H	0	+	2127	3163	3234	0.9780458
C7	53331248	53332130	BolC7t45879H	0	+	178	666	882	0.7551020
C7	53333971	53337844	BolC7t45880H	0	+	2443	3817	3873	0.9855409
C7	53339269	53339445	BolC7t45881H	0	-	205	136	176	0.7727273
C7	53340838	53342459	BolC7t45882H	0	-	131	1164	1621	0.7180753
C7	53346854	53349022	BolC7t45883H	0	+	1243	1803	2168	0.8316421
C7	53351121	53352273	BolC7t45884H	0	+	42	682	1152	0.5920139
C7	53353220	53353994	BolC7t45885H	0	+	22	567	774	0.7325581
C7	53354858	53356207	BolC7t45886H	0	+	967	1231	1349	0.9125278
C7	53356907	53362110	BolC7t45887H	0	-	2342	4642	5203	0.8921776
C7	53364154	53364437	BolC7t45888H	0	+	53	283	283	1.0000000
C7	53365431	53370154	BolC7t45889H	0	-	1071	4052	4723	0.8579293
C7	53373908	53375265	BolC7t45890H	0	-	878	1357	1357	1.0000000
C7	53376031	53383235	BolC7t45891H	0	+	3429	7057	7204	0.9795946
C7	53383733	53384712	BolC7t45892H	0	-	583	979	979	1.0000000
C7	53385895	53386687	BolC7t45893H	0	+	695	792	792	1.0000000
C7	53387486	53391253	BolC7t45894H	0	-	978	3210	3767	0.8521370
C7	53393684	53395290	BolC7t45895H	0	-	766	1523	1606	0.9483188
C7	53396733	53397837	BolC7t45896H	0	+	232	1055	1104	0.9556159
C7	53398438	53398609	BolC7t45897H	0	-	138	171	171	1.0000000
C7	53400586	53403981	BolC7t45898H	0	+	2111	3287	3395	0.9681885
C7	53408385	53408985	BolC7t45899H	0	+	60	392	600	0.6533333
C7	53411341	53411947	BolC7t45900H	0	-	56	458	606	0.7557756
C7	53413008	53416072	BolC7t45901H	0	-	1725	3051	3064	0.9957572
C7	53416383	53417703	BolC7t45902H	0	+	269	1279	1320	0.9689394
C7	53419274	53420839	BolC7t45903H	0	+	1170	1565	1565	1.0000000
C7	53421600	53422890	BolC7t45904H	0	-	1404	1290	1290	1.0000000
C7	53426252	53427812	BolC7t45905H	0	+	499	1515	1560	0.9711539
C7	53432513	53433361	BolC7t45906H	0	+	261	771	848	0.9091981
C7	53434391	53436751	BolC7t45907H	0	-	1358	2360	2360	1.0000000
C7	53439026	53445183	BolC7t45908H	0	-	3734	6157	6157	1.0000000
C7	53447886	53448675	BolC7t45909H	0	+	20	633	789	0.8022814
C7	53449202	53450142	BolC7t45910H	0	-	279	893	940	0.9500000
C7	53451177	53452693	BolC7t45911H	0	+	1377	1516	1516	1.0000000
C7	53454095	53454491	BolC7t45912H	0	-	35	266	396	0.6717172
C7	53455632	53457450	BolC7t45913H	0	+	799	1818	1818	1.0000000
C7	53459624	53461879	BolC7t45914H	0	+	1433	2255	2255	1.0000000
C7	53463105	53463384	BolC7t45915H	0	-	67	279	279	1.0000000
C7	53464092	53469957	BolC7t45916H	0	+	7542	5599	5865	0.9546462
C7	53478864	53479743	BolC7t45917H	0	+	117	575	879	0.6541525
C7	53490063	53491521	BolC7t45918H	0	-	310	1410	1458	0.9670782
C7	53495560	53497246	BolC7t45919H	0	-	142	1415	1686	0.8392645
C7	53515076	53515724	BolC7t45920H	0	-	452	648	648	1.0000000
C7	53530732	53532315	BolC7t45921H	0	+	1215	1576	1583	0.9955780
C7	53538657	53541589	BolC7t45922H	0	+	1376	2926	2932	0.9979536
C7	53542235	53544615	BolC7t45923H	0	-	1680	2363	2380	0.9928572
C7	53546367	53547239	BolC7t45924H	0	-	37	619	872	0.7098624
C7	53548515	53553752	BolC7t45925H	0	-	1194	4441	5237	0.8480046
C7	53554130	53555771	BolC7t45926H	0	+	1011	1641	1641	1.0000000
C7	53557709	53558670	BolC7t45927H	0	+	151	826	961	0.8595213
C7	53563054	53564736	BolC7t45928H	0	-	852	1563	1682	0.9292509
C7	53565280	53567257	BolC7t45929H	0	+	631	1872	1977	0.9468892
C7	53567877	53569131	BolC7t45930H	0	-	788	1254	1254	1.0000000
C7	53570846	53577372	BolC7t45931H	0	+	5475	6435	6526	0.9860558
C7	53577813	53579420	BolC7t45932H	0	-	628	1497	1607	0.9315495
C7	53585530	53587567	BolC7t45933H	0	+	2016	2037	2037	1.0000000
C7	53588631	53593039	BolC7t45934H	0	-	3577	3912	4408	0.8874773
C7	53593113	53593874	BolC7t45935H	0	-	785	761	761	1.0000000
C7	53597251	53599231	BolC7t45936H	0	-	315	1300	1980	0.6565657
C7	53600697	53604365	BolC7t45937H	0	-	1456	3439	3668	0.9375681
C7	53605373	53606276	BolC7t45938H	0	-	409	903	903	1.0000000
C7	53612021	53612429	BolC7t45939H	0	+	123	402	408	0.9852941
C7	53616972	53618274	BolC7t45940H	0	+	496	1151	1302	0.8840246
C7	53622412	53623930	BolC7t45941H	0	+	896	1518	1518	1.0000000
C7	53627857	53629430	BolC7t45942H	0	+	455	1440	1573	0.9154482
C7	53629929	53631721	BolC7t45943H	0	-	889	1727	1792	0.9637277
C7	53635451	53638465	BolC7t45944H	0	+	765	2889	3014	0.9585268
C7	53639056	53639744	BolC7t45945H	0	-	642	688	688	1.0000000
C7	53644310	53650151	BolC7t45946H	0	+	1949	5457	5841	0.9342578
C7	53650400	53652509	BolC7t45947H	0	-	951	1790	2109	0.8487435
C7	53681501	53683708	BolC7t45948H	0	+	673	2207	2207	1.0000000
C7	53684584	53686073	BolC7t45949H	0	+	458	1069	1489	0.7179315
C7	53687820	53688943	BolC7t45950H	0	+	167	790	1123	0.7034729
C7	53689257	53690720	BolC7t45951H	0	-	1207	1463	1463	1.0000000
C7	53696491	53696842	BolC7t45952H	0	-	43	351	351	1.0000000
C7	53696997	53697636	BolC7t45953H	0	+	153	358	639	0.5602504
C7	53704210	53704885	BolC7t45954H	0	+	38	391	675	0.5792593
C7	53714119	53716951	BolC7t45955H	0	+	1570	2754	2832	0.9724576
C7	53717617	53717965	BolC7t45956H	0	-	476	348	348	1.0000000
C7	53721816	53723798	BolC7t45957H	0	-	688	1858	1982	0.9374369
C7	53725528	53727758	BolC7t45958H	0	+	923	2024	2230	0.9076233
C7	53728149	53729668	BolC7t45959H	0	-	302	1508	1519	0.9927584
C7	53733614	53738103	BolC7t45960H	0	-	1194	4441	4489	0.9893072
C7	53750477	53751955	BolC7t45961H	0	+	286	1154	1478	0.7807848
C7	53756490	53756955	BolC7t45962H	0	-	396	465	465	1.0000000
C7	53773916	53775513	BolC7t45963H	0	+	39	828	1597	0.5184721
C7	53779000	53780676	BolC7t45964H	0	+	1382	1676	1676	1.0000000
C7	53781262	53781669	BolC7t45965H	0	-	210	407	407	1.0000000
C7	53785148	53787701	BolC7t45966H	0	+	806	2499	2553	0.9788484
C7	53788737	53789727	BolC7t45967H	0	-	17	289	990	0.2919192
C7	53791579	53795133	BolC7t45968H	0	-	1276	3554	3554	1.0000000
C7	53796215	53796395	BolC7t45969H	0	-	6	121	180	0.6722222
C7	53798294	53798588	BolC7t45970H	0	-	200	294	294	1.0000000
C7	53799537	53802742	BolC7t45971H	0	+	1372	3147	3205	0.9819033
C7	53803232	53804457	BolC7t45972H	0	+	1025	1225	1225	1.0000000
C7	53806598	53808213	BolC7t45973H	0	+	1287	1615	1615	1.0000000
C7	53811201	53812176	BolC7t45974H	0	-	98	800	975	0.8205128
C7	53812807	53814479	BolC7t45975H	0	+	1142	1672	1672	1.0000000
C7	53814738	53815693	BolC7t45976H	0	-	117	764	955	0.8000000
C7	53816547	53824126	BolC7t45977H	0	+	2206	4091	7579	0.5397810
C7	53824343	53826222	BolC7t45978H	0	-	555	1779	1879	0.9467802
C7	53828636	53830988	BolC7t45979H	0	+	802	2352	2352	1.0000000
C7	53831693	53831888	BolC7t45980H	0	+	87	195	195	1.0000000
C7	53832142	53833045	BolC7t45981H	0	-	720	903	903	1.0000000
C7	53835380	53835686	BolC7t45982H	0	-	86	306	306	1.0000000
C7	53836547	53837442	BolC7t45983H	0	+	332	768	895	0.8581005
C7	53837893	53840492	BolC7t45984H	0	-	1249	2599	2599	1.0000000
C7	53842927	53844149	BolC7t45985H	0	-	92	1210	1222	0.9901800
C7	53844496	53848653	BolC7t45986H	0	-	1630	4012	4157	0.9651191
C7	53850615	53851013	BolC7t45987H	0	-	177	398	398	1.0000000
C7	53853727	53854648	BolC7t45988H	0	-	322	665	921	0.7220412
C7	53857001	53860080	BolC7t45989H	0	-	1802	2872	3079	0.9327704
C7	53867353	53870693	BolC7t45990H	0	-	989	3180	3340	0.9520958
C7	53872408	53872997	BolC7t45991H	0	-	228	589	589	1.0000000
C7	53875073	53875459	BolC7t45992H	0	+	118	386	386	1.0000000
C7	53875707	53876403	BolC7t45993H	0	-	259	696	696	1.0000000
C7	53879110	53879900	BolC7t45994H	0	-	604	790	790	1.0000000
C7	53883130	53885540	BolC7t45995H	0	+	809	1466	2410	0.6082988
C7	53904278	53904690	BolC7t45996H	0	+	22	314	412	0.7621359
C7	53920128	53920578	BolC7t45997H	0	+	270	450	450	1.0000000
C7	53923948	53924775	BolC7t45998H	0	+	284	778	827	0.9407497
C7	53925671	53926985	BolC7t45999H	0	-	1068	1310	1314	0.9969559
C7	53927147	53929614	BolC7t46000H	0	-	1424	2364	2467	0.9582489
C7	53930296	53931836	BolC7t46001H	0	-	429	1537	1540	0.9980519
C7	53934584	53935259	BolC7t46002H	0	+	239	675	675	1.0000000
C7	53935815	53937405	BolC7t46003H	0	-	372	1532	1590	0.9635220
C7	53942930	53943380	BolC7t46004H	0	-	360	450	450	1.0000000
C7	53946217	53951523	BolC7t46005H	0	-	4201	5306	5306	1.0000000
C7	53952528	53955045	BolC7t46006H	0	-	1307	2381	2517	0.9459674
C7	53955620	53956496	BolC7t46007H	0	+	368	876	876	1.0000000
C7	53956847	53958342	BolC7t46008H	0	-	939	1292	1495	0.8642141
C7	53959245	53961219	BolC7t46009H	0	+	1098	1974	1974	1.0000000
C7	53961806	53967338	BolC7t46010H	0	-	1663	4742	5532	0.8571945
C7	53967906	53968255	BolC7t46011H	0	+	173	349	349	1.0000000
C7	53968995	53972482	BolC7t46012H	0	+	1586	3195	3487	0.9162604
C7	53973475	53979158	BolC7t46013H	0	-	3547	5648	5683	0.9938413
C7	53989648	53990125	BolC7t46014H	0	+	64	301	477	0.6310273
C7	53992181	53992593	BolC7t46015H	0	+	324	412	412	1.0000000
C7	53992643	53995232	BolC7t46016H	0	+	792	1776	2589	0.6859791
C7	53996791	53998641	BolC7t46017H	0	-	1172	1794	1850	0.9697297
C7	54006749	54009068	BolC7t46018H	0	+	710	2068	2319	0.8917637
C7	54017776	54020655	BolC7t46019H	0	+	488	2162	2879	0.7509552
C7	54024437	54025160	BolC7t46020H	0	+	107	723	723	1.0000000
C7	54038380	54039408	BolC7t46021H	0	-	227	983	1028	0.9562257
C7	54047080	54048306	BolC7t46022H	0	-	658	1226	1226	1.0000000
C7	54049214	54050963	BolC7t46023H	0	+	534	1423	1749	0.8136078
C7	54052443	54053583	BolC7t46024H	0	-	522	1126	1140	0.9877193
C7	54057734	54060351	BolC7t46025H	0	-	475	2208	2617	0.8437142
C7	54062879	54063059	BolC7t46026H	0	+	88	180	180	1.0000000
C7	54065132	54065743	BolC7t46027H	0	+	440	611	611	1.0000000
C7	54066553	54069845	BolC7t46028H	0	+	1377	3249	3292	0.9869381
C7	54070275	54071791	BolC7t46029H	0	-	944	1402	1516	0.9248021
C7	54079437	54081116	BolC7t46030H	0	+	1582	1679	1679	1.0000000
C7	54083768	54085976	BolC7t46031H	0	+	1062	2174	2208	0.9846014
C7	54088546	54090452	BolC7t46032H	0	-	1907	1900	1906	0.9968520
C7	54094704	54098643	BolC7t46033H	0	+	624	3203	3939	0.8131505
C7	54098960	54099366	BolC7t46034H	0	-	561	406	406	1.0000000
C7	54100148	54100721	BolC7t46035H	0	-	55	405	573	0.7068063
C7	54102175	54102580	BolC7t46036H	0	+	402	405	405	1.0000000
C7	54103631	54105512	BolC7t46037H	0	-	1272	1881	1881	1.0000000
C7	54106240	54106546	BolC7t46038H	0	+	78	306	306	1.0000000
C7	54106722	54107178	BolC7t46039H	0	-	358	456	456	1.0000000
C7	54107261	54108777	BolC7t46040H	0	-	1550	1516	1516	1.0000000
C7	54110282	54115591	BolC7t46041H	0	-	3383	5309	5309	1.0000000
C7	54116879	54119886	BolC7t46042H	0	-	1697	3005	3007	0.9993349
C7	54123800	54125746	BolC7t46043H	0	+	1233	1946	1946	1.0000000
C7	54128076	54128268	BolC7t46044H	0	+	146	192	192	1.0000000
C7	54129224	54129413	BolC7t46045H	0	+	389	189	189	1.0000000
C7	54137293	54137967	BolC7t46046H	0	-	327	674	674	1.0000000
C7	54138783	54140230	BolC7t46047H	0	+	480	1415	1447	0.9778853
C7	54141958	54143436	BolC7t46048H	0	+	420	1478	1478	1.0000000
C7	54144400	54145093	BolC7t46049H	0	+	461	693	693	1.0000000
C7	54145487	54147534	BolC7t46050H	0	+	931	1956	2047	0.9555447
C7	54153393	54155420	BolC7t46051H	0	-	729	2026	2027	0.9995067
C7	54168270	54169158	BolC7t46052H	0	-	413	888	888	1.0000000
C7	54177565	54178843	BolC7t46053H	0	-	10	291	1278	0.2276995
C7	54181894	54182647	BolC7t46054H	0	-	171	686	753	0.9110226
C7	54193100	54195890	BolC7t46055H	0	+	2609	2790	2790	1.0000000
C7	54196719	54197969	BolC7t46056H	0	+	1113	1250	1250	1.0000000
C7	54198729	54199809	BolC7t46057H	0	+	696	1080	1080	1.0000000
C7	54201240	54202221	BolC7t46058H	0	+	240	871	981	0.8878695
C7	54208675	54209687	BolC7t46059H	0	+	194	960	1012	0.9486166
C7	54210959	54216241	BolC7t46060H	0	+	5294	5282	5282	1.0000000
C7	54220405	54221380	BolC7t46061H	0	-	680	975	975	1.0000000
C7	54228755	54232702	BolC7t46062H	0	-	719	1170	3947	0.2964277
C7	54233618	54235526	BolC7t46063H	0	-	917	1873	1908	0.9816562
C7	54236763	54238297	BolC7t46064H	0	+	1274	1534	1534	1.0000000
C7	54242140	54245938	BolC7t46065H	0	+	1309	3461	3798	0.9112691
C7	54246295	54249945	BolC7t46066H	0	-	1919	3031	3650	0.8304110
C7	54251292	54252425	BolC7t46067H	0	-	424	1096	1133	0.9673433
C7	54252784	54253701	BolC7t46068H	0	-	84	603	917	0.6575791
C7	54254315	54262408	BolC7t46069H	0	-	1882	6184	8093	0.7641171
C7	54267529	54267778	BolC7t46070H	0	+	313	249	249	1.0000000
C7	54272804	54274010	BolC7t46071H	0	-	266	1170	1206	0.9701493
C7	54276254	54279250	BolC7t46072H	0	+	809	2345	2996	0.7827103
C7	54279917	54280250	BolC7t46073H	0	-	297	333	333	1.0000000
C7	54280391	54280622	BolC7t46074H	0	-	187	231	231	1.0000000
C7	54285283	54286069	BolC7t46075H	0	-	198	642	786	0.8167939
C7	54287432	54288716	BolC7t46076H	0	-	257	1279	1284	0.9961059
C7	54290305	54290680	BolC7t46077H	0	+	264	375	375	1.0000000
C7	54296129	54296705	BolC7t46078H	0	-	852	576	576	1.0000000
C7	54299105	54300617	BolC7t46079H	0	+	113	1091	1512	0.7215608
C7	54301300	54302675	BolC7t46080H	0	+	522	1375	1375	1.0000000
C7	54303568	54306493	BolC7t46081H	0	+	733	2425	2925	0.8290598
C7	54307001	54307265	BolC7t46082H	0	-	254	264	264	1.0000000
C7	54311862	54313458	BolC7t46083H	0	-	427	1212	1596	0.7593985
C7	54316486	54318169	BolC7t46084H	0	+	449	1575	1683	0.9358289
C7	54322776	54323364	BolC7t46085H	0	-	180	583	588	0.9914966
C7	54327398	54327593	BolC7t46086H	0	+	39	195	195	1.0000000
C7	54330559	54332234	BolC7t46087H	0	+	992	1675	1675	1.0000000
C7	54334316	54334838	BolC7t46088H	0	+	456	522	522	1.0000000
C7	54335574	54335697	BolC7t46089H	0	+	142	88	123	0.7154471
C7	54336175	54337573	BolC7t46090H	0	+	278	842	1398	0.6022890
C7	54348243	54349564	BolC7t46091H	0	+	144	1212	1321	0.9174867
C7	54351040	54351401	BolC7t46092H	0	-	48	222	361	0.6149585
C7	54353021	54353802	BolC7t46093H	0	+	308	781	781	1.0000000
C7	54355606	54357121	BolC7t46094H	0	+	902	1515	1515	1.0000000
C7	54363863	54366544	BolC7t46095H	0	+	775	2487	2681	0.9276389
C7	54366607	54367027	BolC7t46096H	0	+	398	420	420	1.0000000
C7	54382935	54385718	BolC7t46097H	0	+	1029	2547	2783	0.9151994
C7	54387905	54388743	BolC7t46098H	0	+	713	838	838	1.0000000
C7	54389161	54391902	BolC7t46099H	0	-	653	2285	2741	0.8336374
C7	54392300	54392510	BolC7t46100H	0	-	18	210	210	1.0000000
C7	54395680	54395902	BolC7t46101H	0	+	256	222	222	1.0000000
C7	54396591	54401311	BolC7t46102H	0	-	2244	4703	4720	0.9963983
C7	54402181	54403416	BolC7t46103H	0	+	686	1216	1235	0.9846154
C7	54403604	54404409	BolC7t46104H	0	-	397	805	805	1.0000000
C7	54413041	54414603	BolC7t46105H	0	+	516	1166	1562	0.7464789
C7	54415795	54416435	BolC7t46106H	0	+	554	639	640	0.9984375
C7	54417595	54422784	BolC7t46107H	0	-	2770	4585	5189	0.8835999
C7	54451255	54452073	BolC7t46108H	0	-	51	694	818	0.8484108
C7	54468204	54472228	BolC7t46109H	0	-	302	2503	4024	0.6220179
C7	54473111	54477325	BolC7t46110H	0	+	888	3254	4214	0.7721879
C7	54482019	54485179	BolC7t46111H	0	+	1076	2932	3160	0.9278481
C7	54487125	54487554	BolC7t46112H	0	+	168	397	429	0.9254079
C7	54490560	54491938	BolC7t46113H	0	-	98	823	1378	0.5972424
C7	54501027	54502767	BolC7t46114H	0	-	1108	1740	1740	1.0000000
C7	54506359	54509295	BolC7t46115H	0	+	1489	2864	2936	0.9754769
C7	54511109	54512639	BolC7t46116H	0	+	114	1243	1530	0.8124183
C7	54514545	54515724	BolC7t46117H	0	-	218	757	1179	0.6420696
C7	54518631	54519084	BolC7t46118H	0	-	514	453	453	1.0000000
C7	54519155	54519839	BolC7t46119H	0	-	547	684	684	1.0000000
C7	54522265	54525131	BolC7t46120H	0	+	1878	2866	2866	1.0000000
C7	54525969	54526363	BolC7t46121H	0	+	1	2	394	0.0050761
C7	54532866	54535747	BolC7t46122H	0	-	1108	2775	2881	0.9632072
C7	54537107	54537500	BolC7t46123H	0	+	572	393	393	1.0000000
C7	54538671	54540203	BolC7t46124H	0	-	790	1532	1532	1.0000000
C7	54540429	54541673	BolC7t46125H	0	+	466	1244	1244	1.0000000
C7	54549128	54550699	BolC7t46126H	0	+	278	1482	1571	0.9433482
C7	54553742	54556114	BolC7t46127H	0	+	952	2248	2372	0.9477234
C7	54558022	54559291	BolC7t46128H	0	-	434	1261	1269	0.9936958
C7	54560885	54562191	BolC7t46129H	0	-	967	1306	1306	1.0000000
C7	54567486	54568962	BolC7t46130H	0	-	1327	1476	1476	1.0000000
C7	54575464	54577997	BolC7t46131H	0	+	1427	2533	2533	1.0000000
C7	54583877	54584307	BolC7t46132H	0	-	129	430	430	1.0000000
C7	54584986	54591223	BolC7t46133H	0	+	2585	6187	6237	0.9919834
C7	54593774	54595210	BolC7t46134H	0	+	1999	1436	1436	1.0000000
C7	54595668	54598166	BolC7t46135H	0	+	1196	2498	2498	1.0000000
C7	54600641	54605339	BolC7t46136H	0	-	2417	4691	4698	0.9985100
C7	54607599	54608430	BolC7t46137H	0	-	24	356	831	0.4283995
C7	54619363	54619828	BolC7t46138H	0	+	599	465	465	1.0000000
C7	54620318	54621186	BolC7t46139H	0	+	27	528	868	0.6082949
C7	54624778	54626571	BolC7t46140H	0	+	1273	1793	1793	1.0000000
C7	54627839	54628295	BolC7t46141H	0	+	3	112	456	0.2456140
C7	54628985	54629528	BolC7t46142H	0	-	387	543	543	1.0000000
C7	54629601	54629958	BolC7t46143H	0	-	300	357	357	1.0000000
C7	54631534	54632701	BolC7t46144H	0	+	1	45	1167	0.0385604
C7	54636124	54638939	BolC7t46145H	0	+	2577	2815	2815	1.0000000
C7	54651697	54653773	BolC7t46146H	0	-	1782	2076	2076	1.0000000
C7	54662890	54663520	BolC7t46147H	0	+	86	494	630	0.7841270
C7	54672607	54673788	BolC7t46148H	0	+	1520	1181	1181	1.0000000
C7	54715149	54715341	BolC7t46149H	0	-	2592	192	192	1.0000000
C7	54718031	54719648	BolC7t46150H	0	+	124	894	1617	0.5528757
C7	54729559	54731292	BolC7t46151H	0	+	453	1587	1733	0.9157530
C7	54735691	54740120	BolC7t46152H	0	+	3936	4429	4429	1.0000000
C7	54740558	54743715	BolC7t46153H	0	+	1041	3157	3157	1.0000000
C7	54756186	54758082	BolC7t46154H	0	+	1014	1837	1896	0.9688818
C7	54758094	54760704	BolC7t46155H	0	+	1886	2610	2610	1.0000000
C7	54762214	54762448	BolC7t46156H	0	+	274	234	234	1.0000000
C7	54764020	54767370	BolC7t46157H	0	+	1570	3173	3350	0.9471642
C7	54768384	54770826	BolC7t46158H	0	+	1526	2418	2442	0.9901720
C7	54778016	54780767	BolC7t46159H	0	+	715	2354	2751	0.8556889
C7	54788980	54790198	BolC7t46160H	0	+	117	811	1218	0.6658456
C7	54790378	54791561	BolC7t46161H	0	-	553	1183	1183	1.0000000
C7	54793290	54793933	BolC7t46162H	0	+	185	563	643	0.8755832
C7	54796561	54797162	BolC7t46163H	0	+	25	147	601	0.2445923
C7	54799427	54800047	BolC7t46164H	0	+	60	420	620	0.6774194
C7	54802089	54802648	BolC7t46165H	0	+	104	521	559	0.9320214
C7	54803666	54804415	BolC7t46166H	0	+	67	567	749	0.7570093
C7	54812643	54815181	BolC7t46167H	0	+	1566	2497	2538	0.9838455
C7	54818407	54819616	BolC7t46168H	0	+	95	667	1209	0.5516956
C7	54821690	54824122	BolC7t46169H	0	-	2332	2432	2432	1.0000000
C7	54824979	54826779	BolC7t46170H	0	+	1238	1800	1800	1.0000000
C7	54827161	54829896	BolC7t46171H	0	-	1578	2735	2735	1.0000000
C7	54837113	54837953	BolC7t46172H	0	+	9	374	840	0.4452381
C7	54838802	54839732	BolC7t46173H	0	+	455	925	930	0.9946237
C7	54840517	54841654	BolC7t46174H	0	-	657	1102	1137	0.9692172
C7	54842430	54843837	BolC7t46175H	0	-	458	1248	1407	0.8869936
C7	54846189	54847140	BolC7t46176H	0	-	219	951	951	1.0000000
C7	54847332	54847470	BolC7t46177H	0	-	19	138	138	1.0000000
C7	54855704	54857390	BolC7t46178H	0	-	1144	1686	1686	1.0000000
C7	54865535	54866351	BolC7t46179H	0	-	846	816	816	1.0000000
C7	54869591	54873318	BolC7t46180H	0	+	2962	3727	3727	1.0000000
C7	54873866	54875719	BolC7t46181H	0	-	251	1458	1853	0.7868322
C7	54892737	54893729	BolC7t46182H	0	-	88	837	992	0.8437500
C7	54895902	54896166	BolC7t46183H	0	+	89	264	264	1.0000000
C7	54898075	54899909	BolC7t46184H	0	-	75	1178	1834	0.6423119
C7	54902067	54902397	BolC7t46185H	0	+	308	330	330	1.0000000
C7	54905852	54909583	BolC7t46186H	0	+	1404	3523	3731	0.9442509
C7	54916152	54918644	BolC7t46187H	0	-	1889	2492	2492	1.0000000
C7	54927845	54930886	BolC7t46188H	0	-	1242	2598	3041	0.8543242
C7	54935552	54937421	BolC7t46189H	0	-	241	1300	1869	0.6955591
C7	54939634	54940156	BolC7t46190H	0	-	0	0	522	0.0000000
C7	54941874	54944833	BolC7t46191H	0	+	2507	2959	2959	1.0000000
C7	54945017	54946834	BolC7t46192H	0	-	1356	1817	1817	1.0000000
C7	54948499	54950931	BolC7t46193H	0	-	2825	2432	2432	1.0000000
C7	54952414	54953851	BolC7t46194H	0	+	488	1414	1437	0.9839944
C7	54957263	54962245	BolC7t46195H	0	+	2758	4834	4982	0.9702930
C7	54964789	54964978	BolC7t46196H	0	-	195	189	189	1.0000000
C7	54972073	54973315	BolC7t46197H	0	-	1055	1242	1242	1.0000000
C7	54975873	54976979	BolC7t46198H	0	-	498	1106	1106	1.0000000
C7	54977281	54977806	BolC7t46199H	0	+	233	525	525	1.0000000
C7	54978651	54979908	BolC7t46200H	0	-	865	1222	1257	0.9721559
C7	54981040	54983252	BolC7t46201H	0	+	2216	2212	2212	1.0000000
C7	54984956	54985286	BolC7t46202H	0	-	2	146	330	0.4424242
C7	54987716	54994466	BolC7t46203H	0	-	1499	5968	6750	0.8841481
C7	55002940	55003144	BolC7t46204H	0	-	353	204	204	1.0000000
C7	55006748	55007069	BolC7t46205H	0	-	323	321	321	1.0000000
C7	55016655	55021573	BolC7t46206H	0	+	5306	4918	4918	1.0000000
C7	55022674	55023258	BolC7t46207H	0	-	618	584	584	1.0000000
C7	55024010	55024508	BolC7t46208H	0	-	284	488	498	0.9799197
C7	55026597	55026870	BolC7t46209H	0	+	45	273	273	1.0000000
C7	55033086	55036443	BolC7t46210H	0	+	580	3182	3357	0.9478701
C7	55037617	55039718	BolC7t46211H	0	-	1839	2017	2101	0.9600191
C7	55052647	55053188	BolC7t46212H	0	+	187	500	541	0.9242144
C7	55054931	55055788	BolC7t46213H	0	-	169	819	857	0.9556593
C7	55063316	55066533	BolC7t46214H	0	-	391	2790	3217	0.8672677
C7	55070042	55070323	BolC7t46215H	0	-	0	0	281	0.0000000
C7	55070671	55074732	BolC7t46216H	0	+	1237	2703	4061	0.6655996
C7	55079959	55084931	BolC7t46217H	0	+	1010	2890	4972	0.5812550
C7	55085293	55089469	BolC7t46218H	0	-	1256	3919	4176	0.9384578
C7	55106393	55110971	BolC7t46219H	0	+	975	4418	4578	0.9650502
C7	55112198	55113270	BolC7t46220H	0	+	356	1072	1072	1.0000000
C7	55115005	55116889	BolC7t46221H	0	+	553	1642	1884	0.8715499
C7	55119257	55122331	BolC7t46222H	0	+	1092	2927	3074	0.9521796
C7	55131110	55132773	BolC7t46223H	0	+	549	1419	1663	0.8532772
C7	55133893	55138160	BolC7t46224H	0	-	280	2780	4267	0.6515116
C7	55150022	55154061	BolC7t46225H	0	+	487	3268	4039	0.8091112
C7	55155565	55156056	BolC7t46226H	0	+	113	491	491	1.0000000
C7	55157838	55159746	BolC7t46227H	0	-	917	1793	1908	0.9397275
C7	55172037	55172955	BolC7t46228H	0	+	604	918	918	1.0000000
C7	55177071	55180511	BolC7t46229H	0	+	1223	3144	3440	0.9139535
C7	55194396	55194822	BolC7t46230H	0	+	592	426	426	1.0000000
C7	55195630	55196305	BolC7t46231H	0	-	824	675	675	1.0000000
C7	55201887	55202679	BolC7t46232H	0	+	96	653	792	0.8244950
C7	55205965	55206172	BolC7t46233H	0	-	306	207	207	1.0000000
C7	55207885	55208575	BolC7t46234H	0	-	493	690	690	1.0000000
C7	55208781	55209048	BolC7t46235H	0	-	244	267	267	1.0000000
C7	55211844	55212977	BolC7t46236H	0	-	313	1041	1133	0.9187996
C7	55216940	55217214	BolC7t46237H	0	+	0	0	274	0.0000000
C7	55223190	55224337	BolC7t46238H	0	-	56	656	1147	0.5719268
C7	55225756	55226939	BolC7t46239H	0	-	143	673	1183	0.5688927
C7	55229079	55229434	BolC7t46240H	0	+	116	355	355	1.0000000
C7	55230866	55233771	BolC7t46241H	0	+	1485	2885	2905	0.9931153
C7	55234482	55234983	BolC7t46242H	0	+	212	443	501	0.8842315
C7	55252187	55255084	BolC7t46243H	0	+	1379	2826	2897	0.9754919
C7	55259862	55260452	BolC7t46244H	0	-	431	590	590	1.0000000
C7	55264271	55265630	BolC7t46245H	0	+	64	460	1359	0.3384842
C7	55295312	55296266	BolC7t46246H	0	-	269	954	954	1.0000000
C7	55300548	55300869	BolC7t46247H	0	+	433	321	321	1.0000000
C7	55321468	55322296	BolC7t46248H	0	+	4	69	828	0.0833333
C7	55323356	55324649	BolC7t46249H	0	-	14	372	1293	0.2877030
C7	55331956	55332232	BolC7t46250H	0	-	136	276	276	1.0000000
C7	55335600	55336095	BolC7t46251H	0	-	46	445	495	0.8989899
C7	55346224	55346341	BolC7t46252H	0	+	27	107	117	0.9145299
C7	55348063	55349246	BolC7t46253H	0	+	770	1183	1183	1.0000000
C7	55349491	55352074	BolC7t46254H	0	-	2389	2583	2583	1.0000000
C7	55353715	55354784	BolC7t46255H	0	+	676	1069	1069	1.0000000
C7	55355357	55357465	BolC7t46256H	0	-	1439	2108	2108	1.0000000
C7	55358130	55360972	BolC7t46257H	0	-	2161	2842	2842	1.0000000
C7	55371928	55373330	BolC7t46258H	0	+	1076	1287	1402	0.9179743
C7	55374276	55377056	BolC7t46259H	0	-	635	2502	2780	0.9000000
C7	55378419	55379657	BolC7t46260H	0	-	740	1238	1238	1.0000000
C7	55382381	55384009	BolC7t46261H	0	-	1005	1628	1628	1.0000000
C7	55384606	55385458	BolC7t46262H	0	-	192	852	852	1.0000000
C7	55387907	55390302	BolC7t46263H	0	-	1051	2342	2395	0.9778706
C7	55407975	55412685	BolC7t46264H	0	+	2763	4441	4710	0.9428875
C7	55413924	55414935	BolC7t46265H	0	+	1232	1011	1011	1.0000000
C7	55417723	55418633	BolC7t46266H	0	+	40	422	910	0.4637363
C7	55419799	55420852	BolC7t46267H	0	-	138	665	1053	0.6315290
C7	55423984	55424878	BolC7t46268H	0	-	103	849	894	0.9496644
C7	55426432	55427412	BolC7t46269H	0	+	10	158	980	0.1612245
C7	55428684	55429268	BolC7t46270H	0	+	169	567	584	0.9708904
C7	55430957	55432173	BolC7t46271H	0	+	761	1215	1216	0.9991776
C7	55433957	55434288	BolC7t46272H	0	+	362	331	331	1.0000000
C7	55435343	55435655	BolC7t46273H	0	-	315	312	312	1.0000000
C7	55438188	55459697	BolC7t46274H	0	-	12338	20117	21509	0.9352829
C7	55442924	55444418	BolC7t46275H	0	+	1296	1488	1494	0.9959840
C7	55444669	55447042	BolC7t46276H	0	-	1412	2373	2373	1.0000000
C7	55447741	55450022	BolC7t46277H	0	-	2250	2281	2281	1.0000000
C7	55455272	55458314	BolC7t46278H	0	-	1477	2974	3042	0.9776463
C7	55460997	55463147	BolC7t46279H	0	+	890	2111	2150	0.9818605
C7	55463645	55467679	BolC7t46280H	0	-	3208	4034	4034	1.0000000
C7	55477574	55481446	BolC7t46281H	0	+	3240	3822	3872	0.9870868
C7	55481832	55485860	BolC7t46282H	0	-	1964	3950	4028	0.9806355
C7	55486558	55487003	BolC7t46283H	0	+	335	445	445	1.0000000
C7	55487132	55489013	BolC7t46284H	0	-	683	1881	1881	1.0000000
C7	55490835	55492861	BolC7t46285H	0	-	2296	2026	2026	1.0000000
C7	55494318	55498344	BolC7t46286H	0	-	3796	4026	4026	1.0000000
C7	55501235	55501406	BolC7t46287H	0	-	219	162	171	0.9473684
C7	55501782	55502007	BolC7t46288H	0	-	273	205	225	0.9111111
C7	55512588	55513884	BolC7t46289H	0	+	635	1296	1296	1.0000000
C7	55525524	55525722	BolC7t46290H	0	-	11	108	198	0.5454546
C7	55542475	55554590	BolC7t46291H	0	+	4375	11121	12115	0.9179530
C7	55556478	55556784	BolC7t46292H	0	+	180	306	306	1.0000000
C7	55557287	55558717	BolC7t46293H	0	-	760	1430	1430	1.0000000
C7	55560818	55562224	BolC7t46294H	0	-	197	1290	1406	0.9174964
C7	55564761	55566374	BolC7t46295H	0	-	1229	1613	1613	1.0000000
C7	55567362	55569162	BolC7t46296H	0	-	659	1789	1800	0.9938889
C7	55571922	55574118	BolC7t46297H	0	+	2145	2196	2196	1.0000000
C7	55580984	55581568	BolC7t46298H	0	+	223	545	584	0.9332192
C7	55583706	55585251	BolC7t46299H	0	+	230	1545	1545	1.0000000
C7	55585512	55589794	BolC7t46300H	0	-	1743	4139	4282	0.9666044
C7	55598067	55600106	BolC7t46301H	0	+	255	1711	2039	0.8391368
C7	55601182	55607971	BolC7t46302H	0	+	900	3958	6789	0.5830019
C7	55608525	55609843	BolC7t46303H	0	-	298	1114	1318	0.8452200
C7	55611527	55621151	BolC7t46304H	0	+	6158	9263	9624	0.9624896
C7	55621769	55624830	BolC7t46305H	0	-	576	2690	3061	0.8787978
C7	55627988	55636919	BolC7t46306H	0	+	1119	1494	8931	0.1672825
C7	55637282	55643724	BolC7t46307H	0	+	651	2051	6442	0.3183794
C7	55645128	55645758	BolC7t46308H	0	-	76	367	630	0.5825397
C7	55654354	55655149	BolC7t46309H	0	+	183	630	795	0.7924528
C7	55657851	55660677	BolC7t46310H	0	+	1281	2493	2826	0.8821656
C7	55662476	55663624	BolC7t46311H	0	-	689	1032	1148	0.8989547
C7	55676826	55677201	BolC7t46312H	0	+	175	364	375	0.9706666
C7	55683266	55684854	BolC7t46313H	0	+	913	1588	1588	1.0000000
C7	55685921	55687610	BolC7t46314H	0	-	1035	1596	1689	0.9449378
C7	55687835	55690233	BolC7t46315H	0	-	689	2213	2398	0.9228524
C7	55692501	55693271	BolC7t46316H	0	+	146	661	770	0.8584415
C7	55694905	55695454	BolC7t46317H	0	-	433	549	549	1.0000000
C7	55699197	55702419	BolC7t46318H	0	+	463	2042	3222	0.6337678
C7	55705306	55706235	BolC7t46319H	0	-	552	929	929	1.0000000
C7	55709433	55711083	BolC7t46320H	0	+	1368	1650	1650	1.0000000
C7	55711802	55712157	BolC7t46321H	0	-	415	355	355	1.0000000
C7	55723910	55725259	BolC7t46322H	0	-	437	1347	1349	0.9985174
C7	55735379	55736112	BolC7t46323H	0	+	1083	733	733	1.0000000
C7	55737015	55745861	BolC7t46324H	0	+	3316	7602	8846	0.8593715
C7	55746453	55747425	BolC7t46325H	0	+	776	972	972	1.0000000
C7	55748225	55750567	BolC7t46326H	0	-	1284	2342	2342	1.0000000
C7	55754621	55756310	BolC7t46327H	0	-	1253	1478	1689	0.8750740
C7	55756689	55763931	BolC7t46328H	0	-	6542	7202	7242	0.9944767
C7	55769975	55773102	BolC7t46329H	0	-	1749	3127	3127	1.0000000
C7	55776788	55777346	BolC7t46330H	0	+	500	558	558	1.0000000
C7	55777490	55779922	BolC7t46331H	0	+	2024	2432	2432	1.0000000
C7	55786915	55787410	BolC7t46332H	0	+	38	356	495	0.7191919
C7	55800700	55801368	BolC7t46333H	0	-	871	668	668	1.0000000
C7	55805682	55808417	BolC7t46334H	0	-	2843	2735	2735	1.0000000
C7	55809389	55812020	BolC7t46335H	0	+	1418	2613	2631	0.9931585
C7	55817931	55819067	BolC7t46336H	0	+	318	1021	1136	0.8987676
C7	55819644	55820973	BolC7t46337H	0	+	245	1168	1329	0.8788563
C7	55828335	55829041	BolC7t46338H	0	+	142	651	706	0.9220963
C7	55829860	55833160	BolC7t46339H	0	+	1450	3271	3300	0.9912121
C7	55833439	55835286	BolC7t46340H	0	-	964	1847	1847	1.0000000
C7	55839930	55841300	BolC7t46341H	0	+	361	1220	1370	0.8905110
C7	55841554	55841895	BolC7t46342H	0	-	733	341	341	1.0000000
C7	55844389	55844560	BolC7t46343H	0	-	0	0	171	0.0000000
C7	55857171	55862072	BolC7t46344H	0	-	2130	4384	4901	0.8945113
C7	55868502	55872935	BolC7t46345H	0	+	1306	4089	4433	0.9224002
C7	55875553	55877878	BolC7t46346H	0	+	153	660	2325	0.2838710
C7	55879252	55881638	BolC7t46347H	0	-	1208	2276	2386	0.9538977
C7	55883319	55883706	BolC7t46348H	0	+	32	380	387	0.9819121
C7	55888799	55889918	BolC7t46349H	0	-	685	1119	1119	1.0000000
C7	55890314	55890702	BolC7t46350H	0	+	265	388	388	1.0000000
C7	55891333	55894003	BolC7t46351H	0	-	1363	2559	2670	0.9584270
C7	55905149	55909132	BolC7t46352H	0	+	1411	3683	3983	0.9246799
C7	55911696	55912248	BolC7t46353H	0	+	178	552	552	1.0000000
C7	55913896	55915914	BolC7t46354H	0	+	877	2016	2018	0.9990089
C7	55917277	55918830	BolC7t46355H	0	+	1180	1553	1553	1.0000000
C7	55919778	55921917	BolC7t46356H	0	-	1421	2139	2139	1.0000000
C7	55925635	55926078	BolC7t46357H	0	-	1120	378	443	0.8532732
C7	55929992	55933447	BolC7t46358H	0	+	1094	3149	3455	0.9114327
C7	55942610	55942754	BolC7t46359H	0	+	284	144	144	1.0000000
C7	55944709	55945048	BolC7t46360H	0	+	53	339	339	1.0000000
C7	55946313	55950797	BolC7t46361H	0	+	1063	4442	4484	0.9906334
C7	55952812	55954679	BolC7t46362H	0	-	369	1774	1867	0.9501874
C7	55957504	55959404	BolC7t46363H	0	-	1005	1321	1900	0.6952631
C7	55960262	55962734	BolC7t46364H	0	-	959	2470	2472	0.9991909
C7	55968008	55969253	BolC7t46365H	0	-	1313	1243	1245	0.9983936
C7	55970771	55971923	BolC7t46366H	0	+	164	1062	1152	0.9218750
C7	55973493	55975256	BolC7t46367H	0	-	731	1495	1763	0.8479864
C7	55979820	55981459	BolC7t46368H	0	+	379	1433	1639	0.8743136
C7	55988450	55989818	BolC7t46369H	0	-	1536	1368	1368	1.0000000
C7	55991349	55993339	BolC7t46370H	0	-	1611	1990	1990	1.0000000
C7	55993401	55996133	BolC7t46371H	0	-	484	2493	2732	0.9125183
C7	55998535	56003165	BolC7t46372H	0	+	2909	4553	4630	0.9833694
C7	56003771	56005174	BolC7t46373H	0	-	638	1403	1403	1.0000000
C7	56006623	56010354	BolC7t46374H	0	-	1137	2685	3731	0.7196462
C7	56016039	56016273	BolC7t46375H	0	-	238	234	234	1.0000000
C7	56017733	56022010	BolC7t46376H	0	+	929	3655	4277	0.8545710
C7	56022644	56023889	BolC7t46377H	0	-	1692	1245	1245	1.0000000
C7	56025766	56029554	BolC7t46378H	0	+	2885	3788	3788	1.0000000
C7	56033183	56035829	BolC7t46379H	0	+	1816	2592	2646	0.9795918
C7	56041104	56041785	BolC7t46380H	0	+	387	681	681	1.0000000
C7	56046123	56046711	BolC7t46381H	0	-	10	295	588	0.5017007
C7	56057550	56058078	BolC7t46382H	0	+	129	433	528	0.8200758
C7	56061258	56062561	BolC7t46383H	0	+	522	1303	1303	1.0000000
C7	56064132	56065194	BolC7t46384H	0	+	1016	1012	1062	0.9529190
C7	56065768	56072102	BolC7t46385H	0	-	3680	6296	6334	0.9940006
C7	56076743	56078258	BolC7t46386H	0	-	1133	1477	1515	0.9749175
C7	56092883	56094104	BolC7t46387H	0	-	626	1208	1221	0.9893530
C7	56097268	56098898	BolC7t46388H	0	-	840	1586	1630	0.9730061
C7	56102222	56103655	BolC7t46389H	0	+	1436	1433	1433	1.0000000
C7	56107283	56108963	BolC7t46390H	0	+	342	1352	1680	0.8047619
C7	56112286	56112721	BolC7t46391H	0	-	133	418	435	0.9609196
C7	56115358	56117957	BolC7t46392H	0	-	121	1040	2599	0.4001539
C7	56122101	56124995	BolC7t46393H	0	-	1313	2771	2894	0.9574983
C7	56128613	56130759	BolC7t46394H	0	+	1997	2107	2146	0.9818267
C7	56131153	56133853	BolC7t46395H	0	-	545	2467	2700	0.9137037
C7	56137346	56139635	BolC7t46396H	0	-	552	2289	2289	1.0000000
C7	56147892	56149086	BolC7t46397H	0	+	467	1161	1194	0.9723618
C7	56150140	56152084	BolC7t46398H	0	+	895	1843	1944	0.9480453
C7	56152985	56167117	BolC7t46399H	0	-	5164	12107	14132	0.8567082
C7	56167120	56177800	BolC7t46400H	0	-	7317	10481	10680	0.9813671
C7	56179551	56181968	BolC7t46401H	0	-	326	1770	2417	0.7323128
C7	56182454	56183917	BolC7t46402H	0	-	1358	1463	1463	1.0000000
C7	56184681	56191280	BolC7t46403H	0	-	3015	6476	6599	0.9813608
C7	56191984	56192329	BolC7t46404H	0	+	163	345	345	1.0000000
C7	56192855	56194198	BolC7t46405H	0	-	679	1305	1343	0.9717051
C7	56195521	56197643	BolC7t46406H	0	+	1160	2006	2122	0.9453346
C7	56200171	56201471	BolC7t46407H	0	+	802	1300	1300	1.0000000
C7	56203155	56204768	BolC7t46408H	0	+	568	1502	1613	0.9311841
C7	56205316	56207922	BolC7t46409H	0	-	1182	2541	2606	0.9750575
C7	56209767	56212206	BolC7t46410H	0	+	381	1336	2439	0.5477655
C7	56214239	56215074	BolC7t46411H	0	-	87	751	835	0.8994012
C7	56217703	56218065	BolC7t46412H	0	-	224	362	362	1.0000000
C7	56219344	56219753	BolC7t46413H	0	+	49	388	409	0.9486552
C7	56222209	56222436	BolC7t46414H	0	+	331	227	227	1.0000000
C7	56227108	56228038	BolC7t46415H	0	+	581	930	930	1.0000000
C7	56231191	56233059	BolC7t46416H	0	+	841	1856	1868	0.9935760
C7	56233230	56234622	BolC7t46417H	0	-	437	1357	1392	0.9748563
C7	56235305	56235683	BolC7t46418H	0	-	224	378	378	1.0000000
C7	56237185	56239473	BolC7t46419H	0	-	1954	2175	2288	0.9506119
C7	56241935	56244106	BolC7t46420H	0	-	1150	2106	2171	0.9700599
C7	56249007	56250206	BolC7t46421H	0	-	923	1199	1199	1.0000000
C7	56252575	56255290	BolC7t46422H	0	+	227	1454	2715	0.5355433
C7	56256211	56257272	BolC7t46423H	0	-	69	509	1061	0.4797361
C7	56257570	56260992	BolC7t46424H	0	+	1769	3288	3422	0.9608416
C7	56262190	56267015	BolC7t46425H	0	+	2073	4190	4825	0.8683938
C7	56267595	56267959	BolC7t46426H	0	-	244	364	364	1.0000000
C7	56268670	56270114	BolC7t46427H	0	-	802	1283	1444	0.8885041
C7	56273667	56275627	BolC7t46428H	0	+	1170	1540	1960	0.7857143
C7	56279989	56280508	BolC7t46429H	0	+	306	519	519	1.0000000
C7	56283847	56285122	BolC7t46430H	0	+	495	1273	1275	0.9984314
C7	56285593	56287959	BolC7t46431H	0	-	1457	2366	2366	1.0000000
C7	56292983	56294351	BolC7t46432H	0	-	802	1354	1368	0.9897661
C7	56296095	56296896	BolC7t46433H	0	-	329	801	801	1.0000000
C7	56298963	56301305	BolC7t46434H	0	-	880	2264	2342	0.9666951
C7	56305898	56314179	BolC7t46435H	0	-	1041	3091	8281	0.3732641
C7	56315759	56316094	BolC7t46436H	0	-	0	0	335	0.0000000
C7	56318121	56318408	BolC7t46437H	0	+	2	76	287	0.2648084
C7	56329604	56338925	BolC7t46438H	0	-	647	3534	9321	0.3791439
C7	56331064	56331624	BolC7t46439H	0	-	11	390	560	0.6964286
C7	56333520	56335129	BolC7t46440H	0	+	10	264	1609	0.1640771
C7	56343283	56344878	BolC7t46441H	0	-	103	1061	1595	0.6652038
C7	56354032	56357902	BolC7t46442H	0	+	926	2997	3870	0.7744186
C7	56358507	56359632	BolC7t46443H	0	-	692	1125	1125	1.0000000
C7	56362788	56364408	BolC7t46444H	0	+	346	1364	1620	0.8419753
C7	56367787	56368126	BolC7t46445H	0	-	19	298	339	0.8790560
C7	56370629	56371819	BolC7t46446H	0	+	470	1150	1190	0.9663866
C7	56373884	56375878	BolC7t46447H	0	+	210	1583	1994	0.7938817
C7	56384165	56384363	BolC7t46448H	0	+	4	27	198	0.1363636
C7	56389141	56391559	BolC7t46449H	0	-	1371	1313	2418	0.5430108
C7	56392632	56393795	BolC7t46450H	0	-	999	1154	1163	0.9922614
C7	56395652	56396228	BolC7t46451H	0	-	161	576	576	1.0000000
C7	56403797	56405485	BolC7t46452H	0	+	1199	1688	1688	1.0000000
C7	56406101	56409272	BolC7t46453H	0	+	1904	3171	3171	1.0000000
C7	56410984	56412121	BolC7t46454H	0	+	223	912	1137	0.8021108
C7	56412852	56414745	BolC7t46455H	0	-	441	1745	1893	0.9218172
C7	56415073	56415289	BolC7t46456H	0	+	270	216	216	1.0000000
C7	56416223	56417296	BolC7t46457H	0	+	299	950	1073	0.8853681
C7	56418531	56420089	BolC7t46458H	0	+	1866	1558	1558	1.0000000
C7	56421022	56422908	BolC7t46459H	0	+	1218	1886	1886	1.0000000
C7	56423908	56425216	BolC7t46460H	0	+	517	1289	1308	0.9854740
C7	56434388	56435553	BolC7t46461H	0	-	233	856	1165	0.7347639
C7	56437383	56440001	BolC7t46462H	0	+	1923	2607	2618	0.9957983
C7	56440543	56441860	BolC7t46463H	0	-	609	1317	1317	1.0000000
C7	56444259	56444766	BolC7t46464H	0	+	0	0	507	0.0000000
C7	56447652	56448011	BolC7t46465H	0	+	94	359	359	1.0000000
C7	56449811	56450099	BolC7t46466H	0	+	55	271	288	0.9409722
C7	56450599	56451018	BolC7t46467H	0	-	26	341	419	0.8138425
C7	56451670	56452861	BolC7t46468H	0	+	1167	1189	1191	0.9983208
C7	56461692	56463878	BolC7t46469H	0	-	576	2033	2186	0.9300091
C7	56465095	56468195	BolC7t46470H	0	-	2528	3075	3100	0.9919355
C7	56471156	56472941	BolC7t46471H	0	-	334	1423	1785	0.7971989
C7	56476233	56476919	BolC7t46472H	0	-	2	128	686	0.1865889
C7	56501502	56503698	BolC7t46473H	0	+	251	911	2196	0.4148452
C7	56517842	56519189	BolC7t46474H	0	-	760	1347	1347	1.0000000
C7	56518083	56519016	BolC7t46475H	0	-	599	933	933	1.0000000
C7	56535909	56536351	BolC7t46476H	0	-	310	442	442	1.0000000
C7	56546680	56548070	BolC7t46477H	0	-	27	316	1390	0.2273381
C7	56554832	56554994	BolC7t46478H	0	+	209	162	162	1.0000000
C7	56558738	56559099	BolC7t46479H	0	+	183	361	361	1.0000000
C7	56563534	56563951	BolC7t46480H	0	-	414	417	417	1.0000000
C7	56564595	56565327	BolC7t46481H	0	-	24	443	732	0.6051912
C7	56580384	56581833	BolC7t46482H	0	+	546	1449	1449	1.0000000
C7	56583638	56584538	BolC7t46483H	0	+	1246	900	900	1.0000000
C7	56589643	56591156	BolC7t46484H	0	+	443	1299	1513	0.8585591
C7	56593304	56594774	BolC7t46485H	0	+	626	1470	1470	1.0000000
C7	56596323	56599792	BolC7t46486H	0	+	3979	3469	3469	1.0000000
C7	56600995	56602912	BolC7t46487H	0	+	1428	1890	1917	0.9859155
C7	56609274	56610096	BolC7t46488H	0	+	510	822	822	1.0000000
C7	56610411	56618849	BolC7t46489H	0	-	4696	8175	8438	0.9688315
C7	56619870	56621126	BolC7t46490H	0	-	1163	1256	1256	1.0000000
C7	56621297	56621522	BolC7t46491H	0	+	334	225	225	1.0000000
C7	56624103	56624772	BolC7t46492H	0	+	721	669	669	1.0000000
C7	56628540	56629093	BolC7t46493H	0	-	291	553	553	1.0000000
C7	56632842	56635635	BolC7t46494H	0	+	1602	2793	2793	1.0000000
C7	56636924	56637386	BolC7t46495H	0	+	13	131	462	0.2835498
C7	56650819	56651457	BolC7t46496H	0	+	19	217	638	0.3401254
C7	56651658	56657197	BolC7t46497H	0	-	2513	5193	5539	0.9375339
C7	56657365	56663117	BolC7t46498H	0	+	2157	5226	5752	0.9085535
C7	56664148	56665346	BolC7t46499H	0	+	1025	1198	1198	1.0000000
C7	56670324	56671195	BolC7t46500H	0	+	240	799	871	0.9173364
C7	56672532	56673674	BolC7t46501H	0	+	1538	1142	1142	1.0000000
C7	56677537	56679592	BolC7t46502H	0	-	699	1998	2055	0.9722628
C7	56687019	56688056	BolC7t46503H	0	-	1467	1037	1037	1.0000000
C7	56693722	56694046	BolC7t46504H	0	-	113	324	324	1.0000000
C7	56703288	56703606	BolC7t46505H	0	+	26	224	318	0.7044025
C7	56704042	56705115	BolC7t46506H	0	+	15	375	1073	0.3494874
C7	56709602	56715095	BolC7t46507H	0	+	1721	3461	5493	0.6300746
C7	56717285	56717582	BolC7t46508H	0	+	205	297	297	1.0000000
C7	56719300	56720779	BolC7t46509H	0	+	400	1172	1479	0.7924273
C7	56721211	56721654	BolC7t46510H	0	-	532	443	443	1.0000000
C7	56723916	56724513	BolC7t46511H	0	+	35	482	597	0.8073702
C7	56727115	56729419	BolC7t46512H	0	-	497	2107	2304	0.9144965
C7	56731863	56732758	BolC7t46513H	0	-	111	888	895	0.9921788
C7	56735391	56737404	BolC7t46514H	0	-	876	1506	2013	0.7481371
C7	56738061	56742001	BolC7t46515H	0	-	703	2983	3940	0.7571066
C7	56743682	56744066	BolC7t46516H	0	-	244	384	384	1.0000000
C7	56765236	56766023	BolC7t46517H	0	+	624	787	787	1.0000000
C7	56768389	56770591	BolC7t46518H	0	-	472	2029	2202	0.9214351
C7	56775977	56777368	BolC7t46519H	0	+	862	1356	1391	0.9748383
C7	56780257	56781484	BolC7t46520H	0	-	980	1227	1227	1.0000000
C7	56782054	56782265	BolC7t46521H	0	+	222	211	211	1.0000000
C7	56782321	56784475	BolC7t46522H	0	+	1738	2154	2154	1.0000000
C7	56784643	56786279	BolC7t46523H	0	+	1363	1636	1636	1.0000000
C7	56790842	56794227	BolC7t46524H	0	-	2146	3367	3385	0.9946824
C7	56795665	56797634	BolC7t46525H	0	-	1354	1753	1969	0.8902996
C7	56799770	56800232	BolC7t46526H	0	+	186	462	462	1.0000000
C7	56804665	56805952	BolC7t46527H	0	+	778	1180	1287	0.9168609
C7	56806564	56808329	BolC7t46528H	0	-	193	1347	1765	0.7631728
C7	56816584	56817358	BolC7t46529H	0	+	514	774	774	1.0000000
C7	56818314	56819071	BolC7t46530H	0	+	482	757	757	1.0000000
C7	56821599	56824565	BolC7t46531H	0	-	479	2645	2966	0.8917734
C7	56836112	56836985	BolC7t46532H	0	-	174	704	873	0.8064147
C7	56838585	56840271	BolC7t46533H	0	+	1164	1686	1686	1.0000000
C7	56840464	56840694	BolC7t46534H	0	+	434	230	230	1.0000000
C7	56843176	56843435	BolC7t46535H	0	-	322	259	259	1.0000000
C7	56843777	56846055	BolC7t46536H	0	+	645	1994	2278	0.8753293
C7	56858461	56859015	BolC7t46537H	0	+	226	511	554	0.9223827
C7	56862983	56863313	BolC7t46538H	0	+	395	330	330	1.0000000
C7	56865011	56866790	BolC7t46539H	0	+	620	1722	1779	0.9679595
C7	56874904	56876931	BolC7t46540H	0	+	1385	2027	2027	1.0000000
C7	56884493	56885066	BolC7t46541H	0	-	167	572	573	0.9982548
C7	56890724	56891195	BolC7t46542H	0	+	120	471	471	1.0000000
C7	56892532	56893003	BolC7t46543H	0	+	123	348	471	0.7388535
C7	56893952	56895547	BolC7t46544H	0	+	1051	1595	1595	1.0000000
C7	56896852	56897482	BolC7t46545H	0	+	466	630	630	1.0000000
C7	56899331	56900162	BolC7t46546H	0	-	862	831	831	1.0000000
C7	56902835	56908710	BolC7t46547H	0	+	4312	5875	5875	1.0000000
C7	56908939	56910192	BolC7t46548H	0	-	1752	1253	1253	1.0000000
C7	56910953	56912012	BolC7t46549H	0	-	557	988	1059	0.9329556
C7	56919053	56924233	BolC7t46550H	0	+	3149	5109	5180	0.9862934
C7	56924830	56927814	BolC7t46551H	0	-	2349	2984	2984	1.0000000
C7	56930114	56932375	BolC7t46552H	0	+	918	2083	2261	0.9212738
C7	56933117	56938561	BolC7t46553H	0	+	1692	3685	5444	0.6768920
C7	56943881	56946028	BolC7t46554H	0	+	1040	2102	2147	0.9790405
C7	56947749	56948589	BolC7t46555H	0	+	656	840	840	1.0000000
C7	56951319	56953464	BolC7t46556H	0	+	982	1833	2145	0.8545455
C7	56959071	56960298	BolC7t46557H	0	+	453	1171	1227	0.9543602
C7	56963465	56966634	BolC7t46558H	0	+	3278	2402	3169	0.7579678
C7	56967048	56967449	BolC7t46559H	0	-	379	401	401	1.0000000
C7	56971653	56971839	BolC7t46560H	0	+	107	186	186	1.0000000
C7	56972377	56975985	BolC7t46561H	0	-	2147	3514	3608	0.9739468
C7	56982889	56983824	BolC7t46562H	0	+	719	935	935	1.0000000
C7	56985024	56986154	BolC7t46563H	0	-	1030	1130	1130	1.0000000
C7	56986354	56986579	BolC7t46564H	0	-	289	225	225	1.0000000
C7	56988014	56990556	BolC7t46565H	0	+	2405	2542	2542	1.0000000
C7	56995906	56996950	BolC7t46566H	0	+	837	1044	1044	1.0000000
C7	56998318	56999082	BolC7t46567H	0	-	878	764	764	1.0000000
C7	56999639	57002001	BolC7t46568H	0	-	1446	2362	2362	1.0000000
C7	57005846	57006975	BolC7t46569H	0	+	356	1129	1129	1.0000000
C7	57007910	57009423	BolC7t46570H	0	+	1233	1436	1513	0.9491077
C7	57009803	57014255	BolC7t46571H	0	-	1468	3555	4452	0.7985175
C7	57016261	57017023	BolC7t46572H	0	-	306	762	762	1.0000000
C7	57020092	57022069	BolC7t46573H	0	-	280	1800	1977	0.9104704
C7	57025061	57025547	BolC7t46574H	0	-	80	486	486	1.0000000
C7	57028397	57029488	BolC7t46575H	0	+	405	1091	1091	1.0000000
C7	57029922	57032513	BolC7t46576H	0	-	3117	2591	2591	1.0000000
C7	57037053	57037353	BolC7t46577H	0	+	36	179	300	0.5966667
C7	57042133	57043402	BolC7t46578H	0	+	517	1254	1269	0.9881797
C7	57043945	57048398	BolC7t46579H	0	-	4142	4453	4453	1.0000000
C7	57048587	57052406	BolC7t46580H	0	+	3655	3819	3819	1.0000000
C7	57057855	57059766	BolC7t46581H	0	-	102	1172	1911	0.6132914
C7	57065775	57068547	BolC7t46582H	0	+	1380	2760	2772	0.9956710
C7	57075053	57077083	BolC7t46583H	0	-	91	830	2030	0.4088670
C7	57096992	57099234	BolC7t46584H	0	+	833	2046	2242	0.9125780
C7	57108394	57109738	BolC7t46585H	0	-	249	986	1344	0.7336310
C7	57117707	57119421	BolC7t46586H	0	-	306	1634	1714	0.9533256
C7	57117996	57118216	BolC7t46587H	0	-	141	220	220	1.0000000
C7	57120015	57121902	BolC7t46588H	0	-	131	1375	1887	0.7286698
C7	57123221	57123473	BolC7t46589H	0	-	194	252	252	1.0000000
C7	57124233	57124818	BolC7t46590H	0	-	364	585	585	1.0000000
C7	57126886	57131049	BolC7t46591H	0	-	2624	4163	4163	1.0000000
C7	57155689	57158639	BolC7t46592H	0	+	2115	2950	2950	1.0000000
C7	57159424	57160267	BolC7t46593H	0	+	888	843	843	1.0000000
C7	57161321	57161837	BolC7t46594H	0	-	228	516	516	1.0000000
C7	57162776	57164005	BolC7t46595H	0	-	395	1229	1229	1.0000000
C7	57165119	57167268	BolC7t46596H	0	-	2029	2149	2149	1.0000000
C7	57168932	57170596	BolC7t46597H	0	+	341	1195	1664	0.7181491
C7	57171098	57171467	BolC7t46598H	0	-	103	243	369	0.6585366
C7	57184357	57185437	BolC7t46599H	0	+	846	1066	1080	0.9870371
C7	57187597	57189279	BolC7t46600H	0	-	502	1634	1682	0.9714625
C7	57194128	57195064	BolC7t46601H	0	-	10	422	936	0.4508547
C7	57199907	57204110	BolC7t46602H	0	-	1080	3765	4203	0.8957887
C7	57204881	57206091	BolC7t46603H	0	-	141	775	1210	0.6404959
C7	57209435	57209672	BolC7t46604H	0	-	58	237	237	1.0000000
C7	57210227	57212236	BolC7t46605H	0	-	632	1619	2009	0.8058736
C7	57212539	57215704	BolC7t46606H	0	-	1834	2902	3165	0.9169036
C7	57219396	57220092	BolC7t46607H	0	-	425	696	696	1.0000000
C7	57220519	57220918	BolC7t46608H	0	+	302	399	399	1.0000000
C7	57226040	57227925	BolC7t46609H	0	-	383	1449	1885	0.7687002
C7	57231887	57233273	BolC7t46610H	0	+	1323	1386	1386	1.0000000
C7	57233490	57234955	BolC7t46611H	0	+	2887	1465	1465	1.0000000
C7	57236233	57238253	BolC7t46612H	0	-	1874	2020	2020	1.0000000
C7	57239601	57240068	BolC7t46613H	0	-	624	467	467	1.0000000
C7	57243425	57244921	BolC7t46614H	0	-	866	1315	1496	0.8790107
C7	57253903	57255175	BolC7t46615H	0	+	615	1272	1272	1.0000000
C7	57257784	57259302	BolC7t46616H	0	+	407	1491	1518	0.9822134
C7	57260494	57261796	BolC7t46617H	0	-	455	1110	1302	0.8525345
C7	57267808	57269367	BolC7t46618H	0	+	391	1423	1559	0.9127646
C7	57274529	57274955	BolC7t46619H	0	+	6	171	426	0.4014085
C7	57276897	57277215	BolC7t46620H	0	+	0	0	318	0.0000000
C7	57282599	57284413	BolC7t46621H	0	+	75	767	1814	0.4228225
C7	57294983	57295133	BolC7t46622H	0	+	30	150	150	1.0000000
C7	57297784	57298684	BolC7t46623H	0	+	456	832	900	0.9244444
C7	57302747	57303421	BolC7t46624H	0	-	594	674	674	1.0000000
C7	57308034	57308550	BolC7t46625H	0	-	120	451	516	0.8740310
C7	57310500	57311800	BolC7t46626H	0	-	614	1290	1300	0.9923077
C7	57313426	57314022	BolC7t46627H	0	+	942	596	596	1.0000000
C7	57315827	57316136	BolC7t46628H	0	-	833	309	309	1.0000000
C7	57317413	57321423	BolC7t46629H	0	-	4071	4008	4010	0.9995012
C7	57326953	57329171	BolC7t46630H	0	+	806	1903	2218	0.8579802
C7	57336190	57337324	BolC7t46631H	0	+	1627	1134	1134	1.0000000
C7	57338835	57341031	BolC7t46632H	0	+	1625	2160	2196	0.9836066
C7	57344846	57346972	BolC7t46633H	0	+	878	1654	2126	0.7779868
C7	57347672	57348256	BolC7t46634H	0	+	677	584	584	1.0000000
C7	57349823	57350741	BolC7t46635H	0	-	434	903	918	0.9836601
C7	57353954	57355384	BolC7t46636H	0	+	589	1428	1430	0.9986014
C7	57355588	57357492	BolC7t46637H	0	-	1237	1831	1904	0.9616597
C7	57362631	57364987	BolC7t46638H	0	+	417	1686	2356	0.7156197
C7	57366312	57367624	BolC7t46639H	0	-	618	1304	1312	0.9939024
C7	57369471	57370268	BolC7t46640H	0	+	574	797	797	1.0000000
C7	57371060	57373844	BolC7t46641H	0	-	1769	2784	2784	1.0000000
C7	57380697	57382873	BolC7t46642H	0	-	675	1744	2176	0.8014706
C7	57391342	57393394	BolC7t46643H	0	+	1766	2052	2052	1.0000000
C7	57394218	57394706	BolC7t46644H	0	-	73	368	488	0.7540984
C7	57400119	57400695	BolC7t46645H	0	-	334	576	576	1.0000000
C7	57443002	57443800	BolC7t46646H	0	+	300	693	798	0.8684211
C7	57445015	57445273	BolC7t46647H	0	-	151	258	258	1.0000000
C7	57450492	57450753	BolC7t46648H	0	+	2	96	261	0.3678161
C7	57451642	57452344	BolC7t46649H	0	+	605	702	702	1.0000000
C7	57453923	57456158	BolC7t46650H	0	-	643	1864	2235	0.8340045
C7	57457259	57460135	BolC7t46651H	0	-	700	2087	2876	0.7256606
C7	57461036	57463301	BolC7t46652H	0	-	534	2193	2265	0.9682119
C7	57463961	57464752	BolC7t46653H	0	-	390	791	791	1.0000000
C7	57467187	57468027	BolC7t46654H	0	-	822	840	840	1.0000000
C7	57475270	57480402	BolC7t46655H	0	-	4041	4824	5132	0.9399844
C7	57481702	57482746	BolC7t46656H	0	-	330	866	1044	0.8295019
C7	57490254	57491741	BolC7t46657H	0	+	1241	1480	1487	0.9952925
C7	57494699	57495204	BolC7t46658H	0	-	318	396	505	0.7841584
C7	57496936	57498064	BolC7t46659H	0	-	891	877	1128	0.7774823
C7	57514499	57516231	BolC7t46660H	0	+	148	1108	1732	0.6397229
C7	57518972	57520986	BolC7t46661H	0	-	1044	2014	2014	1.0000000
C7	57524422	57525402	BolC7t46662H	0	+	1649	980	980	1.0000000
C7	57525557	57527187	BolC7t46663H	0	-	691	1583	1630	0.9711657
C7	57536274	57536867	BolC7t46664H	0	+	698	593	593	1.0000000
C7	57537820	57538027	BolC7t46665H	0	+	585	207	207	1.0000000
C7	57544465	57546089	BolC7t46666H	0	+	610	1624	1624	1.0000000
C7	57548856	57553344	BolC7t46667H	0	-	1550	4340	4488	0.9670232
C7	57559455	57561054	BolC7t46668H	0	+	93	1021	1599	0.6385241
C7	57564126	57564633	BolC7t46669H	0	+	496	507	507	1.0000000
C7	57564695	57567144	BolC7t46670H	0	-	1388	2305	2449	0.9412005
C7	57570544	57572022	BolC7t46671H	0	+	319	1271	1478	0.8599459
C7	57576540	57577857	BolC7t46672H	0	+	100	619	1317	0.4700076
C7	57582082	57582532	BolC7t46673H	0	-	50	396	450	0.8800000
C7	57584376	57584721	BolC7t46674H	0	+	30	208	345	0.6028985
C7	57585170	57585523	BolC7t46675H	0	-	164	337	353	0.9546742
C7	57589437	57589788	BolC7t46676H	0	+	232	351	351	1.0000000
C7	57597079	57597190	BolC7t46677H	0	+	0	0	111	0.0000000
C7	57598626	57600579	BolC7t46678H	0	-	986	1866	1953	0.9554532
C7	57638999	57641439	BolC7t46679H	0	+	403	1448	2440	0.5934426
C7	57661132	57662378	BolC7t46680H	0	+	36	510	1246	0.4093098
C7	57674443	57675885	BolC7t46681H	0	-	110	1016	1442	0.7045770
C7	57681111	57681495	BolC7t46682H	0	-	356	384	384	1.0000000
C7	57684124	57687209	BolC7t46683H	0	-	1023	2872	3085	0.9309562
C7	57692627	57693483	BolC7t46684H	0	+	789	856	856	1.0000000
C7	57696093	57698228	BolC7t46685H	0	-	500	1624	2135	0.7606558
C7	57708763	57709013	BolC7t46686H	0	-	165	250	250	1.0000000
C7	57709095	57711075	BolC7t46687H	0	-	43	797	1980	0.4025252
C7	57712687	57713373	BolC7t46688H	0	-	460	686	686	1.0000000
C7	57717421	57718723	BolC7t46689H	0	-	99	652	1302	0.5007681
C7	57720007	57722399	BolC7t46690H	0	-	246	1391	2392	0.5815217
C7	57725421	57726818	BolC7t46691H	0	-	37	964	1397	0.6900501
C7	57727783	57728821	BolC7t46692H	0	-	738	1038	1038	1.0000000
C7	57729677	57730086	BolC7t46693H	0	-	54	392	409	0.9584352
C7	57732122	57733377	BolC7t46694H	0	-	331	1216	1255	0.9689243
C7	57734072	57734612	BolC7t46695H	0	-	348	540	540	1.0000000
C7	57735190	57737048	BolC7t46696H	0	-	2019	1858	1858	1.0000000
C7	57740572	57747130	BolC7t46697H	0	-	4397	6558	6558	1.0000000
C7	57748699	57749667	BolC7t46698H	0	-	124	792	968	0.8181818
C7	57754838	57755915	BolC7t46699H	0	+	114	822	1077	0.7632312
C7	57763579	57763963	BolC7t46700H	0	+	0	0	384	0.0000000
C7	57777402	57778019	BolC7t46701H	0	-	199	617	617	1.0000000
C7	57782969	57783197	BolC7t46702H	0	+	50	228	228	1.0000000
C7	57785212	57786235	BolC7t46703H	0	+	108	935	1023	0.9139785
C7	57790449	57792612	BolC7t46704H	0	-	138	1549	2163	0.7161350
C7	57802687	57803890	BolC7t46705H	0	+	0	0	1203	0.0000000
C7	57806053	57806556	BolC7t46706H	0	-	346	503	503	1.0000000
C7	57811043	57811853	BolC7t46707H	0	+	752	810	810	1.0000000
C7	57813861	57814683	BolC7t46708H	0	+	15	391	822	0.4756691
C7	57818440	57819249	BolC7t46709H	0	+	7	199	809	0.2459827
C7	57819842	57820314	BolC7t46710H	0	-	0	0	472	0.0000000
C7	57820478	57822765	BolC7t46711H	0	+	1554	2253	2287	0.9851333
C7	57829733	57833289	BolC7t46712H	0	+	1793	3010	3556	0.8464567
C7	57841058	57841742	BolC7t46713H	0	-	386	684	684	1.0000000
C7	57843583	57846028	BolC7t46714H	0	-	108	1465	2445	0.5991820
C7	57847243	57849816	BolC7t46715H	0	-	136	1509	2573	0.5864750
C7	57852881	57873486	BolC7t46716H	0	-	1094	6731	20605	0.3266683
C7	57858902	57859839	BolC7t46717H	0	-	4	109	937	0.1163287
C7	57861565	57862336	BolC7t46718H	0	-	2	19	771	0.0246433
C7	57874049	57874980	BolC7t46719H	0	+	757	931	931	1.0000000
C7	57875746	57876740	BolC7t46720H	0	+	208	954	994	0.9597586
C7	57877225	57879930	BolC7t46721H	0	+	1067	2247	2705	0.8306839
C7	57880443	57882810	BolC7t46722H	0	+	1718	2367	2367	1.0000000
C7	57883775	57885353	BolC7t46723H	0	+	570	1441	1578	0.9131812
C7	57887261	57895806	BolC7t46724H	0	+	985	3549	8545	0.4153306
C7	57897498	57899046	BolC7t46725H	0	-	91	953	1548	0.6156331
C7	57903235	57904768	BolC7t46726H	0	-	119	830	1533	0.5414221
C7	57915317	57916815	BolC7t46727H	0	-	141	691	1498	0.4612817
C7	57917703	57918993	BolC7t46728H	0	+	388	1138	1290	0.8821706
C7	57928212	57930871	BolC7t46729H	0	+	1821	2549	2659	0.9586310
C7	57935351	57936600	BolC7t46730H	0	-	50	618	1249	0.4947958
C7	57943440	57947031	BolC7t46731H	0	-	1251	3361	3591	0.9359510
C7	57959626	57960013	BolC7t46732H	0	+	272	387	387	1.0000000
C7	57960312	57961749	BolC7t46733H	0	-	613	1328	1437	0.9241475
C7	57962743	57963615	BolC7t46734H	0	-	856	872	872	1.0000000
C7	57964514	57964957	BolC7t46735H	0	-	303	443	443	1.0000000
C7	57965324	57968191	BolC7t46736H	0	-	442	2255	2867	0.7865365
C7	57969937	57971312	BolC7t46737H	0	+	1379	1375	1375	1.0000000
C7	57971997	57972438	BolC7t46738H	0	+	536	441	441	1.0000000
C7	57972692	57973128	BolC7t46739H	0	-	605	436	436	1.0000000
C7	57974112	57974864	BolC7t46740H	0	-	568	752	752	1.0000000
C7	57975699	57979623	BolC7t46741H	0	-	2093	3924	3924	1.0000000
C7	57982531	57983254	BolC7t46742H	0	-	663	723	723	1.0000000
C7	57985631	57986441	BolC7t46743H	0	+	548	810	810	1.0000000
C7	57989627	57990470	BolC7t46744H	0	+	521	843	843	1.0000000
C7	57990704	57993410	BolC7t46745H	0	-	2204	2706	2706	1.0000000
C7	57994597	57996220	BolC7t46746H	0	+	1112	1623	1623	1.0000000
C7	57997159	57999769	BolC7t46747H	0	+	172	2191	2610	0.8394636
C7	58007948	58014195	BolC7t46748H	0	-	414	3769	6247	0.6033296
C7	58026540	58027596	BolC7t46749H	0	+	381	1056	1056	1.0000000
C7	58029276	58029429	BolC7t46750H	0	+	106	153	153	1.0000000
C7	58032236	58032491	BolC7t46751H	0	-	115	255	255	1.0000000
C7	58034594	58036325	BolC7t46752H	0	+	168	1495	1731	0.8636626
C7	58036584	58038205	BolC7t46753H	0	-	753	1447	1621	0.8926588
C7	58043590	58046468	BolC7t46754H	0	+	555	2217	2878	0.7703266
C7	58047418	58055890	BolC7t46755H	0	+	920	4601	8472	0.5430831
C7	58056776	58057928	BolC7t46756H	0	+	352	1152	1152	1.0000000
C7	58062115	58064013	BolC7t46757H	0	-	1000	1436	1898	0.7565859
C7	58063281	58063482	BolC7t46758H	0	+	0	0	201	0.0000000
C7	58066447	58068151	BolC7t46759H	0	+	606	1704	1704	1.0000000
C7	58069915	58073288	BolC7t46760H	0	+	1830	3366	3373	0.9979247
C7	58073673	58074055	BolC7t46761H	0	+	270	382	382	1.0000000
C7	58074445	58075627	BolC7t46762H	0	-	474	1158	1182	0.9796954
C7	58076071	58077036	BolC7t46763H	0	-	539	965	965	1.0000000
C7	58077989	58078799	BolC7t46764H	0	+	62	498	810	0.6148148
C7	58082213	58083871	BolC7t46765H	0	+	1569	1658	1658	1.0000000
C7	58086371	58086686	BolC7t46766H	0	-	16	103	315	0.3269841
C7	58095826	58096070	BolC7t46767H	0	-	349	244	244	1.0000000
C7	58096935	58097217	BolC7t46768H	0	+	189	282	282	1.0000000
C7	58097391	58099932	BolC7t46769H	0	-	1423	2521	2541	0.9921291
C7	58102348	58105939	BolC7t46770H	0	+	957	3252	3591	0.9055973
C7	58106861	58107661	BolC7t46771H	0	+	475	800	800	1.0000000
C7	58108007	58109289	BolC7t46772H	0	-	865	1282	1282	1.0000000
C7	58111511	58121426	BolC7t46773H	0	+	1837	5881	9915	0.5931417
C7	58121901	58122420	BolC7t46774H	0	+	276	519	519	1.0000000
C7	58123071	58124985	BolC7t46775H	0	+	1703	1914	1914	1.0000000
C7	58136756	58137770	BolC7t46776H	0	-	51	734	1014	0.7238659
C7	58138090	58139482	BolC7t46777H	0	-	379	1083	1392	0.7780172
C7	58145730	58147217	BolC7t46778H	0	+	1180	1487	1487	1.0000000
C7	58147668	58152364	BolC7t46779H	0	-	1245	4048	4696	0.8620102
C7	58153265	58154398	BolC7t46780H	0	-	859	1133	1133	1.0000000
C7	58154961	58155724	BolC7t46781H	0	+	697	763	763	1.0000000
C7	58155901	58157538	BolC7t46782H	0	-	881	1637	1637	1.0000000
C7	58157883	58160132	BolC7t46783H	0	-	440	1974	2249	0.8777235
C7	58171718	58173218	BolC7t46784H	0	+	538	1500	1500	1.0000000
C7	58173531	58175604	BolC7t46785H	0	-	1427	2073	2073	1.0000000
C7	58176542	58182532	BolC7t46786H	0	-	2658	5144	5990	0.8587646
C7	58188284	58189239	BolC7t46787H	0	+	225	894	955	0.9361256
C7	58189548	58191940	BolC7t46788H	0	-	803	2317	2392	0.9686455
C7	58194521	58196661	BolC7t46789H	0	-	938	2047	2140	0.9565421
C7	58199010	58201519	BolC7t46790H	0	-	1061	2399	2509	0.9561578
C7	58220839	58223674	BolC7t46791H	0	-	1055	1840	2835	0.6490300
C7	58223905	58225011	BolC7t46792H	0	+	739	1106	1106	1.0000000
C7	58225222	58226554	BolC7t46793H	0	-	266	1325	1332	0.9947447
C7	58226941	58229881	BolC7t46794H	0	+	1014	2647	2940	0.9003401
C7	58230965	58232897	BolC7t46795H	0	+	262	1168	1932	0.6045549
C7	58233345	58235015	BolC7t46796H	0	-	485	1298	1670	0.7772455
C7	58235705	58242694	BolC7t46797H	0	-	464	2824	6989	0.4040635
C7	58244882	58248389	BolC7t46798H	0	+	47	609	3507	0.1736527
C7	58250113	58251396	BolC7t46799H	0	-	1800	1283	1283	1.0000000
C7	58252739	58253075	BolC7t46800H	0	+	1	104	336	0.3095238
C8	14332	14601	BolC8t46801H	0	+	512	269	269	1.0000000
C8	95905	96332	BolC8t46802H	0	-	14	214	427	0.5011709
C8	97900	98147	BolC8t46803H	0	-	13	172	247	0.6963563
C8	98172	98367	BolC8t46804H	0	-	2	50	195	0.2564103
C8	105390	106733	BolC8t46805H	0	+	92	975	1343	0.7259866
C8	111629	113968	BolC8t46806H	0	+	1058	2339	2339	1.0000000
C8	114483	115800	BolC8t46807H	0	-	14	341	1317	0.2589218
C8	125935	126322	BolC8t46808H	0	+	291	387	387	1.0000000
C8	147177	147372	BolC8t46809H	0	+	0	0	195	0.0000000
C8	147397	149812	BolC8t46810H	0	+	528	1920	2415	0.7950311
C8	163349	167959	BolC8t46811H	0	+	1702	4564	4610	0.9900217
C8	170604	180973	BolC8t46812H	0	-	5355	9092	10369	0.8768445
C8	182400	183994	BolC8t46813H	0	+	1589	1594	1594	1.0000000
C8	184954	210775	BolC8t46814H	0	-	5017	18391	25821	0.7122497
C8	190679	191075	BolC8t46815H	0	-	98	396	396	1.0000000
C8	212121	212343	BolC8t46816H	0	+	0	0	222	0.0000000
C8	214340	215807	BolC8t46817H	0	-	466	1454	1467	0.9911384
C8	216246	218428	BolC8t46818H	0	-	987	2182	2182	1.0000000
C8	221516	221777	BolC8t46819H	0	-	119	261	261	1.0000000
C8	270139	270466	BolC8t46820H	0	-	133	327	327	1.0000000
C8	275677	276853	BolC8t46821H	0	+	1444	1176	1176	1.0000000
C8	278231	278720	BolC8t46822H	0	+	589	489	489	1.0000000
C8	279810	280841	BolC8t46823H	0	-	716	1031	1031	1.0000000
C8	282129	282375	BolC8t46824H	0	-	268	246	246	1.0000000
C8	288168	289707	BolC8t46825H	0	-	107	991	1539	0.6439247
C8	299754	300591	BolC8t46826H	0	+	293	352	837	0.4205496
C8	315547	318016	BolC8t46827H	0	+	630	1890	2469	0.7654921
C8	318791	319729	BolC8t46828H	0	-	589	938	938	1.0000000
C8	341818	342550	BolC8t46829H	0	-	240	732	732	1.0000000
C8	342720	342849	BolC8t46830H	0	-	117	129	129	1.0000000
C8	351320	352871	BolC8t46831H	0	-	535	1260	1551	0.8123791
C8	353387	353870	BolC8t46832H	0	+	20	242	483	0.5010352
C8	355137	355503	BolC8t46833H	0	-	31	325	366	0.8879781
C8	356506	358551	BolC8t46834H	0	-	1342	2045	2045	1.0000000
C8	359047	359574	BolC8t46835H	0	-	476	527	527	1.0000000
C8	360138	362730	BolC8t46836H	0	-	2358	2592	2592	1.0000000
C8	364206	364714	BolC8t46837H	0	-	4	71	508	0.1397638
C8	367609	368344	BolC8t46838H	0	-	42	716	735	0.9741496
C8	375714	380693	BolC8t46839H	0	+	3628	4839	4979	0.9718819
C8	385346	389931	BolC8t46840H	0	+	1273	3767	4585	0.8215922
C8	390189	391905	BolC8t46841H	0	-	362	1162	1716	0.6771562
C8	392474	392660	BolC8t46842H	0	+	169	186	186	1.0000000
C8	392815	397158	BolC8t46843H	0	+	488	1852	4343	0.4264334
C8	400022	400757	BolC8t46844H	0	+	93	720	735	0.9795918
C8	408004	414052	BolC8t46845H	0	-	449	1413	6048	0.2336310
C8	418866	422872	BolC8t46846H	0	+	1400	3791	4006	0.9463305
C8	423163	423313	BolC8t46847H	0	-	93	150	150	1.0000000
C8	423359	423605	BolC8t46848H	0	+	92	246	246	1.0000000
C8	427674	430974	BolC8t46849H	0	-	249	2836	3300	0.8593940
C8	431761	433066	BolC8t46850H	0	-	156	1057	1305	0.8099617
C8	434904	435239	BolC8t46851H	0	-	348	335	335	1.0000000
C8	444846	447417	BolC8t46852H	0	+	1544	2523	2571	0.9813302
C8	447952	448939	BolC8t46853H	0	-	547	987	987	1.0000000
C8	449258	450530	BolC8t46854H	0	-	426	1272	1272	1.0000000
C8	489749	490028	BolC8t46855H	0	+	88	184	279	0.6594982
C8	498645	499833	BolC8t46856H	0	+	533	1188	1188	1.0000000
C8	547132	547850	BolC8t46857H	0	+	1	1	718	0.0013928
C8	561091	562017	BolC8t46858H	0	+	183	864	926	0.9330453
C8	565008	565317	BolC8t46859H	0	+	66	309	309	1.0000000
C8	570536	572284	BolC8t46860H	0	+	62	1418	1748	0.8112128
C8	577547	583729	BolC8t46861H	0	+	1332	5411	6182	0.8752831
C8	593089	594220	BolC8t46862H	0	+	73	731	1131	0.6463307
C8	603093	604383	BolC8t46863H	0	-	449	913	1290	0.7077519
C8	607494	608721	BolC8t46864H	0	-	546	1227	1227	1.0000000
C8	610820	612635	BolC8t46865H	0	+	705	1641	1815	0.9041322
C8	613500	614639	BolC8t46866H	0	-	898	1139	1139	1.0000000
C8	615626	617277	BolC8t46867H	0	-	406	1561	1651	0.9454876
C8	620493	621012	BolC8t46868H	0	+	184	519	519	1.0000000
C8	622056	623243	BolC8t46869H	0	+	152	669	1187	0.5636057
C8	655965	658003	BolC8t46870H	0	-	26	837	2038	0.4106968
C8	658804	660345	BolC8t46871H	0	+	608	1541	1541	1.0000000
C8	666435	666876	BolC8t46872H	0	-	825	441	441	1.0000000
C8	673001	673572	BolC8t46873H	0	-	116	571	571	1.0000000
C8	675584	677615	BolC8t46874H	0	-	158	1887	2031	0.9290990
C8	680587	681748	BolC8t46875H	0	+	1211	1161	1161	1.0000000
C8	689479	690136	BolC8t46876H	0	-	379	647	657	0.9847793
C8	696713	701807	BolC8t46877H	0	-	2677	4546	5094	0.8924224
C8	703672	704127	BolC8t46878H	0	+	1	74	455	0.1626374
C8	710056	711842	BolC8t46879H	0	-	335	1550	1786	0.8678612
C8	713974	716805	BolC8t46880H	0	-	583	2667	2831	0.9420699
C8	717015	718645	BolC8t46881H	0	+	410	1606	1630	0.9852761
C8	719133	720696	BolC8t46882H	0	+	244	1211	1563	0.7747921
C8	721752	750149	BolC8t46883H	0	-	4220	20098	28397	0.7077508
C8	767795	768353	BolC8t46884H	0	-	9	312	558	0.5591398
C8	770981	771608	BolC8t46885H	0	-	690	627	627	1.0000000
C8	772841	776201	BolC8t46886H	0	+	1771	3344	3360	0.9952381
C8	777285	778419	BolC8t46887H	0	-	70	688	1134	0.6067019
C8	778994	779234	BolC8t46888H	0	+	0	0	240	0.0000000
C8	780198	780318	BolC8t46889H	0	-	0	0	120	0.0000000
C8	780463	780577	BolC8t46890H	0	+	0	0	114	0.0000000
C8	787307	792077	BolC8t46891H	0	+	1035	4070	4770	0.8532495
C8	792913	797248	BolC8t46892H	0	-	1420	4029	4335	0.9294118
C8	798443	800642	BolC8t46893H	0	+	738	2182	2199	0.9922692
C8	806364	813646	BolC8t46894H	0	+	4363	7089	7282	0.9734963
C8	814143	814683	BolC8t46895H	0	-	186	376	540	0.6962963
C8	827761	827887	BolC8t46896H	0	-	99	126	126	1.0000000
C8	851044	852609	BolC8t46897H	0	+	93	965	1565	0.6166134
C8	857910	860075	BolC8t46898H	0	-	1225	2115	2165	0.9769053
C8	860874	864262	BolC8t46899H	0	-	3603	3248	3388	0.9586777
C8	871032	871667	BolC8t46900H	0	-	428	635	635	1.0000000
C8	872169	884134	BolC8t46901H	0	-	2346	9619	11965	0.8039281
C8	890222	891791	BolC8t46902H	0	-	936	1569	1569	1.0000000
C8	894861	895745	BolC8t46903H	0	-	498	884	884	1.0000000
C8	897633	899847	BolC8t46904H	0	-	3376	2214	2214	1.0000000
C8	902961	904214	BolC8t46905H	0	-	1260	1253	1253	1.0000000
C8	911384	912249	BolC8t46906H	0	+	220	865	865	1.0000000
C8	912800	914388	BolC8t46907H	0	+	440	1535	1588	0.9666247
C8	920179	920623	BolC8t46908H	0	-	115	219	444	0.4932432
C8	921026	922048	BolC8t46909H	0	-	390	875	1022	0.8561644
C8	927856	928261	BolC8t46910H	0	-	253	405	405	1.0000000
C8	929873	930592	BolC8t46911H	0	-	687	719	719	1.0000000
C8	930941	933482	BolC8t46912H	0	-	867	2455	2541	0.9661551
C8	947679	949450	BolC8t46913H	0	-	645	1636	1771	0.9237719
C8	952772	955598	BolC8t46914H	0	+	960	2783	2826	0.9847841
C8	956521	957013	BolC8t46915H	0	+	557	492	492	1.0000000
C8	958032	959005	BolC8t46916H	0	+	479	846	973	0.8694758
C8	960015	960905	BolC8t46917H	0	+	489	851	890	0.9561798
C8	961658	965062	BolC8t46918H	0	-	1682	2604	3404	0.7649824
C8	967459	968085	BolC8t46919H	0	+	565	626	626	1.0000000
C8	972431	972760	BolC8t46920H	0	+	12	256	329	0.7781155
C8	979155	1061913	BolC8t46921H	0	+	1462	15957	82758	0.1928152
C8	989251	990177	BolC8t46922H	0	+	29	522	926	0.5637149
C8	991579	992118	BolC8t46923H	0	-	9	196	539	0.3636364
C8	1008591	1010895	BolC8t46924H	0	+	16	523	2304	0.2269965
C8	1024244	1025207	BolC8t46925H	0	+	8	552	963	0.5732087
C8	1028518	1029225	BolC8t46926H	0	+	0	0	707	0.0000000
C8	1031396	1031932	BolC8t46927H	0	-	11	164	536	0.3059702
C8	1048426	1049351	BolC8t46928H	0	+	157	853	925	0.9221622
C8	1050748	1051287	BolC8t46929H	0	-	0	0	539	0.0000000
C8	1062656	1063597	BolC8t46930H	0	-	672	941	941	1.0000000
C8	1064110	1064284	BolC8t46931H	0	-	164	174	174	1.0000000
C8	1066869	1068034	BolC8t46932H	0	+	66	31	1165	0.0266094
C8	1078614	1081092	BolC8t46933H	0	-	565	2058	2478	0.8305085
C8	1082685	1103563	BolC8t46934H	0	+	7234	11477	20878	0.5497174
C8	1091013	1114254	BolC8t46935H	0	-	1587	9329	23241	0.4014027
C8	1099087	1099480	BolC8t46936H	0	-	15	393	393	1.0000000
C8	1104542	1104935	BolC8t46937H	0	-	12	224	393	0.5699745
C8	1107659	1108220	BolC8t46938H	0	+	0	0	561	0.0000000
C8	1118298	1118691	BolC8t46939H	0	-	49	373	393	0.9491094
C8	1122041	1122770	BolC8t46940H	0	+	123	590	729	0.8093278
C8	1123923	1124148	BolC8t46941H	0	-	3	26	225	0.1155556
C8	1126926	1127364	BolC8t46942H	0	+	0	0	438	0.0000000
C8	1144013	1148026	BolC8t46943H	0	-	2959	3728	4013	0.9289808
C8	1168218	1170570	BolC8t46944H	0	-	2062	2352	2352	1.0000000
C8	1168715	1169108	BolC8t46945H	0	-	214	393	393	1.0000000
C8	1172058	1175371	BolC8t46946H	0	-	1094	3204	3313	0.9670993
C8	1180262	1182175	BolC8t46947H	0	+	475	1746	1913	0.9127026
C8	1188740	1189013	BolC8t46948H	0	-	112	273	273	1.0000000
C8	1200677	1200968	BolC8t46949H	0	+	17	86	291	0.2955326
C8	1214303	1216307	BolC8t46950H	0	-	813	1896	2004	0.9461078
C8	1217091	1219503	BolC8t46951H	0	+	1206	2383	2412	0.9879768
C8	1224317	1224638	BolC8t46952H	0	-	201	321	321	1.0000000
C8	1225046	1230931	BolC8t46953H	0	-	3841	5885	5885	1.0000000
C8	1231636	1232693	BolC8t46954H	0	-	461	1057	1057	1.0000000
C8	1239022	1240716	BolC8t46955H	0	+	0	0	1694	0.0000000
C8	1251398	1252523	BolC8t46956H	0	-	621	1125	1125	1.0000000
C8	1253610	1259746	BolC8t46957H	0	-	2457	5922	6136	0.9651238
C8	1262922	1265952	BolC8t46958H	0	-	1925	2934	3030	0.9683169
C8	1266300	1269220	BolC8t46959H	0	-	910	2920	2920	1.0000000
C8	1270683	1272313	BolC8t46960H	0	-	883	1630	1630	1.0000000
C8	1276551	1279060	BolC8t46961H	0	-	1584	2506	2509	0.9988043
C8	1288647	1289014	BolC8t46962H	0	-	365	367	367	1.0000000
C8	1290136	1290967	BolC8t46963H	0	-	459	831	831	1.0000000
C8	1296574	1298176	BolC8t46964H	0	+	1177	1602	1602	1.0000000
C8	1298865	1304351	BolC8t46965H	0	-	5310	5486	5486	1.0000000
C8	1305697	1307830	BolC8t46966H	0	-	722	2007	2133	0.9409283
C8	1308504	1310826	BolC8t46967H	0	+	1524	2322	2322	1.0000000
C8	1312792	1314029	BolC8t46968H	0	+	949	1237	1237	1.0000000
C8	1314137	1314424	BolC8t46969H	0	+	342	287	287	1.0000000
C8	1326171	1328517	BolC8t46970H	0	-	543	2258	2346	0.9624894
C8	1336205	1336379	BolC8t46971H	0	+	11	111	174	0.6379310
C8	1336898	1339262	BolC8t46972H	0	-	1956	2364	2364	1.0000000
C8	1339762	1342106	BolC8t46973H	0	-	1274	2184	2344	0.9317406
C8	1345747	1347941	BolC8t46974H	0	+	2109	2194	2194	1.0000000
C8	1348225	1352272	BolC8t46975H	0	-	3534	4047	4047	1.0000000
C8	1353666	1354683	BolC8t46976H	0	-	509	980	1017	0.9636185
C8	1382133	1382854	BolC8t46977H	0	-	687	721	721	1.0000000
C8	1383679	1386638	BolC8t46978H	0	-	1221	2915	2959	0.9851301
C8	1403289	1403754	BolC8t46979H	0	-	16	256	465	0.5505376
C8	1403796	1404099	BolC8t46980H	0	-	12	219	303	0.7227723
C8	1405870	1407435	BolC8t46981H	0	+	90	1146	1565	0.7322684
C8	1418895	1428769	BolC8t46982H	0	-	1233	5950	9874	0.6025926
C8	1432015	1432702	BolC8t46983H	0	+	302	687	687	1.0000000
C8	1467148	1469294	BolC8t46984H	0	-	1525	2065	2146	0.9622554
C8	1470304	1473513	BolC8t46985H	0	-	1735	2951	3209	0.9196011
C8	1479479	1486024	BolC8t46986H	0	-	1279	5558	6545	0.8491979
C8	1492140	1493643	BolC8t46987H	0	-	222	1444	1503	0.9607452
C8	1499922	1502444	BolC8t46988H	0	-	1431	2370	2522	0.9397303
C8	1522822	1526358	BolC8t46989H	0	+	2203	3421	3536	0.9674774
C8	1527017	1530752	BolC8t46990H	0	-	2055	3441	3735	0.9212852
C8	1535239	1535708	BolC8t46991H	0	+	256	469	469	1.0000000
C8	1536219	1536636	BolC8t46992H	0	+	261	417	417	1.0000000
C8	1537802	1539216	BolC8t46993H	0	-	734	1414	1414	1.0000000
C8	1540265	1541592	BolC8t46994H	0	+	568	1058	1327	0.7972871
C8	1542242	1543621	BolC8t46995H	0	-	260	889	1379	0.6446701
C8	1546879	1569239	BolC8t46996H	0	+	2667	6696	22360	0.2994633
C8	1571290	1571407	BolC8t46997H	0	+	4	99	117	0.8461539
C8	1574353	1575997	BolC8t46998H	0	+	343	1451	1644	0.8826034
C8	1577443	1582530	BolC8t46999H	0	+	1974	4502	5087	0.8850010
C8	1582701	1599299	BolC8t47000H	0	-	1029	5166	16598	0.3112423
C8	1616765	1623919	BolC8t47001H	0	-	4653	6871	7154	0.9604417
C8	1634014	1636802	BolC8t47002H	0	-	937	2650	2788	0.9505022
C8	1640601	1653407	BolC8t47003H	0	-	3745	7567	12806	0.5908949
C8	1650992	1651391	BolC8t47004H	0	-	330	399	399	1.0000000
C8	1668734	1670532	BolC8t47005H	0	-	1512	1798	1798	1.0000000
C8	1675641	1679169	BolC8t47006H	0	+	227	1357	3528	0.3846372
C8	1676729	1677549	BolC8t47007H	0	+	35	478	820	0.5829268
C8	1679246	1682651	BolC8t47008H	0	+	2261	3405	3405	1.0000000
C8	1696608	1696801	BolC8t47009H	0	+	120	193	193	1.0000000
C8	1709413	1710848	BolC8t47010H	0	+	209	1268	1435	0.8836237
C8	1711439	1715347	BolC8t47011H	0	+	2743	3908	3908	1.0000000
C8	1731254	1732040	BolC8t47012H	0	+	741	786	786	1.0000000
C8	1732596	1733883	BolC8t47013H	0	-	1275	1287	1287	1.0000000
C8	1734079	1735591	BolC8t47014H	0	+	813	1512	1512	1.0000000
C8	1737364	1741202	BolC8t47015H	0	+	3307	3838	3838	1.0000000
C8	1742233	1745010	BolC8t47016H	0	+	1371	2777	2777	1.0000000
C8	1757972	1758287	BolC8t47017H	0	-	2	181	315	0.5746032
C8	1763325	1764905	BolC8t47018H	0	-	755	1580	1580	1.0000000
C8	1766149	1767406	BolC8t47019H	0	+	571	1257	1257	1.0000000
C8	1768033	1771706	BolC8t47020H	0	+	2605	3673	3673	1.0000000
C8	1775015	1776230	BolC8t47021H	0	+	307	1106	1215	0.9102881
C8	1776763	1781625	BolC8t47022H	0	-	1915	4773	4862	0.9816948
C8	1784475	1785902	BolC8t47023H	0	-	26	814	1427	0.5704275
C8	1790598	1791054	BolC8t47024H	0	+	101	456	456	1.0000000
C8	1792329	1792661	BolC8t47025H	0	+	348	332	332	1.0000000
C8	1795369	1796575	BolC8t47026H	0	-	504	639	1206	0.5298507
C8	1802258	1804413	BolC8t47027H	0	+	1220	2155	2155	1.0000000
C8	1804622	1805542	BolC8t47028H	0	-	258	869	920	0.9445652
C8	1812885	1814203	BolC8t47029H	0	+	639	1310	1318	0.9939302
C8	1814860	1816355	BolC8t47030H	0	-	1104	1495	1495	1.0000000
C8	1818370	1819947	BolC8t47031H	0	+	782	1559	1577	0.9885859
C8	1820213	1822152	BolC8t47032H	0	-	1072	1939	1939	1.0000000
C8	1826417	1827709	BolC8t47033H	0	+	804	1292	1292	1.0000000
C8	1828620	1832462	BolC8t47034H	0	+	1047	2730	3842	0.7105674
C8	1833998	1836496	BolC8t47035H	0	+	1407	2475	2498	0.9907926
C8	1837529	1839507	BolC8t47036H	0	+	1326	1863	1978	0.9418604
C8	1839819	1841663	BolC8t47037H	0	-	580	1600	1844	0.8676789
C8	1841895	1843179	BolC8t47038H	0	+	1045	1165	1284	0.9073209
C8	1843774	1844392	BolC8t47039H	0	-	790	618	618	1.0000000
C8	1845427	1846114	BolC8t47040H	0	+	370	687	687	1.0000000
C8	1847829	1850455	BolC8t47041H	0	+	165	1123	2626	0.4276466
C8	1849128	1849276	BolC8t47042H	0	+	0	0	148	0.0000000
C8	1849423	1850070	BolC8t47043H	0	+	55	440	647	0.6800618
C8	1855391	1856153	BolC8t47044H	0	-	407	762	762	1.0000000
C8	1873449	1874948	BolC8t47045H	0	-	1011	1499	1499	1.0000000
C8	1896013	1896922	BolC8t47046H	0	-	0	0	909	0.0000000
C8	1898138	1899336	BolC8t47047H	0	-	403	1192	1198	0.9949917
C8	1906180	1906444	BolC8t47048H	0	-	219	264	264	1.0000000
C8	1907483	1909326	BolC8t47049H	0	-	910	1826	1843	0.9907759
C8	1924247	1925941	BolC8t47050H	0	-	747	1550	1694	0.9149941
C8	1928030	1930755	BolC8t47051H	0	+	442	2202	2725	0.8080734
C8	1931263	1933885	BolC8t47052H	0	-	856	2215	2622	0.8447750
C8	1935585	1946083	BolC8t47053H	0	-	1444	3989	10498	0.3799771
C8	1947510	1950320	BolC8t47054H	0	+	1373	2804	2810	0.9978648
C8	1952701	1952968	BolC8t47055H	0	-	8	163	267	0.6104869
C8	1956318	1957358	BolC8t47056H	0	-	32	829	1040	0.7971154
C8	1958319	1960277	BolC8t47057H	0	-	372	1659	1958	0.8472931
C8	1962208	1963740	BolC8t47058H	0	-	252	1343	1532	0.8766319
C8	1965560	1966894	BolC8t47059H	0	-	1020	1334	1334	1.0000000
C8	1976236	1978676	BolC8t47060H	0	-	1074	2440	2440	1.0000000
C8	1979604	1983336	BolC8t47061H	0	+	2185	3611	3732	0.9675777
C8	1984230	1986713	BolC8t47062H	0	-	628	2295	2483	0.9242851
C8	1987290	1988485	BolC8t47063H	0	+	480	1187	1195	0.9933054
C8	1988968	1991581	BolC8t47064H	0	-	2167	2481	2613	0.9494833
C8	1991915	1993133	BolC8t47065H	0	+	879	1218	1218	1.0000000
C8	1994537	1995918	BolC8t47066H	0	+	447	1381	1381	1.0000000
C8	1996764	1998923	BolC8t47067H	0	-	1078	2070	2159	0.9587772
C8	1999899	2000812	BolC8t47068H	0	-	1356	913	913	1.0000000
C8	2002625	2013291	BolC8t47069H	0	-	3524	8853	10666	0.8300206
C8	2017202	2020599	BolC8t47070H	0	+	719	3208	3397	0.9443627
C8	2027429	2028597	BolC8t47071H	0	-	174	1168	1168	1.0000000
C8	2049426	2049933	BolC8t47072H	0	-	268	507	507	1.0000000
C8	2060814	2061598	BolC8t47073H	0	+	0	0	784	0.0000000
C8	2063934	2064617	BolC8t47074H	0	-	687	683	683	1.0000000
C8	2072564	2073262	BolC8t47075H	0	-	218	632	698	0.9054441
C8	2074582	2076285	BolC8t47076H	0	+	751	1576	1703	0.9254257
C8	2077917	2083153	BolC8t47077H	0	-	1632	4501	5236	0.8596257
C8	2085354	2085762	BolC8t47078H	0	-	0	0	408	0.0000000
C8	2086519	2086672	BolC8t47079H	0	-	3	13	153	0.0849673
C8	2087562	2088558	BolC8t47080H	0	+	494	996	996	1.0000000
C8	2091445	2091904	BolC8t47081H	0	+	1611	459	459	1.0000000
C8	2095018	2096590	BolC8t47082H	0	-	1263	1572	1572	1.0000000
C8	2106868	2109160	BolC8t47083H	0	+	2	43	2292	0.0187609
C8	2118041	2120458	BolC8t47084H	0	-	1731	2388	2417	0.9880016
C8	2137922	2140184	BolC8t47085H	0	+	1050	2151	2262	0.9509284
C8	2146400	2146532	BolC8t47086H	0	-	230	132	132	1.0000000
C8	2153682	2154453	BolC8t47087H	0	-	128	665	771	0.8625162
C8	2155211	2155364	BolC8t47088H	0	-	0	0	153	0.0000000
C8	2156350	2156827	BolC8t47089H	0	+	427	477	477	1.0000000
C8	2157802	2158099	BolC8t47090H	0	-	482	297	297	1.0000000
C8	2166641	2166959	BolC8t47091H	0	-	74	277	318	0.8710692
C8	2168638	2170066	BolC8t47092H	0	-	1659	1428	1428	1.0000000
C8	2189426	2189963	BolC8t47093H	0	+	343	537	537	1.0000000
C8	2192960	2193209	BolC8t47094H	0	-	91	249	249	1.0000000
C8	2195284	2197739	BolC8t47095H	0	+	1582	2455	2455	1.0000000
C8	2204086	2206646	BolC8t47096H	0	+	898	2482	2560	0.9695312
C8	2207654	2209827	BolC8t47097H	0	+	707	2145	2173	0.9871146
C8	2210326	2212932	BolC8t47098H	0	-	1008	2512	2606	0.9639294
C8	2216924	2217134	BolC8t47099H	0	+	192	210	210	1.0000000
C8	2217409	2220965	BolC8t47100H	0	-	1918	3534	3556	0.9938133
C8	2221633	2223176	BolC8t47101H	0	+	570	1523	1543	0.9870383
C8	2223931	2226093	BolC8t47102H	0	+	1337	2115	2162	0.9782609
C8	2231288	2232260	BolC8t47103H	0	+	521	972	972	1.0000000
C8	2232478	2245632	BolC8t47104H	0	-	2172	11886	13154	0.9036035
C8	2256385	2257734	BolC8t47105H	0	-	842	1349	1349	1.0000000
C8	2283039	2285381	BolC8t47106H	0	+	1796	2342	2342	1.0000000
C8	2285660	2285931	BolC8t47107H	0	-	562	271	271	1.0000000
C8	2288019	2288368	BolC8t47108H	0	+	29	186	349	0.5329513
C8	2302065	2307173	BolC8t47109H	0	-	2967	4810	5108	0.9416602
C8	2320509	2322747	BolC8t47110H	0	-	850	2238	2238	1.0000000
C8	2324340	2326848	BolC8t47111H	0	-	437	2335	2508	0.9310207
C8	2327734	2329068	BolC8t47112H	0	+	349	1040	1334	0.7796102
C8	2330739	2337650	BolC8t47113H	0	+	5065	6786	6911	0.9819129
C8	2343928	2344733	BolC8t47114H	0	+	622	805	805	1.0000000
C8	2359607	2368238	BolC8t47115H	0	-	4884	7995	8631	0.9263121
C8	2370754	2371162	BolC8t47116H	0	-	113	408	408	1.0000000
C8	2371863	2372420	BolC8t47117H	0	+	82	540	557	0.9694794
C8	2372527	2372848	BolC8t47118H	0	-	63	321	321	1.0000000
C8	2374752	2376727	BolC8t47119H	0	-	1519	1975	1975	1.0000000
C8	2377716	2379429	BolC8t47120H	0	-	222	1435	1713	0.8377116
C8	2382697	2384736	BolC8t47121H	0	+	1286	2034	2039	0.9975478
C8	2387606	2388253	BolC8t47122H	0	-	358	647	647	1.0000000
C8	2391967	2393586	BolC8t47123H	0	-	136	1003	1619	0.6195182
C8	2427265	2428165	BolC8t47124H	0	-	513	900	900	1.0000000
C8	2441108	2442370	BolC8t47125H	0	-	665	1262	1262	1.0000000
C8	2443532	2444126	BolC8t47126H	0	+	505	594	594	1.0000000
C8	2452346	2453519	BolC8t47127H	0	+	666	1173	1173	1.0000000
C8	2454398	2454716	BolC8t47128H	0	-	10	267	318	0.8396226
C8	2460955	2461249	BolC8t47129H	0	-	142	294	294	1.0000000
C8	2488296	2490209	BolC8t47130H	0	+	1808	1913	1913	1.0000000
C8	2490716	2491842	BolC8t47131H	0	+	889	1126	1126	1.0000000
C8	2492573	2494409	BolC8t47132H	0	+	1156	1836	1836	1.0000000
C8	2497212	2498265	BolC8t47133H	0	+	19	498	1053	0.4729345
C8	2504282	2504393	BolC8t47134H	0	-	189	111	111	1.0000000
C8	2506137	2508095	BolC8t47135H	0	+	554	1540	1958	0.7865168
C8	2509569	2510424	BolC8t47136H	0	-	147	849	855	0.9929824
C8	2514002	2516796	BolC8t47137H	0	-	3177	2793	2794	0.9996421
C8	2519034	2519346	BolC8t47138H	0	-	129	312	312	1.0000000
C8	2520420	2520967	BolC8t47139H	0	-	655	547	547	1.0000000
C8	2520912	2522084	BolC8t47140H	0	-	465	1092	1172	0.9317406
C8	2522342	2523592	BolC8t47141H	0	-	639	1250	1250	1.0000000
C8	2526305	2526521	BolC8t47142H	0	+	0	0	216	0.0000000
C8	2532059	2532356	BolC8t47143H	0	+	10	297	297	1.0000000
C8	2539622	2539745	BolC8t47144H	0	+	177	123	123	1.0000000
C8	2542843	2543605	BolC8t47145H	0	+	126	731	762	0.9593176
C8	2547405	2549544	BolC8t47146H	0	+	1333	2139	2139	1.0000000
C8	2550531	2555583	BolC8t47147H	0	+	1635	4326	5052	0.8562945
C8	2555858	2557148	BolC8t47148H	0	-	1295	1290	1290	1.0000000
C8	2565591	2568793	BolC8t47149H	0	-	1714	3123	3202	0.9753279
C8	2581867	2582221	BolC8t47150H	0	+	385	354	354	1.0000000
C8	2589555	2590599	BolC8t47151H	0	+	78	1036	1044	0.9923372
C8	2593392	2593515	BolC8t47152H	0	+	87	121	123	0.9837399
C8	2595776	2596319	BolC8t47153H	0	-	349	543	543	1.0000000
C8	2597076	2597779	BolC8t47154H	0	-	916	703	703	1.0000000
C8	2603903	2604191	BolC8t47155H	0	+	38	269	288	0.9340278
C8	2606553	2607183	BolC8t47156H	0	-	81	360	630	0.5714286
C8	2609574	2609898	BolC8t47157H	0	-	115	324	324	1.0000000
C8	2611712	2614053	BolC8t47158H	0	-	916	2293	2341	0.9794959
C8	2617328	2620363	BolC8t47159H	0	-	1276	3005	3035	0.9901153
C8	2621122	2622735	BolC8t47160H	0	-	258	1426	1613	0.8840669
C8	2624894	2629971	BolC8t47161H	0	-	372	2368	5077	0.4664172
C8	2627145	2628170	BolC8t47162H	0	+	0	0	1025	0.0000000
C8	2632688	2633919	BolC8t47163H	0	+	652	1231	1231	1.0000000
C8	2636146	2638147	BolC8t47164H	0	+	1969	1979	2001	0.9890055
C8	2655047	2656395	BolC8t47165H	0	-	498	1348	1348	1.0000000
C8	2659311	2660018	BolC8t47166H	0	+	576	707	707	1.0000000
C8	2660497	2660830	BolC8t47167H	0	+	258	333	333	1.0000000
C8	2661660	2661999	BolC8t47168H	0	+	156	339	339	1.0000000
C8	2667293	2667626	BolC8t47169H	0	-	285	333	333	1.0000000
C8	2673066	2673468	BolC8t47170H	0	-	95	402	402	1.0000000
C8	2713078	2716045	BolC8t47171H	0	-	716	1994	2967	0.6720593
C8	2744993	2745760	BolC8t47172H	0	+	61	636	767	0.8292047
C8	2746668	2748285	BolC8t47173H	0	-	261	1617	1617	1.0000000
C8	2753117	2754280	BolC8t47174H	0	+	2	135	1163	0.1160791
C8	2757178	2757550	BolC8t47175H	0	-	4	137	372	0.3682796
C8	2759458	2759761	BolC8t47176H	0	+	16	240	303	0.7920792
C8	2769475	2770547	BolC8t47177H	0	-	101	936	1072	0.8731343
C8	2773225	2773666	BolC8t47178H	0	+	423	441	441	1.0000000
C8	2778177	2778534	BolC8t47179H	0	+	158	357	357	1.0000000
C8	2783398	2784463	BolC8t47180H	0	+	314	667	1065	0.6262911
C8	2789576	2789799	BolC8t47181H	0	+	106	223	223	1.0000000
C8	2797415	2797787	BolC8t47182H	0	-	248	372	372	1.0000000
C8	2800018	2804125	BolC8t47183H	0	-	1887	3807	4107	0.9269540
C8	2811427	2813755	BolC8t47184H	0	-	583	2175	2328	0.9342784
C8	2828314	2845479	BolC8t47185H	0	+	4666	15640	17165	0.9111564
C8	2846935	2848794	BolC8t47186H	0	-	1011	1828	1859	0.9833243
C8	2857521	2858793	BolC8t47187H	0	-	72	686	1272	0.5393082
C8	2887518	2887848	BolC8t47188H	0	-	0	0	330	0.0000000
C8	2909706	2910513	BolC8t47189H	0	+	43	468	807	0.5799257
C8	2912917	2915663	BolC8t47190H	0	-	382	1825	2746	0.6646031
C8	2933498	2933654	BolC8t47191H	0	+	10	20	156	0.1282051
C8	2938316	2940253	BolC8t47192H	0	-	502	1567	1937	0.8089830
C8	2960114	2960364	BolC8t47193H	0	+	127	250	250	1.0000000
C8	2960914	2961686	BolC8t47194H	0	+	239	770	772	0.9974093
C8	2961940	2963084	BolC8t47195H	0	+	498	1144	1144	1.0000000
C8	2973930	2975086	BolC8t47196H	0	+	462	1156	1156	1.0000000
C8	3010239	3010669	BolC8t47197H	0	-	0	0	430	0.0000000
C8	3025828	3026110	BolC8t47198H	0	+	44	282	282	1.0000000
C8	3027871	3031248	BolC8t47199H	0	+	11	82	3377	0.0242819
C8	3032703	3034024	BolC8t47200H	0	+	8	20	1321	0.0151400
C8	3038489	3039105	BolC8t47201H	0	-	337	334	616	0.5422078
C8	3048828	3049020	BolC8t47202H	0	+	1	116	192	0.6041667
C8	3160206	3162444	BolC8t47203H	0	+	424	1570	2238	0.7015192
C8	3164714	3166737	BolC8t47204H	0	+	373	1561	2023	0.7716263
C8	3168162	3168777	BolC8t47205H	0	-	49	602	615	0.9788618
C8	3170137	3170983	BolC8t47206H	0	-	1467	750	846	0.8865248
C8	3185028	3185721	BolC8t47207H	0	+	0	0	693	0.0000000
C8	3213969	3214125	BolC8t47208H	0	-	0	0	156	0.0000000
C8	3215570	3215864	BolC8t47209H	0	-	1	53	294	0.1802721
C8	3234410	3235061	BolC8t47210H	0	+	2	147	651	0.2258064
C8	3236697	3237036	BolC8t47211H	0	-	4	133	339	0.3923304
C8	3245266	3245588	BolC8t47212H	0	-	0	0	322	0.0000000
C8	3259489	3262277	BolC8t47213H	0	-	483	980	2788	0.3515064
C8	3260319	3260664	BolC8t47214H	0	+	365	345	345	1.0000000
C8	3268041	3268281	BolC8t47215H	0	-	0	0	240	0.0000000
C8	3269736	3270647	BolC8t47216H	0	-	145	465	911	0.5104281
C8	3274961	3275719	BolC8t47217H	0	-	65	319	758	0.4208443
C8	3280409	3281309	BolC8t47218H	0	-	88	732	900	0.8133333
C8	3319367	3319634	BolC8t47219H	0	-	373	267	267	1.0000000
C8	3320461	3321865	BolC8t47220H	0	-	524	1337	1404	0.9522792
C8	3332276	3333243	BolC8t47221H	0	+	12	61	967	0.0630817
C8	3341965	3342614	BolC8t47222H	0	+	16	528	649	0.8135593
C8	3385620	3386677	BolC8t47223H	0	+	763	1057	1057	1.0000000
C8	3394589	3395201	BolC8t47224H	0	+	160	469	612	0.7663399
C8	3395854	3396243	BolC8t47225H	0	-	241	388	389	0.9974293
C8	3397675	3399994	BolC8t47226H	0	-	877	2201	2319	0.9491160
C8	3416313	3416841	BolC8t47227H	0	+	1198	528	528	1.0000000
C8	3429714	3430512	BolC8t47228H	0	-	4	369	798	0.4624060
C8	3450033	3451098	BolC8t47229H	0	-	1	75	1065	0.0704225
C8	3489119	3489983	BolC8t47230H	0	-	972	864	864	1.0000000
C8	3497502	3497857	BolC8t47231H	0	+	39	274	355	0.7718310
C8	3502215	3503975	BolC8t47232H	0	-	170	1368	1760	0.7772727
C8	3504842	3506217	BolC8t47233H	0	-	458	1082	1375	0.7869091
C8	3511945	3512065	BolC8t47234H	0	-	3	69	120	0.5750000
C8	3513552	3513786	BolC8t47235H	0	-	83	234	234	1.0000000
C8	3531923	3532484	BolC8t47236H	0	+	1838	561	561	1.0000000
C8	3548897	3559543	BolC8t47237H	0	+	3803	10431	10646	0.9798046
C8	3566820	3567954	BolC8t47238H	0	-	32	603	1134	0.5317460
C8	3569754	3570114	BolC8t47239H	0	-	356	360	360	1.0000000
C8	3595260	3598880	BolC8t47240H	0	-	166	2033	3620	0.5616022
C8	3614723	3616194	BolC8t47241H	0	+	119	1320	1471	0.8973488
C8	3618216	3618873	BolC8t47242H	0	-	28	588	657	0.8949772
C8	3619941	3620980	BolC8t47243H	0	-	157	844	1039	0.8123195
C8	3638690	3639984	BolC8t47244H	0	+	602	1294	1294	1.0000000
C8	3652637	3652980	BolC8t47245H	0	-	286	343	343	1.0000000
C8	3659250	3660987	BolC8t47246H	0	-	152	1216	1737	0.7000576
C8	3672004	3673340	BolC8t47247H	0	+	691	1336	1336	1.0000000
C8	3686115	3686463	BolC8t47248H	0	-	52	232	348	0.6666667
C8	3737076	3737358	BolC8t47249H	0	+	19	248	282	0.8794326
C8	3742413	3743165	BolC8t47250H	0	+	480	752	752	1.0000000
C8	3744927	3745029	BolC8t47251H	0	+	0	0	102	0.0000000
C8	3745371	3746512	BolC8t47252H	0	+	14	510	1141	0.4469763
C8	3766364	3770368	BolC8t47253H	0	+	315	2488	4004	0.6213786
C8	3771455	3772465	BolC8t47254H	0	-	92	655	1010	0.6485149
C8	3795209	3795506	BolC8t47255H	0	+	27	223	297	0.7508417
C8	3834291	3834753	BolC8t47256H	0	+	0	0	462	0.0000000
C8	3835695	3836118	BolC8t47257H	0	-	1	104	423	0.2458629
C8	3845956	3848815	BolC8t47258H	0	+	1058	2120	2859	0.7415180
C8	3857150	3858113	BolC8t47259H	0	-	62	829	963	0.8608515
C8	3860147	3863082	BolC8t47260H	0	-	896	2271	2935	0.7737649
C8	3866547	3867564	BolC8t47261H	0	+	205	983	1017	0.9665684
C8	3868243	3871304	BolC8t47262H	0	-	1156	3012	3061	0.9839922
C8	3918204	3918547	BolC8t47263H	0	-	181	343	343	1.0000000
C8	3935435	3935760	BolC8t47264H	0	+	93	325	325	1.0000000
C8	3941456	3944242	BolC8t47265H	0	+	1677	2527	2786	0.9070352
C8	3951122	3952634	BolC8t47266H	0	-	303	1225	1512	0.8101852
C8	3968293	3968654	BolC8t47267H	0	+	278	361	361	1.0000000
C8	3980445	3980925	BolC8t47268H	0	-	43	480	480	1.0000000
C8	3987353	3987787	BolC8t47269H	0	-	0	0	434	0.0000000
C8	4002943	4003135	BolC8t47270H	0	-	153	192	192	1.0000000
C8	4012926	4013163	BolC8t47271H	0	+	291	237	237	1.0000000
C8	4016642	4020177	BolC8t47272H	0	+	1680	3099	3535	0.8766620
C8	4028004	4031353	BolC8t47273H	0	+	1685	3279	3349	0.9790983
C8	4031899	4032489	BolC8t47274H	0	-	405	590	590	1.0000000
C8	4042736	4043852	BolC8t47275H	0	+	326	1105	1116	0.9901434
C8	4067558	4067852	BolC8t47276H	0	-	4	16	294	0.0544218
C8	4070412	4071689	BolC8t47277H	0	-	1607	1277	1277	1.0000000
C8	4079309	4079696	BolC8t47278H	0	-	31	155	387	0.4005168
C8	4086368	4088501	BolC8t47279H	0	+	1627	1977	2133	0.9268636
C8	4106035	4107156	BolC8t47280H	0	-	187	853	1121	0.7609277
C8	4115336	4115528	BolC8t47281H	0	+	106	192	192	1.0000000
C8	4118110	4122656	BolC8t47282H	0	+	2760	4221	4546	0.9285086
C8	4125219	4125324	BolC8t47283H	0	-	2	94	105	0.8952381
C8	4145580	4145727	BolC8t47284H	0	-	146	147	147	1.0000000
C8	4150994	4151162	BolC8t47285H	0	-	186	168	168	1.0000000
C8	4158341	4159620	BolC8t47286H	0	+	340	1246	1279	0.9741986
C8	4161489	4161729	BolC8t47287H	0	+	229	240	240	1.0000000
C8	4176819	4177200	BolC8t47288H	0	-	386	381	381	1.0000000
C8	4182857	4183394	BolC8t47289H	0	+	341	537	537	1.0000000
C8	4192434	4193264	BolC8t47290H	0	+	516	830	830	1.0000000
C8	4206556	4207336	BolC8t47291H	0	-	95	703	780	0.9012821
C8	4209963	4210068	BolC8t47292H	0	-	0	0	105	0.0000000
C8	4219591	4219942	BolC8t47293H	0	+	299	351	351	1.0000000
C8	4236054	4237639	BolC8t47294H	0	-	942	1585	1585	1.0000000
C8	4237707	4239045	BolC8t47295H	0	-	788	1338	1338	1.0000000
C8	4242029	4242410	BolC8t47296H	0	-	14	248	381	0.6509187
C8	4246309	4246591	BolC8t47297H	0	-	243	282	282	1.0000000
C8	4247283	4247694	BolC8t47298H	0	-	222	411	411	1.0000000
C8	4255800	4256918	BolC8t47299H	0	+	1161	1118	1118	1.0000000
C8	4261297	4262361	BolC8t47300H	0	+	1028	1064	1064	1.0000000
C8	4274540	4275130	BolC8t47301H	0	+	471	590	590	1.0000000
C8	4328736	4329472	BolC8t47302H	0	-	570	718	736	0.9755435
C8	4362431	4362695	BolC8t47303H	0	+	119	264	264	1.0000000
C8	4363879	4365248	BolC8t47304H	0	+	545	1369	1369	1.0000000
C8	4365632	4366753	BolC8t47305H	0	+	453	1121	1121	1.0000000
C8	4408155	4408395	BolC8t47306H	0	-	209	240	240	1.0000000
C8	4410176	4410506	BolC8t47307H	0	-	295	330	330	1.0000000
C8	4427501	4433690	BolC8t47308H	0	+	1163	4673	6189	0.7550493
C8	4473742	4475181	BolC8t47309H	0	-	234	1045	1439	0.7261987
C8	4476002	4478682	BolC8t47310H	0	-	98	1834	2680	0.6843284
C8	4498869	4499067	BolC8t47311H	0	-	282	198	198	1.0000000
C8	4500496	4501577	BolC8t47312H	0	-	738	1081	1081	1.0000000
C8	4502059	4505581	BolC8t47313H	0	+	2306	3396	3522	0.9642249
C8	4520362	4525430	BolC8t47314H	0	+	472	3393	5068	0.6694949
C8	4532460	4532769	BolC8t47315H	0	-	0	0	309	0.0000000
C8	4536644	4537053	BolC8t47316H	0	-	1	41	409	0.1002445
C8	4539378	4539666	BolC8t47317H	0	-	10	238	288	0.8263889
C8	4542776	4543130	BolC8t47318H	0	-	22	316	354	0.8926554
C8	4544374	4545808	BolC8t47319H	0	-	456	1260	1434	0.8786611
C8	4546054	4546553	BolC8t47320H	0	-	105	492	499	0.9859719
C8	4564060	4565040	BolC8t47321H	0	+	700	980	980	1.0000000
C8	4566356	4567990	BolC8t47322H	0	+	1020	1634	1634	1.0000000
C8	4568330	4570962	BolC8t47323H	0	-	160	1681	2632	0.6386778
C8	4571988	4576104	BolC8t47324H	0	-	2032	3960	4116	0.9620991
C8	4576599	4577458	BolC8t47325H	0	-	417	859	859	1.0000000
C8	4577852	4578236	BolC8t47326H	0	-	609	384	384	1.0000000
C8	4628818	4629496	BolC8t47327H	0	+	192	678	678	1.0000000
C8	4630000	4630387	BolC8t47328H	0	+	102	387	387	1.0000000
C8	4631167	4631470	BolC8t47329H	0	+	137	303	303	1.0000000
C8	4644995	4645211	BolC8t47330H	0	-	96	216	216	1.0000000
C8	4645594	4645924	BolC8t47331H	0	-	220	330	330	1.0000000
C8	4653991	4655000	BolC8t47332H	0	-	214	904	1009	0.8959365
C8	4654099	4654706	BolC8t47333H	0	-	139	563	607	0.9275123
C8	4660492	4661039	BolC8t47334H	0	+	117	547	547	1.0000000
C8	4662549	4663229	BolC8t47335H	0	+	53	207	680	0.3044118
C8	4664956	4666610	BolC8t47336H	0	+	2	19	1654	0.0114873
C8	4695916	4696149	BolC8t47337H	0	-	66	233	233	1.0000000
C8	4720674	4721823	BolC8t47338H	0	-	299	1121	1149	0.9756310
C8	4722662	4722938	BolC8t47339H	0	+	30	245	276	0.8876812
C8	4751731	4752217	BolC8t47340H	0	-	316	486	486	1.0000000
C8	4753506	4754832	BolC8t47341H	0	+	724	1326	1326	1.0000000
C8	4780766	4780871	BolC8t47342H	0	+	142	105	105	1.0000000
C8	4812732	4812930	BolC8t47343H	0	+	35	198	198	1.0000000
C8	4825668	4831214	BolC8t47344H	0	+	3607	5533	5546	0.9976560
C8	4832138	4833352	BolC8t47345H	0	-	1643	1214	1214	1.0000000
C8	4833553	4835061	BolC8t47346H	0	+	978	1508	1508	1.0000000
C8	4837126	4837871	BolC8t47347H	0	-	804	745	745	1.0000000
C8	4862159	4863091	BolC8t47348H	0	+	52	36	932	0.0386266
C8	4867392	4869783	BolC8t47349H	0	-	27	473	2391	0.1978252
C8	4874242	4874431	BolC8t47350H	0	+	63	189	189	1.0000000
C8	4892477	4894411	BolC8t47351H	0	-	256	1677	1934	0.8671148
C8	4900626	4901032	BolC8t47352H	0	+	109	372	406	0.9162561
C8	4902992	4903651	BolC8t47353H	0	+	26	484	659	0.7344461
C8	4903704	4904430	BolC8t47354H	0	+	302	726	726	1.0000000
C8	4904880	4908037	BolC8t47355H	0	-	1279	3064	3157	0.9705417
C8	4918534	4919769	BolC8t47356H	0	+	625	1235	1235	1.0000000
C8	4921966	4923109	BolC8t47357H	0	-	115	640	1143	0.5599300
C8	4923752	4924861	BolC8t47358H	0	-	549	1086	1109	0.9792606
C8	4926064	4927394	BolC8t47359H	0	+	405	1330	1330	1.0000000
C8	4927733	4928182	BolC8t47360H	0	-	163	430	449	0.9576837
C8	4930779	4931754	BolC8t47361H	0	-	842	975	975	1.0000000
C8	4933144	4933540	BolC8t47362H	0	-	364	396	396	1.0000000
C8	4952657	4953394	BolC8t47363H	0	-	713	737	737	1.0000000
C8	4954836	4955065	BolC8t47364H	0	-	82	229	229	1.0000000
C8	4955450	4955552	BolC8t47365H	0	+	0	0	102	0.0000000
C8	4959140	4959293	BolC8t47366H	0	+	0	0	153	0.0000000
C8	4961781	4963072	BolC8t47367H	0	-	42	758	1291	0.5871418
C8	4963169	4963339	BolC8t47368H	0	-	1	67	170	0.3941177
C8	4963735	4964059	BolC8t47369H	0	-	13	324	324	1.0000000
C8	4975757	4976087	BolC8t47370H	0	+	196	330	330	1.0000000
C8	4977201	4977516	BolC8t47371H	0	+	32	129	315	0.4095238
C8	5000102	5024132	BolC8t47372H	0	+	525	6893	24030	0.2868498
C8	5025390	5026160	BolC8t47373H	0	-	76	611	770	0.7935065
C8	5026351	5026654	BolC8t47374H	0	-	11	167	303	0.5511551
C8	5118977	5122263	BolC8t47375H	0	-	344	2046	3286	0.6226415
C8	5129596	5130130	BolC8t47376H	0	+	38	201	534	0.3764045
C8	5138352	5138713	BolC8t47377H	0	+	22	163	361	0.4515235
C8	5138850	5154346	BolC8t47378H	0	-	2003	4469	15496	0.2883970
C8	5176340	5176553	BolC8t47379H	0	+	215	213	213	1.0000000
C8	5190100	5190346	BolC8t47380H	0	+	1	77	246	0.3130081
C8	5190759	5191406	BolC8t47381H	0	-	803	647	647	1.0000000
C8	5191850	5192545	BolC8t47382H	0	-	657	695	695	1.0000000
C8	5193477	5194318	BolC8t47383H	0	-	3	216	841	0.2568371
C8	5194846	5195154	BolC8t47384H	0	-	48	216	308	0.7012987
C8	5199581	5199999	BolC8t47385H	0	+	49	344	418	0.8229665
C8	5208555	5209793	BolC8t47386H	0	-	0	0	1238	0.0000000
C8	5211511	5212544	BolC8t47387H	0	+	22	418	1033	0.4046467
C8	5231498	5231717	BolC8t47388H	0	-	94	219	219	1.0000000
C8	5232877	5233357	BolC8t47389H	0	-	0	0	480	0.0000000
C8	5233896	5234206	BolC8t47390H	0	-	41	300	310	0.9677419
C8	5255859	5256470	BolC8t47391H	0	-	15	483	611	0.7905074
C8	5277747	5277909	BolC8t47392H	0	-	55	155	162	0.9567901
C8	5297134	5321097	BolC8t47393H	0	+	5648	12803	23963	0.5342820
C8	5317696	5318176	BolC8t47394H	0	-	0	0	480	0.0000000
C8	5322290	5322572	BolC8t47395H	0	-	20	252	282	0.8936170
C8	5326421	5327935	BolC8t47396H	0	+	527	1514	1514	1.0000000
C8	5352054	5353506	BolC8t47397H	0	-	244	1203	1452	0.8285124
C8	5360823	5361144	BolC8t47398H	0	+	414	321	321	1.0000000
C8	5373475	5375893	BolC8t47399H	0	-	128	1277	2418	0.5281224
C8	5406827	5407316	BolC8t47400H	0	-	332	489	489	1.0000000
C8	5407397	5409170	BolC8t47401H	0	-	1094	1773	1773	1.0000000
C8	5419605	5420850	BolC8t47402H	0	+	312	1162	1245	0.9333333
C8	5435840	5436474	BolC8t47403H	0	-	945	634	634	1.0000000
C8	5479968	5480648	BolC8t47404H	0	-	432	680	680	1.0000000
C8	5485101	5486870	BolC8t47405H	0	-	525	1423	1769	0.8044093
C8	5502144	5504339	BolC8t47406H	0	-	1171	2183	2195	0.9945330
C8	5508059	5509303	BolC8t47407H	0	+	18	392	1244	0.3151125
C8	5532920	5534013	BolC8t47408H	0	+	113	692	1093	0.6331199
C8	5534199	5534946	BolC8t47409H	0	-	329	747	747	1.0000000
C8	5536044	5536173	BolC8t47410H	0	+	29	129	129	1.0000000
C8	5537182	5539252	BolC8t47411H	0	-	851	2070	2070	1.0000000
C8	5540534	5541474	BolC8t47412H	0	+	370	940	940	1.0000000
C8	5544974	5545394	BolC8t47413H	0	+	27	349	420	0.8309524
C8	5547140	5547544	BolC8t47414H	0	-	62	350	404	0.8663366
C8	5548623	5548963	BolC8t47415H	0	-	46	340	340	1.0000000
C8	5550903	5551213	BolC8t47416H	0	-	12	225	310	0.7258065
C8	5551687	5552064	BolC8t47417H	0	-	50	377	377	1.0000000
C8	5552209	5552656	BolC8t47418H	0	-	34	141	447	0.3154362
C8	5567391	5569073	BolC8t47419H	0	-	583	1575	1682	0.9363853
C8	5583870	5586098	BolC8t47420H	0	-	56	926	2228	0.4156194
C8	5589130	5589717	BolC8t47421H	0	-	49	471	587	0.8023850
C8	5600450	5602854	BolC8t47422H	0	+	210	1416	2404	0.5890183
C8	5611603	5614923	BolC8t47423H	0	-	368	2271	3320	0.6840361
C8	5615546	5657513	BolC8t47424H	0	-	14963	21750	41967	0.5182644
C8	5660353	5660557	BolC8t47425H	0	-	3	153	204	0.7500000
C8	5683599	5683899	BolC8t47426H	0	+	122	300	300	1.0000000
C8	5685469	5685838	BolC8t47427H	0	+	8	37	369	0.1002710
C8	5686146	5686284	BolC8t47428H	0	+	18	98	138	0.7101449
C8	5694746	5695327	BolC8t47429H	0	+	47	220	581	0.3786575
C8	5831081	5831702	BolC8t47430H	0	-	7	359	621	0.5780998
C8	5857708	5857912	BolC8t47431H	0	+	2	134	204	0.6568627
C8	5859312	5865602	BolC8t47432H	0	+	1410	5193	6290	0.8255962
C8	5863390	5864199	BolC8t47433H	0	-	325	809	809	1.0000000
C8	5871520	5872759	BolC8t47434H	0	-	0	0	1239	0.0000000
C8	5874725	5874958	BolC8t47435H	0	+	0	0	233	0.0000000
C8	5890643	5890934	BolC8t47436H	0	+	158	291	291	1.0000000
C8	5926785	5927840	BolC8t47437H	0	-	57	411	1055	0.3895735
C8	5930207	5930823	BolC8t47438H	0	+	0	0	616	0.0000000
C8	5948631	5949090	BolC8t47439H	0	+	423	459	459	1.0000000
C8	5973404	5974067	BolC8t47440H	0	+	118	663	663	1.0000000
C8	5982296	5983812	BolC8t47441H	0	-	4	281	1516	0.1853562
C8	6005846	6006215	BolC8t47442H	0	+	92	369	369	1.0000000
C8	6008102	6018857	BolC8t47443H	0	+	958	4292	10755	0.3990702
C8	6020065	6020341	BolC8t47444H	0	+	60	276	276	1.0000000
C8	6028212	6028491	BolC8t47445H	0	+	25	233	279	0.8351254
C8	6031237	6031786	BolC8t47446H	0	+	17	180	549	0.3278688
C8	6054534	6055150	BolC8t47447H	0	-	0	0	616	0.0000000
C8	6057714	6057982	BolC8t47448H	0	+	0	0	268	0.0000000
C8	6059081	6059651	BolC8t47449H	0	+	127	570	570	1.0000000
C8	6120355	6120688	BolC8t47450H	0	-	6	64	333	0.1921922
C8	6146081	6146361	BolC8t47451H	0	+	9	178	280	0.6357143
C8	6152828	6153939	BolC8t47452H	0	-	0	0	1111	0.0000000
C8	6156034	6156269	BolC8t47453H	0	+	2	93	235	0.3957447
C8	6187921	6188050	BolC8t47454H	0	-	313	129	129	1.0000000
C8	6228407	6228857	BolC8t47455H	0	+	1	110	450	0.2444444
C8	6239848	6240789	BolC8t47456H	0	-	54	786	941	0.8352816
C8	6246048	6246895	BolC8t47457H	0	+	0	0	847	0.0000000
C8	6263625	6264783	BolC8t47458H	0	-	24	546	1158	0.4715026
C8	6273326	6273806	BolC8t47459H	0	+	0	0	480	0.0000000
C8	6292592	6304509	BolC8t47460H	0	-	5692	7180	11917	0.6025006
C8	6304693	6305437	BolC8t47461H	0	-	202	651	744	0.8750000
C8	6305896	6306529	BolC8t47462H	0	-	44	401	633	0.6334913
C8	6328669	6333856	BolC8t47463H	0	+	1281	5144	5187	0.9917101
C8	6370807	6371083	BolC8t47464H	0	-	0	0	276	0.0000000
C8	6383317	6384841	BolC8t47465H	0	-	290	1508	1524	0.9895013
C8	6386052	6405931	BolC8t47466H	0	-	4784	19673	19879	0.9896373
C8	6422872	6423148	BolC8t47467H	0	-	0	0	276	0.0000000
C8	6448206	6449187	BolC8t47468H	0	-	531	981	981	1.0000000
C8	6483804	6484203	BolC8t47469H	0	-	164	325	399	0.8145363
C8	6484717	6485669	BolC8t47470H	0	-	465	952	952	1.0000000
C8	6504975	6506454	BolC8t47471H	0	-	228	834	1479	0.5638945
C8	6508495	6509714	BolC8t47472H	0	+	187	633	1219	0.5192781
C8	6509679	6510235	BolC8t47473H	0	+	22	491	556	0.8830935
C8	6511228	6511591	BolC8t47474H	0	+	60	363	363	1.0000000
C8	6523281	6524995	BolC8t47475H	0	+	300	1344	1714	0.7841307
C8	6525350	6528016	BolC8t47476H	0	-	1718	2646	2666	0.9924981
C8	6532806	6532980	BolC8t47477H	0	+	280	174	174	1.0000000
C8	6566963	6567089	BolC8t47478H	0	-	89	126	126	1.0000000
C8	6569342	6569654	BolC8t47479H	0	+	471	312	312	1.0000000
C8	6572611	6578428	BolC8t47480H	0	+	1409	5300	5817	0.9111226
C8	6607199	6607364	BolC8t47481H	0	-	276	165	165	1.0000000
C8	6631037	6631961	BolC8t47482H	0	-	739	924	924	1.0000000
C8	6636168	6636809	BolC8t47483H	0	+	278	547	641	0.8533542
C8	6647178	6651199	BolC8t47484H	0	-	362	2994	4021	0.7445909
C8	6662942	6664972	BolC8t47485H	0	+	175	1364	2030	0.6719212
C8	6672497	6673907	BolC8t47486H	0	+	288	1301	1410	0.9226950
C8	6675079	6675683	BolC8t47487H	0	-	417	590	604	0.9768212
C8	6680262	6680649	BolC8t47488H	0	-	536	387	387	1.0000000
C8	6686547	6687044	BolC8t47489H	0	+	59	354	497	0.7122737
C8	6687484	6688419	BolC8t47490H	0	-	538	906	935	0.9689839
C8	6699066	6701264	BolC8t47491H	0	-	213	1442	2198	0.6560510
C8	6703186	6704597	BolC8t47492H	0	-	263	1006	1411	0.7129695
C8	6719968	6720166	BolC8t47493H	0	+	2	168	198	0.8484849
C8	6737354	6738971	BolC8t47494H	0	+	423	1533	1617	0.9480519
C8	6739285	6740825	BolC8t47495H	0	-	1523	1540	1540	1.0000000
C8	6744082	6746077	BolC8t47496H	0	-	469	1748	1995	0.8761905
C8	6754466	6756301	BolC8t47497H	0	+	1000	1797	1835	0.9792916
C8	6757290	6758901	BolC8t47498H	0	-	454	1598	1611	0.9919305
C8	6773848	6775824	BolC8t47499H	0	+	202	1312	1976	0.6639676
C8	6776218	6777889	BolC8t47500H	0	-	616	1631	1671	0.9760622
C8	6784002	6785796	BolC8t47501H	0	-	507	1622	1794	0.9041249
C8	6789393	6797056	BolC8t47502H	0	+	2321	7497	7663	0.9783375
C8	6823278	6823812	BolC8t47503H	0	+	100	414	534	0.7752809
C8	6839743	6839995	BolC8t47504H	0	-	168	252	252	1.0000000
C8	6843126	6843960	BolC8t47505H	0	-	1295	834	834	1.0000000
C8	6844192	6853971	BolC8t47506H	0	-	2444	6212	9779	0.6352388
C8	6856678	6857008	BolC8t47507H	0	+	115	330	330	1.0000000
C8	6900758	6902826	BolC8t47508H	0	+	430	1886	2068	0.9119923
C8	6911978	6912440	BolC8t47509H	0	-	2	118	462	0.2554113
C8	6912468	6912836	BolC8t47510H	0	-	0	0	368	0.0000000
C8	6955235	6956615	BolC8t47511H	0	-	693	1380	1380	1.0000000
C8	6974908	6975376	BolC8t47512H	0	+	17	366	468	0.7820513
C8	6981426	6982524	BolC8t47513H	0	+	240	1098	1098	1.0000000
C8	6989936	6991779	BolC8t47514H	0	-	272	1591	1843	0.8632664
C8	7030226	7030934	BolC8t47515H	0	-	11	576	708	0.8135593
C8	7033232	7034799	BolC8t47516H	0	-	124	864	1567	0.5513721
C8	7038631	7038805	BolC8t47517H	0	+	23	145	174	0.8333333
C8	7119863	7120903	BolC8t47518H	0	+	36	563	1040	0.5413461
C8	7191349	7192457	BolC8t47519H	0	-	67	662	1108	0.5974729
C8	7219156	7219578	BolC8t47520H	0	+	6	86	422	0.2037915
C8	7222506	7223379	BolC8t47521H	0	+	820	873	873	1.0000000
C8	7224262	7224505	BolC8t47522H	0	-	196	243	243	1.0000000
C8	7245158	7245281	BolC8t47523H	0	-	21	119	123	0.9674796
C8	7258218	7259973	BolC8t47524H	0	+	91	1218	1755	0.6940171
C8	7260068	7265971	BolC8t47525H	0	+	524	3831	5903	0.6489921
C8	7278390	7281169	BolC8t47526H	0	+	1629	2779	2779	1.0000000
C8	7285305	7287370	BolC8t47527H	0	-	310	1337	2065	0.6474576
C8	7297876	7299668	BolC8t47528H	0	-	258	1496	1792	0.8348214
C8	7328514	7328646	BolC8t47529H	0	+	20	132	132	1.0000000
C8	7332915	7333410	BolC8t47530H	0	+	335	495	495	1.0000000
C8	7337662	7341547	BolC8t47531H	0	+	744	3032	3885	0.7804376
C8	7341688	7342865	BolC8t47532H	0	-	113	853	1177	0.7247239
C8	7348046	7349216	BolC8t47533H	0	-	890	1170	1170	1.0000000
C8	7349856	7351020	BolC8t47534H	0	+	513	1007	1164	0.8651203
C8	7356941	7361047	BolC8t47535H	0	+	589	3219	4106	0.7839746
C8	7376048	7380867	BolC8t47536H	0	-	2710	4713	4819	0.9780037
C8	7424157	7428720	BolC8t47537H	0	-	1773	4530	4563	0.9927679
C8	7431446	7431822	BolC8t47538H	0	-	21	281	376	0.7473404
C8	7434112	7436851	BolC8t47539H	0	-	831	1683	2739	0.6144578
C8	7459732	7464899	BolC8t47540H	0	+	1170	4018	5167	0.7776272
C8	7475696	7476797	BolC8t47541H	0	+	129	727	1101	0.6603088
C8	7477780	7478167	BolC8t47542H	0	+	258	387	387	1.0000000
C8	7499853	7500762	BolC8t47543H	0	+	84	755	909	0.8305830
C8	7504117	7505142	BolC8t47544H	0	+	119	734	1025	0.7160975
C8	7514081	7518636	BolC8t47545H	0	+	924	3116	4555	0.6840834
C8	7523373	7523475	BolC8t47546H	0	+	73	102	102	1.0000000
C8	7562924	7563272	BolC8t47547H	0	+	329	348	348	1.0000000
C8	7569501	7570135	BolC8t47548H	0	-	2	160	634	0.2523659
C8	7587221	7587761	BolC8t47549H	0	+	439	540	540	1.0000000
C8	7589234	7597995	BolC8t47550H	0	-	1338	5785	8761	0.6603128
C8	7602398	7602943	BolC8t47551H	0	-	329	545	545	1.0000000
C8	7609181	7610810	BolC8t47552H	0	-	81	870	1629	0.5340700
C8	7611017	7614169	BolC8t47553H	0	-	528	2356	3152	0.7474619
C8	7621573	7626917	BolC8t47554H	0	+	909	3700	5344	0.6923653
C8	7622686	7623001	BolC8t47555H	0	+	131	315	315	1.0000000
C8	7631714	7635871	BolC8t47556H	0	-	893	2399	4157	0.5770988
C8	7647690	7649729	BolC8t47557H	0	-	238	1597	2039	0.7832271
C8	7650958	7652514	BolC8t47558H	0	+	373	1556	1556	1.0000000
C8	7683803	7683962	BolC8t47559H	0	-	339	159	159	1.0000000
C8	7699587	7702623	BolC8t47560H	0	+	722	1949	3036	0.6419631
C8	7753958	7754168	BolC8t47561H	0	-	0	0	210	0.0000000
C8	7761971	7764102	BolC8t47562H	0	+	509	1819	2131	0.8535899
C8	7763342	7763726	BolC8t47563H	0	-	122	384	384	1.0000000
C8	7779769	7780348	BolC8t47564H	0	-	613	579	579	1.0000000
C8	7800098	7800284	BolC8t47565H	0	+	159	186	186	1.0000000
C8	7804923	7808613	BolC8t47566H	0	-	4973	3690	3690	1.0000000
C8	7809443	7809791	BolC8t47567H	0	+	161	348	348	1.0000000
C8	7810412	7811333	BolC8t47568H	0	+	27	450	921	0.4885994
C8	7811645	7811912	BolC8t47569H	0	+	17	70	267	0.2621723
C8	7813141	7814041	BolC8t47570H	0	-	557	900	900	1.0000000
C8	7826408	7827914	BolC8t47571H	0	+	1256	1506	1506	1.0000000
C8	7832083	7833135	BolC8t47572H	0	-	10	469	1052	0.4458175
C8	7865292	7867539	BolC8t47573H	0	+	1420	2247	2247	1.0000000
C8	7881598	7881990	BolC8t47574H	0	+	460	392	392	1.0000000
C8	7889377	7890838	BolC8t47575H	0	+	595	1333	1461	0.9123888
C8	7932353	7935188	BolC8t47576H	0	+	193	1411	2835	0.4977072
C8	7960045	7963177	BolC8t47577H	0	+	1525	3132	3132	1.0000000
C8	7984322	7985490	BolC8t47578H	0	-	489	1162	1168	0.9948630
C8	7985922	7986471	BolC8t47579H	0	-	388	549	549	1.0000000
C8	7988886	7989234	BolC8t47580H	0	+	227	348	348	1.0000000
C8	7989449	7990097	BolC8t47581H	0	+	564	648	648	1.0000000
C8	7992424	7994665	BolC8t47582H	0	+	148	1102	2241	0.4917448
C8	8018020	8018389	BolC8t47583H	0	+	46	264	369	0.7154471
C8	8044113	8047164	BolC8t47584H	0	+	143	1233	3051	0.4041298
C8	8086170	8086374	BolC8t47585H	0	+	155	204	204	1.0000000
C8	8107985	8108216	BolC8t47586H	0	-	11	108	231	0.4675325
C8	8135876	8141193	BolC8t47587H	0	+	1902	4806	5317	0.9038932
C8	8173066	8173360	BolC8t47588H	0	+	100	257	294	0.8741497
C8	8179976	8181681	BolC8t47589H	0	-	123	1033	1705	0.6058651
C8	8207711	8210266	BolC8t47590H	0	-	1055	1892	2555	0.7405088
C8	8215531	8216674	BolC8t47591H	0	-	12	196	1143	0.1714786
C8	8226453	8226555	BolC8t47592H	0	+	137	102	102	1.0000000
C8	8242621	8246586	BolC8t47593H	0	+	1897	3965	3965	1.0000000
C8	8248825	8249227	BolC8t47594H	0	+	454	402	402	1.0000000
C8	8250054	8252350	BolC8t47595H	0	-	2099	2279	2296	0.9925958
C8	8273084	8277284	BolC8t47596H	0	-	1359	3184	4200	0.7580953
C8	8320764	8321247	BolC8t47597H	0	-	367	483	483	1.0000000
C8	8322117	8324031	BolC8t47598H	0	+	263	1021	1914	0.5334378
C8	8330742	8331075	BolC8t47599H	0	+	10	68	333	0.2042042
C8	8334206	8336080	BolC8t47600H	0	-	166	906	1874	0.4834578
C8	8343878	8344380	BolC8t47601H	0	+	355	502	502	1.0000000
C8	8346798	8346963	BolC8t47602H	0	+	180	165	165	1.0000000
C8	8348602	8348854	BolC8t47603H	0	-	710	252	252	1.0000000
C8	8373504	8375393	BolC8t47604H	0	+	246	1603	1889	0.8485972
C8	8396982	8397212	BolC8t47605H	0	-	15	198	230	0.8608696
C8	8437004	8439464	BolC8t47606H	0	-	83	662	2460	0.2691057
C8	8458838	8459559	BolC8t47607H	0	-	334	721	721	1.0000000
C8	8494864	8496268	BolC8t47608H	0	-	488	1297	1404	0.9237892
C8	8505903	8506606	BolC8t47609H	0	+	385	703	703	1.0000000
C8	8515474	8516170	BolC8t47610H	0	+	436	696	696	1.0000000
C8	8528929	8529250	BolC8t47611H	0	+	1169	321	321	1.0000000
C8	8536307	8536481	BolC8t47612H	0	-	29	174	174	1.0000000
C8	8537956	8540340	BolC8t47613H	0	+	1636	2384	2384	1.0000000
C8	8544602	8545367	BolC8t47614H	0	-	294	753	765	0.9843137
C8	8546462	8547328	BolC8t47615H	0	-	19	261	866	0.3013857
C8	8557398	8557650	BolC8t47616H	0	+	272	252	252	1.0000000
C8	8588027	8589349	BolC8t47617H	0	-	1110	1322	1322	1.0000000
C8	8612991	8613402	BolC8t47618H	0	+	196	411	411	1.0000000
C8	8620845	8622483	BolC8t47619H	0	+	176	1062	1638	0.6483517
C8	8651973	8652105	BolC8t47620H	0	-	13	128	132	0.9696970
C8	8661763	8661955	BolC8t47621H	0	+	85	192	192	1.0000000
C8	8662727	8675315	BolC8t47622H	0	-	1248	6948	12588	0.5519543
C8	8688009	8689517	BolC8t47623H	0	+	1578	1508	1508	1.0000000
C8	8701164	8701742	BolC8t47624H	0	+	532	578	578	1.0000000
C8	8706463	8709718	BolC8t47625H	0	-	867	2488	3255	0.7643625
C8	8734997	8736106	BolC8t47626H	0	+	360	1066	1109	0.9612263
C8	8736771	8739248	BolC8t47627H	0	+	450	2035	2477	0.8215584
C8	8741255	8742311	BolC8t47628H	0	+	630	1056	1056	1.0000000
C8	8753078	8753330	BolC8t47629H	0	+	284	252	252	1.0000000
C8	8763742	8766339	BolC8t47630H	0	+	1502	2597	2597	1.0000000
C8	8767440	8768122	BolC8t47631H	0	-	620	608	682	0.8914956
C8	8770548	8773160	BolC8t47632H	0	+	156	1052	2612	0.4027565
C8	8772306	8772747	BolC8t47633H	0	-	77	312	441	0.7074830
C8	8783717	8784017	BolC8t47634H	0	+	6	235	300	0.7833334
C8	8789061	8789361	BolC8t47635H	0	+	135	300	300	1.0000000
C8	8789825	8790192	BolC8t47636H	0	+	10	82	367	0.2234332
C8	8805464	8806172	BolC8t47637H	0	+	248	708	708	1.0000000
C8	8818244	8818608	BolC8t47638H	0	-	282	364	364	1.0000000
C8	8821095	8822582	BolC8t47639H	0	-	469	1099	1487	0.7390720
C8	8835491	8836237	BolC8t47640H	0	+	509	746	746	1.0000000
C8	8889360	8892023	BolC8t47641H	0	-	1084	2663	2663	1.0000000
C8	8905555	8907948	BolC8t47642H	0	+	707	1478	2393	0.6176348
C8	8908188	8908923	BolC8t47643H	0	-	37	364	735	0.4952381
C8	8920259	8921066	BolC8t47644H	0	-	134	699	807	0.8661710
C8	8969147	8970250	BolC8t47645H	0	-	749	1103	1103	1.0000000
C8	8976862	8977475	BolC8t47646H	0	-	16	101	613	0.1647635
C8	8983383	8983979	BolC8t47647H	0	+	213	596	596	1.0000000
C8	8986098	8987068	BolC8t47648H	0	+	315	970	970	1.0000000
C8	8999960	9006897	BolC8t47649H	0	-	879	5923	6937	0.8538273
C8	9023843	9025355	BolC8t47650H	0	+	750	1512	1512	1.0000000
C8	9101163	9101490	BolC8t47651H	0	+	22	229	327	0.7003058
C8	9112553	9112859	BolC8t47652H	0	+	68	306	306	1.0000000
C8	9193944	9196170	BolC8t47653H	0	+	859	1884	2226	0.8463612
C8	9194983	9195412	BolC8t47654H	0	+	66	429	429	1.0000000
C8	9200535	9200874	BolC8t47655H	0	-	825	339	339	1.0000000
C8	9205028	9209867	BolC8t47656H	0	-	3115	4839	4839	1.0000000
C8	9215329	9215956	BolC8t47657H	0	-	418	627	627	1.0000000
C8	9224331	9226117	BolC8t47658H	0	-	12753	1786	1786	1.0000000
C8	9225297	9226288	BolC8t47659H	0	-	9873	991	991	1.0000000
C8	9226424	9229414	BolC8t47660H	0	-	1884	2990	2990	1.0000000
C8	9231390	9233756	BolC8t47661H	0	-	1998	2366	2366	1.0000000
C8	9245181	9245477	BolC8t47662H	0	+	163	296	296	1.0000000
C8	9254954	9257522	BolC8t47663H	0	-	109	1850	2568	0.7204050
C8	9258376	9258650	BolC8t47664H	0	+	37	192	274	0.7007299
C8	9269692	9270185	BolC8t47665H	0	+	6	308	493	0.6247464
C8	9308267	9311796	BolC8t47666H	0	+	590	2440	3529	0.6914140
C8	9316838	9317054	BolC8t47667H	0	+	338	216	216	1.0000000
C8	9392435	9392627	BolC8t47668H	0	-	77	192	192	1.0000000
C8	9395709	9395877	BolC8t47669H	0	+	10	168	168	1.0000000
C8	9397258	9404471	BolC8t47670H	0	+	649	5084	7213	0.7048385
C8	9419452	9419872	BolC8t47671H	0	-	5	93	420	0.2214286
C8	9423850	9424208	BolC8t47672H	0	-	200	358	358	1.0000000
C8	9449195	9449357	BolC8t47673H	0	-	293	162	162	1.0000000
C8	9467102	9468365	BolC8t47674H	0	-	5475	1263	1263	1.0000000
C8	9569708	9573031	BolC8t47675H	0	-	761	2620	3323	0.7884442
C8	9577139	9579499	BolC8t47676H	0	+	209	1741	2360	0.7377118
C8	9579779	9584068	BolC8t47677H	0	-	2747	4289	4289	1.0000000
C8	9605705	9606260	BolC8t47678H	0	-	467	555	555	1.0000000
C8	9610101	9614114	BolC8t47679H	0	-	1360	4013	4013	1.0000000
C8	9614174	9614660	BolC8t47680H	0	-	196	486	486	1.0000000
C8	9614677	9615143	BolC8t47681H	0	-	418	466	466	1.0000000
C8	9620829	9621240	BolC8t47682H	0	+	213	411	411	1.0000000
C8	9634217	9638259	BolC8t47683H	0	+	975	3178	4042	0.7862445
C8	9667325	9667589	BolC8t47684H	0	-	303	264	264	1.0000000
C8	9671034	9673335	BolC8t47685H	0	-	33	884	2301	0.3841808
C8	9688636	9688882	BolC8t47686H	0	+	195	246	246	1.0000000
C8	9712448	9712901	BolC8t47687H	0	-	0	0	453	0.0000000
C8	9718408	9718582	BolC8t47688H	0	+	0	0	174	0.0000000
C8	9757254	9757707	BolC8t47689H	0	-	0	0	453	0.0000000
C8	9763667	9764189	BolC8t47690H	0	-	206	522	522	1.0000000
C8	9766060	9766372	BolC8t47691H	0	+	0	0	312	0.0000000
C8	9843763	9845885	BolC8t47692H	0	-	902	1949	2122	0.9184731
C8	9870480	9872089	BolC8t47693H	0	-	710	1377	1609	0.8558111
C8	9943801	9944095	BolC8t47694H	0	+	3	48	294	0.1632653
C8	9953672	9954973	BolC8t47695H	0	-	440	1301	1301	1.0000000
C8	9955183	9956117	BolC8t47696H	0	-	405	934	934	1.0000000
C8	9982273	9987353	BolC8t47697H	0	+	6635	5080	5080	1.0000000
C8	9987857	9988367	BolC8t47698H	0	+	727	510	510	1.0000000
C8	10001477	10002302	BolC8t47699H	0	-	1344	825	825	1.0000000
C8	10204541	10206794	BolC8t47700H	0	+	74	1283	2253	0.5694630
C8	10226529	10227484	BolC8t47701H	0	+	108	691	955	0.7235602
C8	10251880	10252699	BolC8t47702H	0	+	93	600	819	0.7326007
C8	10265233	10267095	BolC8t47703H	0	+	1144	1760	1862	0.9452202
C8	10283359	10284904	BolC8t47704H	0	+	1015	1545	1545	1.0000000
C8	10295249	10300970	BolC8t47705H	0	-	1932	5492	5721	0.9599720
C8	10305983	10306181	BolC8t47706H	0	-	189	198	198	1.0000000
C8	10311747	10312114	BolC8t47707H	0	-	95	367	367	1.0000000
C8	10312845	10314320	BolC8t47708H	0	+	633	1475	1475	1.0000000
C8	10314341	10318674	BolC8t47709H	0	-	1131	4333	4333	1.0000000
C8	10329104	10331316	BolC8t47710H	0	-	336	1874	2212	0.8471971
C8	10333591	10334448	BolC8t47711H	0	+	657	857	857	1.0000000
C8	10338066	10346389	BolC8t47712H	0	+	7630	8224	8323	0.9881052
C8	10338640	10340506	BolC8t47713H	0	-	1905	1866	1866	1.0000000
C8	10342139	10342847	BolC8t47714H	0	-	848	708	708	1.0000000
C8	10356443	10356967	BolC8t47715H	0	-	615	524	524	1.0000000
C8	10364256	10365616	BolC8t47716H	0	-	365	1131	1360	0.8316177
C8	10367316	10367640	BolC8t47717H	0	-	253	324	324	1.0000000
C8	10368367	10368603	BolC8t47718H	0	+	588	236	236	1.0000000
C8	10375517	10382419	BolC8t47719H	0	-	10938	6902	6902	1.0000000
C8	10383383	10384451	BolC8t47720H	0	-	175	1068	1068	1.0000000
C8	10384983	10387201	BolC8t47721H	0	-	8488	2218	2218	1.0000000
C8	10395353	10395701	BolC8t47722H	0	+	39	348	348	1.0000000
C8	10433288	10434684	BolC8t47723H	0	+	403	1183	1396	0.8474212
C8	10435322	10435763	BolC8t47724H	0	-	35	235	441	0.5328798
C8	10447977	10449412	BolC8t47725H	0	-	244	1214	1435	0.8459930
C8	10459161	10459464	BolC8t47726H	0	+	2	231	303	0.7623762
C8	10460605	10460911	BolC8t47727H	0	+	144	293	306	0.9575163
C8	10478498	10478906	BolC8t47728H	0	-	323	408	408	1.0000000
C8	10481320	10483628	BolC8t47729H	0	-	338	1865	2308	0.8080589
C8	10499777	10500925	BolC8t47730H	0	+	299	1138	1148	0.9912892
C8	10503080	10504617	BolC8t47731H	0	-	364	1036	1537	0.6740403
C8	10517718	10518296	BolC8t47732H	0	+	62	470	578	0.8131488
C8	10519348	10519516	BolC8t47733H	0	-	24	168	168	1.0000000
C8	10520155	10520329	BolC8t47734H	0	-	141	174	174	1.0000000
C8	10539933	10541338	BolC8t47735H	0	+	767	1405	1405	1.0000000
C8	10561897	10563253	BolC8t47736H	0	+	6	272	1356	0.2005900
C8	10672904	10673309	BolC8t47737H	0	-	240	405	405	1.0000000
C8	10682035	10682596	BolC8t47738H	0	+	25	400	561	0.7130125
C8	10714751	10715417	BolC8t47739H	0	+	573	666	666	1.0000000
C8	10758816	10760938	BolC8t47740H	0	+	1122	2122	2122	1.0000000
C8	10774389	10775562	BolC8t47741H	0	+	820	1173	1173	1.0000000
C8	10826928	10832694	BolC8t47742H	0	-	1760	5766	5766	1.0000000
C8	10849472	10850276	BolC8t47743H	0	-	477	800	804	0.9950249
C8	10867949	10870860	BolC8t47744H	0	+	2074	2911	2911	1.0000000
C8	10871020	10872053	BolC8t47745H	0	-	852	1033	1033	1.0000000
C8	10874512	10875562	BolC8t47746H	0	+	770	1050	1050	1.0000000
C8	10883341	10884317	BolC8t47747H	0	+	39	773	976	0.7920082
C8	10891963	10892422	BolC8t47748H	0	+	18	71	459	0.1546841
C8	10907076	10911174	BolC8t47749H	0	-	180	2625	4098	0.6405564
C8	10920240	10923567	BolC8t47750H	0	-	201	2370	3327	0.7123535
C8	10944385	10945470	BolC8t47751H	0	-	141	745	1085	0.6866360
C8	10948879	10949234	BolC8t47752H	0	+	7	331	355	0.9323944
C8	10974407	10974704	BolC8t47753H	0	+	272	297	297	1.0000000
C8	11040983	11042234	BolC8t47754H	0	-	184	973	1251	0.7777778
C8	11058315	11059967	BolC8t47755H	0	-	332	1652	1652	1.0000000
C8	11062379	11063701	BolC8t47756H	0	+	32	741	1322	0.5605144
C8	11082248	11083024	BolC8t47757H	0	-	275	776	776	1.0000000
C8	11083735	11084154	BolC8t47758H	0	-	325	419	419	1.0000000
C8	11089952	11090360	BolC8t47759H	0	+	332	408	408	1.0000000
C8	11139333	11139954	BolC8t47760H	0	+	123	608	621	0.9790660
C8	11142291	11144405	BolC8t47761H	0	-	1991	1941	2114	0.9181646
C8	11145124	11146705	BolC8t47762H	0	-	52	1230	1581	0.7779886
C8	11172494	11172701	BolC8t47763H	0	+	330	207	207	1.0000000
C8	11172938	11174577	BolC8t47764H	0	+	415	1585	1639	0.9670531
C8	11174931	11176709	BolC8t47765H	0	-	62	924	1778	0.5196850
C8	11198195	11199084	BolC8t47766H	0	+	479	889	889	1.0000000
C8	11206473	11206689	BolC8t47767H	0	+	98	216	216	1.0000000
C8	11314339	11314510	BolC8t47768H	0	+	73	171	171	1.0000000
C8	11324561	11327814	BolC8t47769H	0	+	127	1113	3253	0.3421457
C8	11410078	11410936	BolC8t47770H	0	-	701	858	858	1.0000000
C8	11426676	11427913	BolC8t47771H	0	+	529	1081	1237	0.8738884
C8	11443667	11446152	BolC8t47772H	0	-	286	985	2485	0.3963783
C8	11446590	11447693	BolC8t47773H	0	-	409	1103	1103	1.0000000
C8	11466083	11468615	BolC8t47774H	0	-	118	1420	2532	0.5608215
C8	11469147	11472370	BolC8t47775H	0	-	45	991	3223	0.3074775
C8	11477338	11479085	BolC8t47776H	0	-	55	468	1747	0.2678878
C8	11487391	11487948	BolC8t47777H	0	+	259	557	557	1.0000000
C8	11491042	11491449	BolC8t47778H	0	-	307	407	407	1.0000000
C8	11514463	11516087	BolC8t47779H	0	-	99	778	1624	0.4790640
C8	11537450	11538468	BolC8t47780H	0	-	2095	1018	1018	1.0000000
C8	11559897	11574361	BolC8t47781H	0	+	1974	12613	14464	0.8720271
C8	11574567	11575847	BolC8t47782H	0	+	280	672	1280	0.5250000
C8	11632917	11633190	BolC8t47783H	0	-	241	273	273	1.0000000
C8	11641622	11643274	BolC8t47784H	0	-	31	513	1652	0.3105327
C8	11723418	11724054	BolC8t47785H	0	+	211	636	636	1.0000000
C8	11724162	11724725	BolC8t47786H	0	+	284	563	563	1.0000000
C8	11856230	11862511	BolC8t47787H	0	-	2594	5335	6281	0.8493870
C8	11873848	11875022	BolC8t47788H	0	+	728	1174	1174	1.0000000
C8	11875025	11875208	BolC8t47789H	0	+	185	183	183	1.0000000
C8	11882995	11884241	BolC8t47790H	0	-	27	656	1246	0.5264847
C8	11891254	11891605	BolC8t47791H	0	+	231	351	351	1.0000000
C8	11901289	11901691	BolC8t47792H	0	-	346	402	402	1.0000000
C8	11906331	11907481	BolC8t47793H	0	+	239	1150	1150	1.0000000
C8	11920613	11920802	BolC8t47794H	0	-	62	189	189	1.0000000
C8	12005527	12005638	BolC8t47795H	0	+	78	111	111	1.0000000
C8	12008522	12008741	BolC8t47796H	0	-	60	219	219	1.0000000
C8	12010024	12010261	BolC8t47797H	0	+	141	237	237	1.0000000
C8	12011208	12011340	BolC8t47798H	0	+	93	132	132	1.0000000
C8	12015286	12015784	BolC8t47799H	0	+	888	498	498	1.0000000
C8	12024252	12024911	BolC8t47800H	0	+	594	659	659	1.0000000
C8	12038458	12040771	BolC8t47801H	0	+	304	1724	2313	0.7453523
C8	12062508	12062892	BolC8t47802H	0	+	136	384	384	1.0000000
C8	12095419	12096371	BolC8t47803H	0	+	521	952	952	1.0000000
C8	13951901	13952105	BolC8t47804H	0	-	159	204	204	1.0000000
C8	13994970	13996232	BolC8t47805H	0	-	147	1076	1262	0.8526149
C8	14005991	14014810	BolC8t47806H	0	+	4001	8819	8819	1.0000000
C8	14010145	14011194	BolC8t47807H	0	-	621	1049	1049	1.0000000
C8	14080097	14080370	BolC8t47808H	0	+	514	273	273	1.0000000
C8	14081820	14084530	BolC8t47809H	0	-	1143	2710	2710	1.0000000
C8	14086988	14087199	BolC8t47810H	0	-	153	211	211	1.0000000
C8	14087536	14087878	BolC8t47811H	0	-	133	342	342	1.0000000
C8	14088080	14089109	BolC8t47812H	0	-	353	1020	1029	0.9912537
C8	14098818	14101091	BolC8t47813H	0	+	433	1958	2273	0.8614166
C8	14113672	14115253	BolC8t47814H	0	+	23	217	1581	0.1372549
C8	14119208	14120793	BolC8t47815H	0	-	312	1296	1585	0.8176656
C8	14161758	14162971	BolC8t47816H	0	-	127	881	1213	0.7262985
C8	14184965	14185154	BolC8t47817H	0	+	49	135	189	0.7142857
C8	14186747	14196130	BolC8t47818H	0	-	146	2639	9383	0.2812533
C8	14198810	14200338	BolC8t47819H	0	+	609	1505	1528	0.9849476
C8	14200746	14201258	BolC8t47820H	0	-	112	512	512	1.0000000
C8	14202003	14204205	BolC8t47821H	0	-	429	2178	2202	0.9891008
C8	14218220	14218481	BolC8t47822H	0	+	156	261	261	1.0000000
C8	14219046	14220246	BolC8t47823H	0	-	93	732	1200	0.6100000
C8	14231358	14233450	BolC8t47824H	0	+	1613	2092	2092	1.0000000
C8	14239555	14239888	BolC8t47825H	0	+	473	333	333	1.0000000
C8	14242779	14244626	BolC8t47826H	0	+	191	1532	1847	0.8294532
C8	14244676	14244850	BolC8t47827H	0	+	1	149	174	0.8563218
C8	14277067	14280480	BolC8t47828H	0	-	982	2860	3413	0.8379725
C8	14280590	14281616	BolC8t47829H	0	+	150	903	1026	0.8801169
C8	14294482	14295401	BolC8t47830H	0	+	481	919	919	1.0000000
C8	14295413	14299187	BolC8t47831H	0	+	1954	3774	3774	1.0000000
C8	14297227	14297581	BolC8t47832H	0	-	212	354	354	1.0000000
C8	14301306	14302446	BolC8t47833H	0	+	537	1140	1140	1.0000000
C8	14312432	14319278	BolC8t47834H	0	-	6006	5757	6846	0.8409290
C8	14334599	14335400	BolC8t47835H	0	-	32	403	801	0.5031211
C8	14337421	14338506	BolC8t47836H	0	-	153	710	1085	0.6543779
C8	14338872	14342262	BolC8t47837H	0	+	822	3385	3390	0.9985251
C8	14343142	14346277	BolC8t47838H	0	-	1142	3135	3135	1.0000000
C8	14378947	14379556	BolC8t47839H	0	+	268	609	609	1.0000000
C8	14411944	14413044	BolC8t47840H	0	-	345	1100	1100	1.0000000
C8	14414172	14414847	BolC8t47841H	0	+	326	675	675	1.0000000
C8	14435891	14436553	BolC8t47842H	0	-	412	662	662	1.0000000
C8	14441487	14441925	BolC8t47843H	0	+	52	405	438	0.9246575
C8	14470896	14472944	BolC8t47844H	0	+	10	360	2048	0.1757812
C8	14484752	14486613	BolC8t47845H	0	+	361	1766	1861	0.9489522
C8	14536404	14537699	BolC8t47846H	0	+	367	1173	1295	0.9057915
C8	14537974	14539107	BolC8t47847H	0	-	465	1133	1133	1.0000000
C8	14545028	14545214	BolC8t47848H	0	+	182	186	186	1.0000000
C8	14545355	14547002	BolC8t47849H	0	+	356	1263	1647	0.7668488
C8	14549359	14552370	BolC8t47850H	0	-	1074	2817	3011	0.9355696
C8	14555277	14555511	BolC8t47851H	0	-	196	234	234	1.0000000
C8	14556336	14558795	BolC8t47852H	0	+	811	2459	2459	1.0000000
C8	14593359	14601988	BolC8t47853H	0	+	3331	6947	8629	0.8050759
C8	14597454	14597678	BolC8t47854H	0	+	183	224	224	1.0000000
C8	14602780	14611590	BolC8t47855H	0	+	2052	6598	8810	0.7489217
C8	14612378	14615343	BolC8t47856H	0	-	266	2509	2965	0.8462057
C8	14618257	14618794	BolC8t47857H	0	+	24	461	537	0.8584730
C8	14622898	14624430	BolC8t47858H	0	-	1726	1532	1532	1.0000000
C8	14645897	14647388	BolC8t47859H	0	-	98	1129	1491	0.7572099
C8	14652197	14654493	BolC8t47860H	0	-	694	1944	2296	0.8466899
C8	14678069	14678525	BolC8t47861H	0	+	450	456	456	1.0000000
C8	14678996	14679230	BolC8t47862H	0	+	305	234	234	1.0000000
C8	14702841	14703387	BolC8t47863H	0	+	5	108	546	0.1978022
C8	14710275	14712424	BolC8t47864H	0	-	59	969	2149	0.4509074
C8	14745436	14747602	BolC8t47865H	0	-	30	663	2166	0.3060942
C8	14781948	14783722	BolC8t47866H	0	-	1183	1482	1774	0.8354002
C8	14814323	14817438	BolC8t47867H	0	-	2229	3115	3115	1.0000000
C8	14825599	14828080	BolC8t47868H	0	-	380	1162	2481	0.4683595
C8	14832206	14833950	BolC8t47869H	0	+	310	1292	1744	0.7408257
C8	14834233	14836507	BolC8t47870H	0	+	432	1865	2274	0.8201407
C8	14837272	14839425	BolC8t47871H	0	-	337	1620	2153	0.7524385
C8	14842498	14842651	BolC8t47872H	0	+	163	153	153	1.0000000
C8	14842868	14843149	BolC8t47873H	0	+	241	281	281	1.0000000
C8	14849733	14853384	BolC8t47874H	0	-	2280	3651	3651	1.0000000
C8	14850633	14850998	BolC8t47875H	0	+	443	365	365	1.0000000
C8	14857688	14857883	BolC8t47876H	0	+	215	195	195	1.0000000
C8	14872227	14873963	BolC8t47877H	0	+	146	371	1736	0.2137097
C8	14884426	14885184	BolC8t47878H	0	+	539	758	758	1.0000000
C8	14888578	14889238	BolC8t47879H	0	+	225	660	660	1.0000000
C8	14890624	14890765	BolC8t47880H	0	+	121	141	141	1.0000000
C8	14907111	14908021	BolC8t47881H	0	+	278	893	910	0.9813187
C8	14908266	14910178	BolC8t47882H	0	-	556	1628	1912	0.8514645
C8	14918966	14920409	BolC8t47883H	0	+	857	1416	1443	0.9812890
C8	14922445	14939575	BolC8t47884H	0	-	3134	8869	17130	0.5177466
C8	14950119	14950668	BolC8t47885H	0	-	367	549	549	1.0000000
C8	15050027	15051160	BolC8t47886H	0	-	180	878	1133	0.7749338
C8	15054621	15057767	BolC8t47887H	0	-	1530	2969	3146	0.9437381
C8	15059397	15059897	BolC8t47888H	0	-	25	146	500	0.2920000
C8	15065079	15065316	BolC8t47889H	0	-	0	0	237	0.0000000
C8	15066068	15067455	BolC8t47890H	0	+	44	57	1387	0.0410959
C8	15071662	15071824	BolC8t47891H	0	-	6	110	162	0.6790124
C8	15078184	15078869	BolC8t47892H	0	+	20	318	685	0.4642336
C8	15085235	15086546	BolC8t47893H	0	-	258	1088	1311	0.8299009
C8	15091001	15091450	BolC8t47894H	0	-	36	297	449	0.6614699
C8	15097020	15097294	BolC8t47895H	0	+	4259	274	274	1.0000000
C8	15123320	15124280	BolC8t47896H	0	+	253	960	960	1.0000000
C8	15147753	15148682	BolC8t47897H	0	+	659	929	929	1.0000000
C8	15175653	15177982	BolC8t47898H	0	+	471	1915	2329	0.8222413
C8	15188362	15188889	BolC8t47899H	0	+	655	527	527	1.0000000
C8	15201013	15202016	BolC8t47900H	0	+	542	1003	1003	1.0000000
C8	15208023	15210581	BolC8t47901H	0	+	162	1740	2558	0.6802189
C8	15215097	15215496	BolC8t47902H	0	-	54	399	399	1.0000000
C8	15218233	15219220	BolC8t47903H	0	-	158	643	987	0.6514691
C8	15220021	15220711	BolC8t47904H	0	-	63	575	690	0.8333333
C8	15235198	15237441	BolC8t47905H	0	+	212	1546	2243	0.6892555
C8	15244404	15244734	BolC8t47906H	0	-	0	0	330	0.0000000
C8	15253252	15254242	BolC8t47907H	0	-	0	0	990	0.0000000
C8	15262101	15263091	BolC8t47908H	0	-	5	134	990	0.1353535
C8	15265210	15265672	BolC8t47909H	0	+	244	462	462	1.0000000
C8	15282511	15284923	BolC8t47910H	0	-	161	1186	2412	0.4917081
C8	15303660	15310805	BolC8t47911H	0	-	985	4617	7145	0.6461862
C8	15407178	15407355	BolC8t47912H	0	+	0	0	177	0.0000000
C8	15467522	15467723	BolC8t47913H	0	+	45	201	201	1.0000000
C8	15470115	15472235	BolC8t47914H	0	+	648	1982	2120	0.9349056
C8	15472889	15473144	BolC8t47915H	0	+	87	255	255	1.0000000
C8	15473981	15475330	BolC8t47916H	0	+	81	545	1349	0.4040030
C8	15480044	15480188	BolC8t47917H	0	-	12	114	144	0.7916667
C8	15498439	15498610	BolC8t47918H	0	+	73	171	171	1.0000000
C8	15500515	15500617	BolC8t47919H	0	+	112	102	102	1.0000000
C8	15522651	15523329	BolC8t47920H	0	-	679	678	678	1.0000000
C8	15535874	15536072	BolC8t47921H	0	+	224	198	198	1.0000000
C8	15554158	15563829	BolC8t47922H	0	-	2063	6159	9671	0.6368524
C8	15569180	15570438	BolC8t47923H	0	-	737	1258	1258	1.0000000
C8	15572275	15573931	BolC8t47924H	0	+	1060	1506	1656	0.9094203
C8	15586398	15586947	BolC8t47925H	0	+	22	430	549	0.7832423
C8	15636922	15637393	BolC8t47926H	0	+	565	471	471	1.0000000
C8	15640634	15641119	BolC8t47927H	0	-	387	485	485	1.0000000
C8	15663198	15663435	BolC8t47928H	0	+	15	170	237	0.7172996
C8	15663718	15664474	BolC8t47929H	0	-	3	219	756	0.2896825
C8	15666918	15667158	BolC8t47930H	0	-	99	240	240	1.0000000
C8	15685385	15686185	BolC8t47931H	0	-	424	800	800	1.0000000
C8	15702943	15704018	BolC8t47932H	0	-	166	994	1075	0.9246511
C8	15725051	15726096	BolC8t47933H	0	+	523	1004	1045	0.9607655
C8	15731295	15732743	BolC8t47934H	0	-	245	1229	1448	0.8487569
C8	15733501	15733991	BolC8t47935H	0	+	83	461	490	0.9408163
C8	15739533	15740783	BolC8t47936H	0	-	90	817	1250	0.6536000
C8	15742749	15743463	BolC8t47937H	0	-	99	714	714	1.0000000
C8	15743628	15743844	BolC8t47938H	0	-	52	216	216	1.0000000
C8	15751705	15751957	BolC8t47939H	0	-	138	252	252	1.0000000
C8	15765627	15766557	BolC8t47940H	0	-	316	930	930	1.0000000
C8	15773096	15774132	BolC8t47941H	0	+	365	928	1036	0.8957529
C8	15784800	15785472	BolC8t47942H	0	-	13	441	672	0.6562500
C8	15797685	15799633	BolC8t47943H	0	-	2118	1948	1948	1.0000000
C8	15818327	15818597	BolC8t47944H	0	-	98	270	270	1.0000000
C8	15828963	15829465	BolC8t47945H	0	+	155	502	502	1.0000000
C8	15829795	15830762	BolC8t47946H	0	+	163	967	967	1.0000000
C8	15840740	15840926	BolC8t47947H	0	-	64	186	186	1.0000000
C8	15858560	15859040	BolC8t47948H	0	-	40	415	480	0.8645833
C8	15865203	15866801	BolC8t47949H	0	-	0	0	1598	0.0000000
C8	15873971	15875744	BolC8t47950H	0	-	939	1773	1773	1.0000000
C8	15936857	15936965	BolC8t47951H	0	+	0	0	108	0.0000000
C8	15938500	15942157	BolC8t47952H	0	+	67	1743	3657	0.4766202
C8	16074717	16077163	BolC8t47953H	0	+	242	1440	2446	0.5887163
C8	16213858	16214670	BolC8t47954H	0	-	0	0	812	0.0000000
C8	16230655	16231195	BolC8t47955H	0	-	302	540	540	1.0000000
C8	16232022	16232385	BolC8t47956H	0	+	306	363	363	1.0000000
C8	16235025	16235558	BolC8t47957H	0	+	51	471	533	0.8836773
C8	16254791	16255304	BolC8t47958H	0	+	43	456	513	0.8888889
C8	16255358	16255796	BolC8t47959H	0	+	75	438	438	1.0000000
C8	16295472	16304310	BolC8t47960H	0	-	218	3252	8838	0.3679565
C8	16342511	16343473	BolC8t47961H	0	+	626	962	962	1.0000000
C8	16349845	16350109	BolC8t47962H	0	-	177	264	264	1.0000000
C8	16350740	16351096	BolC8t47963H	0	-	260	356	356	1.0000000
C8	16407070	16408213	BolC8t47964H	0	+	68	395	1143	0.3455818
C8	16426276	16429429	BolC8t47965H	0	+	1267	3019	3153	0.9575008
C8	16429474	16429800	BolC8t47966H	0	+	48	312	326	0.9570552
C8	16429908	16430111	BolC8t47967H	0	+	128	203	203	1.0000000
C8	16430715	16431285	BolC8t47968H	0	-	116	549	570	0.9631579
C8	16436938	16437688	BolC8t47969H	0	-	371	750	750	1.0000000
C8	16440253	16440586	BolC8t47970H	0	-	287	333	333	1.0000000
C8	16467378	16471736	BolC8t47971H	0	+	475	2827	4358	0.6486921
C8	16475325	16475871	BolC8t47972H	0	-	382	546	546	1.0000000
C8	16499619	16501024	BolC8t47973H	0	+	540	1373	1405	0.9772242
C8	16504245	16504848	BolC8t47974H	0	-	6	258	603	0.4278607
C8	16505515	16507544	BolC8t47975H	0	-	1218	2029	2029	1.0000000
C8	16523293	16523533	BolC8t47976H	0	+	32	110	240	0.4583333
C8	16525639	16526056	BolC8t47977H	0	-	166	417	417	1.0000000
C8	16532366	16532555	BolC8t47978H	0	-	1	101	189	0.5343915
C8	16533570	16533759	BolC8t47979H	0	-	0	0	189	0.0000000
C8	16535740	16536686	BolC8t47980H	0	+	176	906	946	0.9577167
C8	16540563	16540722	BolC8t47981H	0	+	215	159	159	1.0000000
C8	16543801	16545982	BolC8t47982H	0	-	999	1984	2181	0.9096745
C8	16572124	16573752	BolC8t47983H	0	-	575	1628	1628	1.0000000
C8	16578326	16584352	BolC8t47984H	0	+	4293	6007	6026	0.9968470
C8	16585165	16586527	BolC8t47985H	0	-	374	1176	1362	0.8634361
C8	16588725	16589528	BolC8t47986H	0	+	642	803	803	1.0000000
C8	16605545	16605896	BolC8t47987H	0	+	6	29	351	0.0826211
C8	16628624	16629590	BolC8t47988H	0	-	911	966	966	1.0000000
C8	16642021	16642701	BolC8t47989H	0	+	687	674	680	0.9911765
C8	16642987	16643825	BolC8t47990H	0	+	382	543	838	0.6479713
C8	16645055	16645477	BolC8t47991H	0	+	0	0	422	0.0000000
C8	16646146	16646661	BolC8t47992H	0	+	548	515	515	1.0000000
C8	16671584	16671839	BolC8t47993H	0	-	312	255	255	1.0000000
C8	16672308	16673322	BolC8t47994H	0	-	730	1014	1014	1.0000000
C8	16694044	16704035	BolC8t47995H	0	+	3580	8827	9991	0.8834952
C8	16707209	16708175	BolC8t47996H	0	+	757	966	966	1.0000000
C8	16767902	16769594	BolC8t47997H	0	-	100	1141	1692	0.6743499
C8	16773808	16775705	BolC8t47998H	0	+	2007	1897	1897	1.0000000
C8	16777503	16779962	BolC8t47999H	0	+	998	2280	2459	0.9272062
C8	16781951	16784293	BolC8t48000H	0	-	455	1610	2342	0.6874467
C8	16788532	16789635	BolC8t48001H	0	-	549	1103	1103	1.0000000
C8	16849568	16850072	BolC8t48002H	0	+	108	504	504	1.0000000
C8	16850772	16851006	BolC8t48003H	0	-	7	58	234	0.2478632
C8	16857731	16859780	BolC8t48004H	0	-	1662	2049	2049	1.0000000
C8	16863211	16864722	BolC8t48005H	0	+	326	1511	1511	1.0000000
C8	16872200	16872879	BolC8t48006H	0	+	343	679	679	1.0000000
C8	16877416	16878344	BolC8t48007H	0	-	4896	928	928	1.0000000
C8	16895314	16897021	BolC8t48008H	0	-	118	897	1707	0.5254833
C8	16904955	16907331	BolC8t48009H	0	-	714	1874	2376	0.7887205
C8	16909696	16910494	BolC8t48010H	0	+	582	789	798	0.9887218
C8	16935194	16936710	BolC8t48011H	0	-	489	1516	1516	1.0000000
C8	16938951	16939281	BolC8t48012H	0	-	243	330	330	1.0000000
C8	16940010	16942383	BolC8t48013H	0	-	366	1252	2373	0.5276022
C8	16962059	16963965	BolC8t48014H	0	-	512	1395	1906	0.7318993
C8	16988710	16999038	BolC8t48015H	0	-	2193	7164	10328	0.6936483
C8	17026409	17026721	BolC8t48016H	0	-	41	250	312	0.8012820
C8	17041387	17041975	BolC8t48017H	0	-	378	588	588	1.0000000
C8	17070254	17072802	BolC8t48018H	0	+	334	1857	2548	0.7288069
C8	17085252	17087030	BolC8t48019H	0	+	3	218	1778	0.1226097
C8	17094736	17101366	BolC8t48020H	0	+	1642	4283	6630	0.6460030
C8	17102369	17104563	BolC8t48021H	0	+	319	1952	2194	0.8896992
C8	17109166	17109451	BolC8t48022H	0	-	384	285	285	1.0000000
C8	17111035	17112709	BolC8t48023H	0	-	1741	1674	1674	1.0000000
C8	17126235	17129482	BolC8t48024H	0	+	2515	3247	3247	1.0000000
C8	17148202	17160380	BolC8t48025H	0	-	5393	12144	12178	0.9972081
C8	17163565	17164243	BolC8t48026H	0	+	537	594	678	0.8761062
C8	17205905	17208114	BolC8t48027H	0	-	118	1042	2209	0.4717067
C8	17228769	17229006	BolC8t48028H	0	+	104	237	237	1.0000000
C8	17234497	17235628	BolC8t48029H	0	+	551	1131	1131	1.0000000
C8	17258314	17259261	BolC8t48030H	0	-	11	361	947	0.3812038
C8	17270723	17271104	BolC8t48031H	0	-	5	43	381	0.1128609
C8	17285202	17285583	BolC8t48032H	0	-	3	48	381	0.1259843
C8	17312011	17313124	BolC8t48033H	0	-	701	1052	1113	0.9451932
C8	17430319	17432447	BolC8t48034H	0	+	522	1830	2128	0.8599624
C8	17432762	17434924	BolC8t48035H	0	-	62	1314	2162	0.6077706
C8	17435442	17438225	BolC8t48036H	0	+	379	1846	2783	0.6633130
C8	17442400	17442664	BolC8t48037H	0	+	26	208	264	0.7878788
C8	17445197	17446000	BolC8t48038H	0	+	235	803	803	1.0000000
C8	17462237	17465327	BolC8t48039H	0	+	1514	2974	3090	0.9624596
C8	17471542	17472781	BolC8t48040H	0	+	293	1024	1239	0.8264729
C8	17482290	17482604	BolC8t48041H	0	+	1467	314	314	1.0000000
C8	17485739	17486151	BolC8t48042H	0	-	427	412	412	1.0000000
C8	17499571	17502427	BolC8t48043H	0	+	505	2470	2856	0.8648459
C8	17539352	17547313	BolC8t48044H	0	-	1919	5870	7961	0.7373446
C8	17561267	17565366	BolC8t48045H	0	-	3739	4063	4099	0.9912174
C8	17567312	17567506	BolC8t48046H	0	-	208	194	194	1.0000000
C8	17584155	17584500	BolC8t48047H	0	+	0	0	345	0.0000000
C8	17586673	17587107	BolC8t48048H	0	-	805	434	434	1.0000000
C8	17598658	17599580	BolC8t48049H	0	+	362	881	922	0.9555315
C8	17606474	17606924	BolC8t48050H	0	-	50	291	450	0.6466666
C8	17614095	17616892	BolC8t48051H	0	+	908	2580	2797	0.9224169
C8	17617658	17619863	BolC8t48052H	0	-	1416	2200	2205	0.9977324
C8	17630057	17632310	BolC8t48053H	0	-	1397	2253	2253	1.0000000
C8	17633387	17643837	BolC8t48054H	0	+	4944	5954	10450	0.5697607
C8	17659088	17661865	BolC8t48055H	0	-	261	1228	2777	0.4422038
C8	17676890	17677395	BolC8t48056H	0	-	301	505	505	1.0000000
C8	17694188	17695655	BolC8t48057H	0	-	983	1436	1467	0.9788684
C8	17699177	17699444	BolC8t48058H	0	+	163	267	267	1.0000000
C8	17701220	17701631	BolC8t48059H	0	+	733	411	411	1.0000000
C8	17705544	17708851	BolC8t48060H	0	-	1273	3251	3307	0.9830662
C8	17709491	17712466	BolC8t48061H	0	+	455	1875	2975	0.6302521
C8	17716846	17719956	BolC8t48062H	0	+	136	894	3110	0.2874598
C8	17720482	17723062	BolC8t48063H	0	-	1410	2157	2580	0.8360465
C8	17723499	17723814	BolC8t48064H	0	+	289	315	315	1.0000000
C8	17750168	17752265	BolC8t48065H	0	+	355	1889	2097	0.9008107
C8	17754393	17754803	BolC8t48066H	0	+	330	410	410	1.0000000
C8	17762376	17763213	BolC8t48067H	0	-	0	0	837	0.0000000
C8	17811950	17813273	BolC8t48068H	0	+	8	207	1323	0.1564626
C8	17852931	17853451	BolC8t48069H	0	+	110	520	520	1.0000000
C8	17853543	17853721	BolC8t48070H	0	+	31	178	178	1.0000000
C8	17899679	17928161	BolC8t48071H	0	+	6715	18890	28482	0.6632259
C8	17928351	17928691	BolC8t48072H	0	+	285	340	340	1.0000000
C8	17939338	17942196	BolC8t48073H	0	+	884	1930	2858	0.6752974
C8	17949466	17951948	BolC8t48074H	0	-	348	1770	2482	0.7131346
C8	17981001	17981814	BolC8t48075H	0	-	689	813	813	1.0000000
C8	17982181	17984425	BolC8t48076H	0	-	1159	2135	2244	0.9514260
C8	17987037	17988213	BolC8t48077H	0	-	186	965	1176	0.8205782
C8	17999676	17999984	BolC8t48078H	0	+	0	0	308	0.0000000
C8	18000053	18000473	BolC8t48079H	0	+	0	0	420	0.0000000
C8	18024217	18025777	BolC8t48080H	0	+	236	1370	1560	0.8782051
C8	18040703	18042748	BolC8t48081H	0	-	226	1838	2045	0.8987775
C8	18043292	18043802	BolC8t48082H	0	-	67	435	510	0.8529412
C8	18064834	18065074	BolC8t48083H	0	-	740	240	240	1.0000000
C8	18066699	18067190	BolC8t48084H	0	+	84	491	491	1.0000000
C8	18084765	18087195	BolC8t48085H	0	+	15	561	2430	0.2308642
C8	18101660	18102915	BolC8t48086H	0	-	297	1255	1255	1.0000000
C8	18114337	18114691	BolC8t48087H	0	-	95	260	354	0.7344633
C8	18120020	18122267	BolC8t48088H	0	-	553	2150	2247	0.9568313
C8	18130074	18131872	BolC8t48089H	0	+	144	632	1798	0.3515017
C8	18137383	18137605	BolC8t48090H	0	+	195	222	222	1.0000000
C8	18142412	18142742	BolC8t48091H	0	-	296	330	330	1.0000000
C8	18162878	18168287	BolC8t48092H	0	-	2790	4596	5409	0.8496950
C8	18195506	18198682	BolC8t48093H	0	+	2014	3176	3176	1.0000000
C8	18207055	18209171	BolC8t48094H	0	-	683	1770	2116	0.8364840
C8	18210308	18212138	BolC8t48095H	0	-	242	1449	1830	0.7918033
C8	18215993	18217664	BolC8t48096H	0	-	360	996	1671	0.5960503
C8	18223659	18224919	BolC8t48097H	0	+	30	478	1260	0.3793651
C8	18235846	18237220	BolC8t48098H	0	-	352	1184	1374	0.8617176
C8	18237958	18239144	BolC8t48099H	0	-	427	1186	1186	1.0000000
C8	18239356	18239583	BolC8t48100H	0	-	88	227	227	1.0000000
C8	18245937	18247946	BolC8t48101H	0	-	1458	2009	2009	1.0000000
C8	18249428	18250571	BolC8t48102H	0	-	2	82	1143	0.0717410
C8	18269984	18271688	BolC8t48103H	0	+	31	897	1704	0.5264084
C8	18282913	18283481	BolC8t48104H	0	+	332	568	568	1.0000000
C8	18292371	18294212	BolC8t48105H	0	-	1026	1813	1841	0.9847909
C8	18354513	18355021	BolC8t48106H	0	+	197	508	508	1.0000000
C8	18355328	18385637	BolC8t48107H	0	+	16408	26190	30309	0.8640998
C8	18367362	18372210	BolC8t48108H	0	+	1707	2897	4848	0.5975660
C8	18386021	18389006	BolC8t48109H	0	-	975	2985	2985	1.0000000
C8	18393713	18399530	BolC8t48110H	0	+	2042	5817	5817	1.0000000
C8	18422884	18423721	BolC8t48111H	0	+	158	530	837	0.6332139
C8	18456058	18456923	BolC8t48112H	0	+	55	350	865	0.4046243
C8	18466123	18467355	BolC8t48113H	0	+	851	1232	1232	1.0000000
C8	18468610	18470926	BolC8t48114H	0	+	1085	2293	2316	0.9900691
C8	18473183	18475551	BolC8t48115H	0	-	723	2368	2368	1.0000000
C8	18488185	18489085	BolC8t48116H	0	-	0	0	900	0.0000000
C8	18504394	18504646	BolC8t48117H	0	+	266	252	252	1.0000000
C8	18531974	18532713	BolC8t48118H	0	-	716	739	739	1.0000000
C8	18539119	18539329	BolC8t48119H	0	-	34	210	210	1.0000000
C8	18556108	18556479	BolC8t48120H	0	-	231	371	371	1.0000000
C8	18570301	18571027	BolC8t48121H	0	-	474	726	726	1.0000000
C8	18572880	18573606	BolC8t48122H	0	+	368	726	726	1.0000000
C8	18574107	18574287	BolC8t48123H	0	-	249	180	180	1.0000000
C8	18581406	18582776	BolC8t48124H	0	-	775	1081	1370	0.7890511
C8	18608060	18609040	BolC8t48125H	0	-	568	980	980	1.0000000
C8	18620205	18620939	BolC8t48126H	0	-	0	0	734	0.0000000
C8	18660694	18661429	BolC8t48127H	0	-	20	455	735	0.6190476
C8	18691608	18691887	BolC8t48128H	0	-	10	134	279	0.4802867
C8	18755209	18756205	BolC8t48129H	0	-	1643	996	996	1.0000000
C8	18756822	18758336	BolC8t48130H	0	-	1847	1514	1514	1.0000000
C8	18773358	18776423	BolC8t48131H	0	+	2	32	3065	0.0104405
C8	18785927	18788970	BolC8t48132H	0	-	38	158	3043	0.0519224
C8	18790943	18792486	BolC8t48133H	0	+	378	880	1543	0.5703176
C8	18807436	18808565	BolC8t48134H	0	+	541	1129	1129	1.0000000
C8	18808963	18809218	BolC8t48135H	0	+	201	255	255	1.0000000
C8	18817219	18817983	BolC8t48136H	0	+	578	764	764	1.0000000
C8	18820084	18820331	BolC8t48137H	0	-	114	220	247	0.8906882
C8	18831149	18832895	BolC8t48138H	0	+	744	1733	1746	0.9925544
C8	18833277	18841061	BolC8t48139H	0	+	2214	6338	7784	0.8142343
C8	18842311	18847360	BolC8t48140H	0	-	2166	4803	5049	0.9512775
C8	18858100	18860336	BolC8t48141H	0	+	246	1750	2236	0.7826476
C8	18861155	18862874	BolC8t48142H	0	+	584	1605	1719	0.9336824
C8	18864036	18868277	BolC8t48143H	0	-	402	3049	4241	0.7189342
C8	18873640	18873802	BolC8t48144H	0	+	216	162	162	1.0000000
C8	18886116	18886832	BolC8t48145H	0	-	381	716	716	1.0000000
C8	18905523	18906702	BolC8t48146H	0	+	270	1105	1179	0.9372349
C8	18909320	18912538	BolC8t48147H	0	+	3052	3218	3218	1.0000000
C8	18915788	18920022	BolC8t48148H	0	-	4272	4234	4234	1.0000000
C8	18920708	18921627	BolC8t48149H	0	+	1063	919	919	1.0000000
C8	18930716	18931749	BolC8t48150H	0	+	307	926	1033	0.8964182
C8	18932402	18933142	BolC8t48151H	0	-	236	739	740	0.9986486
C8	18978734	18983643	BolC8t48152H	0	+	2198	4558	4909	0.9284987
C8	18991002	18991270	BolC8t48153H	0	-	8	210	268	0.7835821
C8	18991427	18993255	BolC8t48154H	0	-	1065	1806	1828	0.9879650
C8	19026447	19032326	BolC8t48155H	0	-	4183	5404	5879	0.9192039
C8	19036320	19036572	BolC8t48156H	0	-	344	252	252	1.0000000
C8	19037271	19037593	BolC8t48157H	0	-	166	322	322	1.0000000
C8	19037626	19040408	BolC8t48158H	0	-	1074	2782	2782	1.0000000
C8	19040382	19040886	BolC8t48159H	0	-	143	504	504	1.0000000
C8	19068907	19069225	BolC8t48160H	0	-	193	318	318	1.0000000
C8	19074162	19075704	BolC8t48161H	0	+	28	447	1542	0.2898833
C8	19083008	19083439	BolC8t48162H	0	-	660	431	431	1.0000000
C8	19122952	19131627	BolC8t48163H	0	-	4445	8267	8675	0.9529683
C8	19127517	19128084	BolC8t48164H	0	-	61	484	567	0.8536155
C8	19138849	19139815	BolC8t48165H	0	+	90	633	966	0.6552795
C8	19164295	19167020	BolC8t48166H	0	+	317	2089	2725	0.7666055
C8	19182408	19184188	BolC8t48167H	0	+	295	1182	1780	0.6640449
C8	19189814	19193265	BolC8t48168H	0	-	343	2284	3451	0.6618372
C8	19240912	19243001	BolC8t48169H	0	-	177	1539	2089	0.7367162
C8	19243970	19244618	BolC8t48170H	0	-	409	648	648	1.0000000
C8	19252899	19253185	BolC8t48171H	0	-	222	286	286	1.0000000
C8	19259428	19260436	BolC8t48172H	0	-	322	948	1008	0.9404762
C8	19261924	19263069	BolC8t48173H	0	-	607	1145	1145	1.0000000
C8	19265750	19265888	BolC8t48174H	0	-	67	138	138	1.0000000
C8	19273246	19274719	BolC8t48175H	0	+	11268	1473	1473	1.0000000
C8	19276021	19276338	BolC8t48176H	0	-	43	293	317	0.9242902
C8	19284771	19289458	BolC8t48177H	0	+	1492	3596	4687	0.7672285
C8	19286101	19286536	BolC8t48178H	0	-	2	102	435	0.2344828
C8	19296835	19298618	BolC8t48179H	0	+	259	987	1783	0.5535614
C8	19308343	19310653	BolC8t48180H	0	+	264	1727	2310	0.7476190
C8	19365567	19367445	BolC8t48181H	0	+	1021	1640	1878	0.8732694
C8	19377093	19377304	BolC8t48182H	0	+	316	211	211	1.0000000
C8	19377369	19377660	BolC8t48183H	0	+	350	291	291	1.0000000
C8	19377842	19379183	BolC8t48184H	0	-	72	545	1341	0.4064131
C8	19414835	19416625	BolC8t48185H	0	-	79	1231	1790	0.6877095
C8	19420911	19421973	BolC8t48186H	0	-	383	782	1062	0.7363465
C8	19422550	19423352	BolC8t48187H	0	+	712	802	802	1.0000000
C8	19424082	19427560	BolC8t48188H	0	+	869	2995	3478	0.8611271
C8	19431956	19434253	BolC8t48189H	0	-	628	2284	2297	0.9943404
C8	19436996	19439498	BolC8t48190H	0	+	555	2166	2502	0.8657075
C8	19445348	19446065	BolC8t48191H	0	-	115	466	717	0.6499302
C8	19462391	19464243	BolC8t48192H	0	-	184	1450	1852	0.7829373
C8	19471986	19472981	BolC8t48193H	0	-	9	162	995	0.1628141
C8	19489541	19492860	BolC8t48194H	0	+	1540	3156	3319	0.9508888
C8	19493206	19493899	BolC8t48195H	0	-	247	693	693	1.0000000
C8	19494913	19495649	BolC8t48196H	0	+	905	736	736	1.0000000
C8	19512276	19514692	BolC8t48197H	0	+	1867	2416	2416	1.0000000
C8	19527093	19528043	BolC8t48198H	0	+	758	950	950	1.0000000
C8	19537695	19539140	BolC8t48199H	0	+	1657	1445	1445	1.0000000
C8	19542966	19544499	BolC8t48200H	0	-	54	761	1533	0.4964123
C8	19547594	19548601	BolC8t48201H	0	+	390	1007	1007	1.0000000
C8	19554757	19587726	BolC8t48202H	0	+	6144	20715	32969	0.6283175
C8	19596129	19597351	BolC8t48203H	0	-	851	1208	1222	0.9885434
C8	19598360	19599097	BolC8t48204H	0	+	419	737	737	1.0000000
C8	19639716	19640439	BolC8t48205H	0	-	126	546	723	0.7551867
C8	19640994	19642237	BolC8t48206H	0	+	1007	1243	1243	1.0000000
C8	19657046	19658495	BolC8t48207H	0	-	56	1000	1449	0.6901311
C8	19666099	19667178	BolC8t48208H	0	-	2	79	1079	0.0732159
C8	19668044	19669492	BolC8t48209H	0	+	337	1233	1448	0.8515193
C8	19672433	19674539	BolC8t48210H	0	+	765	1801	2106	0.8551757
C8	19678227	19679745	BolC8t48211H	0	-	204	1128	1518	0.7430830
C8	19717024	19717174	BolC8t48212H	0	+	213	150	150	1.0000000
C8	19719343	19721670	BolC8t48213H	0	-	1298	1912	2327	0.8216588
C8	19753339	19753948	BolC8t48214H	0	+	101	501	609	0.8226601
C8	19755961	19760369	BolC8t48215H	0	+	1926	4122	4408	0.9351180
C8	19761988	19767756	BolC8t48216H	0	+	1539	4448	5768	0.7711512
C8	19770220	19771947	BolC8t48217H	0	+	540	1727	1727	1.0000000
C8	19782956	19783364	BolC8t48218H	0	+	89	408	408	1.0000000
C8	19784108	19784890	BolC8t48219H	0	+	357	782	782	1.0000000
C8	19787345	19788657	BolC8t48220H	0	+	366	1076	1312	0.8201219
C8	19849058	19849800	BolC8t48221H	0	+	28	181	742	0.2439353
C8	19852583	19852758	BolC8t48222H	0	+	44	175	175	1.0000000
C8	19856808	19857550	BolC8t48223H	0	+	2	2	742	0.0026954
C8	19878359	19879093	BolC8t48224H	0	+	9	100	734	0.1362398
C8	19883146	19883479	BolC8t48225H	0	-	330	333	333	1.0000000
C8	19899944	19900594	BolC8t48226H	0	+	90	420	650	0.6461539
C8	19914504	19921808	BolC8t48227H	0	+	3337	6498	7304	0.8896495
C8	19922306	19924519	BolC8t48228H	0	-	697	2004	2213	0.9055580
C8	19926734	19927271	BolC8t48229H	0	-	19	221	537	0.4115456
C8	19928469	19930626	BolC8t48230H	0	-	1151	2096	2157	0.9717200
C8	19934710	19934917	BolC8t48231H	0	-	432	207	207	1.0000000
C8	19944726	19948394	BolC8t48232H	0	-	694	2836	3668	0.7731734
C8	19971089	19971471	BolC8t48233H	0	-	401	382	382	1.0000000
C8	19974121	19975737	BolC8t48234H	0	-	397	1332	1616	0.8242574
C8	19977595	19978177	BolC8t48235H	0	-	8	428	582	0.7353952
C8	19980279	19981869	BolC8t48236H	0	-	270	1372	1590	0.8628931
C8	19985574	19985676	BolC8t48237H	0	+	304	102	102	1.0000000
C8	19985895	19986837	BolC8t48238H	0	+	680	942	942	1.0000000
C8	20005398	20005554	BolC8t48239H	0	+	0	0	156	0.0000000
C8	20012135	20012315	BolC8t48240H	0	-	382	180	180	1.0000000
C8	20023478	20024785	BolC8t48241H	0	+	224	984	1307	0.7528692
C8	20027795	20028254	BolC8t48242H	0	+	264	459	459	1.0000000
C8	20032940	20035380	BolC8t48243H	0	-	26	1141	2440	0.4676230
C8	20036628	20037987	BolC8t48244H	0	+	902	1293	1359	0.9514349
C8	20038174	20038968	BolC8t48245H	0	-	414	794	794	1.0000000
C8	20040859	20043103	BolC8t48246H	0	+	632	1616	2244	0.7201426
C8	20044747	20045972	BolC8t48247H	0	-	272	1181	1225	0.9640816
C8	20061711	20062005	BolC8t48248H	0	+	281	294	294	1.0000000
C8	20067438	20067759	BolC8t48249H	0	+	32	261	321	0.8130841
C8	20085519	20087296	BolC8t48250H	0	-	653	1716	1777	0.9656725
C8	20104254	20104377	BolC8t48251H	0	+	156	123	123	1.0000000
C8	20107318	20109353	BolC8t48252H	0	+	912	1977	2035	0.9714988
C8	20112651	20114425	BolC8t48253H	0	+	296	1134	1774	0.6392334
C8	20128582	20131291	BolC8t48254H	0	-	76	1759	2709	0.6493171
C8	20133706	20141162	BolC8t48255H	0	+	910	5069	7456	0.6798552
C8	20159165	20159573	BolC8t48256H	0	+	36	204	408	0.5000000
C8	20166482	20167199	BolC8t48257H	0	-	193	708	717	0.9874477
C8	20172646	20176671	BolC8t48258H	0	-	1089	2954	4025	0.7339131
C8	20180630	20181889	BolC8t48259H	0	-	420	1238	1259	0.9833201
C8	20207483	20209413	BolC8t48260H	0	+	1559	1930	1930	1.0000000
C8	20210802	20212037	BolC8t48261H	0	+	943	1235	1235	1.0000000
C8	20218735	20219793	BolC8t48262H	0	+	888	1058	1058	1.0000000
C8	20241078	20244731	BolC8t48263H	0	-	692	3530	3653	0.9663290
C8	20260463	20260754	BolC8t48264H	0	+	0	0	291	0.0000000
C8	20262624	20265377	BolC8t48265H	0	+	570	2495	2753	0.9062840
C8	20284148	20284962	BolC8t48266H	0	-	524	814	814	1.0000000
C8	20285654	20296120	BolC8t48267H	0	+	6415	9592	10466	0.9164915
C8	20296636	20299640	BolC8t48268H	0	-	974	2938	3004	0.9780293
C8	20307735	20308300	BolC8t48269H	0	-	48	565	565	1.0000000
C8	20311864	20312047	BolC8t48270H	0	-	64	183	183	1.0000000
C8	20319303	20329956	BolC8t48271H	0	-	1255	7565	10653	0.7101286
C8	20342070	20349055	BolC8t48272H	0	+	5634	6985	6985	1.0000000
C8	20355364	20358129	BolC8t48273H	0	+	83	1610	2765	0.5822785
C8	20364374	20365145	BolC8t48274H	0	+	5	108	771	0.1400778
C8	20372593	20377943	BolC8t48275H	0	-	449	2491	5350	0.4656075
C8	20379334	20379436	BolC8t48276H	0	-	101	102	102	1.0000000
C8	20405846	20406179	BolC8t48277H	0	-	150	333	333	1.0000000
C8	20423455	20424072	BolC8t48278H	0	-	16	257	617	0.4165316
C8	20448850	20450252	BolC8t48279H	0	+	287	1324	1402	0.9443652
C8	20456502	20456730	BolC8t48280H	0	+	1	37	228	0.1622807
C8	20473107	20476416	BolC8t48281H	0	+	908	2486	3309	0.7512844
C8	20478080	20478308	BolC8t48282H	0	-	12	166	228	0.7280702
C8	20478968	20481473	BolC8t48283H	0	+	737	2195	2505	0.8762475
C8	20556652	20557185	BolC8t48284H	0	-	389	533	533	1.0000000
C8	20562091	20562409	BolC8t48285H	0	-	237	318	318	1.0000000
C8	20643247	20643664	BolC8t48286H	0	-	268	417	417	1.0000000
C8	20645652	20658487	BolC8t48287H	0	-	11833	12782	12835	0.9958706
C8	20676950	20678816	BolC8t48288H	0	+	1804	1866	1866	1.0000000
C8	20699814	20701925	BolC8t48289H	0	+	232	1642	2111	0.7778304
C8	20708409	20708586	BolC8t48290H	0	+	178	177	177	1.0000000
C8	20726113	20728693	BolC8t48291H	0	-	641	2448	2580	0.9488372
C8	20729485	20731252	BolC8t48292H	0	+	269	1590	1767	0.8998302
C8	20731857	20732100	BolC8t48293H	0	+	276	243	243	1.0000000
C8	20761962	20762268	BolC8t48294H	0	+	0	0	306	0.0000000
C8	20792795	20793104	BolC8t48295H	0	+	221	309	309	1.0000000
C8	20793816	20794627	BolC8t48296H	0	+	747	811	811	1.0000000
C8	20807805	20808389	BolC8t48297H	0	+	241	584	584	1.0000000
C8	20838580	20838889	BolC8t48298H	0	+	6	151	309	0.4886732
C8	20892210	20892375	BolC8t48299H	0	+	124	165	165	1.0000000
C8	20893040	20894161	BolC8t48300H	0	+	41	384	1121	0.3425513
C8	20917388	20917804	BolC8t48301H	0	+	266	415	416	0.9975961
C8	20941452	20942850	BolC8t48302H	0	-	5	255	1398	0.1824034
C8	20947867	20949214	BolC8t48303H	0	-	2	10	1347	0.0074239
C8	20971190	20972477	BolC8t48304H	0	-	1079	1287	1287	1.0000000
C8	21004892	21005259	BolC8t48305H	0	+	554	367	367	1.0000000
C8	21011984	21016992	BolC8t48306H	0	+	4647	5008	5008	1.0000000
C8	21026110	21036605	BolC8t48307H	0	-	1599	8573	10495	0.8168651
C8	21075523	21076399	BolC8t48308H	0	-	244	705	876	0.8047945
C8	21079228	21081092	BolC8t48309H	0	-	1053	1864	1864	1.0000000
C8	21081153	21086670	BolC8t48310H	0	-	2210	4708	5517	0.8533623
C8	21101111	21101969	BolC8t48311H	0	-	183	858	858	1.0000000
C8	21103034	21105720	BolC8t48312H	0	-	791	1775	2686	0.6608340
C8	21121308	21121701	BolC8t48313H	0	+	524	393	393	1.0000000
C8	21122825	21123664	BolC8t48314H	0	-	478	839	839	1.0000000
C8	21130233	21132679	BolC8t48315H	0	+	898	2446	2446	1.0000000
C8	21137612	21138176	BolC8t48316H	0	+	70	239	564	0.4237589
C8	21151549	21152704	BolC8t48317H	0	+	639	1155	1155	1.0000000
C8	21153709	21154407	BolC8t48318H	0	-	445	673	698	0.9641834
C8	21155826	21157064	BolC8t48319H	0	-	749	1209	1238	0.9765751
C8	21158280	21161598	BolC8t48320H	0	-	1543	3200	3318	0.9644364
C8	21168118	21171903	BolC8t48321H	0	+	619	2974	3785	0.7857332
C8	21186463	21187792	BolC8t48322H	0	+	734	1329	1329	1.0000000
C8	21217654	21218908	BolC8t48323H	0	+	612	1254	1254	1.0000000
C8	21219315	21221012	BolC8t48324H	0	+	2491	1697	1697	1.0000000
C8	21221661	21228231	BolC8t48325H	0	+	3633	6514	6570	0.9914764
C8	21228792	21230966	BolC8t48326H	0	-	1116	1865	2174	0.8578657
C8	21245152	21245992	BolC8t48327H	0	+	176	805	840	0.9583333
C8	21249584	21261546	BolC8t48328H	0	-	3690	10606	11962	0.8866410
C8	21264594	21265011	BolC8t48329H	0	-	1	46	417	0.1103118
C8	21275331	21277367	BolC8t48330H	0	+	1182	1912	2036	0.9390963
C8	21280526	21281534	BolC8t48331H	0	+	224	924	1008	0.9166667
C8	21296773	21297634	BolC8t48332H	0	+	378	639	861	0.7421603
C8	21306238	21307603	BolC8t48333H	0	+	543	1043	1365	0.7641026
C8	21316516	21316930	BolC8t48334H	0	+	2	104	414	0.2512077
C8	21325850	21326995	BolC8t48335H	0	-	664	1113	1145	0.9720524
C8	21330553	21333236	BolC8t48336H	0	-	249	1960	2683	0.7305256
C8	21342867	21344616	BolC8t48337H	0	-	1118	1749	1749	1.0000000
C8	21382009	21386272	BolC8t48338H	0	+	1211	2287	4263	0.5364767
C8	21387004	21387443	BolC8t48339H	0	+	248	439	439	1.0000000
C8	21387192	21446112	BolC8t48340H	0	+	37181	53229	58920	0.9034114
C8	21401295	21401817	BolC8t48341H	0	+	33	321	522	0.6149426
C8	21404981	21405917	BolC8t48342H	0	+	18	105	936	0.1121795
C8	21411115	21412303	BolC8t48343H	0	-	1122	1185	1188	0.9974747
C8	21415249	21416712	BolC8t48344H	0	+	1248	1463	1463	1.0000000
C8	21458869	21459493	BolC8t48345H	0	+	47	448	624	0.7179487
C8	21470392	21471091	BolC8t48346H	0	-	57	309	699	0.4420601
C8	21483552	21484047	BolC8t48347H	0	-	27	192	495	0.3878788
C8	21487935	21495871	BolC8t48348H	0	-	5083	7850	7936	0.9891633
C8	21511470	21512178	BolC8t48349H	0	+	531	708	708	1.0000000
C8	21545009	21546691	BolC8t48350H	0	-	508	1536	1682	0.9131986
C8	21565993	21566275	BolC8t48351H	0	+	770	282	282	1.0000000
C8	21571718	21572842	BolC8t48352H	0	-	626	1124	1124	1.0000000
C8	21577321	21577973	BolC8t48353H	0	+	60	616	652	0.9447853
C8	21599533	21600631	BolC8t48354H	0	-	951	1098	1098	1.0000000
C8	21609925	21613989	BolC8t48355H	0	-	2037	3817	4064	0.9392225
C8	21614218	21614398	BolC8t48356H	0	-	130	180	180	1.0000000
C8	21619374	21624076	BolC8t48357H	0	+	896	2153	4702	0.4578903
C8	21624213	21625320	BolC8t48358H	0	+	2	113	1107	0.1020777
C8	21625958	21626345	BolC8t48359H	0	+	171	387	387	1.0000000
C8	21627508	21628712	BolC8t48360H	0	+	444	1204	1204	1.0000000
C8	21629365	21632229	BolC8t48361H	0	-	498	1807	2864	0.6309357
C8	21636162	21636608	BolC8t48362H	0	+	112	446	446	1.0000000
C8	21641948	21643197	BolC8t48363H	0	+	157	909	1249	0.7277822
C8	21655711	21657802	BolC8t48364H	0	+	255	1601	2091	0.7656624
C8	21658218	21659516	BolC8t48365H	0	+	259	1171	1298	0.9021572
C8	21659763	21662315	BolC8t48366H	0	-	615	1785	2552	0.6994514
C8	21663349	21664251	BolC8t48367H	0	+	128	857	902	0.9501109
C8	21683535	21684493	BolC8t48368H	0	-	340	958	958	1.0000000
C8	21702933	21704041	BolC8t48369H	0	-	378	1085	1108	0.9792418
C8	21719762	21720146	BolC8t48370H	0	+	11	84	384	0.2187500
C8	21722547	21723894	BolC8t48371H	0	-	138	1096	1347	0.8136600
C8	21751873	21754554	BolC8t48372H	0	+	2280	2667	2681	0.9947781
C8	21757553	21758584	BolC8t48373H	0	+	24	537	1031	0.5208535
C8	21759553	21759889	BolC8t48374H	0	-	16	215	336	0.6398810
C8	21768596	21768941	BolC8t48375H	0	-	32	143	345	0.4144928
C8	21774912	21776710	BolC8t48376H	0	+	712	1704	1798	0.9477197
C8	21777115	21777602	BolC8t48377H	0	-	260	480	487	0.9856263
C8	21778525	21780798	BolC8t48378H	0	-	1941	2273	2273	1.0000000
C8	21782306	21783346	BolC8t48379H	0	+	372	1040	1040	1.0000000
C8	21784583	21785768	BolC8t48380H	0	-	93	998	1185	0.8421941
C8	21789259	21789836	BolC8t48381H	0	-	123	190	577	0.3292894
C8	21792551	21793181	BolC8t48382H	0	-	86	420	630	0.6666667
C8	21799563	21806018	BolC8t48383H	0	-	669	1850	6455	0.2865995
C8	21821439	21825551	BolC8t48384H	0	-	1799	3974	4112	0.9664397
C8	21830429	21830875	BolC8t48385H	0	-	320	446	446	1.0000000
C8	21835856	21839007	BolC8t48386H	0	+	2318	2923	3151	0.9276420
C8	21839687	21841031	BolC8t48387H	0	-	1558	1344	1344	1.0000000
C8	21842050	21844616	BolC8t48388H	0	+	41	877	2566	0.3417771
C8	21845808	21846270	BolC8t48389H	0	-	10	1	462	0.0021645
C8	21858433	21861063	BolC8t48390H	0	-	1152	2562	2630	0.9741445
C8	21912814	21915044	BolC8t48391H	0	+	412	2140	2230	0.9596413
C8	21915724	21915871	BolC8t48392H	0	-	118	147	147	1.0000000
C8	21920093	21920273	BolC8t48393H	0	+	286	180	180	1.0000000
C8	21930192	21931330	BolC8t48394H	0	-	287	1138	1138	1.0000000
C8	21935529	21938816	BolC8t48395H	0	+	1909	3276	3287	0.9966535
C8	21939117	21947226	BolC8t48396H	0	+	1499	4998	8109	0.6163522
C8	21951320	21951719	BolC8t48397H	0	+	99	244	399	0.6115288
C8	21958311	21959835	BolC8t48398H	0	-	1004	1524	1524	1.0000000
C8	21964144	21964476	BolC8t48399H	0	+	219	332	332	1.0000000
C8	21964267	21964624	BolC8t48400H	0	+	234	357	357	1.0000000
C8	21967512	21968130	BolC8t48401H	0	-	66	424	618	0.6860842
C8	21997233	21998118	BolC8t48402H	0	+	667	885	885	1.0000000
C8	22003657	22004210	BolC8t48403H	0	+	474	553	553	1.0000000
C8	22004568	22004793	BolC8t48404H	0	+	194	225	225	1.0000000
C8	22005326	22005479	BolC8t48405H	0	+	148	153	153	1.0000000
C8	22006106	22006274	BolC8t48406H	0	+	188	168	168	1.0000000
C8	22018692	22020977	BolC8t48407H	0	-	2427	2285	2285	1.0000000
C8	22051123	22052998	BolC8t48408H	0	-	440	1875	1875	1.0000000
C8	22055452	22057124	BolC8t48409H	0	-	1058	1672	1672	1.0000000
C8	22061952	22063314	BolC8t48410H	0	-	252	949	1362	0.6967695
C8	22077906	22079484	BolC8t48411H	0	+	8	448	1578	0.2839037
C8	22084228	22088739	BolC8t48412H	0	-	2299	4511	4511	1.0000000
C8	22090914	22093392	BolC8t48413H	0	-	991	1911	2478	0.7711864
C8	22096342	22098055	BolC8t48414H	0	+	898	1713	1713	1.0000000
C8	22099016	22100741	BolC8t48415H	0	+	203	1071	1725	0.6208696
C8	22107105	22107264	BolC8t48416H	0	+	288	159	159	1.0000000
C8	22111472	22112505	BolC8t48417H	0	+	364	1033	1033	1.0000000
C8	22112592	22113714	BolC8t48418H	0	+	185	1122	1122	1.0000000
C8	22114340	22114604	BolC8t48419H	0	+	59	237	264	0.8977273
C8	22118030	22127747	BolC8t48420H	0	-	3364	6790	9717	0.6987754
C8	22135070	22135235	BolC8t48421H	0	+	21	130	165	0.7878788
C8	22138570	22139065	BolC8t48422H	0	+	3	164	495	0.3313131
C8	22140841	22142319	BolC8t48423H	0	-	1072	1416	1478	0.9580514
C8	22199709	22201192	BolC8t48424H	0	-	1306	1483	1483	1.0000000
C8	22203387	22204265	BolC8t48425H	0	+	170	878	878	1.0000000
C8	22205504	22205914	BolC8t48426H	0	+	109	410	410	1.0000000
C8	22208461	22211075	BolC8t48427H	0	-	1225	2614	2614	1.0000000
C8	22216606	22217066	BolC8t48428H	0	+	268	460	460	1.0000000
C8	22220781	22224303	BolC8t48429H	0	-	2152	3522	3522	1.0000000
C8	22226524	22228167	BolC8t48430H	0	-	270	1171	1643	0.7127206
C8	22237378	22237669	BolC8t48431H	0	-	56	291	291	1.0000000
C8	22243965	22245975	BolC8t48432H	0	+	820	1942	2010	0.9661692
C8	22246837	22247116	BolC8t48433H	0	+	276	279	279	1.0000000
C8	22247887	22248323	BolC8t48434H	0	-	108	436	436	1.0000000
C8	22250280	22250418	BolC8t48435H	0	-	202	138	138	1.0000000
C8	22250549	22250839	BolC8t48436H	0	-	388	290	290	1.0000000
C8	22261749	22284359	BolC8t48437H	0	-	1057	7595	22610	0.3359133
C8	22296481	22299247	BolC8t48438H	0	+	910	2612	2766	0.9443240
C8	22299571	22300877	BolC8t48439H	0	-	638	1306	1306	1.0000000
C8	22312357	22313996	BolC8t48440H	0	-	352	1357	1639	0.8279439
C8	22315938	22317540	BolC8t48441H	0	-	434	1535	1602	0.9581773
C8	22332103	22333584	BolC8t48442H	0	+	86	880	1481	0.5941931
C8	22339903	22340343	BolC8t48443H	0	-	274	440	440	1.0000000
C8	22348170	22349845	BolC8t48444H	0	+	549	1528	1675	0.9122388
C8	22360830	22361286	BolC8t48445H	0	+	168	422	456	0.9254386
C8	22364858	22367129	BolC8t48446H	0	-	34	805	2271	0.3544694
C8	22367712	22370807	BolC8t48447H	0	+	437	2410	3095	0.7786753
C8	22374832	22375750	BolC8t48448H	0	-	620	918	918	1.0000000
C8	22378475	22382615	BolC8t48449H	0	+	72	650	4140	0.1570048
C8	22387409	22389522	BolC8t48450H	0	-	8	357	2113	0.1689541
C8	22389726	22390326	BolC8t48451H	0	-	0	0	600	0.0000000
C8	22394645	22395278	BolC8t48452H	0	+	0	0	633	0.0000000
C8	22395983	22400154	BolC8t48453H	0	+	3	56	4171	0.0134260
C8	22401948	22403525	BolC8t48454H	0	+	0	0	1577	0.0000000
C8	22404072	22404546	BolC8t48455H	0	-	0	0	474	0.0000000
C8	22412041	22412967	BolC8t48456H	0	+	209	841	926	0.9082074
C8	22421214	22423000	BolC8t48457H	0	+	30	486	1786	0.2721165
C8	22425622	22426713	BolC8t48458H	0	+	636	1033	1091	0.9468378
C8	22434483	22434904	BolC8t48459H	0	-	273	421	421	1.0000000
C8	22436368	22436842	BolC8t48460H	0	+	1	97	474	0.2046414
C8	22441600	22444001	BolC8t48461H	0	-	2	182	2401	0.0758018
C8	22444653	22446273	BolC8t48462H	0	-	2	70	1620	0.0432099
C8	22447503	22452680	BolC8t48463H	0	-	1028	3699	5177	0.7145064
C8	22466707	22470138	BolC8t48464H	0	-	244	1929	3431	0.5622268
C8	22480614	22486029	BolC8t48465H	0	+	2861	5243	5415	0.9682364
C8	22486243	22487199	BolC8t48466H	0	-	693	956	956	1.0000000
C8	22490468	22490612	BolC8t48467H	0	+	22	144	144	1.0000000
C8	22501330	22501546	BolC8t48468H	0	+	304	216	216	1.0000000
C8	22508458	22509211	BolC8t48469H	0	+	31	460	753	0.6108898
C8	22513475	22513900	BolC8t48470H	0	+	77	328	425	0.7717647
C8	22514221	22514513	BolC8t48471H	0	-	136	292	292	1.0000000
C8	22519274	22522194	BolC8t48472H	0	+	434	1317	2920	0.4510274
C8	22531957	22532384	BolC8t48473H	0	+	0	0	427	0.0000000
C8	22534230	22535187	BolC8t48474H	0	-	2	99	957	0.1034483
C8	22541236	22541663	BolC8t48475H	0	+	9	185	427	0.4332553
C8	22543933	22544467	BolC8t48476H	0	-	0	0	534	0.0000000
C8	22552748	22553705	BolC8t48477H	0	-	2	209	957	0.2183908
C8	22562687	22562933	BolC8t48478H	0	-	0	0	246	0.0000000
C8	22568810	22569152	BolC8t48479H	0	-	391	342	342	1.0000000
C8	22569385	22569925	BolC8t48480H	0	-	1324	540	540	1.0000000
C8	22577697	22577838	BolC8t48481H	0	-	178	141	141	1.0000000
C8	22624491	22624662	BolC8t48482H	0	+	152	171	171	1.0000000
C8	22627389	22629645	BolC8t48483H	0	+	877	2244	2256	0.9946808
C8	22631558	22635331	BolC8t48484H	0	-	356	3245	3773	0.8600583
C8	22638743	22639397	BolC8t48485H	0	-	419	654	654	1.0000000
C8	22645924	22647402	BolC8t48486H	0	-	718	1348	1478	0.9120433
C8	22649281	22650560	BolC8t48487H	0	-	554	1279	1279	1.0000000
C8	22653144	22654017	BolC8t48488H	0	-	124	695	873	0.7961054
C8	22668609	22669377	BolC8t48489H	0	+	165	731	768	0.9518229
C8	22676797	22685338	BolC8t48490H	0	-	7062	8540	8541	0.9998829
C8	22686364	22686961	BolC8t48491H	0	+	1253	597	597	1.0000000
C8	22689647	22690031	BolC8t48492H	0	-	309	384	384	1.0000000
C8	22691704	22692055	BolC8t48493H	0	-	339	351	351	1.0000000
C8	22693388	22693671	BolC8t48494H	0	-	263	283	283	1.0000000
C8	22693761	22694844	BolC8t48495H	0	-	1423	1083	1083	1.0000000
C8	22698252	22698960	BolC8t48496H	0	-	41	664	708	0.9378531
C8	22710603	22711317	BolC8t48497H	0	-	0	0	714	0.0000000
C8	22714598	22715216	BolC8t48498H	0	-	486	618	618	1.0000000
C8	22717656	22719561	BolC8t48499H	0	+	320	1657	1905	0.8698162
C8	22719969	22721608	BolC8t48500H	0	-	812	1618	1639	0.9871873
C8	22722243	22724018	BolC8t48501H	0	-	48	766	1775	0.4315493
C8	22724783	22726010	BolC8t48502H	0	+	596	1227	1227	1.0000000
C8	22727199	22729627	BolC8t48503H	0	-	398	1874	2428	0.7718287
C8	22731597	22731982	BolC8t48504H	0	-	39	365	385	0.9480519
C8	22767804	22768029	BolC8t48505H	0	-	220	225	225	1.0000000
C8	22821023	22821176	BolC8t48506H	0	+	285	153	153	1.0000000
C8	22825019	22825136	BolC8t48507H	0	+	642	117	117	1.0000000
C8	22826447	22827932	BolC8t48508H	0	+	200	1089	1485	0.7333333
C8	22836424	22837317	BolC8t48509H	0	-	189	857	893	0.9596865
C8	22838282	22838795	BolC8t48510H	0	-	61	513	513	1.0000000
C8	22863963	22866579	BolC8t48511H	0	-	227	1692	2616	0.6467890
C8	22871528	22872245	BolC8t48512H	0	-	408	717	717	1.0000000
C8	22882708	22883841	BolC8t48513H	0	-	849	1133	1133	1.0000000
C8	22886659	22887190	BolC8t48514H	0	-	125	531	531	1.0000000
C8	22889661	22892868	BolC8t48515H	0	-	702	2603	3207	0.8116620
C8	22895186	22895650	BolC8t48516H	0	+	383	464	464	1.0000000
C8	22896503	22896713	BolC8t48517H	0	+	233	210	210	1.0000000
C8	22900133	22902427	BolC8t48518H	0	-	193	1603	2294	0.6987794
C8	22925290	22925576	BolC8t48519H	0	+	23	209	286	0.7307692
C8	22933272	22933593	BolC8t48520H	0	+	0	0	321	0.0000000
C8	22940720	22941050	BolC8t48521H	0	-	101	330	330	1.0000000
C8	22941319	22942159	BolC8t48522H	0	-	35	588	840	0.7000000
C8	22950228	22954027	BolC8t48523H	0	-	570	2979	3799	0.7841537
C8	22958816	22959473	BolC8t48524H	0	+	51	394	657	0.5996956
C8	22992293	22993178	BolC8t48525H	0	-	226	885	885	1.0000000
C8	23005781	23006358	BolC8t48526H	0	+	397	572	577	0.9913345
C8	23007004	23008239	BolC8t48527H	0	+	770	1235	1235	1.0000000
C8	23010860	23011128	BolC8t48528H	0	+	0	0	268	0.0000000
C8	23015492	23030437	BolC8t48529H	0	+	1591	6048	14945	0.4046838
C8	23040436	23042991	BolC8t48530H	0	+	298	1639	2555	0.6414873
C8	23049432	23050848	BolC8t48531H	0	+	301	1295	1416	0.9145480
C8	23058733	23059684	BolC8t48532H	0	+	376	951	951	1.0000000
C8	23060263	23061877	BolC8t48533H	0	-	875	1614	1614	1.0000000
C8	23066984	23068497	BolC8t48534H	0	-	330	1295	1513	0.8559154
C8	23070664	23070889	BolC8t48535H	0	+	0	0	225	0.0000000
C8	23074452	23075645	BolC8t48536H	0	+	518	1193	1193	1.0000000
C8	23085754	23086962	BolC8t48537H	0	-	224	1011	1208	0.8369206
C8	23087660	23088480	BolC8t48538H	0	-	78	670	820	0.8170732
C8	23100556	23101676	BolC8t48539H	0	+	369	1120	1120	1.0000000
C8	23104497	23107774	BolC8t48540H	0	+	482	2666	3277	0.8135490
C8	23108447	23117028	BolC8t48541H	0	+	535	3264	8581	0.3803752
C8	23129015	23129585	BolC8t48542H	0	-	506	570	570	1.0000000
C8	23130855	23131379	BolC8t48543H	0	+	43	500	524	0.9541985
C8	23176330	23177487	BolC8t48544H	0	+	67	699	1157	0.6041487
C8	23184257	23185562	BolC8t48545H	0	+	907	1198	1305	0.9180077
C8	23186584	23187775	BolC8t48546H	0	+	302	1034	1191	0.8681780
C8	23187810	23187990	BolC8t48547H	0	-	182	180	180	1.0000000
C8	23189537	23189678	BolC8t48548H	0	+	6	60	141	0.4255319
C8	23191269	23191598	BolC8t48549H	0	+	35	111	329	0.3373860
C8	23192011	23192325	BolC8t48550H	0	-	0	0	314	0.0000000
C8	23192361	23195147	BolC8t48551H	0	+	2	19	2786	0.0068198
C8	23197519	23197714	BolC8t48552H	0	+	81	184	195	0.9435897
C8	23201312	23204500	BolC8t48553H	0	-	953	2069	3188	0.6489962
C8	23216017	23216381	BolC8t48554H	0	-	523	364	364	1.0000000
C8	23216818	23221536	BolC8t48555H	0	+	1922	4232	4718	0.8969902
C8	23221997	23224282	BolC8t48556H	0	-	830	2109	2285	0.9229760
C8	23229672	23231077	BolC8t48557H	0	-	539	1081	1405	0.7693950
C8	23235560	23235816	BolC8t48558H	0	-	126	254	256	0.9921875
C8	23248256	23248586	BolC8t48559H	0	-	10	218	330	0.6606061
C8	23267518	23267869	BolC8t48560H	0	-	245	351	351	1.0000000
C8	23267936	23270368	BolC8t48561H	0	+	118	1274	2432	0.5238487
C8	23276368	23276683	BolC8t48562H	0	+	11	107	315	0.3396825
C8	23285583	23289151	BolC8t48563H	0	-	1695	3524	3568	0.9876682
C8	23289853	23291091	BolC8t48564H	0	+	201	1054	1238	0.8513732
C8	23291336	23291823	BolC8t48565H	0	-	362	443	487	0.9096509
C8	23295351	23298470	BolC8t48566H	0	+	1021	3112	3119	0.9977557
C8	23299469	23314556	BolC8t48567H	0	-	8099	13574	15087	0.8997150
C8	23306670	23307021	BolC8t48568H	0	+	196	351	351	1.0000000
C8	23315132	23325542	BolC8t48569H	0	-	5679	10207	10410	0.9804995
C8	23324115	23324469	BolC8t48570H	0	-	342	354	354	1.0000000
C8	23326519	23326894	BolC8t48571H	0	-	446	375	375	1.0000000
C8	23374707	23377710	BolC8t48572H	0	+	1334	2919	3003	0.9720280
C8	23380913	23381579	BolC8t48573H	0	+	217	643	666	0.9654655
C8	23382027	23382938	BolC8t48574H	0	-	735	911	911	1.0000000
C8	23383194	23384565	BolC8t48575H	0	+	271	1232	1371	0.8986142
C8	23419973	23421013	BolC8t48576H	0	+	770	1040	1040	1.0000000
C8	23421733	23424723	BolC8t48577H	0	+	2049	2990	2990	1.0000000
C8	23425952	23431095	BolC8t48578H	0	-	2182	4762	5143	0.9259187
C8	23449510	23451315	BolC8t48579H	0	+	1215	1785	1805	0.9889197
C8	23451670	23452151	BolC8t48580H	0	-	398	481	481	1.0000000
C8	23452534	23454308	BolC8t48581H	0	+	1042	1774	1774	1.0000000
C8	23456474	23456840	BolC8t48582H	0	+	595	366	366	1.0000000
C8	23457800	23458070	BolC8t48583H	0	+	178	270	270	1.0000000
C8	23463694	23464327	BolC8t48584H	0	-	166	586	633	0.9257504
C8	23475713	23478628	BolC8t48585H	0	+	1437	2915	2915	1.0000000
C8	23478996	23480286	BolC8t48586H	0	-	852	1290	1290	1.0000000
C8	23481679	23483098	BolC8t48587H	0	-	65	814	1419	0.5736434
C8	23506337	23511880	BolC8t48588H	0	-	3208	4653	5543	0.8394371
C8	23523508	23526021	BolC8t48589H	0	+	4094	2513	2513	1.0000000
C8	23529727	23530138	BolC8t48590H	0	+	621	411	411	1.0000000
C8	23539741	23540992	BolC8t48591H	0	+	5520	1251	1251	1.0000000
C8	23542756	23542996	BolC8t48592H	0	+	481	240	240	1.0000000
C8	23550383	23556052	BolC8t48593H	0	+	3048	5648	5669	0.9962956
C8	23559753	23560062	BolC8t48594H	0	-	116	309	309	1.0000000
C8	23561272	23564202	BolC8t48595H	0	-	47	619	2930	0.2112628
C8	23574691	23575632	BolC8t48596H	0	+	4	69	941	0.0733262
C8	23576918	23577619	BolC8t48597H	0	+	34	529	701	0.7546362
C8	23579154	23580039	BolC8t48598H	0	+	331	820	885	0.9265537
C8	23581169	23583296	BolC8t48599H	0	+	390	1540	2127	0.7240245
C8	23595511	23596829	BolC8t48600H	0	+	125	1071	1318	0.8125948
C8	23598882	23599260	BolC8t48601H	0	+	139	378	378	1.0000000
C8	23603340	23603790	BolC8t48602H	0	+	325	285	450	0.6333333
C8	23606107	23606242	BolC8t48603H	0	-	156	135	135	1.0000000
C8	23611715	23626550	BolC8t48604H	0	+	4921	8783	14835	0.5920458
C8	23627508	23630816	BolC8t48605H	0	-	1614	3198	3308	0.9667473
C8	23664423	23665126	BolC8t48606H	0	+	212	703	703	1.0000000
C8	23692725	23693597	BolC8t48607H	0	+	52	515	872	0.5905963
C8	23722760	23724576	BolC8t48608H	0	+	1392	1816	1816	1.0000000
C8	23725454	23727955	BolC8t48609H	0	-	2034	1982	2501	0.7924830
C8	23737972	23742622	BolC8t48610H	0	-	729	2129	4650	0.4578495
C8	23743320	23744073	BolC8t48611H	0	-	127	661	753	0.8778220
C8	23744419	23745016	BolC8t48612H	0	+	228	546	597	0.9145728
C8	23756879	23757109	BolC8t48613H	0	+	239	230	230	1.0000000
C8	23762973	23763569	BolC8t48614H	0	+	463	596	596	1.0000000
C8	23783866	23784700	BolC8t48615H	0	-	282	727	834	0.8717026
C8	23788145	23789442	BolC8t48616H	0	-	276	805	1297	0.6206630
C8	23797819	23800341	BolC8t48617H	0	-	282	2506	2522	0.9936558
C8	23804122	23804542	BolC8t48618H	0	-	98	420	420	1.0000000
C8	23809233	23810053	BolC8t48619H	0	-	20	571	820	0.6963415
C8	23811227	23813781	BolC8t48620H	0	-	132	1938	2554	0.7588097
C8	23818923	23820878	BolC8t48621H	0	+	441	1794	1955	0.9176471
C8	23825823	23828828	BolC8t48622H	0	+	494	2368	3005	0.7880200
C8	23830029	23832186	BolC8t48623H	0	+	1372	2157	2157	1.0000000
C8	23835787	23836600	BolC8t48624H	0	+	281	770	813	0.9471095
C8	23837199	23843464	BolC8t48625H	0	-	289	2589	6265	0.4132482
C8	23847513	23848073	BolC8t48626H	0	+	101	560	560	1.0000000
C8	23858472	23862291	BolC8t48627H	0	+	737	1725	3819	0.4516889
C8	23864148	23871821	BolC8t48628H	0	-	1773	7025	7673	0.9155480
C8	23882973	23884103	BolC8t48629H	0	+	1180	1130	1130	1.0000000
C8	23893196	23897037	BolC8t48630H	0	-	1347	3706	3841	0.9648529
C8	23903267	23904668	BolC8t48631H	0	-	563	1394	1401	0.9950036
C8	23910468	23911029	BolC8t48632H	0	+	29	391	561	0.6969697
C8	23934429	23936023	BolC8t48633H	0	+	867	1312	1594	0.8230866
C8	23950448	23951447	BolC8t48634H	0	+	818	999	999	1.0000000
C8	23960562	23961338	BolC8t48635H	0	+	172	776	776	1.0000000
C8	23966502	23968331	BolC8t48636H	0	-	628	1829	1829	1.0000000
C8	23982721	23983176	BolC8t48637H	0	+	206	455	455	1.0000000
C8	23984258	23985228	BolC8t48638H	0	+	39	764	970	0.7876289
C8	23985306	23987383	BolC8t48639H	0	+	42	1144	2077	0.5507944
C8	23988738	23989041	BolC8t48640H	0	-	59	303	303	1.0000000
C8	23992145	23992622	BolC8t48641H	0	+	362	477	477	1.0000000
C8	23993876	23994410	BolC8t48642H	0	+	369	534	534	1.0000000
C8	23995094	23995670	BolC8t48643H	0	+	371	576	576	1.0000000
C8	23998257	23999634	BolC8t48644H	0	-	736	1377	1377	1.0000000
C8	24001266	24001458	BolC8t48645H	0	-	8	111	192	0.5781250
C8	24005767	24015987	BolC8t48646H	0	+	772	4825	10220	0.4721135
C8	24017754	24019814	BolC8t48647H	0	+	1570	2060	2060	1.0000000
C8	24020329	24022612	BolC8t48648H	0	-	940	2283	2283	1.0000000
C8	24026233	24027720	BolC8t48649H	0	-	529	1434	1487	0.9643578
C8	24028203	24029329	BolC8t48650H	0	+	43	434	1126	0.3854352
C8	24044922	24047013	BolC8t48651H	0	+	9	79	2091	0.0377810
C8	24064863	24065043	BolC8t48652H	0	-	0	0	180	0.0000000
C8	24087090	24093958	BolC8t48653H	0	+	2146	6176	6868	0.8992429
C8	24096069	24096648	BolC8t48654H	0	-	7	324	579	0.5595855
C8	24097923	24099217	BolC8t48655H	0	+	60	947	1294	0.7318392
C8	24107093	24107739	BolC8t48656H	0	+	362	646	646	1.0000000
C8	24108513	24109220	BolC8t48657H	0	+	495	707	707	1.0000000
C8	24109312	24109575	BolC8t48658H	0	+	172	263	263	1.0000000
C8	24109812	24114571	BolC8t48659H	0	-	2241	4723	4759	0.9924354
C8	24117571	24119152	BolC8t48660H	0	-	1096	1581	1581	1.0000000
C8	24122361	24124096	BolC8t48661H	0	-	1177	1735	1735	1.0000000
C8	24139473	24141421	BolC8t48662H	0	+	476	1636	1948	0.8398357
C8	24149614	24150288	BolC8t48663H	0	+	1620	674	674	1.0000000
C8	24152869	24155054	BolC8t48664H	0	-	174	1655	2185	0.7574371
C8	24158597	24159198	BolC8t48665H	0	-	127	570	601	0.9484193
C8	24172469	24179136	BolC8t48666H	0	-	1147	5633	6667	0.8449078
C8	24180480	24183723	BolC8t48667H	0	-	638	2632	3243	0.8115942
C8	24189026	24189200	BolC8t48668H	0	-	50	174	174	1.0000000
C8	24190393	24191340	BolC8t48669H	0	-	921	891	947	0.9408659
C8	24205120	24205730	BolC8t48670H	0	-	517	610	610	1.0000000
C8	24207708	24210457	BolC8t48671H	0	-	1887	2731	2749	0.9934522
C8	24212513	24213247	BolC8t48672H	0	+	189	734	734	1.0000000
C8	24218839	24222915	BolC8t48673H	0	-	2259	4070	4076	0.9985279
C8	24224032	24225275	BolC8t48674H	0	-	497	1171	1243	0.9420756
C8	24225905	24226352	BolC8t48675H	0	-	297	447	447	1.0000000
C8	24227017	24228012	BolC8t48676H	0	+	523	995	995	1.0000000
C8	24229301	24231042	BolC8t48677H	0	-	704	1594	1741	0.9155658
C8	24232857	24233342	BolC8t48678H	0	+	30	239	485	0.4927835
C8	24235870	24236350	BolC8t48679H	0	+	58	480	480	1.0000000
C8	24245205	24246531	BolC8t48680H	0	+	995	1326	1326	1.0000000
C8	24263898	24264525	BolC8t48681H	0	-	369	627	627	1.0000000
C8	24267207	24269044	BolC8t48682H	0	-	1494	1837	1837	1.0000000
C8	24274505	24277048	BolC8t48683H	0	-	1000	1525	2543	0.5996854
C8	24281901	24282261	BolC8t48684H	0	-	334	360	360	1.0000000
C8	24301656	24303811	BolC8t48685H	0	+	1756	2155	2155	1.0000000
C8	24304781	24310235	BolC8t48686H	0	+	2588	5183	5454	0.9503117
C8	24310831	24313769	BolC8t48687H	0	-	1701	2938	2938	1.0000000
C8	24318706	24319006	BolC8t48688H	0	-	19	220	300	0.7333333
C8	24321364	24322369	BolC8t48689H	0	+	0	0	1005	0.0000000
C8	24326783	24328873	BolC8t48690H	0	+	368	1497	2090	0.7162679
C8	24333245	24333884	BolC8t48691H	0	+	0	0	639	0.0000000
C8	24347105	24347990	BolC8t48692H	0	+	336	869	885	0.9819209
C8	24348443	24349724	BolC8t48693H	0	-	1693	1281	1281	1.0000000
C8	24363942	24365099	BolC8t48694H	0	+	2372	1157	1157	1.0000000
C8	24366467	24367491	BolC8t48695H	0	-	582	1024	1024	1.0000000
C8	24370527	24373960	BolC8t48696H	0	+	1431	3278	3433	0.9548500
C8	24374497	24375688	BolC8t48697H	0	-	514	1191	1191	1.0000000
C8	24376546	24378870	BolC8t48698H	0	-	517	2162	2324	0.9302926
C8	24379550	24386744	BolC8t48699H	0	-	1951	5365	7194	0.7457604
C8	24382622	24384995	BolC8t48700H	0	+	102	1078	2373	0.4542773
C8	24387636	24388059	BolC8t48701H	0	+	156	413	423	0.9763594
C8	24410723	24411011	BolC8t48702H	0	+	24	259	288	0.8993056
C8	24411128	24411977	BolC8t48703H	0	+	59	290	849	0.3415783
C8	24420561	24424682	BolC8t48704H	0	+	2607	3938	4121	0.9555933
C8	24425312	24426410	BolC8t48705H	0	-	328	1046	1098	0.9526412
C8	24433547	24434159	BolC8t48706H	0	+	528	542	612	0.8856209
C8	24434469	24436030	BolC8t48707H	0	-	226	1086	1561	0.6957079
C8	24444141	24444486	BolC8t48708H	0	+	274	345	345	1.0000000
C8	24445325	24450573	BolC8t48709H	0	+	735	4996	5248	0.9519817
C8	24460474	24461451	BolC8t48710H	0	-	263	963	977	0.9856704
C8	24461834	24462017	BolC8t48711H	0	-	121	183	183	1.0000000
C8	24463971	24466254	BolC8t48712H	0	+	400	2105	2283	0.9220324
C8	24466767	24467242	BolC8t48713H	0	+	726	475	475	1.0000000
C8	24468034	24472111	BolC8t48714H	0	-	1115	3698	4077	0.9070395
C8	24508146	24508383	BolC8t48715H	0	+	186	237	237	1.0000000
C8	24509665	24509869	BolC8t48716H	0	+	232	204	204	1.0000000
C8	24511742	24511961	BolC8t48717H	0	+	85	219	219	1.0000000
C8	24513334	24513640	BolC8t48718H	0	+	145	306	306	1.0000000
C8	24516462	24516654	BolC8t48719H	0	+	260	192	192	1.0000000
C8	24518104	24518413	BolC8t48720H	0	+	22	309	309	1.0000000
C8	24519254	24520160	BolC8t48721H	0	+	155	879	906	0.9701987
C8	24520601	24521006	BolC8t48722H	0	+	20	372	405	0.9185185
C8	24521467	24522133	BolC8t48723H	0	+	476	666	666	1.0000000
C8	24524752	24525167	BolC8t48724H	0	+	244	415	415	1.0000000
C8	24535776	24541604	BolC8t48725H	0	+	1726	5069	5828	0.8697667
C8	24542816	24544374	BolC8t48726H	0	+	757	1354	1558	0.8690629
C8	24550203	24551779	BolC8t48727H	0	+	431	1555	1576	0.9866751
C8	24571608	24577927	BolC8t48728H	0	-	3399	6270	6319	0.9922456
C8	24606545	24607532	BolC8t48729H	0	-	79	703	987	0.7122594
C8	24614233	24621262	BolC8t48730H	0	-	2049	6059	7029	0.8620003
C8	24616134	24616867	BolC8t48731H	0	+	50	584	733	0.7967258
C8	24627507	24628120	BolC8t48732H	0	+	242	613	613	1.0000000
C8	24629686	24631898	BolC8t48733H	0	-	922	2129	2212	0.9624774
C8	24632463	24633755	BolC8t48734H	0	+	0	0	1292	0.0000000
C8	24650887	24651115	BolC8t48735H	0	-	34	228	228	1.0000000
C8	24656369	24663977	BolC8t48736H	0	+	1746	5955	7608	0.7827287
C8	24664160	24672351	BolC8t48737H	0	-	2001	6157	8191	0.7516786
C8	24674444	24674749	BolC8t48738H	0	+	183	305	305	1.0000000
C8	24675339	24676173	BolC8t48739H	0	-	3	182	834	0.2182254
C8	24678693	24681626	BolC8t48740H	0	-	862	2717	2933	0.9263552
C8	24684303	24685924	BolC8t48741H	0	+	253	1305	1621	0.8050586
C8	24699752	24700013	BolC8t48742H	0	-	199	261	261	1.0000000
C8	24705672	24707322	BolC8t48743H	0	+	841	1604	1650	0.9721212
C8	24708785	24709379	BolC8t48744H	0	-	119	594	594	1.0000000
C8	24715017	24715644	BolC8t48745H	0	+	287	621	627	0.9904306
C8	24718047	24718281	BolC8t48746H	0	+	73	234	234	1.0000000
C8	24732743	24733176	BolC8t48747H	0	-	250	433	433	1.0000000
C8	24737558	24737798	BolC8t48748H	0	+	138	240	240	1.0000000
C8	24750049	24750211	BolC8t48749H	0	-	312	162	162	1.0000000
C8	24752814	24753188	BolC8t48750H	0	+	786	374	374	1.0000000
C8	24758478	24758739	BolC8t48751H	0	-	0	0	261	0.0000000
C8	24764109	24765902	BolC8t48752H	0	+	577	1704	1793	0.9503625
C8	24766858	24767482	BolC8t48753H	0	+	219	624	624	1.0000000
C8	24768825	24769083	BolC8t48754H	0	-	24	76	258	0.2945736
C8	24769676	24770138	BolC8t48755H	0	-	433	462	462	1.0000000
C8	24776725	24778774	BolC8t48756H	0	+	103	1481	2049	0.7227916
C8	24779326	24780185	BolC8t48757H	0	-	322	859	859	1.0000000
C8	24782733	24786205	BolC8t48758H	0	+	1070	3111	3472	0.8960254
C8	24787128	24788637	BolC8t48759H	0	-	368	1509	1509	1.0000000
C8	24799545	24800681	BolC8t48760H	0	+	604	1134	1136	0.9982395
C8	24809206	24809425	BolC8t48761H	0	+	1	107	219	0.4885845
C8	24810386	24815314	BolC8t48762H	0	-	2517	4742	4928	0.9622565
C8	24830385	24833765	BolC8t48763H	0	-	548	2031	3380	0.6008876
C8	24839281	24839647	BolC8t48764H	0	+	314	366	366	1.0000000
C8	24862338	24867967	BolC8t48765H	0	+	2766	5533	5629	0.9829454
C8	24879164	24879299	BolC8t48766H	0	+	0	0	135	0.0000000
C8	24896105	24898303	BolC8t48767H	0	-	163	1490	2198	0.6778890
C8	24902687	24905287	BolC8t48768H	0	+	1312	2588	2600	0.9953846
C8	24907289	24907647	BolC8t48769H	0	+	43	270	358	0.7541900
C8	24907939	24908281	BolC8t48770H	0	+	10	163	342	0.4766082
C8	24910405	24912073	BolC8t48771H	0	-	683	1498	1668	0.8980815
C8	24940695	24942170	BolC8t48772H	0	+	140	1258	1475	0.8528814
C8	24947059	24947853	BolC8t48773H	0	-	82	438	794	0.5516373
C8	24952932	24954019	BolC8t48774H	0	+	415	948	1087	0.8721251
C8	24954303	24954937	BolC8t48775H	0	+	84	630	634	0.9936908
C8	24955198	24956088	BolC8t48776H	0	-	160	890	890	1.0000000
C8	24967590	24968339	BolC8t48777H	0	+	694	749	749	1.0000000
C8	24969449	24970706	BolC8t48778H	0	-	143	925	1257	0.7358791
C8	24973442	24976010	BolC8t48779H	0	+	1949	2544	2568	0.9906542
C8	24977152	24979684	BolC8t48780H	0	-	1213	2532	2532	1.0000000
C8	24987875	24988331	BolC8t48781H	0	+	41	283	456	0.6206141
C8	25006507	25006813	BolC8t48782H	0	+	293	306	306	1.0000000
C8	25012026	25012143	BolC8t48783H	0	-	19	117	117	1.0000000
C8	25012834	25013448	BolC8t48784H	0	-	9	261	614	0.4250814
C8	25028215	25041872	BolC8t48785H	0	-	8227	13453	13657	0.9850626
C8	25038037	25038442	BolC8t48786H	0	-	258	401	405	0.9901235
C8	25048951	25049371	BolC8t48787H	0	-	284	420	420	1.0000000
C8	25055131	25055559	BolC8t48788H	0	+	157	354	428	0.8271028
C8	25056856	25057177	BolC8t48789H	0	+	2	20	321	0.0623053
C8	25066207	25066752	BolC8t48790H	0	+	0	0	545	0.0000000
C8	25090440	25090698	BolC8t48791H	0	+	0	0	258	0.0000000
C8	25115167	25116515	BolC8t48792H	0	+	29	659	1348	0.4888724
C8	25119911	25120320	BolC8t48793H	0	-	72	332	409	0.8117359
C8	25132696	25134238	BolC8t48794H	0	-	5	172	1542	0.1115434
C8	25134555	25135279	BolC8t48795H	0	-	628	517	724	0.7140884
C8	25135516	25136476	BolC8t48796H	0	+	1167	960	960	1.0000000
C8	25141042	25141369	BolC8t48797H	0	+	91	327	327	1.0000000
C8	25143651	25144434	BolC8t48798H	0	+	11	507	783	0.6475096
C8	25168403	25189759	BolC8t48799H	0	+	10793	19263	21356	0.9019948
C8	25171714	25172230	BolC8t48800H	0	-	347	516	516	1.0000000
C8	25186206	25188135	BolC8t48801H	0	-	1038	1861	1929	0.9647486
C8	25188697	25189327	BolC8t48802H	0	+	743	630	630	1.0000000
C8	25190676	25191458	BolC8t48803H	0	+	2	154	782	0.1969309
C8	25193616	25194236	BolC8t48804H	0	-	654	620	620	1.0000000
C8	25215335	25215746	BolC8t48805H	0	+	2	179	411	0.4355231
C8	25240907	25241603	BolC8t48806H	0	+	394	628	696	0.9022989
C8	25247886	25248069	BolC8t48807H	0	+	7	78	183	0.4262295
C8	25259530	25259923	BolC8t48808H	0	+	185	312	393	0.7938932
C8	25262800	25278784	BolC8t48809H	0	-	21196	13908	15984	0.8701201
C8	25284483	25285235	BolC8t48810H	0	+	0	0	752	0.0000000
C8	25292245	25296321	BolC8t48811H	0	+	869	3461	4076	0.8491168
C8	25306115	25307811	BolC8t48812H	0	+	50	1096	1696	0.6462264
C8	25318012	25319629	BolC8t48813H	0	+	75	1259	1617	0.7786024
C8	25326236	25327352	BolC8t48814H	0	-	181	1029	1116	0.9220430
C8	25329981	25330215	BolC8t48815H	0	+	4	128	234	0.5470086
C8	25330975	25331674	BolC8t48816H	0	-	5	178	699	0.2546495
C8	25332702	25333686	BolC8t48817H	0	-	3	110	984	0.1117886
C8	25335121	25336165	BolC8t48818H	0	+	0	0	1044	0.0000000
C8	25348965	25349297	BolC8t48819H	0	+	2	19	332	0.0572289
C8	25364883	25365979	BolC8t48820H	0	-	64	161	1096	0.1468978
C8	25392441	25392725	BolC8t48821H	0	-	262	268	284	0.9436620
C8	25393941	25394717	BolC8t48822H	0	-	145	695	776	0.8956186
C8	25406817	25409648	BolC8t48823H	0	+	2058	2801	2831	0.9894030
C8	25411062	25417278	BolC8t48824H	0	+	2323	4685	6216	0.7537001
C8	25419100	25420262	BolC8t48825H	0	+	99	929	1162	0.7994837
C8	25421138	25423423	BolC8t48826H	0	+	711	1993	2285	0.8722101
C8	25433030	25434532	BolC8t48827H	0	+	2	167	1502	0.1111851
C8	25447115	25476302	BolC8t48828H	0	+	6942	22409	29187	0.7677733
C8	25464355	25465387	BolC8t48829H	0	-	431	1032	1032	1.0000000
C8	25489498	25492327	BolC8t48830H	0	-	747	2692	2829	0.9515730
C8	25495557	25499269	BolC8t48831H	0	+	1733	3673	3712	0.9894935
C8	25505177	25506336	BolC8t48832H	0	+	977	1159	1159	1.0000000
C8	25508522	25509465	BolC8t48833H	0	+	234	882	943	0.9353128
C8	25510649	25512381	BolC8t48834H	0	-	731	1723	1732	0.9948037
C8	25516116	25518595	BolC8t48835H	0	+	942	2445	2479	0.9862848
C8	25525828	25526740	BolC8t48836H	0	-	709	912	912	1.0000000
C8	25530006	25533072	BolC8t48837H	0	+	691	2993	3066	0.9761904
C8	25534428	25561198	BolC8t48838H	0	+	3267	14255	26770	0.5324991
C8	25539303	25541415	BolC8t48839H	0	-	365	1481	2112	0.7012311
C8	25545268	25547189	BolC8t48840H	0	+	10	354	1921	0.1842790
C8	25545418	25545959	BolC8t48841H	0	-	1	37	541	0.0683919
C8	25561716	25564765	BolC8t48842H	0	-	1188	1459	3049	0.4785175
C8	25567194	25567461	BolC8t48843H	0	+	140	267	267	1.0000000
C8	25572298	25572451	BolC8t48844H	0	+	27	153	153	1.0000000
C8	25574313	25576422	BolC8t48845H	0	+	49	1321	2109	0.6263632
C8	25578421	25579404	BolC8t48846H	0	+	301	983	983	1.0000000
C8	25589937	25591281	BolC8t48847H	0	+	499	1344	1344	1.0000000
C8	25593559	25593787	BolC8t48848H	0	+	343	228	228	1.0000000
C8	25594222	25594398	BolC8t48849H	0	+	41	176	176	1.0000000
C8	25607865	25608281	BolC8t48850H	0	-	1449	416	416	1.0000000
C8	25612634	25622074	BolC8t48851H	0	+	4399	7905	9440	0.8373941
C8	25643638	25643842	BolC8t48852H	0	+	128	204	204	1.0000000
C8	25644265	25644580	BolC8t48853H	0	+	307	315	315	1.0000000
C8	25648790	25649464	BolC8t48854H	0	-	647	674	674	1.0000000
C8	25683037	25685572	BolC8t48855H	0	+	1762	2535	2535	1.0000000
C8	25690424	25690742	BolC8t48856H	0	+	88	318	318	1.0000000
C8	25690695	25691853	BolC8t48857H	0	+	422	1158	1158	1.0000000
C8	25693814	25699621	BolC8t48858H	0	+	1629	5807	5807	1.0000000
C8	25695890	25696090	BolC8t48859H	0	+	162	200	200	1.0000000
C8	25700696	25700900	BolC8t48860H	0	+	185	204	204	1.0000000
C8	25706413	25707395	BolC8t48861H	0	-	12	205	982	0.2087576
C8	25708549	25709093	BolC8t48862H	0	-	558	544	544	1.0000000
C8	25710126	25711084	BolC8t48863H	0	-	619	958	958	1.0000000
C8	25712431	25714511	BolC8t48864H	0	-	93	506	2080	0.2432692
C8	25714600	25714915	BolC8t48865H	0	+	20	159	315	0.5047619
C8	25715434	25715876	BolC8t48866H	0	-	10	331	442	0.7488688
C8	25716943	25717258	BolC8t48867H	0	-	205	315	315	1.0000000
C8	25725498	25727045	BolC8t48868H	0	+	1361	1456	1547	0.9411765
C8	25725941	25726602	BolC8t48869H	0	+	427	595	661	0.9001513
C8	25728389	25731223	BolC8t48870H	0	-	1089	2496	2834	0.8807340
C8	25732976	25733989	BolC8t48871H	0	-	202	648	1013	0.6396841
C8	25735786	25738102	BolC8t48872H	0	-	1542	2316	2316	1.0000000
C8	25740300	25740827	BolC8t48873H	0	-	188	507	527	0.9620494
C8	25740883	25745276	BolC8t48874H	0	+	1775	4254	4393	0.9683588
C8	25746914	25747543	BolC8t48875H	0	-	522	629	629	1.0000000
C8	25751734	25754581	BolC8t48876H	0	+	253	2573	2847	0.9037583
C8	25764680	25767992	BolC8t48877H	0	+	592	3120	3312	0.9420290
C8	25771182	25772286	BolC8t48878H	0	+	406	1104	1104	1.0000000
C8	25773519	25787657	BolC8t48879H	0	+	6239	13956	14138	0.9871269
C8	25788031	25792157	BolC8t48880H	0	-	2482	4109	4126	0.9958798
C8	25792898	25796908	BolC8t48881H	0	-	1584	3995	4010	0.9962593
C8	25798928	25802643	BolC8t48882H	0	+	2702	3662	3715	0.9857335
C8	25802973	25806881	BolC8t48883H	0	-	2434	3871	3908	0.9905322
C8	25810896	25811850	BolC8t48884H	0	+	187	792	954	0.8301887
C8	25813239	25815092	BolC8t48885H	0	-	1278	1853	1853	1.0000000
C8	25815917	25817667	BolC8t48886H	0	+	1934	1750	1750	1.0000000
C8	25818969	25819948	BolC8t48887H	0	-	681	979	979	1.0000000
C8	25821474	25823765	BolC8t48888H	0	-	2040	2208	2291	0.9637713
C8	25824950	25830200	BolC8t48889H	0	-	2417	5185	5250	0.9876190
C8	25834726	25837561	BolC8t48890H	0	+	2072	2829	2835	0.9978836
C8	25838866	25841760	BolC8t48891H	0	+	1726	2894	2894	1.0000000
C8	25842192	25844275	BolC8t48892H	0	-	1087	2068	2083	0.9927989
C8	25845106	25847766	BolC8t48893H	0	-	1433	2660	2660	1.0000000
C8	25848359	25849829	BolC8t48894H	0	-	1050	1470	1470	1.0000000
C8	25849978	25850265	BolC8t48895H	0	-	240	287	287	1.0000000
C8	25859778	25862577	BolC8t48896H	0	+	637	2396	2799	0.8560200
C8	25869378	25870845	BolC8t48897H	0	-	954	1467	1467	1.0000000
C8	25871302	25874434	BolC8t48898H	0	+	1922	3117	3132	0.9952107
C8	25875013	25879982	BolC8t48899H	0	+	3236	4969	4969	1.0000000
C8	25876345	25877916	BolC8t48900H	0	-	947	1571	1571	1.0000000
C8	25880450	25880612	BolC8t48901H	0	+	180	162	162	1.0000000
C8	25890895	25891798	BolC8t48902H	0	+	8	305	903	0.3377630
C8	25896370	25898087	BolC8t48903H	0	+	187	808	1717	0.4705882
C8	25898294	25899971	BolC8t48904H	0	-	1665	1677	1677	1.0000000
C8	25903126	25904020	BolC8t48905H	0	+	52	812	894	0.9082774
C8	25907084	25909126	BolC8t48906H	0	+	1079	2025	2042	0.9916748
C8	25920827	25922556	BolC8t48907H	0	+	1048	1729	1729	1.0000000
C8	25923224	25923557	BolC8t48908H	0	-	341	333	333	1.0000000
C8	25923924	25926885	BolC8t48909H	0	-	327	1922	2961	0.6491050
C8	25927391	25929734	BolC8t48910H	0	+	1244	2306	2343	0.9842083
C8	25939360	25939939	BolC8t48911H	0	-	86	552	579	0.9533679
C8	25940478	25941462	BolC8t48912H	0	+	0	0	984	0.0000000
C8	25958302	25959580	BolC8t48913H	0	-	46	927	1278	0.7253521
C8	25962266	25964873	BolC8t48914H	0	-	2353	2607	2607	1.0000000
C8	25967034	25967421	BolC8t48915H	0	+	106	386	387	0.9974160
C8	25969042	25969384	BolC8t48916H	0	+	2	50	342	0.1461988
C8	25997895	25998369	BolC8t48917H	0	-	129	411	474	0.8670886
C8	26020366	26020771	BolC8t48918H	0	-	279	405	405	1.0000000
C8	26022881	26023064	BolC8t48919H	0	+	158	183	183	1.0000000
C8	26024060	26024825	BolC8t48920H	0	+	480	765	765	1.0000000
C8	26026777	26027576	BolC8t48921H	0	+	498	799	799	1.0000000
C8	26030948	26034435	BolC8t48922H	0	+	1996	3487	3487	1.0000000
C8	26035276	26036511	BolC8t48923H	0	+	291	1036	1235	0.8388664
C8	26037004	26037594	BolC8t48924H	0	-	504	590	590	1.0000000
C8	26044761	26045441	BolC8t48925H	0	-	621	680	680	1.0000000
C8	26051072	26052321	BolC8t48926H	0	+	268	1212	1249	0.9703763
C8	26053943	26069334	BolC8t48927H	0	-	8629	13220	15391	0.8589435
C8	26105173	26105916	BolC8t48928H	0	+	164	706	743	0.9502019
C8	26116860	26119460	BolC8t48929H	0	-	889	2517	2600	0.9680769
C8	26117684	26119061	BolC8t48930H	0	+	486	1327	1377	0.9636892
C8	26120198	26121362	BolC8t48931H	0	+	201	672	1164	0.5773196
C8	26128523	26129797	BolC8t48932H	0	+	436	1191	1274	0.9348509
C8	26130422	26131254	BolC8t48933H	0	+	177	832	832	1.0000000
C8	26131905	26142059	BolC8t48934H	0	+	5318	8304	10154	0.8178058
C8	26137327	26137804	BolC8t48935H	0	+	7	228	477	0.4779874
C8	26142371	26142629	BolC8t48936H	0	-	224	258	258	1.0000000
C8	26144889	26146091	BolC8t48937H	0	+	1377	1202	1202	1.0000000
C8	26150411	26154499	BolC8t48938H	0	+	2000	4088	4088	1.0000000
C8	26154885	26156761	BolC8t48939H	0	-	1356	1876	1876	1.0000000
C8	26157904	26158737	BolC8t48940H	0	-	371	833	833	1.0000000
C8	26159204	26160651	BolC8t48941H	0	-	428	1447	1447	1.0000000
C8	26161230	26167187	BolC8t48942H	0	-	2010	5363	5957	0.9002854
C8	26167480	26168797	BolC8t48943H	0	+	913	1317	1317	1.0000000
C8	26171553	26171889	BolC8t48944H	0	+	151	336	336	1.0000000
C8	26174408	26175764	BolC8t48945H	0	+	425	1298	1356	0.9572271
C8	26176429	26177916	BolC8t48946H	0	-	619	1459	1487	0.9811701
C8	26178396	26181344	BolC8t48947H	0	+	688	2887	2948	0.9793080
C8	26181713	26184340	BolC8t48948H	0	-	625	2382	2627	0.9067377
C8	26185258	26187917	BolC8t48949H	0	-	1947	2659	2659	1.0000000
C8	26190045	26190822	BolC8t48950H	0	+	82	728	777	0.9369369
C8	26191550	26193761	BolC8t48951H	0	-	1117	2211	2211	1.0000000
C8	26196676	26197381	BolC8t48952H	0	+	2	130	705	0.1843972
C8	26201688	26202030	BolC8t48953H	0	-	70	302	342	0.8830410
C8	26219417	26222533	BolC8t48954H	0	-	1875	3116	3116	1.0000000
C8	26223827	26225854	BolC8t48955H	0	-	1158	2027	2027	1.0000000
C8	26226064	26227144	BolC8t48956H	0	-	202	936	1080	0.8666667
C8	26228628	26228811	BolC8t48957H	0	-	0	0	183	0.0000000
C8	26229445	26230277	BolC8t48958H	0	+	0	0	832	0.0000000
C8	26235222	26236844	BolC8t48959H	0	-	706	1622	1622	1.0000000
C8	26237832	26240388	BolC8t48960H	0	-	2053	2504	2556	0.9796557
C8	26244284	26245898	BolC8t48961H	0	-	1580	1614	1614	1.0000000
C8	26253048	26253787	BolC8t48962H	0	+	44	560	739	0.7577808
C8	26259763	26260985	BolC8t48963H	0	-	213	1222	1222	1.0000000
C8	26270283	26273272	BolC8t48964H	0	+	1444	2989	2989	1.0000000
C8	26276750	26278306	BolC8t48965H	0	-	762	1513	1556	0.9723650
C8	26281449	26283355	BolC8t48966H	0	+	1816	1906	1906	1.0000000
C8	26285201	26287174	BolC8t48967H	0	-	1893	1973	1973	1.0000000
C8	26301823	26304402	BolC8t48968H	0	+	1518	2490	2579	0.9654905
C8	26306833	26308738	BolC8t48969H	0	+	2060	1905	1905	1.0000000
C8	26308994	26312110	BolC8t48970H	0	-	1466	2968	3116	0.9525032
C8	26312180	26316495	BolC8t48971H	0	-	2484	3860	4315	0.8945539
C8	26332628	26333102	BolC8t48972H	0	-	514	474	474	1.0000000
C8	26334761	26335919	BolC8t48973H	0	+	143	943	1158	0.8143350
C8	26336575	26339893	BolC8t48974H	0	-	201	1286	3318	0.3875829
C8	26340684	26344560	BolC8t48975H	0	-	1197	3092	3876	0.7977296
C8	26344882	26345386	BolC8t48976H	0	-	99	286	504	0.5674603
C8	26347043	26368081	BolC8t48977H	0	+	1351	5023	21038	0.2387584
C8	26362459	26364316	BolC8t48978H	0	+	0	0	1857	0.0000000
C8	26371678	26371894	BolC8t48979H	0	+	0	0	216	0.0000000
C8	26373421	26373715	BolC8t48980H	0	-	0	0	294	0.0000000
C8	26377101	26377799	BolC8t48981H	0	+	1	24	698	0.0343840
C8	26377843	26378883	BolC8t48982H	0	+	0	0	1040	0.0000000
C8	26380869	26382499	BolC8t48983H	0	+	4	161	1630	0.0987730
C8	26384163	26385631	BolC8t48984H	0	+	295	1307	1468	0.8903270
C8	26386727	26387231	BolC8t48985H	0	-	72	244	504	0.4841270
C8	26388825	26389915	BolC8t48986H	0	-	81	853	1090	0.7825688
C8	26392316	26392958	BolC8t48987H	0	+	118	428	642	0.6666667
C8	26394469	26395221	BolC8t48988H	0	-	23	367	752	0.4880319
C8	26397214	26399680	BolC8t48989H	0	+	2141	2437	2466	0.9882401
C8	26400115	26402228	BolC8t48990H	0	-	1628	2113	2113	1.0000000
C8	26405755	26412055	BolC8t48991H	0	+	3802	5971	6300	0.9477777
C8	26414522	26415608	BolC8t48992H	0	+	0	0	1086	0.0000000
C8	26416082	26416584	BolC8t48993H	0	+	0	0	502	0.0000000
C8	26416757	26417255	BolC8t48994H	0	-	0	0	498	0.0000000
C8	26427812	26428580	BolC8t48995H	0	+	0	0	768	0.0000000
C8	26429291	26429874	BolC8t48996H	0	+	1	150	583	0.2572899
C8	26430051	26430549	BolC8t48997H	0	-	0	0	498	0.0000000
C8	26431847	26455916	BolC8t48998H	0	-	11135	17559	24069	0.7295276
C8	26449996	26450837	BolC8t48999H	0	-	759	841	841	1.0000000
C8	26459423	26460915	BolC8t49000H	0	-	718	1492	1492	1.0000000
C8	26469776	26470655	BolC8t49001H	0	+	28	495	879	0.5631399
C8	26471980	26476011	BolC8t49002H	0	+	2558	4031	4031	1.0000000
C8	26476977	26480122	BolC8t49003H	0	+	993	3094	3145	0.9837838
C8	26480558	26485202	BolC8t49004H	0	-	579	3941	4644	0.8486219
C8	26489072	26495581	BolC8t49005H	0	-	793	5556	6509	0.8535873
C8	26503766	26504869	BolC8t49006H	0	-	1025	1103	1103	1.0000000
C8	26512877	26513498	BolC8t49007H	0	+	451	621	621	1.0000000
C8	26520547	26526035	BolC8t49008H	0	+	2834	5418	5488	0.9872449
C8	26526280	26527353	BolC8t49009H	0	-	756	1073	1073	1.0000000
C8	26536008	26539245	BolC8t49010H	0	+	1494	3237	3237	1.0000000
C8	26539720	26543299	BolC8t49011H	0	+	1707	3564	3579	0.9958089
C8	26551655	26553148	BolC8t49012H	0	-	1105	1493	1493	1.0000000
C8	26568631	26570196	BolC8t49013H	0	+	237	849	1565	0.5424920
C8	26576905	26578785	BolC8t49014H	0	-	1121	1880	1880	1.0000000
C8	26581182	26581593	BolC8t49015H	0	-	456	411	411	1.0000000
C8	26605887	26606825	BolC8t49016H	0	-	36	539	938	0.5746269
C8	26610934	26611316	BolC8t49017H	0	+	3	140	382	0.3664922
C8	26612324	26612828	BolC8t49018H	0	-	12	417	504	0.8273810
C8	26613805	26617104	BolC8t49019H	0	-	1020	2979	3299	0.9030009
C8	26618973	26621886	BolC8t49020H	0	+	1195	2704	2913	0.9282526
C8	26624570	26625922	BolC8t49021H	0	+	467	1352	1352	1.0000000
C8	26626490	26628792	BolC8t49022H	0	-	232	1659	2302	0.7206777
C8	26646768	26647962	BolC8t49023H	0	-	27	418	1194	0.3500837
C8	26663486	26666740	BolC8t49024H	0	+	1957	2851	3254	0.8761525
C8	26667326	26667740	BolC8t49025H	0	+	555	414	414	1.0000000
C8	26692330	26694227	BolC8t49026H	0	-	3	121	1897	0.0637849
C8	26701075	26703248	BolC8t49027H	0	-	464	1853	2173	0.8527381
C8	26710526	26717206	BolC8t49028H	0	-	1636	3961	6680	0.5929641
C8	26728027	26735815	BolC8t49029H	0	-	4240	7788	7788	1.0000000
C8	26741418	26741709	BolC8t49030H	0	-	217	291	291	1.0000000
C8	26742450	26745034	BolC8t49031H	0	-	1629	2584	2584	1.0000000
C8	26746231	26748301	BolC8t49032H	0	-	834	2038	2070	0.9845411
C8	26753418	26753976	BolC8t49033H	0	-	370	558	558	1.0000000
C8	26770138	26781248	BolC8t49034H	0	+	2999	7946	11110	0.7152115
C8	26773643	26774311	BolC8t49035H	0	+	76	470	668	0.7035928
C8	26774803	26775439	BolC8t49036H	0	+	209	507	636	0.7971698
C8	26781849	26784476	BolC8t49037H	0	+	2087	2627	2627	1.0000000
C8	26785094	26794115	BolC8t49038H	0	-	2194	5978	9021	0.6626760
C8	26789686	26791004	BolC8t49039H	0	-	0	0	1318	0.0000000
C8	26795657	26802010	BolC8t49040H	0	-	2155	5865	6353	0.9231859
C8	26806063	26807058	BolC8t49041H	0	-	388	995	995	1.0000000
C8	26807609	26808513	BolC8t49042H	0	+	2	17	904	0.0188053
C8	26810384	26814181	BolC8t49043H	0	+	1507	3685	3797	0.9705030
C8	26815150	26815597	BolC8t49044H	0	+	144	423	447	0.9463087
C8	26816284	26818531	BolC8t49045H	0	+	816	2159	2247	0.9608366
C8	26819799	26821629	BolC8t49046H	0	-	936	1830	1830	1.0000000
C8	26822752	26825751	BolC8t49047H	0	-	597	2631	2999	0.8772925
C8	26833182	26834148	BolC8t49048H	0	+	116	764	966	0.7908903
C8	26835091	26835286	BolC8t49049H	0	-	13	108	195	0.5538462
C8	26837115	26838932	BolC8t49050H	0	+	2527	1817	1817	1.0000000
C8	26839895	26842424	BolC8t49051H	0	+	271	1250	2529	0.4942665
C8	26869819	26870786	BolC8t49052H	0	-	714	963	967	0.9958635
C8	26881045	26881225	BolC8t49053H	0	+	0	0	180	0.0000000
C8	26881665	26883964	BolC8t49054H	0	-	352	1166	2299	0.5071771
C8	26886435	26887526	BolC8t49055H	0	-	400	821	1091	0.7525206
C8	26887897	26889176	BolC8t49056H	0	+	320	1079	1279	0.8436278
C8	26890559	26890909	BolC8t49057H	0	+	0	0	350	0.0000000
C8	26891599	26892814	BolC8t49058H	0	-	41	210	1215	0.1728395
C8	26892986	26893340	BolC8t49059H	0	+	283	354	354	1.0000000
C8	26894733	26895168	BolC8t49060H	0	-	11	179	435	0.4114943
C8	26898419	26899120	BolC8t49061H	0	-	228	679	701	0.9686162
C8	26899503	26900274	BolC8t49062H	0	-	274	771	771	1.0000000
C8	26902583	26905593	BolC8t49063H	0	-	636	2773	3010	0.9212624
C8	26907207	26907424	BolC8t49064H	0	+	186	217	217	1.0000000
C8	26907375	26908485	BolC8t49065H	0	+	598	1110	1110	1.0000000
C8	26909372	26909921	BolC8t49066H	0	+	43	226	549	0.4116576
C8	26909994	26915834	BolC8t49067H	0	+	2579	4817	5840	0.8248287
C8	26916578	26916827	BolC8t49068H	0	-	6	230	249	0.9236948
C8	26917086	26917248	BolC8t49069H	0	-	441	162	162	1.0000000
C8	26918763	26921192	BolC8t49070H	0	-	428	2353	2429	0.9687114
C8	26922949	26925959	BolC8t49071H	0	+	800	2447	3010	0.8129568
C8	26926109	26929001	BolC8t49072H	0	-	1519	2726	2892	0.9426003
C8	26930661	26930964	BolC8t49073H	0	-	30	159	303	0.5247525
C8	26933812	26943903	BolC8t49074H	0	-	1657	6832	10091	0.6770390
C8	26951745	26952734	BolC8t49075H	0	+	605	989	989	1.0000000
C8	26952956	26953161	BolC8t49076H	0	+	178	205	205	1.0000000
C8	26954706	26955048	BolC8t49077H	0	-	420	342	342	1.0000000
C8	26959222	26959456	BolC8t49078H	0	+	4	49	234	0.2094017
C8	26960196	26960405	BolC8t49079H	0	+	0	0	209	0.0000000
C8	26960892	26962468	BolC8t49080H	0	-	875	1566	1576	0.9936548
C8	26964945	26966939	BolC8t49081H	0	+	26	839	1994	0.4207623
C8	26968852	26973107	BolC8t49082H	0	-	854	2741	4255	0.6441833
C8	26975176	26976334	BolC8t49083H	0	+	312	1138	1158	0.9827288
C8	26976413	26980070	BolC8t49084H	0	+	1106	3123	3657	0.8539787
C8	26981273	26981822	BolC8t49085H	0	-	157	516	549	0.9398907
C8	26983409	26984265	BolC8t49086H	0	+	189	856	856	1.0000000
C8	26992832	26994208	BolC8t49087H	0	-	7	109	1376	0.0792151
C8	27002104	27002533	BolC8t49088H	0	-	51	109	429	0.2540793
C8	27004958	27005387	BolC8t49089H	0	-	5	58	429	0.1351981
C8	27014145	27014527	BolC8t49090H	0	-	45	261	382	0.6832461
C8	27017174	27017561	BolC8t49091H	0	+	0	0	387	0.0000000
C8	27028150	27029716	BolC8t49092H	0	-	649	1103	1566	0.7043422
C8	27032527	27033160	BolC8t49093H	0	+	53	455	633	0.7187994
C8	27039346	27041107	BolC8t49094H	0	+	10	398	1761	0.2260080
C8	27047016	27047151	BolC8t49095H	0	+	145	135	135	1.0000000
C8	27066425	27067330	BolC8t49096H	0	+	640	905	905	1.0000000
C8	27068026	27071142	BolC8t49097H	0	+	762	2996	3116	0.9614891
C8	27071961	27073651	BolC8t49098H	0	+	764	1591	1690	0.9414201
C8	27074214	27075159	BolC8t49099H	0	+	111	706	945	0.7470899
C8	27076323	27077548	BolC8t49100H	0	+	426	1085	1225	0.8857143
C8	27078346	27079629	BolC8t49101H	0	+	758	1283	1283	1.0000000
C8	27080116	27080506	BolC8t49102H	0	+	127	390	390	1.0000000
C8	27093273	27093543	BolC8t49103H	0	+	204	270	270	1.0000000
C8	27097419	27100524	BolC8t49104H	0	+	269	1978	3105	0.6370370
C8	27101707	27102134	BolC8t49105H	0	+	338	427	427	1.0000000
C8	27107775	27108087	BolC8t49106H	0	+	46	242	312	0.7756410
C8	27116029	27117184	BolC8t49107H	0	-	66	532	1155	0.4606061
C8	27118742	27122521	BolC8t49108H	0	+	1103	2684	3779	0.7102408
C8	27132602	27132875	BolC8t49109H	0	+	29	222	273	0.8131868
C8	27132950	27133106	BolC8t49110H	0	+	77	156	156	1.0000000
C8	27134246	27135779	BolC8t49111H	0	+	268	974	1533	0.6353555
C8	27159705	27160059	BolC8t49112H	0	+	386	354	354	1.0000000
C8	27160357	27161420	BolC8t49113H	0	-	365	1063	1063	1.0000000
C8	27162469	27163974	BolC8t49114H	0	+	481	1390	1505	0.9235880
C8	27169121	27172071	BolC8t49115H	0	-	586	2481	2950	0.8410169
C8	27200056	27202093	BolC8t49116H	0	+	151	1805	2037	0.8861070
C8	27202911	27203892	BolC8t49117H	0	+	315	861	981	0.8776758
C8	27206038	27206374	BolC8t49118H	0	+	199	336	336	1.0000000
C8	27209674	27209893	BolC8t49119H	0	+	178	219	219	1.0000000
C8	27213394	27214176	BolC8t49120H	0	+	284	782	782	1.0000000
C8	27227895	27232922	BolC8t49121H	0	+	1538	4862	5027	0.9671773
C8	27236237	27238363	BolC8t49122H	0	-	721	1935	2126	0.9101599
C8	27240281	27242230	BolC8t49123H	0	+	1309	1893	1949	0.9712673
C8	27242686	27245161	BolC8t49124H	0	-	1614	2475	2475	1.0000000
C8	27247801	27254995	BolC8t49125H	0	+	4655	6971	7194	0.9690019
C8	27251311	27253133	BolC8t49126H	0	-	412	1702	1822	0.9341383
C8	27257868	27259483	BolC8t49127H	0	+	1183	1615	1615	1.0000000
C8	27259723	27262451	BolC8t49128H	0	-	1590	2725	2728	0.9989003
C8	27262846	27265270	BolC8t49129H	0	+	2049	2424	2424	1.0000000
C8	27265649	27267763	BolC8t49130H	0	-	1730	2114	2114	1.0000000
C8	27268736	27269964	BolC8t49131H	0	+	449	1228	1228	1.0000000
C8	27271175	27275120	BolC8t49132H	0	-	2322	3927	3945	0.9954373
C8	27295493	27299611	BolC8t49133H	0	+	1511	3676	4118	0.8926663
C8	27301382	27301727	BolC8t49134H	0	+	223	345	345	1.0000000
C8	27307844	27309182	BolC8t49135H	0	-	424	1230	1338	0.9192825
C8	27309290	27309509	BolC8t49136H	0	-	271	219	219	1.0000000
C8	27310900	27315610	BolC8t49137H	0	+	1109	3686	4710	0.7825902
C8	27316064	27317813	BolC8t49138H	0	+	1130	1749	1749	1.0000000
C8	27318134	27320599	BolC8t49139H	0	-	1649	2444	2465	0.9914807
C8	27321543	27324939	BolC8t49140H	0	-	1976	3353	3396	0.9873381
C8	27328146	27330324	BolC8t49141H	0	-	0	0	2178	0.0000000
C8	27335465	27341752	BolC8t49142H	0	-	2132	4371	6287	0.6952441
C8	27346332	27347007	BolC8t49143H	0	-	242	662	675	0.9807407
C8	27348467	27350075	BolC8t49144H	0	-	880	1509	1608	0.9384328
C8	27352979	27355229	BolC8t49145H	0	+	2121	1915	2250	0.8511111
C8	27355870	27356506	BolC8t49146H	0	+	427	570	636	0.8962264
C8	27357682	27357870	BolC8t49147H	0	-	235	188	188	1.0000000
C8	27358718	27376645	BolC8t49148H	0	-	6192	17872	17927	0.9969320
C8	27387476	27387887	BolC8t49149H	0	+	317	411	411	1.0000000
C8	27401565	27401979	BolC8t49150H	0	-	67	413	414	0.9975845
C8	27405616	27406015	BolC8t49151H	0	+	104	399	399	1.0000000
C8	27427819	27431842	BolC8t49152H	0	+	1569	4018	4023	0.9987571
C8	27434870	27436304	BolC8t49153H	0	-	1288	1434	1434	1.0000000
C8	27440587	27442503	BolC8t49154H	0	+	1144	1916	1916	1.0000000
C8	27442587	27444335	BolC8t49155H	0	-	386	1703	1748	0.9742563
C8	27445403	27445784	BolC8t49156H	0	+	102	381	381	1.0000000
C8	27448917	27449980	BolC8t49157H	0	+	549	1063	1063	1.0000000
C8	27452833	27454199	BolC8t49158H	0	-	35	474	1366	0.3469985
C8	27456543	27457209	BolC8t49159H	0	-	219	666	666	1.0000000
C8	27464387	27464699	BolC8t49160H	0	+	969	312	312	1.0000000
C8	27472096	27473065	BolC8t49161H	0	+	77	775	969	0.7997936
C8	27474630	27474786	BolC8t49162H	0	-	0	0	156	0.0000000
C8	27479251	27482988	BolC8t49163H	0	-	2844	3425	3737	0.9165106
C8	27490025	27490472	BolC8t49164H	0	-	308	447	447	1.0000000
C8	27492889	27493660	BolC8t49165H	0	+	344	771	771	1.0000000
C8	27497496	27499284	BolC8t49166H	0	+	385	1451	1788	0.8115212
C8	27507347	27509600	BolC8t49167H	0	-	527	2224	2253	0.9871283
C8	27523183	27525442	BolC8t49168H	0	-	175	1605	2259	0.7104914
C8	27528782	27529847	BolC8t49169H	0	+	879	1061	1065	0.9962441
C8	27530611	27530916	BolC8t49170H	0	+	100	284	305	0.9311475
C8	27543585	27545693	BolC8t49171H	0	-	525	2108	2108	1.0000000
C8	27551887	27553264	BolC8t49172H	0	+	431	1371	1377	0.9956427
C8	27554516	27560554	BolC8t49173H	0	+	1244	3846	6038	0.6369659
C8	27562080	27563702	BolC8t49174H	0	-	689	1615	1622	0.9956843
C8	27571166	27572632	BolC8t49175H	0	-	616	1466	1466	1.0000000
C8	27574663	27575705	BolC8t49176H	0	+	187	936	1042	0.8982726
C8	27576094	27576732	BolC8t49177H	0	-	369	638	638	1.0000000
C8	27579945	27583800	BolC8t49178H	0	+	2727	3855	3855	1.0000000
C8	27584230	27587163	BolC8t49179H	0	-	857	2334	2933	0.7957723
C8	27596593	27598897	BolC8t49180H	0	+	1233	2304	2304	1.0000000
C8	27599519	27602052	BolC8t49181H	0	-	2108	2533	2533	1.0000000
C8	27626988	27627597	BolC8t49182H	0	-	343	609	609	1.0000000
C8	27630603	27632430	BolC8t49183H	0	-	1317	1827	1827	1.0000000
C8	27634589	27636430	BolC8t49184H	0	-	1542	1841	1841	1.0000000
C8	27642092	27642662	BolC8t49185H	0	+	88	373	570	0.6543860
C8	27647936	27648486	BolC8t49186H	0	-	558	550	550	1.0000000
C8	27650979	27652812	BolC8t49187H	0	+	1431	1833	1833	1.0000000
C8	27653713	27654159	BolC8t49188H	0	-	391	446	446	1.0000000
C8	27655494	27658952	BolC8t49189H	0	+	1331	3144	3458	0.9091961
C8	27659172	27661138	BolC8t49190H	0	-	1055	1966	1966	1.0000000
C8	27663999	27664846	BolC8t49191H	0	-	550	846	847	0.9988194
C8	27667682	27667904	BolC8t49192H	0	+	19	45	222	0.2027027
C8	27669429	27670667	BolC8t49193H	0	+	1301	1238	1238	1.0000000
C8	27671092	27673303	BolC8t49194H	0	-	1710	2211	2211	1.0000000
C8	27681223	27681439	BolC8t49195H	0	+	219	216	216	1.0000000
C8	27687270	27687828	BolC8t49196H	0	-	548	558	558	1.0000000
C8	27688159	27690332	BolC8t49197H	0	+	654	2052	2173	0.9443166
C8	27690931	27691264	BolC8t49198H	0	-	229	333	333	1.0000000
C8	27691805	27693126	BolC8t49199H	0	-	843	1321	1321	1.0000000
C8	27710139	27711756	BolC8t49200H	0	+	996	1521	1617	0.9406308
C8	27712355	27713663	BolC8t49201H	0	-	241	1256	1308	0.9602447
C8	27729158	27730956	BolC8t49202H	0	+	143	861	1798	0.4788654
C8	27732278	27735171	BolC8t49203H	0	+	3035	2893	2893	1.0000000
C8	27743889	27745849	BolC8t49204H	0	-	759	1953	1960	0.9964285
C8	27746771	27750417	BolC8t49205H	0	+	1349	3623	3646	0.9936917
C8	27751290	27753069	BolC8t49206H	0	+	403	1779	1779	1.0000000
C8	27753557	27755152	BolC8t49207H	0	+	197	1397	1595	0.8758621
C8	27761455	27763034	BolC8t49208H	0	+	323	1244	1579	0.7878404
C8	27764390	27771158	BolC8t49209H	0	+	2933	5660	6768	0.8362884
C8	27777564	27779124	BolC8t49210H	0	+	784	1560	1560	1.0000000
C8	27780155	27782972	BolC8t49211H	0	+	1977	2817	2817	1.0000000
C8	27785862	27786015	BolC8t49212H	0	+	169	153	153	1.0000000
C8	27786455	27788036	BolC8t49213H	0	-	466	1581	1581	1.0000000
C8	27788790	27789783	BolC8t49214H	0	+	1188	993	993	1.0000000
C8	27792576	27794944	BolC8t49215H	0	+	1538	2368	2368	1.0000000
C8	27806829	27808060	BolC8t49216H	0	+	16	654	1231	0.5312754
C8	27813465	27813657	BolC8t49217H	0	+	17	192	192	1.0000000
C8	27819092	27819248	BolC8t49218H	0	+	54	144	156	0.9230769
C8	27828357	27829909	BolC8t49219H	0	-	914	1552	1552	1.0000000
C8	27857042	27866512	BolC8t49220H	0	+	4111	9135	9470	0.9646251
C8	27868736	27869186	BolC8t49221H	0	+	181	450	450	1.0000000
C8	27873082	27873682	BolC8t49222H	0	+	19	233	600	0.3883333
C8	27880348	27880516	BolC8t49223H	0	+	200	168	168	1.0000000
C8	27884696	27885989	BolC8t49224H	0	-	339	1159	1293	0.8963650
C8	27911975	27913568	BolC8t49225H	0	+	552	1519	1593	0.9535468
C8	27917767	27917887	BolC8t49226H	0	-	10	62	120	0.5166667
C8	27939701	27941941	BolC8t49227H	0	+	857	2178	2240	0.9723215
C8	27942588	27943421	BolC8t49228H	0	+	256	771	833	0.9255702
C8	27946368	27947968	BolC8t49229H	0	+	129	1099	1600	0.6868750
C8	27950633	27952555	BolC8t49230H	0	-	1082	1920	1922	0.9989594
C8	27954456	27955827	BolC8t49231H	0	-	252	1294	1371	0.9438366
C8	27958444	27958999	BolC8t49232H	0	-	128	549	555	0.9891892
C8	27967250	27968547	BolC8t49233H	0	-	55	700	1297	0.5397070
C8	27982053	27982888	BolC8t49234H	0	+	389	835	835	1.0000000
C8	27985079	27985346	BolC8t49235H	0	+	774	267	267	1.0000000
C8	27989179	27989869	BolC8t49236H	0	-	11	312	690	0.4521739
C8	27991206	27997726	BolC8t49237H	0	+	2143	5932	6520	0.9098160
C8	28002352	28004149	BolC8t49238H	0	+	819	1797	1797	1.0000000
C8	28004799	28007620	BolC8t49239H	0	-	856	2821	2821	1.0000000
C8	28010765	28011567	BolC8t49240H	0	+	753	802	802	1.0000000
C8	28012080	28013046	BolC8t49241H	0	-	611	966	966	1.0000000
C8	28013487	28014300	BolC8t49242H	0	+	724	813	813	1.0000000
C8	28017070	28018309	BolC8t49243H	0	-	176	1075	1239	0.8676352
C8	28020769	28021186	BolC8t49244H	0	-	291	417	417	1.0000000
C8	28030676	28031284	BolC8t49245H	0	+	375	608	608	1.0000000
C8	28031322	28031965	BolC8t49246H	0	+	443	643	643	1.0000000
C8	28036145	28036379	BolC8t49247H	0	+	13	102	234	0.4358974
C8	28037165	28038052	BolC8t49248H	0	+	130	887	887	1.0000000
C8	28038959	28041721	BolC8t49249H	0	+	1668	2762	2762	1.0000000
C8	28043010	28043684	BolC8t49250H	0	+	208	674	674	1.0000000
C8	28044625	28045606	BolC8t49251H	0	-	340	981	981	1.0000000
C8	28046806	28049344	BolC8t49252H	0	+	992	2538	2538	1.0000000
C8	28050131	28050363	BolC8t49253H	0	+	205	232	232	1.0000000
C8	28079078	28080377	BolC8t49254H	0	+	2	112	1299	0.0862202
C8	28098753	28099743	BolC8t49255H	0	-	566	990	990	1.0000000
C8	28101909	28102899	BolC8t49256H	0	-	662	990	990	1.0000000
C8	28103399	28104443	BolC8t49257H	0	+	167	1003	1044	0.9607280
C8	28108192	28108900	BolC8t49258H	0	-	274	701	708	0.9901130
C8	28110692	28111595	BolC8t49259H	0	-	593	903	903	1.0000000
C8	28112776	28114090	BolC8t49260H	0	+	726	1314	1314	1.0000000
C8	28114950	28117566	BolC8t49261H	0	-	1163	2532	2616	0.9678899
C8	28118407	28120101	BolC8t49262H	0	+	1119	1694	1694	1.0000000
C8	28128724	28129195	BolC8t49263H	0	+	329	471	471	1.0000000
C8	28133927	28134314	BolC8t49264H	0	+	241	387	387	1.0000000
C8	28135127	28137910	BolC8t49265H	0	-	1532	2783	2783	1.0000000
C8	28154297	28154549	BolC8t49266H	0	-	7	31	252	0.1230159
C8	28160894	28163544	BolC8t49267H	0	-	979	1727	2650	0.6516981
C8	28170307	28178956	BolC8t49268H	0	+	5297	8095	8649	0.9359463
C8	28179017	28180972	BolC8t49269H	0	+	1244	1955	1955	1.0000000
C8	28181711	28183150	BolC8t49270H	0	-	714	1439	1439	1.0000000
C8	28184398	28186469	BolC8t49271H	0	+	955	2011	2071	0.9710285
C8	28187346	28187817	BolC8t49272H	0	-	164	471	471	1.0000000
C8	28192842	28196947	BolC8t49273H	0	+	1200	3861	4105	0.9405603
C8	28198617	28198803	BolC8t49274H	0	+	54	186	186	1.0000000
C8	28199222	28199417	BolC8t49275H	0	+	88	195	195	1.0000000
C8	28207710	28215809	BolC8t49276H	0	+	767	2985	8099	0.3685640
C8	28221765	28222146	BolC8t49277H	0	-	13	219	381	0.5748032
C8	28222609	28223208	BolC8t49278H	0	-	20	302	599	0.5041736
C8	28225058	28225426	BolC8t49279H	0	-	0	0	368	0.0000000
C8	28236521	28238278	BolC8t49280H	0	+	200	1680	1757	0.9561753
C8	28238799	28239970	BolC8t49281H	0	-	151	997	1171	0.8514091
C8	28241650	28242782	BolC8t49282H	0	-	291	1004	1132	0.8869258
C8	28249326	28250309	BolC8t49283H	0	-	117	771	983	0.7843336
C8	28258154	28260165	BolC8t49284H	0	-	1597	2009	2011	0.9990055
C8	28261530	28262664	BolC8t49285H	0	+	667	1134	1134	1.0000000
C8	28263681	28264928	BolC8t49286H	0	-	886	1247	1247	1.0000000
C8	28265698	28266531	BolC8t49287H	0	+	107	833	833	1.0000000
C8	28268093	28269147	BolC8t49288H	0	+	143	906	1054	0.8595825
C8	28269632	28272515	BolC8t49289H	0	-	1970	2883	2883	1.0000000
C8	28274903	28276497	BolC8t49290H	0	-	948	1587	1594	0.9956085
C8	28277022	28277691	BolC8t49291H	0	+	193	661	669	0.9880419
C8	28278485	28280265	BolC8t49292H	0	-	324	1543	1780	0.8668540
C8	28282108	28304308	BolC8t49293H	0	-	5767	11401	22200	0.5135586
C8	28301566	28302287	BolC8t49294H	0	+	477	721	721	1.0000000
C8	28304984	28306604	BolC8t49295H	0	-	600	1590	1620	0.9814815
C8	28308412	28315266	BolC8t49296H	0	-	1170	2823	6854	0.4118763
C8	28317143	28318889	BolC8t49297H	0	+	931	1612	1746	0.9232532
C8	28320222	28322564	BolC8t49298H	0	+	1299	2342	2342	1.0000000
C8	28333231	28334613	BolC8t49299H	0	+	16	309	1382	0.2235890
C8	28338010	28342983	BolC8t49300H	0	-	2918	4973	4973	1.0000000
C8	28343792	28346279	BolC8t49301H	0	+	912	2284	2487	0.9183756
C8	28354861	28357284	BolC8t49302H	0	+	974	2357	2423	0.9727610
C8	28358577	28360964	BolC8t49303H	0	+	1021	2387	2387	1.0000000
C8	28362444	28363260	BolC8t49304H	0	+	243	762	816	0.9338235
C8	28363927	28365385	BolC8t49305H	0	-	707	982	1458	0.6735254
C8	28374926	28375091	BolC8t49306H	0	-	2	51	165	0.3090909
C8	28379883	28380337	BolC8t49307H	0	-	14	20	454	0.0440529
C8	28383485	28383879	BolC8t49308H	0	-	3	183	394	0.4644670
C8	28391054	28392487	BolC8t49309H	0	-	9	466	1433	0.3251919
C8	28397063	28397496	BolC8t49310H	0	-	0	0	433	0.0000000
C8	28399660	28401087	BolC8t49311H	0	-	226	1075	1427	0.7533287
C8	28415692	28418106	BolC8t49312H	0	+	1318	2414	2414	1.0000000
C8	28426396	28428523	BolC8t49313H	0	-	2180	2127	2127	1.0000000
C8	28429384	28429771	BolC8t49314H	0	+	150	387	387	1.0000000
C8	28429970	28430339	BolC8t49315H	0	-	150	369	369	1.0000000
C8	28430381	28430648	BolC8t49316H	0	+	115	267	267	1.0000000
C8	28431605	28433798	BolC8t49317H	0	-	1303	2193	2193	1.0000000
C8	28434851	28437385	BolC8t49318H	0	-	1112	2433	2534	0.9601421
C8	28456743	28458607	BolC8t49319H	0	-	1212	1852	1864	0.9935622
C8	28459256	28462872	BolC8t49320H	0	-	1724	3616	3616	1.0000000
C8	28463520	28464101	BolC8t49321H	0	+	594	581	581	1.0000000
C8	28478610	28479216	BolC8t49322H	0	+	331	590	606	0.9735973
C8	28480361	28480922	BolC8t49323H	0	-	409	561	561	1.0000000
C8	28483659	28486367	BolC8t49324H	0	+	73	1303	2708	0.4811669
C8	28490761	28491181	BolC8t49325H	0	+	105	363	420	0.8642857
C8	28491592	28494777	BolC8t49326H	0	-	2300	3112	3185	0.9770800
C8	28495534	28495959	BolC8t49327H	0	+	527	425	425	1.0000000
C8	28496573	28498465	BolC8t49328H	0	-	1423	1883	1892	0.9952431
C8	28518519	28520572	BolC8t49329H	0	+	476	1757	2053	0.8558208
C8	28531311	28532046	BolC8t49330H	0	+	436	735	735	1.0000000
C8	28532296	28538225	BolC8t49331H	0	-	786	4688	5929	0.7906898
C8	28539984	28540627	BolC8t49332H	0	-	320	643	643	1.0000000
C8	28542315	28543159	BolC8t49333H	0	-	574	844	844	1.0000000
C8	28543656	28547207	BolC8t49334H	0	+	2281	3527	3551	0.9932414
C8	28548559	28551212	BolC8t49335H	0	-	1902	2653	2653	1.0000000
C8	28552014	28553545	BolC8t49336H	0	-	1410	1531	1531	1.0000000
C8	28555396	28556634	BolC8t49337H	0	-	973	1238	1238	1.0000000
C8	28564000	28564414	BolC8t49338H	0	+	332	414	414	1.0000000
C8	28566312	28567199	BolC8t49339H	0	+	76	719	887	0.8105975
C8	28574259	28574676	BolC8t49340H	0	+	0	0	417	0.0000000
C8	28583667	28584417	BolC8t49341H	0	-	20	425	750	0.5666667
C8	28585786	28586044	BolC8t49342H	0	-	29	216	258	0.8372093
C8	28587162	28588118	BolC8t49343H	0	+	93	835	956	0.8734310
C8	28596444	28596603	BolC8t49344H	0	-	142	159	159	1.0000000
C8	28611163	28612688	BolC8t49345H	0	-	15	315	1525	0.2065574
C8	28621764	28622150	BolC8t49346H	0	-	2	19	386	0.0492228
C8	28630116	28631641	BolC8t49347H	0	-	94	722	1525	0.4734426
C8	28632750	28634229	BolC8t49348H	0	-	1255	1479	1479	1.0000000
C8	28637160	28637901	BolC8t49349H	0	+	268	737	741	0.9946019
C8	28638232	28641377	BolC8t49350H	0	-	1598	3035	3145	0.9650239
C8	28647605	28649745	BolC8t49351H	0	+	1206	2131	2140	0.9957944
C8	28651466	28652470	BolC8t49352H	0	+	1030	1004	1004	1.0000000
C8	28672077	28675633	BolC8t49353H	0	+	1791	3548	3556	0.9977503
C8	28675966	28677106	BolC8t49354H	0	-	730	1140	1140	1.0000000
C8	28677692	28683347	BolC8t49355H	0	-	1577	4648	5655	0.8219275
C8	28684977	28686099	BolC8t49356H	0	-	264	1041	1122	0.9278075
C8	28688710	28689614	BolC8t49357H	0	-	381	904	904	1.0000000
C8	28690677	28691854	BolC8t49358H	0	+	1854	1172	1177	0.9957519
C8	28692279	28693415	BolC8t49359H	0	-	1056	1136	1136	1.0000000
C8	28698792	28699430	BolC8t49360H	0	+	428	638	638	1.0000000
C8	28700374	28704344	BolC8t49361H	0	+	2790	3970	3970	1.0000000
C8	28704685	28706044	BolC8t49362H	0	-	882	1359	1359	1.0000000
C8	28710030	28711983	BolC8t49363H	0	-	537	1920	1953	0.9831029
C8	28713156	28714730	BolC8t49364H	0	+	745	1574	1574	1.0000000
C8	28715453	28715720	BolC8t49365H	0	-	282	267	267	1.0000000
C8	28717764	28721443	BolC8t49366H	0	+	1472	3585	3679	0.9744496
C8	28722579	28722870	BolC8t49367H	0	+	143	291	291	1.0000000
C8	28732224	28734529	BolC8t49368H	0	-	323	1826	2305	0.7921909
C8	28739924	28741356	BolC8t49369H	0	-	1416	1432	1432	1.0000000
C8	28745818	28750398	BolC8t49370H	0	-	4867	4580	4580	1.0000000
C8	28751608	28754583	BolC8t49371H	0	-	575	2311	2975	0.7768067
C8	28761161	28762697	BolC8t49372H	0	+	243	1454	1536	0.9466146
C8	28764318	28767132	BolC8t49373H	0	-	890	2631	2814	0.9349680
C8	28768347	28771269	BolC8t49374H	0	-	1330	2709	2922	0.9271047
C8	28772795	28779619	BolC8t49375H	0	+	1441	4995	6824	0.7319754
C8	28775915	28776920	BolC8t49376H	0	-	1	31	1005	0.0308458
C8	28788012	28797576	BolC8t49377H	0	+	3894	9421	9564	0.9850481
C8	28798262	28798640	BolC8t49378H	0	-	226	378	378	1.0000000
C8	28799053	28801603	BolC8t49379H	0	+	439	2101	2550	0.8239216
C8	28801859	28804242	BolC8t49380H	0	-	1443	2240	2383	0.9399916
C8	28807803	28818147	BolC8t49381H	0	+	3121	9656	10344	0.9334880
C8	28820381	28822061	BolC8t49382H	0	+	842	1680	1680	1.0000000
C8	28822880	28823292	BolC8t49383H	0	-	374	412	412	1.0000000
C8	28826108	28827840	BolC8t49384H	0	+	1584	1732	1732	1.0000000
C8	28828218	28829738	BolC8t49385H	0	-	1486	1520	1520	1.0000000
C8	28831060	28834085	BolC8t49386H	0	-	3272	3025	3025	1.0000000
C8	28836704	28838927	BolC8t49387H	0	-	1602	2223	2223	1.0000000
C8	28841790	28844082	BolC8t49388H	0	+	1598	2292	2292	1.0000000
C8	28844814	28846020	BolC8t49389H	0	-	1007	1206	1206	1.0000000
C8	28847904	28849308	BolC8t49390H	0	-	977	1404	1404	1.0000000
C8	28853981	28854254	BolC8t49391H	0	+	4	93	273	0.3406594
C8	28859933	28861022	BolC8t49392H	0	+	257	1010	1089	0.9274564
C8	28861808	28864695	BolC8t49393H	0	-	102	1140	2887	0.3948736
C8	28867771	28868205	BolC8t49394H	0	-	448	434	434	1.0000000
C8	28868368	28869620	BolC8t49395H	0	-	929	1252	1252	1.0000000
C8	28870670	28870955	BolC8t49396H	0	-	443	285	285	1.0000000
C8	28871811	28875620	BolC8t49397H	0	-	1367	3753	3809	0.9852980
C8	28878012	28878972	BolC8t49398H	0	-	850	960	960	1.0000000
C8	28885130	28885400	BolC8t49399H	0	-	98	253	270	0.9370371
C8	28887226	28888167	BolC8t49400H	0	+	237	897	941	0.9532412
C8	28898530	28899641	BolC8t49401H	0	+	843	1111	1111	1.0000000
C8	28899698	28904617	BolC8t49402H	0	-	2439	4332	4919	0.8806668
C8	28905161	28909970	BolC8t49403H	0	+	2656	4731	4809	0.9837804
C8	28910217	28912266	BolC8t49404H	0	-	528	1831	2049	0.8936067
C8	28913152	28917704	BolC8t49405H	0	+	4143	4552	4552	1.0000000
C8	28918064	28920089	BolC8t49406H	0	-	1861	2025	2025	1.0000000
C8	28921008	28922964	BolC8t49407H	0	-	605	1830	1956	0.9355828
C8	28924415	28927472	BolC8t49408H	0	+	758	2569	3057	0.8403664
C8	28929448	28942517	BolC8t49409H	0	-	603	2492	13069	0.1906802
C8	28938726	28939287	BolC8t49410H	0	+	0	0	561	0.0000000
C8	28940417	28940651	BolC8t49411H	0	+	0	0	234	0.0000000
C8	28951931	28952297	BolC8t49412H	0	+	0	0	366	0.0000000
C8	28994636	28995426	BolC8t49413H	0	+	14	275	790	0.3481013
C8	29006933	29007288	BolC8t49414H	0	+	24	345	355	0.9718310
C8	29008426	29008819	BolC8t49415H	0	+	56	365	393	0.9287532
C8	29009698	29010435	BolC8t49416H	0	-	0	0	737	0.0000000
C8	29018980	29021907	BolC8t49417H	0	+	25	292	2927	0.0997608
C8	29024283	29024385	BolC8t49418H	0	+	1	23	102	0.2254902
C8	29026514	29027096	BolC8t49419H	0	-	388	582	582	1.0000000
C8	29027824	29031029	BolC8t49420H	0	-	1837	1895	3205	0.5912637
C8	29043947	29045363	BolC8t49421H	0	-	172	1280	1416	0.9039548
C8	29047554	29048716	BolC8t49422H	0	-	45	677	1162	0.5826162
C8	29056217	29056713	BolC8t49423H	0	+	12	408	496	0.8225806
C8	29057460	29068272	BolC8t49424H	0	-	4661	10330	10812	0.9554199
C8	29075322	29076226	BolC8t49425H	0	+	7	165	904	0.1825221
C8	29080064	29080643	BolC8t49426H	0	-	190	579	579	1.0000000
C8	29084671	29085247	BolC8t49427H	0	-	9	396	576	0.6875000
C8	29117054	29121377	BolC8t49428H	0	+	667	3550	4323	0.8211890
C8	29122256	29127792	BolC8t49429H	0	+	1313	3794	5536	0.6853324
C8	29163316	29163478	BolC8t49430H	0	+	182	162	162	1.0000000
C8	29168895	29169345	BolC8t49431H	0	+	151	449	450	0.9977778
C8	29183518	29184007	BolC8t49432H	0	-	980	489	489	1.0000000
C8	29193615	29193744	BolC8t49433H	0	-	81	129	129	1.0000000
C8	29195547	29207977	BolC8t49434H	0	+	2980	12027	12430	0.9675784
C8	29217877	29218823	BolC8t49435H	0	+	3699	946	946	1.0000000
C8	29222177	29222873	BolC8t49436H	0	+	793	696	696	1.0000000
C8	29223561	29225774	BolC8t49437H	0	-	1061	2213	2213	1.0000000
C8	29228411	29230302	BolC8t49438H	0	-	1213	1888	1891	0.9984136
C8	29230610	29231168	BolC8t49439H	0	+	156	558	558	1.0000000
C8	29231859	29235424	BolC8t49440H	0	-	920	3322	3565	0.9318373
C8	29236430	29237909	BolC8t49441H	0	+	608	1473	1479	0.9959432
C8	29239465	29250117	BolC8t49442H	0	+	764	6500	10652	0.6102141
C8	29242243	29242927	BolC8t49443H	0	-	36	600	684	0.8771930
C8	29243591	29243936	BolC8t49444H	0	-	69	268	345	0.7768116
C8	29252530	29253310	BolC8t49445H	0	+	145	621	780	0.7961538
C8	29255045	29256486	BolC8t49446H	0	-	264	1124	1441	0.7800139
C8	29256602	29261913	BolC8t49447H	0	-	1793	5101	5311	0.9604594
C8	29263325	29264492	BolC8t49448H	0	-	403	1136	1167	0.9734362
C8	29266934	29270689	BolC8t49449H	0	-	664	3462	3755	0.9219707
C8	29278804	29283104	BolC8t49450H	0	+	828	3583	4300	0.8332558
C8	29283722	29289071	BolC8t49451H	0	-	2640	5297	5349	0.9902785
C8	29289795	29290131	BolC8t49452H	0	-	261	336	336	1.0000000
C8	29292365	29293370	BolC8t49453H	0	+	402	1005	1005	1.0000000
C8	29293764	29295344	BolC8t49454H	0	-	615	1580	1580	1.0000000
C8	29298384	29300227	BolC8t49455H	0	-	629	1770	1843	0.9603907
C8	29303381	29306312	BolC8t49456H	0	+	1734	2930	2931	0.9996588
C8	29309644	29309869	BolC8t49457H	0	+	82	225	225	1.0000000
C8	29315009	29315597	BolC8t49458H	0	+	347	565	588	0.9608843
C8	29315928	29318516	BolC8t49459H	0	-	1446	2431	2588	0.9393354
C8	29320513	29323198	BolC8t49460H	0	-	1115	2569	2685	0.9567970
C8	29329855	29331806	BolC8t49461H	0	+	1310	1404	1951	0.7196310
C8	29333011	29335193	BolC8t49462H	0	+	348	1933	2182	0.8858845
C8	29348234	29349706	BolC8t49463H	0	+	278	698	1472	0.4741848
C8	29353853	29355813	BolC8t49464H	0	+	1591	1960	1960	1.0000000
C8	29356489	29359728	BolC8t49465H	0	-	2516	3219	3239	0.9938253
C8	29360993	29363210	BolC8t49466H	0	-	2068	2217	2217	1.0000000
C8	29364065	29365430	BolC8t49467H	0	-	621	1316	1365	0.9641026
C8	29366299	29369911	BolC8t49468H	0	-	1301	3519	3612	0.9742525
C8	29392948	29393527	BolC8t49469H	0	-	0	0	579	0.0000000
C8	29397038	29398151	BolC8t49470H	0	-	24	153	1113	0.1374663
C8	29409732	29411184	BolC8t49471H	0	+	672	1452	1452	1.0000000
C8	29412518	29415498	BolC8t49472H	0	+	1518	2874	2980	0.9644296
C8	29415803	29418739	BolC8t49473H	0	-	1343	2601	2936	0.8858992
C8	29423849	29424993	BolC8t49474H	0	-	1025	1144	1144	1.0000000
C8	29431444	29431738	BolC8t49475H	0	-	81	294	294	1.0000000
C8	29438681	29440362	BolC8t49476H	0	-	406	1463	1681	0.8703153
C8	29440864	29441959	BolC8t49477H	0	-	618	1068	1095	0.9753425
C8	29451657	29452289	BolC8t49478H	0	+	484	632	632	1.0000000
C8	29458973	29460068	BolC8t49479H	0	-	1054	1095	1095	1.0000000
C8	29460849	29461383	BolC8t49480H	0	-	510	534	534	1.0000000
C8	29467948	29469660	BolC8t49481H	0	+	1069	1712	1712	1.0000000
C8	29471911	29472409	BolC8t49482H	0	+	3	43	498	0.0863454
C8	29475575	29476461	BolC8t49483H	0	+	332	886	886	1.0000000
C8	29476999	29477973	BolC8t49484H	0	+	337	974	974	1.0000000
C8	29478992	29480540	BolC8t49485H	0	-	1140	1548	1548	1.0000000
C8	29482741	29487024	BolC8t49486H	0	-	3141	4283	4283	1.0000000
C8	29491930	29494394	BolC8t49487H	0	-	1174	2329	2464	0.9452111
C8	29496667	29497563	BolC8t49488H	0	+	493	896	896	1.0000000
C8	29500654	29508320	BolC8t49489H	0	+	5593	7666	7666	1.0000000
C8	29508707	29512268	BolC8t49490H	0	-	1748	3444	3561	0.9671441
C8	29514707	29514929	BolC8t49491H	0	-	21	183	222	0.8243243
C8	29516214	29517384	BolC8t49492H	0	+	336	1033	1170	0.8829060
C8	29520881	29521805	BolC8t49493H	0	+	865	924	924	1.0000000
C8	29525785	29526787	BolC8t49494H	0	+	303	1002	1002	1.0000000
C8	29527274	29528373	BolC8t49495H	0	-	396	1099	1099	1.0000000
C8	29545046	29546580	BolC8t49496H	0	+	225	1394	1534	0.9087353
C8	29553432	29555738	BolC8t49497H	0	+	1188	2004	2306	0.8690373
C8	29558279	29559269	BolC8t49498H	0	+	993	990	990	1.0000000
C8	29564724	29564946	BolC8t49499H	0	-	0	0	222	0.0000000
C8	29568495	29570097	BolC8t49500H	0	-	666	1602	1602	1.0000000
C8	29576635	29576752	BolC8t49501H	0	-	2	57	117	0.4871795
C8	29584791	29585225	BolC8t49502H	0	+	494	434	434	1.0000000
C8	29593975	29596601	BolC8t49503H	0	+	1325	2626	2626	1.0000000
C8	29597614	29599973	BolC8t49504H	0	+	2409	2359	2359	1.0000000
C8	29601097	29604172	BolC8t49505H	0	+	1625	2968	3075	0.9652032
C8	29604593	29605448	BolC8t49506H	0	+	610	855	855	1.0000000
C8	29605771	29607319	BolC8t49507H	0	-	1600	1542	1548	0.9961240
C8	29608038	29609439	BolC8t49508H	0	-	715	1356	1401	0.9678801
C8	29612262	29615248	BolC8t49509H	0	-	361	2318	2986	0.7762893
C8	29620085	29620584	BolC8t49510H	0	-	270	499	499	1.0000000
C8	29623750	29624604	BolC8t49511H	0	+	390	854	854	1.0000000
C8	29654088	29655456	BolC8t49512H	0	+	1436	1368	1368	1.0000000
C8	29664802	29665810	BolC8t49513H	0	-	901	1008	1008	1.0000000
C8	29680970	29682083	BolC8t49514H	0	+	782	1113	1113	1.0000000
C8	29684211	29686363	BolC8t49515H	0	+	848	1940	2152	0.9014870
C8	29690077	29690503	BolC8t49516H	0	-	573	426	426	1.0000000
C8	29691635	29692894	BolC8t49517H	0	-	123	974	1259	0.7736298
C8	29693857	29694184	BolC8t49518H	0	+	37	205	327	0.6269113
C8	29696121	29697922	BolC8t49519H	0	-	1201	1801	1801	1.0000000
C8	29700213	29701296	BolC8t49520H	0	-	18	604	1083	0.5577101
C8	29705951	29710585	BolC8t49521H	0	+	1245	3666	4634	0.7911092
C8	29713202	29713469	BolC8t49522H	0	-	242	267	267	1.0000000
C8	29720272	29720560	BolC8t49523H	0	-	497	288	288	1.0000000
C8	29721873	29725291	BolC8t49524H	0	-	2716	3366	3418	0.9847865
C8	29731895	29734501	BolC8t49525H	0	+	179	1767	2606	0.6780506
C8	29734802	29738439	BolC8t49526H	0	+	1459	3230	3637	0.8880946
C8	29738776	29751412	BolC8t49527H	0	+	7076	12615	12636	0.9983381
C8	29743380	29744112	BolC8t49528H	0	-	546	732	732	1.0000000
C8	29744439	29745135	BolC8t49529H	0	-	668	696	696	1.0000000
C8	29753725	29756198	BolC8t49530H	0	+	1010	2297	2473	0.9288314
C8	29758186	29762151	BolC8t49531H	0	+	1491	3881	3965	0.9788146
C8	29763114	29764208	BolC8t49532H	0	+	309	1094	1094	1.0000000
C8	29765919	29767281	BolC8t49533H	0	-	480	1362	1362	1.0000000
C8	29778645	29780382	BolC8t49534H	0	+	587	1678	1737	0.9660334
C8	29785990	29786367	BolC8t49535H	0	+	576	377	377	1.0000000
C8	29794334	29795112	BolC8t49536H	0	+	181	603	778	0.7750643
C8	29799065	29799743	BolC8t49537H	0	-	263	651	678	0.9601770
C8	29801015	29802376	BolC8t49538H	0	-	140	1113	1361	0.8177810
C8	29812087	29815256	BolC8t49539H	0	+	1610	3169	3169	1.0000000
C8	29815506	29816480	BolC8t49540H	0	+	858	974	974	1.0000000
C8	29821788	29822700	BolC8t49541H	0	-	179	912	912	1.0000000
C8	29823129	29824453	BolC8t49542H	0	-	1122	1324	1324	1.0000000
C8	29825589	29826467	BolC8t49543H	0	+	143	734	878	0.8359909
C8	29838204	29840676	BolC8t49544H	0	+	588	2319	2472	0.9381068
C8	29844424	29845563	BolC8t49545H	0	+	289	1139	1139	1.0000000
C8	29846851	29847051	BolC8t49546H	0	+	296	200	200	1.0000000
C8	29847123	29860210	BolC8t49547H	0	+	2163	10443	13087	0.7979674
C8	29877955	29886142	BolC8t49548H	0	+	2169	4543	8187	0.5549041
C8	29890220	29890631	BolC8t49549H	0	-	0	0	411	0.0000000
C8	29894304	29894991	BolC8t49550H	0	-	0	0	687	0.0000000
C8	29905128	29905668	BolC8t49551H	0	-	56	530	540	0.9814815
C8	29906412	29910674	BolC8t49552H	0	-	2816	4207	4262	0.9870952
C8	29930866	29931687	BolC8t49553H	0	-	6	122	821	0.1485993
C8	29947117	29950465	BolC8t49554H	0	-	1757	3091	3348	0.9232377
C8	29955312	29957562	BolC8t49555H	0	+	541	2132	2250	0.9475555
C8	29958356	29961014	BolC8t49556H	0	+	1017	2658	2658	1.0000000
C8	29963114	29964170	BolC8t49557H	0	-	107	850	1056	0.8049242
C8	29969655	29970231	BolC8t49558H	0	-	0	0	576	0.0000000
C8	29998644	29998986	BolC8t49559H	0	+	0	0	342	0.0000000
C8	30021575	30022675	BolC8t49560H	0	+	0	0	1100	0.0000000
C8	30023554	30023854	BolC8t49561H	0	-	87	119	300	0.3966667
C8	30024683	30025325	BolC8t49562H	0	+	19	66	642	0.1028037
C8	30025457	30027991	BolC8t49563H	0	+	409	1213	2534	0.4786898
C8	30033069	30033969	BolC8t49564H	0	+	1	35	900	0.0388889
C8	30045429	30047770	BolC8t49565H	0	-	2098	2327	2341	0.9940196
C8	30049712	30050329	BolC8t49566H	0	+	318	617	617	1.0000000
C8	30051608	30052764	BolC8t49567H	0	+	233	1060	1156	0.9169550
C8	30053246	30054555	BolC8t49568H	0	-	207	1185	1309	0.9052712
C8	30056618	30057154	BolC8t49569H	0	+	311	536	536	1.0000000
C8	30064292	30080107	BolC8t49570H	0	-	5770	10951	15815	0.6924439
C8	30085423	30087096	BolC8t49571H	0	-	1020	1673	1673	1.0000000
C8	30088215	30092555	BolC8t49572H	0	+	3222	4334	4340	0.9986175
C8	30093389	30093635	BolC8t49573H	0	-	138	246	246	1.0000000
C8	30094922	30096118	BolC8t49574H	0	-	464	968	1196	0.8093646
C8	30105458	30107557	BolC8t49575H	0	+	711	1731	2099	0.8246784
C8	30108575	30108910	BolC8t49576H	0	-	282	335	335	1.0000000
C8	30110702	30111578	BolC8t49577H	0	+	190	875	876	0.9988585
C8	30116156	30118817	BolC8t49578H	0	-	140	1380	2661	0.5186020
C8	30120289	30122779	BolC8t49579H	0	-	111	1276	2490	0.5124498
C8	30126227	30130719	BolC8t49580H	0	-	2908	4492	4492	1.0000000
C8	30139517	30139793	BolC8t49581H	0	-	111	276	276	1.0000000
C8	30141240	30141366	BolC8t49582H	0	-	29	126	126	1.0000000
C8	30143474	30143702	BolC8t49583H	0	+	135	228	228	1.0000000
C8	30147276	30148353	BolC8t49584H	0	-	124	938	1077	0.8709378
C8	30149795	30151133	BolC8t49585H	0	+	421	238	1338	0.1778774
C8	30155390	30156293	BolC8t49586H	0	-	1229	903	903	1.0000000
C8	30166213	30166474	BolC8t49587H	0	+	8	236	261	0.9042146
C8	30166502	30167146	BolC8t49588H	0	+	44	467	644	0.7251553
C8	30167939	30168871	BolC8t49589H	0	+	19	416	932	0.4463519
C8	30170170	30171218	BolC8t49590H	0	+	19	630	1048	0.6011450
C8	30171296	30173740	BolC8t49591H	0	+	1322	2053	2444	0.8400164
C8	30174690	30175205	BolC8t49592H	0	+	301	498	515	0.9669903
C8	30175463	30175859	BolC8t49593H	0	-	8	190	396	0.4797980
C8	30177771	30178205	BolC8t49594H	0	-	65	387	434	0.8917051
C8	30180198	30182243	BolC8t49595H	0	-	884	1856	2045	0.9075795
C8	30182364	30182925	BolC8t49596H	0	-	197	541	561	0.9643494
C8	30184544	30186342	BolC8t49597H	0	-	997	1798	1798	1.0000000
C8	30189978	30190508	BolC8t49598H	0	-	3	97	530	0.1830189
C8	30194565	30194781	BolC8t49599H	0	-	283	216	216	1.0000000
C8	30208452	30209169	BolC8t49600H	0	-	395	687	717	0.9581590
C8	30209170	30210008	BolC8t49601H	0	+	546	497	838	0.5930787
C8	30211156	30212088	BolC8t49602H	0	+	287	932	932	1.0000000
C8	30214284	30216797	BolC8t49603H	0	-	468	2157	2513	0.8583366
C8	30218716	30234227	BolC8t49604H	0	-	2356	11416	15511	0.7359938
C8	30248100	30249722	BolC8t49605H	0	-	373	1600	1622	0.9864365
C8	30256607	30262084	BolC8t49606H	0	-	1025	4166	5477	0.7606354
C8	30262845	30263350	BolC8t49607H	0	-	135	462	505	0.9148515
C8	30264126	30267364	BolC8t49608H	0	+	876	3038	3238	0.9382335
C8	30267624	30270515	BolC8t49609H	0	-	877	2788	2891	0.9643722
C8	30287192	30287633	BolC8t49610H	0	-	34	325	441	0.7369614
C8	30297834	30298325	BolC8t49611H	0	-	376	491	491	1.0000000
C8	30303244	30303610	BolC8t49612H	0	+	383	366	366	1.0000000
C8	30317496	30320921	BolC8t49613H	0	+	1400	3314	3425	0.9675912
C8	30321397	30323975	BolC8t49614H	0	-	1681	2423	2578	0.9398759
C8	30325001	30325494	BolC8t49615H	0	-	237	493	493	1.0000000
C8	30332561	30335482	BolC8t49616H	0	-	2076	2773	2921	0.9493324
C8	30344838	30345464	BolC8t49617H	0	-	291	626	626	1.0000000
C8	30346889	30348533	BolC8t49618H	0	-	234	1033	1644	0.6283455
C8	30353344	30353771	BolC8t49619H	0	+	127	280	427	0.6557377
C8	30354544	30356754	BolC8t49620H	0	-	704	2047	2210	0.9262443
C8	30360162	30361573	BolC8t49621H	0	+	1259	1411	1411	1.0000000
C8	30362747	30362933	BolC8t49622H	0	+	17	153	186	0.8225806
C8	30365026	30365452	BolC8t49623H	0	+	97	167	426	0.3920188
C8	30366211	30367649	BolC8t49624H	0	-	74	472	1438	0.3282337
C8	30393392	30393560	BolC8t49625H	0	-	2	93	168	0.5535714
C8	30398785	30400110	BolC8t49626H	0	+	894	1325	1325	1.0000000
C8	30400690	30402564	BolC8t49627H	0	+	1341	1845	1874	0.9845251
C8	30405594	30406167	BolC8t49628H	0	-	347	573	573	1.0000000
C8	30438637	30441368	BolC8t49629H	0	+	1032	2730	2731	0.9996338
C8	30451063	30453061	BolC8t49630H	0	-	0	0	1998	0.0000000
C8	30457438	30458562	BolC8t49631H	0	+	863	1124	1124	1.0000000
C8	30460239	30463224	BolC8t49632H	0	+	2324	2980	2985	0.9983249
C8	30463848	30465893	BolC8t49633H	0	+	299	1184	2045	0.5789731
C8	30480651	30481608	BolC8t49634H	0	+	1319	957	957	1.0000000
C8	30482474	30482810	BolC8t49635H	0	-	239	336	336	1.0000000
C8	30484548	30485814	BolC8t49636H	0	-	59	859	1266	0.6785150
C8	30486985	30488831	BolC8t49637H	0	-	1417	1846	1846	1.0000000
C8	30489597	30491449	BolC8t49638H	0	-	1102	1852	1852	1.0000000
C8	30495585	30495756	BolC8t49639H	0	-	265	171	171	1.0000000
C8	30496141	30498970	BolC8t49640H	0	+	2068	2829	2829	1.0000000
C8	30499806	30501180	BolC8t49641H	0	-	603	1309	1374	0.9526929
C8	30503584	30506436	BolC8t49642H	0	-	1171	2256	2852	0.7910239
C8	30509723	30510344	BolC8t49643H	0	+	256	561	621	0.9033816
C8	30512075	30512732	BolC8t49644H	0	+	125	657	657	1.0000000
C8	30519909	30520554	BolC8t49645H	0	+	239	645	645	1.0000000
C8	30526494	30528715	BolC8t49646H	0	-	475	1910	2221	0.8599730
C8	30542696	30544785	BolC8t49647H	0	-	578	1825	2089	0.8736237
C8	30559530	30560085	BolC8t49648H	0	-	424	555	555	1.0000000
C8	30562349	30564460	BolC8t49649H	0	-	1121	1813	2111	0.8588347
C8	30565900	30566596	BolC8t49650H	0	-	22	376	696	0.5402299
C8	30573385	30573975	BolC8t49651H	0	+	199	590	590	1.0000000
C8	30574634	30576608	BolC8t49652H	0	-	194	1516	1974	0.7679838
C8	30627668	30628130	BolC8t49653H	0	-	192	462	462	1.0000000
C8	30633678	30635866	BolC8t49654H	0	+	1084	2151	2188	0.9830896
C8	30644272	30644491	BolC8t49655H	0	-	86	219	219	1.0000000
C8	30650084	30653062	BolC8t49656H	0	+	579	1717	2978	0.5765615
C8	30662777	30664337	BolC8t49657H	0	-	164	1105	1560	0.7083333
C8	30669667	30669952	BolC8t49658H	0	-	234	285	285	1.0000000
C8	30671710	30675194	BolC8t49659H	0	-	1013	3214	3484	0.9225029
C8	30677164	30680701	BolC8t49660H	0	-	833	2119	3537	0.5990953
C8	30682633	30683578	BolC8t49661H	0	+	773	945	945	1.0000000
C8	30684444	30689226	BolC8t49662H	0	+	2960	4666	4782	0.9757423
C8	30689562	30690664	BolC8t49663H	0	-	646	1102	1102	1.0000000
C8	30691796	30695302	BolC8t49664H	0	+	1162	3318	3506	0.9463776
C8	30696677	30697823	BolC8t49665H	0	-	949	1146	1146	1.0000000
C8	30736349	30736571	BolC8t49666H	0	+	0	0	222	0.0000000
C8	30737508	30738102	BolC8t49667H	0	+	59	495	594	0.8333333
C8	30752698	30753636	BolC8t49668H	0	+	747	938	938	1.0000000
C8	30753978	30756674	BolC8t49669H	0	-	1033	2695	2696	0.9996291
C8	30761265	30762507	BolC8t49670H	0	+	219	1152	1242	0.9275362
C8	30762871	30768350	BolC8t49671H	0	-	706	2062	5479	0.3763461
C8	30769214	30770582	BolC8t49672H	0	-	1376	1368	1368	1.0000000
C8	30775719	30776696	BolC8t49673H	0	+	20	249	977	0.2548618
C8	30777081	30777511	BolC8t49674H	0	+	191	328	430	0.7627907
C8	30782275	30782803	BolC8t49675H	0	+	54	489	528	0.9261364
C8	30786103	30786376	BolC8t49676H	0	+	211	273	273	1.0000000
C8	30814077	30815028	BolC8t49677H	0	+	688	951	951	1.0000000
C8	30821087	30824177	BolC8t49678H	0	-	1833	3042	3090	0.9844660
C8	30824831	30828401	BolC8t49679H	0	-	1749	3477	3570	0.9739496
C8	30833855	30834814	BolC8t49680H	0	+	67	618	959	0.6444213
C8	30845845	30846532	BolC8t49681H	0	+	224	670	687	0.9752547
C8	30847592	30847709	BolC8t49682H	0	+	160	117	117	1.0000000
C8	30852698	30853162	BolC8t49683H	0	+	21	291	464	0.6271552
C8	30864173	30864797	BolC8t49684H	0	+	182	609	624	0.9759616
C8	30879653	30880496	BolC8t49685H	0	+	35	170	843	0.2016607
C8	30881918	30882428	BolC8t49686H	0	+	22	53	510	0.1039216
C8	30885666	30886971	BolC8t49687H	0	+	1223	1305	1305	1.0000000
C8	30887380	30888811	BolC8t49688H	0	-	376	1322	1431	0.9238295
C8	30889800	30892490	BolC8t49689H	0	-	241	1861	2690	0.6918216
C8	30902158	30902266	BolC8t49690H	0	-	0	0	108	0.0000000
C8	30966359	30966869	BolC8t49691H	0	-	3	201	510	0.3941177
C8	30968328	30970528	BolC8t49692H	0	-	149	1221	2200	0.5550000
C8	30979160	30980467	BolC8t49693H	0	-	116	1165	1307	0.8913543
C8	30987134	30988435	BolC8t49694H	0	-	548	1105	1301	0.8493466
C8	30989841	30990883	BolC8t49695H	0	+	6	292	1042	0.2802303
C8	30991530	30991713	BolC8t49696H	0	-	50	183	183	1.0000000
C8	30998605	30999193	BolC8t49697H	0	+	66	274	588	0.4659864
C8	31008896	31012982	BolC8t49698H	0	-	3045	4005	4086	0.9801762
C8	31019525	31019828	BolC8t49699H	0	+	19	139	303	0.4587459
C8	31020647	31021799	BolC8t49700H	0	+	302	875	1152	0.7595486
C8	31023224	31025532	BolC8t49701H	0	+	1865	2308	2308	1.0000000
C8	31025832	31026012	BolC8t49702H	0	-	204	180	180	1.0000000
C8	31027850	31035281	BolC8t49703H	0	+	1448	4045	7431	0.5443413
C8	31036863	31037700	BolC8t49704H	0	+	27	683	837	0.8160096
C8	31038802	31039195	BolC8t49705H	0	-	8	319	393	0.8117048
C8	31044455	31068827	BolC8t49706H	0	+	7439	15323	24372	0.6287133
C8	31047294	31048058	BolC8t49707H	0	-	507	743	764	0.9725131
C8	31049181	31050021	BolC8t49708H	0	-	259	759	840	0.9035714
C8	31099762	31102219	BolC8t49709H	0	+	289	2054	2457	0.8359789
C8	31104581	31105430	BolC8t49710H	0	+	15	234	849	0.2756184
C8	31108728	31111117	BolC8t49711H	0	+	665	2210	2389	0.9250733
C8	31114449	31114961	BolC8t49712H	0	+	0	0	512	0.0000000
C8	31147380	31148609	BolC8t49713H	0	+	236	1053	1229	0.8567941
C8	31152203	31154666	BolC8t49714H	0	+	371	2272	2463	0.9224523
C8	31155002	31156357	BolC8t49715H	0	-	94	459	1355	0.3387454
C8	31157344	31158475	BolC8t49716H	0	+	778	1131	1131	1.0000000
C8	31158709	31160744	BolC8t49717H	0	-	1658	2035	2035	1.0000000
C8	31162449	31164054	BolC8t49718H	0	-	353	1568	1605	0.9769471
C8	31167520	31175183	BolC8t49719H	0	+	1213	3189	7663	0.4161555
C8	31180960	31181281	BolC8t49720H	0	-	0	0	321	0.0000000
C8	31181930	31183004	BolC8t49721H	0	-	4	72	1074	0.0670391
C8	31185186	31187074	BolC8t49722H	0	+	1035	1888	1888	1.0000000
C8	31187951	31189182	BolC8t49723H	0	-	622	1213	1231	0.9853777
C8	31192531	31194718	BolC8t49724H	0	-	641	1942	2187	0.8879744
C8	31195266	31197430	BolC8t49725H	0	-	666	2132	2164	0.9852126
C8	31202745	31202955	BolC8t49726H	0	-	87	210	210	1.0000000
C8	31221916	31222208	BolC8t49727H	0	-	336	292	292	1.0000000
C8	31226893	31227109	BolC8t49728H	0	-	202	216	216	1.0000000
C8	31239450	31246077	BolC8t49729H	0	-	3410	6293	6627	0.9496001
C8	31247078	31249895	BolC8t49730H	0	-	680	2639	2817	0.9368122
C8	31252939	31254354	BolC8t49731H	0	-	1256	1415	1415	1.0000000
C8	31259332	31259437	BolC8t49732H	0	-	177	105	105	1.0000000
C8	31259891	31265383	BolC8t49733H	0	+	2020	5250	5492	0.9559359
C8	31268102	31275304	BolC8t49734H	0	-	3000	7052	7202	0.9791725
C8	31275791	31276846	BolC8t49735H	0	+	667	1055	1055	1.0000000
C8	31280217	31280628	BolC8t49736H	0	+	2	278	411	0.6763991
C8	31283222	31316897	BolC8t49737H	0	+	7921	16362	33675	0.4858797
C8	31318865	31322197	BolC8t49738H	0	-	1707	3293	3332	0.9882953
C8	31328318	31329755	BolC8t49739H	0	+	164	1238	1437	0.8615171
C8	31333224	31334427	BolC8t49740H	0	+	115	962	1203	0.7996675
C8	31339011	31339263	BolC8t49741H	0	+	99	252	252	1.0000000
C8	31342937	31343563	BolC8t49742H	0	-	371	626	626	1.0000000
C8	31349609	31350185	BolC8t49743H	0	+	622	576	576	1.0000000
C8	31354160	31355018	BolC8t49744H	0	+	516	858	858	1.0000000
C8	31360403	31361338	BolC8t49745H	0	-	31	682	935	0.7294118
C8	31365679	31366948	BolC8t49746H	0	-	348	1222	1269	0.9629630
C8	31369113	31371706	BolC8t49747H	0	+	621	2244	2593	0.8654069
C8	31372009	31372309	BolC8t49748H	0	-	102	300	300	1.0000000
C8	31374443	31374623	BolC8t49749H	0	-	70	180	180	1.0000000
C8	31374900	31376179	BolC8t49750H	0	-	814	1099	1279	0.8592650
C8	31393347	31393809	BolC8t49751H	0	-	102	462	462	1.0000000
C8	31394169	31394589	BolC8t49752H	0	-	199	420	420	1.0000000
C8	31394739	31395327	BolC8t49753H	0	-	154	571	588	0.9710884
C8	31400152	31401697	BolC8t49754H	0	+	749	1545	1545	1.0000000
C8	31402442	31404378	BolC8t49755H	0	+	1564	1936	1936	1.0000000
C8	31405220	31406156	BolC8t49756H	0	-	610	936	936	1.0000000
C8	31410034	31410667	BolC8t49757H	0	+	31	247	633	0.3902054
C8	31414305	31430669	BolC8t49758H	0	-	30917	8072	16364	0.4932779
C8	31447382	31447718	BolC8t49759H	0	+	34	336	336	1.0000000
C8	31450538	31451971	BolC8t49760H	0	-	279	1313	1433	0.9162596
C8	31456572	31457052	BolC8t49761H	0	-	71	372	480	0.7750000
C8	31458300	31459970	BolC8t49762H	0	-	734	1670	1670	1.0000000
C8	31466223	31469334	BolC8t49763H	0	+	621	2935	3111	0.9434265
C8	31474663	31488105	BolC8t49764H	0	+	3231	10450	13442	0.7774141
C8	31492905	31493627	BolC8t49765H	0	-	286	722	722	1.0000000
C8	31496082	31496655	BolC8t49766H	0	-	380	573	573	1.0000000
C8	31513014	31513119	BolC8t49767H	0	-	78	105	105	1.0000000
C8	31515428	31517738	BolC8t49768H	0	-	321	1447	2310	0.6264069
C8	31526545	31528486	BolC8t49769H	0	+	256	1629	1941	0.8392581
C8	31530503	31531780	BolC8t49770H	0	-	57	881	1277	0.6898982
C8	31541208	31543706	BolC8t49771H	0	-	1148	2151	2498	0.8610889
C8	31553058	31553305	BolC8t49772H	0	-	119	247	247	1.0000000
C8	31555780	31556634	BolC8t49773H	0	+	91	756	854	0.8852459
C8	31559061	31560663	BolC8t49774H	0	+	438	1053	1602	0.6573034
C8	31561057	31563313	BolC8t49775H	0	-	230	1340	2256	0.5939716
C8	31566234	31566507	BolC8t49776H	0	-	34	273	273	1.0000000
C8	31568028	31568892	BolC8t49777H	0	-	389	864	864	1.0000000
C8	31582601	31584584	BolC8t49778H	0	-	437	1915	1983	0.9657085
C8	31585206	31585501	BolC8t49779H	0	-	388	295	295	1.0000000
C8	31585562	31587498	BolC8t49780H	0	-	1323	1936	1936	1.0000000
C8	31590312	31591272	BolC8t49781H	0	+	264	941	960	0.9802083
C8	31592978	31593409	BolC8t49782H	0	+	364	431	431	1.0000000
C8	31595466	31595772	BolC8t49783H	0	+	319	306	306	1.0000000
C8	31601652	31601957	BolC8t49784H	0	-	248	305	305	1.0000000
C8	31604538	31604875	BolC8t49785H	0	-	303	337	337	1.0000000
C8	31616559	31618347	BolC8t49786H	0	+	1486	1788	1788	1.0000000
C8	31621622	31622819	BolC8t49787H	0	+	520	1191	1197	0.9949875
C8	31623199	31624350	BolC8t49788H	0	-	720	1151	1151	1.0000000
C8	31626232	31628526	BolC8t49789H	0	-	884	2294	2294	1.0000000
C8	31682229	31684960	BolC8t49790H	0	+	1060	2354	2731	0.8619553
C8	31698785	31699904	BolC8t49791H	0	+	1102	1119	1119	1.0000000
C8	31712814	31714005	BolC8t49792H	0	+	273	911	1191	0.7649034
C8	31714515	31715421	BolC8t49793H	0	-	304	906	906	1.0000000
C8	31719838	31721914	BolC8t49794H	0	+	1435	2076	2076	1.0000000
C8	31722983	31723791	BolC8t49795H	0	+	424	752	808	0.9306931
C8	31731974	31733897	BolC8t49796H	0	-	197	1279	1923	0.6651066
C8	31735446	31735602	BolC8t49797H	0	+	0	0	156	0.0000000
C8	31755930	31756352	BolC8t49798H	0	-	226	422	422	1.0000000
C8	31758186	31761110	BolC8t49799H	0	-	768	2053	2924	0.7021204
C8	31771452	31776068	BolC8t49800H	0	-	1037	3426	4616	0.7422010
C8	31779612	31781314	BolC8t49801H	0	+	138	1054	1702	0.6192715
C8	31789180	31789846	BolC8t49802H	0	+	93	395	666	0.5930931
C8	31793519	31794418	BolC8t49803H	0	+	623	899	899	1.0000000
C8	31811724	31812967	BolC8t49804H	0	+	136	319	1243	0.2566372
C8	31821479	31822356	BolC8t49805H	0	+	1031	877	877	1.0000000
C8	31825407	31828578	BolC8t49806H	0	+	447	1091	3171	0.3440555
C8	31841719	31843704	BolC8t49807H	0	-	462	1978	1985	0.9964736
C8	31846544	31846730	BolC8t49808H	0	-	247	186	186	1.0000000
C8	31847993	31848479	BolC8t49809H	0	-	165	465	486	0.9567901
C8	31859931	31863195	BolC8t49810H	0	-	2143	3139	3264	0.9617034
C8	31881825	31882486	BolC8t49811H	0	+	442	657	661	0.9939486
C8	31885905	31886509	BolC8t49812H	0	+	839	604	604	1.0000000
C8	31888293	31888491	BolC8t49813H	0	+	157	198	198	1.0000000
C8	31891659	31892173	BolC8t49814H	0	+	142	514	514	1.0000000
C8	31893726	31894326	BolC8t49815H	0	-	676	600	600	1.0000000
C8	31896191	31896801	BolC8t49816H	0	+	236	530	610	0.8688524
C8	31904022	31907517	BolC8t49817H	0	+	1233	3459	3495	0.9896995
C8	31907990	31912032	BolC8t49818H	0	+	681	3755	4042	0.9289955
C8	31912713	31914004	BolC8t49819H	0	+	491	1289	1291	0.9984508
C8	31914407	31915829	BolC8t49820H	0	-	1335	1422	1422	1.0000000
C8	31921708	31922158	BolC8t49821H	0	+	356	450	450	1.0000000
C8	31922969	31925389	BolC8t49822H	0	-	1675	2420	2420	1.0000000
C8	31927271	31935367	BolC8t49823H	0	-	3241	5104	8096	0.6304348
C8	31936313	31938799	BolC8t49824H	0	-	545	2333	2486	0.9384553
C8	31957455	31957953	BolC8t49825H	0	-	116	467	498	0.9377510
C8	31958851	31960301	BolC8t49826H	0	-	1629	1450	1450	1.0000000
C8	31964272	31970191	BolC8t49827H	0	-	2293	5378	5919	0.9085994
C8	31991710	31991892	BolC8t49828H	0	+	84	182	182	1.0000000
C8	31993102	31993781	BolC8t49829H	0	+	498	679	679	1.0000000
C8	31993889	31997386	BolC8t49830H	0	+	1963	3497	3497	1.0000000
C8	32009941	32010481	BolC8t49831H	0	+	396	540	540	1.0000000
C8	32010895	32013613	BolC8t49832H	0	-	1900	2718	2718	1.0000000
C8	32015322	32022876	BolC8t49833H	0	-	1335	5869	7554	0.7769394
C8	32019023	32019922	BolC8t49834H	0	-	56	526	899	0.5850946
C8	32026148	32026427	BolC8t49835H	0	-	4	24	279	0.0860215
C8	32038588	32039227	BolC8t49836H	0	+	521	639	639	1.0000000
C8	32039895	32040117	BolC8t49837H	0	+	266	222	222	1.0000000
C8	32040402	32040601	BolC8t49838H	0	+	240	199	199	1.0000000
C8	32047765	32047930	BolC8t49839H	0	-	102	165	165	1.0000000
C8	32050652	32053283	BolC8t49840H	0	+	1604	2631	2631	1.0000000
C8	32053327	32054296	BolC8t49841H	0	+	651	969	969	1.0000000
C8	32064449	32077786	BolC8t49842H	0	-	8016	11926	13337	0.8942041
C8	32079714	32080923	BolC8t49843H	0	-	850	1209	1209	1.0000000
C8	32094918	32098775	BolC8t49844H	0	-	910	3149	3857	0.8164377
C8	32100543	32100849	BolC8t49845H	0	+	10	124	306	0.4052288
C8	32101335	32101728	BolC8t49846H	0	+	405	393	393	1.0000000
C8	32101816	32102187	BolC8t49847H	0	-	286	371	371	1.0000000
C8	32105117	32107167	BolC8t49848H	0	-	2084	2050	2050	1.0000000
C8	32106972	32107430	BolC8t49849H	0	+	445	458	458	1.0000000
C8	32116664	32117167	BolC8t49850H	0	-	303	471	503	0.9363817
C8	32117389	32118640	BolC8t49851H	0	-	134	850	1251	0.6794564
C8	32125292	32132084	BolC8t49852H	0	-	3659	5961	6792	0.8776502
C8	32128413	32129044	BolC8t49853H	0	-	11	238	631	0.3771791
C8	32147201	32148344	BolC8t49854H	0	-	835	1143	1143	1.0000000
C8	32152721	32154554	BolC8t49855H	0	+	1489	1833	1833	1.0000000
C8	32154843	32157409	BolC8t49856H	0	-	1029	2554	2566	0.9953235
C8	32158459	32158824	BolC8t49857H	0	+	38	316	365	0.8657534
C8	32161969	32162260	BolC8t49858H	0	-	28	291	291	1.0000000
C8	32164142	32167173	BolC8t49859H	0	+	1863	3031	3031	1.0000000
C8	32174133	32177102	BolC8t49860H	0	+	961	2969	2969	1.0000000
C8	32178194	32178660	BolC8t49861H	0	+	382	466	466	1.0000000
C8	32181658	32182672	BolC8t49862H	0	-	608	1014	1014	1.0000000
C8	32188346	32188631	BolC8t49863H	0	-	195	285	285	1.0000000
C8	32190651	32191104	BolC8t49864H	0	-	73	448	453	0.9889625
C8	32199997	32200457	BolC8t49865H	0	-	18	151	460	0.3282609
C8	32208850	32209766	BolC8t49866H	0	-	790	803	916	0.8766376
C8	32225659	32226519	BolC8t49867H	0	-	179	806	860	0.9372093
C8	32240285	32240534	BolC8t49868H	0	-	276	249	249	1.0000000
C8	32243740	32264325	BolC8t49869H	0	-	10806	19648	20585	0.9544814
C8	32255222	32255884	BolC8t49870H	0	+	524	662	662	1.0000000
C8	32260253	32260706	BolC8t49871H	0	-	285	453	453	1.0000000
C8	32267687	32268191	BolC8t49872H	0	+	59	359	504	0.7123016
C8	32276126	32276888	BolC8t49873H	0	+	578	762	762	1.0000000
C8	32291843	32292050	BolC8t49874H	0	+	229	207	207	1.0000000
C8	32309846	32311569	BolC8t49875H	0	-	886	1723	1723	1.0000000
C8	32313917	32314338	BolC8t49876H	0	+	193	321	421	0.7624703
C8	32320636	32322606	BolC8t49877H	0	-	1671	1970	1970	1.0000000
C8	32328707	32329001	BolC8t49878H	0	-	139	294	294	1.0000000
C8	32337971	32373425	BolC8t49879H	0	+	11040	29775	35454	0.8398206
C8	32354038	32355736	BolC8t49880H	0	+	502	1429	1698	0.8415783
C8	32356828	32361474	BolC8t49881H	0	-	1539	4328	4646	0.9315540
C8	32362918	32363248	BolC8t49882H	0	+	6	98	330	0.2969697
C8	32365251	32366117	BolC8t49883H	0	-	283	749	866	0.8648961
C8	32377019	32378144	BolC8t49884H	0	+	1270	1125	1125	1.0000000
C8	32378944	32379711	BolC8t49885H	0	+	3	212	767	0.2764016
C8	32382046	32413053	BolC8t49886H	0	+	4771	15160	31007	0.4889219
C8	32384095	32384704	BolC8t49887H	0	+	20	176	609	0.2889984
C8	32415298	32416057	BolC8t49888H	0	+	438	759	759	1.0000000
C8	32428292	32428799	BolC8t49889H	0	+	349	507	507	1.0000000
C8	32429309	32431636	BolC8t49890H	0	-	1375	2327	2327	1.0000000
C8	32440096	32443160	BolC8t49891H	0	+	1598	2960	3064	0.9660574
C8	32444760	32445677	BolC8t49892H	0	+	635	917	917	1.0000000
C8	32446696	32448582	BolC8t49893H	0	+	968	1886	1886	1.0000000
C8	32448965	32451754	BolC8t49894H	0	-	1412	2782	2789	0.9974902
C8	32456653	32479953	BolC8t49895H	0	+	12695	20969	23300	0.8999571
C8	32464300	32465979	BolC8t49896H	0	-	1214	1340	1679	0.7980941
C8	32489968	32490945	BolC8t49897H	0	+	296	977	977	1.0000000
C8	32490825	32491505	BolC8t49898H	0	+	348	680	680	1.0000000
C8	32496831	32498793	BolC8t49899H	0	-	756	1766	1962	0.9001020
C8	32510333	32513146	BolC8t49900H	0	-	219	2048	2813	0.7280483
C8	32518831	32520865	BolC8t49901H	0	-	768	2020	2034	0.9931170
C8	32525430	32526364	BolC8t49902H	0	-	31	720	934	0.7708780
C8	32532034	32533314	BolC8t49903H	0	-	309	1184	1280	0.9250000
C8	32538956	32540412	BolC8t49904H	0	-	641	1422	1456	0.9766483
C8	32553134	32554412	BolC8t49905H	0	+	146	859	1278	0.6721440
C8	32558636	32559161	BolC8t49906H	0	-	303	525	525	1.0000000
C8	32586541	32587096	BolC8t49907H	0	-	31	426	555	0.7675676
C8	32602993	32603787	BolC8t49908H	0	+	801	794	794	1.0000000
C8	32605307	32607280	BolC8t49909H	0	-	1508	1613	1973	0.8175368
C8	32630043	32631909	BolC8t49910H	0	-	40	644	1866	0.3451233
C8	32641473	32644085	BolC8t49911H	0	+	1689	2612	2612	1.0000000
C8	32645639	32647419	BolC8t49912H	0	-	1259	1780	1780	1.0000000
C8	32648199	32650477	BolC8t49913H	0	-	251	1963	2278	0.8617208
C8	32655365	32655515	BolC8t49914H	0	+	206	150	150	1.0000000
C8	32660069	32660666	BolC8t49915H	0	+	319	597	597	1.0000000
C8	32660955	32662993	BolC8t49916H	0	-	1203	1699	2038	0.8336604
C8	32664624	32670499	BolC8t49917H	0	-	216	3126	5875	0.5320851
C8	32666136	32666604	BolC8t49918H	0	-	0	0	468	0.0000000
C8	32673130	32674503	BolC8t49919H	0	+	996	1373	1373	1.0000000
C8	32687746	32690167	BolC8t49920H	0	-	1556	2421	2421	1.0000000
C8	32691669	32693000	BolC8t49921H	0	+	695	1331	1331	1.0000000
C8	32694080	32695315	BolC8t49922H	0	+	1053	1235	1235	1.0000000
C8	32699088	32700476	BolC8t49923H	0	-	353	1135	1388	0.8177233
C8	32725144	32725879	BolC8t49924H	0	-	171	700	735	0.9523810
C8	32727965	32728298	BolC8t49925H	0	-	269	333	333	1.0000000
C8	32729691	32731322	BolC8t49926H	0	+	298	1631	1631	1.0000000
C8	32738844	32741262	BolC8t49927H	0	-	1246	2418	2418	1.0000000
C8	32741699	32741804	BolC8t49928H	0	-	43	105	105	1.0000000
C8	32742493	32743492	BolC8t49929H	0	-	468	999	999	1.0000000
C8	32746359	32749136	BolC8t49930H	0	-	915	2619	2777	0.9431041
C8	32750287	32753260	BolC8t49931H	0	-	528	1881	2973	0.6326942
C8	32764766	32765216	BolC8t49932H	0	+	24	406	450	0.9022222
C8	32767019	32767844	BolC8t49933H	0	-	871	825	825	1.0000000
C8	32768658	32770144	BolC8t49934H	0	+	1169	1328	1486	0.8936743
C8	32771591	32772510	BolC8t49935H	0	+	2	19	919	0.0206746
C8	32775808	32776153	BolC8t49936H	0	+	671	345	345	1.0000000
C8	32784396	32786519	BolC8t49937H	0	-	313	1569	2123	0.7390485
C8	32793952	32795524	BolC8t49938H	0	-	104	951	1572	0.6049618
C8	32798162	32800176	BolC8t49939H	0	+	1215	1736	2014	0.8619663
C8	32801610	32802410	BolC8t49940H	0	+	264	795	800	0.9937500
C8	32803050	32805507	BolC8t49941H	0	-	563	2078	2457	0.8457469
C8	32816483	32818564	BolC8t49942H	0	+	1547	2058	2081	0.9889476
C8	32819201	32819823	BolC8t49943H	0	-	181	520	622	0.8360128
C8	32824506	32824909	BolC8t49944H	0	-	334	403	403	1.0000000
C8	32846744	32846969	BolC8t49945H	0	+	2	37	225	0.1644444
C8	32860502	32860801	BolC8t49946H	0	+	239	299	299	1.0000000
C8	32883191	32883492	BolC8t49947H	0	+	86	299	301	0.9933555
C8	32900520	32900888	BolC8t49948H	0	+	1209	368	368	1.0000000
C8	32916601	32919193	BolC8t49949H	0	+	401	1887	2592	0.7280093
C8	32919603	32924183	BolC8t49950H	0	-	707	2949	4580	0.6438864
C8	32929700	32931093	BolC8t49951H	0	+	1019	1393	1393	1.0000000
C8	32935169	32935436	BolC8t49952H	0	-	25	176	267	0.6591761
C8	32953102	32953669	BolC8t49953H	0	-	138	545	567	0.9611993
C8	32954862	32955237	BolC8t49954H	0	-	145	361	375	0.9626667
C8	32958559	32960358	BolC8t49955H	0	-	1429	1799	1799	1.0000000
C8	32968436	32969171	BolC8t49956H	0	+	29	74	735	0.1006803
C8	32970076	32970776	BolC8t49957H	0	-	492	700	700	1.0000000
C8	32970936	32972617	BolC8t49958H	0	-	502	1412	1681	0.8399762
C8	32973869	32974505	BolC8t49959H	0	+	126	504	636	0.7924528
C8	32977465	32979247	BolC8t49960H	0	-	544	1764	1782	0.9898990
C8	32992250	32992637	BolC8t49961H	0	+	436	387	387	1.0000000
C8	33009559	33011232	BolC8t49962H	0	+	72	966	1673	0.5774059
C8	33030832	33033296	BolC8t49963H	0	+	592	2132	2464	0.8652598
C8	33039700	33041634	BolC8t49964H	0	-	186	1280	1934	0.6618407
C8	33076745	33078527	BolC8t49965H	0	-	126	1142	1782	0.6408530
C8	33091803	33095199	BolC8t49966H	0	+	864	3021	3396	0.8895760
C8	33095571	33101841	BolC8t49967H	0	-	2933	6182	6270	0.9859649
C8	33104285	33104621	BolC8t49968H	0	-	65	336	336	1.0000000
C8	33109904	33111749	BolC8t49969H	0	+	401	1831	1845	0.9924119
C8	33111911	33113623	BolC8t49970H	0	-	728	1500	1712	0.8761683
C8	33114901	33117184	BolC8t49971H	0	+	1162	2283	2283	1.0000000
C8	33118426	33123529	BolC8t49972H	0	+	904	4209	5103	0.8248090
C8	33126835	33134912	BolC8t49973H	0	-	2191	8028	8077	0.9939334
C8	33138194	33140299	BolC8t49974H	0	+	1020	2105	2105	1.0000000
C8	33141462	33141789	BolC8t49975H	0	-	192	327	327	1.0000000
C8	33149657	33150706	BolC8t49976H	0	-	712	1049	1049	1.0000000
C8	33154793	33157592	BolC8t49977H	0	+	523	2289	2799	0.8177921
C8	33161837	33162339	BolC8t49978H	0	+	227	502	502	1.0000000
C8	33163759	33164161	BolC8t49979H	0	-	140	376	402	0.9353234
C8	33164479	33165000	BolC8t49980H	0	-	492	521	521	1.0000000
C8	33171617	33172774	BolC8t49981H	0	-	985	1157	1157	1.0000000
C8	33174790	33184560	BolC8t49982H	0	+	2054	5260	9770	0.5383828
C8	33186402	33187288	BolC8t49983H	0	-	324	814	886	0.9187359
C8	33194023	33195544	BolC8t49984H	0	-	335	987	1521	0.6489152
C8	33204704	33205415	BolC8t49985H	0	-	0	0	711	0.0000000
C8	33205468	33206084	BolC8t49986H	0	-	22	170	616	0.2759740
C8	33214658	33216571	BolC8t49987H	0	+	723	1835	1913	0.9592264
C8	33228691	33229248	BolC8t49988H	0	+	41	498	557	0.8940754
C8	33280389	33281399	BolC8t49989H	0	-	702	1010	1010	1.0000000
C8	33305323	33305839	BolC8t49990H	0	-	402	516	516	1.0000000
C8	33305929	33306355	BolC8t49991H	0	-	704	426	426	1.0000000
C8	33307484	33307793	BolC8t49992H	0	-	248	309	309	1.0000000
C8	33310205	33311003	BolC8t49993H	0	-	418	798	798	1.0000000
C8	33328370	33331617	BolC8t49994H	0	-	1303	3160	3247	0.9732060
C8	33336122	33336317	BolC8t49995H	0	+	290	195	195	1.0000000
C8	33337847	33338057	BolC8t49996H	0	+	204	210	210	1.0000000
C8	33338337	33342695	BolC8t49997H	0	+	1890	3361	4358	0.7712253
C8	33344069	33345268	BolC8t49998H	0	+	335	1035	1199	0.8632193
C8	33353887	33356440	BolC8t49999H	0	+	3158	2553	2553	1.0000000
C8	33375536	33378336	BolC8t50000H	0	+	1972	2800	2800	1.0000000
C8	33400633	33402613	BolC8t50001H	0	+	163	900	1980	0.4545455
C8	33404656	33406719	BolC8t50002H	0	-	734	1895	2063	0.9185652
C8	33423241	33426184	BolC8t50003H	0	+	1204	2833	2943	0.9626232
C8	33427345	33431785	BolC8t50004H	0	-	3383	4440	4440	1.0000000
C8	33444032	33446044	BolC8t50005H	0	+	586	1898	2012	0.9433399
C8	33446227	33452134	BolC8t50006H	0	-	1417	4734	5907	0.8014221
C8	33458313	33458527	BolC8t50007H	0	+	1	55	214	0.2570094
C8	33463019	33463700	BolC8t50008H	0	-	82	429	681	0.6299559
C8	33468439	33472596	BolC8t50009H	0	+	396	2618	4157	0.6297811
C8	33472993	33476495	BolC8t50010H	0	-	595	2725	3502	0.7781268
C8	33478151	33479135	BolC8t50011H	0	+	610	984	984	1.0000000
C8	33482603	33483691	BolC8t50012H	0	+	462	985	1088	0.9053309
C8	33487266	33487881	BolC8t50013H	0	-	0	0	615	0.0000000
C8	33505263	33506588	BolC8t50014H	0	+	1460	1325	1325	1.0000000
C8	33506966	33507924	BolC8t50015H	0	-	188	916	958	0.9561586
C8	33518749	33521115	BolC8t50016H	0	+	463	2244	2366	0.9484362
C8	33521508	33522255	BolC8t50017H	0	-	54	447	747	0.5983936
C8	33524941	33527512	BolC8t50018H	0	+	928	2192	2571	0.8525866
C8	33540260	33541988	BolC8t50019H	0	-	185	1166	1728	0.6747685
C8	33557189	33559290	BolC8t50020H	0	-	347	1853	2101	0.8819610
C8	33560931	33561890	BolC8t50021H	0	+	780	959	959	1.0000000
C8	33562692	33562990	BolC8t50022H	0	+	243	298	298	1.0000000
C8	33563457	33564335	BolC8t50023H	0	-	408	878	878	1.0000000
C8	33574923	33576876	BolC8t50024H	0	+	1673	1940	1953	0.9933436
C8	33577015	33577192	BolC8t50025H	0	-	273	177	177	1.0000000
C8	33577792	33585010	BolC8t50026H	0	-	2216	6590	7218	0.9129953
C8	33590693	33591882	BolC8t50027H	0	-	377	1178	1189	0.9907485
C8	33593402	33595085	BolC8t50028H	0	+	741	1630	1683	0.9685086
C8	33595817	33597579	BolC8t50029H	0	-	868	1656	1762	0.9398411
C8	33597871	33598883	BolC8t50030H	0	+	1189	1012	1012	1.0000000
C8	33599335	33600952	BolC8t50031H	0	+	1327	1617	1617	1.0000000
C8	33615626	33622152	BolC8t50032H	0	+	2464	5817	6526	0.8913577
C8	33634484	33636967	BolC8t50033H	0	+	749	2263	2483	0.9113975
C8	33644848	33647966	BolC8t50034H	0	-	2061	3118	3118	1.0000000
C8	33648982	33654040	BolC8t50035H	0	-	364	2987	5058	0.5905496
C8	33655172	33657575	BolC8t50036H	0	+	1384	2403	2403	1.0000000
C8	33657845	33661061	BolC8t50037H	0	-	619	2094	3216	0.6511194
C8	33677123	33678377	BolC8t50038H	0	+	841	1254	1254	1.0000000
C8	33689626	33693040	BolC8t50039H	0	+	590	2640	3414	0.7732865
C8	33695315	33696276	BolC8t50040H	0	+	311	961	961	1.0000000
C8	33711007	33712112	BolC8t50041H	0	+	959	1105	1105	1.0000000
C8	33712715	33714616	BolC8t50042H	0	-	749	1890	1901	0.9942136
C8	33716218	33717365	BolC8t50043H	0	-	492	1147	1147	1.0000000
C8	33725352	33729230	BolC8t50044H	0	+	1381	3256	3878	0.8396081
C8	33750617	33752097	BolC8t50045H	0	+	175	1140	1480	0.7702703
C8	33752531	33755550	BolC8t50046H	0	-	1278	2353	3019	0.7793971
C8	33761297	33776280	BolC8t50047H	0	+	1509	7534	14983	0.5028365
C8	33768888	33769547	BolC8t50048H	0	-	46	554	659	0.8406677
C8	33778892	33779558	BolC8t50049H	0	-	352	666	666	1.0000000
C8	33787760	33790592	BolC8t50050H	0	-	857	2715	2832	0.9586864
C8	33791513	33792080	BolC8t50051H	0	+	4	34	567	0.0599647
C8	33796212	33796779	BolC8t50052H	0	-	387	567	567	1.0000000
C8	33798844	33800589	BolC8t50053H	0	-	147	1253	1745	0.7180516
C8	33811891	33812131	BolC8t50054H	0	-	114	131	240	0.5458333
C8	33826318	33828154	BolC8t50055H	0	+	0	0	1836	0.0000000
C8	33840660	33841800	BolC8t50056H	0	+	362	1140	1140	1.0000000
C8	33855963	33859072	BolC8t50057H	0	-	1039	3011	3109	0.9684786
C8	33860463	33862121	BolC8t50058H	0	-	629	1289	1658	0.7774427
C8	33864862	33867156	BolC8t50059H	0	-	1917	2294	2294	1.0000000
C8	33875335	33876508	BolC8t50060H	0	-	172	516	1173	0.4398977
C8	33881302	33881458	BolC8t50061H	0	-	35	156	156	1.0000000
C8	33886812	33887015	BolC8t50062H	0	+	316	203	203	1.0000000
C8	33891354	33891929	BolC8t50063H	0	+	115	529	575	0.9200000
C8	33898969	33900705	BolC8t50064H	0	+	958	1736	1736	1.0000000
C8	33920411	33921636	BolC8t50065H	0	-	448	1168	1225	0.9534694
C8	33925042	33926269	BolC8t50066H	0	-	355	1102	1227	0.8981255
C8	33937450	33938284	BolC8t50067H	0	-	531	827	834	0.9916067
C8	33945930	33947154	BolC8t50068H	0	-	387	598	1224	0.4885621
C8	33964806	33967837	BolC8t50069H	0	-	1423	2960	3031	0.9765754
C8	33969721	33971574	BolC8t50070H	0	-	1138	1853	1853	1.0000000
C8	33974907	33976101	BolC8t50071H	0	+	776	981	1194	0.8216081
C8	33977016	33979268	BolC8t50072H	0	+	2386	2252	2252	1.0000000
C8	33984326	33984620	BolC8t50073H	0	-	211	294	294	1.0000000
C8	33990162	33990417	BolC8t50074H	0	-	508	255	255	1.0000000
C8	34027902	34029104	BolC8t50075H	0	+	721	1185	1202	0.9858569
C8	34029642	34035143	BolC8t50076H	0	-	2226	5154	5501	0.9369206
C8	34036393	34038181	BolC8t50077H	0	-	670	1735	1788	0.9703580
C8	34044216	34044452	BolC8t50078H	0	-	49	236	236	1.0000000
C8	34045272	34045380	BolC8t50079H	0	-	59	108	108	1.0000000
C8	34046383	34049423	BolC8t50080H	0	+	1711	2944	3040	0.9684210
C8	34057938	34063282	BolC8t50081H	0	-	5000	5344	5344	1.0000000
C8	34063808	34064446	BolC8t50082H	0	+	743	638	638	1.0000000
C8	34080987	34083118	BolC8t50083H	0	+	1991	2131	2131	1.0000000
C8	34102913	34104144	BolC8t50084H	0	+	964	1216	1231	0.9878148
C8	34138398	34140400	BolC8t50085H	0	-	86	883	2002	0.4410589
C8	34141999	34143677	BolC8t50086H	0	-	472	1378	1678	0.8212157
C8	34150704	34152870	BolC8t50087H	0	+	250	1527	2166	0.7049862
C8	34153065	34154604	BolC8t50088H	0	-	323	1459	1539	0.9480182
C8	34155798	34158593	BolC8t50089H	0	-	481	2257	2795	0.8075134
C8	34159505	34161428	BolC8t50090H	0	-	720	1763	1923	0.9167967
C8	34171164	34171995	BolC8t50091H	0	-	666	831	831	1.0000000
C8	34181055	34181316	BolC8t50092H	0	-	0	0	261	0.0000000
C8	34191252	34191813	BolC8t50093H	0	-	119	524	561	0.9340463
C8	34240254	34241296	BolC8t50094H	0	+	723	1042	1042	1.0000000
C8	34242558	34243275	BolC8t50095H	0	-	658	717	717	1.0000000
C8	34244418	34245150	BolC8t50096H	0	-	624	732	732	1.0000000
C8	34256107	34256957	BolC8t50097H	0	+	551	850	850	1.0000000
C8	34263129	34264164	BolC8t50098H	0	-	343	1035	1035	1.0000000
C8	34268047	34268962	BolC8t50099H	0	-	356	777	915	0.8491803
C8	34275727	34276912	BolC8t50100H	0	-	2025	1185	1185	1.0000000
C8	34293636	34294447	BolC8t50101H	0	+	0	0	811	0.0000000
C8	34295100	34295924	BolC8t50102H	0	-	1293	824	824	1.0000000
C8	34309453	34310061	BolC8t50103H	0	+	255	526	608	0.8651316
C8	34317784	34318260	BolC8t50104H	0	-	128	387	476	0.8130252
C8	34329641	34331415	BolC8t50105H	0	-	245	1621	1774	0.9137542
C8	34332121	34332283	BolC8t50106H	0	-	120	162	162	1.0000000
C8	34336354	34336537	BolC8t50107H	0	+	108	183	183	1.0000000
C8	34342747	34344090	BolC8t50108H	0	+	770	1343	1343	1.0000000
C8	34357933	34359713	BolC8t50109H	0	+	491	1777	1780	0.9983146
C8	34364904	34365881	BolC8t50110H	0	+	755	977	977	1.0000000
C8	34366204	34368359	BolC8t50111H	0	-	315	1583	2155	0.7345707
C8	34369498	34369939	BolC8t50112H	0	+	81	396	441	0.8979592
C8	34394530	34394797	BolC8t50113H	0	-	232	267	267	1.0000000
C8	34405634	34405850	BolC8t50114H	0	-	24	216	216	1.0000000
C8	34411655	34412475	BolC8t50115H	0	+	280	787	820	0.9597561
C8	34426109	34426669	BolC8t50116H	0	-	312	560	560	1.0000000
C8	34428844	34429995	BolC8t50117H	0	-	509	1151	1151	1.0000000
C8	34441389	34443002	BolC8t50118H	0	+	132	1347	1613	0.8350899
C8	34452833	34453091	BolC8t50119H	0	-	0	0	258	0.0000000
C8	34465024	34466281	BolC8t50120H	0	+	291	1257	1257	1.0000000
C8	34468713	34468975	BolC8t50121H	0	-	56	207	262	0.7900763
C8	34469243	34470077	BolC8t50122H	0	-	60	751	834	0.9004796
C8	34470276	34471452	BolC8t50123H	0	-	936	1176	1176	1.0000000
C8	34472529	34493808	BolC8t50124H	0	-	13843	17161	21279	0.8064759
C8	34476790	34478919	BolC8t50125H	0	+	3994	2129	2129	1.0000000
C8	34495576	34495807	BolC8t50126H	0	-	227	231	231	1.0000000
C8	34505055	34505304	BolC8t50127H	0	-	225	249	249	1.0000000
C8	34505567	34507854	BolC8t50128H	0	-	182	1107	2287	0.4840402
C8	34509188	34509426	BolC8t50129H	0	-	45	236	238	0.9915966
C8	34511886	34513891	BolC8t50130H	0	+	930	1959	2005	0.9770573
C8	34516141	34519027	BolC8t50131H	0	+	1765	2840	2886	0.9840610
C8	34523291	34524437	BolC8t50132H	0	+	251	1146	1146	1.0000000
C8	34524591	34527367	BolC8t50133H	0	-	1347	2723	2776	0.9809078
C8	34532565	34533402	BolC8t50134H	0	-	440	837	837	1.0000000
C8	34559217	34559872	BolC8t50135H	0	-	12	19	655	0.0290076
C8	34566795	34567263	BolC8t50136H	0	+	19	278	468	0.5940171
C8	34579511	34580850	BolC8t50137H	0	-	495	1297	1339	0.9686333
C8	34604412	34614524	BolC8t50138H	0	-	2065	5526	10112	0.5464794
C8	34616722	34617839	BolC8t50139H	0	-	176	1113	1117	0.9964190
C8	34620610	34623316	BolC8t50140H	0	-	1152	2639	2706	0.9752402
C8	34641336	34641549	BolC8t50141H	0	+	62	213	213	1.0000000
C8	34643407	34644148	BolC8t50142H	0	-	311	741	741	1.0000000
C8	34658916	34661059	BolC8t50143H	0	+	628	1952	2143	0.9108726
C8	34661818	34664160	BolC8t50144H	0	-	563	2226	2342	0.9504697
C8	34666712	34668635	BolC8t50145H	0	-	948	1749	1923	0.9095164
C8	34676521	34677195	BolC8t50146H	0	-	241	674	674	1.0000000
C8	34682231	34682510	BolC8t50147H	0	+	163	279	279	1.0000000
C8	34682937	34684861	BolC8t50148H	0	-	606	1770	1924	0.9199584
C8	34693965	34694940	BolC8t50149H	0	-	330	845	975	0.8666667
C8	34700908	34706625	BolC8t50150H	0	-	3456	5669	5717	0.9916040
C8	34713370	34714772	BolC8t50151H	0	-	1200	1402	1402	1.0000000
C8	34717014	34717503	BolC8t50152H	0	+	181	489	489	1.0000000
C8	34719090	34720104	BolC8t50153H	0	+	1116	1014	1014	1.0000000
C8	34722099	34723128	BolC8t50154H	0	-	761	958	1029	0.9310009
C8	34754861	34756138	BolC8t50155H	0	-	458	1277	1277	1.0000000
C8	34757874	34758555	BolC8t50156H	0	-	261	644	681	0.9456682
C8	34771637	34772345	BolC8t50157H	0	+	62	587	708	0.8290960
C8	34772355	34772943	BolC8t50158H	0	+	1	31	588	0.0527211
C8	34782600	34783812	BolC8t50159H	0	-	142	970	1212	0.8003300
C8	34787690	34787960	BolC8t50160H	0	+	193	270	270	1.0000000
C8	34792152	34792742	BolC8t50161H	0	+	9	387	590	0.6559322
C8	34794160	34800816	BolC8t50162H	0	-	3049	6639	6656	0.9974459
C8	34802817	34805322	BolC8t50163H	0	+	1619	2494	2505	0.9956088
C8	34807613	34808757	BolC8t50164H	0	+	56	650	1144	0.5681818
C8	34814447	34814792	BolC8t50165H	0	-	102	290	345	0.8405797
C8	34822465	34823328	BolC8t50166H	0	+	110	634	863	0.7346466
C8	34825361	34830931	BolC8t50167H	0	+	2726	3708	5570	0.6657091
C8	34833101	34857342	BolC8t50168H	0	+	10729	22266	24241	0.9185265
C8	34847448	34848654	BolC8t50169H	0	+	647	1206	1206	1.0000000
C8	34848674	34849052	BolC8t50170H	0	+	163	378	378	1.0000000
C8	34858613	34859999	BolC8t50171H	0	+	107	903	1386	0.6515151
C8	34864487	34864847	BolC8t50172H	0	+	82	307	360	0.8527778
C8	34870658	34870949	BolC8t50173H	0	-	343	291	291	1.0000000
C8	34875535	34875788	BolC8t50174H	0	-	318	253	253	1.0000000
C8	34882725	34883415	BolC8t50175H	0	+	298	690	690	1.0000000
C8	34886218	34896290	BolC8t50176H	0	+	4211	8525	10072	0.8464059
C8	34897046	34908583	BolC8t50177H	0	-	6299	11498	11537	0.9966196
C8	34902179	34902822	BolC8t50178H	0	-	417	643	643	1.0000000
C8	34903820	34904930	BolC8t50179H	0	+	786	1110	1110	1.0000000
C8	34915623	34918641	BolC8t50180H	0	+	1030	2911	3018	0.9645461
C8	34931545	34935074	BolC8t50181H	0	-	459	2242	3529	0.6353074
C8	34954341	34955022	BolC8t50182H	0	-	2	103	681	0.1512482
C8	34966570	34967151	BolC8t50183H	0	+	17	365	581	0.6282272
C8	34970333	34978162	BolC8t50184H	0	+	660	4913	7829	0.6275386
C8	35014210	35015569	BolC8t50185H	0	-	376	1302	1359	0.9580574
C8	35041461	35041728	BolC8t50186H	0	+	308	267	267	1.0000000
C8	35046454	35046987	BolC8t50187H	0	-	8	353	533	0.6622889
C8	35068777	35069369	BolC8t50188H	0	-	0	0	592	0.0000000
C8	35086325	35088114	BolC8t50189H	0	-	10	523	1789	0.2923421
C8	35094718	35095304	BolC8t50190H	0	-	0	0	586	0.0000000
C8	35113300	35114027	BolC8t50191H	0	-	4	84	727	0.1155433
C8	35119936	35120236	BolC8t50192H	0	+	74	300	300	1.0000000
C8	35159762	35160438	BolC8t50193H	0	-	2	69	676	0.1020710
C8	35187871	35189623	BolC8t50194H	0	+	586	1451	1752	0.8281963
C8	35204811	35205181	BolC8t50195H	0	-	345	370	370	1.0000000
C8	35206725	35207085	BolC8t50196H	0	-	432	360	360	1.0000000
C8	35212062	35212251	BolC8t50197H	0	-	275	189	189	1.0000000
C8	35218381	35219191	BolC8t50198H	0	-	143	588	810	0.7259259
C8	35224990	35227026	BolC8t50199H	0	-	1350	2036	2036	1.0000000
C8	35229280	35230330	BolC8t50200H	0	-	284	789	1050	0.7514285
C8	35234186	35234375	BolC8t50201H	0	-	74	189	189	1.0000000
C8	35235562	35255296	BolC8t50202H	0	-	9941	15447	19734	0.7827607
C8	35246120	35247416	BolC8t50203H	0	-	556	1177	1296	0.9081790
C8	35254144	35254564	BolC8t50204H	0	-	23	420	420	1.0000000
C8	35271455	35271656	BolC8t50205H	0	+	164	201	201	1.0000000
C8	35300128	35300363	BolC8t50206H	0	-	221	235	235	1.0000000
C8	35301018	35301348	BolC8t50207H	0	-	374	330	330	1.0000000
C8	35320135	35320547	BolC8t50208H	0	-	40	381	412	0.9247573
C8	35335326	35336904	BolC8t50209H	0	-	232	1152	1578	0.7300380
C8	35345841	35347628	BolC8t50210H	0	-	740	1729	1787	0.9675434
C8	35349958	35351140	BolC8t50211H	0	-	128	942	1182	0.7969543
C8	35351271	35352244	BolC8t50212H	0	-	23	585	973	0.6012333
C8	35355412	35355874	BolC8t50213H	0	-	51	388	462	0.8398268
C8	35367298	35368148	BolC8t50214H	0	-	38	527	850	0.6200000
C8	35368599	35369456	BolC8t50215H	0	-	96	522	857	0.6091015
C8	35374799	35375893	BolC8t50216H	0	-	517	1094	1094	1.0000000
C8	35376812	35378349	BolC8t50217H	0	-	1253	1537	1537	1.0000000
C8	35379440	35379947	BolC8t50218H	0	-	446	507	507	1.0000000
C8	35380108	35380900	BolC8t50219H	0	-	650	792	792	1.0000000
C8	35382764	35383122	BolC8t50220H	0	-	120	358	358	1.0000000
C8	35385345	35386358	BolC8t50221H	0	-	128	897	1013	0.8854886
C8	35389380	35391427	BolC8t50222H	0	-	319	1920	2047	0.9379580
C8	35392848	35393904	BolC8t50223H	0	-	390	1013	1056	0.9592803
C8	35408493	35409258	BolC8t50224H	0	-	514	765	765	1.0000000
C8	35409721	35411422	BolC8t50225H	0	+	1106	1641	1701	0.9647266
C8	35429951	35431209	BolC8t50226H	0	+	127	696	1258	0.5532591
C8	35433799	35434639	BolC8t50227H	0	+	129	515	840	0.6130952
C8	35436628	35437276	BolC8t50228H	0	+	210	505	648	0.7793210
C8	35438836	35439178	BolC8t50229H	0	+	45	201	342	0.5877193
C8	35440745	35442170	BolC8t50230H	0	+	1279	1425	1425	1.0000000
C8	35442489	35443190	BolC8t50231H	0	-	209	701	701	1.0000000
C8	35447550	35448324	BolC8t50232H	0	+	528	774	774	1.0000000
C8	35477207	35478220	BolC8t50233H	0	-	200	828	1013	0.8173741
C8	35478355	35479569	BolC8t50234H	0	-	739	945	1214	0.7784184
C8	35490791	35491652	BolC8t50235H	0	-	84	752	861	0.8734030
C8	35492506	35493467	BolC8t50236H	0	-	970	961	961	1.0000000
C8	35509234	35509570	BolC8t50237H	0	+	238	336	336	1.0000000
C8	35516851	35518546	BolC8t50238H	0	+	254	911	1695	0.5374631
C8	35520089	35525209	BolC8t50239H	0	+	920	4245	5120	0.8291016
C8	35525402	35526843	BolC8t50240H	0	-	985	1441	1441	1.0000000
C8	35527266	35528205	BolC8t50241H	0	+	390	922	939	0.9818956
C8	35530205	35531806	BolC8t50242H	0	+	319	1468	1601	0.9169269
C8	35535847	35537115	BolC8t50243H	0	-	109	1071	1268	0.8446372
C8	35542511	35544257	BolC8t50244H	0	+	33	641	1746	0.3671249
C8	35545152	35545719	BolC8t50245H	0	-	4	10	567	0.0176367
C8	35547163	35547725	BolC8t50246H	0	+	115	562	562	1.0000000
C8	35552578	35553134	BolC8t50247H	0	+	289	545	556	0.9802158
C8	35555758	35565054	BolC8t50248H	0	-	2289	6881	9296	0.7402108
C8	35565564	35566714	BolC8t50249H	0	-	956	1150	1150	1.0000000
C8	35577346	35577995	BolC8t50250H	0	+	104	485	649	0.7473035
C8	35582283	35583259	BolC8t50251H	0	-	78	661	976	0.6772541
C8	35592690	35593223	BolC8t50252H	0	+	310	533	533	1.0000000
C8	35593715	35593940	BolC8t50253H	0	-	20	194	225	0.8622222
C8	35628311	35629905	BolC8t50254H	0	+	159	1063	1594	0.6668758
C8	35637186	35640916	BolC8t50255H	0	+	429	2378	3730	0.6375335
C8	35647813	35647987	BolC8t50256H	0	+	0	0	174	0.0000000
C8	35650433	35656240	BolC8t50257H	0	-	1098	3590	5807	0.6182194
C8	35663341	35668399	BolC8t50258H	0	+	2497	5020	5058	0.9924871
C8	35670972	35675227	BolC8t50259H	0	+	1080	3449	4255	0.8105758
C8	35676069	35677152	BolC8t50260H	0	-	267	1036	1083	0.9566020
C8	35685801	35688070	BolC8t50261H	0	+	1361	2173	2269	0.9576906
C8	35688478	35689064	BolC8t50262H	0	-	75	582	586	0.9931741
C8	35700212	35700530	BolC8t50263H	0	-	3	119	318	0.3742138
C8	35702378	35703139	BolC8t50264H	0	-	206	761	761	1.0000000
C8	35704928	35706463	BolC8t50265H	0	+	70	1044	1535	0.6801303
C8	35710919	35712909	BolC8t50266H	0	+	1275	1990	1990	1.0000000
C8	35716946	35718435	BolC8t50267H	0	+	888	1442	1489	0.9684352
C8	35719588	35722241	BolC8t50268H	0	+	946	2450	2653	0.9234828
C8	35722731	35724302	BolC8t50269H	0	+	1249	1556	1571	0.9904519
C8	35726950	35732989	BolC8t50270H	0	+	1551	5722	6039	0.9475079
C8	35729527	35730377	BolC8t50271H	0	-	208	822	850	0.9670588
C8	35733385	35738031	BolC8t50272H	0	-	721	3412	4646	0.7343952
C8	35741887	35743465	BolC8t50273H	0	-	1262	1578	1578	1.0000000
C8	35744606	35744768	BolC8t50274H	0	-	64	162	162	1.0000000
C8	35744871	35745138	BolC8t50275H	0	+	85	177	267	0.6629214
C8	35747504	35749935	BolC8t50276H	0	-	685	2342	2431	0.9633896
C8	35752712	35755345	BolC8t50277H	0	-	1693	2584	2633	0.9813901
C8	35757820	35758552	BolC8t50278H	0	-	679	732	732	1.0000000
C8	35760112	35761490	BolC8t50279H	0	+	585	1329	1378	0.9644412
C8	35764128	35765077	BolC8t50280H	0	-	782	949	949	1.0000000
C8	35775127	35777109	BolC8t50281H	0	+	999	1840	1982	0.9283552
C8	35777243	35778068	BolC8t50282H	0	-	440	776	825	0.9406061
C8	35780860	35781694	BolC8t50283H	0	-	70	478	834	0.5731415
C8	35788301	35789748	BolC8t50284H	0	+	545	1431	1447	0.9889426
C8	35794357	35796941	BolC8t50285H	0	+	661	2378	2584	0.9202786
C8	35799868	35801551	BolC8t50286H	0	-	649	1662	1683	0.9875223
C8	35802386	35805634	BolC8t50287H	0	+	1670	3183	3248	0.9799877
C8	35806200	35809192	BolC8t50288H	0	-	927	2838	2992	0.9485294
C8	35811884	35812597	BolC8t50289H	0	+	331	713	713	1.0000000
C8	35814096	35816367	BolC8t50290H	0	+	273	1576	2271	0.6939674
C8	35819692	35822001	BolC8t50291H	0	-	337	1918	2309	0.8306626
C8	35824188	35829583	BolC8t50292H	0	-	2930	5185	5395	0.9610751
C8	35829992	35833023	BolC8t50293H	0	+	447	1460	3031	0.4816892
C8	35835963	35836311	BolC8t50294H	0	-	61	290	348	0.8333333
C8	35859925	35860276	BolC8t50295H	0	-	30	244	351	0.6951567
C8	35860931	35861819	BolC8t50296H	0	-	858	888	888	1.0000000
C8	35869108	35871780	BolC8t50297H	0	+	701	2554	2672	0.9558383
C8	35874316	35877020	BolC8t50298H	0	+	523	2095	2704	0.7747781
C8	35877813	35878071	BolC8t50299H	0	+	169	258	258	1.0000000
C8	35878413	35881128	BolC8t50300H	0	+	121	925	2715	0.3406998
C8	35882357	35882552	BolC8t50301H	0	+	151	195	195	1.0000000
C8	35901140	35902135	BolC8t50302H	0	-	527	989	995	0.9939699
C8	35910768	35912811	BolC8t50303H	0	+	68	1126	2043	0.5511503
C8	35918468	35919587	BolC8t50304H	0	-	248	797	1119	0.7122431
C8	35924788	35926412	BolC8t50305H	0	-	531	1225	1624	0.7543104
C8	35927909	35929390	BolC8t50306H	0	+	699	1449	1481	0.9783930
C8	35930367	35932096	BolC8t50307H	0	-	1088	1729	1729	1.0000000
C8	35938266	35941376	BolC8t50308H	0	+	1320	2960	3110	0.9517685
C8	35951305	35955494	BolC8t50309H	0	+	1326	3192	4189	0.7619957
C8	35953368	35954583	BolC8t50310H	0	+	221	1155	1215	0.9506173
C8	35955611	35956786	BolC8t50311H	0	+	1812	1175	1175	1.0000000
C8	35958583	35958808	BolC8t50312H	0	-	1155	225	225	1.0000000
C8	35961212	35962425	BolC8t50313H	0	+	465	1172	1213	0.9661995
C8	35965243	35965528	BolC8t50314H	0	-	59	262	285	0.9192982
C8	35966912	35969549	BolC8t50315H	0	-	492	2386	2637	0.9048161
C8	35971666	35972517	BolC8t50316H	0	-	52	606	851	0.7121034
C8	35973396	35976484	BolC8t50317H	0	-	437	1787	3088	0.5786917
C8	35979381	35980531	BolC8t50318H	0	-	695	1150	1150	1.0000000
C8	35981708	35982467	BolC8t50319H	0	-	334	749	759	0.9868248
C8	35983280	35988925	BolC8t50320H	0	-	3043	5643	5645	0.9996457
C8	35989507	35992267	BolC8t50321H	0	-	2212	2755	2760	0.9981884
C8	35996829	35999836	BolC8t50322H	0	+	1227	2844	3007	0.9457932
C8	36005179	36008194	BolC8t50323H	0	+	874	2874	3015	0.9532338
C8	36009606	36010801	BolC8t50324H	0	-	421	1195	1195	1.0000000
C8	36011480	36015651	BolC8t50325H	0	-	719	3464	4171	0.8304963
C8	36032496	36032748	BolC8t50326H	0	-	110	252	252	1.0000000
C8	36033140	36034754	BolC8t50327H	0	-	600	1614	1614	1.0000000
C8	36034974	36035275	BolC8t50328H	0	-	73	252	301	0.8372093
C8	36060329	36060774	BolC8t50329H	0	-	35	262	445	0.5887641
C8	36067363	36079820	BolC8t50330H	0	-	2113	8665	12457	0.6955928
C8	36086031	36086334	BolC8t50331H	0	+	23	259	303	0.8547855
C8	36088085	36090163	BolC8t50332H	0	-	398	1450	2078	0.6977863
C8	36092669	36093692	BolC8t50333H	0	-	1131	1023	1023	1.0000000
C8	36095730	36096084	BolC8t50334H	0	+	122	354	354	1.0000000
C8	36096399	36096645	BolC8t50335H	0	+	56	246	246	1.0000000
C8	36097488	36098757	BolC8t50336H	0	+	92	628	1269	0.4948778
C8	36099558	36100927	BolC8t50337H	0	-	216	1146	1369	0.8371074
C8	36117118	36117713	BolC8t50338H	0	-	71	498	595	0.8369748
C8	36117800	36119195	BolC8t50339H	0	-	150	1090	1395	0.7813620
C8	36121876	36122506	BolC8t50340H	0	-	473	630	630	1.0000000
C8	36122145	36122372	BolC8t50341H	0	-	193	227	227	1.0000000
C8	36122958	36123999	BolC8t50342H	0	+	270	940	1041	0.9029779
C8	36133314	36133626	BolC8t50343H	0	-	126	312	312	1.0000000
C8	36135611	36137254	BolC8t50344H	0	-	591	1643	1643	1.0000000
C8	36138259	36139336	BolC8t50345H	0	+	762	1040	1077	0.9656453
C8	36140779	36141220	BolC8t50346H	0	-	406	441	441	1.0000000
C8	36141936	36145835	BolC8t50347H	0	+	2576	3794	3899	0.9730700
C8	36146658	36147702	BolC8t50348H	0	-	452	1044	1044	1.0000000
C8	36148674	36149016	BolC8t50349H	0	+	890	342	342	1.0000000
C8	36149160	36151317	BolC8t50350H	0	-	1353	2039	2157	0.9452944
C8	36151829	36152002	BolC8t50351H	0	+	209	173	173	1.0000000
C8	36152582	36153361	BolC8t50352H	0	-	338	750	779	0.9627728
C8	36153727	36157158	BolC8t50353H	0	+	687	2865	3431	0.8350335
C8	36157966	36158176	BolC8t50354H	0	+	92	210	210	1.0000000
C8	36158582	36160111	BolC8t50355H	0	-	743	1515	1529	0.9908437
C8	36163682	36166349	BolC8t50356H	0	+	968	2498	2667	0.9366329
C8	36166666	36167119	BolC8t50357H	0	-	53	246	453	0.5430464
C8	36168237	36174254	BolC8t50358H	0	+	2217	4878	6017	0.8107030
C8	36176739	36177728	BolC8t50359H	0	+	184	859	989	0.8685541
C8	36178139	36181010	BolC8t50360H	0	-	1874	2871	2871	1.0000000
C8	36182299	36184823	BolC8t50361H	0	-	750	2375	2524	0.9409667
C8	36188213	36190681	BolC8t50362H	0	+	773	2466	2468	0.9991896
C8	36191019	36192909	BolC8t50363H	0	-	878	1861	1890	0.9846561
C8	36193292	36194330	BolC8t50364H	0	+	911	1038	1038	1.0000000
C8	36194934	36197241	BolC8t50365H	0	-	851	1965	2307	0.8517555
C8	36199156	36199267	BolC8t50366H	0	+	0	0	111	0.0000000
C8	36199567	36199858	BolC8t50367H	0	+	40	291	291	1.0000000
C8	36199968	36200436	BolC8t50368H	0	+	75	365	468	0.7799146
C8	36202737	36203510	BolC8t50369H	0	-	583	773	773	1.0000000
C8	36205719	36211848	BolC8t50370H	0	+	1153	4828	6129	0.7877305
C8	36214266	36216919	BolC8t50371H	0	-	451	2484	2653	0.9362985
C8	36222771	36223033	BolC8t50372H	0	-	184	262	262	1.0000000
C8	36230809	36231031	BolC8t50373H	0	-	6	110	222	0.4954955
C8	36232329	36233908	BolC8t50374H	0	+	1387	1579	1579	1.0000000
C8	36240668	36240929	BolC8t50375H	0	-	0	0	261	0.0000000
C8	36248250	36248606	BolC8t50376H	0	+	508	356	356	1.0000000
C8	36264852	36265834	BolC8t50377H	0	-	1138	982	982	1.0000000
C8	36269996	36271016	BolC8t50378H	0	-	785	963	1020	0.9441177
C8	36274495	36274660	BolC8t50379H	0	+	0	0	165	0.0000000
C8	36297704	36298328	BolC8t50380H	0	-	382	624	624	1.0000000
C8	36298452	36298669	BolC8t50381H	0	-	210	217	217	1.0000000
C8	36301466	36304286	BolC8t50382H	0	+	484	2449	2820	0.8684397
C8	36311254	36322877	BolC8t50383H	0	+	695	5303	11623	0.4562505
C8	36323831	36324623	BolC8t50384H	0	+	2	132	792	0.1666667
C8	36325747	36326125	BolC8t50385H	0	+	36	133	378	0.3518519
C8	36335413	36337493	BolC8t50386H	0	+	274	1350	2080	0.6490384
C8	36338295	36340226	BolC8t50387H	0	+	149	1689	1931	0.8746763
C8	36364129	36364861	BolC8t50388H	0	+	21	204	732	0.2786885
C8	36370082	36371390	BolC8t50389H	0	-	13	151	1308	0.1154434
C8	36396345	36397254	BolC8t50390H	0	+	405	893	909	0.9823982
C8	36399296	36399923	BolC8t50391H	0	+	42	396	627	0.6315789
C8	36406153	36406783	BolC8t50392H	0	-	28	359	630	0.5698413
C8	36413341	36414222	BolC8t50393H	0	-	494	881	881	1.0000000
C8	36419313	36421972	BolC8t50394H	0	-	171	1642	2659	0.6175254
C8	36423043	36423595	BolC8t50395H	0	-	68	430	552	0.7789855
C8	36426949	36427417	BolC8t50396H	0	-	374	468	468	1.0000000
C8	36430016	36430346	BolC8t50397H	0	+	56	141	330	0.4272727
C8	36442656	36443460	BolC8t50398H	0	-	42	235	804	0.2922886
C8	36446763	36447276	BolC8t50399H	0	-	71	313	513	0.6101364
C8	36455902	36456992	BolC8t50400H	0	-	432	1045	1090	0.9587156
C8	36460800	36461094	BolC8t50401H	0	-	233	294	294	1.0000000
C8	36467783	36471824	BolC8t50402H	0	+	857	3791	4041	0.9381341
C8	36473820	36474264	BolC8t50403H	0	+	199	444	444	1.0000000
C8	36474940	36475969	BolC8t50404H	0	+	406	1027	1029	0.9980564
C8	36478916	36481037	BolC8t50405H	0	+	407	2079	2121	0.9801980
C8	36481834	36483650	BolC8t50406H	0	+	1124	1795	1816	0.9884361
C8	36502092	36504127	BolC8t50407H	0	+	1230	2027	2035	0.9960688
C8	36505955	36507430	BolC8t50408H	0	+	694	1368	1475	0.9274576
C8	36508333	36510031	BolC8t50409H	0	-	1302	1698	1698	1.0000000
C8	36512048	36513713	BolC8t50410H	0	+	1770	1665	1665	1.0000000
C8	36525004	36525853	BolC8t50411H	0	+	185	849	849	1.0000000
C8	36528448	36531197	BolC8t50412H	0	-	1246	2451	2749	0.8915970
C8	36538278	36539092	BolC8t50413H	0	-	280	814	814	1.0000000
C8	36543518	36543935	BolC8t50414H	0	-	69	368	417	0.8824940
C8	36548066	36548380	BolC8t50415H	0	+	129	314	314	1.0000000
C8	36549641	36551960	BolC8t50416H	0	-	1212	2175	2319	0.9379043
C8	36565701	36565911	BolC8t50417H	0	-	36	188	210	0.8952381
C8	36572682	36575433	BolC8t50418H	0	-	838	2505	2751	0.9105780
C8	36582731	36583676	BolC8t50419H	0	-	787	945	945	1.0000000
C8	36584041	36585415	BolC8t50420H	0	+	74	699	1374	0.5087336
C8	36594799	36597037	BolC8t50421H	0	-	258	2181	2238	0.9745308
C8	36611026	36611554	BolC8t50422H	0	+	106	488	528	0.9242424
C8	36614803	36617838	BolC8t50423H	0	-	791	1964	3035	0.6471170
C8	36621533	36624949	BolC8t50424H	0	+	986	2572	3416	0.7529274
C8	36625227	36626301	BolC8t50425H	0	-	689	1074	1074	1.0000000
C8	36629735	36632485	BolC8t50426H	0	-	818	2374	2750	0.8632727
C8	36635057	36637361	BolC8t50427H	0	-	663	1622	2304	0.7039931
C8	36651386	36656402	BolC8t50428H	0	+	2550	4863	5016	0.9694976
C8	36656823	36659027	BolC8t50429H	0	-	691	2204	2204	1.0000000
C8	36675407	36676610	BolC8t50430H	0	+	538	1203	1203	1.0000000
C8	36677662	36679251	BolC8t50431H	0	-	525	1566	1589	0.9855255
C8	36683241	36686012	BolC8t50432H	0	+	1496	2718	2771	0.9808733
C8	36687086	36688727	BolC8t50433H	0	-	758	1517	1641	0.9244363
C8	36694303	36694749	BolC8t50434H	0	+	351	446	446	1.0000000
C8	36694856	36695878	BolC8t50435H	0	+	912	1022	1022	1.0000000
C8	36695958	36697039	BolC8t50436H	0	+	1084	1081	1081	1.0000000
C8	36698296	36699304	BolC8t50437H	0	-	960	1008	1008	1.0000000
C8	36705410	36706103	BolC8t50438H	0	+	150	649	693	0.9365079
C8	36708611	36711838	BolC8t50439H	0	+	1829	3207	3227	0.9938023
C8	36714793	36715942	BolC8t50440H	0	+	607	1102	1149	0.9590949
C8	36716296	36717967	BolC8t50441H	0	-	385	1126	1671	0.6738480
C8	36720835	36721556	BolC8t50442H	0	-	513	721	721	1.0000000
C8	36727993	36729087	BolC8t50443H	0	+	228	946	1094	0.8647166
C8	36730277	36731075	BolC8t50444H	0	-	342	798	798	1.0000000
C8	36731804	36735452	BolC8t50445H	0	+	2272	3631	3648	0.9953399
C8	36752216	36753722	BolC8t50446H	0	-	652	1504	1506	0.9986720
C8	36764384	36766467	BolC8t50447H	0	-	156	937	2083	0.4498320
C8	36767039	36768512	BolC8t50448H	0	-	762	997	1473	0.6768500
C8	36770881	36772533	BolC8t50449H	0	-	800	1593	1652	0.9642857
C8	36773897	36778224	BolC8t50450H	0	+	2981	4062	4327	0.9387566
C8	36791502	36794812	BolC8t50451H	0	+	1246	2583	3310	0.7803625
C8	36796324	36797340	BolC8t50452H	0	-	1157	1016	1016	1.0000000
C8	36800815	36803914	BolC8t50453H	0	+	1125	2848	3099	0.9190061
C8	36816064	36816238	BolC8t50454H	0	-	127	154	174	0.8850574
C8	36819415	36819664	BolC8t50455H	0	-	113	249	249	1.0000000
C8	36825188	36827681	BolC8t50456H	0	-	223	1272	2493	0.5102286
C8	36835218	36838015	BolC8t50457H	0	-	2852	2791	2797	0.9978548
C8	36851761	36853758	BolC8t50458H	0	+	1229	1959	1997	0.9809715
C8	36855173	36858017	BolC8t50459H	0	+	601	2374	2844	0.8347398
C8	36859743	36861667	BolC8t50460H	0	+	378	1422	1924	0.7390853
C8	36862504	36863719	BolC8t50461H	0	-	1360	1215	1215	1.0000000
C8	36864368	36867144	BolC8t50462H	0	-	853	2712	2776	0.9769452
C8	36867792	36875825	BolC8t50463H	0	-	4967	5430	8033	0.6759617
C8	36881453	36882406	BolC8t50464H	0	-	2771	953	953	1.0000000
C8	36884785	36885662	BolC8t50465H	0	-	1050	877	877	1.0000000
C8	36886845	36887352	BolC8t50466H	0	-	1824	507	507	1.0000000
C8	36892728	36893139	BolC8t50467H	0	-	508	411	411	1.0000000
C8	36908441	36908669	BolC8t50468H	0	-	0	0	228	0.0000000
C8	36912683	36913112	BolC8t50469H	0	-	2	19	429	0.0442890
C8	36924509	36926073	BolC8t50470H	0	+	24	379	1564	0.2423274
C8	36935100	36946807	BolC8t50471H	0	+	867	2565	11707	0.2190997
C8	36948663	36949137	BolC8t50472H	0	+	0	0	474	0.0000000
C8	36953924	36955133	BolC8t50473H	0	-	643	1191	1209	0.9851117
C8	36958633	36960931	BolC8t50474H	0	+	988	2297	2298	0.9995648
C8	36961220	36961985	BolC8t50475H	0	-	63	664	765	0.8679739
C8	36963305	36963620	BolC8t50476H	0	-	137	183	315	0.5809524
C8	36972107	36975772	BolC8t50477H	0	+	1491	3278	3665	0.8944066
C8	36978414	36979302	BolC8t50478H	0	+	675	888	888	1.0000000
C8	36979944	36981528	BolC8t50479H	0	-	436	1450	1584	0.9154040
C8	36986101	36986602	BolC8t50480H	0	-	151	501	501	1.0000000
C8	36987812	36989324	BolC8t50481H	0	+	877	1512	1512	1.0000000
C8	36989752	36992179	BolC8t50482H	0	-	1505	2427	2427	1.0000000
C8	37003542	37004889	BolC8t50483H	0	-	368	1347	1347	1.0000000
C8	37009562	37012155	BolC8t50484H	0	-	109	1802	2593	0.6949480
C8	37012738	37013225	BolC8t50485H	0	+	10	146	487	0.2997947
C8	37014525	37016188	BolC8t50486H	0	-	352	1239	1663	0.7450391
C8	37016869	37019215	BolC8t50487H	0	-	456	2252	2346	0.9599318
C8	37023944	37026247	BolC8t50488H	0	+	208	1483	2303	0.6439427
C8	37027326	37028318	BolC8t50489H	0	+	1101	992	992	1.0000000
C8	37028582	37031905	BolC8t50490H	0	-	1642	3093	3323	0.9307854
C8	37046140	37047576	BolC8t50491H	0	+	436	1337	1436	0.9310585
C8	37049477	37050457	BolC8t50492H	0	-	431	980	980	1.0000000
C8	37054193	37056809	BolC8t50493H	0	-	1127	2571	2616	0.9827982
C8	37057486	37059665	BolC8t50494H	0	+	1216	2175	2179	0.9981643
C8	37059951	37061102	BolC8t50495H	0	-	249	998	1151	0.8670721
C8	37063169	37063980	BolC8t50496H	0	-	457	801	811	0.9876695
C8	37067127	37075478	BolC8t50497H	0	-	3175	7864	8351	0.9416837
C8	37083889	37085655	BolC8t50498H	0	+	867	1621	1766	0.9178935
C8	37086113	37086952	BolC8t50499H	0	+	530	839	839	1.0000000
C8	37088345	37088762	BolC8t50500H	0	+	138	417	417	1.0000000
C8	37090649	37091808	BolC8t50501H	0	+	617	1156	1159	0.9974115
C8	37096267	37098356	BolC8t50502H	0	-	707	2002	2089	0.9583533
C8	37102602	37104428	BolC8t50503H	0	-	710	1721	1826	0.9424973
C8	37104497	37104884	BolC8t50504H	0	-	9	192	387	0.4961240
C8	37107482	37107794	BolC8t50505H	0	-	79	312	312	1.0000000
C8	37108589	37109467	BolC8t50506H	0	-	457	839	878	0.9555809
C8	37110887	37112438	BolC8t50507H	0	+	266	1227	1551	0.7911025
C8	37113116	37116897	BolC8t50508H	0	-	113	1221	3781	0.3229305
C8	37117659	37119269	BolC8t50509H	0	-	255	1562	1610	0.9701864
C8	37122010	37122500	BolC8t50510H	0	+	381	490	490	1.0000000
C8	37127687	37135103	BolC8t50511H	0	+	1165	4324	7416	0.5830637
C8	37135744	37137985	BolC8t50512H	0	-	611	1746	2241	0.7791165
C8	37171895	37172318	BolC8t50513H	0	+	2	29	423	0.0685579
C8	37176542	37186262	BolC8t50514H	0	+	3708	7611	9720	0.7830247
C8	37186570	37187195	BolC8t50515H	0	-	189	549	625	0.8784000
C8	37188051	37189704	BolC8t50516H	0	+	487	1480	1653	0.8953418
C8	37190598	37191045	BolC8t50517H	0	-	315	447	447	1.0000000
C8	37192071	37194676	BolC8t50518H	0	-	1306	2358	2605	0.9051824
C8	37195509	37198626	BolC8t50519H	0	-	1063	2878	3117	0.9233237
C8	37220177	37221586	BolC8t50520H	0	+	509	1193	1409	0.8466998
C8	37224758	37226018	BolC8t50521H	0	-	33	587	1260	0.4658730
C8	37236331	37236653	BolC8t50522H	0	+	43	311	322	0.9658385
C8	37251934	37252240	BolC8t50523H	0	-	2	43	306	0.1405229
C8	37252888	37253176	BolC8t50524H	0	-	122	247	288	0.8576389
C8	37254824	37255745	BolC8t50525H	0	+	13	425	921	0.4614549
C8	37256868	37257255	BolC8t50526H	0	+	25	123	387	0.3178295
C8	37258263	37259658	BolC8t50527H	0	+	1119	1395	1395	1.0000000
C8	37271589	37273123	BolC8t50528H	0	-	2659	1534	1534	1.0000000
C8	37277363	37277914	BolC8t50529H	0	-	27	378	551	0.6860254
C8	37286874	37289234	BolC8t50530H	0	+	494	2049	2360	0.8682203
C8	37309282	37310264	BolC8t50531H	0	+	328	903	982	0.9195519
C8	37312796	37313779	BolC8t50532H	0	+	274	865	983	0.8799593
C8	37319004	37326181	BolC8t50533H	0	+	1017	4081	7177	0.5686220
C8	37327802	37328034	BolC8t50534H	0	-	112	232	232	1.0000000
C8	37330356	37331926	BolC8t50535H	0	+	434	1468	1570	0.9350318
C8	37332295	37335698	BolC8t50536H	0	-	777	3154	3403	0.9268293
C8	37343180	37345094	BolC8t50537H	0	+	1536	1914	1914	1.0000000
C8	37345348	37346247	BolC8t50538H	0	-	197	899	899	1.0000000
C8	37347856	37349901	BolC8t50539H	0	-	554	1961	2045	0.9589242
C8	37350507	37352132	BolC8t50540H	0	-	1077	1625	1625	1.0000000
C8	37354030	37354222	BolC8t50541H	0	-	122	192	192	1.0000000
C8	37360773	37360926	BolC8t50542H	0	-	13	153	153	1.0000000
C8	37364681	37366376	BolC8t50543H	0	-	694	1575	1695	0.9292035
C8	37368102	37370823	BolC8t50544H	0	+	774	2312	2721	0.8496876
C8	37373991	37374180	BolC8t50545H	0	+	247	189	189	1.0000000
C8	37374062	37374435	BolC8t50546H	0	+	350	373	373	1.0000000
C8	37375009	37377044	BolC8t50547H	0	-	1026	2035	2035	1.0000000
C8	37379837	37380524	BolC8t50548H	0	+	92	687	687	1.0000000
C8	37381774	37382483	BolC8t50549H	0	-	150	649	709	0.9153737
C8	37385551	37387591	BolC8t50550H	0	+	450	2013	2040	0.9867647
C8	37389807	37396111	BolC8t50551H	0	+	4473	5777	6304	0.9164023
C8	37396764	37397127	BolC8t50552H	0	+	13	112	363	0.3085400
C8	37397498	37397738	BolC8t50553H	0	+	35	185	240	0.7708333
C8	37399121	37401880	BolC8t50554H	0	-	549	2378	2759	0.8619065
C8	37403317	37405925	BolC8t50555H	0	-	1264	2440	2608	0.9355828
C8	37413258	37414015	BolC8t50556H	0	-	19	376	757	0.4966975
C8	37415248	37426731	BolC8t50557H	0	+	1807	5604	11483	0.4880258
C8	37427432	37428664	BolC8t50558H	0	-	381	1230	1232	0.9983766
C8	37437198	37438847	BolC8t50559H	0	-	1381	1649	1649	1.0000000
C8	37440474	37442037	BolC8t50560H	0	-	1741	1501	1563	0.9603327
C8	37448093	37451708	BolC8t50561H	0	+	744	2915	3615	0.8063624
C8	37459924	37462017	BolC8t50562H	0	-	472	1812	2093	0.8657430
C8	37464347	37467235	BolC8t50563H	0	-	1423	2588	2888	0.8961219
C8	37468630	37471675	BolC8t50564H	0	-	1095	3035	3045	0.9967159
C8	37475659	37478654	BolC8t50565H	0	-	915	2724	2995	0.9095159
C8	37479986	37497120	BolC8t50566H	0	+	819	4636	17134	0.2705731
C8	37481906	37482242	BolC8t50567H	0	+	19	251	336	0.7470238
C8	37483360	37485055	BolC8t50568H	0	-	0	0	1695	0.0000000
C8	37487345	37505869	BolC8t50569H	0	+	576	4897	18524	0.2643597
C8	37492399	37493086	BolC8t50570H	0	-	0	0	687	0.0000000
C8	37497811	37499973	BolC8t50571H	0	-	34	792	2162	0.3663275
C8	37507299	37507986	BolC8t50572H	0	-	0	0	687	0.0000000
C8	37511114	37512024	BolC8t50573H	0	+	0	0	910	0.0000000
C8	37512719	37518335	BolC8t50574H	0	-	971	4457	5616	0.7936254
C8	37529588	37530918	BolC8t50575H	0	+	18	320	1330	0.2406015
C8	37534659	37537170	BolC8t50576H	0	-	1455	2511	2511	1.0000000
C8	37539866	37541228	BolC8t50577H	0	-	570	722	1362	0.5301028
C8	37551248	37554362	BolC8t50578H	0	+	947	2836	3114	0.9107258
C8	37554874	37554979	BolC8t50579H	0	-	187	105	105	1.0000000
C8	37558890	37559997	BolC8t50580H	0	-	1542	1107	1107	1.0000000
C8	37563748	37565905	BolC8t50581H	0	+	541	2002	2157	0.9281409
C8	37566043	37566157	BolC8t50582H	0	+	31	114	114	1.0000000
C8	37571422	37573869	BolC8t50583H	0	+	45	1081	2447	0.4417654
C8	37590369	37590636	BolC8t50584H	0	-	415	267	267	1.0000000
C8	37601438	37649120	BolC8t50585H	0	-	9938	30842	47682	0.6468269
C8	37612895	37613725	BolC8t50586H	0	+	5	314	830	0.3783132
C8	37651820	37653760	BolC8t50587H	0	-	1173	1940	1940	1.0000000
C8	37664347	37665704	BolC8t50588H	0	+	631	1357	1357	1.0000000
C8	37678515	37680240	BolC8t50589H	0	-	300	1637	1725	0.9489855
C8	37682442	37684147	BolC8t50590H	0	-	505	1544	1705	0.9055718
C8	37684926	37688667	BolC8t50591H	0	-	1002	3233	3741	0.8642074
C8	37690218	37693046	BolC8t50592H	0	-	1556	2803	2828	0.9911599
C8	37697342	37704500	BolC8t50593H	0	+	700	4487	7158	0.6268511
C8	37705383	37706315	BolC8t50594H	0	+	153	654	932	0.7017167
C8	37708237	37708977	BolC8t50595H	0	+	275	740	740	1.0000000
C8	37710437	37712033	BolC8t50596H	0	-	72	965	1596	0.6046366
C8	37714003	37716878	BolC8t50597H	0	-	1444	2852	2875	0.9920000
C8	37720355	37721060	BolC8t50598H	0	+	280	665	705	0.9432624
C8	37722753	37724166	BolC8t50599H	0	+	549	1403	1413	0.9929228
C8	37724865	37728380	BolC8t50600H	0	-	2284	3478	3515	0.9894737
C8	37735980	37743442	BolC8t50601H	0	-	357	3629	7462	0.4863307
C8	37745455	37747875	BolC8t50602H	0	-	753	2343	2420	0.9681818
C8	37752739	37756440	BolC8t50603H	0	+	504	2946	3701	0.7960011
C8	37769135	37770336	BolC8t50604H	0	+	67	330	1201	0.2747710
C8	37783003	37785413	BolC8t50605H	0	+	182	1251	2410	0.5190871
C8	37790231	37791124	BolC8t50606H	0	+	126	829	893	0.9283315
C8	37798585	37799527	BolC8t50607H	0	+	259	897	942	0.9522293
C8	37800898	37804145	BolC8t50608H	0	-	364	2421	3247	0.7456113
C8	37810871	37811698	BolC8t50609H	0	+	35	374	827	0.4522370
C8	37812599	37813066	BolC8t50610H	0	+	0	0	467	0.0000000
C8	37817616	37817913	BolC8t50611H	0	+	56	195	297	0.6565657
C8	37819299	37822068	BolC8t50612H	0	+	1055	2668	2769	0.9635248
C8	37835043	37840552	BolC8t50613H	0	+	3311	5151	5509	0.9350154
C8	37840954	37845994	BolC8t50614H	0	-	2029	4497	5040	0.8922619
C8	37847701	37853384	BolC8t50615H	0	+	1697	4421	5683	0.7779342
C8	37853858	37854567	BolC8t50616H	0	-	124	640	709	0.9026798
C8	37856866	37858227	BolC8t50617H	0	-	192	1204	1361	0.8846437
C8	37859353	37859596	BolC8t50618H	0	-	142	236	243	0.9711934
C8	37863744	37867146	BolC8t50619H	0	-	2320	3398	3402	0.9988242
C8	37872856	37873053	BolC8t50620H	0	-	58	196	197	0.9949238
C8	37874735	37878466	BolC8t50621H	0	+	865	3247	3731	0.8702761
C8	37879193	37881504	BolC8t50622H	0	-	345	1485	2311	0.6425790
C8	37884694	37886385	BolC8t50623H	0	+	1133	1596	1691	0.9438202
C8	37891632	37893257	BolC8t50624H	0	-	159	944	1625	0.5809231
C8	37895082	37898163	BolC8t50625H	0	-	937	2822	3081	0.9159364
C8	37898993	37900562	BolC8t50626H	0	-	414	1553	1569	0.9898024
C8	37900763	37903313	BolC8t50627H	0	+	718	2027	2550	0.7949020
C8	37905161	37909152	BolC8t50628H	0	-	934	3737	3991	0.9363568
C8	37909577	37909757	BolC8t50629H	0	-	52	180	180	1.0000000
C8	37925349	37926876	BolC8t50630H	0	+	983	1527	1527	1.0000000
C8	37927520	37929306	BolC8t50631H	0	+	1424	1786	1786	1.0000000
C8	37930253	37932177	BolC8t50632H	0	+	335	1546	1924	0.8035343
C8	37932538	37937743	BolC8t50633H	0	-	2931	5063	5205	0.9727185
C8	37940995	37942127	BolC8t50634H	0	+	498	1085	1132	0.9584805
C8	37943241	37944851	BolC8t50635H	0	-	1391	1610	1610	1.0000000
C8	37945545	37946791	BolC8t50636H	0	-	97	914	1246	0.7335473
C8	37950822	37952170	BolC8t50637H	0	+	158	657	1348	0.4873887
C8	37953369	37953843	BolC8t50638H	0	-	0	0	474	0.0000000
C8	37959851	37961431	BolC8t50639H	0	-	0	0	1580	0.0000000
C8	38002830	38003067	BolC8t50640H	0	-	0	0	237	0.0000000
C8	38003487	38003797	BolC8t50641H	0	-	0	0	310	0.0000000
C8	38008520	38011454	BolC8t50642H	0	-	9	300	2934	0.1022495
C8	38012567	38013206	BolC8t50643H	0	+	0	0	639	0.0000000
C8	38022602	38050348	BolC8t50644H	0	-	978	3918	27746	0.1412095
C8	38035423	38038367	BolC8t50645H	0	-	2	37	2944	0.0125679
C8	38046116	38047211	BolC8t50646H	0	+	0	0	1095	0.0000000
C8	38054467	38054704	BolC8t50647H	0	-	0	0	237	0.0000000
C8	38058110	38094206	BolC8t50648H	0	-	2065	11665	36096	0.3231660
C8	38062174	38062810	BolC8t50649H	0	+	0	0	636	0.0000000
C8	38066714	38067794	BolC8t50650H	0	+	141	1007	1080	0.9324074
C8	38069702	38076137	BolC8t50651H	0	-	408	2468	6435	0.3835276
C8	38083497	38084605	BolC8t50652H	0	+	0	0	1108	0.0000000
C8	38095292	38095856	BolC8t50653H	0	+	0	0	564	0.0000000
C8	38108879	38111254	BolC8t50654H	0	+	727	2342	2375	0.9861053
C8	38111773	38112317	BolC8t50655H	0	+	48	413	544	0.7591912
C8	38114854	38115694	BolC8t50656H	0	+	78	716	840	0.8523809
C8	38116207	38119495	BolC8t50657H	0	-	837	3028	3288	0.9209246
C8	38123398	38125651	BolC8t50658H	0	-	524	1964	2253	0.8717266
C8	38171930	38173573	BolC8t50659H	0	-	629	1611	1643	0.9805234
C8	38177962	38179309	BolC8t50660H	0	-	335	1169	1347	0.8678545
C8	38190548	38192286	BolC8t50661H	0	-	856	1704	1738	0.9804373
C8	38193087	38194971	BolC8t50662H	0	-	947	1632	1884	0.8662421
C8	38206564	38207311	BolC8t50663H	0	+	557	747	747	1.0000000
C8	38221772	38224134	BolC8t50664H	0	+	683	2294	2362	0.9712108
C8	38225146	38225995	BolC8t50665H	0	+	32	681	849	0.8021201
C8	38233904	38234764	BolC8t50666H	0	-	308	734	860	0.8534884
C8	38250191	38251713	BolC8t50667H	0	+	530	1522	1522	1.0000000
C8	38255356	38257510	BolC8t50668H	0	+	942	1989	2154	0.9233983
C8	38258515	38260809	BolC8t50669H	0	+	731	1924	2294	0.8387097
C8	38261716	38263404	BolC8t50670H	0	+	727	1564	1688	0.9265403
C8	38264748	38266446	BolC8t50671H	0	-	1034	1605	1698	0.9452297
C8	38271341	38272178	BolC8t50672H	0	+	2175	837	837	1.0000000
C8	38273551	38274880	BolC8t50673H	0	-	526	1289	1329	0.9699022
C8	38302008	38302487	BolC8t50674H	0	-	36	413	479	0.8622130
C8	38337825	38338108	BolC8t50675H	0	+	22	212	283	0.7491166
C8	38347238	38348556	BolC8t50676H	0	+	807	1318	1318	1.0000000
C8	38349840	38350755	BolC8t50677H	0	+	59	637	915	0.6961749
C8	38350975	38354070	BolC8t50678H	0	-	1800	3095	3095	1.0000000
C8	38365765	38368605	BolC8t50679H	0	+	320	2297	2840	0.8088028
C8	38371929	38372580	BolC8t50680H	0	+	203	617	651	0.9477727
C8	38375643	38378305	BolC8t50681H	0	-	1423	2662	2662	1.0000000
C8	38384412	38385181	BolC8t50682H	0	+	1171	769	769	1.0000000
C8	38393636	38395665	BolC8t50683H	0	-	221	1557	2029	0.7673731
C8	38399101	38399961	BolC8t50684H	0	+	969	860	860	1.0000000
C8	38412170	38413738	BolC8t50685H	0	+	378	1375	1568	0.8769132
C8	38425012	38426092	BolC8t50686H	0	-	1112	1080	1080	1.0000000
C8	38432393	38433401	BolC8t50687H	0	+	647	1008	1008	1.0000000
C8	38435356	38440584	BolC8t50688H	0	+	1560	1745	5228	0.3337797
C8	38438535	38439033	BolC8t50689H	0	+	0	0	498	0.0000000
C8	38447756	38452523	BolC8t50690H	0	-	1343	4279	4767	0.8976296
C8	38453167	38454763	BolC8t50691H	0	+	803	1434	1596	0.8984963
C8	38455678	38456885	BolC8t50692H	0	+	759	1207	1207	1.0000000
C8	38456921	38498987	BolC8t50693H	0	+	7219	20921	42066	0.4973375
C8	38467251	38468133	BolC8t50694H	0	+	71	595	882	0.6746032
C8	38470298	38470694	BolC8t50695H	0	-	82	294	396	0.7424242
C8	38471248	38472377	BolC8t50696H	0	-	452	1019	1129	0.9025686
C8	38477914	38478492	BolC8t50697H	0	-	436	553	578	0.9567474
C8	38492423	38492825	BolC8t50698H	0	+	385	402	402	1.0000000
C8	38500811	38501120	BolC8t50699H	0	-	3	220	309	0.7119741
C8	38506859	38508127	BolC8t50700H	0	+	730	1214	1268	0.9574133
C8	38508921	38510094	BolC8t50701H	0	-	300	1173	1173	1.0000000
C8	38525472	38528213	BolC8t50702H	0	+	1238	2672	2741	0.9748267
C8	38531276	38533004	BolC8t50703H	0	+	127	1276	1728	0.7384259
C8	38558132	38558360	BolC8t50704H	0	-	44	150	228	0.6578947
C8	38561181	38563106	BolC8t50705H	0	+	21	905	1925	0.4701299
C8	38563810	38564904	BolC8t50706H	0	+	20	632	1094	0.5776965
C8	38567122	38567906	BolC8t50707H	0	+	3	259	784	0.3303571
C8	38575091	38575358	BolC8t50708H	0	+	1	6	267	0.0224719
C8	38579502	38580454	BolC8t50709H	0	+	371	880	952	0.9243698
C8	38580978	38582891	BolC8t50710H	0	-	1167	1679	1913	0.8776790
C8	38585322	38586660	BolC8t50711H	0	-	102	372	1338	0.2780269
C8	38591340	38592234	BolC8t50712H	0	-	37	497	894	0.5559284
C8	38604550	38604748	BolC8t50713H	0	-	183	198	198	1.0000000
C8	38607474	38607741	BolC8t50714H	0	+	49	267	267	1.0000000
C8	38612246	38615164	BolC8t50715H	0	+	2160	2513	2918	0.8612063
C8	38616903	38617459	BolC8t50716H	0	+	31	387	556	0.6960432
C8	38622499	38638748	BolC8t50717H	0	+	1314	5257	16249	0.3235276
C8	38639375	38643514	BolC8t50718H	0	-	672	2999	4139	0.7245712
C8	38665231	38666748	BolC8t50719H	0	+	1167	1516	1517	0.9993408
C8	38667681	38670744	BolC8t50720H	0	+	1035	2670	3063	0.8716944
C8	38671526	38673519	BolC8t50721H	0	+	1757	1993	1993	1.0000000
C8	38684090	38685117	BolC8t50722H	0	+	1047	1027	1027	1.0000000
C8	38686531	38689215	BolC8t50723H	0	-	677	2246	2684	0.8368107
C8	38699286	38699748	BolC8t50724H	0	+	27	354	462	0.7662337
C8	38702140	38706203	BolC8t50725H	0	+	3026	3944	4063	0.9707113
C8	38715985	38717793	BolC8t50726H	0	+	316	1573	1808	0.8700221
C8	38718017	38719596	BolC8t50727H	0	-	524	1566	1579	0.9917669
C8	38783041	38785284	BolC8t50728H	0	+	353	1822	2243	0.8123050
C8	38785889	38786760	BolC8t50729H	0	+	385	862	871	0.9896671
C8	38787027	38787655	BolC8t50730H	0	+	428	607	628	0.9665605
C8	38788055	38789340	BolC8t50731H	0	+	465	1199	1285	0.9330739
C8	38789986	38791120	BolC8t50732H	0	+	252	1050	1134	0.9259259
C8	38792529	38792865	BolC8t50733H	0	+	167	326	336	0.9702381
C8	38800365	38802212	BolC8t50734H	0	+	129	1403	1847	0.7596102
C8	38820063	38820678	BolC8t50735H	0	+	233	615	615	1.0000000
C8	38821610	38823065	BolC8t50736H	0	+	419	1455	1455	1.0000000
C8	38823277	38824555	BolC8t50737H	0	-	19	265	1278	0.2073552
C8	38833246	38833348	BolC8t50738H	0	-	0	0	102	0.0000000
C8	38833357	38834032	BolC8t50739H	0	-	0	0	675	0.0000000
C8	38837379	38839068	BolC8t50740H	0	-	479	1525	1689	0.9029011
C8	38839310	38839970	BolC8t50741H	0	-	42	253	660	0.3833333
C8	38840410	38841780	BolC8t50742H	0	-	874	1370	1370	1.0000000
C8	38847871	38849367	BolC8t50743H	0	+	388	1261	1496	0.8429145
C8	38852625	38854666	BolC8t50744H	0	+	993	1592	2041	0.7800098
C8	38861020	38862549	BolC8t50745H	0	-	783	1529	1529	1.0000000
C8	38863361	38866042	BolC8t50746H	0	+	356	1839	2681	0.6859381
C8	38868032	38870456	BolC8t50747H	0	-	227	1624	2424	0.6699670
C8	38879966	38881423	BolC8t50748H	0	-	740	1457	1457	1.0000000
C8	38894380	38899394	BolC8t50749H	0	-	1302	3753	5014	0.7485042
C8	38899837	38900062	BolC8t50750H	0	-	3	145	225	0.6444445
C8	38913934	38915560	BolC8t50751H	0	+	86	572	1626	0.3517835
C8	38918784	38921326	BolC8t50752H	0	+	170	1816	2542	0.7143981
C8	38922242	38924408	BolC8t50753H	0	-	430	1808	2166	0.8347183
C8	38925722	38926483	BolC8t50754H	0	+	481	749	761	0.9842313
C8	38927706	38928714	BolC8t50755H	0	+	301	978	1008	0.9702381
C8	38928929	38930014	BolC8t50756H	0	-	132	827	1085	0.7622120
C8	38934854	38937280	BolC8t50757H	0	-	1132	2309	2426	0.9517725
C8	38941654	38949808	BolC8t50758H	0	-	924	5023	8154	0.6160167
C8	38954235	38963605	BolC8t50759H	0	-	1427	4403	9370	0.4699039
C8	38970200	38970734	BolC8t50760H	0	-	95	453	534	0.8483146
C8	38977139	38978656	BolC8t50761H	0	-	433	1310	1517	0.8635465
C8	38981625	38982237	BolC8t50762H	0	-	58	430	612	0.7026144
C8	38986326	38991189	BolC8t50763H	0	+	3854	4828	4863	0.9928028
C8	38992547	38995367	BolC8t50764H	0	+	1042	2656	2820	0.9418440
C8	38995664	39002791	BolC8t50765H	0	-	3685	6678	7127	0.9370002
C8	39008518	39009403	BolC8t50766H	0	+	580	885	885	1.0000000
C8	39024551	39025220	BolC8t50767H	0	-	66	562	669	0.8400598
C8	39031217	39033006	BolC8t50768H	0	+	562	1566	1789	0.8753493
C8	39033500	39034300	BolC8t50769H	0	+	179	694	800	0.8675000
C8	39034770	39036914	BolC8t50770H	0	-	1130	2141	2144	0.9986007
C8	39038202	39040180	BolC8t50771H	0	+	583	1915	1978	0.9681497
C8	39055362	39057309	BolC8t50772H	0	-	505	1916	1947	0.9840780
C8	39058073	39058181	BolC8t50773H	0	-	57	108	108	1.0000000
C8	39059533	39060224	BolC8t50774H	0	+	51	653	691	0.9450073
C8	39060442	39061912	BolC8t50775H	0	-	642	1358	1470	0.9238095
C8	39083025	39084259	BolC8t50776H	0	+	29	726	1234	0.5883306
C8	39084956	39086237	BolC8t50777H	0	-	27	354	1281	0.2763466
C8	39088113	39088543	BolC8t50778H	0	-	29	240	430	0.5581396
C8	39095095	39096515	BolC8t50779H	0	+	1556	1420	1420	1.0000000
C8	39096862	39097474	BolC8t50780H	0	-	12	236	612	0.3856209
C8	39114154	39115891	BolC8t50781H	0	+	524	1424	1737	0.8198043
C8	39119090	39119758	BolC8t50782H	0	+	893	668	668	1.0000000
C8	39128664	39129521	BolC8t50783H	0	-	574	812	857	0.9474912
C8	39136782	39139201	BolC8t50784H	0	+	2654	2419	2419	1.0000000
C8	39139631	39142650	BolC8t50785H	0	-	440	2753	3019	0.9118913
C8	39155127	39156788	BolC8t50786H	0	+	1299	1661	1661	1.0000000
C8	39157165	39157880	BolC8t50787H	0	-	269	715	715	1.0000000
C8	39160294	39161588	BolC8t50788H	0	-	1586	1294	1294	1.0000000
C8	39163172	39163850	BolC8t50789H	0	+	327	678	678	1.0000000
C8	39165697	39169061	BolC8t50790H	0	-	962	2944	3364	0.8751487
C8	39172394	39173263	BolC8t50791H	0	+	184	696	869	0.8009206
C8	39176141	39176258	BolC8t50792H	0	-	130	117	117	1.0000000
C8	39194232	39195560	BolC8t50793H	0	-	1504	1328	1328	1.0000000
C8	39196482	39197190	BolC8t50794H	0	-	352	673	708	0.9505650
C8	39197792	39199092	BolC8t50795H	0	-	310	1018	1300	0.7830769
C8	39200303	39202142	BolC8t50796H	0	+	570	1551	1839	0.8433931
C8	39204702	39205701	BolC8t50797H	0	+	616	999	999	1.0000000
C8	39206127	39208533	BolC8t50798H	0	-	1557	2379	2406	0.9887781
C8	39211703	39212856	BolC8t50799H	0	+	1591	1153	1153	1.0000000
C8	39213644	39215004	BolC8t50800H	0	-	431	1358	1360	0.9985294
C8	39216169	39218197	BolC8t50801H	0	-	1247	2009	2028	0.9906312
C8	39223815	39225919	BolC8t50802H	0	+	865	2104	2104	1.0000000
C8	39230807	39232540	BolC8t50803H	0	+	768	1727	1733	0.9965378
C8	39245248	39246866	BolC8t50804H	0	+	807	1574	1618	0.9728059
C8	39251053	39256063	BolC8t50805H	0	+	1747	4385	5010	0.8752495
C8	39256949	39258697	BolC8t50806H	0	-	248	1214	1748	0.6945080
C8	39277623	39280395	BolC8t50807H	0	+	686	2196	2772	0.7922078
C8	39283291	39285661	BolC8t50808H	0	+	235	2077	2370	0.8763713
C8	39286544	39290550	BolC8t50809H	0	-	3233	4006	4006	1.0000000
C8	39291559	39296390	BolC8t50810H	0	-	2036	4653	4831	0.9631546
C8	39301143	39302502	BolC8t50811H	0	-	838	1359	1359	1.0000000
C8	39305127	39305577	BolC8t50812H	0	-	88	329	450	0.7311111
C8	39316441	39318340	BolC8t50813H	0	+	1040	1823	1899	0.9599789
C8	39319118	39321302	BolC8t50814H	0	+	435	1740	2184	0.7967033
C8	39322327	39323201	BolC8t50815H	0	-	815	874	874	1.0000000
C8	39323882	39324710	BolC8t50816H	0	-	231	740	828	0.8937198
C8	39337686	39337866	BolC8t50817H	0	-	12	180	180	1.0000000
C8	39342704	39344633	BolC8t50818H	0	-	1466	1929	1929	1.0000000
C8	39354192	39365369	BolC8t50819H	0	-	4423	10794	11177	0.9657332
C8	39397718	39398551	BolC8t50820H	0	-	677	833	833	1.0000000
C8	39410750	39411525	BolC8t50821H	0	+	179	682	775	0.8800000
C8	39413427	39415497	BolC8t50822H	0	-	1822	2040	2070	0.9855072
C8	39417276	39418869	BolC8t50823H	0	-	705	1585	1593	0.9949780
C8	39419514	39420721	BolC8t50824H	0	-	215	1143	1207	0.9469759
C8	39421408	39423834	BolC8t50825H	0	+	344	1467	2426	0.6046991
C8	39424133	39425382	BolC8t50826H	0	-	85	949	1249	0.7598078
C8	39425563	39426751	BolC8t50827H	0	+	538	1188	1188	1.0000000
C8	39427559	39428927	BolC8t50828H	0	-	193	807	1368	0.5899123
C8	39429794	39432555	BolC8t50829H	0	+	1077	2490	2761	0.9018472
C8	39441609	39441825	BolC8t50830H	0	+	117	216	216	1.0000000
C8	39443741	39444431	BolC8t50831H	0	+	140	657	690	0.9521739
C8	39446675	39447528	BolC8t50832H	0	-	325	853	853	1.0000000
C8	39459126	39461902	BolC8t50833H	0	+	1135	2480	2776	0.8933718
C8	39462142	39462738	BolC8t50834H	0	-	240	519	596	0.8708054
C8	39463046	39465012	BolC8t50835H	0	+	380	1608	1966	0.8179044
C8	39466397	39469462	BolC8t50836H	0	+	1006	2316	3065	0.7556280
C8	39472426	39472838	BolC8t50837H	0	-	531	412	412	1.0000000
C8	39473434	39477031	BolC8t50838H	0	-	778	2621	3597	0.7286628
C8	39479211	39479445	BolC8t50839H	0	-	62	220	234	0.9401709
C8	39484061	39487074	BolC8t50840H	0	+	597	2395	3013	0.7948888
C8	39509404	39510270	BolC8t50841H	0	-	116	477	866	0.5508083
C8	39525709	39526905	BolC8t50842H	0	-	263	1196	1196	1.0000000
C8	39533647	39535159	BolC8t50843H	0	-	436	907	1512	0.5998677
C8	39545993	39546757	BolC8t50844H	0	-	2003	764	764	1.0000000
C8	39546847	39547264	BolC8t50845H	0	-	710	417	417	1.0000000
C8	39550571	39554299	BolC8t50846H	0	-	1022	3173	3728	0.8511266
C8	39557416	39558889	BolC8t50847H	0	+	368	1466	1473	0.9952478
C8	39559539	39561637	BolC8t50848H	0	-	856	1903	2098	0.9070544
C8	39563465	39565030	BolC8t50849H	0	-	492	1372	1565	0.8766773
C8	39565605	39565782	BolC8t50850H	0	+	285	177	177	1.0000000
C8	39573255	39574488	BolC8t50851H	0	+	1844	1233	1233	1.0000000
C8	39575135	39577297	BolC8t50852H	0	-	379	1627	2162	0.7525439
C8	39583469	39589177	BolC8t50853H	0	-	595	2789	5708	0.4886125
C8	39592019	39592166	BolC8t50854H	0	+	133	147	147	1.0000000
C8	39594545	39595742	BolC8t50855H	0	+	129	932	1197	0.7786132
C8	39598609	39600343	BolC8t50856H	0	+	788	1734	1734	1.0000000
C8	39600571	39601930	BolC8t50857H	0	+	1200	1359	1359	1.0000000
C8	39602531	39605442	BolC8t50858H	0	+	1461	2870	2911	0.9859155
C8	39606836	39608696	BolC8t50859H	0	+	1296	1745	1860	0.9381720
C8	39623598	39624879	BolC8t50860H	0	+	1140	1281	1281	1.0000000
C8	39653580	39655790	BolC8t50861H	0	+	407	1300	2210	0.5882353
C8	39658720	39658981	BolC8t50862H	0	+	518	261	261	1.0000000
C8	39660119	39661642	BolC8t50863H	0	-	1044	1523	1523	1.0000000
C8	39663181	39666158	BolC8t50864H	0	-	1511	2720	2977	0.9136715
C8	39673323	39675902	BolC8t50865H	0	-	847	2444	2579	0.9476541
C8	39682766	39685465	BolC8t50866H	0	+	1359	2606	2699	0.9655428
C8	39686026	39688355	BolC8t50867H	0	+	1467	2329	2329	1.0000000
C8	39691129	39700352	BolC8t50868H	0	-	3658	7205	9223	0.7811992
C8	39693647	39694139	BolC8t50869H	0	-	214	492	492	1.0000000
C8	39694337	39694711	BolC8t50870H	0	-	28	228	374	0.6096257
C8	39696857	39697349	BolC8t50871H	0	-	1768	492	492	1.0000000
C8	39701380	39702510	BolC8t50872H	0	-	0	0	1130	0.0000000
C8	39707410	39708547	BolC8t50873H	0	-	0	0	1137	0.0000000
C8	39712064	39712564	BolC8t50874H	0	+	35	307	500	0.6140000
C8	39714149	39715695	BolC8t50875H	0	-	485	1546	1546	1.0000000
C8	39719594	39719874	BolC8t50876H	0	+	124	280	280	1.0000000
C8	39719954	39721236	BolC8t50877H	0	+	251	1109	1282	0.8650546
C8	39727633	39728763	BolC8t50878H	0	-	18	502	1130	0.4442478
C8	39740972	39741560	BolC8t50879H	0	-	0	0	588	0.0000000
C8	39744538	39745945	BolC8t50880H	0	+	526	1407	1407	1.0000000
C8	39746397	39748614	BolC8t50881H	0	-	556	2217	2217	1.0000000
C8	39750731	39758053	BolC8t50882H	0	+	1841	6027	7322	0.8231357
C8	39759904	39764666	BolC8t50883H	0	-	1413	4042	4762	0.8488030
C8	39769930	39771019	BolC8t50884H	0	+	326	989	1089	0.9081726
C8	39771255	39775938	BolC8t50885H	0	-	2525	3756	4683	0.8020500
C8	39776278	39777266	BolC8t50886H	0	+	603	988	988	1.0000000
C8	39777612	39781226	BolC8t50887H	0	-	2482	3614	3614	1.0000000
C8	39783188	39784102	BolC8t50888H	0	+	501	914	914	1.0000000
C8	39785357	39787930	BolC8t50889H	0	+	2074	2573	2573	1.0000000
C8	39790206	39792206	BolC8t50890H	0	+	2068	2000	2000	1.0000000
C8	39794442	39794556	BolC8t50891H	0	+	36	114	114	1.0000000
C8	39799050	39799839	BolC8t50892H	0	-	78	337	789	0.4271230
C8	39801809	39803165	BolC8t50893H	0	+	754	1356	1356	1.0000000
C8	39808249	39814235	BolC8t50894H	0	-	2312	5429	5986	0.9069495
C8	39817496	39820154	BolC8t50895H	0	-	1731	2658	2658	1.0000000
C8	39820732	39830230	BolC8t50896H	0	+	3417	8391	9498	0.8834491
C8	39832121	39832403	BolC8t50897H	0	+	166	282	282	1.0000000
C8	39834682	39835180	BolC8t50898H	0	+	49	498	498	1.0000000
C8	39838639	39846078	BolC8t50899H	0	+	1425	6160	7439	0.8280683
C8	39848953	39850721	BolC8t50900H	0	+	188	1345	1768	0.7607466
C8	39851986	39857754	BolC8t50901H	0	-	2234	5266	5768	0.9129681
C8	39859006	39859742	BolC8t50902H	0	-	508	736	736	1.0000000
C8	39861056	39861449	BolC8t50903H	0	+	41	202	393	0.5139949
C8	39872246	39875945	BolC8t50904H	0	-	1896	3609	3699	0.9756691
C8	39878619	39882201	BolC8t50905H	0	-	2201	3541	3582	0.9885539
C8	39893900	39896495	BolC8t50906H	0	-	660	2407	2595	0.9275530
C8	39904001	39905153	BolC8t50907H	0	-	53	864	1152	0.7500000
C8	39913193	39914066	BolC8t50908H	0	+	878	873	873	1.0000000
C8	39924847	39925726	BolC8t50909H	0	-	146	801	879	0.9112628
C8	39926468	39928562	BolC8t50910H	0	+	2162	2094	2094	1.0000000
C8	39932153	39933191	BolC8t50911H	0	-	732	1038	1038	1.0000000
C8	39934001	39934539	BolC8t50912H	0	+	63	290	538	0.5390335
C8	39935570	39936834	BolC8t50913H	0	-	265	1067	1264	0.8441456
C8	39939313	39939984	BolC8t50914H	0	-	177	622	671	0.9269747
C8	39951115	39953745	BolC8t50915H	0	+	1825	2630	2630	1.0000000
C8	39955956	39956466	BolC8t50916H	0	+	4	37	510	0.0725490
C8	39956704	39957836	BolC8t50917H	0	-	1021	1132	1132	1.0000000
C8	39958257	39967249	BolC8t50918H	0	+	8088	8859	8992	0.9852090
C8	39969769	39970591	BolC8t50919H	0	+	300	676	822	0.8223844
C8	39971551	39973707	BolC8t50920H	0	-	904	2156	2156	1.0000000
C8	39974375	39978531	BolC8t50921H	0	-	1476	3705	4156	0.8914822
C8	39987207	39987609	BolC8t50922H	0	+	742	402	402	1.0000000
C8	39989575	39992448	BolC8t50923H	0	+	2338	2873	2873	1.0000000
C8	39993554	40000932	BolC8t50924H	0	+	4352	7236	7378	0.9807536
C8	40018271	40020260	BolC8t50925H	0	+	205	1209	1989	0.6078432
C8	40022862	40023954	BolC8t50926H	0	+	59	497	1092	0.4551282
C8	40024461	40024851	BolC8t50927H	0	+	23	390	390	1.0000000
C8	40041093	40043493	BolC8t50928H	0	+	336	2179	2400	0.9079167
C8	40044008	40044194	BolC8t50929H	0	+	96	186	186	1.0000000
C8	40049665	40050035	BolC8t50930H	0	-	357	370	370	1.0000000
C8	40050113	40051564	BolC8t50931H	0	-	195	803	1451	0.5534114
C8	40061173	40062269	BolC8t50932H	0	+	346	1066	1096	0.9726278
C8	40067185	40069977	BolC8t50933H	0	-	82	1006	2792	0.3603152
C8	40074997	40082460	BolC8t50934H	0	-	4550	6830	7463	0.9151816
C8	40076364	40079449	BolC8t50935H	0	+	1965	2610	3085	0.8460292
C8	40079992	40080670	BolC8t50936H	0	-	427	678	678	1.0000000
C8	40082665	40083712	BolC8t50937H	0	+	132	836	1047	0.7984718
C8	40091372	40094467	BolC8t50938H	0	-	970	3011	3095	0.9728594
C8	40098876	40099140	BolC8t50939H	0	+	46	264	264	1.0000000
C8	40111353	40112693	BolC8t50940H	0	+	434	1305	1340	0.9738806
C8	40118159	40120692	BolC8t50941H	0	+	574	2408	2533	0.9506514
C8	40123727	40125119	BolC8t50942H	0	-	745	1375	1392	0.9877874
C8	40125494	40126079	BolC8t50943H	0	+	186	577	585	0.9863248
C8	40126710	40130059	BolC8t50944H	0	+	934	2531	3349	0.7557480
C8	40132009	40132255	BolC8t50945H	0	+	21	122	246	0.4959350
C8	40134946	40135192	BolC8t50946H	0	+	80	246	246	1.0000000
C8	40142347	40143268	BolC8t50947H	0	+	738	921	921	1.0000000
C8	40146409	40147081	BolC8t50948H	0	+	322	672	672	1.0000000
C8	40150314	40151914	BolC8t50949H	0	+	1258	1600	1600	1.0000000
C8	40152082	40154457	BolC8t50950H	0	-	1283	2337	2375	0.9840000
C8	40160362	40161367	BolC8t50951H	0	-	410	955	1005	0.9502488
C8	40171878	40172412	BolC8t50952H	0	+	91	479	534	0.8970038
C8	40182515	40184976	BolC8t50953H	0	+	1115	2461	2461	1.0000000
C8	40188804	40189188	BolC8t50954H	0	-	24	276	384	0.7187500
C8	40199212	40200526	BolC8t50955H	0	+	350	1314	1314	1.0000000
C8	40203392	40204966	BolC8t50956H	0	+	794	1411	1574	0.8964422
C8	40205959	40207853	BolC8t50957H	0	-	558	1693	1894	0.8938754
C8	40207934	40208147	BolC8t50958H	0	-	190	213	213	1.0000000
C8	40219870	40220629	BolC8t50959H	0	-	174	690	759	0.9090909
C8	40226382	40226793	BolC8t50960H	0	-	187	387	411	0.9416059
C8	40236627	40238457	BolC8t50961H	0	-	490	1810	1830	0.9890710
C8	40242876	40243688	BolC8t50962H	0	+	843	812	812	1.0000000
C8	40252438	40253678	BolC8t50963H	0	+	1973	1240	1240	1.0000000
C8	40254023	40256218	BolC8t50964H	0	-	2196	2195	2195	1.0000000
C8	40257832	40258379	BolC8t50965H	0	+	0	0	547	0.0000000
C8	40258931	40259225	BolC8t50966H	0	+	2	110	294	0.3741497
C8	40259336	40259705	BolC8t50967H	0	+	0	0	369	0.0000000
C8	40260839	40262046	BolC8t50968H	0	+	72	1023	1207	0.8475559
C8	40268221	40268560	BolC8t50969H	0	+	15	174	339	0.5132743
C8	40271456	40273728	BolC8t50970H	0	-	553	2122	2272	0.9339789
C8	40277371	40277977	BolC8t50971H	0	-	68	514	606	0.8481848
C8	40278280	40280677	BolC8t50972H	0	+	402	2048	2397	0.8544014
C8	40285767	40286220	BolC8t50973H	0	+	11	129	453	0.2847682
C8	40289027	40289866	BolC8t50974H	0	-	1017	839	839	1.0000000
C8	40290792	40292401	BolC8t50975H	0	+	1271	1609	1609	1.0000000
C8	40295800	40296590	BolC8t50976H	0	-	329	599	790	0.7582278
C8	40303432	40303648	BolC8t50977H	0	+	14	209	216	0.9675926
C8	40310505	40317631	BolC8t50978H	0	+	3634	5106	7126	0.7165310
C8	40312042	40328350	BolC8t50979H	0	-	8195	11509	16308	0.7057273
C8	40316034	40316745	BolC8t50980H	0	+	13	500	711	0.7032349
C8	40330754	40330871	BolC8t50981H	0	-	239	117	117	1.0000000
C8	40337264	40338115	BolC8t50982H	0	+	551	851	851	1.0000000
C8	40338561	40342872	BolC8t50983H	0	-	3249	4199	4311	0.9740199
C8	40349458	40357407	BolC8t50984H	0	+	2298	7208	7949	0.9067807
C8	40363437	40364591	BolC8t50985H	0	-	770	1154	1154	1.0000000
C8	40367505	40370684	BolC8t50986H	0	-	3356	3179	3179	1.0000000
C8	40371435	40381995	BolC8t50987H	0	+	4502	10098	10560	0.9562500
C8	40377389	40378775	BolC8t50988H	0	-	412	1351	1386	0.9747475
C8	40384087	40386628	BolC8t50989H	0	+	626	2496	2541	0.9822904
C8	40387114	40389820	BolC8t50990H	0	-	409	2147	2706	0.7934220
C8	40393236	40395744	BolC8t50991H	0	-	1658	2508	2508	1.0000000
C8	40396155	40398861	BolC8t50992H	0	+	663	2210	2706	0.8167036
C8	40408294	40410811	BolC8t50993H	0	+	1314	2245	2517	0.8919349
C8	40411217	40412372	BolC8t50994H	0	-	162	885	1155	0.7662337
C8	40413242	40414819	BolC8t50995H	0	-	393	1270	1577	0.8053266
C8	40416103	40422050	BolC8t50996H	0	-	894	3582	5947	0.6023205
C8	40426155	40427307	BolC8t50997H	0	+	372	1152	1152	1.0000000
C8	40427972	40429410	BolC8t50998H	0	-	809	1438	1438	1.0000000
C8	40434562	40434685	BolC8t50999H	0	-	1	19	123	0.1544715
C8	40435107	40436479	BolC8t51000H	0	+	828	1369	1372	0.9978134
C8	40443539	40444622	BolC8t51001H	0	+	311	1022	1083	0.9436750
C8	40448401	40449915	BolC8t51002H	0	-	431	1479	1514	0.9768825
C8	40453265	40453523	BolC8t51003H	0	+	276	258	258	1.0000000
C8	40454170	40454959	BolC8t51004H	0	-	77	403	789	0.5107731
C8	40456093	40460605	BolC8t51005H	0	-	1316	2984	4512	0.6613475
C8	40463536	40464704	BolC8t51006H	0	-	588	1015	1168	0.8690069
C8	40465100	40465400	BolC8t51007H	0	+	95	244	300	0.8133333
C8	40465702	40468770	BolC8t51008H	0	-	743	2993	3068	0.9755541
C8	40472243	40475410	BolC8t51009H	0	+	1840	2889	3167	0.9122198
C8	40485297	40487975	BolC8t51010H	0	+	2120	2555	2678	0.9540702
C8	40488689	40492496	BolC8t51011H	0	-	1356	3539	3807	0.9296033
C8	40496966	40497998	BolC8t51012H	0	+	277	1022	1032	0.9903101
C8	40503393	40503720	BolC8t51013H	0	-	22	71	327	0.2171254
C8	40511711	40513320	BolC8t51014H	0	+	898	1609	1609	1.0000000
C8	40514461	40516189	BolC8t51015H	0	-	428	1574	1728	0.9108796
C8	40516878	40518527	BolC8t51016H	0	-	696	1627	1649	0.9866586
C8	40519256	40520112	BolC8t51017H	0	-	567	836	856	0.9766355
C8	40522068	40525115	BolC8t51018H	0	-	1160	3038	3047	0.9970463
C8	40545526	40545937	BolC8t51019H	0	+	43	285	411	0.6934307
C8	40547081	40549677	BolC8t51020H	0	-	907	2570	2596	0.9899846
C8	40552013	40553832	BolC8t51021H	0	-	681	1537	1819	0.8449697
C8	40557849	40562801	BolC8t51022H	0	-	2585	3931	4952	0.7938207
C8	40564433	40566860	BolC8t51023H	0	+	2256	2269	2427	0.9348990
C8	40570319	40572276	BolC8t51024H	0	+	909	1957	1957	1.0000000
C8	40572412	40578692	BolC8t51025H	0	-	2299	5747	6280	0.9151274
C8	40588768	40598539	BolC8t51026H	0	+	3223	5470	9771	0.5598199
C8	40603511	40604734	BolC8t51027H	0	-	0	0	1223	0.0000000
C8	40609923	40610745	BolC8t51028H	0	-	23	265	822	0.3223844
C8	40613499	40615095	BolC8t51029H	0	-	337	1537	1596	0.9630326
C8	40621679	40622297	BolC8t51030H	0	+	494	618	618	1.0000000
C8	40622855	40623365	BolC8t51031H	0	+	507	510	510	1.0000000
C8	40627914	40628220	BolC8t51032H	0	+	131	299	306	0.9771242
C8	40636391	40637854	BolC8t51033H	0	+	186	1214	1463	0.8298018
C8	40638736	40640287	BolC8t51034H	0	+	596	1366	1551	0.8807221
C8	40645236	40647957	BolC8t51035H	0	+	15638	2721	2721	1.0000000
C8	40648677	40649550	BolC8t51036H	0	-	513	873	873	1.0000000
C8	40651146	40654154	BolC8t51037H	0	+	2266	3000	3008	0.9973404
C8	40660091	40661384	BolC8t51038H	0	+	86	319	1293	0.2467131
C8	40661361	40661814	BolC8t51039H	0	+	241	453	453	1.0000000
C8	40663797	40663959	BolC8t51040H	0	+	19	152	162	0.9382716
C8	40665692	40669026	BolC8t51041H	0	-	3137	3334	3334	1.0000000
C8	40672067	40672844	BolC8t51042H	0	-	262	777	777	1.0000000
C8	40677838	40685961	BolC8t51043H	0	+	1625	6959	8123	0.8567032
C8	40687362	40690020	BolC8t51044H	0	-	527	2450	2658	0.9217457
C8	40692002	40693837	BolC8t51045H	0	-	800	1690	1835	0.9209809
C8	40697942	40698545	BolC8t51046H	0	+	180	578	603	0.9585406
C8	40699020	40702617	BolC8t51047H	0	-	1603	3516	3597	0.9774812
C8	40702674	40704113	BolC8t51048H	0	+	367	1288	1439	0.8950660
C8	40704263	40707083	BolC8t51049H	0	-	706	2610	2820	0.9255319
C8	40715341	40717351	BolC8t51050H	0	+	943	1988	2010	0.9890547
C8	40717486	40718992	BolC8t51051H	0	-	1330	1506	1506	1.0000000
C8	40719481	40721658	BolC8t51052H	0	+	1633	2177	2177	1.0000000
C8	40724890	40725700	BolC8t51053H	0	+	213	785	810	0.9691358
C8	40726393	40727861	BolC8t51054H	0	+	518	1462	1468	0.9959128
C8	40728324	40732249	BolC8t51055H	0	-	842	3624	3925	0.9233121
C8	40732830	40733463	BolC8t51056H	0	-	478	633	633	1.0000000
C8	40733639	40736576	BolC8t51057H	0	+	1543	2907	2937	0.9897855
C8	40737013	40740203	BolC8t51058H	0	-	1194	2833	3190	0.8880877
C8	40756887	40758599	BolC8t51059H	0	+	1175	1648	1712	0.9626168
C8	40760754	40761214	BolC8t51060H	0	-	118	460	460	1.0000000
C8	40767005	40767539	BolC8t51061H	0	+	463	534	534	1.0000000
C8	40772073	40772463	BolC8t51062H	0	-	197	387	390	0.9923077
C8	40774237	40775162	BolC8t51063H	0	+	463	925	925	1.0000000
C8	40777536	40779898	BolC8t51064H	0	-	1498	2251	2362	0.9530059
C8	40780838	40782428	BolC8t51065H	0	+	452	1590	1590	1.0000000
C8	40790512	40791278	BolC8t51066H	0	+	181	536	766	0.6997389
C8	40792549	40793106	BolC8t51067H	0	+	186	557	557	1.0000000
C8	40797779	40801568	BolC8t51068H	0	-	1580	3341	3789	0.8817630
C8	40805705	40807527	BolC8t51069H	0	+	350	1501	1822	0.8238200
C8	40811423	40812011	BolC8t51070H	0	+	15	363	588	0.6173469
C8	40823490	40823972	BolC8t51071H	0	+	270	482	482	1.0000000
C8	40827082	40828522	BolC8t51072H	0	-	464	1192	1440	0.8277778
C8	40831412	40833529	BolC8t51073H	0	+	551	1992	2117	0.9409542
C8	40833945	40840188	BolC8t51074H	0	-	972	4906	6243	0.7858402
C8	40841374	40841689	BolC8t51075H	0	+	291	315	315	1.0000000
C8	40846305	40849057	BolC8t51076H	0	+	1894	2731	2752	0.9923692
C8	40851613	40853916	BolC8t51077H	0	+	424	2155	2303	0.9357360
C8	40854249	40855620	BolC8t51078H	0	-	373	1068	1371	0.7789934
C8	40856196	40856415	BolC8t51079H	0	+	176	219	219	1.0000000
C8	40857593	40860912	BolC8t51080H	0	-	735	2728	3319	0.8219343
C8	40863790	40871520	BolC8t51081H	0	-	2279	6696	7730	0.8662354
C8	40871744	40872401	BolC8t51082H	0	-	55	159	657	0.2420091
C8	40871841	40873596	BolC8t51083H	0	+	138	751	1755	0.4279202
C8	40874065	40885952	BolC8t51084H	0	-	2450	7429	11887	0.6249685
C8	40890834	40891212	BolC8t51085H	0	+	5	112	378	0.2962963
C8	40892788	40893031	BolC8t51086H	0	-	51	211	243	0.8683128
C8	40895188	40899965	BolC8t51087H	0	+	2873	4413	4777	0.9238015
C8	40915484	40918254	BolC8t51088H	0	+	500	1849	2770	0.6675090
C8	40924913	40925198	BolC8t51089H	0	+	24	137	285	0.4807017
C8	40928943	40929217	BolC8t51090H	0	+	11	248	274	0.9051095
C8	40929879	40930038	BolC8t51091H	0	+	0	0	159	0.0000000
C8	40934808	40935039	BolC8t51092H	0	-	4	126	231	0.5454546
C8	40937913	40940876	BolC8t51093H	0	-	1680	2852	2963	0.9625379
C8	40946569	40946734	BolC8t51094H	0	-	0	0	165	0.0000000
C8	40947080	40947224	BolC8t51095H	0	-	0	0	144	0.0000000
C8	40952482	40953666	BolC8t51096H	0	+	55	336	1184	0.2837838
C8	40958528	40959655	BolC8t51097H	0	+	226	971	1127	0.8615794
C8	40968540	40969797	BolC8t51098H	0	+	241	1106	1257	0.8798727
C8	40972917	40975359	BolC8t51099H	0	-	623	2318	2442	0.9492220
C8	40976447	40978519	BolC8t51100H	0	+	932	2049	2072	0.9888996
C8	40979743	40982759	BolC8t51101H	0	+	1412	2903	3016	0.9625332
C8	40982926	40983908	BolC8t51102H	0	-	282	963	982	0.9806517
C8	40984281	40986915	BolC8t51103H	0	-	1001	2472	2634	0.9384966
C8	40988178	40988637	BolC8t51104H	0	-	70	459	459	1.0000000
C8	40990888	40991374	BolC8t51105H	0	-	532	486	486	1.0000000
C8	40998656	40998764	BolC8t51106H	0	-	181	108	108	1.0000000
C8	41000156	41000671	BolC8t51107H	0	-	62	319	515	0.6194175
C8	41003897	41004761	BolC8t51108H	0	+	250	864	864	1.0000000
C8	41007122	41007596	BolC8t51109H	0	+	372	474	474	1.0000000
C8	41014442	41017330	BolC8t51110H	0	+	1189	2517	2888	0.8715374
C8	41026021	41028534	BolC8t51111H	0	+	217	1924	2513	0.7656188
C8	41031427	41047763	BolC8t51112H	0	+	5020	12790	16336	0.7829334
C8	41048713	41049109	BolC8t51113H	0	-	272	396	396	1.0000000
C8	41049725	41053851	BolC8t51114H	0	-	1434	1701	4126	0.4122637
C8	41052894	41053194	BolC8t51115H	0	+	0	0	300	0.0000000
C8	41054441	41058026	BolC8t51116H	0	-	2373	3585	3585	1.0000000
C8	41059558	41060374	BolC8t51117H	0	+	114	774	816	0.9485294
C8	41062068	41063010	BolC8t51118H	0	-	518	835	942	0.8864119
C8	41064461	41067478	BolC8t51119H	0	+	1685	2843	3017	0.9423268
C8	41073894	41074280	BolC8t51120H	0	+	160	386	386	1.0000000
C8	41076740	41077750	BolC8t51121H	0	-	730	1010	1010	1.0000000
C8	41080529	41081678	BolC8t51122H	0	-	316	1119	1149	0.9738904
C8	41083107	41084960	BolC8t51123H	0	+	1466	1838	1853	0.9919050
C8	41085466	41086340	BolC8t51124H	0	-	128	873	874	0.9988558
C8	41087829	41090755	BolC8t51125H	0	-	1878	2858	2926	0.9767601
C8	41092995	41097569	BolC8t51126H	0	+	886	2809	4574	0.6141233
C8	41098258	41099020	BolC8t51127H	0	+	352	762	762	1.0000000
C8	41103651	41104134	BolC8t51128H	0	+	545	483	483	1.0000000
C8	41116988	41120665	BolC8t51129H	0	-	635	3260	3677	0.8865923
C8	41123653	41125046	BolC8t51130H	0	-	1131	1393	1393	1.0000000
C8	41129274	41130817	BolC8t51131H	0	-	224	1320	1543	0.8554763
C8	41143658	41147077	BolC8t51132H	0	+	560	3043	3419	0.8900263
C8	41149098	41149518	BolC8t51133H	0	+	146	420	420	1.0000000
C8	41157920	41161800	BolC8t51134H	0	+	260	2171	3880	0.5595361
C8	41162148	41163051	BolC8t51135H	0	-	393	903	903	1.0000000
C8	41173699	41174005	BolC8t51136H	0	-	76	286	306	0.9346405
C8	41189201	41191353	BolC8t51137H	0	+	689	1504	2152	0.6988848
C8	41193293	41193730	BolC8t51138H	0	-	135	421	437	0.9633867
C8	41201487	41202234	BolC8t51139H	0	-	99	613	747	0.8206158
C8	41205339	41205831	BolC8t51140H	0	-	13	138	492	0.2804878
C8	41214944	41216960	BolC8t51141H	0	+	919	1988	2016	0.9861111
C8	41219733	41220421	BolC8t51142H	0	-	2	102	688	0.1482558
C8	41229419	41230259	BolC8t51143H	0	+	179	710	840	0.8452381
C8	41248309	41249106	BolC8t51144H	0	+	69	647	797	0.8117942
C8	41258434	41259325	BolC8t51145H	0	+	511	828	891	0.9292929
C8	41267653	41268607	BolC8t51146H	0	+	301	867	954	0.9088050
C8	41272527	41277601	BolC8t51147H	0	+	2013	4646	5074	0.9156484
C8	41280925	41281909	BolC8t51148H	0	+	872	969	984	0.9847561
C8	41283343	41284921	BolC8t51149H	0	+	1143	1578	1578	1.0000000
C8	41286474	41286774	BolC8t51150H	0	-	336	300	300	1.0000000
C8	41287043	41287741	BolC8t51151H	0	-	127	693	698	0.9928367
C8	41293414	41294827	BolC8t51152H	0	+	470	1413	1413	1.0000000
C8	41299465	41299844	BolC8t51153H	0	-	535	379	379	1.0000000
C8	41302807	41303320	BolC8t51154H	0	+	74	375	513	0.7309942
C8	41309455	41314716	BolC8t51155H	0	-	376	2615	5261	0.4970538
C8	41312982	41313440	BolC8t51156H	0	+	0	0	458	0.0000000
C8	41317368	41318966	BolC8t51157H	0	+	478	1213	1598	0.7590739
C8	41322375	41324692	BolC8t51158H	0	+	44	860	2317	0.3711696
C8	41332701	41335433	BolC8t51159H	0	+	688	2606	2732	0.9538800
C8	41336261	41337149	BolC8t51160H	0	-	214	856	888	0.9639640
C8	41343260	41344145	BolC8t51161H	0	+	108	603	885	0.6813560
C8	41344417	41346915	BolC8t51162H	0	+	1203	2495	2498	0.9987990
C8	41355564	41356858	BolC8t51163H	0	+	760	1294	1294	1.0000000
C8	41357881	41358966	BolC8t51164H	0	+	368	1062	1085	0.9788018
C8	41361868	41363899	BolC8t51165H	0	+	964	1612	2031	0.7936977
C8	41365870	41367653	BolC8t51166H	0	-	849	1783	1783	1.0000000
C8	41368598	41369732	BolC8t51167H	0	+	434	1134	1134	1.0000000
C8	41369941	41371147	BolC8t51168H	0	-	450	1206	1206	1.0000000
C8	41373350	41374911	BolC8t51169H	0	+	821	1554	1561	0.9955157
C8	41375601	41377509	BolC8t51170H	0	+	375	1766	1908	0.9255765
C8	41378774	41380203	BolC8t51171H	0	+	933	1429	1429	1.0000000
C8	41383334	41384603	BolC8t51172H	0	-	112	1204	1269	0.9487786
C8	41391952	41394018	BolC8t51173H	0	+	990	2066	2066	1.0000000
C8	41394661	41407072	BolC8t51174H	0	-	2851	10447	12411	0.8417533
C8	41408366	41410567	BolC8t51175H	0	-	881	2143	2201	0.9736484
C8	41413331	41413848	BolC8t51176H	0	-	384	517	517	1.0000000
C8	41414698	41417473	BolC8t51177H	0	+	763	2469	2775	0.8897297
C8	41419899	41420974	BolC8t51178H	0	-	79	939	1075	0.8734884
C8	41421635	41426510	BolC8t51179H	0	+	1855	4148	4875	0.8508718
C8	41423402	41424471	BolC8t51180H	0	+	33	543	1069	0.5079514
C8	41434006	41436213	BolC8t51181H	0	+	2267	2207	2207	1.0000000
C8	41437370	41439806	BolC8t51182H	0	+	1496	2335	2436	0.9585386
C8	41439958	41442385	BolC8t51183H	0	-	1116	2427	2427	1.0000000
C8	41454291	41455150	BolC8t51184H	0	-	1134	859	859	1.0000000
C8	41456572	41456944	BolC8t51185H	0	-	455	372	372	1.0000000
C8	41464756	41466215	BolC8t51186H	0	+	655	1459	1459	1.0000000
C8	41468140	41468776	BolC8t51187H	0	-	21	226	636	0.3553459
C8	41475112	41477053	BolC8t51188H	0	+	1063	1941	1941	1.0000000
C8	41507176	41508147	BolC8t51189H	0	-	794	971	971	1.0000000
C8	41509435	41510512	BolC8t51190H	0	+	414	1077	1077	1.0000000
C8	41513963	41514549	BolC8t51191H	0	+	150	527	586	0.8993174
C8	41514794	41515709	BolC8t51192H	0	-	511	915	915	1.0000000
C8	41516882	41519027	BolC8t51193H	0	+	981	1852	2145	0.8634033
C8	41521169	41522226	BolC8t51194H	0	+	380	1024	1057	0.9687796
C8	41522874	41523931	BolC8t51195H	0	-	600	970	1057	0.9176916
C8	41525740	41536404	BolC8t51196H	0	+	503	3642	10664	0.3415229
C8	41537286	41540035	BolC8t51197H	0	+	707	2123	2749	0.7722808
C8	41542598	41542826	BolC8t51198H	0	+	26	183	228	0.8026316
C8	41545978	41548398	BolC8t51199H	0	+	759	1760	2420	0.7272727
C8	41550201	41554061	BolC8t51200H	0	+	1632	3757	3860	0.9733161
C8	41557574	41560604	BolC8t51201H	0	+	714	2867	3030	0.9462046
C8	41560788	41562362	BolC8t51202H	0	-	547	1514	1574	0.9618806
C8	41564272	41565981	BolC8t51203H	0	+	481	1709	1709	1.0000000
C8	41566214	41567687	BolC8t51204H	0	-	642	1473	1473	1.0000000
C8	41568249	41568932	BolC8t51205H	0	+	492	646	683	0.9458272
C8	41569412	41571834	BolC8t51206H	0	-	753	2273	2422	0.9384806
C8	41577225	41579078	BolC8t51207H	0	+	927	1837	1853	0.9913654
C8	41582019	41583469	BolC8t51208H	0	+	671	1439	1450	0.9924138
C8	41584048	41586183	BolC8t51209H	0	-	1572	2135	2135	1.0000000
C8	41589952	41591340	BolC8t51210H	0	+	1277	1384	1388	0.9971182
C8	41592061	41592748	BolC8t51211H	0	-	36	386	687	0.5618632
C8	41596796	41597408	BolC8t51212H	0	-	3	101	612	0.1650327
C8	41611239	41611542	BolC8t51213H	0	+	6	93	303	0.3069307
C8	41612763	41614773	BolC8t51214H	0	+	791	1945	2010	0.9676617
C8	41616240	41617777	BolC8t51215H	0	+	1386	1537	1537	1.0000000
C8	41623400	41623922	BolC8t51216H	0	-	145	522	522	1.0000000
C8	41636839	41641502	BolC8t51217H	0	-	2361	4663	4663	1.0000000
C8	41646359	41652227	BolC8t51218H	0	+	2250	5649	5868	0.9626789
C8	41654192	41660231	BolC8t51219H	0	+	2314	5607	6039	0.9284649
C8	41661968	41662394	BolC8t51220H	0	+	306	426	426	1.0000000
C8	41665623	41668473	BolC8t51221H	0	-	1063	2214	2850	0.7768421
C8	41682556	41683947	BolC8t51222H	0	-	235	1281	1391	0.9209202
C8	41687411	41688056	BolC8t51223H	0	+	631	631	645	0.9782946
C8	41690074	41693900	BolC8t51224H	0	-	1911	3648	3826	0.9534762
C8	41703197	41704550	BolC8t51225H	0	+	286	1243	1353	0.9186992
C8	41708997	41711987	BolC8t51226H	0	+	1003	2562	2990	0.8568562
C8	41713596	41714463	BolC8t51227H	0	+	1176	867	867	1.0000000
C8	41718637	41721063	BolC8t51228H	0	+	2171	2426	2426	1.0000000
C8	41723053	41724603	BolC8t51229H	0	+	863	1257	1550	0.8109677
C8	41727280	41728718	BolC8t51230H	0	-	1451	1438	1438	1.0000000
C8	41733685	41734549	BolC8t51231H	0	+	698	864	864	1.0000000
C8	41736337	41738875	BolC8t51232H	0	-	1281	2508	2538	0.9881797
C8	41739408	41741291	BolC8t51233H	0	-	908	1883	1883	1.0000000
C8	41748505	41748916	BolC8t51234H	0	+	470	411	411	1.0000000
C8	41751662	41754383	BolC8t51235H	0	+	609	2455	2721	0.9022418
C8	41758658	41759542	BolC8t51236H	0	-	239	770	884	0.8710407
C8	41759607	41759958	BolC8t51237H	0	-	21	266	351	0.7578347
C8	41760150	41760564	BolC8t51238H	0	-	5	264	414	0.6376812
C8	41760577	41762010	BolC8t51239H	0	+	526	1356	1433	0.9462666
C8	41762605	41763398	BolC8t51240H	0	-	511	793	793	1.0000000
C8	41765566	41766165	BolC8t51241H	0	+	150	462	599	0.7712855
C8	41771782	41780337	BolC8t51242H	0	+	3840	8255	8555	0.9649328
C8	41780671	41782306	BolC8t51243H	0	+	886	1635	1635	1.0000000
C8	41784693	41787176	BolC8t51244H	0	-	1257	2380	2483	0.9585179
C8	41787940	41789242	BolC8t51245H	0	-	425	1103	1302	0.8471582
C8	41790770	41796351	BolC8t51246H	0	-	3001	5581	5581	1.0000000
C8	41797256	41799116	BolC8t51247H	0	-	687	1807	1860	0.9715054
C8	41800437	41801290	BolC8t51248H	0	+	436	853	853	1.0000000
C8	41824335	41824997	BolC8t51249H	0	+	207	599	662	0.9048339
C8	41825098	41829502	BolC8t51250H	0	+	1562	4094	4404	0.9296094
C8	41831243	41831417	BolC8t51251H	0	-	167	174	174	1.0000000
C8	41837472	41842624	BolC8t51252H	0	-	1636	4987	5152	0.9679736
C8	41846725	41847962	BolC8t51253H	0	+	571	972	1237	0.7857720
C8	41848704	41849394	BolC8t51254H	0	+	138	690	690	1.0000000
C8	41852770	41854531	BolC8t51255H	0	-	148	1105	1761	0.6274844
C8	41899650	41900735	BolC8t51256H	0	-	95	719	1085	0.6626728
C8	41915699	41915895	BolC8t51257H	0	-	243	196	196	1.0000000
C8	41921491	41921751	BolC8t51258H	0	+	214	260	260	1.0000000
C8	41934032	41934826	BolC8t51259H	0	+	65	652	794	0.8211587
C8	41937272	41937521	BolC8t51260H	0	-	5	7	249	0.0281125
C8	41941510	41941891	BolC8t51261H	0	-	3	40	381	0.1049869
C8	41951192	41951552	BolC8t51262H	0	+	262	360	360	1.0000000
C8	41957927	41959244	BolC8t51263H	0	-	138	785	1317	0.5960516
C8	41981035	41981599	BolC8t51264H	0	-	11	300	564	0.5319149
C8	41992896	41993229	BolC8t51265H	0	+	1	55	333	0.1651652
C8	42012924	42013307	BolC8t51266H	0	+	158	343	383	0.8955613
C8	42014525	42015944	BolC8t51267H	0	+	437	1410	1419	0.9936575
C8	42016545	42019013	BolC8t51268H	0	-	1264	2397	2468	0.9712318
C8	42041057	42041936	BolC8t51269H	0	+	78	401	879	0.4562002
C8	42044723	42045101	BolC8t51270H	0	-	231	378	378	1.0000000
C8	42046032	42046182	BolC8t51271H	0	-	208	150	150	1.0000000
C8	42053380	42054980	BolC8t51272H	0	-	630	1600	1600	1.0000000
C8	42057852	42060183	BolC8t51273H	0	+	195	1766	2331	0.7576147
C8	42061496	42067565	BolC8t51274H	0	+	1804	4749	6069	0.7825012
C8	42068095	42068826	BolC8t51275H	0	-	366	720	731	0.9849521
C8	42069946	42070090	BolC8t51276H	0	+	196	144	144	1.0000000
C8	42070887	42072203	BolC8t51277H	0	+	608	1316	1316	1.0000000
C8	42072338	42073626	BolC8t51278H	0	-	1278	1288	1288	1.0000000
C8	42076397	42078595	BolC8t51279H	0	+	1951	2189	2198	0.9959053
C8	42079251	42079998	BolC8t51280H	0	-	322	747	747	1.0000000
C8	42081512	42083662	BolC8t51281H	0	+	812	2116	2150	0.9841861
C8	42084076	42085402	BolC8t51282H	0	-	445	1170	1326	0.8823529
C8	42088006	42088327	BolC8t51283H	0	-	25	253	321	0.7881620
C8	42097346	42098272	BolC8t51284H	0	+	9	521	926	0.5626350
C8	42118302	42120345	BolC8t51285H	0	-	582	1654	2043	0.8095937
C8	42122121	42124838	BolC8t51286H	0	-	1257	2671	2717	0.9830695
C8	42125217	42126531	BolC8t51287H	0	+	828	1282	1314	0.9756469
C8	42129306	42129567	BolC8t51288H	0	+	14	258	261	0.9885057
C8	42131204	42133115	BolC8t51289H	0	-	86	1096	1911	0.5735217
C8	42134773	42135478	BolC8t51290H	0	-	24	515	705	0.7304965
C8	42136899	42137790	BolC8t51291H	0	+	314	891	891	1.0000000
C8	42139046	42141196	BolC8t51292H	0	-	245	1678	2150	0.7804651
C8	42142343	42142817	BolC8t51293H	0	+	57	422	474	0.8902954
C8	42143951	42145699	BolC8t51294H	0	-	1070	1748	1748	1.0000000
C8	42149221	42152044	BolC8t51295H	0	+	2295	2823	2823	1.0000000
C8	42152269	42155170	BolC8t51296H	0	-	1355	2847	2901	0.9813857
C8	42161385	42161964	BolC8t51297H	0	-	535	579	579	1.0000000
C8	42162759	42164769	BolC8t51298H	0	-	787	2010	2010	1.0000000
C8	42170312	42171399	BolC8t51299H	0	-	980	1087	1087	1.0000000
C8	42172487	42172763	BolC8t51300H	0	+	236	276	276	1.0000000
C8	42173283	42180257	BolC8t51301H	0	-	1496	5669	6974	0.8128764
C8	42183255	42184992	BolC8t51302H	0	-	809	1705	1737	0.9815775
C8	42186004	42186199	BolC8t51303H	0	+	126	195	195	1.0000000
C8	42186798	42187191	BolC8t51304H	0	+	534	393	393	1.0000000
C8	42187537	42187963	BolC8t51305H	0	-	92	426	426	1.0000000
C8	42192130	42192649	BolC8t51306H	0	+	865	519	519	1.0000000
C8	42194855	42195353	BolC8t51307H	0	+	620	498	498	1.0000000
C8	42195854	42197672	BolC8t51308H	0	-	487	1679	1818	0.9235424
C8	42198018	42198222	BolC8t51309H	0	-	100	204	204	1.0000000
C8	42200612	42201456	BolC8t51310H	0	+	511	844	844	1.0000000
C8	42209095	42210989	BolC8t51311H	0	+	650	1524	1894	0.8046463
C8	42213029	42214056	BolC8t51312H	0	+	156	764	1027	0.7439143
C8	42214222	42216327	BolC8t51313H	0	-	428	1326	2105	0.6299288
C8	42217201	42219424	BolC8t51314H	0	-	753	2223	2223	1.0000000
C8	42219851	42221617	BolC8t51315H	0	+	1123	1766	1766	1.0000000
C8	42223848	42224985	BolC8t51316H	0	-	457	1137	1137	1.0000000
C8	42226061	42226400	BolC8t51317H	0	-	11	325	339	0.9587021
C8	42234386	42234695	BolC8t51318H	0	-	0	0	309	0.0000000
C8	42234752	42235802	BolC8t51319H	0	-	6	211	1050	0.2009524
C8	42239906	42240579	BolC8t51320H	0	-	112	364	673	0.5408618
C8	42246949	42247387	BolC8t51321H	0	+	558	438	438	1.0000000
C8	42258380	42259463	BolC8t51322H	0	+	286	795	1083	0.7340720
C8	42267555	42269210	BolC8t51323H	0	-	94	1036	1655	0.6259819
C8	42273730	42274135	BolC8t51324H	0	+	644	405	405	1.0000000
C8	42276315	42278318	BolC8t51325H	0	-	607	2003	2003	1.0000000
C8	42282477	42288022	BolC8t51326H	0	-	1064	4834	5545	0.8717764
C8	42289952	42290210	BolC8t51327H	0	+	2	185	258	0.7170542
C8	42297001	42297163	BolC8t51328H	0	-	178	162	162	1.0000000
C8	42298874	42300245	BolC8t51329H	0	+	186	1193	1371	0.8701677
C8	42300621	42302138	BolC8t51330H	0	-	575	1321	1517	0.8707976
C8	42311443	42314198	BolC8t51331H	0	+	1033	2560	2755	0.9292196
C8	42317012	42319625	BolC8t51332H	0	+	703	2434	2613	0.9314964
C8	42321191	42322753	BolC8t51333H	0	-	666	1562	1562	1.0000000
C8	42323321	42323579	BolC8t51334H	0	-	322	258	258	1.0000000
C8	42324913	42326321	BolC8t51335H	0	-	709	1347	1408	0.9566761
C8	42327005	42327393	BolC8t51336H	0	+	167	388	388	1.0000000
C8	42329304	42329874	BolC8t51337H	0	+	38	138	570	0.2421053
C8	42335373	42338221	BolC8t51338H	0	+	571	2304	2848	0.8089887
C8	42338759	42356862	BolC8t51339H	0	-	473	5253	18103	0.2901729
C8	42340983	42349324	BolC8t51340H	0	-	117	1571	8341	0.1883467
C8	42351025	42351435	BolC8t51341H	0	+	18	272	410	0.6634147
C8	42358346	42359507	BolC8t51342H	0	-	429	1110	1161	0.9560723
C8	42360785	42365781	BolC8t51343H	0	-	2530	4812	4996	0.9631705
C8	42373671	42374754	BolC8t51344H	0	+	379	1083	1083	1.0000000
C8	42375030	42377738	BolC8t51345H	0	-	2508	2617	2708	0.9663959
C8	42377938	42378589	BolC8t51346H	0	+	404	487	651	0.7480799
C8	42378911	42379220	BolC8t51347H	0	-	92	309	309	1.0000000
C8	42380467	42381538	BolC8t51348H	0	-	486	1070	1071	0.9990663
C8	42391845	42392157	BolC8t51349H	0	+	1	45	312	0.1442308
C8	42394409	42394718	BolC8t51350H	0	+	5	176	309	0.5695793
C8	42397048	42399122	BolC8t51351H	0	+	881	1970	2074	0.9498553
C8	42400003	42402359	BolC8t51352H	0	-	591	2069	2356	0.8781834
C8	42420411	42420810	BolC8t51353H	0	+	314	399	399	1.0000000
C8	42421171	42422200	BolC8t51354H	0	+	756	962	1029	0.9348882
C8	42426140	42427461	BolC8t51355H	0	+	381	1154	1321	0.8735806
C8	42429774	42433289	BolC8t51356H	0	-	824	2976	3515	0.8466572
C8	42434086	42434638	BolC8t51357H	0	+	335	552	552	1.0000000
C8	42437760	42438930	BolC8t51358H	0	-	1664	1170	1170	1.0000000
C8	42452404	42452551	BolC8t51359H	0	+	138	147	147	1.0000000
C8	42453098	42455456	BolC8t51360H	0	+	1217	2358	2358	1.0000000
C8	42468731	42469730	BolC8t51361H	0	-	159	935	999	0.9359359
C8	42472146	42472392	BolC8t51362H	0	-	112	246	246	1.0000000
C8	42474293	42475040	BolC8t51363H	0	-	736	747	747	1.0000000
C8	42475701	42477716	BolC8t51364H	0	+	378	1776	2015	0.8813896
C8	42479014	42479287	BolC8t51365H	0	-	221	273	273	1.0000000
C8	42480249	42481378	BolC8t51366H	0	+	405	1129	1129	1.0000000
C8	42481868	42483276	BolC8t51367H	0	-	412	1258	1408	0.8934659
C8	42484035	42484721	BolC8t51368H	0	+	232	686	686	1.0000000
C8	42487310	42488552	BolC8t51369H	0	+	295	1221	1242	0.9830918
C8	42498048	42498834	BolC8t51370H	0	-	529	786	786	1.0000000
C8	42515428	42518258	BolC8t51371H	0	-	637	2711	2830	0.9579505
C8	42523130	42526995	BolC8t51372H	0	-	1341	3740	3865	0.9676585
C8	42536375	42536777	BolC8t51373H	0	+	1	8	402	0.0199005
C8	42539851	42541618	BolC8t51374H	0	+	912	1767	1767	1.0000000
C8	42547520	42548246	BolC8t51375H	0	+	657	726	726	1.0000000
C8	42552044	42552590	BolC8t51376H	0	-	141	546	546	1.0000000
C8	42553456	42553741	BolC8t51377H	0	+	241	285	285	1.0000000
C8	42555499	42557216	BolC8t51378H	0	+	486	1688	1717	0.9831101
C8	42559338	42561677	BolC8t51379H	0	+	432	2070	2339	0.8849936
C8	42566031	42567072	BolC8t51380H	0	+	190	1014	1041	0.9740634
C8	42573942	42580038	BolC8t51381H	0	-	1291	4871	6096	0.7990485
C8	42581094	42584466	BolC8t51382H	0	-	1562	3365	3372	0.9979241
C8	42590464	42592644	BolC8t51383H	0	+	1427	2033	2180	0.9325688
C8	42593427	42593799	BolC8t51384H	0	-	112	361	372	0.9704301
C8	42597148	42598546	BolC8t51385H	0	-	125	617	1398	0.4413448
C8	42600053	42603559	BolC8t51386H	0	-	1596	3158	3506	0.9007416
C8	42603886	42606311	BolC8t51387H	0	-	1516	2425	2425	1.0000000
C8	42608891	42610347	BolC8t51388H	0	+	711	1456	1456	1.0000000
C8	42611339	42612389	BolC8t51389H	0	+	264	998	1050	0.9504762
C8	42616425	42625704	BolC8t51390H	0	+	5262	8536	9279	0.9199267
C8	42628225	42630500	BolC8t51391H	0	+	1155	2275	2275	1.0000000
C8	42631034	42632220	BolC8t51392H	0	-	689	1186	1186	1.0000000
C8	42636120	42641421	BolC8t51393H	0	+	3778	5199	5301	0.9807584
C8	42642652	42644540	BolC8t51394H	0	-	536	1888	1888	1.0000000
C8	42645648	42647507	BolC8t51395H	0	-	310	1791	1859	0.9634212
C8	42648121	42648721	BolC8t51396H	0	+	181	513	600	0.8550000
C8	42649461	42651323	BolC8t51397H	0	-	415	1862	1862	1.0000000
C8	42659074	42661484	BolC8t51398H	0	-	2090	2410	2410	1.0000000
C8	42664005	42665250	BolC8t51399H	0	-	194	930	1245	0.7469879
C8	42669901	42672163	BolC8t51400H	0	+	418	1655	2262	0.7316534
C8	42672866	42672968	BolC8t51401H	0	-	128	102	102	1.0000000
C8	42673187	42677684	BolC8t51402H	0	-	2343	4240	4497	0.9428508
C8	42683192	42685320	BolC8t51403H	0	+	1101	2046	2128	0.9614662
C8	42688904	42690879	BolC8t51404H	0	+	1437	1975	1975	1.0000000
C8	42692135	42692666	BolC8t51405H	0	+	168	531	531	1.0000000
C8	42698033	42698854	BolC8t51406H	0	+	251	774	821	0.9427527
C8	42701049	42701510	BolC8t51407H	0	+	446	461	461	1.0000000
C8	42701852	42703895	BolC8t51408H	0	-	1362	2043	2043	1.0000000
C8	42707205	42708219	BolC8t51409H	0	-	1429	1014	1014	1.0000000
C8	42712107	42712674	BolC8t51410H	0	+	1	1	567	0.0017637
C8	42716493	42717639	BolC8t51411H	0	-	287	1146	1146	1.0000000
C8	42721842	42722088	BolC8t51412H	0	+	196	246	246	1.0000000
C8	42725256	42727995	BolC8t51413H	0	+	1650	2719	2739	0.9926981
C8	42728336	42730831	BolC8t51414H	0	-	639	2440	2495	0.9779559
C8	42740602	42744250	BolC8t51415H	0	-	885	3373	3648	0.9246162
C8	42749281	42749770	BolC8t51416H	0	-	73	373	489	0.7627812
C8	42754514	42757602	BolC8t51417H	0	+	1031	3077	3088	0.9964378
C8	42758719	42761285	BolC8t51418H	0	-	1136	2549	2566	0.9933749
C8	42764565	42765584	BolC8t51419H	0	+	443	669	1019	0.6565260
C8	42769440	42770814	BolC8t51420H	0	+	162	1176	1374	0.8558952
C8	42772315	42773603	BolC8t51421H	0	+	1090	1288	1288	1.0000000
C8	42775523	42776934	BolC8t51422H	0	+	359	1240	1411	0.8788093
C8	42781166	42785146	BolC8t51423H	0	-	586	3062	3980	0.7693467
C8	42788217	42789706	BolC8t51424H	0	-	435	1224	1489	0.8220282
C8	42791763	42793035	BolC8t51425H	0	-	606	848	1272	0.6666667
C8	42802370	42804146	BolC8t51426H	0	-	888	1688	1776	0.9504505
C8	42804665	42806190	BolC8t51427H	0	+	469	1387	1525	0.9095082
C8	42809411	42810005	BolC8t51428H	0	+	149	594	594	1.0000000
C8	42817021	42818881	BolC8t51429H	0	-	1247	1860	1860	1.0000000
C8	42825093	42827532	BolC8t51430H	0	+	363	2297	2439	0.9417794
C8	42828635	42831600	BolC8t51431H	0	+	1052	2933	2965	0.9892074
C8	42832100	42833643	BolC8t51432H	0	-	502	1329	1543	0.8613091
C8	42844776	42847422	BolC8t51433H	0	-	1386	2546	2646	0.9622071
C8	42858472	42859522	BolC8t51434H	0	-	1378	1050	1050	1.0000000
C8	42872105	42875597	BolC8t51435H	0	+	916	3362	3492	0.9627721
C8	42878255	42880377	BolC8t51436H	0	+	448	1861	2122	0.8770028
C8	42883760	42885617	BolC8t51437H	0	-	129	1378	1857	0.7420571
C8	42888904	42890824	BolC8t51438H	0	-	554	1870	1920	0.9739583
C8	42894017	42899974	BolC8t51439H	0	+	360	3019	5957	0.5067987
C8	42902207	42903451	BolC8t51440H	0	+	890	1244	1244	1.0000000
C8	42904783	42906799	BolC8t51441H	0	+	864	2016	2016	1.0000000
C8	42908443	42910765	BolC8t51442H	0	+	446	1858	2322	0.8001723
C8	42911967	42913563	BolC8t51443H	0	+	1132	1596	1596	1.0000000
C8	42913751	42916423	BolC8t51444H	0	-	796	2541	2672	0.9509730
C8	42920532	42921095	BolC8t51445H	0	-	567	563	563	1.0000000
C8	42925026	42928397	BolC8t51446H	0	-	2677	3371	3371	1.0000000
C8	42934644	42934869	BolC8t51447H	0	-	9	101	225	0.4488889
C8	42956326	42956567	BolC8t51448H	0	-	82	241	241	1.0000000
C8	42961176	42962226	BolC8t51449H	0	+	242	891	1050	0.8485714
C8	42964606	42965415	BolC8t51450H	0	+	5	293	809	0.3621755
C8	42967981	42969400	BolC8t51451H	0	+	297	1365	1419	0.9619451
C8	42970906	42979784	BolC8t51452H	0	-	3148	7049	8878	0.7939851
C8	42982991	42991066	BolC8t51453H	0	-	2086	7188	8075	0.8901548
C8	42991713	42992081	BolC8t51454H	0	-	147	368	368	1.0000000
C8	42994543	42995720	BolC8t51455H	0	+	4	384	1177	0.3262532
C8	42996854	43000622	BolC8t51456H	0	+	749	3542	3768	0.9400212
C8	43002395	43003914	BolC8t51457H	0	+	492	1519	1519	1.0000000
C8	43006835	43008415	BolC8t51458H	0	-	778	1580	1580	1.0000000
C8	43009255	43009530	BolC8t51459H	0	+	157	275	275	1.0000000
C8	43009541	43009762	BolC8t51460H	0	+	239	221	221	1.0000000
C8	43020626	43021873	BolC8t51461H	0	-	811	1244	1247	0.9975942
C8	43029378	43031163	BolC8t51462H	0	+	934	1785	1785	1.0000000
C8	43032279	43032907	BolC8t51463H	0	-	248	628	628	1.0000000
C8	43035742	43036024	BolC8t51464H	0	-	821	282	282	1.0000000
C8	43038413	43043361	BolC8t51465H	0	+	3026	4923	4948	0.9949474
C8	43044369	43045176	BolC8t51466H	0	+	224	807	807	1.0000000
C8	43049959	43052323	BolC8t51467H	0	-	794	1979	2364	0.8371404
C8	43059984	43066299	BolC8t51468H	0	-	3708	6229	6315	0.9863816
C8	43095948	43101752	BolC8t51469H	0	-	3055	5648	5804	0.9731220
C8	43108905	43109656	BolC8t51470H	0	-	464	751	751	1.0000000
C8	43111420	43112312	BolC8t51471H	0	-	540	892	892	1.0000000
C8	43113611	43114460	BolC8t51472H	0	+	624	849	849	1.0000000
C8	43115395	43118051	BolC8t51473H	0	-	477	1955	2656	0.7360693
C8	43131734	43132382	BolC8t51474H	0	-	40	356	648	0.5493827
C8	43134481	43136300	BolC8t51475H	0	+	737	1819	1819	1.0000000
C8	43142293	43143568	BolC8t51476H	0	+	481	1275	1275	1.0000000
C8	43146241	43149244	BolC8t51477H	0	+	561	2802	3003	0.9330669
C8	43150389	43151513	BolC8t51478H	0	-	695	1124	1124	1.0000000
C8	43158109	43158469	BolC8t51479H	0	-	20	302	360	0.8388889
C8	43161609	43161862	BolC8t51480H	0	+	332	253	253	1.0000000
C8	43165335	43165788	BolC8t51481H	0	-	396	453	453	1.0000000
C8	43173877	43177120	BolC8t51482H	0	+	2118	3243	3243	1.0000000
C8	43181679	43182673	BolC8t51483H	0	+	460	994	994	1.0000000
C8	43184393	43189260	BolC8t51484H	0	+	2431	4790	4867	0.9841791
C8	43191902	43195487	BolC8t51485H	0	+	1213	3224	3585	0.8993027
C8	43199485	43202067	BolC8t51486H	0	+	630	2332	2582	0.9031758
C8	43203015	43206462	BolC8t51487H	0	-	616	2995	3447	0.8688715
C8	43209003	43215386	BolC8t51488H	0	-	3325	6208	6383	0.9725834
C8	43218541	43219379	BolC8t51489H	0	+	236	829	838	0.9892601
C8	43220746	43222148	BolC8t51490H	0	+	259	1200	1402	0.8559201
C8	43222872	43223982	BolC8t51491H	0	-	320	1083	1110	0.9756757
C8	43228266	43229975	BolC8t51492H	0	-	1085	1709	1709	1.0000000
C8	43234534	43247859	BolC8t51493H	0	+	5834	12327	13325	0.9251032
C8	43250864	43251866	BolC8t51494H	0	+	608	1002	1002	1.0000000
C8	43255082	43255595	BolC8t51495H	0	-	663	513	513	1.0000000
C8	43256203	43256833	BolC8t51496H	0	-	102	478	630	0.7587302
C8	43257264	43258347	BolC8t51497H	0	+	4	103	1083	0.0951062
C8	43259199	43260042	BolC8t51498H	0	+	55	366	843	0.4341637
C8	43260512	43261223	BolC8t51499H	0	-	293	711	711	1.0000000
C8	43273883	43276303	BolC8t51500H	0	+	952	2351	2420	0.9714876
C8	43277213	43279672	BolC8t51501H	0	-	866	2373	2459	0.9650264
C8	43283597	43286804	BolC8t51502H	0	+	282	2506	3207	0.7814156
C8	43287444	43288536	BolC8t51503H	0	-	472	1092	1092	1.0000000
C8	43291951	43299042	BolC8t51504H	0	-	1610	6246	7091	0.8808349
C8	43300665	43305492	BolC8t51505H	0	+	1642	4170	4827	0.8638906
C8	43306251	43307485	BolC8t51506H	0	+	394	1137	1234	0.9213938
C8	43317489	43325068	BolC8t51507H	0	-	533	3064	7579	0.4042750
C8	43329383	43331853	BolC8t51508H	0	+	454	2255	2470	0.9129555
C8	43338688	43341374	BolC8t51509H	0	+	491	2619	2686	0.9750559
C8	43346008	43346552	BolC8t51510H	0	+	286	514	544	0.9448529
C8	43346558	43347593	BolC8t51511H	0	-	55	484	1035	0.4676329
C8	43348577	43348917	BolC8t51512H	0	+	88	319	340	0.9382353
C8	43350179	43351598	BolC8t51513H	0	-	141	1268	1419	0.8935871
C8	43367544	43368375	BolC8t51514H	0	-	424	831	831	1.0000000
C8	43371467	43372090	BolC8t51515H	0	-	467	623	623	1.0000000
C8	43374228	43375720	BolC8t51516H	0	-	871	1492	1492	1.0000000
C8	43377495	43380767	BolC8t51517H	0	-	1412	3171	3272	0.9691320
C8	43384834	43387186	BolC8t51518H	0	+	736	2319	2352	0.9859694
C8	43388616	43390450	BolC8t51519H	0	-	324	1413	1834	0.7704471
C8	43402713	43402977	BolC8t51520H	0	+	1	130	264	0.4924242
C8	43407558	43410552	BolC8t51521H	0	+	699	2682	2994	0.8957916
C8	43412244	43413305	BolC8t51522H	0	+	163	814	1061	0.7672008
C8	43415295	43418353	BolC8t51523H	0	-	120	1923	3058	0.6288424
C8	43426190	43426876	BolC8t51524H	0	-	164	675	686	0.9839650
C8	43429578	43433973	BolC8t51525H	0	+	1320	3813	4395	0.8675768
C8	43434869	43436500	BolC8t51526H	0	+	455	1631	1631	1.0000000
C8	43436989	43439098	BolC8t51527H	0	-	1356	2109	2109	1.0000000
C8	43454676	43455345	BolC8t51528H	0	-	715	669	669	1.0000000
C8	43456527	43457360	BolC8t51529H	0	-	497	833	833	1.0000000
C8	43462876	43465005	BolC8t51530H	0	+	1490	2129	2129	1.0000000
C8	43466953	43467586	BolC8t51531H	0	+	572	633	633	1.0000000
C8	43471022	43472182	BolC8t51532H	0	+	895	1160	1160	1.0000000
C8	43473166	43479773	BolC8t51533H	0	-	2551	5329	6607	0.8065688
C8	43486859	43487912	BolC8t51534H	0	+	7	316	1053	0.3000950
C8	43488887	43492077	BolC8t51535H	0	+	681	2897	3190	0.9081505
C8	43492266	43494378	BolC8t51536H	0	-	1054	2028	2112	0.9602273
C8	43496956	43498808	BolC8t51537H	0	-	198	1278	1852	0.6900648
C8	43502446	43502689	BolC8t51538H	0	+	281	243	243	1.0000000
C8	43503035	43504500	BolC8t51539H	0	-	511	1465	1465	1.0000000
C8	43512520	43513802	BolC8t51540H	0	+	326	914	1282	0.7129485
C8	43517027	43518146	BolC8t51541H	0	+	33	662	1119	0.5915996
C8	43524796	43526514	BolC8t51542H	0	+	534	1497	1718	0.8713620
C8	43533675	43534113	BolC8t51543H	0	+	0	0	438	0.0000000
C8	43555377	43555662	BolC8t51544H	0	+	1	110	285	0.3859649
C8	43556167	43556450	BolC8t51545H	0	-	2	73	283	0.2579505
C8	43567516	43572118	BolC8t51546H	0	+	1186	3919	4602	0.8515863
C8	43589253	43594493	BolC8t51547H	0	-	534	2840	5240	0.5419847
C8	43597309	43599363	BolC8t51548H	0	+	797	1765	2054	0.8592989
C8	43599528	43600637	BolC8t51549H	0	-	767	1109	1109	1.0000000
C8	43600707	43601840	BolC8t51550H	0	+	817	1133	1133	1.0000000
C8	43610994	43611489	BolC8t51551H	0	-	174	428	495	0.8646465
C8	43615147	43616448	BolC8t51552H	0	-	250	980	1301	0.7532667
C8	43619083	43622189	BolC8t51553H	0	+	2187	3106	3106	1.0000000
C8	43633420	43635167	BolC8t51554H	0	+	621	1423	1747	0.8145392
C8	43636194	43638709	BolC8t51555H	0	-	877	2216	2515	0.8811133
C8	43651755	43654072	BolC8t51556H	0	+	1635	2251	2317	0.9715149
C8	43660818	43664320	BolC8t51557H	0	+	2775	3502	3502	1.0000000
C8	43678488	43680825	BolC8t51558H	0	+	791	1836	2337	0.7856226
C8	43698961	43699213	BolC8t51559H	0	-	4	46	252	0.1825397
C8	43702693	43703776	BolC8t51560H	0	+	351	1060	1083	0.9787627
C8	43704784	43705720	BolC8t51561H	0	-	31	588	936	0.6282051
C8	43709314	43712337	BolC8t51562H	0	-	1339	2978	3023	0.9851141
C8	43713738	43715694	BolC8t51563H	0	+	469	1473	1956	0.7530675
C8	43716035	43718955	BolC8t51564H	0	-	581	2629	2920	0.9003425
C8	43721726	43724643	BolC8t51565H	0	-	1588	2818	2917	0.9660610
C8	43726389	43726566	BolC8t51566H	0	+	196	177	177	1.0000000
C8	43727187	43732605	BolC8t51567H	0	-	11488	4902	5418	0.9047619
C8	43735003	43735261	BolC8t51568H	0	-	46	258	258	1.0000000
C8	43747878	43749264	BolC8t51569H	0	+	259	883	1386	0.6370851
C8	43750694	43752041	BolC8t51570H	0	+	286	1200	1347	0.8908686
C8	43752717	43755219	BolC8t51571H	0	-	549	2087	2502	0.8341327
C8	43755989	43757153	BolC8t51572H	0	-	120	314	1164	0.2697594
C8	43760449	43761649	BolC8t51573H	0	-	88	661	1200	0.5508333
C8	43787146	43789258	BolC8t51574H	0	+	194	843	2112	0.3991477
C8	43790014	43792237	BolC8t51575H	0	+	321	1805	2223	0.8119658
C8	43797977	43818019	BolC8t51576H	0	+	9467	14823	20042	0.7395968
C8	43805323	43813237	BolC8t51577H	0	-	2137	3229	7914	0.4080111
C8	43814030	43814327	BolC8t51578H	0	-	28	297	297	1.0000000
C8	43824845	43825775	BolC8t51579H	0	-	423	930	930	1.0000000
C8	43830380	43830629	BolC8t51580H	0	-	25	170	249	0.6827309
C8	43840020	43840791	BolC8t51581H	0	+	167	614	771	0.7963684
C8	43845127	43847453	BolC8t51582H	0	-	996	2300	2326	0.9888220
C8	43850043	43850769	BolC8t51583H	0	+	483	726	726	1.0000000
C8	43853141	43855744	BolC8t51584H	0	+	374	2257	2603	0.8670765
C8	43857307	43858974	BolC8t51585H	0	-	766	1611	1667	0.9664067
C8	43863845	43868086	BolC8t51586H	0	-	757	3473	4241	0.8189107
C8	43872014	43877510	BolC8t51587H	0	+	1394	4112	5496	0.7481805
C8	43879707	43880541	BolC8t51588H	0	+	772	834	834	1.0000000
C8	43880722	43880935	BolC8t51589H	0	+	321	213	213	1.0000000
C8	43883474	43884821	BolC8t51590H	0	+	35	557	1347	0.4135115
C8	43888347	43889792	BolC8t51591H	0	+	748	1412	1445	0.9771627
C8	43892210	43896773	BolC8t51592H	0	-	3648	4495	4563	0.9850975
C8	43904292	43904505	BolC8t51593H	0	+	31	199	213	0.9342723
C8	43907373	43910110	BolC8t51594H	0	+	2440	2737	2737	1.0000000
C8	43911407	43912304	BolC8t51595H	0	-	125	833	897	0.9286510
C8	43917267	43918170	BolC8t51596H	0	+	134	902	903	0.9988926
C8	43923137	43925188	BolC8t51597H	0	-	1531	1974	2051	0.9624574
C8	43936384	43937306	BolC8t51598H	0	-	9	159	922	0.1724512
C8	43937441	43942454	BolC8t51599H	0	-	203	1796	5013	0.3582685
C8	43938210	43939271	BolC8t51600H	0	+	1	44	1061	0.0414703
C8	43947749	43949649	BolC8t51601H	0	+	672	1453	1900	0.7647368
C8	43969639	43974383	BolC8t51602H	0	+	665	2792	4744	0.5885329
C8	43979862	43981173	BolC8t51603H	0	+	41	1010	1311	0.7704043
C8	43991177	43991668	BolC8t51604H	0	-	316	491	491	1.0000000
C8	44003400	44020256	BolC8t51605H	0	+	5109	15146	16856	0.8985524
C8	44009242	44010831	BolC8t51606H	0	-	126	1008	1589	0.6343612
C8	44027229	44027720	BolC8t51607H	0	-	324	491	491	1.0000000
C8	44035414	44036781	BolC8t51608H	0	-	360	1367	1367	1.0000000
C8	44040063	44044879	BolC8t51609H	0	-	530	3491	4816	0.7248754
C8	44057210	44057348	BolC8t51610H	0	-	75	138	138	1.0000000
C8	44061889	44063443	BolC8t51611H	0	-	523	1545	1554	0.9942085
C8	44075763	44121410	BolC8t51612H	0	-	11124	37659	45647	0.8250049
C8	44079695	44080502	BolC8t51613H	0	-	146	534	807	0.6617100
C8	44087958	44095912	BolC8t51614H	0	-	1349	5678	7954	0.7138547
C8	44090818	44091655	BolC8t51615H	0	-	0	0	837	0.0000000
C8	44106377	44106698	BolC8t51616H	0	+	57	321	321	1.0000000
C8	44112377	44116198	BolC8t51617H	0	+	434	2942	3821	0.7699555
C8	44117423	44122320	BolC8t51618H	0	-	1492	4643	4897	0.9481315
C8	44127760	44130687	BolC8t51619H	0	-	1236	2916	2927	0.9962419
C8	44133142	44134262	BolC8t51620H	0	+	217	1008	1120	0.9000000
C8	44134677	44136035	BolC8t51621H	0	-	1114	1358	1358	1.0000000
C8	44140175	44143009	BolC8t51622H	0	-	1908	2788	2834	0.9837685
C8	44147354	44151769	BolC8t51623H	0	+	1021	4056	4415	0.9186863
C8	44152302	44158052	BolC8t51624H	0	-	3936	5659	5750	0.9841739
C8	44160788	44161079	BolC8t51625H	0	+	2	65	291	0.2233677
C8	44164872	44165468	BolC8t51626H	0	-	350	596	596	1.0000000
C8	44172645	44175641	BolC8t51627H	0	+	1451	2948	2996	0.9839786
C8	44193250	44193634	BolC8t51628H	0	+	248	384	384	1.0000000
C8	44210161	44211109	BolC8t51629H	0	+	321	873	948	0.9208861
C8	44220157	44221709	BolC8t51630H	0	+	427	1552	1552	1.0000000
C8	44227104	44229838	BolC8t51631H	0	-	1812	2734	2734	1.0000000
C8	44231564	44234019	BolC8t51632H	0	-	1648	2303	2455	0.9380856
C8	44238068	44238467	BolC8t51633H	0	+	107	399	399	1.0000000
C8	44240342	44242831	BolC8t51634H	0	-	1105	2489	2489	1.0000000
C8	44243293	44245433	BolC8t51635H	0	-	996	2102	2140	0.9822430
C8	44247825	44248937	BolC8t51636H	0	+	444	1112	1112	1.0000000
C8	44260748	44261225	BolC8t51637H	0	-	336	477	477	1.0000000
C8	44266265	44267952	BolC8t51638H	0	-	915	1683	1687	0.9976289
C8	44271312	44271722	BolC8t51639H	0	-	0	0	410	0.0000000
C8	44274888	44275492	BolC8t51640H	0	+	761	604	604	1.0000000
C8	44284766	44285036	BolC8t51641H	0	-	258	270	270	1.0000000
C8	44286695	44287848	BolC8t51642H	0	-	178	712	1153	0.6175195
C8	44296442	44296613	BolC8t51643H	0	-	62	171	171	1.0000000
C8	44297228	44301013	BolC8t51644H	0	+	1226	3201	3785	0.8457068
C8	44308734	44309301	BolC8t51645H	0	-	76	439	567	0.7742504
C8	44309396	44309680	BolC8t51646H	0	-	12	60	284	0.2112676
C8	44313343	44319399	BolC8t51647H	0	-	904	2114	6056	0.3490753
C8	44321379	44321622	BolC8t51648H	0	+	343	243	243	1.0000000
C8	44324442	44324963	BolC8t51649H	0	+	0	0	521	0.0000000
C8	44326860	44327211	BolC8t51650H	0	-	42	351	351	1.0000000
C8	44329199	44330851	BolC8t51651H	0	+	601	1643	1652	0.9945521
C8	44332314	44340086	BolC8t51652H	0	-	2889	6637	7772	0.8539630
C8	44341046	44342682	BolC8t51653H	0	-	780	1517	1636	0.9272616
C8	44343238	44344633	BolC8t51654H	0	-	794	1395	1395	1.0000000
C8	44359252	44360152	BolC8t51655H	0	+	125	900	900	1.0000000
C8	44360248	44361296	BolC8t51656H	0	+	248	990	1048	0.9446565
C8	44361972	44378260	BolC8t51657H	0	-	3740	11575	16288	0.7106459
C8	44381589	44381805	BolC8t51658H	0	+	41	177	216	0.8194444
C8	44390254	44393486	BolC8t51659H	0	+	1060	2874	3232	0.8892327
C8	44394334	44401403	BolC8t51660H	0	-	742	2892	7069	0.4091102
C8	44403255	44403399	BolC8t51661H	0	+	5	108	144	0.7500000
C8	44407602	44407827	BolC8t51662H	0	-	8	185	225	0.8222222
C8	44426863	44428826	BolC8t51663H	0	-	486	1800	1963	0.9169638
C8	44430374	44431301	BolC8t51664H	0	+	251	879	927	0.9482201
C8	44432842	44433690	BolC8t51665H	0	-	1150	848	848	1.0000000
C8	44434611	44436993	BolC8t51666H	0	-	1104	2382	2382	1.0000000
C8	44438866	44439037	BolC8t51667H	0	-	91	171	171	1.0000000
C8	44439888	44440938	BolC8t51668H	0	+	170	915	1050	0.8714285
C8	44443846	44444029	BolC8t51669H	0	+	72	183	183	1.0000000
C8	44445536	44446634	BolC8t51670H	0	+	222	1098	1098	1.0000000
C8	44447722	44449687	BolC8t51671H	0	+	177	1633	1965	0.8310432
C8	44462299	44465222	BolC8t51672H	0	-	3214	2904	2923	0.9934998
C8	44462870	44463849	BolC8t51673H	0	-	863	979	979	1.0000000
C8	44466377	44470961	BolC8t51674H	0	+	926	4362	4584	0.9515707
C8	44472451	44472982	BolC8t51675H	0	-	144	531	531	1.0000000
C8	44477201	44481261	BolC8t51676H	0	-	564	3064	4060	0.7546798
C8	44486376	44487279	BolC8t51677H	0	+	138	732	903	0.8106312
C8	44488640	44490173	BolC8t51678H	0	-	279	952	1533	0.6210046
C8	44501355	44502608	BolC8t51679H	0	+	310	1062	1253	0.8475658
C8	44514895	44517569	BolC8t51680H	0	-	2900	2674	2674	1.0000000
C8	44523459	44524749	BolC8t51681H	0	+	148	1161	1290	0.9000000
C8	44526232	44528129	BolC8t51682H	0	+	1049	1897	1897	1.0000000
C8	44530337	44530664	BolC8t51683H	0	-	31	272	327	0.8318043
C8	44533749	44534133	BolC8t51684H	0	+	161	384	384	1.0000000
C8	44534571	44536512	BolC8t51685H	0	-	665	1597	1941	0.8227718
C8	44540955	44544126	BolC8t51686H	0	-	2035	3136	3171	0.9889625
C8	44545326	44548464	BolC8t51687H	0	+	1595	3138	3138	1.0000000
C8	44548924	44551701	BolC8t51688H	0	-	1550	2650	2777	0.9542672
C8	44553179	44554346	BolC8t51689H	0	-	441	1053	1167	0.9023136
C8	44555834	44556974	BolC8t51690H	0	-	77	1009	1140	0.8850877
C8	44559364	44560135	BolC8t51691H	0	+	445	771	771	1.0000000
C8	44563553	44563901	BolC8t51692H	0	+	438	348	348	1.0000000
C8	44569770	44570064	BolC8t51693H	0	+	23	292	294	0.9931973
C8	44578897	44580455	BolC8t51694H	0	-	85	1178	1558	0.7560976
C8	44582658	44588362	BolC8t51695H	0	-	1158	4800	5704	0.8415147
C8	44592787	44595106	BolC8t51696H	0	+	1061	2315	2319	0.9982751
C8	44595846	44596203	BolC8t51697H	0	+	22	355	357	0.9943978
C8	44596374	44596721	BolC8t51698H	0	+	64	293	347	0.8443804
C8	44597183	44599764	BolC8t51699H	0	-	1751	2555	2581	0.9899264
C8	44604949	44605633	BolC8t51700H	0	+	201	660	684	0.9649123
C8	44607835	44608375	BolC8t51701H	0	-	96	432	540	0.8000000
C8	44611219	44611696	BolC8t51702H	0	+	297	445	477	0.9329140
C8	44612015	44613040	BolC8t51703H	0	-	588	1008	1025	0.9834146
C8	44613469	44616752	BolC8t51704H	0	-	560	2289	3283	0.6972281
C8	44630864	44631223	BolC8t51705H	0	-	47	359	359	1.0000000
C8	44632501	44634368	BolC8t51706H	0	+	721	1804	1867	0.9662560
C8	44635240	44636666	BolC8t51707H	0	+	72	236	1426	0.1654979
C8	44636866	44637154	BolC8t51708H	0	-	3	185	288	0.6423611
C8	44645755	44647319	BolC8t51709H	0	+	646	1525	1564	0.9750639
C8	44651733	44652660	BolC8t51710H	0	+	729	927	927	1.0000000
C8	44653496	44653791	BolC8t51711H	0	-	6	67	295	0.2271186
C8	44653934	44654135	BolC8t51712H	0	-	0	0	201	0.0000000
C8	44654803	44657975	BolC8t51713H	0	-	647	3047	3172	0.9605927
C8	44660573	44666067	BolC8t51714H	0	+	1027	4477	5494	0.8148890
C8	44666715	44668815	BolC8t51715H	0	+	479	1686	2100	0.8028572
C8	44669696	44672185	BolC8t51716H	0	-	1823	2449	2489	0.9839293
C8	44675701	44680967	BolC8t51717H	0	-	2279	5001	5266	0.9496772
C8	44685039	44686348	BolC8t51718H	0	-	64	1154	1309	0.8815890
C8	44690729	44694008	BolC8t51719H	0	-	3368	3279	3279	1.0000000
C8	44700974	44703093	BolC8t51720H	0	-	1805	2119	2119	1.0000000
C8	44704461	44711051	BolC8t51721H	0	-	1629	3867	6590	0.5867982
C8	44713147	44715566	BolC8t51722H	0	+	1699	2419	2419	1.0000000
C8	44716213	44719076	BolC8t51723H	0	-	996	2844	2863	0.9933636
C8	44721685	44723731	BolC8t51724H	0	+	648	2040	2046	0.9970675
C8	44724548	44725682	BolC8t51725H	0	-	545	1134	1134	1.0000000
C8	44733235	44733502	BolC8t51726H	0	+	2	5	267	0.0187266
C8	44734229	44734895	BolC8t51727H	0	+	391	661	666	0.9924925
C8	44735851	44739887	BolC8t51728H	0	+	320	2371	4036	0.5874628
C8	44741000	44741276	BolC8t51729H	0	-	35	270	276	0.9782609
C8	44741603	44741864	BolC8t51730H	0	-	223	261	261	1.0000000
C8	44742073	44743765	BolC8t51731H	0	-	496	1587	1692	0.9379433
C8	44744574	44746211	BolC8t51732H	0	+	506	1579	1637	0.9645693
C8	44748100	44748223	BolC8t51733H	0	+	338	123	123	1.0000000
C8	44749200	44749719	BolC8t51734H	0	+	378	519	519	1.0000000
C8	44753295	44754958	BolC8t51735H	0	+	534	1663	1663	1.0000000
C8	44756384	44757206	BolC8t51736H	0	+	626	822	822	1.0000000
C8	44779926	44780241	BolC8t51737H	0	-	19	175	315	0.5555556
C8	44789805	44791288	BolC8t51738H	0	-	255	1411	1483	0.9514498
C8	44794397	44794679	BolC8t51739H	0	+	23	282	282	1.0000000
C8	44795695	44796094	BolC8t51740H	0	+	30	247	399	0.6190476
C8	44796813	44798624	BolC8t51741H	0	+	773	1811	1811	1.0000000
C8	44800448	44802326	BolC8t51742H	0	-	1245	1768	1878	0.9414271
C8	44802837	44805183	BolC8t51743H	0	-	1715	2251	2346	0.9595056
C8	44807374	44809087	BolC8t51744H	0	+	1881	1713	1713	1.0000000
C8	44809733	44809904	BolC8t51745H	0	-	50	171	171	1.0000000
C8	44810331	44810916	BolC8t51746H	0	+	352	578	585	0.9880342
C8	44813113	44815742	BolC8t51747H	0	+	665	2398	2629	0.9121339
C8	44821541	44822198	BolC8t51748H	0	+	336	654	657	0.9954338
C8	44822762	44824933	BolC8t51749H	0	-	917	2162	2171	0.9958544
C8	44834397	44836609	BolC8t51750H	0	-	1089	2030	2212	0.9177215
C8	44838504	44839581	BolC8t51751H	0	-	716	865	1077	0.8031569
C8	44840935	44843156	BolC8t51752H	0	-	189	1862	2221	0.8383611
C8	44846336	44848509	BolC8t51753H	0	-	51	1041	2173	0.4790612
C8	44850283	44851093	BolC8t51754H	0	+	247	763	810	0.9419753
C8	44851242	44851571	BolC8t51755H	0	-	270	329	329	1.0000000
C8	44852929	44856176	BolC8t51756H	0	+	636	2891	3247	0.8903604
C8	44856400	44857671	BolC8t51757H	0	-	741	1271	1271	1.0000000
C8	44860009	44860951	BolC8t51758H	0	-	519	914	942	0.9702760
C8	44867180	44867610	BolC8t51759H	0	+	81	430	430	1.0000000
C8	44868157	44868601	BolC8t51760H	0	+	162	444	444	1.0000000
C8	44869155	44870510	BolC8t51761H	0	-	329	1208	1355	0.8915129
C8	44871898	44872105	BolC8t51762H	0	+	24	207	207	1.0000000
C8	44872620	44874186	BolC8t51763H	0	+	885	1566	1566	1.0000000
C8	44875582	44876188	BolC8t51764H	0	-	273	606	606	1.0000000
C8	44876593	44877907	BolC8t51765H	0	+	246	1267	1314	0.9642314
C8	44878996	44879239	BolC8t51766H	0	+	126	243	243	1.0000000
C8	44881105	44882984	BolC8t51767H	0	-	228	1787	1879	0.9510378
C8	44894005	44895301	BolC8t51768H	0	+	425	1139	1296	0.8788580
C8	44895809	44898489	BolC8t51769H	0	-	1081	2606	2680	0.9723881
C8	44899417	44900809	BolC8t51770H	0	+	375	883	1392	0.6343391
C8	44908141	44908466	BolC8t51771H	0	-	558	325	325	1.0000000
C8	44910576	44912219	BolC8t51772H	0	+	389	1510	1643	0.9190505
C8	44912981	44914883	BolC8t51773H	0	+	1169	1902	1902	1.0000000
C8	44915582	44916500	BolC8t51774H	0	-	348	918	918	1.0000000
C8	44924343	44928529	BolC8t51775H	0	-	2210	3985	4186	0.9519828
C8	44938137	44938566	BolC8t51776H	0	+	44	350	429	0.8158508
C8	44939132	44940458	BolC8t51777H	0	+	103	1267	1326	0.9555053
C8	44940567	44942190	BolC8t51778H	0	-	861	1623	1623	1.0000000
C8	44942842	44943455	BolC8t51779H	0	-	360	613	613	1.0000000
C8	44943771	44944216	BolC8t51780H	0	+	575	445	445	1.0000000
C8	44944805	44947544	BolC8t51781H	0	+	852	2520	2739	0.9200438
C8	44948694	44954432	BolC8t51782H	0	-	4870	4706	5738	0.8201464
C8	44960138	44961080	BolC8t51783H	0	+	65	487	942	0.5169851
C8	44962089	44962473	BolC8t51784H	0	-	3	24	384	0.0625000
C8	44963072	44969251	BolC8t51785H	0	-	2188	5889	6179	0.9530668
C8	44986348	44989561	BolC8t51786H	0	+	1196	2950	3213	0.9181451
C8	44990384	44997739	BolC8t51787H	0	+	5761	7245	7355	0.9850442
C8	44999203	44999587	BolC8t51788H	0	-	214	384	384	1.0000000
C8	45003404	45006519	BolC8t51789H	0	-	2850	3111	3115	0.9987159
C8	45018813	45020804	BolC8t51790H	0	+	1061	1934	1991	0.9713712
C8	45026876	45027630	BolC8t51791H	0	+	50	633	754	0.8395225
C8	45029255	45030702	BolC8t51792H	0	-	849	1447	1447	1.0000000
C8	45039625	45041103	BolC8t51793H	0	-	786	1265	1478	0.8558863
C8	45042140	45043355	BolC8t51794H	0	-	379	1137	1215	0.9358025
C8	45046396	45046753	BolC8t51795H	0	-	249	357	357	1.0000000
C8	45046479	45047109	BolC8t51796H	0	-	663	630	630	1.0000000
C8	45051080	45053002	BolC8t51797H	0	+	1152	1922	1922	1.0000000
C8	45053274	45056163	BolC8t51798H	0	+	1237	2493	2889	0.8629283
C8	45056855	45059663	BolC8t51799H	0	-	1259	2787	2808	0.9925213
C8	45062994	45063297	BolC8t51800H	0	-	308	303	303	1.0000000
C8	45066017	45067277	BolC8t51801H	0	+	493	1260	1260	1.0000000
C8	45079140	45080331	BolC8t51802H	0	+	255	1191	1191	1.0000000
C8	45082012	45083528	BolC8t51803H	0	-	179	1071	1516	0.7064644
C8	45084425	45085888	BolC8t51804H	0	+	512	1463	1463	1.0000000
C8	45087678	45088329	BolC8t51805H	0	+	255	651	651	1.0000000
C8	45088931	45089902	BolC8t51806H	0	-	875	971	971	1.0000000
C8	45090375	45090744	BolC8t51807H	0	+	307	369	369	1.0000000
C8	45091463	45092040	BolC8t51808H	0	-	356	577	577	1.0000000
C8	45092676	45093387	BolC8t51809H	0	-	640	711	711	1.0000000
C8	45094639	45097165	BolC8t51810H	0	+	1656	2526	2526	1.0000000
C8	45097599	45101679	BolC8t51811H	0	-	2082	3980	4080	0.9754902
C8	45104248	45106662	BolC8t51812H	0	+	589	2375	2414	0.9838442
C8	45107837	45110315	BolC8t51813H	0	+	1638	2420	2478	0.9765940
C8	45111242	45113419	BolC8t51814H	0	-	991	2177	2177	1.0000000
C8	45114453	45115551	BolC8t51815H	0	-	754	1098	1098	1.0000000
C8	45116386	45119402	BolC8t51816H	0	-	2465	3016	3016	1.0000000
C8	45120163	45122010	BolC8t51817H	0	-	1174	1847	1847	1.0000000
C8	45122797	45124955	BolC8t51818H	0	-	989	2108	2158	0.9768304
C8	45130672	45133512	BolC8t51819H	0	+	441	2471	2840	0.8700704
C8	45133925	45135461	BolC8t51820H	0	-	314	867	1536	0.5644531
C8	45139668	45140776	BolC8t51821H	0	+	25	474	1108	0.4277978
C8	45141542	45146235	BolC8t51822H	0	+	2196	4439	4693	0.9458768
C8	45152380	45152911	BolC8t51823H	0	+	682	531	531	1.0000000
C8	45153411	45156649	BolC8t51824H	0	-	2439	2986	3238	0.9221742
C8	45156767	45157229	BolC8t51825H	0	-	795	462	462	1.0000000
C8	45158522	45166007	BolC8t51826H	0	+	2585	5644	7485	0.7540414
C8	45170139	45171021	BolC8t51827H	0	-	424	882	882	1.0000000
C8	45175968	45176289	BolC8t51828H	0	-	278	321	321	1.0000000
C8	45178835	45198489	BolC8t51829H	0	+	8737	17118	19654	0.8709677
C8	45201658	45206729	BolC8t51830H	0	-	2205	4951	5071	0.9763360
C8	45209778	45210085	BolC8t51831H	0	+	298	307	307	1.0000000
C8	45211069	45211645	BolC8t51832H	0	+	267	576	576	1.0000000
C8	45212448	45216490	BolC8t51833H	0	-	1505	3838	4042	0.9495299
C8	45225653	45226380	BolC8t51834H	0	-	387	727	727	1.0000000
C8	45228232	45229027	BolC8t51835H	0	-	303	606	795	0.7622641
C8	45229523	45232973	BolC8t51836H	0	-	1660	3415	3450	0.9898551
C8	45233937	45239085	BolC8t51837H	0	-	3030	4228	5148	0.8212898
C8	45239797	45241560	BolC8t51838H	0	-	1034	1755	1763	0.9954623
C8	45242953	45243208	BolC8t51839H	0	-	72	255	255	1.0000000
C8	45246500	45247683	BolC8t51840H	0	+	400	1081	1183	0.9137785
C8	45248328	45249970	BolC8t51841H	0	+	287	1375	1642	0.8373934
C8	45250909	45251554	BolC8t51842H	0	+	188	580	645	0.8992248
C8	45254113	45257812	BolC8t51843H	0	-	2343	3601	3699	0.9735063
C8	45259687	45263720	BolC8t51844H	0	+	250	2530	4033	0.6273246
C8	45267479	45269843	BolC8t51845H	0	+	153	1529	2364	0.6467851
C8	45270013	45272334	BolC8t51846H	0	-	1101	2321	2321	1.0000000
C8	45277601	45278010	BolC8t51847H	0	+	212	409	409	1.0000000
C8	45282447	45282732	BolC8t51848H	0	-	348	285	285	1.0000000
C8	45283455	45285849	BolC8t51849H	0	-	581	2057	2394	0.8592314
C8	45287904	45288801	BolC8t51850H	0	+	676	885	897	0.9866221
C8	45300619	45303204	BolC8t51851H	0	-	169	1314	2585	0.5083172
C8	45306036	45306303	BolC8t51852H	0	+	6	113	267	0.4232210
C8	45310592	45311444	BolC8t51853H	0	-	8	311	852	0.3650235
C8	45320595	45321627	BolC8t51854H	0	-	0	0	1032	0.0000000
C8	45343940	45344996	BolC8t51855H	0	-	0	0	1056	0.0000000
C8	45353917	45354826	BolC8t51856H	0	-	0	0	909	0.0000000
C8	45363482	45364670	BolC8t51857H	0	-	0	0	1188	0.0000000
C8	45367005	45371766	BolC8t51858H	0	-	81	1359	4761	0.2854442
C8	45373264	45373453	BolC8t51859H	0	+	254	189	189	1.0000000
C8	45373676	45374822	BolC8t51860H	0	-	32	524	1146	0.4572426
C8	45377374	45378862	BolC8t51861H	0	-	1068	1240	1488	0.8333333
C8	45379366	45380706	BolC8t51862H	0	+	862	1319	1340	0.9843283
C8	45381717	45382402	BolC8t51863H	0	+	323	685	685	1.0000000
C8	45389905	45391063	BolC8t51864H	0	+	435	1144	1158	0.9879102
C8	45392092	45393768	BolC8t51865H	0	+	621	1500	1676	0.8949881
C8	45395839	45404414	BolC8t51866H	0	+	1561	4707	8575	0.5489213
C8	45405120	45406098	BolC8t51867H	0	-	260	773	978	0.7903885
C8	45409198	45412081	BolC8t51868H	0	-	648	2265	2883	0.7856399
C8	45437229	45442172	BolC8t51869H	0	-	361	2525	4943	0.5108234
C8	45442473	45443360	BolC8t51870H	0	+	445	838	887	0.9447576
C8	45447647	45447854	BolC8t51871H	0	+	241	207	207	1.0000000
C8	45452545	45453734	BolC8t51872H	0	+	362	1189	1189	1.0000000
C8	45457102	45459802	BolC8t51873H	0	+	1548	2700	2700	1.0000000
C8	45460834	45464048	BolC8t51874H	0	-	1284	2278	3214	0.7087741
C8	45473572	45474246	BolC8t51875H	0	+	756	674	674	1.0000000
C8	45474919	45477836	BolC8t51876H	0	-	2602	2908	2917	0.9969146
C8	45510524	45511777	BolC8t51877H	0	-	808	1232	1253	0.9832402
C8	45513811	45516065	BolC8t51878H	0	-	832	2036	2254	0.9032831
C8	45518326	45518569	BolC8t51879H	0	+	6	74	243	0.3045267
C8	45520504	45520789	BolC8t51880H	0	-	4	50	285	0.1754386
C8	45527474	45527678	BolC8t51881H	0	+	43	204	204	1.0000000
C8	45531949	45533172	BolC8t51882H	0	+	614	1191	1223	0.9738348
C8	45533321	45533792	BolC8t51883H	0	-	287	471	471	1.0000000
C8	45534487	45535377	BolC8t51884H	0	-	336	781	890	0.8775281
C8	45536275	45539461	BolC8t51885H	0	-	492	2792	3186	0.8763340
C8	45542847	45544130	BolC8t51886H	0	+	389	796	1283	0.6204209
C8	45545500	45548846	BolC8t51887H	0	+	1648	3236	3346	0.9671249
C8	45549195	45553719	BolC8t51888H	0	-	2172	4445	4524	0.9825376
C8	45554343	45556222	BolC8t51889H	0	-	1030	1690	1879	0.8994146
C8	45556897	45560660	BolC8t51890H	0	-	2472	3583	3763	0.9521658
C8	45564216	45566322	BolC8t51891H	0	+	745	2104	2106	0.9990503
C8	45566802	45567874	BolC8t51892H	0	-	684	1063	1072	0.9916045
C8	45569044	45569581	BolC8t51893H	0	-	74	397	537	0.7392924
C8	45572113	45572923	BolC8t51894H	0	-	141	761	810	0.9395062
C8	45593495	45593885	BolC8t51895H	0	+	393	390	390	1.0000000
C8	45599988	45600777	BolC8t51896H	0	+	83	634	789	0.8035488
C8	45606482	45607399	BolC8t51897H	0	-	354	917	917	1.0000000
C8	45607812	45610643	BolC8t51898H	0	+	1562	2824	2831	0.9975274
C8	45612810	45614541	BolC8t51899H	0	+	865	1588	1731	0.9173888
C8	45619396	45620810	BolC8t51900H	0	-	436	1401	1414	0.9908062
C8	45621973	45625959	BolC8t51901H	0	+	1200	3393	3986	0.8512293
C8	45626952	45629181	BolC8t51902H	0	+	831	2065	2229	0.9264244
C8	45629499	45630957	BolC8t51903H	0	-	562	1458	1458	1.0000000
C8	45632187	45633561	BolC8t51904H	0	-	154	857	1374	0.6237264
C8	45636087	45639619	BolC8t51905H	0	+	2671	3532	3532	1.0000000
C8	45640790	45643473	BolC8t51906H	0	+	623	2287	2683	0.8524040
C8	45645067	45646268	BolC8t51907H	0	-	433	1167	1201	0.9716902
C8	45650342	45650828	BolC8t51908H	0	+	286	479	486	0.9855967
C8	45651862	45654832	BolC8t51909H	0	+	592	2424	2970	0.8161616
C8	45655122	45656270	BolC8t51910H	0	-	414	1148	1148	1.0000000
C8	45656929	45657497	BolC8t51911H	0	-	32	430	568	0.7570422
C8	45658927	45659800	BolC8t51912H	0	+	674	873	873	1.0000000
C8	45660200	45660302	BolC8t51913H	0	+	220	102	102	1.0000000
C8	45664135	45667465	BolC8t51914H	0	+	1670	3119	3330	0.9366366
C8	45669618	45671045	BolC8t51915H	0	+	917	1378	1427	0.9656622
C8	45672597	45673143	BolC8t51916H	0	-	360	517	546	0.9468864
C8	45680254	45683002	BolC8t51917H	0	+	1581	2728	2748	0.9927220
C8	45686121	45699716	BolC8t51918H	0	-	3962	11459	13595	0.8428834
C8	45686340	45686779	BolC8t51919H	0	-	116	306	439	0.6970387
C8	45686521	45695386	BolC8t51920H	0	-	2361	7356	8865	0.8297800
C8	45695517	45696002	BolC8t51921H	0	+	44	453	485	0.9340206
C8	45700400	45713033	BolC8t51922H	0	+	1620	3199	12633	0.2532257
C8	45703814	45707340	BolC8t51923H	0	-	12	57	3526	0.0161656
C8	45717367	45718679	BolC8t51924H	0	+	96	959	1312	0.7309451
C8	45719617	45720955	BolC8t51925H	0	+	992	1338	1338	1.0000000
C8	45721589	45723200	BolC8t51926H	0	-	93	1171	1611	0.7268777
C8	45724281	45727885	BolC8t51927H	0	+	304	2563	3604	0.7111543
C8	45728913	45737642	BolC8t51928H	0	-	3466	7946	8729	0.9102990
C8	45740310	45741059	BolC8t51929H	0	+	367	749	749	1.0000000
C8	45741388	45741502	BolC8t51930H	0	+	10	54	114	0.4736842
C8	45741645	45742695	BolC8t51931H	0	+	299	989	1050	0.9419048
C8	45743305	45745143	BolC8t51932H	0	+	616	1820	1838	0.9902067
C8	45745973	45750695	BolC8t51933H	0	-	1125	3875	4722	0.8206269
C8	45759401	45759737	BolC8t51934H	0	-	257	336	336	1.0000000
C8	45760663	45763641	BolC8t51935H	0	+	1180	2850	2978	0.9570181
C8	45764072	45768030	BolC8t51936H	0	-	793	3363	3958	0.8496715
C8	45787699	45789301	BolC8t51937H	0	+	81	973	1602	0.6073658
C8	45791723	45797562	BolC8t51938H	0	+	1666	4643	5839	0.7951704
C8	45798454	45798860	BolC8t51939H	0	+	130	234	406	0.5763547
C8	45799927	45803967	BolC8t51940H	0	-	597	2500	4040	0.6188119
C8	45811627	45832033	BolC8t51941H	0	-	13568	18675	20406	0.9151720
C8	45833328	45833895	BolC8t51942H	0	-	82	567	567	1.0000000
C8	45841387	45843466	BolC8t51943H	0	-	476	1362	2079	0.6551226
C8	45845779	45846400	BolC8t51944H	0	+	64	269	621	0.4331723
C8	45848376	45853068	BolC8t51945H	0	-	1317	4334	4692	0.9236999
C8	45860110	45862096	BolC8t51946H	0	+	1510	1986	1986	1.0000000
C8	45863215	45865739	BolC8t51947H	0	+	2246	2524	2524	1.0000000
C8	45866056	45867484	BolC8t51948H	0	-	464	1394	1428	0.9761904
C8	45883835	45884559	BolC8t51949H	0	-	321	724	724	1.0000000
C8	45891429	45892164	BolC8t51950H	0	-	110	700	735	0.9523810
C8	45897210	45897982	BolC8t51951H	0	-	492	772	772	1.0000000
C8	45919777	45920824	BolC8t51952H	0	+	445	1047	1047	1.0000000
C8	45921048	45922999	BolC8t51953H	0	-	560	1784	1951	0.9144028
C8	45927780	45929538	BolC8t51954H	0	-	505	1639	1758	0.9323094
C8	45930289	45932180	BolC8t51955H	0	+	1071	1791	1891	0.9471179
C8	45933403	45934255	BolC8t51956H	0	+	264	852	852	1.0000000
C8	45934461	45936987	BolC8t51957H	0	-	382	1983	2526	0.7850356
C8	45943500	45944452	BolC8t51958H	0	-	567	952	952	1.0000000
C8	45945033	45945694	BolC8t51959H	0	-	444	661	661	1.0000000
C8	45950584	45953734	BolC8t51960H	0	+	482	2291	3150	0.7273016
C8	45954365	45956010	BolC8t51961H	0	-	360	1156	1645	0.7027355
C8	45964591	45966069	BolC8t51962H	0	+	1242	1478	1478	1.0000000
C8	45966362	45967279	BolC8t51963H	0	-	649	905	917	0.9869139
C8	45970892	45975416	BolC8t51964H	0	-	1024	3942	4524	0.8713528
C8	45988102	45989691	BolC8t51965H	0	+	992	1583	1589	0.9962240
C8	45990371	45990611	BolC8t51966H	0	+	173	240	240	1.0000000
C8	45991101	45992496	BolC8t51967H	0	+	814	1361	1395	0.9756272
C8	45993531	45994315	BolC8t51968H	0	+	448	784	784	1.0000000
C8	45995417	45996130	BolC8t51969H	0	+	381	713	713	1.0000000
C8	46000536	46001273	BolC8t51970H	0	-	661	737	737	1.0000000
C8	46002374	46002749	BolC8t51971H	0	+	631	375	375	1.0000000
C8	46004044	46004812	BolC8t51972H	0	-	604	768	768	1.0000000
C8	46030706	46031787	BolC8t51973H	0	-	751	1047	1081	0.9685476
C8	46035530	46035947	BolC8t51974H	0	+	375	417	417	1.0000000
C8	46037446	46037971	BolC8t51975H	0	-	253	502	525	0.9561905
C8	46038748	46047749	BolC8t51976H	0	+	1061	4704	9001	0.5226086
C8	46048272	46052361	BolC8t51977H	0	-	1400	3994	4089	0.9767669
C8	46053571	46060089	BolC8t51978H	0	-	2388	5996	6518	0.9199141
C8	46061339	46066234	BolC8t51979H	0	-	3321	4272	4895	0.8727273
C8	46067778	46069394	BolC8t51980H	0	-	345	1250	1616	0.7735149
C8	46082869	46085773	BolC8t51981H	0	+	1340	2838	2904	0.9772727
C8	46086194	46087244	BolC8t51982H	0	-	508	1050	1050	1.0000000
C8	46087653	46090119	BolC8t51983H	0	+	2291	2466	2466	1.0000000
C8	46091145	46091807	BolC8t51984H	0	-	643	662	662	1.0000000
C8	46093528	46095158	BolC8t51985H	0	-	1132	1630	1630	1.0000000
C8	46096439	46097985	BolC8t51986H	0	+	912	1541	1546	0.9967659
C8	46107344	46107788	BolC8t51987H	0	+	515	444	444	1.0000000
C8	46115674	46116573	BolC8t51988H	0	-	654	899	899	1.0000000
C8	46117134	46117350	BolC8t51989H	0	-	140	216	216	1.0000000
C8	46136519	46137542	BolC8t51990H	0	+	218	993	1023	0.9706745
C8	46140375	46141686	BolC8t51991H	0	-	944	1311	1311	1.0000000
C8	46144148	46144779	BolC8t51992H	0	-	0	0	631	0.0000000
C8	46146117	46147658	BolC8t51993H	0	+	445	1538	1541	0.9980532
C8	46150407	46151823	BolC8t51994H	0	+	8	203	1416	0.1433616
C8	46152584	46153152	BolC8t51995H	0	-	4	104	568	0.1830986
C8	46156825	46160900	BolC8t51996H	0	+	256	1891	4075	0.4640491
C8	46162381	46164539	BolC8t51997H	0	+	1113	1957	2158	0.9068582
C8	46164914	46167400	BolC8t51998H	0	-	1465	2434	2486	0.9790829
C8	46170128	46172571	BolC8t51999H	0	+	2333	2443	2443	1.0000000
C8	46172996	46177189	BolC8t52000H	0	-	2254	3857	4193	0.9198664
C8	46180696	46183036	BolC8t52001H	0	+	1566	2340	2340	1.0000000
C8	46183739	46185080	BolC8t52002H	0	-	806	1341	1341	1.0000000
C8	46185976	46187088	BolC8t52003H	0	+	730	1112	1112	1.0000000
C8	46187470	46189935	BolC8t52004H	0	-	1884	2465	2465	1.0000000
C8	46190565	46192224	BolC8t52005H	0	-	1806	1645	1659	0.9915612
C8	46192580	46193658	BolC8t52006H	0	+	428	1078	1078	1.0000000
C8	46193928	46196157	BolC8t52007H	0	-	658	1685	2229	0.7559444
C8	46196649	46199073	BolC8t52008H	0	-	721	2359	2424	0.9731848
C8	46199614	46214419	BolC8t52009H	0	-	6485	9311	14805	0.6289092
C8	46215382	46215835	BolC8t52010H	0	+	537	453	453	1.0000000
C8	46216192	46218419	BolC8t52011H	0	-	1787	2227	2227	1.0000000
C8	46221543	46222929	BolC8t52012H	0	+	1429	1386	1386	1.0000000
C8	46223295	46226002	BolC8t52013H	0	-	1159	2549	2707	0.9416328
C8	46228898	46233236	BolC8t52014H	0	-	2089	4275	4338	0.9854771
C8	46235657	46237651	BolC8t52015H	0	-	1217	1923	1994	0.9643932
C8	46238634	46241139	BolC8t52016H	0	-	652	2234	2505	0.8918164
C8	46242083	46243332	BolC8t52017H	0	+	531	1237	1249	0.9903923
C8	46244242	46245776	BolC8t52018H	0	-	1259	1534	1534	1.0000000
C8	46247091	46247769	BolC8t52019H	0	+	718	678	678	1.0000000
C8	46249235	46250681	BolC8t52020H	0	+	372	1391	1446	0.9619640
C8	46251097	46252022	BolC8t52021H	0	+	108	925	925	1.0000000
C8	46252355	46254089	BolC8t52022H	0	-	525	1734	1734	1.0000000
C8	46254952	46257024	BolC8t52023H	0	+	758	1870	2072	0.9025096
C8	46261888	46266676	BolC8t52024H	0	+	1230	3940	4788	0.8228906
C8	46269141	46269509	BolC8t52025H	0	+	132	368	368	1.0000000
C8	46276394	46282069	BolC8t52026H	0	+	1823	5274	5675	0.9293392
C8	46284911	46290502	BolC8t52027H	0	-	3059	5550	5591	0.9926668
C8	46294807	46295209	BolC8t52028H	0	+	153	330	402	0.8208955
C8	46302388	46303462	BolC8t52029H	0	-	201	913	1074	0.8500931
C8	46312282	46312654	BolC8t52030H	0	-	316	372	372	1.0000000
C8	46318446	46319781	BolC8t52031H	0	+	82	913	1335	0.6838951
C8	46323189	46323940	BolC8t52032H	0	-	898	751	751	1.0000000
C8	46328760	46330321	BolC8t52033H	0	-	284	1142	1561	0.7315823
C8	46331270	46331929	BolC8t52034H	0	+	2	166	659	0.2518968
C8	46337661	46339365	BolC8t52035H	0	-	1021	1704	1704	1.0000000
C8	46349660	46349909	BolC8t52036H	0	-	436	249	249	1.0000000
C8	46364020	46365543	BolC8t52037H	0	+	204	1323	1523	0.8686802
C8	46368433	46370419	BolC8t52038H	0	+	722	1971	1986	0.9924471
C8	46370883	46371785	BolC8t52039H	0	+	581	902	902	1.0000000
C8	46372328	46374025	BolC8t52040H	0	-	691	1652	1697	0.9734826
C8	46375436	46376177	BolC8t52041H	0	-	14	409	741	0.5519568
C8	46378583	46380722	BolC8t52042H	0	+	1779	2139	2139	1.0000000
C8	46382168	46387347	BolC8t52043H	0	-	194	539	5179	0.1040741
C8	46388687	46389110	BolC8t52044H	0	+	266	423	423	1.0000000
C8	46389538	46390466	BolC8t52045H	0	-	457	928	928	1.0000000
C8	46392559	46392790	BolC8t52046H	0	+	19	152	231	0.6580086
C8	46393984	46395222	BolC8t52047H	0	-	1384	1238	1238	1.0000000
C8	46397602	46397821	BolC8t52048H	0	-	345	219	219	1.0000000
C8	46398178	46398990	BolC8t52049H	0	-	599	812	812	1.0000000
C8	46402794	46403605	BolC8t52050H	0	-	102	687	811	0.8471023
C8	46409223	46410070	BolC8t52051H	0	+	229	847	847	1.0000000
C8	46413805	46413970	BolC8t52052H	0	+	78	165	165	1.0000000
C8	46415163	46416792	BolC8t52053H	0	+	1253	1629	1629	1.0000000
C8	46417254	46417548	BolC8t52054H	0	-	245	294	294	1.0000000
C8	46418682	46419622	BolC8t52055H	0	+	559	872	940	0.9276596
C8	46420093	46425861	BolC8t52056H	0	-	1006	5101	5768	0.8843620
C8	46426439	46428233	BolC8t52057H	0	+	1769	1794	1794	1.0000000
C8	46428618	46428856	BolC8t52058H	0	+	73	238	238	1.0000000
C8	46429180	46435556	BolC8t52059H	0	-	828	2984	6376	0.4680050
C8	46432535	46434608	BolC8t52060H	0	+	59	549	2073	0.2648336
C8	46436393	46436964	BolC8t52061H	0	+	132	571	571	1.0000000
C8	46437567	46441432	BolC8t52062H	0	+	502	2513	3865	0.6501940
C8	46441906	46442913	BolC8t52063H	0	-	722	1007	1007	1.0000000
C8	46445342	46447491	BolC8t52064H	0	-	1263	2149	2149	1.0000000
C8	46453141	46455127	BolC8t52065H	0	-	1535	1940	1986	0.9768379
C8	46457924	46459396	BolC8t52066H	0	-	1831	1472	1472	1.0000000
C8	46461818	46464332	BolC8t52067H	0	+	1925	2514	2514	1.0000000
C8	46465852	46467010	BolC8t52068H	0	+	486	1158	1158	1.0000000
C8	46467229	46469013	BolC8t52069H	0	-	1525	1764	1784	0.9887893
C8	46470368	46473030	BolC8t52070H	0	+	1530	2662	2662	1.0000000
C8	46473567	46474923	BolC8t52071H	0	-	331	1356	1356	1.0000000
C8	46476236	46477062	BolC8t52072H	0	+	501	826	826	1.0000000
C8	46477613	46478219	BolC8t52073H	0	+	258	365	606	0.6023102
C8	46479221	46481889	BolC8t52074H	0	-	37	1537	2668	0.5760869
C8	46482587	46485183	BolC8t52075H	0	+	1435	2596	2596	1.0000000
C8	46487393	46488731	BolC8t52076H	0	-	1820	1338	1338	1.0000000
C8	46495029	46497632	BolC8t52077H	0	+	902	1759	2603	0.6757587
C8	46500920	46501460	BolC8t52078H	0	+	498	540	540	1.0000000
C8	46506557	46507609	BolC8t52079H	0	+	467	1052	1052	1.0000000
C8	46509623	46510060	BolC8t52080H	0	-	1	32	437	0.0732265
C8	46521533	46522420	BolC8t52081H	0	+	85	643	887	0.7249154
C8	46525326	46526213	BolC8t52082H	0	+	58	399	887	0.4498309
C8	46528092	46528859	BolC8t52083H	0	+	49	303	767	0.3950456
C8	46536312	46537461	BolC8t52084H	0	-	110	936	1149	0.8146214
C8	46542622	46543506	BolC8t52085H	0	+	565	884	884	1.0000000
C8	46548548	46549077	BolC8t52086H	0	-	401	529	529	1.0000000
C8	46549798	46550568	BolC8t52087H	0	+	475	770	770	1.0000000
C8	46560795	46561984	BolC8t52088H	0	+	229	1100	1189	0.9251472
C8	46564382	46565273	BolC8t52089H	0	+	156	730	891	0.8193042
C8	46575991	46576810	BolC8t52090H	0	-	64	683	819	0.8339438
C8	46582726	46588455	BolC8t52091H	0	+	750	4569	5729	0.7975214
C8	46590404	46594511	BolC8t52092H	0	+	1630	4063	4107	0.9892866
C8	46603245	46604582	BolC8t52093H	0	+	2005	1337	1337	1.0000000
C8	46605028	46606879	BolC8t52094H	0	+	1387	1851	1851	1.0000000
C8	46607410	46610413	BolC8t52095H	0	+	1917	3003	3003	1.0000000
C8	46610597	46613983	BolC8t52096H	0	-	1544	3258	3386	0.9621973
C8	46618800	46619492	BolC8t52097H	0	+	52	524	692	0.7572255
C8	46622333	46623383	BolC8t52098H	0	+	119	796	1050	0.7580953
C8	46624670	46626811	BolC8t52099H	0	+	245	2071	2141	0.9673050
C8	46627983	46629029	BolC8t52100H	0	-	12	453	1046	0.4330784
C8	46634300	46635956	BolC8t52101H	0	+	230	960	1656	0.5797101
C8	46638275	46640295	BolC8t52102H	0	+	1197	2020	2020	1.0000000
C8	46648644	46651565	BolC8t52103H	0	+	1610	2919	2921	0.9993153
C8	46652713	46653232	BolC8t52104H	0	-	62	423	519	0.8150289
C8	46655105	46657903	BolC8t52105H	0	-	394	2530	2798	0.9042173
C8	46658322	46660792	BolC8t52106H	0	-	1217	2470	2470	1.0000000
C8	46661532	46661878	BolC8t52107H	0	+	22	324	346	0.9364162
C8	46665404	46666594	BolC8t52108H	0	-	271	1137	1190	0.9554622
C8	46668662	46669952	BolC8t52109H	0	-	150	797	1290	0.6178294
C8	46675961	46681473	BolC8t52110H	0	+	1710	5300	5512	0.9615384
C8	46681908	46685286	BolC8t52111H	0	+	1691	3025	3378	0.8955003
C8	46695007	46697162	BolC8t52112H	0	+	276	1473	2155	0.6835267
C8	46706251	46708945	BolC8t52113H	0	-	61	962	2694	0.3570898
C8	46713601	46714147	BolC8t52114H	0	-	170	546	546	1.0000000
C8	46715296	46716940	BolC8t52115H	0	-	296	1393	1644	0.8473236
C8	46728996	46729110	BolC8t52116H	0	-	34	114	114	1.0000000
C8	46730097	46732754	BolC8t52117H	0	+	209	1079	2657	0.4060971
C8	46733552	46734124	BolC8t52118H	0	+	0	0	572	0.0000000
C8	46735141	46737238	BolC8t52119H	0	+	410	1737	2097	0.8283262
C8	46737611	46737870	BolC8t52120H	0	+	211	259	259	1.0000000
C8	46737954	46738257	BolC8t52121H	0	+	211	303	303	1.0000000
C8	46739322	46740774	BolC8t52122H	0	+	784	1426	1452	0.9820937
C8	46740957	46748640	BolC8t52123H	0	-	4563	7309	7683	0.9513211
C8	46749017	46749641	BolC8t52124H	0	-	776	624	624	1.0000000
C8	46757685	46790078	BolC8t52125H	0	-	18107	26880	32393	0.8298089
C8	46759731	46760136	BolC8t52126H	0	-	508	405	405	1.0000000
C8	46806269	46807217	BolC8t52127H	0	+	12	149	948	0.1571730
C8	46809580	46811257	BolC8t52128H	0	-	289	1673	1677	0.9976148
C8	46813850	46817502	BolC8t52129H	0	+	1582	3414	3652	0.9348302
C8	46817905	46820105	BolC8t52130H	0	-	760	2007	2200	0.9122728
C8	46827086	46831244	BolC8t52131H	0	+	1481	3955	4158	0.9511784
C8	46832074	46832773	BolC8t52132H	0	-	896	699	699	1.0000000
C8	46837726	46838956	BolC8t52133H	0	+	293	859	1230	0.6983740
C8	46840164	46841292	BolC8t52134H	0	-	626	1108	1128	0.9822695
C8	46842498	46844146	BolC8t52135H	0	-	488	1539	1648	0.9338592
C8	46850730	46851140	BolC8t52136H	0	+	0	0	410	0.0000000
C8	46855509	46855725	BolC8t52137H	0	-	0	0	216	0.0000000
C8	46855959	46856181	BolC8t52138H	0	+	26	151	222	0.6801802
C8	46856541	46858039	BolC8t52139H	0	-	70	811	1498	0.5413885
C8	46858696	46861127	BolC8t52140H	0	-	1592	2431	2431	1.0000000
C8	46883350	46885463	BolC8t52141H	0	+	30	323	2113	0.1528632
C8	46893771	46894564	BolC8t52142H	0	+	1447	793	793	1.0000000
C8	46895331	46896299	BolC8t52143H	0	+	660	830	968	0.8574380
C8	46896428	46897403	BolC8t52144H	0	-	340	975	975	1.0000000
C8	46897837	46898398	BolC8t52145H	0	+	237	561	561	1.0000000
C8	46898593	46900171	BolC8t52146H	0	-	180	1463	1578	0.9271230
C8	46903026	46904047	BolC8t52147H	0	-	516	1021	1021	1.0000000
C8	46907128	46908902	BolC8t52148H	0	+	382	1744	1774	0.9830891
C8	46909927	46910812	BolC8t52149H	0	+	392	880	885	0.9943503
C8	46910958	46912312	BolC8t52150H	0	-	255	1140	1354	0.8419498
C8	46913221	46914482	BolC8t52151H	0	+	281	1069	1261	0.8477399
C8	46916226	46917223	BolC8t52152H	0	+	83	749	997	0.7512538
C8	46918289	46919371	BolC8t52153H	0	+	112	755	1082	0.6977819
C8	46919684	46921197	BolC8t52154H	0	-	33	789	1513	0.5214805
C8	46921732	46934684	BolC8t52155H	0	-	6546	12562	12952	0.9698888
C8	46927329	46929026	BolC8t52156H	0	-	133	1517	1697	0.8939305
C8	46938559	46939003	BolC8t52157H	0	+	543	444	444	1.0000000
C8	46939887	46944032	BolC8t52158H	0	-	1020	3500	4145	0.8443908
C8	46948267	46952792	BolC8t52159H	0	-	735	2698	4525	0.5962431
C8	46955708	46956637	BolC8t52160H	0	-	24	472	929	0.5080732
C8	46961861	46963798	BolC8t52161H	0	+	454	1589	1937	0.8203408
C8	46964324	46965196	BolC8t52162H	0	+	237	872	872	1.0000000
C8	46965474	46967888	BolC8t52163H	0	-	1731	2414	2414	1.0000000
C8	46977139	46979288	BolC8t52164H	0	+	796	1596	2149	0.7426710
C8	46979876	46981874	BolC8t52165H	0	-	886	1901	1998	0.9514515
C8	46989617	46993272	BolC8t52166H	0	+	1490	3519	3655	0.9627907
C8	46996465	46998975	BolC8t52167H	0	+	785	2311	2510	0.9207171
C8	46999355	47000694	BolC8t52168H	0	-	686	1216	1339	0.9081404
C8	47002165	47004455	BolC8t52169H	0	-	1525	2289	2290	0.9995633
C8	47004758	47005667	BolC8t52170H	0	+	384	858	909	0.9438944
C8	47006795	47007494	BolC8t52171H	0	+	474	699	699	1.0000000
C8	47008570	47009345	BolC8t52172H	0	+	277	775	775	1.0000000
C8	47009861	47010823	BolC8t52173H	0	-	463	943	962	0.9802495
C8	47011180	47013184	BolC8t52174H	0	+	1367	2004	2004	1.0000000
C8	47014427	47017013	BolC8t52175H	0	-	625	2416	2586	0.9342614
C8	47030325	47045481	BolC8t52176H	0	+	10647	14876	15156	0.9815255
C8	47034502	47041292	BolC8t52177H	0	-	4086	6790	6790	1.0000000
C8	47046380	47049525	BolC8t52178H	0	+	2248	3116	3145	0.9907790
C8	47049792	47050787	BolC8t52179H	0	-	116	932	995	0.9366834
C8	47058128	47059535	BolC8t52180H	0	+	76	871	1407	0.6190476
C8	47061667	47063348	BolC8t52181H	0	+	145	1028	1681	0.6115407
C8	47107364	47108408	BolC8t52182H	0	+	316	1019	1044	0.9760537
C8	47135309	47135897	BolC8t52183H	0	+	17	156	588	0.2653061
C8	47137862	47138582	BolC8t52184H	0	-	382	720	720	1.0000000
C8	47141857	47143569	BolC8t52185H	0	+	802	1712	1712	1.0000000
C8	47144689	47147571	BolC8t52186H	0	+	808	2715	2882	0.9420542
C8	47148078	47149841	BolC8t52187H	0	+	420	1510	1763	0.8564946
C8	47150965	47153065	BolC8t52188H	0	+	1034	1896	2100	0.9028571
C8	47154444	47157250	BolC8t52189H	0	+	1791	2687	2806	0.9575909
C8	47160428	47161700	BolC8t52190H	0	+	184	836	1272	0.6572327
C8	47165893	47167185	BolC8t52191H	0	+	738	1292	1292	1.0000000
C8	47168069	47170098	BolC8t52192H	0	+	525	1910	2029	0.9413504
C8	47171595	47175179	BolC8t52193H	0	+	1214	2986	3584	0.8331473
C8	47177630	47179041	BolC8t52194H	0	+	358	1047	1411	0.7420269
C8	47183875	47185243	BolC8t52195H	0	-	1113	1368	1368	1.0000000
C8	47188516	47188654	BolC8t52196H	0	-	0	0	138	0.0000000
C8	47190165	47190925	BolC8t52197H	0	+	0	0	760	0.0000000
C8	47193413	47193962	BolC8t52198H	0	+	397	549	549	1.0000000
C8	47198345	47199722	BolC8t52199H	0	-	48	462	1377	0.3355120
C8	47203094	47203795	BolC8t52200H	0	-	67	604	701	0.8616263
C8	47203854	47204007	BolC8t52201H	0	+	10	62	153	0.4052288
C8	47214714	47215184	BolC8t52202H	0	-	30	334	470	0.7106383
C8	47222822	47224055	BolC8t52203H	0	-	111	620	1233	0.5028386
C8	47228326	47230351	BolC8t52204H	0	-	1162	2024	2025	0.9995062
C8	47232292	47233315	BolC8t52205H	0	-	61	856	1023	0.8367546
C8	47236081	47236904	BolC8t52206H	0	-	16	445	823	0.5407047
C8	47262980	47263184	BolC8t52207H	0	-	133	204	204	1.0000000
C8	47265268	47266464	BolC8t52208H	0	+	26	425	1196	0.3553512
C8	47273207	47274515	BolC8t52209H	0	-	362	750	1308	0.5733945
C8	47277079	47281490	BolC8t52210H	0	+	653	4225	4411	0.9578327
C8	47283027	47284380	BolC8t52211H	0	+	499	1153	1353	0.8521804
C8	47293989	47297912	BolC8t52212H	0	-	1132	3374	3923	0.8600561
C8	47300113	47302636	BolC8t52213H	0	-	84	978	2523	0.3876338
C8	47304626	47307293	BolC8t52214H	0	-	207	1773	2667	0.6647919
C8	47308934	47311514	BolC8t52215H	0	-	267	1621	2580	0.6282946
C8	47312943	47325223	BolC8t52216H	0	-	1401	6170	12280	0.5024430
C8	47326484	47329887	BolC8t52217H	0	+	1632	3403	3403	1.0000000
C8	47330026	47330880	BolC8t52218H	0	-	631	854	854	1.0000000
C8	47334490	47336501	BolC8t52219H	0	-	1865	1990	2011	0.9895574
C8	47345050	47346924	BolC8t52220H	0	+	1131	1845	1874	0.9845251
C8	47385926	47387638	BolC8t52221H	0	+	956	1712	1712	1.0000000
C8	47390042	47392637	BolC8t52222H	0	+	542	2208	2595	0.8508670
C8	47393318	47395103	BolC8t52223H	0	-	417	1533	1785	0.8588235
C8	47396994	47398609	BolC8t52224H	0	-	289	1401	1615	0.8674923
C8	47400995	47402619	BolC8t52225H	0	-	717	1574	1624	0.9692118
C8	47405793	47407629	BolC8t52226H	0	-	551	1241	1836	0.6759259
C8	47408354	47411288	BolC8t52227H	0	+	853	2734	2934	0.9318337
C8	47411822	47412506	BolC8t52228H	0	+	318	684	684	1.0000000
C8	47413298	47414080	BolC8t52229H	0	+	219	782	782	1.0000000
C8	47414268	47414511	BolC8t52230H	0	+	91	172	243	0.7078189
C8	47416065	47418166	BolC8t52231H	0	+	1105	2059	2101	0.9800095
C8	47420096	47420975	BolC8t52232H	0	-	58	674	879	0.7667804
C8	47426479	47427125	BolC8t52233H	0	+	222	606	646	0.9380805
C8	47428640	47431130	BolC8t52234H	0	-	10078	2490	2490	1.0000000
C8	47431928	47432547	BolC8t52235H	0	-	298	619	619	1.0000000
C8	47433913	47435304	BolC8t52236H	0	-	287	932	1391	0.6700216
C8	47435971	47437675	BolC8t52237H	0	+	1165	1704	1704	1.0000000
C8	47442989	47444840	BolC8t52238H	0	-	466	1792	1851	0.9681253
C8	47445719	47446139	BolC8t52239H	0	-	224	420	420	1.0000000
C8	47446489	47451142	BolC8t52240H	0	-	2780	4419	4653	0.9497099
C8	47452700	47458982	BolC8t52241H	0	+	4668	6114	6282	0.9732569
C8	47459768	47461626	BolC8t52242H	0	+	18	464	1858	0.2497309
C8	47463180	47464221	BolC8t52243H	0	+	170	872	1041	0.8376561
C8	47465205	47467068	BolC8t52244H	0	+	976	1806	1863	0.9694042
C8	47467239	47467923	BolC8t52245H	0	-	87	494	684	0.7222222
C8	47470399	47471575	BolC8t52246H	0	+	1532	1176	1176	1.0000000
C8	47472233	47476243	BolC8t52247H	0	-	976	3332	4010	0.8309227
C8	47476566	47477184	BolC8t52248H	0	+	113	618	618	1.0000000
C8	47480390	47482644	BolC8t52249H	0	+	384	1532	2254	0.6796806
C8	47484775	47486710	BolC8t52250H	0	-	1356	1925	1935	0.9948320
C8	47487979	47489860	BolC8t52251H	0	-	981	1881	1881	1.0000000
C8	47490690	47492602	BolC8t52252H	0	-	819	1889	1912	0.9879707
C8	47493828	47495904	BolC8t52253H	0	-	845	1578	2076	0.7601156
C8	47502388	47504203	BolC8t52254H	0	+	918	1815	1815	1.0000000
C8	47505132	47507055	BolC8t52255H	0	+	701	1902	1923	0.9890795
C8	47508379	47510187	BolC8t52256H	0	+	237	1369	1808	0.7571903
C8	47511009	47511365	BolC8t52257H	0	-	614	356	356	1.0000000
C8	47513069	47513604	BolC8t52258H	0	-	567	535	535	1.0000000
C8	47515474	47515903	BolC8t52259H	0	-	256	429	429	1.0000000
C8	47517556	47518388	BolC8t52260H	0	-	442	796	832	0.9567308
C8	47519589	47520078	BolC8t52261H	0	-	41	358	489	0.7321063
C8	47523011	47523498	BolC8t52262H	0	-	21	376	487	0.7720739
C8	47524665	47527765	BolC8t52263H	0	-	486	2011	3100	0.6487097
C8	47530642	47531480	BolC8t52264H	0	-	1	84	838	0.1002387
C8	47532363	47533906	BolC8t52265H	0	-	774	1543	1543	1.0000000
C8	47537060	47537666	BolC8t52266H	0	+	234	606	606	1.0000000
C8	47538495	47540393	BolC8t52267H	0	-	760	1826	1898	0.9620653
C8	47542670	47543829	BolC8t52268H	0	-	366	1068	1159	0.9214841
C8	47544900	47546001	BolC8t52269H	0	-	129	960	1101	0.8719346
C8	47549949	47550132	BolC8t52270H	0	-	0	0	183	0.0000000
C8	47558034	47560036	BolC8t52271H	0	-	1421	1962	2002	0.9800200
C8	47560539	47564892	BolC8t52272H	0	-	1127	3290	4353	0.7558006
C8	47566669	47567772	BolC8t52273H	0	+	404	1101	1103	0.9981868
C8	47567991	47569539	BolC8t52274H	0	+	849	1548	1548	1.0000000
C8	47572942	47574341	BolC8t52275H	0	-	170	1288	1399	0.9206576
C8	47576456	47577324	BolC8t52276H	0	-	337	868	868	1.0000000
C8	47578546	47579026	BolC8t52277H	0	+	183	453	480	0.9437500
C8	47579323	47579670	BolC8t52278H	0	+	234	347	347	1.0000000
C8	47580120	47586167	BolC8t52279H	0	-	2841	5452	6047	0.9016041
C8	47586346	47589831	BolC8t52280H	0	-	684	3089	3485	0.8863702
C8	47591340	47595021	BolC8t52281H	0	-	1822	3309	3681	0.8989405
C8	47598143	47600414	BolC8t52282H	0	+	290	1788	2271	0.7873183
C8	47606008	47610771	BolC8t52283H	0	-	3458	4728	4763	0.9926517
C8	47612987	47613738	BolC8t52284H	0	-	71	668	751	0.8894807
C8	47616285	47616732	BolC8t52285H	0	+	75	405	447	0.9060403
C8	47618153	47623367	BolC8t52286H	0	+	248	3656	5214	0.7011891
C8	47630992	47633647	BolC8t52287H	0	+	907	2633	2655	0.9917138
C8	47638591	47641255	BolC8t52288H	0	+	1303	2664	2664	1.0000000
C8	47642213	47644108	BolC8t52289H	0	-	793	1882	1895	0.9931399
C8	47655784	47657155	BolC8t52290H	0	+	206	833	1371	0.6075857
C8	47657786	47659351	BolC8t52291H	0	-	1440	1565	1565	1.0000000
C8	47659667	47660788	BolC8t52292H	0	-	1028	1121	1121	1.0000000
C8	47662751	47666453	BolC8t52293H	0	-	1255	3293	3702	0.8895192
C8	47672782	47681183	BolC8t52294H	0	-	4487	7869	8401	0.9366742
C8	47673757	47675266	BolC8t52295H	0	-	846	1509	1509	1.0000000
C8	47683501	47683839	BolC8t52296H	0	-	86	338	338	1.0000000
C8	47684365	47685556	BolC8t52297H	0	-	154	293	1191	0.2460117
C8	47685607	47686626	BolC8t52298H	0	+	15	245	1019	0.2404318
C8	47686990	47687771	BolC8t52299H	0	-	2	67	781	0.0857875
C8	47688709	47689834	BolC8t52300H	0	-	29	757	1125	0.6728889
C8	47689849	47691052	BolC8t52301H	0	-	184	948	1203	0.7880299
C8	47691830	47692133	BolC8t52302H	0	-	9	226	303	0.7458746
C8	47692442	47693608	BolC8t52303H	0	-	2	233	1166	0.1998285
C8	47694752	47697010	BolC8t52304H	0	-	575	1819	2258	0.8055801
C8	47699101	47705387	BolC8t52305H	0	+	2565	5527	6286	0.8792555
C8	47706001	47707796	BolC8t52306H	0	-	410	1563	1795	0.8707521
C8	47709971	47711309	BolC8t52307H	0	+	1334	1338	1338	1.0000000
C8	47714417	47718484	BolC8t52308H	0	-	447	2404	4067	0.5910991
C8	47734349	47734757	BolC8t52309H	0	-	5	229	408	0.5612745
C8	47742117	47743499	BolC8t52310H	0	+	55	1104	1382	0.7988423
C8	47745583	47746138	BolC8t52311H	0	+	62	507	555	0.9135135
C8	47746533	47749134	BolC8t52312H	0	-	1077	2364	2601	0.9088812
C8	47775877	47776558	BolC8t52313H	0	+	194	649	681	0.9530103
C8	47781805	47782240	BolC8t52314H	0	-	9	129	435	0.2965517
C8	47789684	47793591	BolC8t52315H	0	+	92	1433	3907	0.3667776
C8	47795848	47796268	BolC8t52316H	0	+	0	0	420	0.0000000
C8	47799247	47800598	BolC8t52317H	0	-	55	710	1351	0.5255367
C8	47805533	47811936	BolC8t52318H	0	+	68	760	6403	0.1186944
C8	47814192	47814612	BolC8t52319H	0	+	2	40	420	0.0952381
C8	47815305	47816247	BolC8t52320H	0	+	93	378	942	0.4012739
C8	47820538	47820958	BolC8t52321H	0	+	32	285	420	0.6785714
C8	47826615	47827491	BolC8t52322H	0	+	303	785	876	0.8961187
C8	47832972	47837879	BolC8t52323H	0	+	2943	4758	4907	0.9696352
C8	47838241	47839999	BolC8t52324H	0	-	1415	1758	1758	1.0000000
C8	47846573	47848201	BolC8t52325H	0	-	1237	1628	1628	1.0000000
C8	47849089	47850273	BolC8t52326H	0	-	489	1108	1184	0.9358108
C8	47850838	47852937	BolC8t52327H	0	+	960	2099	2099	1.0000000
C8	47853382	47856183	BolC8t52328H	0	-	1311	2564	2801	0.9153873
C8	47856921	47859496	BolC8t52329H	0	-	1349	2575	2575	1.0000000
C8	47860119	47860455	BolC8t52330H	0	-	50	306	336	0.9107143
C8	47861942	47862283	BolC8t52331H	0	-	341	341	341	1.0000000
C8	47862907	47863879	BolC8t52332H	0	-	732	972	972	1.0000000
C8	47865082	47868195	BolC8t52333H	0	+	1159	2730	3113	0.8769675
C8	47868793	47870050	BolC8t52334H	0	+	125	779	1257	0.6197295
C8	47871001	47872589	BolC8t52335H	0	+	1116	1588	1588	1.0000000
C8	47872873	47874490	BolC8t52336H	0	-	533	1481	1617	0.9158936
C8	47875596	47876016	BolC8t52337H	0	-	127	420	420	1.0000000
C8	47877463	47877880	BolC8t52338H	0	-	178	417	417	1.0000000
C8	47878470	47879610	BolC8t52339H	0	-	896	1140	1140	1.0000000
C8	47892310	47892922	BolC8t52340H	0	-	479	612	612	1.0000000
C8	47897147	47913227	BolC8t52341H	0	-	3565	10873	16080	0.6761816
C8	47932508	47937034	BolC8t52342H	0	+	2222	4415	4526	0.9754750
C8	47948813	47949002	BolC8t52343H	0	-	135	189	189	1.0000000
C8	47950413	47957412	BolC8t52344H	0	-	2719	5002	6999	0.7146735
C8	47961341	47962874	BolC8t52345H	0	-	50	1044	1533	0.6810176
C8	47964349	47966310	BolC8t52346H	0	-	679	1934	1961	0.9862315
C8	47967216	47969667	BolC8t52347H	0	-	601	2075	2451	0.8465932
C8	47978740	47979576	BolC8t52348H	0	-	536	836	836	1.0000000
C8	47981401	47982130	BolC8t52349H	0	-	297	701	729	0.9615912
C8	47982907	47983662	BolC8t52350H	0	+	713	755	755	1.0000000
C8	47983860	47984563	BolC8t52351H	0	-	62	573	703	0.8150783
C8	47986011	48017552	BolC8t52352H	0	-	3536	10177	31541	0.3226594
C8	47990210	47992619	BolC8t52353H	0	+	281	1777	2409	0.7376505
C8	47995123	47995422	BolC8t52354H	0	-	0	0	299	0.0000000
C8	47995768	47996248	BolC8t52355H	0	+	34	191	480	0.3979167
C8	47996256	47996553	BolC8t52356H	0	+	21	117	297	0.3939394
C8	47996723	47997040	BolC8t52357H	0	+	53	282	317	0.8895899
C8	48013270	48014381	BolC8t52358H	0	+	106	118	1111	0.1062106
C8	48015946	48017179	BolC8t52359H	0	+	48	529	1233	0.4290349
C8	48018126	48020264	BolC8t52360H	0	+	886	2118	2138	0.9906455
C8	48021077	48035282	BolC8t52361H	0	-	3645	11825	14205	0.8324534
C8	48038176	48041106	BolC8t52362H	0	-	1047	2791	2930	0.9525597
C8	48043467	48043684	BolC8t52363H	0	-	178	217	217	1.0000000
C8	48047817	48057039	BolC8t52364H	0	+	4771	8797	9222	0.9539145
C8	48052954	48054082	BolC8t52365H	0	-	711	1117	1128	0.9902482
C8	48067909	48068995	BolC8t52366H	0	+	0	0	1086	0.0000000
C8	48072852	48074048	BolC8t52367H	0	+	24	503	1196	0.4205686
C8	48081858	48084741	BolC8t52368H	0	-	1832	2883	2883	1.0000000
C8	48089611	48090598	BolC8t52369H	0	-	182	725	987	0.7345492
C8	48091421	48094192	BolC8t52370H	0	+	2255	2771	2771	1.0000000
C8	48098189	48102938	BolC8t52371H	0	-	1810	4318	4749	0.9092441
C8	48104245	48108005	BolC8t52372H	0	-	1943	3756	3760	0.9989362
C8	48114226	48114973	BolC8t52373H	0	-	615	747	747	1.0000000
C8	48115853	48118852	BolC8t52374H	0	+	3874	2999	2999	1.0000000
C8	48119267	48123425	BolC8t52375H	0	-	2531	4074	4158	0.9797980
C8	48124252	48126127	BolC8t52376H	0	-	718	1875	1875	1.0000000
C8	48128112	48130146	BolC8t52377H	0	-	571	1757	2034	0.8638151
C8	48131022	48134498	BolC8t52378H	0	+	1838	3457	3476	0.9945340
C8	48141263	48142697	BolC8t52379H	0	+	810	1434	1434	1.0000000
C8	48146534	48150168	BolC8t52380H	0	-	2029	3550	3634	0.9768850
C8	48151136	48153214	BolC8t52381H	0	+	1554	2015	2078	0.9696824
C8	48158823	48165285	BolC8t52382H	0	+	3054	6287	6462	0.9729186
C8	48167645	48170686	BolC8t52383H	0	+	891	2166	3041	0.7122657
C8	48171070	48172247	BolC8t52384H	0	-	449	1080	1177	0.9175871
C8	48174602	48174878	BolC8t52385H	0	-	0	0	276	0.0000000
C8	48177672	48178073	BolC8t52386H	0	+	167	388	401	0.9675810
C8	48178838	48181127	BolC8t52387H	0	+	1030	2208	2289	0.9646134
C8	48182010	48184817	BolC8t52388H	0	+	1091	2801	2807	0.9978625
C8	48185384	48186316	BolC8t52389H	0	-	981	932	932	1.0000000
C8	48188722	48190559	BolC8t52390H	0	+	379	1586	1837	0.8633642
C8	48191423	48191930	BolC8t52391H	0	+	154	507	507	1.0000000
C8	48194617	48203025	BolC8t52392H	0	+	2156	7491	8408	0.8909372
C8	48207572	48208655	BolC8t52393H	0	-	8	312	1083	0.2880886
C8	48208987	48209622	BolC8t52394H	0	-	12	456	635	0.7181103
C8	48214151	48217644	BolC8t52395H	0	+	663	2592	3493	0.7420555
C8	48219922	48220241	BolC8t52396H	0	+	285	319	319	1.0000000
C8	48229745	48231705	BolC8t52397H	0	+	811	1920	1960	0.9795918
C8	48232260	48234564	BolC8t52398H	0	-	1181	2284	2304	0.9913194
C8	48235189	48236748	BolC8t52399H	0	-	442	1410	1559	0.9044259
C8	48237334	48239292	BolC8t52400H	0	-	866	1908	1958	0.9744638
C8	48241210	48243205	BolC8t52401H	0	+	1199	1995	1995	1.0000000
C8	48245765	48246466	BolC8t52402H	0	+	197	701	701	1.0000000
C8	48246863	48247208	BolC8t52403H	0	+	82	313	345	0.9072464
C8	48247380	48247605	BolC8t52404H	0	-	56	171	225	0.7600000
C8	48247636	48248306	BolC8t52405H	0	-	1184	670	670	1.0000000
C8	48248371	48248786	BolC8t52406H	0	-	447	415	415	1.0000000
C8	48267700	48269730	BolC8t52407H	0	+	1459	2030	2030	1.0000000
C8	48271560	48272312	BolC8t52408H	0	-	511	752	752	1.0000000
C8	48275318	48275592	BolC8t52409H	0	-	133	267	274	0.9744526
C8	48280709	48283129	BolC8t52410H	0	+	377	1923	2420	0.7946281
C8	48283542	48285525	BolC8t52411H	0	-	531	1482	1983	0.7473525
C8	48288085	48288624	BolC8t52412H	0	+	366	539	539	1.0000000
C8	48292862	48293807	BolC8t52413H	0	+	216	918	945	0.9714286
C8	48304100	48311754	BolC8t52414H	0	-	106	627	7654	0.0819179
C8	48312945	48314746	BolC8t52415H	0	+	752	1695	1801	0.9411438
C8	48318417	48329599	BolC8t52416H	0	+	4622	10981	11182	0.9820247
C8	48330673	48332653	BolC8t52417H	0	+	2092	1980	1980	1.0000000
C8	48339414	48339636	BolC8t52418H	0	-	16	139	222	0.6261261
C8	48341509	48342306	BolC8t52419H	0	+	364	797	797	1.0000000
C8	48344190	48345106	BolC8t52420H	0	-	653	916	916	1.0000000
C8	48352307	48352922	BolC8t52421H	0	-	36	256	615	0.4162602
C8	48366432	48367161	BolC8t52422H	0	-	218	724	729	0.9931413
C8	48376739	48377962	BolC8t52423H	0	+	329	1223	1223	1.0000000
C8	48382553	48383216	BolC8t52424H	0	+	176	530	663	0.7993967
C8	48384945	48386849	BolC8t52425H	0	+	1259	1856	1904	0.9747899
C8	48387181	48394417	BolC8t52426H	0	-	2467	6102	7236	0.8432836
C8	48397327	48397577	BolC8t52427H	0	+	414	250	250	1.0000000
C8	48402611	48402800	BolC8t52428H	0	+	2	63	189	0.3333333
C8	48404581	48404698	BolC8t52429H	0	-	2	79	117	0.6752137
C8	48405001	48405118	BolC8t52430H	0	-	4144	117	117	1.0000000
C8	48406716	48406827	BolC8t52431H	0	+	40	111	111	1.0000000
C8	48408503	48408704	BolC8t52432H	0	+	16	153	201	0.7611941
C8	48408926	48409052	BolC8t52433H	0	+	6	79	126	0.6269841
C8	48409521	48409878	BolC8t52434H	0	-	89	271	357	0.7591037
C8	48414986	48417269	BolC8t52435H	0	+	1226	2283	2283	1.0000000
C8	48422570	48422873	BolC8t52436H	0	-	0	0	303	0.0000000
C8	48423687	48424198	BolC8t52437H	0	-	244	511	511	1.0000000
C8	48435764	48436752	BolC8t52438H	0	+	120	966	988	0.9777328
C8	48440649	48441196	BolC8t52439H	0	+	402	547	547	1.0000000
C8	48444167	48444531	BolC8t52440H	0	+	368	364	364	1.0000000
C8	48445001	48450032	BolC8t52441H	0	-	4404	5002	5031	0.9942358
C8	48453199	48455623	BolC8t52442H	0	+	2173	2424	2424	1.0000000
C8	48456006	48456855	BolC8t52443H	0	-	881	849	849	1.0000000
C8	48468140	48468410	BolC8t52444H	0	-	91	254	270	0.9407408
C8	48476675	48477176	BolC8t52445H	0	+	55	344	501	0.6866267
C8	48478635	48489843	BolC8t52446H	0	-	7861	11113	11208	0.9915239
C8	48495290	48495744	BolC8t52447H	0	-	611	454	454	1.0000000
C8	48496573	48498140	BolC8t52448H	0	+	1304	1495	1567	0.9540523
C8	48498517	48507122	BolC8t52449H	0	-	5892	8362	8605	0.9717606
C8	48507880	48512582	BolC8t52450H	0	-	1859	4447	4702	0.9457678
C8	48513600	48530328	BolC8t52451H	0	-	5431	11708	16728	0.6999043
C8	48533981	48537820	BolC8t52452H	0	+	1883	3733	3839	0.9723886
C8	48541393	48544394	BolC8t52453H	0	-	545	2694	3001	0.8977008
C8	48548995	48551453	BolC8t52454H	0	-	1294	2356	2458	0.9585028
C8	48554846	48555545	BolC8t52455H	0	+	405	699	699	1.0000000
C8	48556890	48559089	BolC8t52456H	0	+	404	2072	2199	0.9422465
C8	48561681	48563362	BolC8t52457H	0	+	943	1645	1681	0.9785842
C8	48564663	48569024	BolC8t52458H	0	+	986	3664	4361	0.8401743
C8	48569248	48571680	BolC8t52459H	0	-	888	2380	2432	0.9786184
C8	48574926	48576060	BolC8t52460H	0	+	1129	1134	1134	1.0000000
C8	48579873	48582320	BolC8t52461H	0	+	1690	1972	2447	0.8058848
C8	48585994	48588069	BolC8t52462H	0	+	885	1947	2075	0.9383132
C8	48588127	48588742	BolC8t52463H	0	+	243	607	615	0.9869919
C8	48589214	48589914	BolC8t52464H	0	+	342	700	700	1.0000000
C8	48590957	48594395	BolC8t52465H	0	+	2053	3438	3438	1.0000000
C8	48597065	48597395	BolC8t52466H	0	-	2	24	330	0.0727273
C8	48601794	48603294	BolC8t52467H	0	+	256	1372	1500	0.9146667
C8	48605536	48607442	BolC8t52468H	0	-	364	1517	1906	0.7959077
C8	48607817	48608477	BolC8t52469H	0	+	481	660	660	1.0000000
C8	48609434	48610454	BolC8t52470H	0	+	565	968	1020	0.9490196
C8	48612319	48613047	BolC8t52471H	0	-	601	728	728	1.0000000
C8	48613650	48615422	BolC8t52472H	0	-	1453	1772	1772	1.0000000
C8	48616602	48622929	BolC8t52473H	0	+	232	2046	6327	0.3233760
C8	48623293	48628276	BolC8t52474H	0	-	899	3936	4983	0.7898856
C8	48630823	48634777	BolC8t52475H	0	+	1683	3866	3954	0.9777440
C8	48635941	48636654	BolC8t52476H	0	-	268	713	713	1.0000000
C8	48637326	48637930	BolC8t52477H	0	+	160	604	604	1.0000000
C8	48639563	48640727	BolC8t52478H	0	-	313	1058	1164	0.9089347
C8	48641785	48642103	BolC8t52479H	0	-	24	318	318	1.0000000
C8	48653530	48655793	BolC8t52480H	0	-	963	2219	2263	0.9805568
C8	48661965	48662454	BolC8t52481H	0	+	306	489	489	1.0000000
C8	48666958	48667132	BolC8t52482H	0	+	35	174	174	1.0000000
C8	48669460	48672350	BolC8t52483H	0	-	1482	2057	2890	0.7117647
C8	48673638	48674029	BolC8t52484H	0	+	210	390	391	0.9974425
C8	48675925	48679027	BolC8t52485H	0	+	877	2898	3102	0.9342360
C8	48680086	48681030	BolC8t52486H	0	-	96	614	944	0.6504237
C8	48681121	48682507	BolC8t52487H	0	-	13	455	1386	0.3282828
C8	48689697	48690321	BolC8t52488H	0	-	358	624	624	1.0000000
C8	48690972	48691914	BolC8t52489H	0	+	798	942	942	1.0000000
C8	48692929	48694924	BolC8t52490H	0	+	370	1211	1995	0.6070175
C8	48698794	48700738	BolC8t52491H	0	+	178	1325	1944	0.6815844
C8	48709210	48709687	BolC8t52492H	0	+	46	358	477	0.7505241
C8	48714175	48720616	BolC8t52493H	0	-	1325	3673	6441	0.5702531
C8	48717823	48718150	BolC8t52494H	0	-	0	0	327	0.0000000
C8	48721919	48724438	BolC8t52495H	0	+	214	1642	2519	0.6518460
C8	48724714	48725662	BolC8t52496H	0	-	118	783	948	0.8259494
C8	48728090	48729117	BolC8t52497H	0	-	813	1027	1027	1.0000000
C8	48733465	48737408	BolC8t52498H	0	+	1372	3856	3943	0.9779356
C8	48739909	48742930	BolC8t52499H	0	-	1035	2597	3021	0.8596491
C8	48746333	48749881	BolC8t52500H	0	-	779	3284	3548	0.9255919
C8	48751048	48753443	BolC8t52501H	0	-	2328	2284	2395	0.9536535
C8	48755425	48758825	BolC8t52502H	0	-	1483	3326	3400	0.9782353
C8	48771116	48773975	BolC8t52503H	0	-	709	2592	2859	0.9066107
C8	48781620	48785292	BolC8t52504H	0	-	2304	3375	3672	0.9191176
C8	48786356	48786820	BolC8t52505H	0	+	400	464	464	1.0000000
C8	48787510	48791413	BolC8t52506H	0	-	1508	3680	3903	0.9428645
C8	48792717	48793871	BolC8t52507H	0	-	134	1042	1154	0.9029463
C8	48794854	48802942	BolC8t52508H	0	+	3442	7366	8088	0.9107320
C8	48803768	48805538	BolC8t52509H	0	-	1674	1770	1770	1.0000000
C8	48806133	48808791	BolC8t52510H	0	+	1272	2482	2658	0.9337848
C8	48809287	48811580	BolC8t52511H	0	-	794	2197	2293	0.9581335
C8	48813729	48814161	BolC8t52512H	0	-	489	432	432	1.0000000
C8	48814302	48820471	BolC8t52513H	0	-	1634	4204	6169	0.6814719
C8	48824043	48825189	BolC8t52514H	0	+	172	885	1146	0.7722513
C8	48828622	48829841	BolC8t52515H	0	-	88	518	1219	0.4249385
C8	48830972	48832498	BolC8t52516H	0	+	239	1105	1526	0.7241153
C8	48834493	48836643	BolC8t52517H	0	+	951	2137	2150	0.9939535
C8	48843949	48845828	BolC8t52518H	0	+	213	1686	1879	0.8972858
C8	48846742	48848338	BolC8t52519H	0	+	461	1572	1596	0.9849624
C8	48849240	48853635	BolC8t52520H	0	-	3120	4162	4395	0.9469852
C8	48855069	48856196	BolC8t52521H	0	+	963	1127	1127	1.0000000
C8	48857019	48858114	BolC8t52522H	0	-	667	1095	1095	1.0000000
C8	48859806	48859944	BolC8t52523H	0	+	0	0	138	0.0000000
C8	48867280	48868920	BolC8t52524H	0	+	608	1593	1640	0.9713415
C8	48869954	48871120	BolC8t52525H	0	-	524	1140	1166	0.9777015
C8	48874066	48874456	BolC8t52526H	0	+	83	272	390	0.6974359
C8	48877890	48878121	BolC8t52527H	0	+	12	101	231	0.4372294
C8	48879282	48884584	BolC8t52528H	0	-	1606	5105	5302	0.9628442
C8	48886279	48888294	BolC8t52529H	0	-	511	1952	2015	0.9687345
C8	48889808	48892759	BolC8t52530H	0	+	2444	2946	2951	0.9983057
C8	48893626	48899819	BolC8t52531H	0	-	1935	5682	6193	0.9174875
C8	48900783	48901855	BolC8t52532H	0	-	294	1008	1072	0.9402985
C8	48902503	48903138	BolC8t52533H	0	+	433	635	635	1.0000000
C8	48915826	48917033	BolC8t52534H	0	-	643	1207	1207	1.0000000
C8	48919539	48919791	BolC8t52535H	0	+	17	182	252	0.7222222
C8	48923006	48929824	BolC8t52536H	0	+	1506	5909	6818	0.8666764
C8	48932075	48934079	BolC8t52537H	0	+	241	1588	2004	0.7924151
C8	48935144	48936466	BolC8t52538H	0	+	136	1317	1322	0.9962178
C8	48949725	48950985	BolC8t52539H	0	+	56	826	1260	0.6555555
C8	48952260	48953679	BolC8t52540H	0	+	452	1254	1419	0.8837209
C8	48955631	48958591	BolC8t52541H	0	+	908	2782	2960	0.9398649
C8	48959876	48962187	BolC8t52542H	0	+	1189	2311	2311	1.0000000
C8	48965063	48965687	BolC8t52543H	0	+	123	617	624	0.9887820
C8	48966442	48973165	BolC8t52544H	0	+	685	4545	6723	0.6760375
C8	48974854	48981532	BolC8t52545H	0	+	1069	4542	6678	0.6801438
C8	48989750	48993520	BolC8t52546H	0	+	1711	3666	3770	0.9724138
C8	48995937	48997904	BolC8t52547H	0	+	514	1753	1967	0.8912049
C8	49000951	49002872	BolC8t52548H	0	+	419	1781	1921	0.9271213
C8	49004386	49012396	BolC8t52549H	0	+	1982	6620	8010	0.8264669
C8	49015950	49016830	BolC8t52550H	0	+	115	689	880	0.7829546
C8	49017354	49023717	BolC8t52551H	0	-	5530	6287	6363	0.9880559
C8	49024286	49025718	BolC8t52552H	0	+	1320	1423	1432	0.9937151
C8	49027373	49027841	BolC8t52553H	0	-	121	464	468	0.9914530
C8	49030442	49031887	BolC8t52554H	0	-	462	1396	1445	0.9660900
C8	49037633	49044245	BolC8t52555H	0	-	3204	6568	6612	0.9933454
C8	49045052	49046167	BolC8t52556H	0	-	107	901	1115	0.8080717
C8	49051572	49052611	BolC8t52557H	0	+	986	1039	1039	1.0000000
C8	49053286	49054875	BolC8t52558H	0	-	485	1452	1589	0.9137822
C8	49056391	49058343	BolC8t52559H	0	+	1123	1717	1952	0.8796107
C8	49060460	49063021	BolC8t52560H	0	+	796	2487	2561	0.9711050
C8	49063461	49064320	BolC8t52561H	0	-	744	859	859	1.0000000
C8	49064765	49065077	BolC8t52562H	0	+	149	312	312	1.0000000
C8	49065283	49069710	BolC8t52563H	0	-	394	1975	4427	0.4461260
C8	49085301	49091666	BolC8t52564H	0	+	447	3841	6365	0.6034564
C8	49092441	49099491	BolC8t52565H	0	-	10406	5828	7050	0.8266667
C8	49101140	49101732	BolC8t52566H	0	-	17	347	592	0.5861486
C8	49102885	49103450	BolC8t52567H	0	+	75	555	565	0.9823009
C8	49103709	49104419	BolC8t52568H	0	-	142	124	710	0.1746479
C8	49105366	49106136	BolC8t52569H	0	+	266	757	770	0.9831169
C8	49113737	49113899	BolC8t52570H	0	+	17	83	162	0.5123457
C8	49117584	49119590	BolC8t52571H	0	+	160	1532	2006	0.7637089
C8	49120949	49121117	BolC8t52572H	0	+	230	168	168	1.0000000
C8	49223198	49225356	BolC8t52573H	0	+	154	1532	2158	0.7099166
C8	49227570	49229576	BolC8t52574H	0	+	191	1226	2006	0.6111665
C8	49229780	49244461	BolC8t52575H	0	-	2082	7599	14681	0.5176078
C8	49237733	49241575	BolC8t52576H	0	-	510	2837	3842	0.7384175
C8	49245029	49247093	BolC8t52577H	0	-	601	1715	2064	0.8309109
C8	49247840	49249533	BolC8t52578H	0	-	992	1524	1693	0.9001772
C8	49253133	49256130	BolC8t52579H	0	+	1129	2045	2997	0.6823490
C8	49258149	49260249	BolC8t52580H	0	+	469	1863	2100	0.8871428
C8	49260824	49264519	BolC8t52581H	0	-	1901	3196	3695	0.8649526
C8	49269000	49269330	BolC8t52582H	0	+	1	79	330	0.2393939
C8	49271957	49274078	BolC8t52583H	0	+	1489	2061	2121	0.9717115
C8	49274315	49274960	BolC8t52584H	0	-	309	645	645	1.0000000
C8	49276328	49277532	BolC8t52585H	0	+	301	888	1204	0.7375416
C8	49287838	49289757	BolC8t52586H	0	+	1044	1738	1919	0.9056801
C8	49291924	49294360	BolC8t52587H	0	-	2016	2123	2436	0.8715107
C8	49295131	49295862	BolC8t52588H	0	-	167	686	731	0.9384405
C8	49296209	49298387	BolC8t52589H	0	-	96	1421	2178	0.6524334
C8	49298817	49299336	BolC8t52590H	0	-	43	491	519	0.9460501
C8	49299341	49318511	BolC8t52591H	0	-	2702	10470	19170	0.5461659
C8	49318950	49320116	BolC8t52592H	0	-	564	1166	1166	1.0000000
C8	49320659	49321700	BolC8t52593H	0	+	130	1039	1041	0.9980788
C8	49323143	49323536	BolC8t52594H	0	+	653	393	393	1.0000000
C8	49324791	49326622	BolC8t52595H	0	+	1783	1750	1831	0.9557618
C8	49327163	49329753	BolC8t52596H	0	-	1554	2470	2590	0.9536679
C8	49337393	49338028	BolC8t52597H	0	-	59	583	635	0.9181103
C8	49339262	49340951	BolC8t52598H	0	-	75	1057	1689	0.6258141
C8	49343409	49346546	BolC8t52599H	0	+	68	913	3137	0.2910424
C8	49349238	49349973	BolC8t52600H	0	+	40	488	735	0.6639456
C8	49350949	49351813	BolC8t52601H	0	-	4	191	864	0.2210648
C8	49354238	49355663	BolC8t52602H	0	-	566	1425	1425	1.0000000
C8	49357999	49359978	BolC8t52603H	0	+	1631	1951	1979	0.9858515
C8	49360332	49361597	BolC8t52604H	0	-	997	1055	1265	0.8339921
C8	49366988	49370448	BolC8t52605H	0	+	2394	3437	3460	0.9933526
C8	49372109	49373571	BolC8t52606H	0	+	446	954	1462	0.6525308
C8	49375341	49375823	BolC8t52607H	0	+	408	457	482	0.9481328
C8	49385348	49386325	BolC8t52608H	0	+	5	28	977	0.0286592
C8	49387462	49392611	BolC8t52609H	0	+	2982	4521	5149	0.8780346
C8	49395458	49397144	BolC8t52610H	0	-	295	1330	1686	0.7888494
C8	49401312	49401909	BolC8t52611H	0	+	29	325	597	0.5443886
C8	49403323	49405012	BolC8t52612H	0	-	900	1645	1689	0.9739491
C8	49405456	49407491	BolC8t52613H	0	-	504	1413	2035	0.6943489
C8	49407606	49408793	BolC8t52614H	0	-	479	1187	1187	1.0000000
C8	49411891	49412395	BolC8t52615H	0	+	9	66	504	0.1309524
C8	49417634	49418675	BolC8t52616H	0	-	263	593	1041	0.5696446
C8	49419480	49419930	BolC8t52617H	0	-	59	369	450	0.8200000
C8	49420736	49421318	BolC8t52618H	0	-	406	522	582	0.8969072
C8	49423814	49424720	BolC8t52619H	0	+	289	874	906	0.9646799
C8	49425250	49425738	BolC8t52620H	0	-	195	488	488	1.0000000
C8	49426353	49428112	BolC8t52621H	0	-	957	1613	1759	0.9169983
C8	49428731	49433622	BolC8t52622H	0	+	1064	2133	4891	0.4361071
C8	49434701	49436993	BolC8t52623H	0	+	359	1765	2292	0.7700698
C8	49440211	49442051	BolC8t52624H	0	-	1173	1771	1840	0.9625000
C8	49443771	49445440	BolC8t52625H	0	-	663	1450	1669	0.8687837
C8	49446813	49447113	BolC8t52626H	0	-	117	300	300	1.0000000
C8	49448286	49451247	BolC8t52627H	0	+	1967	2869	2961	0.9689294
C8	49451525	49452705	BolC8t52628H	0	-	996	1180	1180	1.0000000
C8	49455588	49455762	BolC8t52629H	0	+	0	0	174	0.0000000
C8	49455854	49458638	BolC8t52630H	0	-	1547	2686	2784	0.9647989
C8	49459971	49462029	BolC8t52631H	0	-	931	1993	2058	0.9684159
C8	49462970	49468936	BolC8t52632H	0	+	1562	4452	5966	0.7462286
C8	49471694	49473284	BolC8t52633H	0	+	542	1285	1590	0.8081761
C8	49473602	49475009	BolC8t52634H	0	-	270	1194	1407	0.8486141
C8	49475617	49477383	BolC8t52635H	0	-	584	936	1766	0.5300113
C8	49481285	49482027	BolC8t52636H	0	-	22	549	742	0.7398922
C8	49482328	49482852	BolC8t52637H	0	-	0	0	524	0.0000000
C8	49483278	49483615	BolC8t52638H	0	+	0	0	337	0.0000000
C8	49485581	49487388	BolC8t52639H	0	-	462	1461	1807	0.8085224
C8	49488392	49494772	BolC8t52640H	0	+	2793	5578	6380	0.8742947
C8	49495278	49496775	BolC8t52641H	0	+	451	1432	1497	0.9565798
C8	49497431	49498830	BolC8t52642H	0	+	309	1003	1399	0.7169407
C8	49499036	49499255	BolC8t52643H	0	-	132	133	219	0.6073059
C8	49500006	49500530	BolC8t52644H	0	+	549	524	524	1.0000000
C8	49501459	49512571	BolC8t52645H	0	-	3775	8159	11112	0.7342513
C8	49516752	49517856	BolC8t52646H	0	-	14	250	1104	0.2264493
C8	49518348	49518897	BolC8t52647H	0	-	0	0	549	0.0000000
C8	49528234	49529338	BolC8t52648H	0	-	35	350	1104	0.3170290
C8	49530109	49530675	BolC8t52649H	0	+	423	554	566	0.9787986
C8	49532396	49532911	BolC8t52650H	0	+	110	432	515	0.8388349
C8	49533244	49533651	BolC8t52651H	0	-	22	168	407	0.4127764
C8	49536587	49537199	BolC8t52652H	0	-	817	594	612	0.9705882
C8	49537928	49538769	BolC8t52653H	0	+	321	632	841	0.7514863
C8	49539899	49540673	BolC8t52654H	0	-	126	671	774	0.8669251
C8	49541806	49543881	BolC8t52655H	0	+	102	1087	2075	0.5238554
C8	49544350	49545117	BolC8t52656H	0	-	1071	767	767	1.0000000
C8	49545409	49550961	BolC8t52657H	0	+	4580	5039	5552	0.9076009
C8	49552128	49554477	BolC8t52658H	0	-	529	1513	2349	0.6441039
C8	49555953	49559779	BolC8t52659H	0	-	25	208	3826	0.0543649
C8	49567634	49569350	BolC8t52660H	0	-	841	1657	1716	0.9656177
C8	49575213	49575900	BolC8t52661H	0	-	61	459	687	0.6681223
C8	49580455	49581028	BolC8t52662H	0	-	124	445	573	0.7766143
C8	49585469	49585574	BolC8t52663H	0	-	22	70	105	0.6666667
C8	49591778	49593488	BolC8t52664H	0	+	496	1604	1710	0.9380117
C8	49594966	49595179	BolC8t52665H	0	+	12	157	213	0.7370892
C8	49597273	49599196	BolC8t52666H	0	+	1907	1858	1923	0.9661986
C8	49599478	49601028	BolC8t52667H	0	-	829	1533	1550	0.9890323
C8	49603159	49603306	BolC8t52668H	0	+	8	72	147	0.4897959
C8	49603870	49607307	BolC8t52669H	0	-	384	1969	3437	0.5728833
C8	49608469	49611645	BolC8t52670H	0	-	953	2463	3176	0.7755038
C8	49615946	49616908	BolC8t52671H	0	+	757	962	962	1.0000000
C8	49617170	49618312	BolC8t52672H	0	-	1162	784	1142	0.6865149
C8	49620367	49621631	BolC8t52673H	0	+	0	0	1264	0.0000000
C8	49623915	49624191	BolC8t52674H	0	-	163	220	276	0.7971014
C8	49627362	49627638	BolC8t52675H	0	+	23	148	276	0.5362319
C8	49629862	49630183	BolC8t52676H	0	-	2	133	321	0.4143302
C8	49632144	49637586	BolC8t52677H	0	+	2057	4238	5442	0.7787578
C8	49638770	49640472	BolC8t52678H	0	+	1372	1670	1702	0.9811986
C8	49642658	49644349	BolC8t52679H	0	+	966	1661	1691	0.9822590
C8	49645427	49650935	BolC8t52680H	0	+	1565	5220	5508	0.9477124
C8	49651203	49656004	BolC8t52681H	0	-	487	2900	4801	0.6040408
C8	49657310	49659699	BolC8t52682H	0	-	1693	2362	2389	0.9886982
C8	49662073	49662597	BolC8t52683H	0	+	241	472	524	0.9007633
C8	49664007	49667011	BolC8t52684H	0	+	700	2328	3004	0.7749667
C8	49667181	49673888	BolC8t52685H	0	-	1440	5263	6707	0.7847025
C8	49674457	49676070	BolC8t52686H	0	-	372	1114	1613	0.6906385
C8	49677809	49681593	BolC8t52687H	0	-	1788	2262	3784	0.5977801
C8	49682295	49682808	BolC8t52688H	0	+	0	0	513	0.0000000
C8	49683229	49684398	BolC8t52689H	0	-	2	45	1169	0.0384944
C8	49690944	49692373	BolC8t52690H	0	-	277	1344	1429	0.9405178
C8	49692634	49693531	BolC8t52691H	0	+	364	704	897	0.7848384
C8	49694670	49699993	BolC8t52692H	0	-	232	2536	5323	0.4764231
C8	49701212	49701914	BolC8t52693H	0	+	154	702	702	1.0000000
C8	49702971	49704879	BolC8t52694H	0	-	825	1833	1908	0.9606918
C8	49706525	49707428	BolC8t52695H	0	+	199	743	903	0.8228129
C8	49708573	49710512	BolC8t52696H	0	-	682	1392	1939	0.7178958
C8	49713461	49725179	BolC8t52697H	0	+	1171	4138	11718	0.3531319
C8	49716861	49717516	BolC8t52698H	0	+	0	0	655	0.0000000
C8	49725625	49726802	BolC8t52699H	0	-	383	1027	1177	0.8725573
C8	49727884	49728232	BolC8t52700H	0	+	46	180	348	0.5172414
C8	49732208	49732949	BolC8t52701H	0	+	97	621	741	0.8380567
C8	49733433	49733610	BolC8t52702H	0	+	0	0	177	0.0000000
C8	49741426	49744331	BolC8t52703H	0	+	1080	2722	2905	0.9370052
C8	49746510	49748735	BolC8t52704H	0	-	1483	2112	2225	0.9492135
C8	49749822	49752848	BolC8t52705H	0	+	2424	2322	3026	0.7673497
C8	49753299	49755462	BolC8t52706H	0	-	802	1836	2163	0.8488211
C8	49761519	49764748	BolC8t52707H	0	+	703	1707	3229	0.5286466
C8	49765827	49768452	BolC8t52708H	0	+	1253	2197	2625	0.8369524
C8	49769204	49770650	BolC8t52709H	0	+	121	955	1446	0.6604426
C8	49772231	49781167	BolC8t52710H	0	+	1071	3608	8936	0.4037601
C8	49781934	49784267	BolC8t52711H	0	+	2913	2172	2333	0.9309902
C8	49785083	49787396	BolC8t52712H	0	+	1552	1998	2313	0.8638132
C8	49787831	49789303	BolC8t52713H	0	-	503	954	1472	0.6480978
C8	49797153	49805371	BolC8t52714H	0	+	508	2313	8218	0.2814553
C8	49806357	49807557	BolC8t52715H	0	-	3	206	1200	0.1716667
C8	49811159	49815011	BolC8t52716H	0	+	1828	3684	3852	0.9563863
C8	49815951	49816523	BolC8t52717H	0	-	15	323	572	0.5646853
C8	49821320	49822646	BolC8t52718H	0	+	53	648	1326	0.4886878
C8	49830870	49834290	BolC8t52719H	0	+	382	1382	3420	0.4040936
C8	49831508	49832927	BolC8t52720H	0	-	14	27	1419	0.0190275
C8	49835232	49836704	BolC8t52721H	0	-	149	1073	1472	0.7289402
C8	49851409	49851870	BolC8t52722H	0	+	18	234	461	0.5075922
C8	49853017	49853738	BolC8t52723H	0	+	192	525	721	0.7281553
C8	49853998	49857233	BolC8t52724H	0	-	486	2818	3235	0.8710974
C8	49862056	49863282	BolC8t52725H	0	+	752	1226	1226	1.0000000
C8	49865083	49868051	BolC8t52726H	0	+	1650	2713	2968	0.9140835
C8	49869121	49870318	BolC8t52727H	0	+	4503	1178	1197	0.9841270
C8	49873073	49880946	BolC8t52728H	0	+	787	4495	7873	0.5709386
C8	49877341	49878061	BolC8t52729H	0	+	5	69	720	0.0958333
C8	49878696	49879099	BolC8t52730H	0	+	187	308	403	0.7642680
C8	49894172	49911902	BolC8t52731H	0	+	3502	9879	17730	0.5571912
C8	49895157	49896521	BolC8t52732H	0	+	17	581	1364	0.4259531
C8	49914511	49916963	BolC8t52733H	0	+	485	2099	2452	0.8560359
C8	49917976	49918543	BolC8t52734H	0	+	491	551	567	0.9717813
C8	49925579	49927437	BolC8t52735H	0	+	112	1256	1858	0.6759957
C8	49928900	49931599	BolC8t52736H	0	+	801	2278	2699	0.8440163
C8	49933832	49935419	BolC8t52737H	0	-	11	540	1587	0.3402646
C8	49936733	49938045	BolC8t52738H	0	+	68	840	1312	0.6402439
C8	49945084	49948660	BolC8t52739H	0	+	113	1596	3576	0.4463087
C8	49952086	49952959	BolC8t52740H	0	-	122	548	873	0.6277205
C8	49953789	49954431	BolC8t52741H	0	+	96	631	642	0.9828660
C8	49956191	49956605	BolC8t52742H	0	+	29	229	414	0.5531401
C8	49956933	49957637	BolC8t52743H	0	+	91	489	704	0.6946023
C8	49960283	49962022	BolC8t52744H	0	-	93	1050	1739	0.6037953
C8	49970052	49972020	BolC8t52745H	0	+	2251	1603	1968	0.8145325
C8	49972274	49973120	BolC8t52746H	0	-	584	717	846	0.8475177
C8	49975060	49977352	BolC8t52747H	0	-	1617	2161	2292	0.9428447
C8	49979205	49981406	BolC8t52748H	0	-	673	1562	2201	0.7096774
C8	49982527	49983158	BolC8t52749H	0	+	0	0	631	0.0000000
C8	49987840	49989124	BolC8t52750H	0	+	220	1093	1284	0.8512461
C8	49990122	49991605	BolC8t52751H	0	-	255	1135	1483	0.7653405
C8	49992299	49996256	BolC8t52752H	0	+	1363	3221	3957	0.8140005
C8	49997018	49998011	BolC8t52753H	0	-	22	381	993	0.3836858
C8	49999192	49999879	BolC8t52754H	0	-	202	628	687	0.9141194
C8	50010260	50010728	BolC8t52755H	0	-	47	366	468	0.7820513
C8	50015471	50018414	BolC8t52756H	0	-	711	2581	2943	0.8769963
C8	50023416	50023824	BolC8t52757H	0	-	0	0	408	0.0000000
C8	50032336	50033440	BolC8t52758H	0	+	229	856	1104	0.7753623
C8	50034260	50037775	BolC8t52759H	0	-	315	778	3515	0.2213371
C8	50045081	50046219	BolC8t52760H	0	+	28	420	1138	0.3690685
C8	50047084	50049031	BolC8t52761H	0	-	644	1342	1947	0.6892655
C8	50050413	50052183	BolC8t52762H	0	+	4	45	1770	0.0254237
C8	50065726	50065920	BolC8t52763H	0	+	5	24	194	0.1237113
C8	50069738	50074273	BolC8t52764H	0	+	1165	3891	4535	0.8579934
C8	50075242	50076114	BolC8t52765H	0	+	279	740	872	0.8486239
C8	50078378	50080268	BolC8t52766H	0	-	263	1190	1890	0.6296296
C8	50088624	50089654	BolC8t52767H	0	+	240	1023	1030	0.9932039
C8	50090139	50094805	BolC8t52768H	0	-	3434	4348	4666	0.9318474
C8	50096398	50096503	BolC8t52769H	0	+	124	105	105	1.0000000
C8	50099058	50100531	BolC8t52770H	0	-	96	1030	1473	0.6992532
C8	50107925	50110008	BolC8t52771H	0	-	511	1754	2083	0.8420547
C8	50110938	50118918	BolC8t52772H	0	-	3156	6552	7980	0.8210526
C8	50121956	50124890	BolC8t52773H	0	+	1049	2617	2934	0.8919564
C8	50125980	50129647	BolC8t52774H	0	+	2005	3533	3667	0.9634579
C8	50130043	50131709	BolC8t52775H	0	-	128	1399	1666	0.8397359
C8	50132101	50134438	BolC8t52776H	0	+	862	1993	2337	0.8528028
C8	50136491	50137873	BolC8t52777H	0	+	182	1006	1382	0.7279305
C8	50138053	50143352	BolC8t52778H	0	-	2687	5053	5299	0.9535761
C8	50143709	50148183	BolC8t52779H	0	+	751	3718	4474	0.8310237
C8	50150604	50151072	BolC8t52780H	0	+	32	40	468	0.0854701
C8	50152269	50153060	BolC8t52781H	0	+	77	701	791	0.8862200
C8	50153859	50156393	BolC8t52782H	0	+	1105	2074	2534	0.8184688
C8	50157026	50159590	BolC8t52783H	0	-	1019	2241	2564	0.8740250
C8	50162483	50166954	BolC8t52784H	0	-	2662	3836	4471	0.8579736
C8	50168051	50168595	BolC8t52785H	0	-	742	526	544	0.9669118
C8	50175636	50176950	BolC8t52786H	0	-	80	239	1314	0.1818874
C8	50182791	50186571	BolC8t52787H	0	-	670	2869	3780	0.7589947
C8	50188206	50189847	BolC8t52788H	0	+	1225	1616	1641	0.9847654
C8	50191787	50192252	BolC8t52789H	0	+	236	465	465	1.0000000
C8	50203505	50205642	BolC8t52790H	0	+	240	1575	2137	0.7370145
C8	50224802	50228189	BolC8t52791H	0	+	2397	3088	3387	0.9117213
C8	50229242	50230785	BolC8t52792H	0	+	695	1471	1543	0.9533377
C8	50232382	50240371	BolC8t52793H	0	-	3757	7039	7989	0.8810865
C8	50243920	50244430	BolC8t52794H	0	+	98	304	510	0.5960785
C8	50245017	50247145	BolC8t52795H	0	-	824	1912	2128	0.8984963
C8	50247393	50248421	BolC8t52796H	0	+	299	918	1028	0.8929961
C8	50248889	50249357	BolC8t52797H	0	+	436	468	468	1.0000000
C8	50250488	50250821	BolC8t52798H	0	+	110	223	333	0.6696697
C8	50251193	50251893	BolC8t52799H	0	+	257	684	700	0.9771429
C8	50256507	50258323	BolC8t52800H	0	+	1665	1631	1816	0.8981277
C8	50259403	50261172	BolC8t52801H	0	+	1729	1725	1769	0.9751272
C8	50263665	50263842	BolC8t52802H	0	+	198	147	177	0.8305085
C8	50264653	50267689	BolC8t52803H	0	-	2270	2698	3036	0.8886693
C8	50268767	50271229	BolC8t52804H	0	+	1567	2271	2462	0.9224208
C8	50274200	50275091	BolC8t52805H	0	+	848	891	891	1.0000000
C8	50275723	50276572	BolC8t52806H	0	-	422	456	849	0.5371025
C8	50276860	50278516	BolC8t52807H	0	+	265	1386	1656	0.8369565
C8	50278675	50285068	BolC8t52808H	0	-	2452	6080	6393	0.9510402
C8	50297799	50298357	BolC8t52809H	0	+	26	347	558	0.6218638
C8	50304527	50318186	BolC8t52810H	0	+	259	3466	13659	0.2537521
C8	50318975	50320637	BolC8t52811H	0	+	117	1140	1662	0.6859206
C8	50320876	50323226	BolC8t52812H	0	-	677	1638	2350	0.6970213
C8	50330417	50331524	BolC8t52813H	0	-	1653	1107	1107	1.0000000
C8	50342423	50343981	BolC8t52814H	0	+	628	952	1558	0.6110398
C8	50351028	50351379	BolC8t52815H	0	+	9	4	351	0.0113960
C8	50357748	50358057	BolC8t52816H	0	+	7	188	309	0.6084142
C8	50359604	50362850	BolC8t52817H	0	-	1686	2816	3246	0.8675293
C8	50364735	50368487	BolC8t52818H	0	+	2903	3598	3752	0.9589552
C8	50368906	50373314	BolC8t52819H	0	+	1454	3672	4408	0.8330309
C8	50373806	50377127	BolC8t52820H	0	-	1819	2855	3321	0.8596808
C8	50380758	50380875	BolC8t52821H	0	-	152	117	117	1.0000000
C8	50386384	50387717	BolC8t52822H	0	+	251	1151	1333	0.8634658
C8	50388055	50388207	BolC8t52823H	0	+	21	38	152	0.2500000
C8	50400766	50401178	BolC8t52824H	0	-	325	412	412	1.0000000
C8	50403696	50405296	BolC8t52825H	0	-	1123	1487	1600	0.9293750
C8	50408193	50408746	BolC8t52826H	0	+	594	553	553	1.0000000
C8	50409035	50409551	BolC8t52827H	0	-	48	464	516	0.8992248
C8	50412554	50415461	BolC8t52828H	0	+	401	2281	2907	0.7846577
C8	50420469	50422093	BolC8t52829H	0	+	53	913	1624	0.5621921
C8	50423718	50424795	BolC8t52830H	0	+	426	1043	1077	0.9684308
C8	50426020	50427352	BolC8t52831H	0	-	814	1332	1332	1.0000000
C8	50427850	50429870	BolC8t52832H	0	+	1632	2020	2020	1.0000000
C8	50430412	50431501	BolC8t52833H	0	-	526	1035	1089	0.9504132
C8	50434883	50435426	BolC8t52834H	0	+	237	425	543	0.7826887
C8	50437561	50439833	BolC8t52835H	0	+	1391	2174	2272	0.9568662
C8	50441389	50445592	BolC8t52836H	0	-	559	3223	4203	0.7668332
C8	50473560	50473841	BolC8t52837H	0	-	0	0	281	0.0000000
C8	50480147	50481091	BolC8t52838H	0	-	225	498	944	0.5275424
C8	50483186	50483635	BolC8t52839H	0	+	549	449	449	1.0000000
C8	50484716	50485978	BolC8t52840H	0	+	40	767	1262	0.6077654
C8	50491668	50494133	BolC8t52841H	0	+	41	256	2465	0.1038540
C8	50494948	50496394	BolC8t52842H	0	+	51	225	1446	0.1556017
C8	50501436	50501859	BolC8t52843H	0	+	20	137	423	0.3238771
C8	50502746	50503651	BolC8t52844H	0	+	251	613	905	0.6773481
C8	50503832	50505262	BolC8t52845H	0	-	793	1261	1430	0.8818182
C8	50505840	50506275	BolC8t52846H	0	+	212	429	435	0.9862069
C8	50508308	50508680	BolC8t52847H	0	+	245	372	372	1.0000000
C8	50513191	50514025	BolC8t52848H	0	-	33	537	834	0.6438849
C8	50518536	50518749	BolC8t52849H	0	+	76	114	213	0.5352113
C8	50518956	50519158	BolC8t52850H	0	-	1	13	202	0.0643564
C8	50523053	50524924	BolC8t52851H	0	+	778	1730	1871	0.9246392
C8	50525363	50525465	BolC8t52852H	0	+	297	102	102	1.0000000
C8	50529437	50530917	BolC8t52853H	0	+	438	1423	1480	0.9614865
C8	50533067	50537924	BolC8t52854H	0	+	1422	4411	4857	0.9081738
C8	50539862	50540971	BolC8t52855H	0	+	1347	1109	1109	1.0000000
C8	50547781	50548807	BolC8t52856H	0	+	844	1026	1026	1.0000000
C8	50549764	50550988	BolC8t52857H	0	-	965	1224	1224	1.0000000
C8	50551869	50554535	BolC8t52858H	0	-	443	1519	2666	0.5697674
C8	50570846	50571974	BolC8t52859H	0	+	76	102	1128	0.0904255
C8	50573025	50576753	BolC8t52860H	0	-	918	2374	3728	0.6368026
C8	50577114	50578626	BolC8t52861H	0	-	279	1325	1512	0.8763227
C8	50579374	50580056	BolC8t52862H	0	-	641	682	682	1.0000000
C8	50581362	50582949	BolC8t52863H	0	-	98	961	1587	0.6055450
C8	50583190	50584477	BolC8t52864H	0	+	129	484	1287	0.3760684
C8	50594461	50597577	BolC8t52865H	0	-	133	1058	3116	0.3395379
C8	50600250	50600565	BolC8t52866H	0	+	258	315	315	1.0000000
C8	50600461	50600851	BolC8t52867H	0	-	271	390	390	1.0000000
C8	50601053	50602294	BolC8t52868H	0	+	372	935	1241	0.7534246
C8	50609203	50610912	BolC8t52869H	0	-	230	1078	1709	0.6307783
C8	50616273	50624018	BolC8t52870H	0	+	1659	4366	7745	0.5637186
C8	50624409	50628165	BolC8t52871H	0	+	1264	3560	3756	0.9478168
C8	50628622	50629700	BolC8t52872H	0	+	403	978	1078	0.9072356
C8	50629950	50631051	BolC8t52873H	0	+	505	1090	1101	0.9900091
C8	50632469	50633486	BolC8t52874H	0	+	540	1017	1017	1.0000000
C8	50636086	50636644	BolC8t52875H	0	-	207	513	558	0.9193549
C8	50640098	50640401	BolC8t52876H	0	+	3	51	303	0.1683168
C8	50641585	50642557	BolC8t52877H	0	+	265	892	972	0.9176955
C8	50643187	50643919	BolC8t52878H	0	+	63	656	732	0.8961748
C8	50645644	50646949	BolC8t52879H	0	+	1116	1305	1305	1.0000000
C8	50650294	50650758	BolC8t52880H	0	+	196	446	464	0.9612069
C8	50653109	50653814	BolC8t52881H	0	-	941	705	705	1.0000000
C8	50664574	50665945	BolC8t52882H	0	-	728	1371	1371	1.0000000
C8	50674461	50675450	BolC8t52883H	0	+	388	989	989	1.0000000
C8	50677345	50679333	BolC8t52884H	0	+	1084	1988	1988	1.0000000
C8	50681612	50685495	BolC8t52885H	0	+	1303	3080	3883	0.7932011
C8	50687383	50690473	BolC8t52886H	0	+	2495	2586	3090	0.8368932
C8	50693224	50695179	BolC8t52887H	0	+	512	1679	1955	0.8588235
C8	50695924	50698395	BolC8t52888H	0	-	713	2135	2471	0.8640227
C8	50703959	50704496	BolC8t52889H	0	-	303	537	537	1.0000000
C8	50705777	50706262	BolC8t52890H	0	-	426	485	485	1.0000000
C8	50709206	50709416	BolC8t52891H	0	-	3	142	210	0.6761905
C8	50711210	50712711	BolC8t52892H	0	+	911	1501	1501	1.0000000
C8	50714635	50717819	BolC8t52893H	0	-	1617	3184	3184	1.0000000
C8	50721160	50721334	BolC8t52894H	0	+	5	97	174	0.5574713
C8	50724014	50724284	BolC8t52895H	0	+	21	225	270	0.8333333
C8	50728923	50730609	BolC8t52896H	0	+	456	1658	1686	0.9833927
C8	50731056	50732972	BolC8t52897H	0	+	1192	1916	1916	1.0000000
C8	50738939	50742273	BolC8t52898H	0	+	1735	3328	3334	0.9982004
C8	50743010	50744166	BolC8t52899H	0	+	236	1098	1156	0.9498270
C8	50744442	50745014	BolC8t52900H	0	+	715	572	572	1.0000000
C8	50745030	50750559	BolC8t52901H	0	+	1733	4950	5529	0.8952794
C8	50772646	50776630	BolC8t52902H	0	-	2184	3860	3984	0.9688755
C8	50777027	50779384	BolC8t52903H	0	-	924	2312	2357	0.9809079
C8	50779818	50780510	BolC8t52904H	0	-	296	692	692	1.0000000
C8	50780948	50782663	BolC8t52905H	0	-	816	1715	1715	1.0000000
C8	50782922	50786173	BolC8t52906H	0	+	1668	3251	3251	1.0000000
C8	50786566	50789198	BolC8t52907H	0	-	904	2534	2632	0.9627659
C8	50789388	50790644	BolC8t52908H	0	+	735	1256	1256	1.0000000
C8	50791271	50795437	BolC8t52909H	0	+	1069	4027	4166	0.9666347
C8	50795899	50802501	BolC8t52910H	0	-	421	2911	6602	0.4409270
C8	50803246	50803473	BolC8t52911H	0	+	138	227	227	1.0000000
C8	50804261	50808395	BolC8t52912H	0	+	1651	3912	4134	0.9462990
C8	50811597	50812374	BolC8t52913H	0	-	245	777	777	1.0000000
C8	50816536	50818245	BolC8t52914H	0	+	725	1569	1709	0.9180807
C8	50824868	50825378	BolC8t52915H	0	-	24	433	510	0.8490196
C8	50838841	50851729	BolC8t52916H	0	+	2041	9493	12888	0.7365767
C8	50858003	50858435	BolC8t52917H	0	-	287	432	432	1.0000000
C8	50859444	50860089	BolC8t52918H	0	-	0	0	645	0.0000000
C8	50861439	50862066	BolC8t52919H	0	-	0	0	627	0.0000000
C8	50862681	50864763	BolC8t52920H	0	+	116	256	2082	0.1229587
C8	50868920	50870786	BolC8t52921H	0	+	1	20	1866	0.0107181
C8	50871179	50871800	BolC8t52922H	0	-	0	0	621	0.0000000
C8	50872748	50873249	BolC8t52923H	0	+	91	479	501	0.9560878
C8	50874327	50875521	BolC8t52924H	0	-	979	1194	1194	1.0000000
C8	50875832	50878712	BolC8t52925H	0	+	928	2141	2880	0.7434028
C8	50879521	50881195	BolC8t52926H	0	-	876	1571	1674	0.9384707
C8	50881666	50882474	BolC8t52927H	0	-	227	609	808	0.7537129
C8	50882683	50886297	BolC8t52928H	0	+	1778	3477	3614	0.9620919
C8	50887445	50888010	BolC8t52929H	0	+	762	565	565	1.0000000
C8	50889891	50894227	BolC8t52930H	0	+	1057	3517	4336	0.8111162
C8	50899736	50900255	BolC8t52931H	0	-	537	413	519	0.7957611
C8	50908138	50912991	BolC8t52932H	0	-	102	750	4853	0.1545436
C8	50914772	50915122	BolC8t52933H	0	+	16	196	350	0.5600000
C8	50917019	50917974	BolC8t52934H	0	-	534	911	955	0.9539267
C9	3353	4701	BolC9t52935H	0	-	26	727	1348	0.5393175
C9	6278	7485	BolC9t52936H	0	-	11	286	1207	0.2369511
C9	11396	16072	BolC9t52937H	0	-	1471	4652	4676	0.9948674
C9	16693	19293	BolC9t52938H	0	+	433	2407	2600	0.9257692
C9	19665	21488	BolC9t52939H	0	-	727	1683	1823	0.9232035
C9	22040	23381	BolC9t52940H	0	+	360	1335	1341	0.9955257
C9	26026	30141	BolC9t52941H	0	-	1098	3692	4115	0.8972054
C9	30474	31162	BolC9t52942H	0	+	163	543	688	0.7892442
C9	31385	32119	BolC9t52943H	0	-	733	734	734	1.0000000
C9	34791	36890	BolC9t52944H	0	+	699	2088	2099	0.9947594
C9	45585	46218	BolC9t52945H	0	+	108	455	633	0.7187994
C9	46792	48932	BolC9t52946H	0	+	787	2094	2140	0.9785047
C9	49602	50895	BolC9t52947H	0	-	213	1086	1293	0.8399072
C9	53638	54868	BolC9t52948H	0	-	1154	1206	1230	0.9804878
C9	59041	60709	BolC9t52949H	0	-	418	1388	1668	0.8321343
C9	71324	74161	BolC9t52950H	0	-	755	2302	2837	0.8114205
C9	116317	116880	BolC9t52951H	0	-	642	563	563	1.0000000
C9	117544	119142	BolC9t52952H	0	-	675	1423	1598	0.8904881
C9	123397	124806	BolC9t52953H	0	-	348	1073	1409	0.7615330
C9	126474	127003	BolC9t52954H	0	+	1148	529	529	1.0000000
C9	131095	133133	BolC9t52955H	0	+	337	1534	2038	0.7526987
C9	136569	136683	BolC9t52956H	0	+	92	114	114	1.0000000
C9	136947	138352	BolC9t52957H	0	-	852	1405	1405	1.0000000
C9	138964	142193	BolC9t52958H	0	+	649	2859	3229	0.8854135
C9	143758	145256	BolC9t52959H	0	+	1067	1487	1498	0.9926569
C9	147154	149554	BolC9t52960H	0	+	199	1249	2400	0.5204167
C9	150644	153984	BolC9t52961H	0	+	317	2271	3340	0.6799401
C9	156898	158275	BolC9t52962H	0	+	183	1229	1377	0.8925200
C9	162107	163728	BolC9t52963H	0	-	638	1606	1621	0.9907464
C9	164791	166751	BolC9t52964H	0	+	1122	1960	1960	1.0000000
C9	168131	170713	BolC9t52965H	0	+	1005	2538	2582	0.9829590
C9	172215	174276	BolC9t52966H	0	+	107	1332	2061	0.6462882
C9	174911	175314	BolC9t52967H	0	-	15	56	403	0.1389578
C9	181944	183812	BolC9t52968H	0	+	163	610	1868	0.3265525
C9	184202	187152	BolC9t52969H	0	-	1330	2950	2950	1.0000000
C9	249375	251742	BolC9t52970H	0	-	325	1248	2367	0.5272497
C9	252817	254051	BolC9t52971H	0	-	297	1161	1234	0.9408428
C9	256752	257445	BolC9t52972H	0	-	211	579	693	0.8354979
C9	262668	265528	BolC9t52973H	0	+	212	2231	2860	0.7800699
C9	269019	276871	BolC9t52974H	0	+	333	2870	7852	0.3655120
C9	277482	279370	BolC9t52975H	0	-	227	1683	1888	0.8914195
C9	281279	283340	BolC9t52976H	0	-	397	889	2061	0.4313440
C9	283907	286944	BolC9t52977H	0	-	814	2871	3037	0.9453408
C9	290710	292873	BolC9t52978H	0	+	572	1766	2163	0.8164586
C9	293183	293728	BolC9t52979H	0	+	195	298	545	0.5467890
C9	294792	297183	BolC9t52980H	0	-	1560	2364	2391	0.9887077
C9	301286	303412	BolC9t52981H	0	-	565	1820	2126	0.8560677
C9	304504	308172	BolC9t52982H	0	-	1212	3612	3668	0.9847328
C9	309519	310280	BolC9t52983H	0	-	349	761	761	1.0000000
C9	310767	312781	BolC9t52984H	0	+	621	1993	2014	0.9895730
C9	313151	314542	BolC9t52985H	0	-	396	1391	1391	1.0000000
C9	315841	318333	BolC9t52986H	0	+	1395	2492	2492	1.0000000
C9	319147	322966	BolC9t52987H	0	-	1019	3365	3819	0.8811207
C9	324026	326244	BolC9t52988H	0	+	1509	2218	2218	1.0000000
C9	327322	329999	BolC9t52989H	0	-	1804	2677	2677	1.0000000
C9	331701	335899	BolC9t52990H	0	-	1351	3671	4198	0.8744640
C9	337815	338233	BolC9t52991H	0	+	0	0	418	0.0000000
C9	339507	340458	BolC9t52992H	0	+	5	151	951	0.1587802
C9	344129	346976	BolC9t52993H	0	-	1763	2847	2847	1.0000000
C9	347397	348823	BolC9t52994H	0	+	872	1426	1426	1.0000000
C9	372193	373190	BolC9t52995H	0	+	174	767	997	0.7693079
C9	374225	375203	BolC9t52996H	0	-	137	408	978	0.4171779
C9	376342	377380	BolC9t52997H	0	-	35	152	1038	0.1464355
C9	380310	381306	BolC9t52998H	0	-	329	977	996	0.9809237
C9	384441	386375	BolC9t52999H	0	-	794	1831	1934	0.9467425
C9	388120	391000	BolC9t53000H	0	-	1513	2689	2880	0.9336805
C9	391310	397654	BolC9t53001H	0	+	3723	6308	6344	0.9943253
C9	400500	402129	BolC9t53002H	0	-	1566	1629	1629	1.0000000
C9	403785	404838	BolC9t53003H	0	-	292	821	1053	0.7796771
C9	405504	407970	BolC9t53004H	0	-	612	2146	2466	0.8702352
C9	412181	413310	BolC9t53005H	0	+	394	1129	1129	1.0000000
C9	414034	415119	BolC9t53006H	0	+	169	1032	1085	0.9511521
C9	415525	416547	BolC9t53007H	0	+	695	1022	1022	1.0000000
C9	417344	418375	BolC9t53008H	0	-	521	1014	1031	0.9835111
C9	418899	419231	BolC9t53009H	0	+	168	332	332	1.0000000
C9	420596	428257	BolC9t53010H	0	+	1730	6899	7661	0.9005352
C9	429500	430004	BolC9t53011H	0	+	304	504	504	1.0000000
C9	434006	435127	BolC9t53012H	0	-	675	1109	1121	0.9892952
C9	436847	437753	BolC9t53013H	0	+	16	328	906	0.3620309
C9	472892	474902	BolC9t53014H	0	+	1181	2010	2010	1.0000000
C9	475803	477738	BolC9t53015H	0	-	433	1324	1935	0.6842377
C9	481428	483779	BolC9t53016H	0	+	783	2209	2351	0.9396002
C9	485367	487620	BolC9t53017H	0	+	605	1866	2253	0.8282290
C9	491527	492973	BolC9t53018H	0	+	222	1180	1446	0.8160443
C9	496400	496820	BolC9t53019H	0	+	5	90	420	0.2142857
C9	500005	500466	BolC9t53020H	0	-	284	461	461	1.0000000
C9	503180	506336	BolC9t53021H	0	-	1825	3156	3156	1.0000000
C9	506681	508226	BolC9t53022H	0	+	533	1545	1545	1.0000000
C9	508467	511293	BolC9t53023H	0	+	683	2635	2826	0.9324133
C9	511454	511637	BolC9t53024H	0	-	126	183	183	1.0000000
C9	512711	514434	BolC9t53025H	0	+	819	1723	1723	1.0000000
C9	514975	521268	BolC9t53026H	0	-	3959	6280	6293	0.9979342
C9	523395	524346	BolC9t53027H	0	-	635	951	951	1.0000000
C9	526503	528411	BolC9t53028H	0	+	709	1903	1908	0.9973795
C9	528555	531351	BolC9t53029H	0	-	1881	2796	2796	1.0000000
C9	559568	560682	BolC9t53030H	0	-	220	981	1114	0.8806104
C9	574973	579330	BolC9t53031H	0	+	1689	3981	4357	0.9137021
C9	581553	582453	BolC9t53032H	0	+	265	864	900	0.9600000
C9	586922	588827	BolC9t53033H	0	+	666	1905	1905	1.0000000
C9	589076	590173	BolC9t53034H	0	-	776	1097	1097	1.0000000
C9	594718	599373	BolC9t53035H	0	+	1708	4167	4655	0.8951665
C9	607003	607405	BolC9t53036H	0	+	39	177	402	0.4402985
C9	611449	611780	BolC9t53037H	0	+	288	331	331	1.0000000
C9	612576	614102	BolC9t53038H	0	+	711	1526	1526	1.0000000
C9	614608	616760	BolC9t53039H	0	-	558	2127	2152	0.9883829
C9	618924	619606	BolC9t53040H	0	+	459	682	682	1.0000000
C9	620356	628413	BolC9t53041H	0	+	2162	5815	8057	0.7217327
C9	631280	632701	BolC9t53042H	0	-	355	1334	1421	0.9387755
C9	640599	641295	BolC9t53043H	0	+	75	368	696	0.5287356
C9	658298	660319	BolC9t53044H	0	+	562	1691	2021	0.8367145
C9	677665	679237	BolC9t53045H	0	+	547	1536	1572	0.9770992
C9	683930	684689	BolC9t53046H	0	-	148	428	759	0.5638999
C9	685322	686926	BolC9t53047H	0	+	695	1498	1604	0.9339152
C9	692196	693117	BolC9t53048H	0	+	365	868	921	0.9424539
C9	695103	696580	BolC9t53049H	0	+	1539	1477	1477	1.0000000
C9	715469	717461	BolC9t53050H	0	-	512	1681	1992	0.8438755
C9	725099	726751	BolC9t53051H	0	-	1264	1652	1652	1.0000000
C9	734553	736956	BolC9t53052H	0	-	1612	2217	2403	0.9225968
C9	740097	745012	BolC9t53053H	0	-	3149	4606	4915	0.9371312
C9	748863	751362	BolC9t53054H	0	-	1261	2473	2499	0.9895958
C9	752530	754873	BolC9t53055H	0	+	897	2317	2343	0.9889031
C9	754929	755307	BolC9t53056H	0	-	87	359	378	0.9497355
C9	757366	757604	BolC9t53057H	0	-	318	238	238	1.0000000
C9	759212	760513	BolC9t53058H	0	+	487	1290	1301	0.9915450
C9	761410	763447	BolC9t53059H	0	+	1835	2037	2037	1.0000000
C9	764029	765699	BolC9t53060H	0	-	1217	1670	1670	1.0000000
C9	770761	772954	BolC9t53061H	0	+	1209	1982	2193	0.9037848
C9	801348	804454	BolC9t53062H	0	+	1643	3106	3106	1.0000000
C9	804842	807231	BolC9t53063H	0	-	1192	2389	2389	1.0000000
C9	821308	822514	BolC9t53064H	0	-	20	360	1206	0.2985075
C9	837036	837984	BolC9t53065H	0	+	0	0	948	0.0000000
C9	867089	868459	BolC9t53066H	0	-	382	996	1370	0.7270073
C9	880563	884113	BolC9t53067H	0	+	2271	3512	3550	0.9892958
C9	890846	892592	BolC9t53068H	0	-	334	1591	1746	0.9112257
C9	895105	898060	BolC9t53069H	0	-	837	2750	2955	0.9306260
C9	901182	902761	BolC9t53070H	0	+	670	1475	1579	0.9341356
C9	905101	906283	BolC9t53071H	0	-	63	692	1182	0.5854484
C9	911668	917815	BolC9t53072H	0	-	1415	5144	6147	0.8368310
C9	918380	919576	BolC9t53073H	0	+	639	1196	1196	1.0000000
C9	919991	921545	BolC9t53074H	0	+	1346	1554	1554	1.0000000
C9	932258	933302	BolC9t53075H	0	+	805	1044	1044	1.0000000
C9	933722	933854	BolC9t53076H	0	+	149	132	132	1.0000000
C9	936731	936991	BolC9t53077H	0	+	222	260	260	1.0000000
C9	937316	939177	BolC9t53078H	0	-	782	1861	1861	1.0000000
C9	938275	938599	BolC9t53079H	0	-	250	324	324	1.0000000
C9	942740	943591	BolC9t53080H	0	+	683	851	851	1.0000000
C9	945274	951597	BolC9t53081H	0	+	3376	6323	6323	1.0000000
C9	952107	962554	BolC9t53082H	0	-	7741	10447	10447	1.0000000
C9	958086	958634	BolC9t53083H	0	+	731	548	548	1.0000000
C9	971428	972712	BolC9t53084H	0	+	793	1284	1284	1.0000000
C9	975068	976727	BolC9t53085H	0	+	604	1600	1659	0.9644364
C9	981900	983910	BolC9t53086H	0	-	577	1494	2010	0.7432836
C9	997200	997727	BolC9t53087H	0	-	297	527	527	1.0000000
C9	1000877	1002080	BolC9t53088H	0	-	410	1110	1203	0.9226933
C9	1004096	1007155	BolC9t53089H	0	-	182	2050	3059	0.6701536
C9	1009108	1010179	BolC9t53090H	0	+	609	1071	1071	1.0000000
C9	1011203	1016397	BolC9t53091H	0	+	2921	4893	5194	0.9420485
C9	1017894	1018239	BolC9t53092H	0	-	341	345	345	1.0000000
C9	1019476	1024058	BolC9t53093H	0	+	909	2996	4582	0.6538630
C9	1024342	1024807	BolC9t53094H	0	+	494	465	465	1.0000000
C9	1025098	1027332	BolC9t53095H	0	-	270	1342	2234	0.6007162
C9	1029314	1034161	BolC9t53096H	0	+	1992	4359	4847	0.8993192
C9	1037126	1038020	BolC9t53097H	0	-	314	846	894	0.9463087
C9	1041063	1044391	BolC9t53098H	0	+	1602	2942	3328	0.8840144
C9	1050266	1050374	BolC9t53099H	0	+	7	34	108	0.3148148
C9	1052177	1053897	BolC9t53100H	0	+	125	1059	1720	0.6156977
C9	1056044	1056200	BolC9t53101H	0	-	0	0	156	0.0000000
C9	1058329	1059859	BolC9t53102H	0	-	59	652	1530	0.4261438
C9	1148674	1149232	BolC9t53103H	0	-	11	316	558	0.5663083
C9	1150854	1151415	BolC9t53104H	0	-	7	147	561	0.2620321
C9	1154937	1160505	BolC9t53105H	0	+	4505	5262	5568	0.9450431
C9	1161017	1164269	BolC9t53106H	0	+	988	3108	3252	0.9557195
C9	1177816	1178434	BolC9t53107H	0	+	32	192	618	0.3106796
C9	1182781	1184743	BolC9t53108H	0	+	670	1889	1962	0.9627931
C9	1191098	1193069	BolC9t53109H	0	+	952	1963	1971	0.9959412
C9	1193386	1195302	BolC9t53110H	0	-	830	1768	1916	0.9227557
C9	1196258	1198141	BolC9t53111H	0	+	1228	1879	1883	0.9978758
C9	1199651	1201134	BolC9t53112H	0	-	908	1173	1483	0.7909642
C9	1206670	1207225	BolC9t53113H	0	+	166	554	555	0.9981982
C9	1212258	1217323	BolC9t53114H	0	+	1860	4749	5065	0.9376110
C9	1218509	1224035	BolC9t53115H	0	+	593	3239	5526	0.5861382
C9	1226274	1228807	BolC9t53116H	0	-	305	1888	2533	0.7453612
C9	1234462	1236967	BolC9t53117H	0	-	5	122	2505	0.0487026
C9	1238584	1243020	BolC9t53118H	0	-	378	1887	4436	0.4253832
C9	1270185	1272733	BolC9t53119H	0	+	692	1372	2548	0.5384616
C9	1278594	1280775	BolC9t53120H	0	+	780	1354	2181	0.6208161
C9	1283458	1283584	BolC9t53121H	0	+	7	126	126	1.0000000
C9	1287887	1290242	BolC9t53122H	0	+	448	2068	2355	0.8781316
C9	1290728	1291181	BolC9t53123H	0	+	293	453	453	1.0000000
C9	1291830	1292272	BolC9t53124H	0	-	481	442	442	1.0000000
C9	1293809	1296656	BolC9t53125H	0	+	1174	2790	2847	0.9799789
C9	1301275	1303051	BolC9t53126H	0	+	174	1475	1776	0.8305180
C9	1304684	1306706	BolC9t53127H	0	-	271	1420	2022	0.7022750
C9	1313642	1316472	BolC9t53128H	0	-	560	2348	2830	0.8296820
C9	1317277	1319732	BolC9t53129H	0	+	1677	2083	2455	0.8484725
C9	1320481	1321687	BolC9t53130H	0	+	421	1080	1206	0.8955224
C9	1322444	1327265	BolC9t53131H	0	-	2396	3823	4821	0.7929890
C9	1328892	1335139	BolC9t53132H	0	-	1059	5216	6247	0.8349608
C9	1336521	1338084	BolC9t53133H	0	+	1056	1253	1563	0.8016635
C9	1342823	1344741	BolC9t53134H	0	+	497	1499	1918	0.7815433
C9	1346605	1351512	BolC9t53135H	0	+	875	2140	4907	0.4361117
C9	1352220	1353050	BolC9t53136H	0	-	460	830	830	1.0000000
C9	1354433	1355427	BolC9t53137H	0	-	243	832	994	0.8370221
C9	1360067	1361305	BolC9t53138H	0	-	293	1060	1238	0.8562197
C9	1362790	1366667	BolC9t53139H	0	+	292	2499	3877	0.6445705
C9	1367309	1369284	BolC9t53140H	0	+	1321	1757	1975	0.8896202
C9	1369956	1371906	BolC9t53141H	0	-	1886	1910	1950	0.9794872
C9	1374071	1377259	BolC9t53142H	0	+	1670	2585	3188	0.8108532
C9	1451297	1452708	BolC9t53143H	0	+	236	1255	1411	0.8894401
C9	1452924	1454171	BolC9t53144H	0	-	611	1119	1247	0.8973536
C9	1454639	1456091	BolC9t53145H	0	+	230	977	1452	0.6728650
C9	1458246	1463488	BolC9t53146H	0	+	2016	4527	5242	0.8636017
C9	1465304	1470431	BolC9t53147H	0	+	1295	4136	5127	0.8067096
C9	1470623	1474494	BolC9t53148H	0	-	817	3377	3871	0.8723844
C9	1478329	1478848	BolC9t53149H	0	-	659	519	519	1.0000000
C9	1480491	1481601	BolC9t53150H	0	-	60	758	1110	0.6828829
C9	1482305	1482825	BolC9t53151H	0	-	234	520	520	1.0000000
C9	1484036	1484950	BolC9t53152H	0	-	80	725	914	0.7932166
C9	1486108	1486807	BolC9t53153H	0	+	217	656	699	0.9384835
C9	1487248	1487892	BolC9t53154H	0	-	731	644	644	1.0000000
C9	1496050	1498386	BolC9t53155H	0	+	855	1619	2336	0.6930650
C9	1498808	1500046	BolC9t53156H	0	-	10	411	1238	0.3319871
C9	1503998	1511511	BolC9t53157H	0	-	6342	7513	7513	1.0000000
C9	1523327	1524035	BolC9t53158H	0	+	493	673	708	0.9505650
C9	1526688	1527820	BolC9t53159H	0	+	897	1132	1132	1.0000000
C9	1530396	1531930	BolC9t53160H	0	+	1173	1534	1534	1.0000000
C9	1532344	1533772	BolC9t53161H	0	-	452	1420	1428	0.9943978
C9	1536416	1536545	BolC9t53162H	0	+	17	129	129	1.0000000
C9	1536964	1537165	BolC9t53163H	0	+	1	50	201	0.2487562
C9	1537387	1537546	BolC9t53164H	0	+	0	0	159	0.0000000
C9	1553326	1558809	BolC9t53165H	0	+	2339	4464	5483	0.8141528
C9	1559666	1562147	BolC9t53166H	0	-	581	1744	2481	0.7029424
C9	1572113	1576711	BolC9t53167H	0	+	1474	4224	4598	0.9186603
C9	1577801	1578404	BolC9t53168H	0	+	168	603	603	1.0000000
C9	1578739	1580074	BolC9t53169H	0	+	130	886	1335	0.6636704
C9	1581367	1582486	BolC9t53170H	0	+	407	1093	1119	0.9767650
C9	1582966	1584214	BolC9t53171H	0	+	437	1044	1248	0.8365384
C9	1584551	1586096	BolC9t53172H	0	-	1492	1545	1545	1.0000000
C9	1589997	1591587	BolC9t53173H	0	+	501	1590	1590	1.0000000
C9	1593297	1596407	BolC9t53174H	0	+	708	2843	3110	0.9141479
C9	1599118	1600315	BolC9t53175H	0	+	188	1075	1197	0.8980785
C9	1601732	1606755	BolC9t53176H	0	-	2921	5023	5023	1.0000000
C9	1610290	1612188	BolC9t53177H	0	-	459	1801	1898	0.9488935
C9	1615833	1617230	BolC9t53178H	0	+	562	1359	1397	0.9727989
C9	1618005	1619410	BolC9t53179H	0	+	197	1283	1405	0.9131672
C9	1619944	1624174	BolC9t53180H	0	-	1703	4129	4230	0.9761229
C9	1625816	1627947	BolC9t53181H	0	+	1527	2131	2131	1.0000000
C9	1628397	1630789	BolC9t53182H	0	-	1018	2342	2392	0.9790970
C9	1632234	1634156	BolC9t53183H	0	-	1101	1890	1922	0.9833507
C9	1634430	1635576	BolC9t53184H	0	+	449	1078	1146	0.9406632
C9	1635775	1638662	BolC9t53185H	0	-	1907	2860	2887	0.9906477
C9	1640443	1642306	BolC9t53186H	0	+	602	1754	1863	0.9414922
C9	1642365	1643254	BolC9t53187H	0	-	275	889	889	1.0000000
C9	1648941	1651844	BolC9t53188H	0	-	686	2541	2903	0.8753014
C9	1652983	1657450	BolC9t53189H	0	+	2343	4417	4467	0.9888068
C9	1671787	1673725	BolC9t53190H	0	+	397	1539	1938	0.7941176
C9	1675312	1677463	BolC9t53191H	0	+	245	1801	2151	0.8372850
C9	1678356	1679799	BolC9t53192H	0	-	167	1055	1443	0.7311158
C9	1685043	1686626	BolC9t53193H	0	+	558	1583	1583	1.0000000
C9	1734805	1735282	BolC9t53194H	0	+	27	312	477	0.6540881
C9	1739404	1740795	BolC9t53195H	0	+	820	1391	1391	1.0000000
C9	1744149	1744999	BolC9t53196H	0	-	0	0	850	0.0000000
C9	1746819	1748237	BolC9t53197H	0	+	656	1078	1418	0.7602257
C9	1750591	1752110	BolC9t53198H	0	+	333	881	1519	0.5799868
C9	1756134	1756269	BolC9t53199H	0	-	1	132	135	0.9777778
C9	1759130	1760921	BolC9t53200H	0	-	264	1337	1791	0.7465103
C9	1767070	1784538	BolC9t53201H	0	-	443	5236	17468	0.2997481
C9	1768396	1768708	BolC9t53202H	0	-	9	312	312	1.0000000
C9	1776368	1776678	BolC9t53203H	0	-	0	0	310	0.0000000
C9	1785545	1785855	BolC9t53204H	0	-	0	0	310	0.0000000
C9	1788864	1792774	BolC9t53205H	0	-	1987	3910	3910	1.0000000
C9	1795556	1796223	BolC9t53206H	0	-	550	667	667	1.0000000
C9	1808419	1811282	BolC9t53207H	0	-	1476	2863	2863	1.0000000
C9	1814487	1817618	BolC9t53208H	0	-	849	2886	3131	0.9217502
C9	1830242	1831713	BolC9t53209H	0	+	394	1370	1471	0.9313392
C9	1837770	1840818	BolC9t53210H	0	-	288	2140	3048	0.7020997
C9	1841869	1845396	BolC9t53211H	0	-	1768	3389	3527	0.9608732
C9	1846198	1849287	BolC9t53212H	0	-	558	2391	3089	0.7740369
C9	1850409	1851120	BolC9t53213H	0	-	425	670	711	0.9423347
C9	1863308	1864919	BolC9t53214H	0	-	1032	1372	1611	0.8516449
C9	1869723	1878630	BolC9t53215H	0	+	296	1739	8907	0.1952397
C9	1882080	1887701	BolC9t53216H	0	+	199	2129	5621	0.3787582
C9	1889215	1893829	BolC9t53217H	0	+	2044	4349	4614	0.9425661
C9	1898775	1900478	BolC9t53218H	0	+	142	1179	1703	0.6923077
C9	1904255	1904820	BolC9t53219H	0	-	3	38	565	0.0672566
C9	1914377	1915181	BolC9t53220H	0	-	0	0	804	0.0000000
C9	1916629	1919163	BolC9t53221H	0	-	1	30	2534	0.0118390
C9	1922103	1923789	BolC9t53222H	0	+	788	1494	1686	0.8861210
C9	1923858	1925217	BolC9t53223H	0	-	561	1338	1359	0.9845474
C9	1930355	1935088	BolC9t53224H	0	+	2137	3545	4733	0.7489964
C9	1935534	1940904	BolC9t53225H	0	-	136	832	5370	0.1549348
C9	1941922	1943033	BolC9t53226H	0	-	323	984	1111	0.8856885
C9	1957061	1958270	BolC9t53227H	0	-	1186	1209	1209	1.0000000
C9	1958336	1958690	BolC9t53228H	0	-	273	354	354	1.0000000
C9	1974202	1990592	BolC9t53229H	0	+	4053	12464	16390	0.7604637
C9	1975841	1976496	BolC9t53230H	0	-	50	321	655	0.4900763
C9	1991743	1992088	BolC9t53231H	0	-	7	206	345	0.5971014
C9	1992614	1994396	BolC9t53232H	0	+	597	1755	1782	0.9848485
C9	1995235	1996228	BolC9t53233H	0	-	510	993	993	1.0000000
C9	1997092	1998241	BolC9t53234H	0	-	83	707	1149	0.6153176
C9	2001570	2004597	BolC9t53235H	0	-	1065	3025	3027	0.9993393
C9	2008881	2009398	BolC9t53236H	0	+	60	474	517	0.9168279
C9	2010173	2016304	BolC9t53237H	0	-	807	1889	6131	0.3081063
C9	2017459	2028912	BolC9t53238H	0	-	632	3876	11453	0.3384266
C9	2033551	2034712	BolC9t53239H	0	+	2	198	1161	0.1705426
C9	2040745	2041146	BolC9t53240H	0	+	775	401	401	1.0000000
C9	2044421	2045339	BolC9t53241H	0	+	143	781	918	0.8507625
C9	2047550	2049836	BolC9t53242H	0	+	245	1831	2286	0.8009624
C9	2053708	2054577	BolC9t53243H	0	-	21	346	869	0.3981588
C9	2055729	2056401	BolC9t53244H	0	-	213	591	672	0.8794643
C9	2058579	2061839	BolC9t53245H	0	-	1646	2847	3260	0.8733129
C9	2069178	2070262	BolC9t53246H	0	+	0	0	1084	0.0000000
C9	2085892	2088354	BolC9t53247H	0	+	1378	2246	2462	0.9122664
C9	2115191	2117288	BolC9t53248H	0	-	2	161	2097	0.0767763
C9	2118935	2121426	BolC9t53249H	0	+	200	1793	2491	0.7197912
C9	2123733	2125584	BolC9t53250H	0	+	561	1733	1851	0.9362507
C9	2133445	2134753	BolC9t53251H	0	+	169	1308	1308	1.0000000
C9	2143499	2147248	BolC9t53252H	0	+	1184	3252	3749	0.8674313
C9	2152282	2154253	BolC9t53253H	0	+	240	1695	1971	0.8599696
C9	2168728	2169223	BolC9t53254H	0	+	82	267	495	0.5393940
C9	2171187	2172683	BolC9t53255H	0	+	660	1413	1496	0.9445187
C9	2174679	2175344	BolC9t53256H	0	+	246	629	665	0.9458647
C9	2176091	2176580	BolC9t53257H	0	-	5	92	489	0.1881391
C9	2177670	2178886	BolC9t53258H	0	-	559	1164	1216	0.9572368
C9	2181588	2183712	BolC9t53259H	0	-	732	1571	2124	0.7396422
C9	2187384	2187603	BolC9t53260H	0	-	250	219	219	1.0000000
C9	2192180	2194437	BolC9t53261H	0	+	1242	2201	2257	0.9751883
C9	2195280	2195972	BolC9t53262H	0	+	466	692	692	1.0000000
C9	2196734	2197328	BolC9t53263H	0	+	664	594	594	1.0000000
C9	2197513	2200242	BolC9t53264H	0	-	1134	2671	2729	0.9787468
C9	2200996	2201809	BolC9t53265H	0	-	250	728	813	0.8954490
C9	2203847	2208175	BolC9t53266H	0	-	1654	3884	4328	0.8974122
C9	2209579	2210735	BolC9t53267H	0	-	660	1143	1156	0.9887543
C9	2217885	2219053	BolC9t53268H	0	+	770	1168	1168	1.0000000
C9	2219591	2220652	BolC9t53269H	0	-	287	1061	1061	1.0000000
C9	2221049	2221906	BolC9t53270H	0	+	536	857	857	1.0000000
C9	2223276	2224509	BolC9t53271H	0	+	458	1140	1233	0.9245742
C9	2225075	2227292	BolC9t53272H	0	-	743	2217	2217	1.0000000
C9	2227583	2228654	BolC9t53273H	0	+	0	0	1071	0.0000000
C9	2231080	2232562	BolC9t53274H	0	+	549	1209	1482	0.8157895
C9	2232862	2236593	BolC9t53275H	0	-	1568	2978	3731	0.7981774
C9	2239848	2241543	BolC9t53276H	0	+	557	1637	1695	0.9657817
C9	2243207	2244390	BolC9t53277H	0	-	730	1114	1183	0.9416737
C9	2245716	2248467	BolC9t53278H	0	-	1595	2724	2751	0.9901854
C9	2250781	2252357	BolC9t53279H	0	-	415	1499	1576	0.9511421
C9	2253946	2256421	BolC9t53280H	0	+	967	1945	2475	0.7858586
C9	2257568	2257724	BolC9t53281H	0	-	126	156	156	1.0000000
C9	2260197	2262803	BolC9t53282H	0	+	791	2440	2606	0.9363009
C9	2264472	2266703	BolC9t53283H	0	+	853	1989	2231	0.8915285
C9	2267893	2268494	BolC9t53284H	0	+	188	573	601	0.9534110
C9	2269160	2269562	BolC9t53285H	0	-	154	220	402	0.5472637
C9	2269694	2270737	BolC9t53286H	0	-	567	1043	1043	1.0000000
C9	2271434	2271770	BolC9t53287H	0	-	479	336	336	1.0000000
C9	2272453	2272842	BolC9t53288H	0	+	394	364	389	0.9357327
C9	2275068	2276234	BolC9t53289H	0	-	96	783	1166	0.6715266
C9	2290141	2290537	BolC9t53290H	0	+	7	103	396	0.2601010
C9	2302472	2303358	BolC9t53291H	0	+	286	799	886	0.9018059
C9	2305673	2306780	BolC9t53292H	0	+	337	1021	1107	0.9223126
C9	2308710	2310303	BolC9t53293H	0	+	220	952	1593	0.5976146
C9	2313775	2314400	BolC9t53294H	0	+	25	269	625	0.4304000
C9	2320033	2322300	BolC9t53295H	0	+	261	1438	2267	0.6343185
C9	2327604	2328296	BolC9t53296H	0	+	195	528	692	0.7630058
C9	2328939	2329107	BolC9t53297H	0	+	10	116	168	0.6904762
C9	2335992	2336579	BolC9t53298H	0	-	864	480	587	0.8177172
C9	2349441	2350731	BolC9t53299H	0	-	645	1137	1290	0.8813953
C9	2354068	2355349	BolC9t53300H	0	-	7	226	1281	0.1764247
C9	2364954	2365158	BolC9t53301H	0	+	0	0	204	0.0000000
C9	2370972	2371149	BolC9t53302H	0	+	8	107	177	0.6045198
C9	2392363	2394585	BolC9t53303H	0	+	814	2143	2222	0.9644464
C9	2402711	2405822	BolC9t53304H	0	+	506	2845	3111	0.9144970
C9	2408724	2411169	BolC9t53305H	0	+	652	2249	2445	0.9198364
C9	2418509	2421601	BolC9t53306H	0	+	313	2673	3092	0.8644890
C9	2422601	2423569	BolC9t53307H	0	+	429	968	968	1.0000000
C9	2426381	2427356	BolC9t53308H	0	+	39	538	975	0.5517949
C9	2428877	2429090	BolC9t53309H	0	+	330	213	213	1.0000000
C9	2429918	2430980	BolC9t53310H	0	-	83	878	1062	0.8267420
C9	2436288	2437582	BolC9t53311H	0	+	488	1294	1294	1.0000000
C9	2440113	2442950	BolC9t53312H	0	-	191	1015	2837	0.3577723
C9	2447530	2452886	BolC9t53313H	0	-	1632	4641	5356	0.8665048
C9	2474647	2475332	BolC9t53314H	0	-	122	473	685	0.6905109
C9	2481878	2483633	BolC9t53315H	0	-	465	1563	1755	0.8905983
C9	2484581	2484926	BolC9t53316H	0	+	45	254	345	0.7362319
C9	2488231	2489830	BolC9t53317H	0	+	528	1579	1599	0.9874922
C9	2493018	2494566	BolC9t53318H	0	+	217	1012	1548	0.6537468
C9	2504011	2504341	BolC9t53319H	0	-	91	330	330	1.0000000
C9	2505347	2505637	BolC9t53320H	0	-	1	142	290	0.4896552
C9	2505653	2505913	BolC9t53321H	0	-	13	249	260	0.9576923
C9	2506603	2508052	BolC9t53322H	0	+	49	689	1449	0.4755003
C9	2508872	2510126	BolC9t53323H	0	+	46	483	1254	0.3851674
C9	2514000	2516080	BolC9t53324H	0	+	1018	2017	2080	0.9697115
C9	2516789	2519639	BolC9t53325H	0	+	2398	2850	2850	1.0000000
C9	2520000	2522379	BolC9t53326H	0	+	699	2273	2379	0.9554434
C9	2524294	2526627	BolC9t53327H	0	-	432	1947	2333	0.8345478
C9	2529726	2533740	BolC9t53328H	0	-	596	3627	4014	0.9035875
C9	2535804	2536662	BolC9t53329H	0	-	154	834	858	0.9720280
C9	2538932	2540866	BolC9t53330H	0	-	4131	1589	1934	0.8216133
C9	2549445	2550705	BolC9t53331H	0	+	93	956	1260	0.7587302
C9	2554661	2555306	BolC9t53332H	0	+	137	645	645	1.0000000
C9	2558972	2559876	BolC9t53333H	0	+	1019	904	904	1.0000000
C9	2565415	2565954	BolC9t53334H	0	-	16	486	539	0.9016697
C9	2572613	2580187	BolC9t53335H	0	-	2400	6238	7574	0.8236071
C9	2587490	2588229	BolC9t53336H	0	-	144	705	739	0.9539919
C9	2590744	2592262	BolC9t53337H	0	+	215	1455	1518	0.9584980
C9	2598107	2598685	BolC9t53338H	0	-	17	331	578	0.5726644
C9	2598720	2599051	BolC9t53339H	0	+	22	331	331	1.0000000
C9	2600409	2600706	BolC9t53340H	0	+	22	234	297	0.7878788
C9	2611946	2612882	BolC9t53341H	0	-	74	736	936	0.7863248
C9	2620913	2621468	BolC9t53342H	0	+	261	555	555	1.0000000
C9	2621840	2622972	BolC9t53343H	0	-	222	722	1132	0.6378092
C9	2624780	2625836	BolC9t53344H	0	-	163	928	1056	0.8787879
C9	2646513	2647818	BolC9t53345H	0	+	277	1005	1305	0.7701150
C9	2649670	2650012	BolC9t53346H	0	+	72	262	342	0.7660819
C9	2650787	2654406	BolC9t53347H	0	-	685	2882	3619	0.7963526
C9	2654958	2656328	BolC9t53348H	0	+	554	1130	1370	0.8248175
C9	2656913	2657935	BolC9t53349H	0	-	636	1018	1022	0.9960861
C9	2658826	2660432	BolC9t53350H	0	+	848	1606	1606	1.0000000
C9	2661084	2662159	BolC9t53351H	0	-	650	1075	1075	1.0000000
C9	2665575	2665884	BolC9t53352H	0	-	332	309	309	1.0000000
C9	2666430	2668012	BolC9t53353H	0	-	778	1557	1582	0.9841972
C9	2668581	2668782	BolC9t53354H	0	+	211	201	201	1.0000000
C9	2672805	2673765	BolC9t53355H	0	+	162	917	960	0.9552084
C9	2674251	2675317	BolC9t53356H	0	-	553	1066	1066	1.0000000
C9	2676247	2677228	BolC9t53357H	0	-	638	981	981	1.0000000
C9	2677874	2678983	BolC9t53358H	0	-	331	1092	1109	0.9846709
C9	2680166	2681108	BolC9t53359H	0	+	271	783	942	0.8312102
C9	2681663	2682856	BolC9t53360H	0	-	400	1143	1193	0.9580889
C9	2686210	2686450	BolC9t53361H	0	-	95	240	240	1.0000000
C9	2687681	2689083	BolC9t53362H	0	-	412	1354	1402	0.9657632
C9	2690937	2692365	BolC9t53363H	0	-	870	1428	1428	1.0000000
C9	2694357	2696520	BolC9t53364H	0	-	84	1086	2163	0.5020804
C9	2697725	2699287	BolC9t53365H	0	-	891	1559	1562	0.9980794
C9	2702133	2709346	BolC9t53366H	0	-	5375	7213	7213	1.0000000
C9	2733810	2736378	BolC9t53367H	0	+	403	2200	2568	0.8566978
C9	2741776	2743770	BolC9t53368H	0	+	962	1786	1994	0.8956870
C9	2756466	2760255	BolC9t53369H	0	+	1808	3301	3789	0.8712061
C9	2761792	2765188	BolC9t53370H	0	+	1971	3341	3396	0.9838045
C9	2770421	2773241	BolC9t53371H	0	+	699	2306	2820	0.8177305
C9	2776760	2778804	BolC9t53372H	0	-	440	1665	2044	0.8145792
C9	2783223	2783430	BolC9t53373H	0	+	38	80	207	0.3864734
C9	2783547	2788254	BolC9t53374H	0	+	2282	4336	4707	0.9211812
C9	2789297	2789702	BolC9t53375H	0	+	55	330	405	0.8148148
C9	2791314	2793982	BolC9t53376H	0	-	302	1756	2668	0.6581709
C9	2800860	2802243	BolC9t53377H	0	+	1206	1317	1383	0.9522777
C9	2805138	2810713	BolC9t53378H	0	+	1775	5009	5575	0.8984753
C9	2811903	2813789	BolC9t53379H	0	+	1439	1886	1886	1.0000000
C9	2814556	2816794	BolC9t53380H	0	-	724	2074	2238	0.9267203
C9	2822785	2823563	BolC9t53381H	0	-	424	778	778	1.0000000
C9	2824472	2826181	BolC9t53382H	0	-	500	1618	1709	0.9467525
C9	2826432	2826920	BolC9t53383H	0	+	250	488	488	1.0000000
C9	2827327	2827867	BolC9t53384H	0	-	194	540	540	1.0000000
C9	2829693	2830160	BolC9t53385H	0	-	505	467	467	1.0000000
C9	2833573	2833857	BolC9t53386H	0	+	167	284	284	1.0000000
C9	2869499	2870750	BolC9t53387H	0	+	1101	1251	1251	1.0000000
C9	2871349	2871640	BolC9t53388H	0	-	110	291	291	1.0000000
C9	2875671	2876886	BolC9t53389H	0	+	745	1215	1215	1.0000000
C9	2877732	2879569	BolC9t53390H	0	-	261	1733	1837	0.9433860
C9	2887112	2887271	BolC9t53391H	0	-	146	159	159	1.0000000
C9	2889206	2889665	BolC9t53392H	0	-	20	272	459	0.5925926
C9	2903535	2904174	BolC9t53393H	0	-	343	639	639	1.0000000
C9	2910041	2912518	BolC9t53394H	0	-	746	1923	2477	0.7763423
C9	2914933	2916844	BolC9t53395H	0	+	815	1849	1911	0.9675562
C9	2919183	2920161	BolC9t53396H	0	-	124	876	978	0.8957055
C9	2920536	2922334	BolC9t53397H	0	-	680	1670	1798	0.9288098
C9	2922939	2923527	BolC9t53398H	0	+	887	588	588	1.0000000
C9	2924067	2926344	BolC9t53399H	0	-	1154	2240	2277	0.9837505
C9	2930695	2932719	BolC9t53400H	0	+	450	1778	2024	0.8784585
C9	2934816	2937743	BolC9t53401H	0	+	1216	2782	2927	0.9504612
C9	2943754	2943940	BolC9t53402H	0	+	22	186	186	1.0000000
C9	2949316	2952004	BolC9t53403H	0	-	557	2408	2688	0.8958333
C9	2965698	2969630	BolC9t53404H	0	+	1080	1961	3932	0.4987284
C9	2969898	2972821	BolC9t53405H	0	+	929	2790	2923	0.9544988
C9	2974795	2978228	BolC9t53406H	0	+	1569	3066	3433	0.8930964
C9	2981045	2982758	BolC9t53407H	0	-	329	1447	1713	0.8447168
C9	2986540	2987752	BolC9t53408H	0	-	213	491	1212	0.4051155
C9	2995233	2995728	BolC9t53409H	0	+	165	484	495	0.9777778
C9	2996197	2997981	BolC9t53410H	0	-	872	1784	1784	1.0000000
C9	3001961	3004029	BolC9t53411H	0	+	850	2031	2068	0.9821083
C9	3004633	3006203	BolC9t53412H	0	+	917	1570	1570	1.0000000
C9	3010017	3010254	BolC9t53413H	0	+	42	232	237	0.9789029
C9	3012187	3012526	BolC9t53414H	0	-	362	339	339	1.0000000
C9	3014151	3016029	BolC9t53415H	0	+	612	1199	1878	0.6384451
C9	3016338	3018253	BolC9t53416H	0	-	611	1735	1915	0.9060052
C9	3023682	3024880	BolC9t53417H	0	-	996	1198	1198	1.0000000
C9	3027757	3029723	BolC9t53418H	0	-	1296	1953	1966	0.9933876
C9	3031739	3032413	BolC9t53419H	0	-	552	674	674	1.0000000
C9	3034454	3036248	BolC9t53420H	0	+	1341	1794	1794	1.0000000
C9	3036937	3038416	BolC9t53421H	0	-	1410	1479	1479	1.0000000
C9	3039295	3040041	BolC9t53422H	0	+	208	664	746	0.8900805
C9	3043712	3045318	BolC9t53423H	0	-	1185	1606	1606	1.0000000
C9	3048188	3049553	BolC9t53424H	0	-	120	1002	1365	0.7340659
C9	3052872	3053073	BolC9t53425H	0	-	209	201	201	1.0000000
C9	3053886	3054430	BolC9t53426H	0	+	236	544	544	1.0000000
C9	3055731	3056271	BolC9t53427H	0	+	840	540	540	1.0000000
C9	3058783	3062622	BolC9t53428H	0	+	1594	3626	3839	0.9445168
C9	3065182	3065521	BolC9t53429H	0	+	580	339	339	1.0000000
C9	3067309	3071206	BolC9t53430H	0	+	1386	3797	3897	0.9743392
C9	3072898	3074479	BolC9t53431H	0	-	828	1581	1581	1.0000000
C9	3079403	3080237	BolC9t53432H	0	-	1259	830	834	0.9952039
C9	3080341	3080443	BolC9t53433H	0	-	140	102	102	1.0000000
C9	3093131	3093512	BolC9t53434H	0	-	100	381	381	1.0000000
C9	3105636	3107242	BolC9t53435H	0	+	158	1254	1606	0.7808219
C9	3113443	3113737	BolC9t53436H	0	+	113	270	294	0.9183673
C9	3117495	3118689	BolC9t53437H	0	-	100	377	1194	0.3157454
C9	3122514	3124975	BolC9t53438H	0	-	646	1646	2461	0.6688338
C9	3128652	3129147	BolC9t53439H	0	-	45	378	495	0.7636364
C9	3130385	3133500	BolC9t53440H	0	-	419	2028	3115	0.6510434
C9	3140683	3142522	BolC9t53441H	0	-	528	1573	1839	0.8553562
C9	3143238	3147616	BolC9t53442H	0	-	210	2011	4378	0.4593422
C9	3154541	3155477	BolC9t53443H	0	-	9	135	936	0.1442308
C9	3162828	3171022	BolC9t53444H	0	+	3171	6630	8194	0.8091286
C9	3165389	3166333	BolC9t53445H	0	+	96	153	944	0.1620763
C9	3177485	3182392	BolC9t53446H	0	+	3044	4808	4907	0.9798247
C9	3188997	3189710	BolC9t53447H	0	+	0	0	713	0.0000000
C9	3196943	3197426	BolC9t53448H	0	+	74	480	483	0.9937888
C9	3204079	3205779	BolC9t53449H	0	+	178	1518	1700	0.8929412
C9	3211919	3212806	BolC9t53450H	0	+	16	362	887	0.4081172
C9	3215289	3217194	BolC9t53451H	0	+	210	1419	1905	0.7448819
C9	3219888	3220029	BolC9t53452H	0	-	0	0	141	0.0000000
C9	3221954	3225715	BolC9t53453H	0	-	1493	3363	3761	0.8941771
C9	3226808	3227435	BolC9t53454H	0	-	78	502	627	0.8006380
C9	3229331	3230415	BolC9t53455H	0	-	474	1084	1084	1.0000000
C9	3239128	3239704	BolC9t53456H	0	-	0	0	576	0.0000000
C9	3241935	3242502	BolC9t53457H	0	-	43	510	567	0.8994709
C9	3252770	3253529	BolC9t53458H	0	-	552	759	759	1.0000000
C9	3256653	3257235	BolC9t53459H	0	+	522	582	582	1.0000000
C9	3260571	3260819	BolC9t53460H	0	+	22	161	248	0.6491935
C9	3262292	3264071	BolC9t53461H	0	-	507	1696	1779	0.9533446
C9	3264152	3264485	BolC9t53462H	0	+	218	333	333	1.0000000
C9	3269230	3270066	BolC9t53463H	0	-	116	779	836	0.9318182
C9	3270809	3271551	BolC9t53464H	0	+	437	742	742	1.0000000
C9	3271961	3272640	BolC9t53465H	0	-	526	679	679	1.0000000
C9	3273346	3275472	BolC9t53466H	0	+	1205	2114	2126	0.9943556
C9	3277650	3278067	BolC9t53467H	0	+	174	410	417	0.9832134
C9	3280161	3283201	BolC9t53468H	0	+	1182	3003	3040	0.9878290
C9	3283874	3286500	BolC9t53469H	0	+	879	2155	2626	0.8206397
C9	3287751	3288098	BolC9t53470H	0	+	0	0	347	0.0000000
C9	3289335	3289606	BolC9t53471H	0	+	0	0	271	0.0000000
C9	3290233	3292483	BolC9t53472H	0	-	540	1933	2250	0.8591111
C9	3294410	3296158	BolC9t53473H	0	-	750	1505	1748	0.8609840
C9	3299405	3300455	BolC9t53474H	0	+	501	1050	1050	1.0000000
C9	3300920	3302245	BolC9t53475H	0	+	223	1223	1325	0.9230189
C9	3302545	3304764	BolC9t53476H	0	-	911	2118	2219	0.9544840
C9	3306434	3307973	BolC9t53477H	0	-	672	1473	1539	0.9571150
C9	3310101	3313858	BolC9t53478H	0	+	1409	3145	3757	0.8371041
C9	3315054	3316057	BolC9t53479H	0	+	799	1003	1003	1.0000000
C9	3316977	3318147	BolC9t53480H	0	+	638	1170	1170	1.0000000
C9	3319769	3325992	BolC9t53481H	0	+	2601	5898	6223	0.9477744
C9	3326409	3327505	BolC9t53482H	0	-	622	1096	1096	1.0000000
C9	3328146	3328335	BolC9t53483H	0	+	148	189	189	1.0000000
C9	3331134	3333211	BolC9t53484H	0	+	386	1992	2077	0.9590756
C9	3337230	3340471	BolC9t53485H	0	+	1894	3146	3241	0.9706880
C9	3340946	3341780	BolC9t53486H	0	+	1189	834	834	1.0000000
C9	3342085	3344099	BolC9t53487H	0	-	1792	2014	2014	1.0000000
C9	3350086	3351397	BolC9t53488H	0	+	791	1311	1311	1.0000000
C9	3355638	3359476	BolC9t53489H	0	+	457	3665	3838	0.9549245
C9	3361248	3370544	BolC9t53490H	0	+	3659	7731	9296	0.8316480
C9	3371718	3372698	BolC9t53491H	0	+	171	713	980	0.7275510
C9	3378281	3380819	BolC9t53492H	0	+	591	2324	2538	0.9156817
C9	3381557	3384621	BolC9t53493H	0	+	442	2775	3064	0.9056789
C9	3386209	3387466	BolC9t53494H	0	+	1245	1257	1257	1.0000000
C9	3390492	3393702	BolC9t53495H	0	+	1326	3151	3210	0.9816200
C9	3394762	3394951	BolC9t53496H	0	-	122	189	189	1.0000000
C9	3395790	3397903	BolC9t53497H	0	-	988	2113	2113	1.0000000
C9	3399065	3400572	BolC9t53498H	0	-	517	1507	1507	1.0000000
C9	3406997	3409330	BolC9t53499H	0	-	742	2185	2333	0.9365624
C9	3409821	3410764	BolC9t53500H	0	-	1048	943	943	1.0000000
C9	3422500	3426863	BolC9t53501H	0	+	1715	3975	4363	0.9110703
C9	3436795	3437845	BolC9t53502H	0	+	96	861	1050	0.8200000
C9	3440519	3444398	BolC9t53503H	0	+	2449	3848	3879	0.9920083
C9	3444630	3446143	BolC9t53504H	0	-	442	1505	1513	0.9947125
C9	3447557	3447971	BolC9t53505H	0	+	140	377	414	0.9106280
C9	3451233	3453644	BolC9t53506H	0	+	1533	2411	2411	1.0000000
C9	3453964	3455371	BolC9t53507H	0	-	368	1407	1407	1.0000000
C9	3461516	3466052	BolC9t53508H	0	+	2494	4505	4536	0.9931658
C9	3466893	3469717	BolC9t53509H	0	-	1143	2824	2824	1.0000000
C9	3470822	3472945	BolC9t53510H	0	+	1691	2123	2123	1.0000000
C9	3473757	3476354	BolC9t53511H	0	+	1707	2597	2597	1.0000000
C9	3483401	3486752	BolC9t53512H	0	+	981	3066	3351	0.9149508
C9	3488454	3488987	BolC9t53513H	0	-	409	533	533	1.0000000
C9	3494114	3494465	BolC9t53514H	0	+	175	351	351	1.0000000
C9	3495644	3497422	BolC9t53515H	0	+	1127	1778	1778	1.0000000
C9	3498181	3499437	BolC9t53516H	0	+	500	1199	1256	0.9546179
C9	3508968	3512433	BolC9t53517H	0	+	1203	3412	3465	0.9847042
C9	3512529	3518748	BolC9t53518H	0	+	3016	6101	6219	0.9810259
C9	3515119	3515959	BolC9t53519H	0	-	165	722	840	0.8595238
C9	3519686	3522145	BolC9t53520H	0	-	688	2172	2459	0.8832859
C9	3525507	3526659	BolC9t53521H	0	+	257	935	1152	0.8116319
C9	3544426	3546648	BolC9t53522H	0	-	284	1499	2222	0.6746175
C9	3550046	3550841	BolC9t53523H	0	-	27	456	795	0.5735849
C9	3562438	3563254	BolC9t53524H	0	-	3	127	816	0.1556372
C9	3596232	3597033	BolC9t53525H	0	-	25	110	801	0.1373283
C9	3603667	3606488	BolC9t53526H	0	-	710	2741	2821	0.9716412
C9	3615216	3616789	BolC9t53527H	0	-	81	1020	1573	0.6484424
C9	3620379	3620535	BolC9t53528H	0	+	234	156	156	1.0000000
C9	3622521	3623154	BolC9t53529H	0	-	221	489	633	0.7725118
C9	3623532	3628473	BolC9t53530H	0	-	2394	4896	4941	0.9908925
C9	3635467	3635978	BolC9t53531H	0	-	110	429	511	0.8395303
C9	3641003	3646659	BolC9t53532H	0	-	253	1039	5656	0.1836987
C9	3648637	3650431	BolC9t53533H	0	+	728	1497	1794	0.8344482
C9	3655038	3655398	BolC9t53534H	0	-	252	360	360	1.0000000
C9	3657461	3658691	BolC9t53535H	0	+	48	954	1230	0.7756097
C9	3705047	3706862	BolC9t53536H	0	+	352	1310	1815	0.7217631
C9	3708163	3708990	BolC9t53537H	0	-	731	827	827	1.0000000
C9	3709992	3715377	BolC9t53538H	0	-	3536	5385	5385	1.0000000
C9	3721180	3724807	BolC9t53539H	0	-	1476	3223	3627	0.8886132
C9	3741584	3744842	BolC9t53540H	0	+	2147	3252	3258	0.9981584
C9	3745100	3745840	BolC9t53541H	0	-	556	740	740	1.0000000
C9	3746644	3747195	BolC9t53542H	0	-	498	551	551	1.0000000
C9	3748352	3748687	BolC9t53543H	0	-	360	335	335	1.0000000
C9	3749978	3755119	BolC9t53544H	0	-	2195	4962	5141	0.9651819
C9	3756183	3760247	BolC9t53545H	0	-	1906	4037	4064	0.9933563
C9	3762144	3763031	BolC9t53546H	0	-	505	856	887	0.9650508
C9	3765625	3767166	BolC9t53547H	0	+	1810	1541	1541	1.0000000
C9	3769595	3772245	BolC9t53548H	0	+	559	2329	2650	0.8788679
C9	3772613	3773598	BolC9t53549H	0	+	200	748	985	0.7593909
C9	3774044	3775479	BolC9t53550H	0	-	540	1191	1435	0.8299652
C9	3788343	3788604	BolC9t53551H	0	+	0	0	261	0.0000000
C9	3815016	3816252	BolC9t53552H	0	+	252	831	1236	0.6723301
C9	3822594	3825163	BolC9t53553H	0	-	1264	2427	2569	0.9447256
C9	3826241	3826968	BolC9t53554H	0	+	147	720	727	0.9903714
C9	3827122	3830425	BolC9t53555H	0	-	1347	3108	3303	0.9409627
C9	3831414	3832756	BolC9t53556H	0	-	998	1342	1342	1.0000000
C9	3833987	3834350	BolC9t53557H	0	-	455	363	363	1.0000000
C9	3840301	3840612	BolC9t53558H	0	-	250	311	311	1.0000000
C9	3842074	3846249	BolC9t53559H	0	+	1008	3968	4175	0.9504192
C9	3846826	3847063	BolC9t53560H	0	-	21	151	237	0.6371308
C9	3849592	3850913	BolC9t53561H	0	-	728	1229	1321	0.9303558
C9	3852644	3853889	BolC9t53562H	0	-	829	1245	1245	1.0000000
C9	3854630	3859936	BolC9t53563H	0	-	2823	5052	5306	0.9521297
C9	3861787	3863174	BolC9t53564H	0	-	0	0	1387	0.0000000
C9	3865076	3865647	BolC9t53565H	0	-	81	472	571	0.8266200
C9	3870645	3875095	BolC9t53566H	0	+	406	3109	4450	0.6986517
C9	3876353	3877106	BolC9t53567H	0	+	222	538	753	0.7144755
C9	3877655	3879522	BolC9t53568H	0	-	280	1544	1867	0.8269952
C9	3895118	3897945	BolC9t53569H	0	+	239	1687	2827	0.5967457
C9	3901275	3903028	BolC9t53570H	0	+	126	1511	1753	0.8619509
C9	3904910	3905786	BolC9t53571H	0	+	138	668	876	0.7625571
C9	3917353	3918653	BolC9t53572H	0	+	634	1294	1300	0.9953846
C9	3921505	3922000	BolC9t53573H	0	-	21	167	495	0.3373737
C9	3922040	3922370	BolC9t53574H	0	-	17	330	330	1.0000000
C9	3932257	3933930	BolC9t53575H	0	+	606	1667	1673	0.9964136
C9	3934573	3935563	BolC9t53576H	0	-	82	713	990	0.7202020
C9	3936952	3939518	BolC9t53577H	0	-	430	2233	2566	0.8702260
C9	3940787	3942005	BolC9t53578H	0	+	145	995	1218	0.8169129
C9	3942496	3943465	BolC9t53579H	0	+	81	788	969	0.8132095
C9	3944600	3945933	BolC9t53580H	0	-	570	1271	1333	0.9534883
C9	3951624	3951732	BolC9t53581H	0	+	35	108	108	1.0000000
C9	3951760	3954023	BolC9t53582H	0	+	580	2201	2263	0.9726027
C9	3957232	3959712	BolC9t53583H	0	+	1580	2308	2480	0.9306452
C9	3961639	3962110	BolC9t53584H	0	+	38	264	471	0.5605096
C9	3963739	3964138	BolC9t53585H	0	-	538	399	399	1.0000000
C9	3966128	3967150	BolC9t53586H	0	-	469	1022	1022	1.0000000
C9	3973553	3974084	BolC9t53587H	0	+	120	531	531	1.0000000
C9	3975676	3976884	BolC9t53588H	0	+	465	1172	1208	0.9701987
C9	3982425	3985226	BolC9t53589H	0	+	2059	2784	2801	0.9939308
C9	4000233	4000890	BolC9t53590H	0	+	265	657	657	1.0000000
C9	4019303	4021475	BolC9t53591H	0	+	1257	2172	2172	1.0000000
C9	4024213	4024342	BolC9t53592H	0	+	28	129	129	1.0000000
C9	4025072	4027269	BolC9t53593H	0	+	1162	2159	2197	0.9827037
C9	4027390	4028700	BolC9t53594H	0	-	701	1310	1310	1.0000000
C9	4029190	4031751	BolC9t53595H	0	-	1104	2465	2561	0.9625146
C9	4036664	4038116	BolC9t53596H	0	-	34	616	1452	0.4242424
C9	4075782	4078338	BolC9t53597H	0	+	819	2254	2556	0.8818466
C9	4090675	4093939	BolC9t53598H	0	+	1747	3264	3264	1.0000000
C9	4095561	4099274	BolC9t53599H	0	+	1607	3616	3713	0.9738756
C9	4099888	4102808	BolC9t53600H	0	+	2115	2920	2920	1.0000000
C9	4103235	4104488	BolC9t53601H	0	+	732	1253	1253	1.0000000
C9	4105692	4106619	BolC9t53602H	0	+	92	844	927	0.9104639
C9	4109417	4110634	BolC9t53603H	0	+	710	1066	1217	0.8759244
C9	4112339	4116900	BolC9t53604H	0	+	791	3016	4561	0.6612585
C9	4122222	4124298	BolC9t53605H	0	-	946	2076	2076	1.0000000
C9	4149221	4151188	BolC9t53606H	0	+	636	1920	1967	0.9761057
C9	4156581	4157175	BolC9t53607H	0	-	371	594	594	1.0000000
C9	4172856	4173477	BolC9t53608H	0	-	214	621	621	1.0000000
C9	4174379	4176156	BolC9t53609H	0	+	913	1777	1777	1.0000000
C9	4177295	4177667	BolC9t53610H	0	+	120	362	372	0.9731183
C9	4188949	4189575	BolC9t53611H	0	+	182	626	626	1.0000000
C9	4202254	4203019	BolC9t53612H	0	-	325	765	765	1.0000000
C9	4205703	4210028	BolC9t53613H	0	-	1477	3888	4325	0.8989595
C9	4210684	4212249	BolC9t53614H	0	-	382	1529	1565	0.9769968
C9	4213555	4214188	BolC9t53615H	0	+	164	633	633	1.0000000
C9	4214394	4215889	BolC9t53616H	0	-	1494	1492	1495	0.9979933
C9	4216659	4222149	BolC9t53617H	0	+	2618	5376	5490	0.9792350
C9	4223764	4224397	BolC9t53618H	0	+	230	618	633	0.9763033
C9	4224880	4226261	BolC9t53619H	0	+	538	1263	1381	0.9145547
C9	4226662	4228211	BolC9t53620H	0	-	283	1169	1549	0.7546805
C9	4234814	4235600	BolC9t53621H	0	+	33	637	786	0.8104326
C9	4237705	4238576	BolC9t53622H	0	-	508	871	871	1.0000000
C9	4240801	4241128	BolC9t53623H	0	-	14	48	327	0.1467890
C9	4245507	4292233	BolC9t53624H	0	+	14390	35272	46726	0.7548688
C9	4251945	4252206	BolC9t53625H	0	+	0	0	261	0.0000000
C9	4259709	4262813	BolC9t53626H	0	+	854	2681	3104	0.8637242
C9	4262905	4265384	BolC9t53627H	0	+	1785	2479	2479	1.0000000
C9	4292269	4292638	BolC9t53628H	0	+	270	369	369	1.0000000
C9	4298919	4315314	BolC9t53629H	0	+	6100	15801	16395	0.9637694
C9	4315379	4316711	BolC9t53630H	0	+	446	1174	1332	0.8813814
C9	4318189	4319655	BolC9t53631H	0	+	1131	1401	1466	0.9556617
C9	4325870	4326934	BolC9t53632H	0	+	698	1064	1064	1.0000000
C9	4331452	4332941	BolC9t53633H	0	-	1007	1489	1489	1.0000000
C9	4339265	4341841	BolC9t53634H	0	+	1921	2537	2576	0.9848602
C9	4342759	4343644	BolC9t53635H	0	-	395	885	885	1.0000000
C9	4355934	4364627	BolC9t53636H	0	+	1774	6161	8693	0.7087312
C9	4368146	4384150	BolC9t53637H	0	+	537	6273	16004	0.3919645
C9	4388563	4390157	BolC9t53638H	0	+	191	1383	1594	0.8676286
C9	4391185	4392241	BolC9t53639H	0	+	354	1005	1056	0.9517046
C9	4393168	4394914	BolC9t53640H	0	+	365	1732	1746	0.9919817
C9	4396736	4397216	BolC9t53641H	0	+	276	480	480	1.0000000
C9	4398045	4398662	BolC9t53642H	0	+	819	617	617	1.0000000
C9	4401141	4403791	BolC9t53643H	0	+	917	2650	2650	1.0000000
C9	4406003	4407481	BolC9t53644H	0	+	69	794	1478	0.5372124
C9	4422828	4424485	BolC9t53645H	0	-	2975	1657	1657	1.0000000
C9	4432367	4434247	BolC9t53646H	0	-	0	0	1880	0.0000000
C9	4449960	4451433	BolC9t53647H	0	+	65	1135	1473	0.7705363
C9	4467329	4467512	BolC9t53648H	0	+	31	47	183	0.2568306
C9	4471035	4480162	BolC9t53649H	0	+	2912	3663	9127	0.4013367
C9	4488231	4488891	BolC9t53650H	0	+	474	571	660	0.8651515
C9	4492059	4494564	BolC9t53651H	0	+	597	2267	2505	0.9049900
C9	4496868	4498633	BolC9t53652H	0	+	89	1109	1765	0.6283286
C9	4499104	4499496	BolC9t53653H	0	-	0	0	392	0.0000000
C9	4500405	4502649	BolC9t53654H	0	-	451	1690	2244	0.7531194
C9	4505252	4505925	BolC9t53655H	0	-	164	565	673	0.8395245
C9	4513854	4515243	BolC9t53656H	0	+	18	528	1389	0.3801296
C9	4534711	4536370	BolC9t53657H	0	+	202	1440	1659	0.8679928
C9	4546585	4548922	BolC9t53658H	0	+	104	1189	2337	0.5087720
C9	4553427	4553580	BolC9t53659H	0	+	9	153	153	1.0000000
C9	4555444	4556734	BolC9t53660H	0	-	164	733	1290	0.5682170
C9	4567387	4568107	BolC9t53661H	0	-	238	720	720	1.0000000
C9	4570242	4571009	BolC9t53662H	0	+	300	767	767	1.0000000
C9	4571268	4575175	BolC9t53663H	0	-	923	3901	3907	0.9984643
C9	4575616	4576489	BolC9t53664H	0	+	535	860	873	0.9851088
C9	4576917	4580887	BolC9t53665H	0	-	3562	3970	3970	1.0000000
C9	4583826	4594741	BolC9t53666H	0	-	894	4792	10915	0.4390289
C9	4595374	4596957	BolC9t53667H	0	+	1173	1583	1583	1.0000000
C9	4603299	4604774	BolC9t53668H	0	+	145	861	1475	0.5837288
C9	4606020	4606683	BolC9t53669H	0	+	109	663	663	1.0000000
C9	4608680	4609781	BolC9t53670H	0	-	116	861	1101	0.7820163
C9	4614288	4614984	BolC9t53671H	0	+	300	696	696	1.0000000
C9	4645106	4646970	BolC9t53672H	0	+	239	1460	1864	0.7832618
C9	4648968	4650146	BolC9t53673H	0	+	62	752	1178	0.6383701
C9	4660780	4667242	BolC9t53674H	0	+	1299	5350	6462	0.8279170
C9	4668483	4671045	BolC9t53675H	0	+	1244	2562	2562	1.0000000
C9	4677475	4679790	BolC9t53676H	0	+	994	2057	2315	0.8885529
C9	4680042	4683085	BolC9t53677H	0	-	2093	3041	3043	0.9993427
C9	4684016	4686190	BolC9t53678H	0	+	1297	1654	2174	0.7608095
C9	4684603	4684920	BolC9t53679H	0	-	125	289	317	0.9116719
C9	4686638	4688508	BolC9t53680H	0	-	550	1801	1870	0.9631016
C9	4689317	4690467	BolC9t53681H	0	-	610	1150	1150	1.0000000
C9	4693165	4694173	BolC9t53682H	0	+	246	929	1008	0.9216270
C9	4705238	4710703	BolC9t53683H	0	-	2996	5465	5465	1.0000000
C9	4713520	4714090	BolC9t53684H	0	+	94	147	570	0.2578947
C9	4715444	4715825	BolC9t53685H	0	-	374	381	381	1.0000000
C9	4728674	4732403	BolC9t53686H	0	-	1269	3063	3729	0.8213999
C9	4733662	4734034	BolC9t53687H	0	-	115	372	372	1.0000000
C9	4739597	4741009	BolC9t53688H	0	+	714	1412	1412	1.0000000
C9	4741445	4743197	BolC9t53689H	0	-	761	1744	1752	0.9954338
C9	4755166	4756291	BolC9t53690H	0	-	221	854	1125	0.7591111
C9	4759960	4760200	BolC9t53691H	0	+	2	45	240	0.1875000
C9	4763263	4763503	BolC9t53692H	0	+	0	0	240	0.0000000
C9	4766595	4766835	BolC9t53693H	0	+	0	0	240	0.0000000
C9	4768355	4770759	BolC9t53694H	0	-	867	2131	2404	0.8864393
C9	4774170	4774809	BolC9t53695H	0	+	268	639	639	1.0000000
C9	4776439	4776682	BolC9t53696H	0	-	427	243	243	1.0000000
C9	4777173	4779239	BolC9t53697H	0	-	976	2066	2066	1.0000000
C9	4779992	4782366	BolC9t53698H	0	+	1039	2374	2374	1.0000000
C9	4782696	4783738	BolC9t53699H	0	-	561	1042	1042	1.0000000
C9	4786335	4786983	BolC9t53700H	0	-	243	648	648	1.0000000
C9	4794624	4794888	BolC9t53701H	0	-	236	264	264	1.0000000
C9	4804275	4804621	BolC9t53702H	0	-	238	346	346	1.0000000
C9	4807520	4808303	BolC9t53703H	0	-	95	749	783	0.9565772
C9	4812711	4813554	BolC9t53704H	0	-	575	843	843	1.0000000
C9	4813924	4819204	BolC9t53705H	0	+	2274	4829	5280	0.9145833
C9	4828089	4829430	BolC9t53706H	0	+	510	1186	1341	0.8844146
C9	4833736	4834489	BolC9t53707H	0	+	122	659	753	0.8751660
C9	4838406	4839717	BolC9t53708H	0	-	185	1014	1311	0.7734554
C9	4852454	4853623	BolC9t53709H	0	+	604	1169	1169	1.0000000
C9	4854869	4855091	BolC9t53710H	0	-	299	222	222	1.0000000
C9	4861207	4863523	BolC9t53711H	0	-	377	1863	2316	0.8044041
C9	4863569	4866193	BolC9t53712H	0	-	237	2009	2624	0.7656250
C9	4871253	4874574	BolC9t53713H	0	-	518	2316	3321	0.6973803
C9	4886797	4889217	BolC9t53714H	0	-	952	2348	2420	0.9702479
C9	4894864	4896882	BolC9t53715H	0	-	1007	1821	2018	0.9023786
C9	4900401	4903173	BolC9t53716H	0	+	1324	2772	2772	1.0000000
C9	4903886	4906636	BolC9t53717H	0	-	440	2476	2750	0.9003636
C9	4907407	4908573	BolC9t53718H	0	+	1110	1166	1166	1.0000000
C9	4909066	4909826	BolC9t53719H	0	-	404	760	760	1.0000000
C9	4910756	4914349	BolC9t53720H	0	-	1122	3359	3593	0.9348733
C9	4921414	4922983	BolC9t53721H	0	-	710	1422	1569	0.9063097
C9	4923363	4926940	BolC9t53722H	0	-	1682	3499	3577	0.9781940
C9	4927252	4928283	BolC9t53723H	0	+	647	1031	1031	1.0000000
C9	4940848	4945434	BolC9t53724H	0	+	3487	4546	4586	0.9912778
C9	4946113	4949209	BolC9t53725H	0	+	2048	3096	3096	1.0000000
C9	4952780	4955006	BolC9t53726H	0	-	1911	2226	2226	1.0000000
C9	4963282	4963723	BolC9t53727H	0	-	182	426	441	0.9659864
C9	4964083	4966705	BolC9t53728H	0	+	374	2174	2622	0.8291380
C9	4970781	4973011	BolC9t53729H	0	+	1492	2177	2230	0.9762332
C9	4973601	4975788	BolC9t53730H	0	-	557	2063	2187	0.9433013
C9	4979669	4981595	BolC9t53731H	0	+	530	1827	1926	0.9485981
C9	4982057	4982282	BolC9t53732H	0	-	207	225	225	1.0000000
C9	4986621	4988020	BolC9t53733H	0	-	333	1394	1399	0.9964260
C9	5010493	5012131	BolC9t53734H	0	-	460	1401	1638	0.8553113
C9	5014486	5016557	BolC9t53735H	0	-	964	1996	2071	0.9637856
C9	5024342	5026244	BolC9t53736H	0	+	1126	1893	1902	0.9952682
C9	5035654	5039272	BolC9t53737H	0	+	365	2942	3618	0.8131564
C9	5044029	5047367	BolC9t53738H	0	+	716	1949	3338	0.5838826
C9	5048351	5048957	BolC9t53739H	0	-	76	396	606	0.6534653
C9	5068711	5069058	BolC9t53740H	0	+	87	108	347	0.3112392
C9	5070400	5071638	BolC9t53741H	0	-	164	890	1238	0.7189015
C9	5071928	5072342	BolC9t53742H	0	-	24	346	414	0.8357488
C9	5082365	5084128	BolC9t53743H	0	+	1245	1763	1763	1.0000000
C9	5085212	5086067	BolC9t53744H	0	-	550	828	855	0.9684210
C9	5087010	5088534	BolC9t53745H	0	+	792	1478	1524	0.9698163
C9	5089359	5091661	BolC9t53746H	0	-	1190	2179	2302	0.9465682
C9	5092702	5093984	BolC9t53747H	0	+	910	1282	1282	1.0000000
C9	5096550	5098439	BolC9t53748H	0	-	1194	1827	1889	0.9671784
C9	5111618	5112959	BolC9t53749H	0	+	893	1341	1341	1.0000000
C9	5113016	5116616	BolC9t53750H	0	+	765	2826	3600	0.7850000
C9	5129031	5129343	BolC9t53751H	0	+	117	312	312	1.0000000
C9	5136335	5142024	BolC9t53752H	0	+	2453	4984	5689	0.8760766
C9	5146763	5148197	BolC9t53753H	0	-	1277	1434	1434	1.0000000
C9	5151072	5152056	BolC9t53754H	0	-	386	984	984	1.0000000
C9	5153069	5156242	BolC9t53755H	0	-	1291	3168	3173	0.9984242
C9	5162440	5162722	BolC9t53756H	0	+	236	282	282	1.0000000
C9	5166492	5167627	BolC9t53757H	0	-	575	1135	1135	1.0000000
C9	5168224	5170207	BolC9t53758H	0	-	511	1866	1983	0.9409985
C9	5171027	5173353	BolC9t53759H	0	+	797	2191	2326	0.9419605
C9	5174848	5176796	BolC9t53760H	0	+	705	1560	1948	0.8008214
C9	5183531	5183708	BolC9t53761H	0	-	182	177	177	1.0000000
C9	5196891	5197773	BolC9t53762H	0	+	494	789	882	0.8945578
C9	5200737	5201337	BolC9t53763H	0	+	92	476	600	0.7933334
C9	5203094	5203469	BolC9t53764H	0	-	62	375	375	1.0000000
C9	5207906	5209083	BolC9t53765H	0	+	611	1177	1177	1.0000000
C9	5209828	5210727	BolC9t53766H	0	-	361	899	899	1.0000000
C9	5212476	5213162	BolC9t53767H	0	+	630	686	686	1.0000000
C9	5213743	5213914	BolC9t53768H	0	-	184	171	171	1.0000000
C9	5225949	5226859	BolC9t53769H	0	-	0	0	910	0.0000000
C9	5228474	5229698	BolC9t53770H	0	-	0	0	1224	0.0000000
C9	5232742	5234114	BolC9t53771H	0	-	61	511	1372	0.3724490
C9	5241098	5241707	BolC9t53772H	0	-	103	609	609	1.0000000
C9	5242468	5243326	BolC9t53773H	0	-	139	671	858	0.7820513
C9	5249252	5249663	BolC9t53774H	0	-	55	280	411	0.6812652
C9	5258156	5258564	BolC9t53775H	0	-	556	408	408	1.0000000
C9	5266305	5268073	BolC9t53776H	0	+	879	1763	1768	0.9971719
C9	5270151	5270559	BolC9t53777H	0	-	49	272	408	0.6666667
C9	5289216	5291221	BolC9t53778H	0	+	1114	1723	2005	0.8593516
C9	5292658	5300279	BolC9t53779H	0	-	4121	7220	7621	0.9473822
C9	5301840	5303468	BolC9t53780H	0	-	649	1518	1628	0.9324324
C9	5306815	5307103	BolC9t53781H	0	+	356	288	288	1.0000000
C9	5307640	5309685	BolC9t53782H	0	-	2441	2045	2045	1.0000000
C9	5312868	5313177	BolC9t53783H	0	-	7	38	309	0.1229773
C9	5315239	5316094	BolC9t53784H	0	+	3	142	855	0.1660819
C9	5329617	5330073	BolC9t53785H	0	+	335	456	456	1.0000000
C9	5334560	5334749	BolC9t53786H	0	+	0	0	189	0.0000000
C9	5341396	5341642	BolC9t53787H	0	+	39	97	246	0.3943090
C9	5341913	5342042	BolC9t53788H	0	-	227	129	129	1.0000000
C9	5344142	5344403	BolC9t53789H	0	+	0	0	261	0.0000000
C9	5344667	5346174	BolC9t53790H	0	-	2	21	1507	0.0139350
C9	5348143	5350524	BolC9t53791H	0	-	284	1955	2381	0.8210836
C9	5370074	5370215	BolC9t53792H	0	-	0	0	141	0.0000000
C9	5377839	5380533	BolC9t53793H	0	+	634	2364	2694	0.8775055
C9	5381852	5396045	BolC9t53794H	0	+	893	4678	14193	0.3295991
C9	5398067	5398613	BolC9t53795H	0	-	34	77	546	0.1410256
C9	5410960	5411626	BolC9t53796H	0	+	236	666	666	1.0000000
C9	5413697	5416629	BolC9t53797H	0	-	2166	2864	2932	0.9768077
C9	5419443	5422282	BolC9t53798H	0	+	1317	2591	2839	0.9126453
C9	5422767	5424320	BolC9t53799H	0	-	671	1553	1553	1.0000000
C9	5430530	5430722	BolC9t53800H	0	+	1	34	192	0.1770833
C9	5431917	5433571	BolC9t53801H	0	+	245	1485	1654	0.8978235
C9	5434451	5438801	BolC9t53802H	0	-	179	2142	4350	0.4924138
C9	5441359	5445962	BolC9t53803H	0	-	110	1465	4603	0.3182707
C9	5466844	5469708	BolC9t53804H	0	+	1748	2786	2864	0.9727654
C9	5471725	5471998	BolC9t53805H	0	+	354	273	273	1.0000000
C9	5482586	5483813	BolC9t53806H	0	-	51	548	1227	0.4466178
C9	5485149	5488035	BolC9t53807H	0	+	3247	2487	2886	0.8617464
C9	5492107	5493523	BolC9t53808H	0	-	46	801	1416	0.5656779
C9	5501061	5502291	BolC9t53809H	0	+	89	577	1230	0.4691057
C9	5504706	5504850	BolC9t53810H	0	-	10	123	144	0.8541667
C9	5509419	5511011	BolC9t53811H	0	-	950	1592	1592	1.0000000
C9	5514582	5516302	BolC9t53812H	0	+	1661	1655	1720	0.9622093
C9	5525773	5526246	BolC9t53813H	0	-	1	8	473	0.0169133
C9	5540540	5542022	BolC9t53814H	0	+	369	1144	1482	0.7719298
C9	5542740	5543755	BolC9t53815H	0	-	1189	1015	1015	1.0000000
C9	5544175	5544841	BolC9t53816H	0	-	465	666	666	1.0000000
C9	5545421	5547040	BolC9t53817H	0	+	523	1619	1619	1.0000000
C9	5549605	5551036	BolC9t53818H	0	+	758	1232	1431	0.8609364
C9	5551315	5553041	BolC9t53819H	0	-	999	1726	1726	1.0000000
C9	5563319	5563604	BolC9t53820H	0	+	200	285	285	1.0000000
C9	5564429	5564789	BolC9t53821H	0	+	234	350	360	0.9722222
C9	5583913	5586321	BolC9t53822H	0	+	1952	2408	2408	1.0000000
C9	5595552	5595890	BolC9t53823H	0	+	72	328	338	0.9704142
C9	5599085	5599832	BolC9t53824H	0	-	131	690	747	0.9236948
C9	5600756	5600933	BolC9t53825H	0	+	36	156	177	0.8813559
C9	5601881	5604362	BolC9t53826H	0	-	1239	2368	2481	0.9544538
C9	5604435	5604543	BolC9t53827H	0	-	136	108	108	1.0000000
C9	5614864	5615395	BolC9t53828H	0	-	10	279	531	0.5254237
C9	5622060	5623005	BolC9t53829H	0	-	169	913	945	0.9661376
C9	5623165	5625556	BolC9t53830H	0	-	664	2090	2391	0.8741112
C9	5626148	5629625	BolC9t53831H	0	-	1066	2884	3477	0.8294507
C9	5630652	5631421	BolC9t53832H	0	+	590	769	769	1.0000000
C9	5634325	5634938	BolC9t53833H	0	-	605	613	613	1.0000000
C9	5638149	5640247	BolC9t53834H	0	+	525	1865	2098	0.8889418
C9	5649245	5652154	BolC9t53835H	0	-	1004	2754	2909	0.9467171
C9	5656805	5659944	BolC9t53836H	0	+	1266	3069	3139	0.9776999
C9	5660354	5662150	BolC9t53837H	0	-	581	1585	1796	0.8825167
C9	5664269	5665747	BolC9t53838H	0	+	354	840	1478	0.5683356
C9	5665927	5667450	BolC9t53839H	0	-	684	1393	1523	0.9146422
C9	5670843	5671559	BolC9t53840H	0	-	462	716	716	1.0000000
C9	5672061	5678375	BolC9t53841H	0	-	3197	5992	6314	0.9490022
C9	5679777	5681302	BolC9t53842H	0	-	979	1525	1525	1.0000000
C9	5693066	5695905	BolC9t53843H	0	-	490	2059	2839	0.7252554
C9	5699822	5701127	BolC9t53844H	0	-	286	1224	1305	0.9379311
C9	5710223	5711314	BolC9t53845H	0	+	821	1091	1091	1.0000000
C9	5713595	5715203	BolC9t53846H	0	-	465	1459	1608	0.9073383
C9	5721361	5724646	BolC9t53847H	0	-	2661	3285	3285	1.0000000
C9	5725107	5725768	BolC9t53848H	0	+	292	661	661	1.0000000
C9	5725973	5729380	BolC9t53849H	0	-	1814	3407	3407	1.0000000
C9	5730041	5731667	BolC9t53850H	0	+	373	1414	1626	0.8696187
C9	5751733	5754058	BolC9t53851H	0	+	325	1574	2325	0.6769893
C9	5761544	5764613	BolC9t53852H	0	-	622	2685	3069	0.8748778
C9	5765093	5768184	BolC9t53853H	0	+	1024	2695	3091	0.8718861
C9	5773931	5776288	BolC9t53854H	0	+	1049	2357	2357	1.0000000
C9	5776747	5778697	BolC9t53855H	0	-	1114	1941	1950	0.9953846
C9	5786525	5788506	BolC9t53856H	0	-	939	1981	1981	1.0000000
C9	5792891	5794298	BolC9t53857H	0	-	537	1407	1407	1.0000000
C9	5795751	5796691	BolC9t53858H	0	+	6	368	940	0.3914894
C9	5797624	5798329	BolC9t53859H	0	+	464	705	705	1.0000000
C9	5806543	5806762	BolC9t53860H	0	+	78	197	219	0.8995434
C9	5809093	5811562	BolC9t53861H	0	+	279	1658	2469	0.6715269
C9	5812005	5814869	BolC9t53862H	0	-	1189	2690	2864	0.9392458
C9	5818440	5820305	BolC9t53863H	0	+	349	1743	1865	0.9345844
C9	5828582	5829833	BolC9t53864H	0	+	263	1026	1251	0.8201439
C9	5831376	5834521	BolC9t53865H	0	+	280	2480	3145	0.7885532
C9	5839857	5841823	BolC9t53866H	0	-	619	1695	1966	0.8621567
C9	5843050	5843915	BolC9t53867H	0	+	583	865	865	1.0000000
C9	5844215	5846721	BolC9t53868H	0	-	1438	2494	2506	0.9952115
C9	5848695	5850444	BolC9t53869H	0	+	654	1707	1749	0.9759863
C9	5856099	5856572	BolC9t53870H	0	-	78	473	473	1.0000000
C9	5858473	5858845	BolC9t53871H	0	-	26	372	372	1.0000000
C9	5859789	5860326	BolC9t53872H	0	+	527	537	537	1.0000000
C9	5861973	5862579	BolC9t53873H	0	+	265	606	606	1.0000000
C9	5882970	5884726	BolC9t53874H	0	+	1595	1756	1756	1.0000000
C9	5886026	5886719	BolC9t53875H	0	-	607	693	693	1.0000000
C9	5889857	5891123	BolC9t53876H	0	+	311	1147	1266	0.9060032
C9	5891459	5892217	BolC9t53877H	0	-	1294	758	758	1.0000000
C9	5893481	5896688	BolC9t53878H	0	-	2488	3207	3207	1.0000000
C9	5897895	5898951	BolC9t53879H	0	+	492	1056	1056	1.0000000
C9	5899266	5903462	BolC9t53880H	0	-	2380	4169	4196	0.9935653
C9	5906304	5911041	BolC9t53881H	0	+	1437	4475	4737	0.9446907
C9	5912510	5916311	BolC9t53882H	0	+	147	1393	3801	0.3664825
C9	5916776	5919095	BolC9t53883H	0	-	560	2205	2319	0.9508409
C9	5920241	5922734	BolC9t53884H	0	+	639	2345	2493	0.9406338
C9	5924566	5928260	BolC9t53885H	0	+	1417	3653	3694	0.9889009
C9	5929034	5930069	BolC9t53886H	0	-	544	1035	1035	1.0000000
C9	5930723	5932671	BolC9t53887H	0	+	884	1616	1948	0.8295688
C9	5933651	5934409	BolC9t53888H	0	+	574	758	758	1.0000000
C9	5935404	5938211	BolC9t53889H	0	+	2124	2781	2807	0.9907374
C9	5952891	5954332	BolC9t53890H	0	+	234	1035	1441	0.7182512
C9	5958414	5959960	BolC9t53891H	0	-	934	1546	1546	1.0000000
C9	5976109	5978395	BolC9t53892H	0	-	552	2118	2286	0.9265092
C9	5979355	5982571	BolC9t53893H	0	-	1215	3192	3216	0.9925373
C9	5983648	5987822	BolC9t53894H	0	+	1927	4174	4174	1.0000000
C9	5998790	6001295	BolC9t53895H	0	+	1580	2505	2505	1.0000000
C9	6001617	6003867	BolC9t53896H	0	-	2935	2250	2250	1.0000000
C9	6005858	6008901	BolC9t53897H	0	+	519	2496	3043	0.8202432
C9	6009617	6009770	BolC9t53898H	0	+	260	153	153	1.0000000
C9	6018291	6018822	BolC9t53899H	0	+	51	215	531	0.4048964
C9	6029421	6030455	BolC9t53900H	0	-	1158	1034	1034	1.0000000
C9	6032198	6032928	BolC9t53901H	0	-	506	730	730	1.0000000
C9	6032949	6033258	BolC9t53902H	0	-	270	309	309	1.0000000
C9	6048387	6052667	BolC9t53903H	0	+	3167	4256	4280	0.9943925
C9	6055112	6056332	BolC9t53904H	0	-	636	1190	1220	0.9754099
C9	6062100	6064507	BolC9t53905H	0	-	1486	2304	2407	0.9572082
C9	6065430	6065670	BolC9t53906H	0	+	226	240	240	1.0000000
C9	6065904	6066490	BolC9t53907H	0	-	340	586	586	1.0000000
C9	6067124	6068787	BolC9t53908H	0	+	176	856	1663	0.5147324
C9	6069741	6071741	BolC9t53909H	0	-	51	822	2000	0.4110000
C9	6083915	6084386	BolC9t53910H	0	-	378	471	471	1.0000000
C9	6095803	6096130	BolC9t53911H	0	+	55	319	327	0.9755352
C9	6110210	6115655	BolC9t53912H	0	+	1664	5006	5445	0.9193756
C9	6131248	6134140	BolC9t53913H	0	+	1607	2892	2892	1.0000000
C9	6140608	6141815	BolC9t53914H	0	+	914	1083	1207	0.8972660
C9	6147127	6148952	BolC9t53915H	0	+	1431	1821	1825	0.9978082
C9	6153852	6164153	BolC9t53916H	0	+	13089	8766	10301	0.8509853
C9	6158382	6159987	BolC9t53917H	0	-	443	1605	1605	1.0000000
C9	6166204	6167179	BolC9t53918H	0	+	248	141	975	0.1446154
C9	6171084	6173032	BolC9t53919H	0	+	83	728	1948	0.3737166
C9	6184704	6185970	BolC9t53920H	0	+	915	1266	1266	1.0000000
C9	6188274	6188942	BolC9t53921H	0	+	1929	668	668	1.0000000
C9	6191822	6192266	BolC9t53922H	0	-	0	0	444	0.0000000
C9	6194943	6196122	BolC9t53923H	0	+	3435	1179	1179	1.0000000
C9	6198465	6200936	BolC9t53924H	0	+	691	1854	2471	0.7503035
C9	6201856	6202951	BolC9t53925H	0	-	496	1095	1095	1.0000000
C9	6205149	6205734	BolC9t53926H	0	-	60	469	585	0.8017094
C9	6231157	6232351	BolC9t53927H	0	+	2069	1194	1194	1.0000000
C9	6232952	6234431	BolC9t53928H	0	+	661	1479	1479	1.0000000
C9	6235069	6236513	BolC9t53929H	0	+	948	1444	1444	1.0000000
C9	6237273	6240755	BolC9t53930H	0	-	954	3357	3482	0.9641011
C9	6241345	6242227	BolC9t53931H	0	-	734	836	882	0.9478458
C9	6243027	6244339	BolC9t53932H	0	-	1193	1312	1312	1.0000000
C9	6251891	6252726	BolC9t53933H	0	-	393	835	835	1.0000000
C9	6256299	6256485	BolC9t53934H	0	+	36	186	186	1.0000000
C9	6271223	6272746	BolC9t53935H	0	-	734	1355	1523	0.8896914
C9	6273119	6276498	BolC9t53936H	0	-	1588	3298	3379	0.9760284
C9	6277288	6278506	BolC9t53937H	0	+	827	1196	1218	0.9819376
C9	6287255	6287648	BolC9t53938H	0	+	55	321	393	0.8167939
C9	6289720	6290174	BolC9t53939H	0	-	0	0	454	0.0000000
C9	6291450	6292407	BolC9t53940H	0	+	118	530	957	0.5538140
C9	6300720	6300942	BolC9t53941H	0	-	45	179	222	0.8063063
C9	6309821	6311382	BolC9t53942H	0	+	370	1561	1561	1.0000000
C9	6331904	6334034	BolC9t53943H	0	+	223	1150	2130	0.5399061
C9	6338513	6339958	BolC9t53944H	0	+	634	1386	1445	0.9591696
C9	6340857	6341298	BolC9t53945H	0	-	176	441	441	1.0000000
C9	6351226	6351973	BolC9t53946H	0	-	34	325	747	0.4350736
C9	6362355	6363437	BolC9t53947H	0	-	1	92	1082	0.0850277
C9	6368771	6369182	BolC9t53948H	0	-	189	411	411	1.0000000
C9	6375827	6379449	BolC9t53949H	0	-	955	2732	3622	0.7542794
C9	6389656	6390424	BolC9t53950H	0	+	129	754	768	0.9817708
C9	6392788	6393007	BolC9t53951H	0	-	194	219	219	1.0000000
C9	6399495	6401622	BolC9t53952H	0	-	535	2090	2127	0.9826046
C9	6405626	6407583	BolC9t53953H	0	-	453	1912	1957	0.9770056
C9	6409912	6410502	BolC9t53954H	0	+	397	590	590	1.0000000
C9	6411426	6414388	BolC9t53955H	0	-	672	2523	2962	0.8517894
C9	6415153	6415747	BolC9t53956H	0	-	65	442	594	0.7441077
C9	6419229	6420474	BolC9t53957H	0	+	82	633	1245	0.5084338
C9	6421083	6422535	BolC9t53958H	0	-	421	1190	1452	0.8195592
C9	6433341	6434190	BolC9t53959H	0	-	277	658	849	0.7750294
C9	6453889	6455163	BolC9t53960H	0	-	435	1029	1274	0.8076923
C9	6479942	6480955	BolC9t53961H	0	-	287	874	1013	0.8627838
C9	6502650	6505699	BolC9t53962H	0	+	956	2825	3049	0.9265333
C9	6515625	6516996	BolC9t53963H	0	+	98	997	1371	0.7272064
C9	6518381	6522183	BolC9t53964H	0	+	284	1922	3802	0.5055234
C9	6537231	6538606	BolC9t53965H	0	+	123	1081	1375	0.7861818
C9	6550850	6551225	BolC9t53966H	0	+	69	353	375	0.9413334
C9	6554366	6555967	BolC9t53967H	0	-	107	1312	1601	0.8194878
C9	6560683	6561875	BolC9t53968H	0	-	357	996	1192	0.8355705
C9	6563107	6563941	BolC9t53969H	0	-	181	739	834	0.8860911
C9	6571337	6572850	BolC9t53970H	0	-	1649	1513	1513	1.0000000
C9	6581188	6581378	BolC9t53971H	0	-	123	190	190	1.0000000
C9	6581626	6582958	BolC9t53972H	0	-	196	1233	1332	0.9256757
C9	6584777	6584993	BolC9t53973H	0	+	116	216	216	1.0000000
C9	6585179	6585931	BolC9t53974H	0	+	343	729	752	0.9694149
C9	6587848	6588783	BolC9t53975H	0	+	126	927	935	0.9914439
C9	6589705	6590606	BolC9t53976H	0	-	669	901	901	1.0000000
C9	6591171	6592377	BolC9t53977H	0	+	578	1206	1206	1.0000000
C9	6592825	6593666	BolC9t53978H	0	-	691	841	841	1.0000000
C9	6596870	6597642	BolC9t53979H	0	+	443	772	772	1.0000000
C9	6599981	6601566	BolC9t53980H	0	-	1262	1426	1585	0.8996845
C9	6613946	6615539	BolC9t53981H	0	-	627	1593	1593	1.0000000
C9	6630113	6630809	BolC9t53982H	0	+	122	696	696	1.0000000
C9	6635282	6637412	BolC9t53983H	0	+	699	1921	2130	0.9018779
C9	6639378	6640230	BolC9t53984H	0	+	2	46	852	0.0539906
C9	6641327	6642136	BolC9t53985H	0	+	73	612	809	0.7564895
C9	6655856	6657790	BolC9t53986H	0	+	567	1906	1934	0.9855222
C9	6658098	6659727	BolC9t53987H	0	-	254	1413	1629	0.8674033
C9	6670029	6670995	BolC9t53988H	0	-	81	443	966	0.4585921
C9	6678454	6679071	BolC9t53989H	0	+	3	130	617	0.2106969
C9	6679914	6680248	BolC9t53990H	0	-	725	334	334	1.0000000
C9	6682908	6683273	BolC9t53991H	0	-	438	365	365	1.0000000
C9	6692162	6692339	BolC9t53992H	0	-	1	67	177	0.3785311
C9	6707796	6709528	BolC9t53993H	0	+	1402	1721	1732	0.9936489
C9	6733751	6736025	BolC9t53994H	0	+	1331	2107	2274	0.9265611
C9	6737139	6737355	BolC9t53995H	0	-	602	216	216	1.0000000
C9	6738175	6740452	BolC9t53996H	0	+	1306	2277	2277	1.0000000
C9	6742492	6744739	BolC9t53997H	0	+	1800	2247	2247	1.0000000
C9	6789043	6791323	BolC9t53998H	0	+	1663	2280	2280	1.0000000
C9	6799185	6800040	BolC9t53999H	0	+	253	808	855	0.9450293
C9	6801285	6804305	BolC9t54000H	0	-	565	1929	3020	0.6387417
C9	6805875	6809475	BolC9t54001H	0	-	1271	3330	3600	0.9250000
C9	6812562	6814257	BolC9t54002H	0	+	320	1695	1695	1.0000000
C9	6815289	6816864	BolC9t54003H	0	+	300	1550	1575	0.9841270
C9	6819713	6820368	BolC9t54004H	0	-	332	577	655	0.8809161
C9	6821147	6822407	BolC9t54005H	0	+	298	816	1260	0.6476191
C9	6826082	6827603	BolC9t54006H	0	+	233	1322	1521	0.8691650
C9	6827963	6828890	BolC9t54007H	0	-	431	927	927	1.0000000
C9	6850244	6854477	BolC9t54008H	0	+	1824	3688	4233	0.8712497
C9	6854905	6856105	BolC9t54009H	0	+	299	1104	1200	0.9200000
C9	6857407	6857677	BolC9t54010H	0	+	16	159	270	0.5888889
C9	6862540	6863166	BolC9t54011H	0	-	5	126	626	0.2012780
C9	6864831	6867259	BolC9t54012H	0	+	1503	2407	2428	0.9913509
C9	6870607	6871147	BolC9t54013H	0	+	18	193	540	0.3574074
C9	6873074	6874881	BolC9t54014H	0	-	944	1807	1807	1.0000000
C9	6876172	6877528	BolC9t54015H	0	+	403	1338	1356	0.9867257
C9	6878614	6878983	BolC9t54016H	0	-	96	366	369	0.9918699
C9	6880165	6880780	BolC9t54017H	0	-	175	453	615	0.7365854
C9	6887558	6889295	BolC9t54018H	0	+	108	1465	1737	0.8434082
C9	6890756	6891900	BolC9t54019H	0	+	17	99	1144	0.0865385
C9	6894886	6897956	BolC9t54020H	0	+	1290	3026	3070	0.9856678
C9	6898872	6899984	BolC9t54021H	0	+	528	1112	1112	1.0000000
C9	6900373	6900637	BolC9t54022H	0	-	105	264	264	1.0000000
C9	6901588	6902741	BolC9t54023H	0	-	98	904	1153	0.7840416
C9	6906484	6909966	BolC9t54024H	0	+	668	2928	3482	0.8408960
C9	6910174	6912769	BolC9t54025H	0	-	155	2012	2595	0.7753372
C9	6916638	6917289	BolC9t54026H	0	+	509	651	651	1.0000000
C9	6917667	6919102	BolC9t54027H	0	-	1570	1435	1435	1.0000000
C9	6920167	6922045	BolC9t54028H	0	+	33	937	1878	0.4989350
C9	6938177	6938813	BolC9t54029H	0	-	259	370	636	0.5817610
C9	6941292	6943526	BolC9t54030H	0	-	130	1459	2234	0.6530886
C9	6945686	6971069	BolC9t54031H	0	+	7658	19936	25383	0.7854075
C9	6962162	6962871	BolC9t54032H	0	+	398	709	709	1.0000000
C9	6962967	6965410	BolC9t54033H	0	+	1174	2365	2443	0.9680721
C9	6972955	6974593	BolC9t54034H	0	+	812	1591	1638	0.9713064
C9	6975975	6976251	BolC9t54035H	0	+	0	0	276	0.0000000
C9	6976899	6977907	BolC9t54036H	0	-	921	1008	1008	1.0000000
C9	6981386	6982541	BolC9t54037H	0	+	1246	1155	1155	1.0000000
C9	6985658	6986153	BolC9t54038H	0	-	112	491	495	0.9919192
C9	6990194	6992335	BolC9t54039H	0	+	869	2053	2141	0.9588977
C9	7004931	7005162	BolC9t54040H	0	-	0	0	231	0.0000000
C9	7008400	7009986	BolC9t54041H	0	+	573	732	1586	0.4615385
C9	7012884	7013184	BolC9t54042H	0	-	1	35	300	0.1166667
C9	7016283	7016855	BolC9t54043H	0	+	322	572	572	1.0000000
C9	7037485	7038140	BolC9t54044H	0	-	79	429	655	0.6549618
C9	7041171	7041536	BolC9t54045H	0	-	323	365	365	1.0000000
C9	7043420	7045674	BolC9t54046H	0	-	190	1819	2254	0.8070098
C9	7050938	7054780	BolC9t54047H	0	-	426	2674	3842	0.6959917
C9	7055239	7055599	BolC9t54048H	0	+	88	360	360	1.0000000
C9	7071924	7072332	BolC9t54049H	0	-	12	76	408	0.1862745
C9	7077211	7077469	BolC9t54050H	0	+	642	258	258	1.0000000
C9	7078128	7079771	BolC9t54051H	0	-	118	1055	1643	0.6421181
C9	7082083	7085854	BolC9t54052H	0	-	1080	3185	3771	0.8446035
C9	7086299	7089327	BolC9t54053H	0	-	1013	3002	3028	0.9914135
C9	7093652	7095590	BolC9t54054H	0	+	651	1938	1938	1.0000000
C9	7095807	7097951	BolC9t54055H	0	-	391	2088	2144	0.9738806
C9	7100610	7100970	BolC9t54056H	0	-	84	325	360	0.9027778
C9	7102071	7103169	BolC9t54057H	0	-	451	1025	1098	0.9335155
C9	7135936	7136880	BolC9t54058H	0	-	67	881	944	0.9332627
C9	7150034	7151480	BolC9t54059H	0	-	798	1434	1446	0.9917012
C9	7163526	7166157	BolC9t54060H	0	+	1189	2574	2631	0.9783353
C9	7167407	7168628	BolC9t54061H	0	+	183	948	1221	0.7764128
C9	7190223	7190367	BolC9t54062H	0	+	117	144	144	1.0000000
C9	7190816	7191873	BolC9t54063H	0	+	57	290	1057	0.2743614
C9	7192671	7195029	BolC9t54064H	0	-	2741	2358	2358	1.0000000
C9	7201789	7211154	BolC9t54065H	0	-	1961	3211	9365	0.3428724
C9	7215460	7251336	BolC9t54066H	0	-	10587	26700	35876	0.7442302
C9	7254208	7257770	BolC9t54067H	0	+	1442	3321	3562	0.9323414
C9	7258035	7258578	BolC9t54068H	0	-	72	431	543	0.7937385
C9	7260012	7260480	BolC9t54069H	0	-	115	424	468	0.9059829
C9	7262730	7264188	BolC9t54070H	0	-	255	1383	1458	0.9485596
C9	7266255	7267698	BolC9t54071H	0	+	704	1443	1443	1.0000000
C9	7273627	7276318	BolC9t54072H	0	+	1390	2683	2691	0.9970271
C9	7281371	7286737	BolC9t54073H	0	+	2210	4942	5366	0.9209840
C9	7287434	7291772	BolC9t54074H	0	+	1136	4263	4338	0.9827109
C9	7312219	7312972	BolC9t54075H	0	+	41	394	753	0.5232404
C9	7315233	7315563	BolC9t54076H	0	+	260	330	330	1.0000000
C9	7316045	7319650	BolC9t54077H	0	-	1621	3366	3605	0.9337032
C9	7320608	7322516	BolC9t54078H	0	-	227	1671	1908	0.8757862
C9	7324405	7325167	BolC9t54079H	0	+	538	762	762	1.0000000
C9	7325733	7327448	BolC9t54080H	0	-	966	1715	1715	1.0000000
C9	7328737	7330268	BolC9t54081H	0	-	303	1076	1531	0.7028086
C9	7334279	7334912	BolC9t54082H	0	-	162	633	633	1.0000000
C9	7336904	7337481	BolC9t54083H	0	+	420	577	577	1.0000000
C9	7341083	7341475	BolC9t54084H	0	-	244	392	392	1.0000000
C9	7342262	7343194	BolC9t54085H	0	-	209	850	932	0.9120172
C9	7344485	7345630	BolC9t54086H	0	-	457	1145	1145	1.0000000
C9	7348602	7351329	BolC9t54087H	0	+	828	2576	2727	0.9446278
C9	7352150	7353932	BolC9t54088H	0	+	845	1738	1782	0.9753087
C9	7354860	7360293	BolC9t54089H	0	+	1204	4823	5433	0.8877231
C9	7362740	7363025	BolC9t54090H	0	+	0	0	285	0.0000000
C9	7363402	7364550	BolC9t54091H	0	+	1	127	1148	0.1106272
C9	7367296	7369898	BolC9t54092H	0	-	502	2022	2602	0.7770945
C9	7370163	7372046	BolC9t54093H	0	+	251	1712	1883	0.9091875
C9	7372975	7374752	BolC9t54094H	0	-	1033	1777	1777	1.0000000
C9	7375696	7379283	BolC9t54095H	0	-	1129	3431	3587	0.9565096
C9	7379507	7381226	BolC9t54096H	0	+	405	1665	1719	0.9685864
C9	7387604	7388534	BolC9t54097H	0	+	403	930	930	1.0000000
C9	7396568	7396766	BolC9t54098H	0	-	326	198	198	1.0000000
C9	7408023	7410150	BolC9t54099H	0	+	1309	2127	2127	1.0000000
C9	7410716	7411362	BolC9t54100H	0	-	182	646	646	1.0000000
C9	7411851	7420203	BolC9t54101H	0	+	1354	7025	8352	0.8411159
C9	7421994	7423212	BolC9t54102H	0	-	509	1153	1218	0.9466338
C9	7428824	7430820	BolC9t54103H	0	-	53	646	1996	0.3236473
C9	7432687	7434515	BolC9t54104H	0	-	556	1817	1828	0.9939825
C9	7436001	7437609	BolC9t54105H	0	-	887	1608	1608	1.0000000
C9	7442551	7448772	BolC9t54106H	0	+	902	5233	6221	0.8411831
C9	7452593	7452897	BolC9t54107H	0	+	145	304	304	1.0000000
C9	7453128	7453860	BolC9t54108H	0	+	218	732	732	1.0000000
C9	7481644	7482427	BolC9t54109H	0	-	82	446	783	0.5696041
C9	7487737	7488973	BolC9t54110H	0	-	5	119	1236	0.0962783
C9	7489430	7490135	BolC9t54111H	0	-	28	41	705	0.0581560
C9	7525185	7525302	BolC9t54112H	0	-	309	117	117	1.0000000
C9	7525530	7526565	BolC9t54113H	0	+	1152	872	1035	0.8425121
C9	7528902	7530958	BolC9t54114H	0	+	122	1714	2056	0.8336576
C9	7535802	7538412	BolC9t54115H	0	+	371	2439	2610	0.9344828
C9	7540727	7543649	BolC9t54116H	0	+	190	2061	2922	0.7053388
C9	7548515	7551228	BolC9t54117H	0	+	409	1864	2713	0.6870623
C9	7559615	7560849	BolC9t54118H	0	-	283	1197	1234	0.9700162
C9	7563545	7566116	BolC9t54119H	0	-	545	2306	2571	0.8969272
C9	7577620	7578079	BolC9t54120H	0	+	143	458	459	0.9978213
C9	7581565	7583792	BolC9t54121H	0	-	1079	1984	2227	0.8908846
C9	7597343	7599581	BolC9t54122H	0	+	742	2046	2238	0.9142091
C9	7615135	7616227	BolC9t54123H	0	-	113	1022	1092	0.9358974
C9	7629656	7630883	BolC9t54124H	0	-	15	399	1227	0.3251834
C9	7632961	7634923	BolC9t54125H	0	-	394	1740	1962	0.8868502
C9	7653212	7662952	BolC9t54126H	0	-	1398	6754	9740	0.6934292
C9	7666154	7668760	BolC9t54127H	0	-	1431	2596	2606	0.9961627
C9	7681015	7685848	BolC9t54128H	0	+	806	4305	4833	0.8907511
C9	7686298	7686925	BolC9t54129H	0	-	52	430	627	0.6858054
C9	7688934	7691469	BolC9t54130H	0	+	142	1570	2535	0.6193294
C9	7693139	7703407	BolC9t54131H	0	+	333	3964	10268	0.3860538
C9	7704571	7708550	BolC9t54132H	0	+	1640	3923	3979	0.9859261
C9	7710989	7711232	BolC9t54133H	0	+	137	243	243	1.0000000
C9	7711798	7713552	BolC9t54134H	0	-	16	105	1754	0.0598632
C9	7716726	7720662	BolC9t54135H	0	+	1520	3297	3936	0.8376524
C9	7721742	7722888	BolC9t54136H	0	+	749	1146	1146	1.0000000
C9	7729923	7732455	BolC9t54137H	0	+	523	1873	2532	0.7397314
C9	7754580	7757538	BolC9t54138H	0	+	709	2755	2958	0.9313725
C9	7761766	7763043	BolC9t54139H	0	+	362	1268	1277	0.9929522
C9	7776940	7778778	BolC9t54140H	0	-	117	1263	1838	0.6871600
C9	7804262	7804540	BolC9t54141H	0	-	13	278	278	1.0000000
C9	7832589	7832727	BolC9t54142H	0	-	98	138	138	1.0000000
C9	7836066	7838754	BolC9t54143H	0	-	821	2312	2688	0.8601190
C9	7843380	7844130	BolC9t54144H	0	+	142	687	750	0.9160000
C9	7844853	7847988	BolC9t54145H	0	+	1673	2723	3135	0.8685805
C9	7851035	7851311	BolC9t54146H	0	-	5	273	276	0.9891304
C9	7864560	7867207	BolC9t54147H	0	+	0	0	2647	0.0000000
C9	7884300	7886944	BolC9t54148H	0	+	2	20	2644	0.0075643
C9	7903890	7906597	BolC9t54149H	0	+	181	1896	2707	0.7004064
C9	7909908	7910718	BolC9t54150H	0	+	198	794	810	0.9802469
C9	7911143	7912278	BolC9t54151H	0	-	144	948	1135	0.8352423
C9	7915766	7916770	BolC9t54152H	0	-	127	926	1004	0.9223108
C9	7920344	7921577	BolC9t54153H	0	+	333	1186	1233	0.9618816
C9	7928798	7929348	BolC9t54154H	0	+	93	531	550	0.9654545
C9	7936125	7937885	BolC9t54155H	0	-	196	1630	1760	0.9261364
C9	7940211	7942325	BolC9t54156H	0	-	16	434	2114	0.2052980
C9	7961909	7964421	BolC9t54157H	0	-	982	2512	2512	1.0000000
C9	7965253	7966445	BolC9t54158H	0	-	423	1192	1192	1.0000000
C9	7969091	7971941	BolC9t54159H	0	+	722	2421	2850	0.8494737
C9	7983080	7984244	BolC9t54160H	0	-	4	282	1164	0.2422680
C9	7993804	7994509	BolC9t54161H	0	+	135	705	705	1.0000000
C9	7998246	7999209	BolC9t54162H	0	-	548	963	963	1.0000000
C9	8012298	8014472	BolC9t54163H	0	+	1053	2107	2174	0.9691812
C9	8018613	8019237	BolC9t54164H	0	+	82	624	624	1.0000000
C9	8023630	8025644	BolC9t54165H	0	+	262	1945	2014	0.9657398
C9	8026666	8027179	BolC9t54166H	0	+	0	0	513	0.0000000
C9	8040341	8040521	BolC9t54167H	0	-	10	19	180	0.1055556
C9	8047386	8047956	BolC9t54168H	0	+	1	79	570	0.1385965
C9	8048401	8048730	BolC9t54169H	0	-	322	329	329	1.0000000
C9	8058840	8060098	BolC9t54170H	0	+	276	821	1258	0.6526232
C9	8067865	8068774	BolC9t54171H	0	-	6	264	909	0.2904291
C9	8072719	8073754	BolC9t54172H	0	-	793	1035	1035	1.0000000
C9	8087313	8087556	BolC9t54173H	0	+	3	14	243	0.0576132
C9	8104162	8104425	BolC9t54174H	0	-	40	209	263	0.7946768
C9	8109323	8110274	BolC9t54175H	0	-	640	951	951	1.0000000
C9	8116809	8118058	BolC9t54176H	0	-	38	870	1249	0.6965572
C9	8118985	8120066	BolC9t54177H	0	-	169	810	1081	0.7493062
C9	8129325	8129741	BolC9t54178H	0	+	4	72	416	0.1730769
C9	8131234	8131648	BolC9t54179H	0	-	67	390	414	0.9420290
C9	8131998	8135079	BolC9t54180H	0	-	81	1143	3081	0.3709835
C9	8146187	8146349	BolC9t54181H	0	-	10	162	162	1.0000000
C9	8147468	8147732	BolC9t54182H	0	-	39	264	264	1.0000000
C9	8160363	8161899	BolC9t54183H	0	+	498	1318	1536	0.8580729
C9	8162344	8163620	BolC9t54184H	0	-	420	1272	1276	0.9968652
C9	8170119	8171307	BolC9t54185H	0	+	838	1188	1188	1.0000000
C9	8182337	8183627	BolC9t54186H	0	-	817	1290	1290	1.0000000
C9	8196282	8196798	BolC9t54187H	0	-	427	516	516	1.0000000
C9	8198165	8198801	BolC9t54188H	0	-	427	636	636	1.0000000
C9	8203826	8206346	BolC9t54189H	0	-	419	1680	2520	0.6666667
C9	8207832	8208165	BolC9t54190H	0	-	233	333	333	1.0000000
C9	8213449	8213659	BolC9t54191H	0	-	245	210	210	1.0000000
C9	8215899	8217279	BolC9t54192H	0	-	550	1359	1380	0.9847826
C9	8222407	8222560	BolC9t54193H	0	+	17	94	153	0.6143791
C9	8224259	8224845	BolC9t54194H	0	+	230	586	586	1.0000000
C9	8225597	8233632	BolC9t54195H	0	-	854	5078	8035	0.6319851
C9	8235970	8239507	BolC9t54196H	0	+	1181	3497	3537	0.9886910
C9	8239866	8241265	BolC9t54197H	0	-	427	1368	1399	0.9778413
C9	8243675	8244191	BolC9t54198H	0	+	61	376	516	0.7286822
C9	8255636	8256794	BolC9t54199H	0	+	217	1107	1158	0.9559585
C9	8259038	8264018	BolC9t54200H	0	-	823	2739	4980	0.5500000
C9	8289316	8290227	BolC9t54201H	0	-	0	0	911	0.0000000
C9	8291020	8291836	BolC9t54202H	0	-	0	0	816	0.0000000
C9	8295043	8295444	BolC9t54203H	0	+	258	401	401	1.0000000
C9	8296576	8296864	BolC9t54204H	0	-	214	288	288	1.0000000
C9	8299213	8303592	BolC9t54205H	0	+	1952	4264	4379	0.9737383
C9	8305363	8306191	BolC9t54206H	0	+	111	571	828	0.6896135
C9	8306716	8308590	BolC9t54207H	0	-	379	1573	1874	0.8393810
C9	8315524	8316209	BolC9t54208H	0	-	341	539	685	0.7868613
C9	8319973	8321241	BolC9t54209H	0	+	364	1139	1268	0.8982650
C9	8331350	8337348	BolC9t54210H	0	+	764	3786	5998	0.6312104
C9	8340059	8347313	BolC9t54211H	0	+	5830	7200	7254	0.9925559
C9	8357370	8357730	BolC9t54212H	0	+	222	360	360	1.0000000
C9	8358647	8358905	BolC9t54213H	0	-	191	258	258	1.0000000
C9	8369844	8371136	BolC9t54214H	0	-	1102	1292	1292	1.0000000
C9	8379172	8381598	BolC9t54215H	0	-	689	2422	2426	0.9983512
C9	8383674	8384799	BolC9t54216H	0	-	17	413	1125	0.3671111
C9	8391035	8392056	BolC9t54217H	0	+	22	664	1021	0.6503428
C9	8395267	8397540	BolC9t54218H	0	-	193	1733	2273	0.7624285
C9	8400732	8403494	BolC9t54219H	0	-	991	2668	2762	0.9659667
C9	8404737	8406630	BolC9t54220H	0	-	593	1630	1893	0.8610671
C9	8411595	8414661	BolC9t54221H	0	+	1015	3038	3066	0.9908676
C9	8415766	8416879	BolC9t54222H	0	+	218	718	1113	0.6451033
C9	8422310	8424724	BolC9t54223H	0	+	557	1871	2414	0.7750621
C9	8434289	8435577	BolC9t54224H	0	-	523	1206	1288	0.9363354
C9	8438124	8438890	BolC9t54225H	0	+	410	766	766	1.0000000
C9	8440065	8440302	BolC9t54226H	0	-	206	237	237	1.0000000
C9	8443009	8443995	BolC9t54227H	0	-	665	986	986	1.0000000
C9	8469193	8481416	BolC9t54228H	0	+	6158	11868	12223	0.9709564
C9	8483078	8485845	BolC9t54229H	0	+	669	2264	2767	0.8182147
C9	8492395	8494193	BolC9t54230H	0	+	399	1756	1798	0.9766407
C9	8496641	8499676	BolC9t54231H	0	-	1282	2721	3035	0.8965403
C9	8504535	8504718	BolC9t54232H	0	-	377	183	183	1.0000000
C9	8523084	8525058	BolC9t54233H	0	+	795	1778	1974	0.9007092
C9	8525984	8532379	BolC9t54234H	0	-	2778	5616	6395	0.8781861
C9	8536787	8537590	BolC9t54235H	0	-	560	803	803	1.0000000
C9	8539424	8539924	BolC9t54236H	0	+	18	406	500	0.8120000
C9	8542073	8543987	BolC9t54237H	0	+	1164	1914	1914	1.0000000
C9	8546891	8548130	BolC9t54238H	0	+	529	1239	1239	1.0000000
C9	8550973	8551183	BolC9t54239H	0	+	7	137	210	0.6523809
C9	8553164	8554532	BolC9t54240H	0	+	424	1368	1368	1.0000000
C9	8571108	8572366	BolC9t54241H	0	+	0	0	1258	0.0000000
C9	8574227	8575094	BolC9t54242H	0	+	85	813	867	0.9377162
C9	8578739	8580843	BolC9t54243H	0	-	747	1880	2104	0.8935362
C9	8582760	8586771	BolC9t54244H	0	-	875	3441	4011	0.8578908
C9	8600169	8600541	BolC9t54245H	0	+	12	235	372	0.6317204
C9	8601094	8601369	BolC9t54246H	0	+	95	275	275	1.0000000
C9	8616315	8616960	BolC9t54247H	0	+	148	585	645	0.9069768
C9	8618581	8619052	BolC9t54248H	0	+	556	471	471	1.0000000
C9	8629284	8630908	BolC9t54249H	0	+	486	1624	1624	1.0000000
C9	8638459	8640605	BolC9t54250H	0	+	1601	2145	2146	0.9995340
C9	8648918	8649783	BolC9t54251H	0	+	489	865	865	1.0000000
C9	8655880	8657567	BolC9t54252H	0	-	411	1552	1687	0.9199763
C9	8659081	8659638	BolC9t54253H	0	+	449	557	557	1.0000000
C9	8661598	8662734	BolC9t54254H	0	+	795	1136	1136	1.0000000
C9	8677319	8677796	BolC9t54255H	0	-	88	445	477	0.9329140
C9	8685437	8701562	BolC9t54256H	0	-	1251	9000	16125	0.5581396
C9	8708619	8710321	BolC9t54257H	0	-	98	953	1702	0.5599295
C9	8742549	8742908	BolC9t54258H	0	+	33	216	359	0.6016713
C9	8743636	8743951	BolC9t54259H	0	+	11	231	315	0.7333333
C9	8751728	8751878	BolC9t54260H	0	+	22	119	150	0.7933334
C9	8755078	8755405	BolC9t54261H	0	+	7	134	327	0.4097859
C9	8760402	8767510	BolC9t54262H	0	+	1183	3187	7108	0.4483680
C9	8768644	8769628	BolC9t54263H	0	+	189	962	984	0.9776423
C9	8772202	8772777	BolC9t54264H	0	+	71	520	575	0.9043478
C9	8782448	8784752	BolC9t54265H	0	+	282	1878	2304	0.8151042
C9	8789982	8803199	BolC9t54266H	0	+	1599	7398	13217	0.5597337
C9	8804328	8806248	BolC9t54267H	0	-	184	1118	1920	0.5822917
C9	8807825	8809317	BolC9t54268H	0	+	546	1152	1492	0.7721180
C9	8823145	8824380	BolC9t54269H	0	+	17	353	1235	0.2858300
C9	8837938	8838445	BolC9t54270H	0	-	26	355	507	0.7001972
C9	8838598	8838724	BolC9t54271H	0	-	28	126	126	1.0000000
C9	8857005	8859132	BolC9t54272H	0	-	445	1650	2127	0.7757405
C9	8864327	8865284	BolC9t54273H	0	-	618	957	957	1.0000000
C9	8873928	8874348	BolC9t54274H	0	+	66	367	420	0.8738095
C9	8874863	8874965	BolC9t54275H	0	+	121	87	102	0.8529412
C9	8883142	8884706	BolC9t54276H	0	-	571	1412	1564	0.9028133
C9	8898667	8913284	BolC9t54277H	0	+	5823	12052	14617	0.8245194
C9	8919965	8920067	BolC9t54278H	0	-	188	102	102	1.0000000
C9	8923035	8924324	BolC9t54279H	0	-	518	1289	1289	1.0000000
C9	8926334	8926800	BolC9t54280H	0	-	450	466	466	1.0000000
C9	8930179	8931848	BolC9t54281H	0	+	668	1669	1669	1.0000000
C9	8932393	8933485	BolC9t54282H	0	+	613	1020	1092	0.9340659
C9	8952838	8954251	BolC9t54283H	0	+	20	533	1413	0.3772116
C9	8955957	8956262	BolC9t54284H	0	+	92	305	305	1.0000000
C9	8961617	8962148	BolC9t54285H	0	+	182	472	531	0.8888889
C9	8967434	8968250	BolC9t54286H	0	-	93	677	816	0.8296568
C9	8983747	8983939	BolC9t54287H	0	-	383	192	192	1.0000000
C9	8996553	8998901	BolC9t54288H	0	-	1116	2348	2348	1.0000000
C9	9003670	9003887	BolC9t54289H	0	-	0	0	217	0.0000000
C9	9004040	9004530	BolC9t54290H	0	-	50	182	490	0.3714286
C9	9006073	9006424	BolC9t54291H	0	+	54	318	351	0.9059829
C9	9011082	9012098	BolC9t54292H	0	-	258	968	1016	0.9527559
C9	9017962	9018253	BolC9t54293H	0	-	227	291	291	1.0000000
C9	9023686	9023996	BolC9t54294H	0	+	298	310	310	1.0000000
C9	9024351	9030775	BolC9t54295H	0	-	2416	6208	6424	0.9663761
C9	9032573	9034178	BolC9t54296H	0	+	41	591	1605	0.3682243
C9	9037952	9038242	BolC9t54297H	0	-	0	0	290	0.0000000
C9	9038582	9039425	BolC9t54298H	0	-	30	475	843	0.5634638
C9	9041926	9042496	BolC9t54299H	0	-	0	0	570	0.0000000
C9	9059813	9060146	BolC9t54300H	0	+	0	0	333	0.0000000
C9	9064697	9065769	BolC9t54301H	0	-	2	52	1072	0.0485075
C9	9068013	9069626	BolC9t54302H	0	-	19	427	1613	0.2647241
C9	9087878	9089759	BolC9t54303H	0	-	885	1516	1881	0.8059543
C9	9090282	9091542	BolC9t54304H	0	-	118	706	1260	0.5603175
C9	9092635	9096238	BolC9t54305H	0	-	644	2330	3603	0.6466833
C9	9137632	9139107	BolC9t54306H	0	-	344	1053	1475	0.7138983
C9	9150298	9151543	BolC9t54307H	0	-	805	1245	1245	1.0000000
C9	9185278	9185905	BolC9t54308H	0	-	885	627	627	1.0000000
C9	9195393	9196324	BolC9t54309H	0	+	222	931	931	1.0000000
C9	9198710	9200062	BolC9t54310H	0	-	882	1331	1352	0.9844674
C9	9203711	9204866	BolC9t54311H	0	+	370	1155	1155	1.0000000
C9	9207348	9208458	BolC9t54312H	0	-	202	863	1110	0.7774775
C9	9211750	9212974	BolC9t54313H	0	-	104	1018	1224	0.8316994
C9	9217765	9218395	BolC9t54314H	0	+	6	38	630	0.0603175
C9	9232449	9233409	BolC9t54315H	0	+	84	414	960	0.4312500
C9	9236672	9237871	BolC9t54316H	0	-	1045	1199	1199	1.0000000
C9	9266308	9269063	BolC9t54317H	0	+	87	1646	2755	0.5974591
C9	9273010	9275931	BolC9t54318H	0	+	1498	2793	2921	0.9561794
C9	9282098	9283548	BolC9t54319H	0	+	1007	1450	1450	1.0000000
C9	9291596	9292335	BolC9t54320H	0	-	21	380	739	0.5142084
C9	9295227	9295498	BolC9t54321H	0	+	0	0	271	0.0000000
C9	9316669	9317665	BolC9t54322H	0	+	911	996	996	1.0000000
C9	9318887	9322085	BolC9t54323H	0	+	877	2730	3198	0.8536586
C9	9324898	9325464	BolC9t54324H	0	+	334	566	566	1.0000000
C9	9325728	9327474	BolC9t54325H	0	-	28	189	1746	0.1082474
C9	9329724	9330408	BolC9t54326H	0	-	721	684	684	1.0000000
C9	9330786	9331180	BolC9t54327H	0	-	847	394	394	1.0000000
C9	9340249	9342811	BolC9t54328H	0	+	703	2399	2562	0.9363778
C9	9351222	9351523	BolC9t54329H	0	+	7	81	301	0.2691030
C9	9361227	9364245	BolC9t54330H	0	+	221	1665	3018	0.5516899
C9	9372845	9372992	BolC9t54331H	0	-	17	147	147	1.0000000
C9	9375447	9379885	BolC9t54332H	0	-	2833	4436	4438	0.9995493
C9	9379996	9380270	BolC9t54333H	0	-	196	274	274	1.0000000
C9	9380891	9381910	BolC9t54334H	0	-	96	825	1019	0.8096173
C9	9390327	9390534	BolC9t54335H	0	+	271	207	207	1.0000000
C9	9406780	9409029	BolC9t54336H	0	-	516	1403	2249	0.6238328
C9	9409892	9412634	BolC9t54337H	0	-	1744	2742	2742	1.0000000
C9	9412632	9413841	BolC9t54338H	0	+	843	1134	1209	0.9379653
C9	9438439	9443792	BolC9t54339H	0	+	450	3716	5353	0.6941901
C9	9450483	9450993	BolC9t54340H	0	-	14	131	510	0.2568628
C9	9454881	9455253	BolC9t54341H	0	+	21	372	372	1.0000000
C9	9473582	9473903	BolC9t54342H	0	+	183	321	321	1.0000000
C9	9479204	9479807	BolC9t54343H	0	+	591	603	603	1.0000000
C9	9487861	9488882	BolC9t54344H	0	+	424	988	1021	0.9676787
C9	9492240	9493574	BolC9t54345H	0	+	1319	1334	1334	1.0000000
C9	9501408	9503502	BolC9t54346H	0	-	164	1631	2094	0.7788921
C9	9509737	9511369	BolC9t54347H	0	+	733	1629	1632	0.9981618
C9	9511630	9514300	BolC9t54348H	0	-	381	2508	2670	0.9393259
C9	9521875	9524347	BolC9t54349H	0	+	254	1823	2472	0.7374595
C9	9526334	9527753	BolC9t54350H	0	+	320	1419	1419	1.0000000
C9	9528701	9529166	BolC9t54351H	0	-	95	373	465	0.8021505
C9	9550688	9553048	BolC9t54352H	0	+	1404	2263	2360	0.9588983
C9	9553556	9556807	BolC9t54353H	0	-	660	2858	3251	0.8791141
C9	9567751	9568538	BolC9t54354H	0	+	201	736	787	0.9351969
C9	9568602	9569945	BolC9t54355H	0	+	250	1042	1343	0.7758749
C9	9572010	9574247	BolC9t54356H	0	+	893	2189	2237	0.9785427
C9	9575895	9576402	BolC9t54357H	0	+	0	0	507	0.0000000
C9	9578568	9579453	BolC9t54358H	0	+	556	746	885	0.8429378
C9	9580374	9582435	BolC9t54359H	0	+	229	1851	2061	0.8981077
C9	9584400	9587283	BolC9t54360H	0	-	1081	2501	2883	0.8674991
C9	9597879	9598148	BolC9t54361H	0	-	159	269	269	1.0000000
C9	9598180	9598907	BolC9t54362H	0	+	483	727	727	1.0000000
C9	9600091	9600256	BolC9t54363H	0	+	97	165	165	1.0000000
C9	9602792	9605739	BolC9t54364H	0	+	1028	2722	2947	0.9236512
C9	9606385	9608789	BolC9t54365H	0	-	498	2135	2404	0.8881032
C9	9609512	9612168	BolC9t54366H	0	+	918	2417	2656	0.9100150
C9	9612687	9616113	BolC9t54367H	0	-	361	2538	3426	0.7408056
C9	9623201	9623692	BolC9t54368H	0	+	507	491	491	1.0000000
C9	9625349	9625840	BolC9t54369H	0	+	148	491	491	1.0000000
C9	9629532	9629738	BolC9t54370H	0	+	34	206	206	1.0000000
C9	9639071	9652849	BolC9t54371H	0	+	1222	5041	13778	0.3658731
C9	9655764	9657504	BolC9t54372H	0	+	272	1527	1740	0.8775862
C9	9658476	9661460	BolC9t54373H	0	+	991	2966	2984	0.9939678
C9	9662214	9664656	BolC9t54374H	0	+	939	2329	2442	0.9537265
C9	9684847	9685156	BolC9t54375H	0	+	336	309	309	1.0000000
C9	9688132	9688833	BolC9t54376H	0	+	42	584	701	0.8330956
C9	9689104	9691732	BolC9t54377H	0	-	279	1795	2628	0.6830289
C9	9698674	9699865	BolC9t54378H	0	-	238	1046	1191	0.8782536
C9	9702441	9704415	BolC9t54379H	0	+	94	554	1974	0.2806484
C9	9705236	9706373	BolC9t54380H	0	+	984	1137	1137	1.0000000
C9	9706757	9708731	BolC9t54381H	0	-	176	930	1974	0.4711246
C9	9714496	9715271	BolC9t54382H	0	+	504	775	775	1.0000000
C9	9718092	9719354	BolC9t54383H	0	+	860	1262	1262	1.0000000
C9	9721950	9722734	BolC9t54384H	0	+	401	773	784	0.9859694
C9	9723289	9725757	BolC9t54385H	0	+	1589	2440	2468	0.9886548
C9	9727028	9727527	BolC9t54386H	0	+	272	499	499	1.0000000
C9	9733223	9734095	BolC9t54387H	0	-	293	872	872	1.0000000
C9	9742088	9744820	BolC9t54388H	0	-	1572	2636	2732	0.9648609
C9	9745635	9746509	BolC9t54389H	0	+	829	874	874	1.0000000
C9	9753294	9754449	BolC9t54390H	0	-	219	368	1155	0.3186147
C9	9771378	9771519	BolC9t54391H	0	+	19	82	141	0.5815603
C9	9780352	9783009	BolC9t54392H	0	-	200	1397	2657	0.5257810
C9	9819284	9819605	BolC9t54393H	0	+	14	321	321	1.0000000
C9	9820026	9820701	BolC9t54394H	0	-	167	635	675	0.9407408
C9	9821531	9821645	BolC9t54395H	0	-	145	114	114	1.0000000
C9	9834848	9835691	BolC9t54396H	0	+	440	807	843	0.9572954
C9	9836430	9839235	BolC9t54397H	0	-	898	2329	2805	0.8303030
C9	9858196	9859676	BolC9t54398H	0	-	613	1311	1480	0.8858108
C9	9876105	9879121	BolC9t54399H	0	+	864	2770	3016	0.9184350
C9	9879709	9880099	BolC9t54400H	0	-	184	390	390	1.0000000
C9	9881319	9881575	BolC9t54401H	0	+	48	256	256	1.0000000
C9	9885107	9888149	BolC9t54402H	0	+	706	2982	3042	0.9802761
C9	9888954	9893759	BolC9t54403H	0	-	2450	4693	4805	0.9766909
C9	9903630	9904362	BolC9t54404H	0	-	92	567	732	0.7745901
C9	9905109	9905891	BolC9t54405H	0	-	566	782	782	1.0000000
C9	9922950	9923472	BolC9t54406H	0	-	82	264	522	0.5057471
C9	9945319	9945691	BolC9t54407H	0	-	207	372	372	1.0000000
C9	9951300	9954656	BolC9t54408H	0	-	1237	3253	3356	0.9693087
C9	9958182	9958413	BolC9t54409H	0	-	5	152	231	0.6580086
C9	9968625	9968949	BolC9t54410H	0	+	409	324	324	1.0000000
C9	9969525	9974462	BolC9t54411H	0	+	1306	3767	4937	0.7630140
C9	9976200	9976857	BolC9t54412H	0	-	211	657	657	1.0000000
C9	9976461	9976869	BolC9t54413H	0	+	169	408	408	1.0000000
C9	9977980	9984856	BolC9t54414H	0	-	2340	5633	6876	0.8192263
C9	9994061	9995400	BolC9t54415H	0	+	690	1339	1339	1.0000000
C9	9997629	9997833	BolC9t54416H	0	+	123	204	204	1.0000000
C9	10001790	10001940	BolC9t54417H	0	+	10	32	150	0.2133333
C9	10002755	10003855	BolC9t54418H	0	+	80	556	1100	0.5054545
C9	10016348	10016684	BolC9t54419H	0	-	149	336	336	1.0000000
C9	10019586	10021920	BolC9t54420H	0	-	1063	2255	2334	0.9661525
C9	10022713	10030612	BolC9t54421H	0	-	1373	5205	7899	0.6589442
C9	10033388	10036517	BolC9t54422H	0	-	350	2510	3129	0.8021732
C9	10037306	10038635	BolC9t54423H	0	-	494	1329	1329	1.0000000
C9	10043121	10048068	BolC9t54424H	0	+	1091	4450	4947	0.8995351
C9	10048700	10051126	BolC9t54425H	0	-	1534	2426	2426	1.0000000
C9	10071085	10073729	BolC9t54426H	0	+	1070	2357	2644	0.8914524
C9	10126484	10126994	BolC9t54427H	0	+	69	496	510	0.9725490
C9	10129951	10130122	BolC9t54428H	0	-	49	171	171	1.0000000
C9	10139618	10145003	BolC9t54429H	0	+	486	3712	5385	0.6893222
C9	10145913	10148563	BolC9t54430H	0	+	531	2544	2650	0.9600000
C9	10149202	10149577	BolC9t54431H	0	+	130	361	375	0.9626667
C9	10155463	10157278	BolC9t54432H	0	+	248	1651	1815	0.9096419
C9	10162901	10164603	BolC9t54433H	0	+	966	1702	1702	1.0000000
C9	10165350	10166310	BolC9t54434H	0	-	272	789	960	0.8218750
C9	10175925	10177629	BolC9t54435H	0	+	0	0	1704	0.0000000
C9	10184198	10184480	BolC9t54436H	0	+	0	0	282	0.0000000
C9	10200329	10202324	BolC9t54437H	0	-	182	1646	1995	0.8250626
C9	10204492	10205212	BolC9t54438H	0	+	245	708	720	0.9833333
C9	10205692	10205830	BolC9t54439H	0	-	72	138	138	1.0000000
C9	10206429	10208895	BolC9t54440H	0	-	396	2289	2466	0.9282238
C9	10215670	10215814	BolC9t54441H	0	+	198	144	144	1.0000000
C9	10219338	10220861	BolC9t54442H	0	+	485	1463	1523	0.9606041
C9	10221252	10224075	BolC9t54443H	0	-	760	2648	2823	0.9380092
C9	10225481	10227592	BolC9t54444H	0	+	232	1763	2111	0.8351492
C9	10229106	10230650	BolC9t54445H	0	-	164	1321	1544	0.8555700
C9	10237489	10238505	BolC9t54446H	0	-	1120	1016	1016	1.0000000
C9	10238985	10240143	BolC9t54447H	0	-	272	1109	1158	0.9576856
C9	10244733	10246350	BolC9t54448H	0	+	557	1533	1617	0.9480519
C9	10251912	10252780	BolC9t54449H	0	-	379	769	868	0.8859447
C9	10260035	10260308	BolC9t54450H	0	-	84	268	273	0.9816850
C9	10273409	10276520	BolC9t54451H	0	-	183	1821	3111	0.5853423
C9	10278366	10284294	BolC9t54452H	0	-	1814	5623	5928	0.9485493
C9	10281565	10282135	BolC9t54453H	0	+	336	570	570	1.0000000
C9	10286983	10287598	BolC9t54454H	0	+	211	586	615	0.9528455
C9	10295059	10295308	BolC9t54455H	0	+	10	197	249	0.7911646
C9	10328974	10330404	BolC9t54456H	0	+	204	1126	1430	0.7874126
C9	10341196	10341430	BolC9t54457H	0	-	213	234	234	1.0000000
C9	10341503	10341653	BolC9t54458H	0	-	112	150	150	1.0000000
C9	10359100	10360441	BolC9t54459H	0	-	950	1341	1341	1.0000000
C9	10361925	10362476	BolC9t54460H	0	-	1595	551	551	1.0000000
C9	10363990	10369536	BolC9t54461H	0	-	1466	5086	5546	0.9170573
C9	10397895	10406776	BolC9t54462H	0	-	1683	3204	8881	0.3607702
C9	10433579	10433792	BolC9t54463H	0	+	0	0	213	0.0000000
C9	10434830	10436704	BolC9t54464H	0	-	868	1870	1874	0.9978656
C9	10438245	10440101	BolC9t54465H	0	+	452	1804	1856	0.9719828
C9	10444070	10445237	BolC9t54466H	0	+	718	1167	1167	1.0000000
C9	10458416	10472505	BolC9t54467H	0	+	2198	8700	14089	0.6175030
C9	10465309	10466581	BolC9t54468H	0	+	790	1245	1272	0.9787736
C9	10508105	10511604	BolC9t54469H	0	+	1162	3362	3499	0.9608459
C9	10513287	10514688	BolC9t54470H	0	-	2290	1401	1401	1.0000000
C9	10517863	10518319	BolC9t54471H	0	-	417	456	456	1.0000000
C9	10518397	10520014	BolC9t54472H	0	-	340	1457	1617	0.9010513
C9	10521355	10522073	BolC9t54473H	0	-	215	675	718	0.9401114
C9	10528600	10529410	BolC9t54474H	0	+	429	810	810	1.0000000
C9	10545864	10548942	BolC9t54475H	0	-	698	2377	3078	0.7722547
C9	10550052	10551522	BolC9t54476H	0	+	206	1259	1470	0.8564626
C9	10552584	10554782	BolC9t54477H	0	+	230	1797	2198	0.8175614
C9	10555101	10555278	BolC9t54478H	0	-	45	177	177	1.0000000
C9	10559156	10559261	BolC9t54479H	0	-	112	105	105	1.0000000
C9	10561046	10561385	BolC9t54480H	0	+	224	339	339	1.0000000
C9	10561873	10565197	BolC9t54481H	0	-	232	2101	3324	0.6320698
C9	10566110	10567421	BolC9t54482H	0	+	74	303	1311	0.2311213
C9	10568009	10568361	BolC9t54483H	0	+	5	217	352	0.6164773
C9	10570397	10571213	BolC9t54484H	0	+	41	370	816	0.4534314
C9	10577294	10577558	BolC9t54485H	0	-	163	264	264	1.0000000
C9	10599971	10600388	BolC9t54486H	0	+	54	403	417	0.9664268
C9	10605605	10612955	BolC9t54487H	0	+	1623	6122	7350	0.8329251
C9	10613811	10614856	BolC9t54488H	0	+	103	503	1045	0.4813397
C9	10631123	10633044	BolC9t54489H	0	-	918	1368	1921	0.7121291
C9	10634452	10635287	BolC9t54490H	0	-	281	730	835	0.8742515
C9	10641759	10642119	BolC9t54491H	0	-	10	52	360	0.1444445
C9	10651072	10654322	BolC9t54492H	0	+	1326	3006	3250	0.9249231
C9	10670981	10672497	BolC9t54493H	0	+	81	806	1516	0.5316623
C9	10673804	10674291	BolC9t54494H	0	+	61	487	487	1.0000000
C9	10690282	10694190	BolC9t54495H	0	+	774	3817	3908	0.9767144
C9	10696006	10699025	BolC9t54496H	0	-	186	1797	3019	0.5952302
C9	10718783	10718903	BolC9t54497H	0	-	0	0	120	0.0000000
C9	10721102	10721551	BolC9t54498H	0	-	42	363	449	0.8084633
C9	10747518	10753462	BolC9t54499H	0	-	1425	5455	5944	0.9177322
C9	10776903	10777278	BolC9t54500H	0	+	1	68	375	0.1813333
C9	10789671	10790656	BolC9t54501H	0	+	134	731	985	0.7421320
C9	10793810	10794107	BolC9t54502H	0	-	2	25	297	0.0841751
C9	10828940	10829208	BolC9t54503H	0	+	74	258	268	0.9626865
C9	10830738	10831778	BolC9t54504H	0	-	437	1040	1040	1.0000000
C9	10849666	10851631	BolC9t54505H	0	-	680	1950	1965	0.9923664
C9	10858436	10859579	BolC9t54506H	0	+	935	985	1143	0.8617673
C9	10863058	10863208	BolC9t54507H	0	+	91	150	150	1.0000000
C9	10879465	10880740	BolC9t54508H	0	-	445	1252	1275	0.9819608
C9	10907170	10907732	BolC9t54509H	0	+	41	419	562	0.7455516
C9	10910774	10912061	BolC9t54510H	0	+	961	1287	1287	1.0000000
C9	10912161	10913345	BolC9t54511H	0	+	860	1184	1184	1.0000000
C9	10915321	10915588	BolC9t54512H	0	+	313	267	267	1.0000000
C9	10915744	10916143	BolC9t54513H	0	+	677	399	399	1.0000000
C9	10917320	10919026	BolC9t54514H	0	-	494	1529	1706	0.8962485
C9	10919578	10921159	BolC9t54515H	0	+	266	1520	1581	0.9614168
C9	10921576	10923542	BolC9t54516H	0	-	638	1732	1966	0.8809766
C9	10938284	10939335	BolC9t54517H	0	+	289	1051	1051	1.0000000
C9	10942900	10943155	BolC9t54518H	0	-	38	194	255	0.7607843
C9	10945600	10945930	BolC9t54519H	0	-	311	330	330	1.0000000
C9	10947489	10947699	BolC9t54520H	0	-	0	0	210	0.0000000
C9	10956741	10957488	BolC9t54521H	0	-	426	747	747	1.0000000
C9	10958475	10958835	BolC9t54522H	0	+	5	87	360	0.2416667
C9	10959529	10961527	BolC9t54523H	0	-	986	1978	1998	0.9899900
C9	10987961	10989331	BolC9t54524H	0	-	17	475	1370	0.3467153
C9	11004197	11004752	BolC9t54525H	0	+	328	483	555	0.8702703
C9	11016256	11019833	BolC9t54526H	0	+	875	3218	3577	0.8996366
C9	11042328	11042916	BolC9t54527H	0	+	9	309	588	0.5255102
C9	11044568	11050951	BolC9t54528H	0	+	609	3876	6383	0.6072380
C9	11045031	11045628	BolC9t54529H	0	+	5	258	597	0.4321608
C9	11047488	11048408	BolC9t54530H	0	+	114	665	920	0.7228261
C9	11053003	11053517	BolC9t54531H	0	-	125	382	514	0.7431906
C9	11054249	11056998	BolC9t54532H	0	+	1740	2673	2749	0.9723536
C9	11057472	11057655	BolC9t54533H	0	+	171	183	183	1.0000000
C9	11068856	11069222	BolC9t54534H	0	+	3229	366	366	1.0000000
C9	11069829	11072339	BolC9t54535H	0	+	18417	2510	2510	1.0000000
C9	11081978	11082503	BolC9t54536H	0	+	235	525	525	1.0000000
C9	11083842	11085318	BolC9t54537H	0	+	660	1464	1476	0.9918699
C9	11088292	11088769	BolC9t54538H	0	-	200	477	477	1.0000000
C9	11112192	11115191	BolC9t54539H	0	+	157	1685	2999	0.5618539
C9	11131852	11132280	BolC9t54540H	0	+	0	0	428	0.0000000
C9	11138310	11141469	BolC9t54541H	0	+	1150	3142	3159	0.9946185
C9	11144588	11145505	BolC9t54542H	0	-	427	917	917	1.0000000
C9	11148052	11155487	BolC9t54543H	0	+	2904	7240	7435	0.9737727
C9	11155638	11156810	BolC9t54544H	0	+	629	1005	1172	0.8575085
C9	11157358	11159173	BolC9t54545H	0	-	870	1756	1815	0.9674931
C9	11164037	11171780	BolC9t54546H	0	-	1832	5596	7743	0.7227173
C9	11173704	11176052	BolC9t54547H	0	+	723	2304	2348	0.9812607
C9	11177609	11179309	BolC9t54548H	0	+	510	1674	1700	0.9847059
C9	11182328	11193748	BolC9t54549H	0	+	6111	8958	11420	0.7844133
C9	11194546	11195683	BolC9t54550H	0	+	399	1137	1137	1.0000000
C9	11196734	11199227	BolC9t54551H	0	+	1431	2493	2493	1.0000000
C9	11200530	11200812	BolC9t54552H	0	-	280	282	282	1.0000000
C9	11202232	11203012	BolC9t54553H	0	+	422	731	780	0.9371795
C9	11204038	11204767	BolC9t54554H	0	+	72	727	729	0.9972565
C9	11205503	11206822	BolC9t54555H	0	-	404	1258	1319	0.9537528
C9	11208558	11214346	BolC9t54556H	0	-	2648	5778	5788	0.9982723
C9	11231389	11234490	BolC9t54557H	0	+	231	2273	3101	0.7329894
C9	11244227	11244446	BolC9t54558H	0	+	74	219	219	1.0000000
C9	11255487	11258416	BolC9t54559H	0	-	1151	2926	2929	0.9989758
C9	11291631	11292802	BolC9t54560H	0	-	386	1171	1171	1.0000000
C9	11300656	11303314	BolC9t54561H	0	+	484	2065	2658	0.7768999
C9	11304602	11307030	BolC9t54562H	0	-	926	2381	2428	0.9806425
C9	11307937	11308577	BolC9t54563H	0	+	264	640	640	1.0000000
C9	11309374	11309497	BolC9t54564H	0	+	65	101	123	0.8211382
C9	11312621	11319539	BolC9t54565H	0	-	1538	5340	6918	0.7718994
C9	11322540	11323870	BolC9t54566H	0	-	270	1223	1330	0.9195489
C9	11327769	11335208	BolC9t54567H	0	+	892	4470	7439	0.6008872
C9	11336096	11345024	BolC9t54568H	0	+	4391	8784	8928	0.9838710
C9	11345638	11346401	BolC9t54569H	0	+	530	763	763	1.0000000
C9	11346798	11349130	BolC9t54570H	0	-	1189	2332	2332	1.0000000
C9	11353506	11353961	BolC9t54571H	0	-	206	393	455	0.8637363
C9	11354618	11355622	BolC9t54572H	0	+	242	978	1004	0.9741036
C9	11356817	11357444	BolC9t54573H	0	-	0	0	627	0.0000000
C9	11358681	11360476	BolC9t54574H	0	-	18	62	1795	0.0345404
C9	11366537	11368102	BolC9t54575H	0	+	582	1565	1565	1.0000000
C9	11372951	11373446	BolC9t54576H	0	-	22	316	495	0.6383839
C9	11378700	11378871	BolC9t54577H	0	-	1	23	171	0.1345029
C9	11380264	11380519	BolC9t54578H	0	-	103	255	255	1.0000000
C9	11385909	11387334	BolC9t54579H	0	-	673	1153	1425	0.8091228
C9	11398881	11399131	BolC9t54580H	0	-	41	238	250	0.9520000
C9	11402912	11461010	BolC9t54581H	0	-	12644	34701	58098	0.5972839
C9	11448417	11450293	BolC9t54582H	0	+	879	1711	1876	0.9120469
C9	11462099	11462553	BolC9t54583H	0	-	302	454	454	1.0000000
C9	11462658	11467363	BolC9t54584H	0	-	2260	4565	4705	0.9702444
C9	11463581	11463896	BolC9t54585H	0	+	6	255	315	0.8095238
C9	11471950	11473943	BolC9t54586H	0	-	1859	1993	1993	1.0000000
C9	11507989	11509228	BolC9t54587H	0	+	42	416	1239	0.3357546
C9	11517403	11519057	BolC9t54588H	0	+	822	1654	1654	1.0000000
C9	11525585	11528849	BolC9t54589H	0	+	2491	3264	3264	1.0000000
C9	11529809	11530857	BolC9t54590H	0	+	374	1013	1048	0.9666030
C9	11531363	11532706	BolC9t54591H	0	-	454	1343	1343	1.0000000
C9	11533018	11535236	BolC9t54592H	0	+	955	2149	2218	0.9688909
C9	11535506	11537429	BolC9t54593H	0	-	806	1826	1923	0.9495580
C9	11556392	11556986	BolC9t54594H	0	+	465	594	594	1.0000000
C9	11564145	11568475	BolC9t54595H	0	+	1810	4297	4330	0.9923788
C9	11570181	11575088	BolC9t54596H	0	-	6146	4907	4907	1.0000000
C9	11576145	11577419	BolC9t54597H	0	-	139	1018	1274	0.7990581
C9	11580638	11581839	BolC9t54598H	0	+	475	1198	1201	0.9975021
C9	11583880	11585797	BolC9t54599H	0	-	284	1476	1917	0.7699531
C9	11591238	11591349	BolC9t54600H	0	-	213	111	111	1.0000000
C9	11592980	11593232	BolC9t54601H	0	-	8	180	252	0.7142857
C9	11604199	11604748	BolC9t54602H	0	+	19	168	549	0.3060109
C9	11605302	11619185	BolC9t54603H	0	-	1877	7490	13883	0.5395088
C9	11620788	11621203	BolC9t54604H	0	+	7	156	415	0.3759036
C9	11625301	11627500	BolC9t54605H	0	+	1111	2131	2199	0.9690769
C9	11627813	11628475	BolC9t54606H	0	+	359	662	662	1.0000000
C9	11628697	11630161	BolC9t54607H	0	-	30	607	1464	0.4146175
C9	11631631	11632714	BolC9t54608H	0	+	471	1012	1083	0.9344414
C9	11632988	11633201	BolC9t54609H	0	-	175	213	213	1.0000000
C9	11633592	11635396	BolC9t54610H	0	+	495	1710	1804	0.9478936
C9	11635778	11636081	BolC9t54611H	0	+	57	193	303	0.6369637
C9	11636581	11638313	BolC9t54612H	0	+	1447	1732	1732	1.0000000
C9	11638714	11641062	BolC9t54613H	0	-	689	2277	2348	0.9697615
C9	11656193	11661713	BolC9t54614H	0	+	2790	4954	5520	0.8974637
C9	11682237	11682345	BolC9t54615H	0	-	45	108	108	1.0000000
C9	11685525	11686357	BolC9t54616H	0	-	304	797	832	0.9579327
C9	11689447	11690510	BolC9t54617H	0	+	227	866	1063	0.8146755
C9	11714369	11714762	BolC9t54618H	0	-	187	393	393	1.0000000
C9	11715187	11716154	BolC9t54619H	0	+	341	864	967	0.8934850
C9	11735219	11736191	BolC9t54620H	0	+	579	972	972	1.0000000
C9	11737372	11737825	BolC9t54621H	0	+	228	400	453	0.8830022
C9	11739447	11740308	BolC9t54622H	0	-	491	861	861	1.0000000
C9	11765306	11766544	BolC9t54623H	0	+	617	1187	1238	0.9588045
C9	11781134	11781752	BolC9t54624H	0	-	567	618	618	1.0000000
C9	11788954	11789074	BolC9t54625H	0	-	199	120	120	1.0000000
C9	11794645	11795409	BolC9t54626H	0	+	0	0	764	0.0000000
C9	11800210	11800594	BolC9t54627H	0	-	341	384	384	1.0000000
C9	11804667	11807817	BolC9t54628H	0	+	567	2419	3150	0.7679365
C9	11808875	11813661	BolC9t54629H	0	-	962	3000	4786	0.6268283
C9	11843447	11843783	BolC9t54630H	0	+	14	182	336	0.5416667
C9	11851641	11852345	BolC9t54631H	0	-	22	307	704	0.4360795
C9	11865376	11878511	BolC9t54632H	0	-	1113	7652	13135	0.5825657
C9	11883453	11884377	BolC9t54633H	0	-	39	574	924	0.6212121
C9	11884662	11885901	BolC9t54634H	0	+	110	942	1239	0.7602906
C9	11895730	11898093	BolC9t54635H	0	+	570	2316	2363	0.9801100
C9	11904612	11907761	BolC9t54636H	0	-	762	3037	3149	0.9644331
C9	11916716	11919032	BolC9t54637H	0	-	794	2271	2316	0.9805700
C9	11922154	11930156	BolC9t54638H	0	+	1424	3719	8002	0.4647588
C9	11944067	11946168	BolC9t54639H	0	+	2971	2101	2101	1.0000000
C9	11964616	11964808	BolC9t54640H	0	-	133	192	192	1.0000000
C9	11975689	11978735	BolC9t54641H	0	+	542	2830	3046	0.9290873
C9	11985280	11986895	BolC9t54642H	0	-	914	1178	1615	0.7294118
C9	11987794	11988590	BolC9t54643H	0	-	35	152	796	0.1909548
C9	12003330	12005561	BolC9t54644H	0	-	314	1654	2231	0.7413716
C9	12014974	12016563	BolC9t54645H	0	-	107	824	1589	0.5185651
C9	12021460	12022203	BolC9t54646H	0	+	28	149	743	0.2005384
C9	12031356	12033742	BolC9t54647H	0	-	306	2188	2386	0.9170159
C9	12049799	12050837	BolC9t54648H	0	+	559	1038	1038	1.0000000
C9	12055975	12057153	BolC9t54649H	0	-	696	1133	1178	0.9617997
C9	12058159	12058645	BolC9t54650H	0	+	1485	476	486	0.9794239
C9	12058913	12059527	BolC9t54651H	0	+	18	318	614	0.5179153
C9	12062086	12062668	BolC9t54652H	0	+	385	582	582	1.0000000
C9	12063082	12064388	BolC9t54653H	0	+	4548	1306	1306	1.0000000
C9	12084239	12084536	BolC9t54654H	0	+	52	297	297	1.0000000
C9	12088318	12091566	BolC9t54655H	0	+	1797	3194	3248	0.9833744
C9	12091922	12096983	BolC9t54656H	0	-	2004	5023	5061	0.9924916
C9	12110165	12110309	BolC9t54657H	0	+	2	74	144	0.5138889
C9	12111330	12112668	BolC9t54658H	0	+	760	1338	1338	1.0000000
C9	12113580	12114132	BolC9t54659H	0	-	392	552	552	1.0000000
C9	12114203	12119419	BolC9t54660H	0	-	700	3050	5216	0.5847393
C9	12120788	12125053	BolC9t54661H	0	-	890	4007	4265	0.9395076
C9	12133071	12134843	BolC9t54662H	0	+	301	1716	1772	0.9683973
C9	12136264	12136620	BolC9t54663H	0	+	94	252	356	0.7078652
C9	12158353	12161664	BolC9t54664H	0	-	1021	3219	3311	0.9722138
C9	12166597	12167549	BolC9t54665H	0	-	17	439	952	0.4611345
C9	12168865	12170411	BolC9t54666H	0	-	544	1502	1546	0.9715394
C9	12170649	12171608	BolC9t54667H	0	+	182	842	959	0.8779979
C9	12172904	12173987	BolC9t54668H	0	-	432	967	1083	0.8928901
C9	12174521	12174869	BolC9t54669H	0	-	85	280	348	0.8045977
C9	12177186	12177578	BolC9t54670H	0	-	2	127	392	0.3239796
C9	12182863	12185501	BolC9t54671H	0	-	740	2290	2638	0.8680819
C9	12192909	12193155	BolC9t54672H	0	-	321	246	246	1.0000000
C9	12206229	12206490	BolC9t54673H	0	-	12	104	261	0.3984674
C9	12208423	12209373	BolC9t54674H	0	-	146	950	950	1.0000000
C9	12210228	12211898	BolC9t54675H	0	+	524	1498	1670	0.8970060
C9	12212670	12213714	BolC9t54676H	0	+	177	688	1044	0.6590039
C9	12214823	12216926	BolC9t54677H	0	-	583	2053	2103	0.9762244
C9	12217637	12220437	BolC9t54678H	0	-	1165	2682	2800	0.9578571
C9	12221000	12221390	BolC9t54679H	0	-	240	390	390	1.0000000
C9	12232058	12232418	BolC9t54680H	0	+	17	318	360	0.8833333
C9	12234423	12237607	BolC9t54681H	0	-	167	1990	3184	0.6250000
C9	12291923	12292856	BolC9t54682H	0	+	523	916	933	0.9817792
C9	12294240	12294687	BolC9t54683H	0	-	73	418	447	0.9351230
C9	12298808	12300355	BolC9t54684H	0	-	597	1547	1547	1.0000000
C9	12305702	12305932	BolC9t54685H	0	-	113	230	230	1.0000000
C9	12307386	12308579	BolC9t54686H	0	+	638	1107	1193	0.9279128
C9	12311412	12311772	BolC9t54687H	0	+	168	360	360	1.0000000
C9	12312981	12314611	BolC9t54688H	0	-	298	1465	1630	0.8987730
C9	12325262	12327567	BolC9t54689H	0	-	306	1675	2305	0.7266811
C9	12331726	12345628	BolC9t54690H	0	+	718	5010	13902	0.3603798
C9	12346086	12347751	BolC9t54691H	0	-	449	1623	1665	0.9747748
C9	12348240	12350463	BolC9t54692H	0	-	67	587	2223	0.2640576
C9	12360495	12361599	BolC9t54693H	0	-	356	966	1104	0.8750000
C9	12369495	12370101	BolC9t54694H	0	+	149	601	606	0.9917492
C9	12370588	12394548	BolC9t54695H	0	-	6085	14018	23960	0.5850585
C9	12395927	12396161	BolC9t54696H	0	+	0	0	234	0.0000000
C9	12397405	12398392	BolC9t54697H	0	-	355	987	987	1.0000000
C9	12398660	12398882	BolC9t54698H	0	+	111	222	222	1.0000000
C9	12399125	12400964	BolC9t54699H	0	-	644	1737	1839	0.9445351
C9	12402102	12402258	BolC9t54700H	0	+	95	156	156	1.0000000
C9	12405765	12406222	BolC9t54701H	0	+	131	397	457	0.8687090
C9	12417813	12418448	BolC9t54702H	0	-	97	626	635	0.9858268
C9	12419753	12423903	BolC9t54703H	0	+	1655	3823	4150	0.9212048
C9	12427956	12429903	BolC9t54704H	0	+	239	1210	1947	0.6214689
C9	12433637	12437968	BolC9t54705H	0	+	1192	3806	4331	0.8787809
C9	12442080	12442236	BolC9t54706H	0	-	3	97	156	0.6217949
C9	12457350	12457506	BolC9t54707H	0	-	36	156	156	1.0000000
C9	12460547	12460712	BolC9t54708H	0	-	1	120	165	0.7272727
C9	12473826	12475141	BolC9t54709H	0	-	987	1315	1315	1.0000000
C9	12476850	12477190	BolC9t54710H	0	+	1447	340	340	1.0000000
C9	12482753	12482858	BolC9t54711H	0	+	134	105	105	1.0000000
C9	12485153	12485859	BolC9t54712H	0	+	263	706	706	1.0000000
C9	12489724	12490060	BolC9t54713H	0	+	157	336	336	1.0000000
C9	12497300	12498654	BolC9t54714H	0	+	412	1339	1354	0.9889217
C9	12503295	12505510	BolC9t54715H	0	-	820	1808	2215	0.8162528
C9	12510781	12516405	BolC9t54716H	0	-	832	4490	5624	0.7983642
C9	12547072	12549832	BolC9t54717H	0	-	500	2013	2760	0.7293478
C9	12564335	12565662	BolC9t54718H	0	+	548	1327	1327	1.0000000
C9	12566464	12567741	BolC9t54719H	0	+	825	1230	1277	0.9631950
C9	12574340	12575500	BolC9t54720H	0	+	166	1159	1160	0.9991379
C9	12576203	12578379	BolC9t54721H	0	-	1192	1642	2176	0.7545956
C9	12582623	12590896	BolC9t54722H	0	+	1124	5445	8273	0.6581651
C9	12587397	12589352	BolC9t54723H	0	-	66	667	1955	0.3411765
C9	12594042	12595464	BolC9t54724H	0	+	464	1422	1422	1.0000000
C9	12603048	12607246	BolC9t54725H	0	-	652	4059	4198	0.9668890
C9	12611493	12611723	BolC9t54726H	0	+	30	154	230	0.6695652
C9	12617037	12618501	BolC9t54727H	0	+	66	975	1464	0.6659836
C9	12620018	12621053	BolC9t54728H	0	-	38	201	1035	0.1942029
C9	12634209	12636584	BolC9t54729H	0	-	774	2230	2375	0.9389474
C9	12637613	12639073	BolC9t54730H	0	+	637	1460	1460	1.0000000
C9	12656692	12658313	BolC9t54731H	0	+	1516	1621	1621	1.0000000
C9	12661856	12662207	BolC9t54732H	0	+	588	351	351	1.0000000
C9	12664163	12664412	BolC9t54733H	0	+	61	249	249	1.0000000
C9	12684448	12687841	BolC9t54734H	0	+	1618	3393	3393	1.0000000
C9	12688544	12692566	BolC9t54735H	0	+	534	2394	4022	0.5952262
C9	12693716	12695445	BolC9t54736H	0	+	488	996	1729	0.5760555
C9	12696951	12697389	BolC9t54737H	0	+	137	433	438	0.9885845
C9	12698239	12698545	BolC9t54738H	0	-	0	0	306	0.0000000
C9	12706740	12707775	BolC9t54739H	0	+	873	1035	1035	1.0000000
C9	12708262	12723197	BolC9t54740H	0	+	10939	14774	14935	0.9892200
C9	12710075	12710523	BolC9t54741H	0	-	790	448	448	1.0000000
C9	12724159	12734530	BolC9t54742H	0	+	1594	7624	10371	0.7351268
C9	12758027	12761604	BolC9t54743H	0	+	307	2152	3577	0.6016214
C9	12768109	12771239	BolC9t54744H	0	-	840	2559	3130	0.8175719
C9	12789959	12791626	BolC9t54745H	0	-	140	1163	1667	0.6976604
C9	12805448	12806005	BolC9t54746H	0	-	495	557	557	1.0000000
C9	12810141	12810648	BolC9t54747H	0	-	151	507	507	1.0000000
C9	12812039	12817228	BolC9t54748H	0	-	1130	4234	5189	0.8159568
C9	12817879	12818386	BolC9t54749H	0	+	41	119	507	0.2347140
C9	12819360	12819713	BolC9t54750H	0	+	0	0	353	0.0000000
C9	12835544	12836348	BolC9t54751H	0	-	6	317	804	0.3942786
C9	12837020	12843335	BolC9t54752H	0	-	2491	6002	6315	0.9504355
C9	12846891	12848398	BolC9t54753H	0	+	369	1404	1507	0.9316523
C9	12878374	12880334	BolC9t54754H	0	+	874	1960	1960	1.0000000
C9	12882271	12887969	BolC9t54755H	0	-	4364	5698	5698	1.0000000
C9	12914930	12915192	BolC9t54756H	0	+	79	262	262	1.0000000
C9	12915797	12919272	BolC9t54757H	0	+	785	2900	3475	0.8345324
C9	12920077	12923642	BolC9t54758H	0	-	660	3218	3565	0.9026648
C9	12930394	12930830	BolC9t54759H	0	-	536	436	436	1.0000000
C9	12940147	12942843	BolC9t54760H	0	+	588	2333	2696	0.8653561
C9	12947195	12947843	BolC9t54761H	0	-	2	21	648	0.0324074
C9	12948711	12951193	BolC9t54762H	0	+	1324	2427	2482	0.9778404
C9	12956625	12961121	BolC9t54763H	0	-	943	3198	4496	0.7112989
C9	12975285	12975453	BolC9t54764H	0	-	346	168	168	1.0000000
C9	12976716	12982432	BolC9t54765H	0	+	2574	5492	5716	0.9608117
C9	12982705	12982910	BolC9t54766H	0	+	380	205	205	1.0000000
C9	12983190	12983725	BolC9t54767H	0	+	271	510	535	0.9532710
C9	12983910	12984959	BolC9t54768H	0	-	56	358	1049	0.3412774
C9	12999128	12999533	BolC9t54769H	0	-	89	391	405	0.9654321
C9	13027807	13028119	BolC9t54770H	0	+	329	312	312	1.0000000
C9	13030684	13033287	BolC9t54771H	0	-	1133	2556	2603	0.9819439
C9	13039175	13039283	BolC9t54772H	0	-	45	108	108	1.0000000
C9	13039328	13040109	BolC9t54773H	0	-	86	626	781	0.8015365
C9	13042232	13043879	BolC9t54774H	0	+	1297	1624	1647	0.9860352
C9	13044961	13046848	BolC9t54775H	0	-	278	1652	1887	0.8754637
C9	13047682	13060045	BolC9t54776H	0	-	402	6379	12363	0.5159751
C9	13073984	13075088	BolC9t54777H	0	+	9	305	1104	0.2762681
C9	13075844	13076591	BolC9t54778H	0	-	1	10	747	0.0133869
C9	13077745	13079265	BolC9t54779H	0	+	4	253	1520	0.1664474
C9	13084072	13084537	BolC9t54780H	0	+	18	153	465	0.3290323
C9	13087446	13088136	BolC9t54781H	0	+	199	565	690	0.8188406
C9	13095353	13098393	BolC9t54782H	0	+	1432	3040	3040	1.0000000
C9	13098814	13102435	BolC9t54783H	0	+	1124	2841	3621	0.7845899
C9	13103519	13105932	BolC9t54784H	0	+	848	2273	2413	0.9419810
C9	13107708	13107963	BolC9t54785H	0	+	32	205	255	0.8039216
C9	13115862	13117990	BolC9t54786H	0	+	734	2097	2128	0.9854323
C9	13119469	13120546	BolC9t54787H	0	-	232	989	1077	0.9182916
C9	13122458	13123213	BolC9t54788H	0	+	304	755	755	1.0000000
C9	13133505	13135028	BolC9t54789H	0	-	99	940	1523	0.6172029
C9	13151679	13152069	BolC9t54790H	0	+	209	390	390	1.0000000
C9	13156180	13156546	BolC9t54791H	0	-	502	366	366	1.0000000
C9	13159602	13161096	BolC9t54792H	0	+	447	1416	1494	0.9477912
C9	13162306	13165109	BolC9t54793H	0	-	2967	2803	2803	1.0000000
C9	13167189	13169127	BolC9t54794H	0	+	641	1790	1938	0.9236326
C9	13187212	13188133	BolC9t54795H	0	+	484	921	921	1.0000000
C9	13192134	13192350	BolC9t54796H	0	-	0	0	216	0.0000000
C9	13196289	13196556	BolC9t54797H	0	+	228	267	267	1.0000000
C9	13208805	13209880	BolC9t54798H	0	+	323	1072	1075	0.9972093
C9	13224022	13226055	BolC9t54799H	0	+	903	1907	2033	0.9380226
C9	13255327	13256074	BolC9t54800H	0	-	69	607	747	0.8125837
C9	13273501	13273768	BolC9t54801H	0	+	300	267	267	1.0000000
C9	13282372	13282576	BolC9t54802H	0	-	1	44	204	0.2156863
C9	13283013	13283148	BolC9t54803H	0	-	4	86	135	0.6370370
C9	13283437	13283994	BolC9t54804H	0	-	0	0	557	0.0000000
C9	13290409	13290627	BolC9t54805H	0	+	52	218	218	1.0000000
C9	13302289	13305092	BolC9t54806H	0	+	698	2492	2803	0.8890474
C9	13316349	13317888	BolC9t54807H	0	-	595	1524	1539	0.9902534
C9	13333567	13342723	BolC9t54808H	0	-	4264	7730	9156	0.8442551
C9	13369413	13370397	BolC9t54809H	0	-	192	963	984	0.9786586
C9	13375838	13377367	BolC9t54810H	0	-	1811	1529	1529	1.0000000
C9	13404437	13404581	BolC9t54811H	0	-	150	144	144	1.0000000
C9	13407705	13410000	BolC9t54812H	0	-	504	2256	2295	0.9830065
C9	13425924	13426131	BolC9t54813H	0	-	348	207	207	1.0000000
C9	13427487	13429352	BolC9t54814H	0	+	553	1703	1865	0.9131367
C9	13430648	13431326	BolC9t54815H	0	-	575	678	678	1.0000000
C9	13445711	13446239	BolC9t54816H	0	+	148	528	528	1.0000000
C9	13448105	13448366	BolC9t54817H	0	-	185	261	261	1.0000000
C9	13449665	13451262	BolC9t54818H	0	-	1130	1595	1597	0.9987476
C9	13454503	13454806	BolC9t54819H	0	-	76	303	303	1.0000000
C9	13458644	13460520	BolC9t54820H	0	+	472	1776	1876	0.9466951
C9	13462565	13463233	BolC9t54821H	0	-	419	668	668	1.0000000
C9	13476965	13479218	BolC9t54822H	0	+	164	1774	2253	0.7873946
C9	13507673	13507977	BolC9t54823H	0	-	94	304	304	1.0000000
C9	13508486	13509343	BolC9t54824H	0	-	83	718	857	0.8378063
C9	13513466	13515197	BolC9t54825H	0	-	10	246	1731	0.1421144
C9	13516351	13518018	BolC9t54826H	0	+	1124	1667	1667	1.0000000
C9	13519244	13521350	BolC9t54827H	0	+	442	1979	2106	0.9396961
C9	13523099	13526328	BolC9t54828H	0	+	967	2776	3229	0.8597089
C9	13527366	13528574	BolC9t54829H	0	-	392	828	1208	0.6854305
C9	13543481	13546019	BolC9t54830H	0	+	598	2378	2538	0.9369583
C9	13557830	13558603	BolC9t54831H	0	+	166	649	773	0.8395860
C9	13569977	13570853	BolC9t54832H	0	-	73	593	876	0.6769406
C9	13573776	13576525	BolC9t54833H	0	-	408	1723	2749	0.6267734
C9	13577246	13577762	BolC9t54834H	0	-	16	420	516	0.8139535
C9	13581815	13582470	BolC9t54835H	0	+	55	520	655	0.7938932
C9	13609891	13610617	BolC9t54836H	0	-	222	694	726	0.9559228
C9	13615599	13615904	BolC9t54837H	0	-	6	57	305	0.1868853
C9	13616796	13617411	BolC9t54838H	0	+	44	413	615	0.6715447
C9	13622418	13625011	BolC9t54839H	0	+	811	2374	2593	0.9155418
C9	13625336	13628140	BolC9t54840H	0	-	800	2381	2804	0.8491441
C9	13634753	13635671	BolC9t54841H	0	+	81	769	918	0.8376907
C9	13653926	13655708	BolC9t54842H	0	+	42	567	1782	0.3181818
C9	13658591	13660274	BolC9t54843H	0	-	2193	1683	1683	1.0000000
C9	13672741	13725893	BolC9t54844H	0	+	17393	46164	53152	0.8685280
C9	13675484	13676936	BolC9t54845H	0	-	672	1375	1452	0.9469697
C9	13727409	13727946	BolC9t54846H	0	-	76	288	537	0.5363129
C9	13773971	13785596	BolC9t54847H	0	+	8655	9182	11625	0.7898495
C9	13786646	13787951	BolC9t54848H	0	+	793	1298	1305	0.9946360
C9	13795267	13795432	BolC9t54849H	0	-	365	165	165	1.0000000
C9	13799216	13799952	BolC9t54850H	0	+	16	193	736	0.2622283
C9	13804837	13810868	BolC9t54851H	0	-	1062	3695	6031	0.6126679
C9	13828849	13830722	BolC9t54852H	0	-	407	1873	1873	1.0000000
C9	13834061	13835793	BolC9t54853H	0	-	417	1384	1732	0.7990762
C9	13837628	13837904	BolC9t54854H	0	+	0	0	276	0.0000000
C9	13837916	13838093	BolC9t54855H	0	+	84	174	177	0.9830508
C9	13838425	13838761	BolC9t54856H	0	+	129	267	336	0.7946429
C9	13838858	13840653	BolC9t54857H	0	+	994	1729	1795	0.9632312
C9	13844432	13847946	BolC9t54858H	0	-	112	1814	3514	0.5162208
C9	13847961	13848315	BolC9t54859H	0	-	31	273	354	0.7711864
C9	13848446	13850657	BolC9t54860H	0	-	48	1413	2211	0.6390774
C9	13853659	13854268	BolC9t54861H	0	-	207	609	609	1.0000000
C9	13855848	13858367	BolC9t54862H	0	-	2871	2448	2519	0.9718142
C9	13891012	13899346	BolC9t54863H	0	-	363	2729	8334	0.3274538
C9	13900016	13905820	BolC9t54864H	0	-	1004	4666	5804	0.8039283
C9	13933357	13934170	BolC9t54865H	0	-	38	305	813	0.3751538
C9	13934922	13936111	BolC9t54866H	0	-	170	911	1189	0.7661901
C9	13964410	13964854	BolC9t54867H	0	+	23	124	444	0.2792793
C9	13978100	13978326	BolC9t54868H	0	+	432	226	226	1.0000000
C9	13981930	13982869	BolC9t54869H	0	-	134	784	939	0.8349308
C9	13984977	13985875	BolC9t54870H	0	-	926	898	898	1.0000000
C9	13986586	13988033	BolC9t54871H	0	-	878	1399	1447	0.9668279
C9	14001594	14002908	BolC9t54872H	0	+	361	1232	1314	0.9375951
C9	14003189	14003825	BolC9t54873H	0	-	1000	636	636	1.0000000
C9	14021405	14022433	BolC9t54874H	0	-	594	1028	1028	1.0000000
C9	14025639	14025894	BolC9t54875H	0	-	369	255	255	1.0000000
C9	14030054	14030225	BolC9t54876H	0	-	236	171	171	1.0000000
C9	14030415	14031145	BolC9t54877H	0	-	508	730	730	1.0000000
C9	14037696	14040298	BolC9t54878H	0	+	1556	2470	2602	0.9492698
C9	14045070	14047614	BolC9t54879H	0	-	3256	2249	2544	0.8840409
C9	14061153	14063893	BolC9t54880H	0	+	1836	2740	2740	1.0000000
C9	14076927	14077978	BolC9t54881H	0	+	1071	1051	1051	1.0000000
C9	14084797	14086632	BolC9t54882H	0	-	1049	1835	1835	1.0000000
C9	14089962	14090810	BolC9t54883H	0	+	324	848	848	1.0000000
C9	14106782	14108412	BolC9t54884H	0	-	48	741	1630	0.4546012
C9	14186690	14186861	BolC9t54885H	0	-	0	0	171	0.0000000
C9	14240002	14241340	BolC9t54886H	0	+	630	1337	1338	0.9992526
C9	14248480	14251405	BolC9t54887H	0	+	250	2094	2925	0.7158974
C9	14254353	14256986	BolC9t54888H	0	-	1754	2633	2633	1.0000000
C9	14258373	14261484	BolC9t54889H	0	-	492	2843	3111	0.9138541
C9	14287593	14292175	BolC9t54890H	0	-	2623	4505	4582	0.9831951
C9	14295668	14299676	BolC9t54891H	0	+	1798	3836	4008	0.9570858
C9	14301702	14302689	BolC9t54892H	0	-	100	665	987	0.6737589
C9	14320586	14325328	BolC9t54893H	0	+	413	3218	4742	0.6786166
C9	14411080	14415737	BolC9t54894H	0	+	221	2456	4657	0.5273781
C9	14417856	14425668	BolC9t54895H	0	+	2207	5122	7812	0.6556579
C9	14436314	14437278	BolC9t54896H	0	+	0	0	964	0.0000000
C9	14442683	14443406	BolC9t54897H	0	-	21	358	723	0.4951591
C9	14459179	14461586	BolC9t54898H	0	+	107	1537	2407	0.6385542
C9	14480731	14480905	BolC9t54899H	0	+	52	174	174	1.0000000
C9	14483313	14483670	BolC9t54900H	0	+	65	276	357	0.7731093
C9	14486121	14495121	BolC9t54901H	0	+	3743	9000	9000	1.0000000
C9	14507650	14507827	BolC9t54902H	0	-	335	177	177	1.0000000
C9	14522120	14523350	BolC9t54903H	0	+	8	24	1230	0.0195122
C9	14523873	14524543	BolC9t54904H	0	-	17	349	670	0.5208955
C9	14527698	14528447	BolC9t54905H	0	+	38	498	749	0.6648865
C9	14533118	14533431	BolC9t54906H	0	-	53	313	313	1.0000000
C9	14533502	14534644	BolC9t54907H	0	-	378	1142	1142	1.0000000
C9	14538502	14538652	BolC9t54908H	0	-	12	87	150	0.5800000
C9	14539313	14539442	BolC9t54909H	0	-	11	129	129	1.0000000
C9	14543940	14545335	BolC9t54910H	0	+	144	466	1395	0.3340502
C9	14546495	14546930	BolC9t54911H	0	+	382	435	435	1.0000000
C9	14555542	14557637	BolC9t54912H	0	+	128	1504	2095	0.7178997
C9	14563306	14563751	BolC9t54913H	0	+	73	409	445	0.9191011
C9	14566454	14566706	BolC9t54914H	0	-	257	252	252	1.0000000
C9	14593094	14594208	BolC9t54915H	0	+	796	1106	1114	0.9928187
C9	14608539	14609793	BolC9t54916H	0	+	433	1221	1254	0.9736842
C9	14618404	14619463	BolC9t54917H	0	+	726	1059	1059	1.0000000
C9	14623857	14624220	BolC9t54918H	0	-	72	363	363	1.0000000
C9	14632137	14632323	BolC9t54919H	0	+	46	186	186	1.0000000
C9	14634855	14649011	BolC9t54920H	0	-	6044	11180	14156	0.7897711
C9	14675537	14676134	BolC9t54921H	0	-	13	232	597	0.3886097
C9	14680275	14680647	BolC9t54922H	0	+	0	0	372	0.0000000
C9	14693393	14695761	BolC9t54923H	0	+	422	1951	2368	0.8239020
C9	14707583	14708102	BolC9t54924H	0	+	464	432	519	0.8323699
C9	14726618	14729586	BolC9t54925H	0	+	510	2405	2968	0.8103099
C9	14742163	14748269	BolC9t54926H	0	-	1240	4177	6106	0.6840813
C9	14752775	14753519	BolC9t54927H	0	-	159	744	744	1.0000000
C9	14764960	14765801	BolC9t54928H	0	-	557	816	841	0.9702735
C9	14774703	14775716	BolC9t54929H	0	+	54	769	1013	0.7591313
C9	14779474	14779651	BolC9t54930H	0	-	280	177	177	1.0000000
C9	14780305	14782319	BolC9t54931H	0	+	1177	1918	2014	0.9523337
C9	14782569	14783210	BolC9t54932H	0	-	318	641	641	1.0000000
C9	14811773	14815431	BolC9t54933H	0	+	2440	3377	3658	0.9231821
C9	14817184	14818324	BolC9t54934H	0	+	363	932	1140	0.8175439
C9	14842101	14843891	BolC9t54935H	0	+	316	1468	1790	0.8201118
C9	14846923	14847466	BolC9t54936H	0	-	342	543	543	1.0000000
C9	14859373	14859577	BolC9t54937H	0	+	344	204	204	1.0000000
C9	14866471	14868460	BolC9t54938H	0	+	213	976	1989	0.4906988
C9	14875019	14875226	BolC9t54939H	0	+	155	207	207	1.0000000
C9	14885530	14896601	BolC9t54940H	0	+	1750	7379	11071	0.6665161
C9	14904734	14918803	BolC9t54941H	0	+	7802	13712	14069	0.9746251
C9	14912641	14913484	BolC9t54942H	0	+	15	584	843	0.6927639
C9	14936445	14945763	BolC9t54943H	0	+	9157	9318	9318	1.0000000
C9	14949896	14950337	BolC9t54944H	0	+	293	441	441	1.0000000
C9	14952618	14953227	BolC9t54945H	0	+	437	609	609	1.0000000
C9	14956705	14957145	BolC9t54946H	0	+	451	440	440	1.0000000
C9	14957501	14962003	BolC9t54947H	0	+	3323	4410	4502	0.9795647
C9	14979809	14980049	BolC9t54948H	0	+	2	240	240	1.0000000
C9	14982587	14982785	BolC9t54949H	0	+	18	131	198	0.6616161
C9	14985367	14985607	BolC9t54950H	0	+	79	240	240	1.0000000
C9	14988143	14988383	BolC9t54951H	0	+	112	240	240	1.0000000
C9	14990920	14991160	BolC9t54952H	0	+	125	240	240	1.0000000
C9	14993669	14993909	BolC9t54953H	0	+	64	240	240	1.0000000
C9	14996657	14997441	BolC9t54954H	0	+	1929	784	784	1.0000000
C9	15000547	15000787	BolC9t54955H	0	+	109	240	240	1.0000000
C9	15002282	15002411	BolC9t54956H	0	+	205	129	129	1.0000000
C9	15006159	15011855	BolC9t54957H	0	+	1445	4263	5696	0.7484199
C9	15013420	15013874	BolC9t54958H	0	+	296	454	454	1.0000000
C9	15017872	15018870	BolC9t54959H	0	-	99	796	998	0.7975952
C9	15024507	15027552	BolC9t54960H	0	+	72	852	3045	0.2798029
C9	15056727	15059823	BolC9t54961H	0	+	552	2712	3096	0.8759690
C9	15063323	15066215	BolC9t54962H	0	+	3561	2892	2892	1.0000000
C9	15076019	15079066	BolC9t54963H	0	+	569	2609	3047	0.8562521
C9	15082251	15084119	BolC9t54964H	0	-	23	150	1868	0.0802998
C9	15123079	15130291	BolC9t54965H	0	+	1374	5344	7212	0.7409872
C9	15132574	15134293	BolC9t54966H	0	-	652	1697	1719	0.9872019
C9	15145151	15146464	BolC9t54967H	0	-	1223	1313	1313	1.0000000
C9	15147982	15148716	BolC9t54968H	0	-	33	646	734	0.8801090
C9	15166335	15167816	BolC9t54969H	0	+	1282	1481	1481	1.0000000
C9	15171436	15171904	BolC9t54970H	0	+	248	468	468	1.0000000
C9	15172472	15174561	BolC9t54971H	0	-	944	2085	2089	0.9980852
C9	15180943	15182386	BolC9t54972H	0	-	1288	1443	1443	1.0000000
C9	15194261	15196688	BolC9t54973H	0	-	1990	2427	2427	1.0000000
C9	15200320	15202846	BolC9t54974H	0	-	230	1041	2526	0.4121140
C9	15207959	15215304	BolC9t54975H	0	+	4906	7345	7345	1.0000000
C9	15221281	15221727	BolC9t54976H	0	-	614	446	446	1.0000000
C9	15221636	15225210	BolC9t54977H	0	-	5664	3397	3574	0.9504756
C9	15227800	15240580	BolC9t54978H	0	-	3443	11454	12780	0.8962441
C9	15248137	15248366	BolC9t54979H	0	-	113	229	229	1.0000000
C9	15250601	15250724	BolC9t54980H	0	-	435	123	123	1.0000000
C9	15271491	15273726	BolC9t54981H	0	-	2326	2235	2235	1.0000000
C9	15271719	15272664	BolC9t54982H	0	-	695	945	945	1.0000000
C9	15275786	15283210	BolC9t54983H	0	-	1336	5080	7424	0.6842672
C9	15286856	15288031	BolC9t54984H	0	+	261	1175	1175	1.0000000
C9	15288108	15288690	BolC9t54985H	0	+	135	582	582	1.0000000
C9	15289104	15289384	BolC9t54986H	0	+	154	280	280	1.0000000
C9	15292948	15294665	BolC9t54987H	0	-	803	1717	1717	1.0000000
C9	15298548	15299112	BolC9t54988H	0	-	210	564	564	1.0000000
C9	15345446	15346870	BolC9t54989H	0	-	2	81	1424	0.0568820
C9	15353509	15356357	BolC9t54990H	0	+	1415	2790	2848	0.9796348
C9	15356532	15357891	BolC9t54991H	0	+	447	1023	1359	0.7527594
C9	15387343	15387538	BolC9t54992H	0	+	222	195	195	1.0000000
C9	15392810	15396254	BolC9t54993H	0	+	1414	3303	3444	0.9590592
C9	15396710	15398409	BolC9t54994H	0	-	1527	1666	1699	0.9805768
C9	15417440	15418197	BolC9t54995H	0	-	42	590	757	0.7793924
C9	15435557	15437362	BolC9t54996H	0	+	102	950	1805	0.5263158
C9	15443627	15445516	BolC9t54997H	0	+	143	1335	1889	0.7067232
C9	15448103	15449378	BolC9t54998H	0	+	356	1243	1275	0.9749020
C9	15449923	15450370	BolC9t54999H	0	-	51	426	447	0.9530202
C9	15451679	15455668	BolC9t55000H	0	-	1262	2928	3989	0.7340186
C9	15462845	15463139	BolC9t55001H	0	-	270	294	294	1.0000000
C9	15465494	15465740	BolC9t55002H	0	-	276	246	246	1.0000000
C9	15478255	15481119	BolC9t55003H	0	-	2038	2864	2864	1.0000000
C9	15478586	15479054	BolC9t55004H	0	-	419	468	468	1.0000000
C9	15484149	15485701	BolC9t55005H	0	+	990	1552	1552	1.0000000
C9	15492145	15492295	BolC9t55006H	0	-	68	150	150	1.0000000
C9	15494467	15501207	BolC9t55007H	0	+	2462	3475	6740	0.5155786
C9	15501794	15502538	BolC9t55008H	0	+	176	601	744	0.8077957
C9	15510450	15510693	BolC9t55009H	0	+	139	243	243	1.0000000
C9	15524551	15525616	BolC9t55010H	0	+	277	1009	1065	0.9474179
C9	15526580	15527735	BolC9t55011H	0	+	255	782	1155	0.6770563
C9	15538034	15539141	BolC9t55012H	0	-	174	1021	1107	0.9223126
C9	15546780	15551970	BolC9t55013H	0	-	2466	4089	5190	0.7878613
C9	15592941	15593665	BolC9t55014H	0	-	356	724	724	1.0000000
C9	15601447	15601768	BolC9t55015H	0	-	259	321	321	1.0000000
C9	15627657	15627960	BolC9t55016H	0	+	15	302	303	0.9966997
C9	15630590	15631696	BolC9t55017H	0	+	678	1075	1106	0.9719711
C9	15632221	15633231	BolC9t55018H	0	+	457	1010	1010	1.0000000
C9	15633404	15633887	BolC9t55019H	0	-	226	483	483	1.0000000
C9	15634484	15635781	BolC9t55020H	0	-	761	1297	1297	1.0000000
C9	15637743	15638705	BolC9t55021H	0	-	90	962	962	1.0000000
C9	15658827	15664399	BolC9t55022H	0	+	1960	5304	5572	0.9519024
C9	15674710	15675307	BolC9t55023H	0	-	171	597	597	1.0000000
C9	15680646	15681258	BolC9t55024H	0	+	0	0	612	0.0000000
C9	15687655	15713023	BolC9t55025H	0	+	10929	19541	25368	0.7703012
C9	15692540	15694266	BolC9t55026H	0	+	115	450	1726	0.2607184
C9	15714854	15715295	BolC9t55027H	0	+	86	358	441	0.8117914
C9	15724560	15725581	BolC9t55028H	0	-	109	776	1021	0.7600392
C9	15733312	15733762	BolC9t55029H	0	+	23	384	450	0.8533334
C9	15734415	15736141	BolC9t55030H	0	-	567	1627	1726	0.9426420
C9	15736196	15736443	BolC9t55031H	0	-	49	247	247	1.0000000
C9	15749778	15750179	BolC9t55032H	0	+	82	348	401	0.8678304
C9	15752849	15758588	BolC9t55033H	0	+	750	4189	5739	0.7299181
C9	15755495	15756649	BolC9t55034H	0	+	241	1060	1154	0.9185442
C9	15762179	15762561	BolC9t55035H	0	+	22	249	382	0.6518325
C9	15769795	15774821	BolC9t55036H	0	+	1296	4593	5026	0.9138480
C9	15779455	15779963	BolC9t55037H	0	-	42	385	508	0.7578740
C9	15789105	15789267	BolC9t55038H	0	-	0	0	162	0.0000000
C9	15791498	15796713	BolC9t55039H	0	-	2490	4670	5215	0.8954937
C9	15805331	15810681	BolC9t55040H	0	+	4590	5213	5350	0.9743925
C9	15813260	15815384	BolC9t55041H	0	+	993	2033	2124	0.9571563
C9	15819614	15821874	BolC9t55042H	0	+	550	2052	2260	0.9079646
C9	15824709	15826666	BolC9t55043H	0	+	460	1835	1957	0.9376597
C9	15828671	15829004	BolC9t55044H	0	-	104	333	333	1.0000000
C9	15836453	15838639	BolC9t55045H	0	-	2	20	2186	0.0091491
C9	15861891	15862971	BolC9t55046H	0	-	119	720	1080	0.6666667
C9	15874816	15875669	BolC9t55047H	0	+	231	305	853	0.3575616
C9	15884715	15885162	BolC9t55048H	0	-	347	444	447	0.9932886
C9	15886432	15887099	BolC9t55049H	0	-	450	667	667	1.0000000
C9	15890181	15890944	BolC9t55050H	0	+	182	750	763	0.9829620
C9	15907787	15908867	BolC9t55051H	0	-	341	1080	1080	1.0000000
C9	15911368	15913066	BolC9t55052H	0	+	520	1608	1698	0.9469965
C9	15913429	15913951	BolC9t55053H	0	-	85	278	522	0.5325670
C9	15916537	15923463	BolC9t55054H	0	+	2541	5582	6926	0.8059486
C9	15923702	15925457	BolC9t55055H	0	+	200	1077	1755	0.6136752
C9	15927183	15933544	BolC9t55056H	0	+	4075	6361	6361	1.0000000
C9	15934996	15936799	BolC9t55057H	0	+	71	1367	1803	0.7581808
C9	15937047	15937455	BolC9t55058H	0	-	49	400	408	0.9803922
C9	15939027	15939168	BolC9t55059H	0	-	14	116	141	0.8226950
C9	15939287	15940187	BolC9t55060H	0	-	149	792	900	0.8800000
C9	15940802	15941160	BolC9t55061H	0	+	0	0	358	0.0000000
C9	15941262	15941669	BolC9t55062H	0	-	3	150	407	0.3685504
C9	15942545	15943540	BolC9t55063H	0	+	80	712	995	0.7155779
C9	15946864	15947359	BolC9t55064H	0	+	455	495	495	1.0000000
C9	15949186	15950814	BolC9t55065H	0	+	592	1618	1628	0.9938575
C9	15958825	15959248	BolC9t55066H	0	+	109	319	423	0.7541371
C9	15979063	15981649	BolC9t55067H	0	-	1257	2586	2586	1.0000000
C9	16007914	16008504	BolC9t55068H	0	+	400	590	590	1.0000000
C9	16008791	16009523	BolC9t55069H	0	-	577	732	732	1.0000000
C9	16014340	16015027	BolC9t55070H	0	+	0	0	687	0.0000000
C9	16017516	16018203	BolC9t55071H	0	-	4	19	687	0.0276565
C9	16020652	16021342	BolC9t55072H	0	-	0	0	690	0.0000000
C9	16023014	16023638	BolC9t55073H	0	-	0	0	624	0.0000000
C9	16026508	16031872	BolC9t55074H	0	-	73	946	5364	0.1763609
C9	16033091	16033499	BolC9t55075H	0	+	448	408	408	1.0000000
C9	16033966	16035655	BolC9t55076H	0	+	727	1689	1689	1.0000000
C9	16077560	16079990	BolC9t55077H	0	+	385	1972	2430	0.8115227
C9	16080611	16081829	BolC9t55078H	0	-	638	1096	1218	0.8998358
C9	16095220	16097147	BolC9t55079H	0	+	928	1896	1927	0.9839128
C9	16098084	16100503	BolC9t55080H	0	-	1095	2349	2419	0.9710624
C9	16107231	16109004	BolC9t55081H	0	-	305	1672	1773	0.9430344
C9	16117662	16119941	BolC9t55082H	0	-	546	2276	2279	0.9986836
C9	16131035	16131221	BolC9t55083H	0	+	0	0	186	0.0000000
C9	16147292	16147985	BolC9t55084H	0	-	16	438	693	0.6320347
C9	16148703	16152869	BolC9t55085H	0	+	955	3419	4166	0.8206913
C9	16154395	16155588	BolC9t55086H	0	+	267	1086	1193	0.9103101
C9	16156543	16156783	BolC9t55087H	0	-	78	240	240	1.0000000
C9	16169934	16170069	BolC9t55088H	0	-	44	135	135	1.0000000
C9	16178444	16179769	BolC9t55089H	0	+	116	788	1325	0.5947170
C9	16183327	16184554	BolC9t55090H	0	+	123	420	1227	0.3422983
C9	16200103	16203933	BolC9t55091H	0	+	400	2898	3830	0.7566580
C9	16205689	16242685	BolC9t55092H	0	+	4316	18064	36996	0.4882690
C9	16210422	16211133	BolC9t55093H	0	+	1	126	711	0.1772152
C9	16221833	16222219	BolC9t55094H	0	+	0	0	386	0.0000000
C9	16230984	16231484	BolC9t55095H	0	+	152	486	500	0.9720000
C9	16247166	16247289	BolC9t55096H	0	+	0	0	123	0.0000000
C9	16249408	16249663	BolC9t55097H	0	-	0	0	255	0.0000000
C9	16257942	16258844	BolC9t55098H	0	+	3	160	902	0.1773836
C9	16264652	16265851	BolC9t55099H	0	-	895	1199	1199	1.0000000
C9	16270866	16272904	BolC9t55100H	0	+	690	2011	2038	0.9867517
C9	16273101	16276315	BolC9t55101H	0	-	938	3024	3214	0.9408836
C9	16277394	16277891	BolC9t55102H	0	+	307	497	497	1.0000000
C9	16294249	16295215	BolC9t55103H	0	-	151	801	966	0.8291925
C9	16311241	16312449	BolC9t55104H	0	-	19	528	1208	0.4370861
C9	16334459	16342718	BolC9t55105H	0	-	6258	7719	8259	0.9346168
C9	16356467	16357801	BolC9t55106H	0	+	3585	1334	1334	1.0000000
C9	16378820	16379176	BolC9t55107H	0	+	31	194	356	0.5449438
C9	16384795	16385413	BolC9t55108H	0	-	624	618	618	1.0000000
C9	16390945	16392484	BolC9t55109H	0	+	655	1407	1539	0.9142300
C9	16398345	16400798	BolC9t55110H	0	-	430	1851	2453	0.7545862
C9	16401918	16402409	BolC9t55111H	0	-	60	491	491	1.0000000
C9	16413792	16414065	BolC9t55112H	0	+	0	0	273	0.0000000
C9	16430854	16431271	BolC9t55113H	0	+	113	417	417	1.0000000
C9	16431385	16431906	BolC9t55114H	0	+	0	0	521	0.0000000
C9	16442570	16443227	BolC9t55115H	0	+	328	657	657	1.0000000
C9	16452354	16452543	BolC9t55116H	0	-	138	189	189	1.0000000
C9	16454645	16461865	BolC9t55117H	0	-	6976	7220	7220	1.0000000
C9	16481440	16482150	BolC9t55118H	0	-	786	710	710	1.0000000
C9	16488231	16490363	BolC9t55119H	0	+	107	1153	2132	0.5408068
C9	16509752	16510169	BolC9t55120H	0	+	185	417	417	1.0000000
C9	16510476	16510878	BolC9t55121H	0	+	240	402	402	1.0000000
C9	16534088	16534811	BolC9t55122H	0	+	152	599	723	0.8284924
C9	16536717	16537561	BolC9t55123H	0	+	449	844	844	1.0000000
C9	16538448	16539517	BolC9t55124H	0	+	834	1069	1069	1.0000000
C9	16540759	16541173	BolC9t55125H	0	+	235	414	414	1.0000000
C9	16541896	16546533	BolC9t55126H	0	+	440	3346	4637	0.7215872
C9	16546587	16548617	BolC9t55127H	0	-	786	2011	2030	0.9906404
C9	16565931	16566819	BolC9t55128H	0	-	95	815	888	0.9177928
C9	16569074	16569278	BolC9t55129H	0	-	141	204	204	1.0000000
C9	16575874	16577200	BolC9t55130H	0	+	195	1086	1326	0.8190045
C9	16589840	16590902	BolC9t55131H	0	-	354	1057	1062	0.9952919
C9	16598177	16599510	BolC9t55132H	0	+	790	1333	1333	1.0000000
C9	16601432	16602644	BolC9t55133H	0	+	403	1212	1212	1.0000000
C9	16608982	16613815	BolC9t55134H	0	-	1949	4496	4833	0.9302710
C9	16628803	16629306	BolC9t55135H	0	+	87	440	503	0.8747515
C9	16636944	16637538	BolC9t55136H	0	+	3	113	594	0.1902357
C9	16662463	16664280	BolC9t55137H	0	+	607	1817	1817	1.0000000
C9	16669000	16678069	BolC9t55138H	0	+	1626	3838	9069	0.4231999
C9	16681776	16682283	BolC9t55139H	0	-	81	486	507	0.9585799
C9	16683024	16685207	BolC9t55140H	0	-	194	1442	2183	0.6605589
C9	16693381	16694925	BolC9t55141H	0	+	67	814	1544	0.5272021
C9	16711381	16716052	BolC9t55142H	0	+	4502	4671	4671	1.0000000
C9	16728967	16729867	BolC9t55143H	0	-	516	900	900	1.0000000
C9	16745774	16747135	BolC9t55144H	0	-	2681	1335	1361	0.9808964
C9	16747957	16750550	BolC9t55145H	0	-	1317	2340	2593	0.9024296
C9	16791478	16791895	BolC9t55146H	0	+	466	417	417	1.0000000
C9	16791980	16793005	BolC9t55147H	0	+	1140	1025	1025	1.0000000
C9	16814618	16815809	BolC9t55148H	0	+	155	810	1191	0.6801007
C9	16817171	16817885	BolC9t55149H	0	+	879	714	714	1.0000000
C9	16818816	16819068	BolC9t55150H	0	+	235	252	252	1.0000000
C9	16822940	16823569	BolC9t55151H	0	+	278	629	629	1.0000000
C9	16824054	16825332	BolC9t55152H	0	-	606	1278	1278	1.0000000
C9	16826904	16827480	BolC9t55153H	0	-	233	576	576	1.0000000
C9	16846664	16850757	BolC9t55154H	0	-	2560	3925	4093	0.9589543
C9	16856700	16858270	BolC9t55155H	0	-	773	1507	1570	0.9598726
C9	16873087	16873614	BolC9t55156H	0	-	281	487	527	0.9240987
C9	16877193	16877687	BolC9t55157H	0	+	191	427	494	0.8643725
C9	16879372	16879501	BolC9t55158H	0	-	5	69	129	0.5348837
C9	16880394	16882951	BolC9t55159H	0	-	134	1292	2557	0.5052796
C9	16890649	16894644	BolC9t55160H	0	-	1439	3913	3995	0.9794744
C9	16898252	16900502	BolC9t55161H	0	-	669	2151	2250	0.9560000
C9	16932511	16932817	BolC9t55162H	0	-	117	306	306	1.0000000
C9	16935701	16937076	BolC9t55163H	0	-	491	1221	1375	0.8880000
C9	16936308	16936665	BolC9t55164H	0	-	231	357	357	1.0000000
C9	16944860	16946038	BolC9t55165H	0	+	674	1178	1178	1.0000000
C9	16947289	16948276	BolC9t55166H	0	-	512	931	987	0.9432624
C9	16971009	16971636	BolC9t55167H	0	-	167	554	627	0.8835726
C9	16984194	16984984	BolC9t55168H	0	-	1024	790	790	1.0000000
C9	16985877	16994474	BolC9t55169H	0	+	60	1123	8597	0.1306270
C9	16994501	16997936	BolC9t55170H	0	+	83	719	3435	0.2093159
C9	17000207	17004804	BolC9t55171H	0	+	182	2153	4597	0.4683489
C9	17007132	17007461	BolC9t55172H	0	+	4	117	329	0.3556231
C9	17008638	17009079	BolC9t55173H	0	+	0	0	441	0.0000000
C9	17009463	17019272	BolC9t55174H	0	+	6	425	9809	0.0433276
C9	17037769	17038298	BolC9t55175H	0	-	2	205	529	0.3875236
C9	17038487	17038784	BolC9t55176H	0	-	0	0	297	0.0000000
C9	17039481	17047982	BolC9t55177H	0	-	25	915	8501	0.1076344
C9	17050492	17050933	BolC9t55178H	0	-	62	402	441	0.9115646
C9	17051190	17051964	BolC9t55179H	0	-	68	472	774	0.6098191
C9	17071766	17072216	BolC9t55180H	0	+	38	256	450	0.5688889
C9	17079718	17080932	BolC9t55181H	0	-	1236	1214	1214	1.0000000
C9	17081402	17082506	BolC9t55182H	0	-	867	1104	1104	1.0000000
C9	17093771	17099236	BolC9t55183H	0	+	2704	5465	5465	1.0000000
C9	17118062	17119438	BolC9t55184H	0	-	605	1346	1376	0.9781977
C9	17120542	17120764	BolC9t55185H	0	-	76	222	222	1.0000000
C9	17130378	17131589	BolC9t55186H	0	-	243	1053	1211	0.8695293
C9	17134242	17134878	BolC9t55187H	0	+	1280	636	636	1.0000000
C9	17135199	17136011	BolC9t55188H	0	+	1215	812	812	1.0000000
C9	17136778	17137417	BolC9t55189H	0	+	1072	639	639	1.0000000
C9	17137841	17138459	BolC9t55190H	0	+	974	618	618	1.0000000
C9	17146903	17149331	BolC9t55191H	0	+	886	2013	2428	0.8290774
C9	17151122	17151653	BolC9t55192H	0	-	54	463	531	0.8719397
C9	17153176	17153397	BolC9t55193H	0	+	21	155	221	0.7013575
C9	17178504	17179035	BolC9t55194H	0	-	30	236	531	0.4444444
C9	17179994	17182783	BolC9t55195H	0	+	3859	2789	2789	1.0000000
C9	17209812	17212836	BolC9t55196H	0	+	1829	2862	3024	0.9464286
C9	17237624	17241296	BolC9t55197H	0	-	1365	3405	3672	0.9272876
C9	17241196	17246320	BolC9t55198H	0	-	2896	5059	5124	0.9873146
C9	17260539	17261192	BolC9t55199H	0	-	436	653	653	1.0000000
C9	17262091	17262328	BolC9t55200H	0	-	223	237	237	1.0000000
C9	17267026	17270912	BolC9t55201H	0	-	1095	2720	3886	0.6999485
C9	17272680	17272932	BolC9t55202H	0	+	142	252	252	1.0000000
C9	17285152	17285770	BolC9t55203H	0	+	441	618	618	1.0000000
C9	17290189	17290468	BolC9t55204H	0	+	445	279	279	1.0000000
C9	17298430	17298871	BolC9t55205H	0	-	90	439	441	0.9954649
C9	17299100	17299587	BolC9t55206H	0	+	167	487	487	1.0000000
C9	17326349	17330627	BolC9t55207H	0	+	1463	4069	4278	0.9511454
C9	17365909	17366353	BolC9t55208H	0	+	10	63	444	0.1418919
C9	17389205	17391075	BolC9t55209H	0	-	58	524	1870	0.2802139
C9	17418604	17418904	BolC9t55210H	0	+	665	300	300	1.0000000
C9	17443502	17443676	BolC9t55211H	0	-	474	174	174	1.0000000
C9	17445079	17446753	BolC9t55212H	0	+	38	875	1674	0.5227001
C9	17463377	17470034	BolC9t55213H	0	-	2271	6293	6657	0.9453207
C9	17472365	17473454	BolC9t55214H	0	+	181	1036	1089	0.9513315
C9	17474934	17475039	BolC9t55215H	0	+	109	105	105	1.0000000
C9	17476685	17476874	BolC9t55216H	0	-	447	189	189	1.0000000
C9	17480098	17480472	BolC9t55217H	0	+	314	374	374	1.0000000
C9	17483375	17485396	BolC9t55218H	0	+	686	1946	2021	0.9628897
C9	17488427	17493984	BolC9t55219H	0	-	2970	5155	5557	0.9276588
C9	17495232	17496261	BolC9t55220H	0	-	281	1012	1029	0.9834791
C9	17501603	17502381	BolC9t55221H	0	+	153	778	778	1.0000000
C9	17522854	17523388	BolC9t55222H	0	-	173	494	534	0.9250937
C9	17523540	17523894	BolC9t55223H	0	-	166	354	354	1.0000000
C9	17600439	17609767	BolC9t55224H	0	+	3659	7834	9328	0.8398371
C9	17613217	17614237	BolC9t55225H	0	+	1319	1020	1020	1.0000000
C9	17616472	17617970	BolC9t55226H	0	+	1562	1498	1498	1.0000000
C9	17626511	17627685	BolC9t55227H	0	+	247	758	1174	0.6456559
C9	17629729	17641091	BolC9t55228H	0	+	447	4100	11362	0.3608520
C9	17642348	17643307	BolC9t55229H	0	-	656	959	959	1.0000000
C9	17646351	17649747	BolC9t55230H	0	+	823	2658	3396	0.7826855
C9	17652083	17652212	BolC9t55231H	0	-	4	122	129	0.9457364
C9	17653831	17654218	BolC9t55232H	0	+	229	387	387	1.0000000
C9	17669872	17671141	BolC9t55233H	0	-	137	825	1269	0.6501182
C9	17671213	17671432	BolC9t55234H	0	-	28	169	219	0.7716895
C9	17674059	17675426	BolC9t55235H	0	+	184	1157	1367	0.8463789
C9	17683172	17684351	BolC9t55236H	0	+	201	1174	1179	0.9957591
C9	17690321	17692568	BolC9t55237H	0	-	9	519	2247	0.2309746
C9	17694487	17697223	BolC9t55238H	0	+	2049	2736	2736	1.0000000
C9	17697818	17698523	BolC9t55239H	0	-	90	675	705	0.9574468
C9	17711351	17711788	BolC9t55240H	0	+	576	437	437	1.0000000
C9	17718911	17731154	BolC9t55241H	0	+	3064	9021	12243	0.7368292
C9	17733105	17734803	BolC9t55242H	0	+	959	1665	1698	0.9805654
C9	17740618	17740942	BolC9t55243H	0	-	107	324	324	1.0000000
C9	17762036	17766395	BolC9t55244H	0	+	1119	3118	4359	0.7153017
C9	17773507	17792433	BolC9t55245H	0	+	5762	16814	18926	0.8884075
C9	17775838	17776358	BolC9t55246H	0	-	14	20	520	0.0384615
C9	17794787	17795873	BolC9t55247H	0	-	74	808	1086	0.7440147
C9	17796002	17796666	BolC9t55248H	0	-	278	664	664	1.0000000
C9	17816676	17817371	BolC9t55249H	0	-	467	690	695	0.9928058
C9	17821313	17822139	BolC9t55250H	0	-	153	704	826	0.8523002
C9	17828136	17828579	BolC9t55251H	0	-	425	443	443	1.0000000
C9	17830106	17830235	BolC9t55252H	0	-	62	129	129	1.0000000
C9	17831795	17833248	BolC9t55253H	0	-	1600	1453	1453	1.0000000
C9	17836189	17838718	BolC9t55254H	0	+	1914	2494	2529	0.9861605
C9	17839306	17839495	BolC9t55255H	0	-	454	189	189	1.0000000
C9	17843773	17845264	BolC9t55256H	0	+	28	891	1491	0.5975855
C9	17862770	17864261	BolC9t55257H	0	+	87	806	1491	0.5405768
C9	17869473	17870919	BolC9t55258H	0	+	361	822	1446	0.5684648
C9	17871602	17872178	BolC9t55259H	0	+	0	0	576	0.0000000
C9	17874077	17875212	BolC9t55260H	0	+	4	260	1135	0.2290749
C9	17879921	17880263	BolC9t55261H	0	-	48	277	342	0.8099415
C9	17890062	17892702	BolC9t55262H	0	+	397	2504	2640	0.9484848
C9	17897475	17899278	BolC9t55263H	0	+	285	1409	1803	0.7814753
C9	17901841	17902186	BolC9t55264H	0	+	7	132	345	0.3826087
C9	17918005	17918158	BolC9t55265H	0	-	38	153	153	1.0000000
C9	17921475	17923160	BolC9t55266H	0	+	349	1267	1685	0.7519288
C9	17924359	17925680	BolC9t55267H	0	+	228	1253	1321	0.9485238
C9	17937645	17939677	BolC9t55268H	0	+	899	1954	2032	0.9616142
C9	17940505	17941657	BolC9t55269H	0	-	833	1152	1152	1.0000000
C9	17942417	17942789	BolC9t55270H	0	-	218	372	372	1.0000000
C9	17947805	17950441	BolC9t55271H	0	-	1355	2636	2636	1.0000000
C9	17952873	17953187	BolC9t55272H	0	-	97	314	314	1.0000000
C9	17953210	17953468	BolC9t55273H	0	-	240	258	258	1.0000000
C9	17965767	17966389	BolC9t55274H	0	-	14	288	622	0.4630225
C9	17979918	17980815	BolC9t55275H	0	-	150	885	897	0.9866221
C9	17985395	17985959	BolC9t55276H	0	-	200	564	564	1.0000000
C9	17993082	17993499	BolC9t55277H	0	+	632	417	417	1.0000000
C9	17995494	17996988	BolC9t55278H	0	-	790	1494	1494	1.0000000
C9	18000039	18000822	BolC9t55279H	0	+	6	193	783	0.2464879
C9	18021616	18022931	BolC9t55280H	0	+	233	1087	1315	0.8266160
C9	18025104	18026844	BolC9t55281H	0	-	377	1642	1740	0.9436781
C9	18028830	18029585	BolC9t55282H	0	-	154	683	755	0.9046358
C9	18031115	18032609	BolC9t55283H	0	-	632	1470	1494	0.9839357
C9	18042102	18063257	BolC9t55284H	0	+	9006	18134	21155	0.8571969
C9	18052112	18058293	BolC9t55285H	0	+	733	4326	6181	0.6998867
C9	18057066	18057534	BolC9t55286H	0	+	3	279	468	0.5961539
C9	18068533	18070294	BolC9t55287H	0	+	1	139	1761	0.0789324
C9	18093741	18093999	BolC9t55288H	0	+	34	258	258	1.0000000
C9	18094421	18096726	BolC9t55289H	0	-	444	1880	2305	0.8156182
C9	18097892	18098405	BolC9t55290H	0	+	237	513	513	1.0000000
C9	18124499	18125093	BolC9t55291H	0	-	1	97	594	0.1632997
C9	18125431	18126436	BolC9t55292H	0	-	6	422	1005	0.4199005
C9	18141556	18142102	BolC9t55293H	0	+	25	539	546	0.9871795
C9	18144206	18145013	BolC9t55294H	0	+	383	807	807	1.0000000
C9	18167653	18168770	BolC9t55295H	0	+	77	836	1117	0.7484333
C9	18171162	18171417	BolC9t55296H	0	+	40	220	255	0.8627451
C9	18172826	18178768	BolC9t55297H	0	-	416	2731	5942	0.4596096
C9	18184292	18186443	BolC9t55298H	0	+	238	970	2151	0.4509530
C9	18204247	18206505	BolC9t55299H	0	+	276	1601	2258	0.7090346
C9	18206781	18210535	BolC9t55300H	0	-	195	2394	3754	0.6377198
C9	18218737	18227970	BolC9t55301H	0	-	2811	8071	9233	0.8741471
C9	18237792	18240575	BolC9t55302H	0	+	178	562	2783	0.2019404
C9	18241820	18243422	BolC9t55303H	0	-	467	1441	1602	0.8995006
C9	18244735	18247117	BolC9t55304H	0	-	628	2330	2382	0.9781696
C9	18253096	18254725	BolC9t55305H	0	-	580	1480	1629	0.9085329
C9	18270263	18273230	BolC9t55306H	0	+	621	2636	2967	0.8884395
C9	18283361	18283829	BolC9t55307H	0	+	237	459	468	0.9807692
C9	18284400	18286793	BolC9t55308H	0	-	605	2205	2393	0.9214375
C9	18309964	18316229	BolC9t55309H	0	+	387	972	6265	0.1551476
C9	18318708	18340355	BolC9t55310H	0	-	7114	17909	21647	0.8273202
C9	18319557	18320289	BolC9t55311H	0	+	87	610	732	0.8333333
C9	18343267	18343588	BolC9t55312H	0	+	78	321	321	1.0000000
C9	18346303	18349224	BolC9t55313H	0	-	157	1838	2921	0.6292366
C9	18354911	18360919	BolC9t55314H	0	-	1801	5806	6008	0.9663782
C9	18361127	18361400	BolC9t55315H	0	+	16	215	273	0.7875458
C9	18362678	18363655	BolC9t55316H	0	-	3	26	977	0.0266121
C9	18376630	18377766	BolC9t55317H	0	-	450	1136	1136	1.0000000
C9	18408680	18409009	BolC9t55318H	0	-	382	329	329	1.0000000
C9	18419409	18419595	BolC9t55319H	0	-	111	186	186	1.0000000
C9	18420789	18420960	BolC9t55320H	0	-	0	0	171	0.0000000
C9	18421310	18422831	BolC9t55321H	0	-	201	1283	1521	0.8435240
C9	18423755	18425165	BolC9t55322H	0	-	929	1410	1410	1.0000000
C9	18427942	18429263	BolC9t55323H	0	-	285	1312	1321	0.9931870
C9	18431500	18434014	BolC9t55324H	0	+	869	2174	2514	0.8647574
C9	18447876	18448803	BolC9t55325H	0	+	454	927	927	1.0000000
C9	18449429	18452553	BolC9t55326H	0	-	466	2786	3124	0.8918054
C9	18462442	18462736	BolC9t55327H	0	+	105	294	294	1.0000000
C9	18479231	18480323	BolC9t55328H	0	+	19	559	1092	0.5119048
C9	18524248	18524662	BolC9t55329H	0	+	1	129	414	0.3115942
C9	18541566	18542351	BolC9t55330H	0	+	703	785	785	1.0000000
C9	18557223	18559046	BolC9t55331H	0	-	43	610	1823	0.3346133
C9	18561057	18563525	BolC9t55332H	0	-	825	2190	2468	0.8873582
C9	18583464	18586121	BolC9t55333H	0	-	473	2429	2657	0.9141889
C9	18586197	18586470	BolC9t55334H	0	-	194	273	273	1.0000000
C9	18591632	18592433	BolC9t55335H	0	+	650	801	801	1.0000000
C9	18598820	18599131	BolC9t55336H	0	-	491	311	311	1.0000000
C9	18608934	18610345	BolC9t55337H	0	-	646	1342	1411	0.9510985
C9	18613143	18613373	BolC9t55338H	0	+	534	230	230	1.0000000
C9	18614928	18617406	BolC9t55339H	0	-	1031	2384	2478	0.9620662
C9	18626062	18627665	BolC9t55340H	0	+	255	1574	1603	0.9819089
C9	18637805	18639215	BolC9t55341H	0	+	241	1029	1410	0.7297872
C9	18639404	18642699	BolC9t55342H	0	-	1253	2415	3295	0.7329287
C9	18644207	18645846	BolC9t55343H	0	-	659	1623	1639	0.9902380
C9	18661121	18663627	BolC9t55344H	0	-	315	2036	2506	0.8124501
C9	18668312	18669717	BolC9t55345H	0	+	343	1405	1405	1.0000000
C9	18670311	18674219	BolC9t55346H	0	-	1043	3812	3908	0.9754350
C9	18678865	18680713	BolC9t55347H	0	-	328	1458	1848	0.7889611
C9	18684611	18685429	BolC9t55348H	0	+	189	806	818	0.9853300
C9	18687053	18689003	BolC9t55349H	0	+	114	1311	1950	0.6723077
C9	18692516	18693902	BolC9t55350H	0	-	133	847	1386	0.6111111
C9	18735813	18738979	BolC9t55351H	0	-	709	1856	3166	0.5862287
C9	18740621	18740873	BolC9t55352H	0	-	42	240	252	0.9523810
C9	18756108	18756325	BolC9t55353H	0	-	7	178	217	0.8202765
C9	18756423	18761313	BolC9t55354H	0	-	1217	3625	4890	0.7413088
C9	18762655	18768914	BolC9t55355H	0	-	3216	6215	6259	0.9929701
C9	18781495	18785187	BolC9t55356H	0	+	1506	3634	3692	0.9842904
C9	18787754	18803318	BolC9t55357H	0	-	5761	12298	15564	0.7901568
C9	18807587	18808205	BolC9t55358H	0	-	192	361	618	0.5841424
C9	18817919	18855960	BolC9t55359H	0	+	5490	25588	38041	0.6726426
C9	18822865	18823844	BolC9t55360H	0	-	1	39	979	0.0398366
C9	18833644	18834652	BolC9t55361H	0	-	60	573	1008	0.5684524
C9	18836046	18837070	BolC9t55362H	0	+	74	726	1024	0.7089844
C9	18870835	18871171	BolC9t55363H	0	-	0	0	336	0.0000000
C9	18891904	18893164	BolC9t55364H	0	+	51	570	1260	0.4523810
C9	18902636	18903047	BolC9t55365H	0	-	36	242	411	0.5888078
C9	18937942	18938413	BolC9t55366H	0	-	28	299	471	0.6348195
C9	18942317	18943284	BolC9t55367H	0	+	543	967	967	1.0000000
C9	18946564	18949072	BolC9t55368H	0	-	661	2446	2508	0.9752791
C9	18954205	18958103	BolC9t55369H	0	+	652	2710	3898	0.6952283
C9	18959660	18967619	BolC9t55370H	0	+	3224	7693	7959	0.9665787
C9	18980929	18981739	BolC9t55371H	0	+	11	435	810	0.5370370
C9	18993049	18994785	BolC9t55372H	0	+	67	1116	1736	0.6428571
C9	18996172	18996558	BolC9t55373H	0	-	38	288	386	0.7461140
C9	18997608	18998043	BolC9t55374H	0	-	21	381	435	0.8758621
C9	18999643	19000165	BolC9t55375H	0	-	115	453	522	0.8678161
C9	19001309	19001679	BolC9t55376H	0	+	261	370	370	1.0000000
C9	19002697	19002862	BolC9t55377H	0	-	17	101	165	0.6121212
C9	19010387	19010885	BolC9t55378H	0	-	269	498	498	1.0000000
C9	19012386	19018405	BolC9t55379H	0	-	1619	5491	6019	0.9122778
C9	19025413	19025924	BolC9t55380H	0	+	595	511	511	1.0000000
C9	19029311	19030815	BolC9t55381H	0	-	823	1504	1504	1.0000000
C9	19035527	19039753	BolC9t55382H	0	+	1650	3694	4226	0.8741127
C9	19040896	19043506	BolC9t55383H	0	-	263	1855	2610	0.7107280
C9	19051001	19052030	BolC9t55384H	0	+	316	987	1029	0.9591837
C9	19059684	19060122	BolC9t55385H	0	-	138	438	438	1.0000000
C9	19082207	19084705	BolC9t55386H	0	+	337	1931	2498	0.7730184
C9	19090213	19090498	BolC9t55387H	0	-	27	205	285	0.7192982
C9	19092427	19093405	BolC9t55388H	0	+	2	241	978	0.2464213
C9	19094479	19094830	BolC9t55389H	0	+	4	192	351	0.5470086
C9	19096773	19098402	BolC9t55390H	0	-	633	1484	1629	0.9109883
C9	19102239	19102999	BolC9t55391H	0	-	69	302	760	0.3973684
C9	19115484	19117379	BolC9t55392H	0	-	517	1805	1895	0.9525066
C9	19121472	19122204	BolC9t55393H	0	-	440	732	732	1.0000000
C9	19128427	19128982	BolC9t55394H	0	-	75	514	555	0.9261261
C9	19136837	19137155	BolC9t55395H	0	-	485	318	318	1.0000000
C9	19139059	19146364	BolC9t55396H	0	+	2220	5852	7305	0.8010951
C9	19152170	19157946	BolC9t55397H	0	-	379	3469	5776	0.6005886
C9	19170746	19170860	BolC9t55398H	0	-	148	114	114	1.0000000
C9	19187253	19187559	BolC9t55399H	0	+	3	6	306	0.0196078
C9	19196979	19198865	BolC9t55400H	0	-	12	110	1886	0.0583245
C9	19204797	19206071	BolC9t55401H	0	+	232	1000	1274	0.7849293
C9	19206920	19208674	BolC9t55402H	0	+	525	1632	1754	0.9304447
C9	19209207	19211064	BolC9t55403H	0	-	1635	1857	1857	1.0000000
C9	19238555	19238937	BolC9t55404H	0	-	1499	382	382	1.0000000
C9	19242792	19243002	BolC9t55405H	0	-	453	210	210	1.0000000
C9	19246122	19247337	BolC9t55406H	0	+	1916	1215	1215	1.0000000
C9	19255530	19257115	BolC9t55407H	0	+	1099	1545	1585	0.9747634
C9	19277892	19279026	BolC9t55408H	0	+	722	1134	1134	1.0000000
C9	19312073	19312790	BolC9t55409H	0	+	18	229	717	0.3193863
C9	19314213	19315990	BolC9t55410H	0	-	21	669	1777	0.3764772
C9	19316195	19316710	BolC9t55411H	0	-	55	482	515	0.9359223
C9	19329655	19329850	BolC9t55412H	0	+	0	0	195	0.0000000
C9	19334255	19334651	BolC9t55413H	0	+	0	0	396	0.0000000
C9	19351049	19353480	BolC9t55414H	0	-	814	2347	2431	0.9654463
C9	19373357	19375015	BolC9t55415H	0	-	43	646	1658	0.3896261
C9	19377105	19377573	BolC9t55416H	0	-	295	468	468	1.0000000
C9	19391673	19396222	BolC9t55417H	0	+	715	2633	4549	0.5788085
C9	19402337	19403924	BolC9t55418H	0	+	203	918	1587	0.5784499
C9	19416325	19420816	BolC9t55419H	0	+	2362	4175	4491	0.9296371
C9	19422328	19422747	BolC9t55420H	0	-	507	419	419	1.0000000
C9	19430769	19430910	BolC9t55421H	0	-	353	141	141	1.0000000
C9	19438440	19439331	BolC9t55422H	0	+	74	392	891	0.4399551
C9	19446992	19449325	BolC9t55423H	0	+	1320	2278	2333	0.9764252
C9	19450198	19450438	BolC9t55424H	0	-	105	240	240	1.0000000
C9	19451670	19452789	BolC9t55425H	0	-	462	1119	1119	1.0000000
C9	19454378	19461492	BolC9t55426H	0	-	2203	6824	7114	0.9592353
C9	19468048	19468790	BolC9t55427H	0	+	85	742	742	1.0000000
C9	19468929	19471644	BolC9t55428H	0	-	264	2625	2715	0.9668508
C9	19471759	19473205	BolC9t55429H	0	-	289	1446	1446	1.0000000
C9	19475615	19475864	BolC9t55430H	0	-	254	249	249	1.0000000
C9	19483542	19484412	BolC9t55431H	0	-	404	870	870	1.0000000
C9	19485572	19486037	BolC9t55432H	0	-	83	452	465	0.9720430
C9	19489961	19491806	BolC9t55433H	0	-	1242	1756	1845	0.9517615
C9	19503695	19505275	BolC9t55434H	0	-	175	871	1580	0.5512658
C9	19509772	19510033	BolC9t55435H	0	+	19	261	261	1.0000000
C9	19519406	19520120	BolC9t55436H	0	-	837	714	714	1.0000000
C9	19523664	19525628	BolC9t55437H	0	+	352	1911	1964	0.9730142
C9	19526939	19527785	BolC9t55438H	0	-	134	846	846	1.0000000
C9	19529351	19530833	BolC9t55439H	0	-	125	981	1482	0.6619433
C9	19541433	19544946	BolC9t55440H	0	-	388	2117	3513	0.6026189
C9	19548861	19549585	BolC9t55441H	0	-	557	724	724	1.0000000
C9	19553765	19554528	BolC9t55442H	0	-	128	528	763	0.6920052
C9	19554578	19554932	BolC9t55443H	0	-	0	0	354	0.0000000
C9	19580325	19582085	BolC9t55444H	0	+	386	1587	1760	0.9017045
C9	19584195	19584303	BolC9t55445H	0	+	0	0	108	0.0000000
C9	19587626	19588324	BolC9t55446H	0	+	94	693	698	0.9928367
C9	19590546	19591586	BolC9t55447H	0	+	5	383	1040	0.3682692
C9	19594942	19596000	BolC9t55448H	0	+	3	172	1058	0.1625709
C9	19601626	19602568	BolC9t55449H	0	-	232	929	942	0.9861996
C9	19611857	19612873	BolC9t55450H	0	-	361	1000	1016	0.9842520
C9	19616463	19619944	BolC9t55451H	0	-	796	2543	3481	0.7305372
C9	19626094	19628053	BolC9t55452H	0	-	816	1951	1959	0.9959163
C9	19631734	19638220	BolC9t55453H	0	+	468	3104	6486	0.4785692
C9	19646669	19647318	BolC9t55454H	0	+	470	649	649	1.0000000
C9	19648873	19650352	BolC9t55455H	0	-	802	1479	1479	1.0000000
C9	19651699	19652170	BolC9t55456H	0	+	177	471	471	1.0000000
C9	19664730	19664976	BolC9t55457H	0	+	2	95	246	0.3861789
C9	19678849	19681029	BolC9t55458H	0	+	333	1416	2180	0.6495413
C9	19682480	19683006	BolC9t55459H	0	+	402	526	526	1.0000000
C9	19683958	19684909	BolC9t55460H	0	+	78	593	951	0.6235542
C9	19693479	19694688	BolC9t55461H	0	-	92	989	1209	0.8180314
C9	19696077	19696647	BolC9t55462H	0	-	294	470	570	0.8245614
C9	19698240	19699200	BolC9t55463H	0	-	1589	960	960	1.0000000
C9	19704650	19704872	BolC9t55464H	0	+	6	183	222	0.8243243
C9	19705288	19709114	BolC9t55465H	0	+	2730	3740	3826	0.9775222
C9	19709503	19709800	BolC9t55466H	0	-	174	297	297	1.0000000
C9	19713511	19713685	BolC9t55467H	0	+	18	46	174	0.2643678
C9	19732950	19746037	BolC9t55468H	0	+	4326	12848	13087	0.9817376
C9	19749632	19751104	BolC9t55469H	0	-	626	1472	1472	1.0000000
C9	19757879	19758784	BolC9t55470H	0	+	388	905	905	1.0000000
C9	19761486	19762737	BolC9t55471H	0	-	907	1211	1251	0.9680256
C9	19770000	19770304	BolC9t55472H	0	-	135	304	304	1.0000000
C9	19771109	19773654	BolC9t55473H	0	-	895	2140	2545	0.8408644
C9	19778811	19780354	BolC9t55474H	0	+	219	1364	1543	0.8839922
C9	19798936	19800466	BolC9t55475H	0	-	57	473	1530	0.3091503
C9	19805210	19806922	BolC9t55476H	0	-	2073	1712	1712	1.0000000
C9	19809643	19811357	BolC9t55477H	0	-	1734	1714	1714	1.0000000
C9	19827802	19828100	BolC9t55478H	0	-	8	52	298	0.1744967
C9	19829068	19830206	BolC9t55479H	0	+	1014	1138	1138	1.0000000
C9	19848376	19884268	BolC9t55480H	0	+	17518	29274	35892	0.8156135
C9	19849181	19849447	BolC9t55481H	0	+	0	0	266	0.0000000
C9	19850167	19855443	BolC9t55482H	0	+	3074	4521	5276	0.8568991
C9	19850624	19850969	BolC9t55483H	0	+	37	345	345	1.0000000
C9	19872457	19873459	BolC9t55484H	0	-	33	239	1002	0.2385229
C9	19886354	19886603	BolC9t55485H	0	+	69	249	249	1.0000000
C9	19897985	19898135	BolC9t55486H	0	+	6	150	150	1.0000000
C9	19931393	19932073	BolC9t55487H	0	+	0	0	680	0.0000000
C9	19932197	19932463	BolC9t55488H	0	+	0	0	266	0.0000000
C9	19936884	19937229	BolC9t55489H	0	+	10	198	345	0.5739130
C9	19967915	19969661	BolC9t55490H	0	+	471	1687	1746	0.9662085
C9	20018384	20018705	BolC9t55491H	0	-	53	316	321	0.9844237
C9	20023085	20023484	BolC9t55492H	0	-	82	394	399	0.9874687
C9	20041421	20056335	BolC9t55493H	0	+	3970	12438	14914	0.8339815
C9	20056809	20057454	BolC9t55494H	0	-	414	645	645	1.0000000
C9	20059932	20061353	BolC9t55495H	0	+	798	1421	1421	1.0000000
C9	20065787	20066873	BolC9t55496H	0	+	202	1013	1086	0.9327809
C9	20077849	20078260	BolC9t55497H	0	+	1	52	411	0.1265207
C9	20080821	20084254	BolC9t55498H	0	-	1113	3261	3433	0.9498981
C9	20084847	20085315	BolC9t55499H	0	-	74	468	468	1.0000000
C9	20101566	20101956	BolC9t55500H	0	+	804	390	390	1.0000000
C9	20106332	20107091	BolC9t55501H	0	+	13	281	759	0.3702240
C9	20112181	20112514	BolC9t55502H	0	+	186	333	333	1.0000000
C9	20137820	20139297	BolC9t55503H	0	+	695	1477	1477	1.0000000
C9	20140493	20141960	BolC9t55504H	0	-	479	1408	1467	0.9597819
C9	20149321	20150701	BolC9t55505H	0	-	820	1361	1380	0.9862319
C9	20157695	20159311	BolC9t55506H	0	+	829	1616	1616	1.0000000
C9	20161260	20163861	BolC9t55507H	0	-	503	2344	2601	0.9011918
C9	20189238	20189583	BolC9t55508H	0	+	829	345	345	1.0000000
C9	20189756	20190560	BolC9t55509H	0	+	1575	804	804	1.0000000
C9	20193537	20194116	BolC9t55510H	0	-	613	579	579	1.0000000
C9	20198955	20208183	BolC9t55511H	0	-	3409	8769	9228	0.9502601
C9	20221152	20222105	BolC9t55512H	0	-	0	0	953	0.0000000
C9	20222861	20224983	BolC9t55513H	0	-	720	2122	2122	1.0000000
C9	20225425	20226075	BolC9t55514H	0	+	0	0	650	0.0000000
C9	20227948	20228288	BolC9t55515H	0	+	22	272	340	0.8000000
C9	20229178	20229947	BolC9t55516H	0	+	7	216	769	0.2808843
C9	20231031	20231943	BolC9t55517H	0	-	0	0	912	0.0000000
C9	20232129	20233722	BolC9t55518H	0	-	35	593	1593	0.3722536
C9	20239308	20248330	BolC9t55519H	0	+	2527	8806	9022	0.9760585
C9	20252922	20253424	BolC9t55520H	0	-	166	502	502	1.0000000
C9	20258890	20263218	BolC9t55521H	0	+	1439	4304	4328	0.9944547
C9	20263777	20266449	BolC9t55522H	0	-	1033	2562	2672	0.9588323
C9	20270599	20271334	BolC9t55523H	0	-	8	265	735	0.3605442
C9	20276439	20276631	BolC9t55524H	0	-	6	106	192	0.5520833
C9	20282556	20282859	BolC9t55525H	0	+	148	303	303	1.0000000
C9	20284355	20284649	BolC9t55526H	0	-	82	261	294	0.8877551
C9	20290342	20290489	BolC9t55527H	0	+	51	147	147	1.0000000
C9	20291745	20293214	BolC9t55528H	0	-	399	1382	1469	0.9407761
C9	20306395	20307989	BolC9t55529H	0	+	86	682	1594	0.4278544
C9	20320226	20320744	BolC9t55530H	0	-	138	518	518	1.0000000
C9	20320944	20324633	BolC9t55531H	0	-	2116	3689	3689	1.0000000
C9	20331156	20335961	BolC9t55532H	0	-	2880	4805	4805	1.0000000
C9	20348934	20349048	BolC9t55533H	0	-	0	0	114	0.0000000
C9	20351486	20351945	BolC9t55534H	0	+	58	451	459	0.9825708
C9	20368327	20376040	BolC9t55535H	0	+	6876	7300	7713	0.9464540
C9	20370952	20371802	BolC9t55536H	0	-	381	850	850	1.0000000
C9	20376682	20379493	BolC9t55537H	0	+	657	2393	2811	0.8512985
C9	20380679	20384362	BolC9t55538H	0	-	1275	3536	3683	0.9600869
C9	20385489	20388208	BolC9t55539H	0	-	1302	2667	2719	0.9808753
C9	20390863	20399710	BolC9t55540H	0	-	734	4292	8847	0.4851362
C9	20401615	20402808	BolC9t55541H	0	+	934	1193	1193	1.0000000
C9	20444190	20444658	BolC9t55542H	0	-	249	468	468	1.0000000
C9	20447540	20449126	BolC9t55543H	0	-	399	1432	1586	0.9029004
C9	20462609	20463359	BolC9t55544H	0	+	15	746	750	0.9946667
C9	20466340	20467274	BolC9t55545H	0	+	1593	877	934	0.9389722
C9	20468400	20469939	BolC9t55546H	0	+	302	1461	1539	0.9493178
C9	20471484	20471643	BolC9t55547H	0	+	9	101	159	0.6352201
C9	20473156	20473279	BolC9t55548H	0	+	3	49	123	0.3983740
C9	20485092	20486437	BolC9t55549H	0	-	689	1345	1345	1.0000000
C9	20486932	20487622	BolC9t55550H	0	+	48	499	690	0.7231884
C9	20491024	20491243	BolC9t55551H	0	-	7	156	219	0.7123288
C9	20494812	20496316	BolC9t55552H	0	+	8	295	1504	0.1961436
C9	20496582	20497117	BolC9t55553H	0	-	4	173	535	0.3233645
C9	20515658	20518956	BolC9t55554H	0	+	1471	2788	3298	0.8453608
C9	20524302	20524575	BolC9t55555H	0	-	245	273	273	1.0000000
C9	20533111	20533618	BolC9t55556H	0	-	164	331	507	0.6528600
C9	20538032	20538444	BolC9t55557H	0	-	89	151	412	0.3665048
C9	20539208	20539439	BolC9t55558H	0	+	225	231	231	1.0000000
C9	20561208	20563203	BolC9t55559H	0	+	503	1948	1995	0.9764411
C9	20563370	20565037	BolC9t55560H	0	-	663	1583	1667	0.9496101
C9	20583367	20584498	BolC9t55561H	0	-	64	651	1131	0.5755968
C9	20587691	20588117	BolC9t55562H	0	+	47	426	426	1.0000000
C9	20605199	20607881	BolC9t55563H	0	-	1470	2263	2682	0.8437733
C9	20609661	20613444	BolC9t55564H	0	+	755	2752	3783	0.7274650
C9	20614852	20617369	BolC9t55565H	0	-	555	2490	2517	0.9892730
C9	20623322	20624794	BolC9t55566H	0	-	788	1277	1472	0.8675272
C9	20627402	20629148	BolC9t55567H	0	-	255	1568	1746	0.8980527
C9	20629958	20631611	BolC9t55568H	0	-	251	1553	1653	0.9395039
C9	20633043	20634156	BolC9t55569H	0	-	271	1113	1113	1.0000000
C9	20642954	20643962	BolC9t55570H	0	+	430	957	1008	0.9494048
C9	20659494	20660723	BolC9t55571H	0	-	893	1229	1229	1.0000000
C9	20666415	20673136	BolC9t55572H	0	-	3462	6564	6721	0.9766404
C9	20678210	20678411	BolC9t55573H	0	+	320	201	201	1.0000000
C9	20692836	20699130	BolC9t55574H	0	-	3344	6234	6294	0.9904671
C9	20734501	20735159	BolC9t55575H	0	+	266	628	658	0.9544073
C9	20737341	20737929	BolC9t55576H	0	-	467	588	588	1.0000000
C9	20739376	20741079	BolC9t55577H	0	-	468	1703	1703	1.0000000
C9	20759876	20761677	BolC9t55578H	0	-	419	1185	1801	0.6579678
C9	20764406	20766008	BolC9t55579H	0	-	148	1016	1602	0.6342072
C9	20776043	20777733	BolC9t55580H	0	-	823	1690	1690	1.0000000
C9	20788966	20791031	BolC9t55581H	0	+	1239	2065	2065	1.0000000
C9	20791929	20792292	BolC9t55582H	0	-	384	363	363	1.0000000
C9	20798327	20800414	BolC9t55583H	0	+	2196	2087	2087	1.0000000
C9	20801144	20802621	BolC9t55584H	0	-	657	1221	1477	0.8266757
C9	20807309	20808548	BolC9t55585H	0	+	335	696	1239	0.5617433
C9	20816961	20824350	BolC9t55586H	0	+	3975	6891	7389	0.9326025
C9	20840666	20840786	BolC9t55587H	0	+	155	120	120	1.0000000
C9	20841979	20842957	BolC9t55588H	0	-	302	978	978	1.0000000
C9	20849993	20850496	BolC9t55589H	0	+	502	503	503	1.0000000
C9	20853848	20855364	BolC9t55590H	0	+	1808	1516	1516	1.0000000
C9	20859727	20861307	BolC9t55591H	0	+	417	1204	1580	0.7620253
C9	20861544	20862459	BolC9t55592H	0	-	434	915	915	1.0000000
C9	20865146	20865447	BolC9t55593H	0	+	0	0	301	0.0000000
C9	20868822	20869258	BolC9t55594H	0	+	125	436	436	1.0000000
C9	20874551	20876840	BolC9t55595H	0	+	509	1841	2289	0.8042814
C9	20897192	20897911	BolC9t55596H	0	+	21	344	719	0.4784423
C9	20903593	20905111	BolC9t55597H	0	+	72	691	1518	0.4552042
C9	20905187	20914564	BolC9t55598H	0	+	1949	7264	9377	0.7746614
C9	20914891	20919565	BolC9t55599H	0	-	1033	3535	4674	0.7563115
C9	20920736	20929245	BolC9t55600H	0	-	502	3491	8509	0.4102715
C9	20951846	20966058	BolC9t55601H	0	-	1117	5572	14212	0.3920631
C9	20971154	20971292	BolC9t55602H	0	-	188	136	138	0.9855072
C9	20975616	20976256	BolC9t55603H	0	+	680	510	640	0.7968750
C9	20980721	20982905	BolC9t55604H	0	+	1045	1704	2184	0.7802198
C9	20989481	20990160	BolC9t55605H	0	-	550	679	679	1.0000000
C9	21004509	21007102	BolC9t55606H	0	+	834	2185	2593	0.8426533
C9	21019081	21041066	BolC9t55607H	0	+	6037	15358	21985	0.6985672
C9	21029928	21033901	BolC9t55608H	0	-	541	3221	3973	0.8107224
C9	21041389	21043576	BolC9t55609H	0	+	1099	1652	2187	0.7553726
C9	21070105	21078692	BolC9t55610H	0	+	1318	5339	8587	0.6217538
C9	21083537	21085382	BolC9t55611H	0	-	104	723	1845	0.3918699
C9	21091452	21091815	BolC9t55612H	0	+	80	363	363	1.0000000
C9	21091963	21093461	BolC9t55613H	0	-	2973	1326	1498	0.8851802
C9	21101727	21102390	BolC9t55614H	0	-	64	663	663	1.0000000
C9	21112404	21112608	BolC9t55615H	0	-	47	204	204	1.0000000
C9	21114455	21114689	BolC9t55616H	0	+	134	234	234	1.0000000
C9	21131682	21132318	BolC9t55617H	0	-	637	636	636	1.0000000
C9	21142387	21142936	BolC9t55618H	0	-	159	549	549	1.0000000
C9	21165216	21166059	BolC9t55619H	0	+	20	182	843	0.2158956
C9	21172206	21173866	BolC9t55620H	0	-	410	1536	1660	0.9253012
C9	21199467	21201027	BolC9t55621H	0	+	88	455	1560	0.2916667
C9	21226617	21228367	BolC9t55622H	0	+	490	1383	1750	0.7902857
C9	21229115	21229605	BolC9t55623H	0	-	233	490	490	1.0000000
C9	21236464	21270929	BolC9t55624H	0	-	3322	17598	34465	0.5106050
C9	21285579	21335776	BolC9t55625H	0	+	9253	28237	50197	0.5625237
C9	21313521	21314632	BolC9t55626H	0	+	184	725	1111	0.6525652
C9	21317493	21318713	BolC9t55627H	0	-	158	1010	1220	0.8278689
C9	21319454	21320201	BolC9t55628H	0	+	99	691	747	0.9250335
C9	21320825	21326421	BolC9t55629H	0	-	372	2430	5596	0.4342387
C9	21346168	21348886	BolC9t55630H	0	-	1007	1799	2718	0.6618837
C9	21350982	21352201	BolC9t55631H	0	+	72	628	1219	0.5151764
C9	21353473	21353763	BolC9t55632H	0	+	185	289	290	0.9965518
C9	21360698	21360943	BolC9t55633H	0	+	177	245	245	1.0000000
C9	21365383	21367632	BolC9t55634H	0	+	2925	1951	2249	0.8674967
C9	21370399	21372592	BolC9t55635H	0	-	470	2088	2193	0.9521204
C9	21382787	21384702	BolC9t55636H	0	-	545	1596	1915	0.8334203
C9	21385834	21386348	BolC9t55637H	0	-	347	514	514	1.0000000
C9	21410901	21413474	BolC9t55638H	0	-	644	2436	2573	0.9467548
C9	21413669	21414392	BolC9t55639H	0	-	279	723	723	1.0000000
C9	21453627	21454335	BolC9t55640H	0	-	0	0	708	0.0000000
C9	21454398	21455016	BolC9t55641H	0	-	1	147	618	0.2378641
C9	21462901	21464124	BolC9t55642H	0	-	62	551	1223	0.4505315
C9	21470114	21471747	BolC9t55643H	0	+	967	1465	1633	0.8971218
C9	21475874	21477661	BolC9t55644H	0	+	798	1753	1787	0.9809737
C9	21480015	21480150	BolC9t55645H	0	+	66	135	135	1.0000000
C9	21486838	21487108	BolC9t55646H	0	-	0	0	270	0.0000000
C9	21487524	21487686	BolC9t55647H	0	-	0	0	162	0.0000000
C9	21501192	21507560	BolC9t55648H	0	+	1584	4680	6368	0.7349246
C9	21519984	21522170	BolC9t55649H	0	-	464	1844	2186	0.8435498
C9	21526994	21528105	BolC9t55650H	0	-	251	984	1111	0.8856885
C9	21548035	21550618	BolC9t55651H	0	+	864	2581	2583	0.9992257
C9	21550893	21552093	BolC9t55652H	0	-	703	1200	1200	1.0000000
C9	21567563	21567734	BolC9t55653H	0	+	262	171	171	1.0000000
C9	21593715	21597141	BolC9t55654H	0	+	2366	3183	3426	0.9290718
C9	21602091	21603561	BolC9t55655H	0	+	952	1470	1470	1.0000000
C9	21609087	21614586	BolC9t55656H	0	+	2346	4945	5499	0.8992544
C9	21619489	21619810	BolC9t55657H	0	+	262	321	321	1.0000000
C9	21623420	21623894	BolC9t55658H	0	-	0	0	474	0.0000000
C9	21694087	21694300	BolC9t55659H	0	+	10	124	213	0.5821596
C9	21694485	21694638	BolC9t55660H	0	-	4	60	153	0.3921569
C9	21705917	21706169	BolC9t55661H	0	-	19	252	252	1.0000000
C9	21712128	21712787	BolC9t55662H	0	-	61	656	659	0.9954476
C9	21716902	21717244	BolC9t55663H	0	-	4	241	342	0.7046784
C9	21724061	21726738	BolC9t55664H	0	-	660	1190	2677	0.4445274
C9	21725361	21725892	BolC9t55665H	0	-	0	0	531	0.0000000
C9	21745240	21750779	BolC9t55666H	0	-	218	2206	5539	0.3982668
C9	21795111	21796880	BolC9t55667H	0	+	260	1148	1769	0.6489542
C9	21797355	21798474	BolC9t55668H	0	+	444	1037	1119	0.9267203
C9	21811642	21813675	BolC9t55669H	0	+	357	1973	2033	0.9704869
C9	21815620	21817343	BolC9t55670H	0	-	227	1603	1723	0.9303541
C9	21817428	21817754	BolC9t55671H	0	-	14	204	326	0.6257669
C9	21829173	21830268	BolC9t55672H	0	+	87	692	1095	0.6319635
C9	21833509	21837201	BolC9t55673H	0	-	503	3056	3692	0.8277357
C9	21843091	21843826	BolC9t55674H	0	+	29	439	735	0.5972789
C9	21849792	21850250	BolC9t55675H	0	+	79	404	458	0.8820961
C9	21854138	21854711	BolC9t55676H	0	+	0	0	573	0.0000000
C9	21856804	21857620	BolC9t55677H	0	-	35	669	816	0.8198529
C9	21857314	21858268	BolC9t55678H	0	+	201	922	954	0.9664570
C9	21858950	21862233	BolC9t55679H	0	+	868	2948	3283	0.8979592
C9	21863103	21864060	BolC9t55680H	0	-	260	939	957	0.9811912
C9	21876084	21877818	BolC9t55681H	0	-	318	1118	1734	0.6447520
C9	21894599	21895172	BolC9t55682H	0	-	149	573	573	1.0000000
C9	21900181	21902031	BolC9t55683H	0	-	232	1612	1850	0.8713514
C9	21929596	21930166	BolC9t55684H	0	+	58	543	570	0.9526316
C9	21930492	21931488	BolC9t55685H	0	-	93	743	996	0.7459840
C9	21932394	21934546	BolC9t55686H	0	-	760	2050	2152	0.9526022
C9	21935996	21936323	BolC9t55687H	0	-	75	290	327	0.8868502
C9	21936982	21937672	BolC9t55688H	0	+	10	358	690	0.5188406
C9	21938225	21945698	BolC9t55689H	0	+	766	5696	7473	0.7622106
C9	21957711	21963203	BolC9t55690H	0	-	1697	4442	5492	0.8088128
C9	21984294	21988971	BolC9t55691H	0	-	713	3703	4677	0.7917469
C9	21994657	22002767	BolC9t55692H	0	-	1900	7574	8110	0.9339088
C9	22013411	22014068	BolC9t55693H	0	+	1049	657	657	1.0000000
C9	22018343	22023005	BolC9t55694H	0	+	553	2866	4662	0.6147576
C9	22029712	22030702	BolC9t55695H	0	+	137	944	990	0.9535354
C9	22032151	22033577	BolC9t55696H	0	-	0	0	1426	0.0000000
C9	22037817	22039320	BolC9t55697H	0	-	389	1454	1503	0.9673985
C9	22044498	22044738	BolC9t55698H	0	-	207	240	240	1.0000000
C9	22045257	22047004	BolC9t55699H	0	-	395	1587	1747	0.9084144
C9	22053579	22059876	BolC9t55700H	0	+	631	3577	6297	0.5680483
C9	22055527	22057408	BolC9t55701H	0	-	176	1598	1881	0.8495481
C9	22062658	22065425	BolC9t55702H	0	+	114	1730	2767	0.6252259
C9	22071761	22072762	BolC9t55703H	0	+	190	630	1001	0.6293706
C9	22077275	22077383	BolC9t55704H	0	+	8	18	108	0.1666667
C9	22081036	22082603	BolC9t55705H	0	-	61	142	1567	0.0906190
C9	22083221	22084619	BolC9t55706H	0	+	199	1216	1398	0.8698140
C9	22087559	22088870	BolC9t55707H	0	-	829	1283	1311	0.9786423
C9	22090808	22095742	BolC9t55708H	0	-	3398	4863	4934	0.9856101
C9	22099780	22100311	BolC9t55709H	0	-	152	313	531	0.5894539
C9	22102196	22105365	BolC9t55710H	0	-	392	2183	3169	0.6888608
C9	22127303	22129642	BolC9t55711H	0	-	731	2315	2339	0.9897392
C9	22138265	22140773	BolC9t55712H	0	-	1085	2493	2508	0.9940192
C9	22161240	22163740	BolC9t55713H	0	+	283	2396	2500	0.9584000
C9	22164356	22166822	BolC9t55714H	0	-	417	2282	2466	0.9253852
C9	22209829	22210206	BolC9t55715H	0	+	2140	377	377	1.0000000
C9	22217128	22217803	BolC9t55716H	0	+	6	209	675	0.3096296
C9	22220987	22223441	BolC9t55717H	0	-	190	2037	2454	0.8300734
C9	22227847	22228915	BolC9t55718H	0	-	42	880	1068	0.8239700
C9	22244943	22248703	BolC9t55719H	0	+	1015	3446	3760	0.9164894
C9	22250145	22251854	BolC9t55720H	0	+	31	247	1709	0.1445290
C9	22271451	22278196	BolC9t55721H	0	-	846	3569	6745	0.5291327
C9	22275546	22276053	BolC9t55722H	0	+	4	289	507	0.5700197
C9	22282182	22282437	BolC9t55723H	0	-	2	104	255	0.4078431
C9	22295040	22296432	BolC9t55724H	0	-	152	912	1392	0.6551724
C9	22297771	22299432	BolC9t55725H	0	-	644	1499	1661	0.9024684
C9	22302240	22303632	BolC9t55726H	0	-	1283	1392	1392	1.0000000
C9	22306006	22308621	BolC9t55727H	0	+	758	2464	2615	0.9422562
C9	22309164	22310002	BolC9t55728H	0	+	139	743	838	0.8866348
C9	22310655	22311171	BolC9t55729H	0	+	14	183	516	0.3546512
C9	22352780	22369331	BolC9t55730H	0	+	2390	7839	16551	0.4736270
C9	22385612	22390845	BolC9t55731H	0	-	1623	1989	5233	0.3800879
C9	22400580	22402038	BolC9t55732H	0	+	442	1321	1458	0.9060357
C9	22403752	22408776	BolC9t55733H	0	-	1033	4810	5024	0.9574044
C9	22410165	22410363	BolC9t55734H	0	+	255	198	198	1.0000000
C9	22452332	22454835	BolC9t55735H	0	+	2056	2503	2503	1.0000000
C9	22456648	22458153	BolC9t55736H	0	+	390	1028	1505	0.6830565
C9	22479284	22480130	BolC9t55737H	0	+	195	838	846	0.9905437
C9	22490702	22497718	BolC9t55738H	0	+	1375	5704	7016	0.8129988
C9	22499845	22500259	BolC9t55739H	0	-	392	414	414	1.0000000
C9	22519094	22519652	BolC9t55740H	0	-	4054	558	558	1.0000000
C9	22527589	22528868	BolC9t55741H	0	+	179	885	1279	0.6919468
C9	22530499	22531945	BolC9t55742H	0	-	760	1446	1446	1.0000000
C9	22563762	22564284	BolC9t55743H	0	+	78	513	522	0.9827586
C9	22569225	22569552	BolC9t55744H	0	+	59	314	327	0.9602447
C9	22574468	22574781	BolC9t55745H	0	+	139	313	313	1.0000000
C9	22578056	22578479	BolC9t55746H	0	-	161	423	423	1.0000000
C9	22581097	22582780	BolC9t55747H	0	+	191	1240	1683	0.7367796
C9	22587349	22587619	BolC9t55748H	0	-	460	270	270	1.0000000
C9	22592976	22593624	BolC9t55749H	0	-	128	343	648	0.5293210
C9	22594451	22596116	BolC9t55750H	0	-	227	1588	1665	0.9537538
C9	22600282	22600444	BolC9t55751H	0	-	88	162	162	1.0000000
C9	22609905	22610359	BolC9t55752H	0	-	32	449	454	0.9889868
C9	22610824	22612042	BolC9t55753H	0	-	167	942	1218	0.7733990
C9	22614682	22615163	BolC9t55754H	0	-	10	162	481	0.3367983
C9	22616435	22616837	BolC9t55755H	0	+	0	0	402	0.0000000
C9	22625757	22626725	BolC9t55756H	0	+	729	908	968	0.9380165
C9	22626040	22626486	BolC9t55757H	0	+	424	446	446	1.0000000
C9	22649250	22649505	BolC9t55758H	0	-	35	255	255	1.0000000
C9	22676227	22676425	BolC9t55759H	0	+	17	198	198	1.0000000
C9	22676481	22677171	BolC9t55760H	0	+	236	690	690	1.0000000
C9	22678600	22680544	BolC9t55761H	0	-	763	1944	1944	1.0000000
C9	22696851	22698375	BolC9t55762H	0	+	67	1024	1524	0.6719160
C9	22729644	22731174	BolC9t55763H	0	+	130	1443	1530	0.9431372
C9	22741704	22741999	BolC9t55764H	0	+	175	188	295	0.6372882
C9	22755006	22755516	BolC9t55765H	0	+	291	510	510	1.0000000
C9	22774987	22775185	BolC9t55766H	0	-	97	198	198	1.0000000
C9	22792137	22793869	BolC9t55767H	0	-	1021	1653	1732	0.9543880
C9	22814068	22815318	BolC9t55768H	0	+	913	1250	1250	1.0000000
C9	22818171	22824839	BolC9t55769H	0	+	816	3788	6668	0.5680864
C9	22825773	22826166	BolC9t55770H	0	-	34	227	393	0.5776082
C9	22834843	22835230	BolC9t55771H	0	-	3	47	387	0.1214470
C9	22850321	22850926	BolC9t55772H	0	+	4	101	605	0.1669421
C9	22855721	22859020	BolC9t55773H	0	+	657	2553	3299	0.7738709
C9	22860729	22861272	BolC9t55774H	0	-	121	363	543	0.6685083
C9	22863875	22864214	BolC9t55775H	0	-	104	339	339	1.0000000
C9	22885547	22885775	BolC9t55776H	0	+	8	217	228	0.9517544
C9	22894952	22895798	BolC9t55777H	0	-	67	559	846	0.6607565
C9	22895957	22896249	BolC9t55778H	0	-	35	287	292	0.9828767
C9	22899829	22900813	BolC9t55779H	0	-	215	927	984	0.9420732
C9	22902811	22903119	BolC9t55780H	0	-	333	308	308	1.0000000
C9	22921965	22922209	BolC9t55781H	0	+	133	244	244	1.0000000
C9	22934808	22935056	BolC9t55782H	0	+	191	248	248	1.0000000
C9	22939610	22940511	BolC9t55783H	0	+	810	901	901	1.0000000
C9	22943318	22950608	BolC9t55784H	0	+	954	5246	7290	0.7196159
C9	22953404	22954441	BolC9t55785H	0	-	866	1037	1037	1.0000000
C9	22956440	22958616	BolC9t55786H	0	+	1666	2176	2176	1.0000000
C9	22976700	22977787	BolC9t55787H	0	+	481	990	1087	0.9107636
C9	22986900	22987257	BolC9t55788H	0	+	1	124	357	0.3473389
C9	22987265	22987956	BolC9t55789H	0	+	32	638	691	0.9232996
C9	22990707	22991230	BolC9t55790H	0	+	402	523	523	1.0000000
C9	22993819	22996243	BolC9t55791H	0	+	1014	2424	2424	1.0000000
C9	23019130	23020104	BolC9t55792H	0	-	829	974	974	1.0000000
C9	23020210	23020410	BolC9t55793H	0	-	154	200	200	1.0000000
C9	23023925	23025634	BolC9t55794H	0	-	0	0	1709	0.0000000
C9	23026770	23027441	BolC9t55795H	0	-	62	624	671	0.9299553
C9	23036082	23036743	BolC9t55796H	0	-	363	661	661	1.0000000
C9	23038695	23039691	BolC9t55797H	0	-	1014	996	996	1.0000000
C9	23050038	23050722	BolC9t55798H	0	-	10	304	684	0.4444444
C9	23051284	23051392	BolC9t55799H	0	-	0	0	108	0.0000000
C9	23066532	23068367	BolC9t55800H	0	-	460	1774	1835	0.9667575
C9	23070369	23070471	BolC9t55801H	0	-	193	102	102	1.0000000
C9	23096371	23097158	BolC9t55802H	0	-	618	787	787	1.0000000
C9	23129933	23130230	BolC9t55803H	0	-	4	124	297	0.4175084
C9	23130582	23130783	BolC9t55804H	0	-	127	201	201	1.0000000
C9	23133641	23135126	BolC9t55805H	0	+	830	1485	1485	1.0000000
C9	23134646	23135061	BolC9t55806H	0	+	537	415	415	1.0000000
C9	23137151	23138980	BolC9t55807H	0	-	782	1478	1829	0.8080919
C9	23145719	23146764	BolC9t55808H	0	-	153	900	1045	0.8612440
C9	23147401	23148862	BolC9t55809H	0	+	1159	1461	1461	1.0000000
C9	23161648	23163591	BolC9t55810H	0	+	1235	1943	1943	1.0000000
C9	23164376	23166175	BolC9t55811H	0	-	1088	1799	1799	1.0000000
C9	23169593	23170724	BolC9t55812H	0	-	809	1131	1131	1.0000000
C9	23183743	23184957	BolC9t55813H	0	+	575	1191	1214	0.9810544
C9	23185426	23187138	BolC9t55814H	0	-	423	1666	1712	0.9731308
C9	23190768	23191545	BolC9t55815H	0	-	820	562	777	0.7232947
C9	23193618	23194578	BolC9t55816H	0	-	2	78	960	0.0812500
C9	23195465	23195624	BolC9t55817H	0	-	0	0	159	0.0000000
C9	23198496	23198973	BolC9t55818H	0	-	1	128	477	0.2683438
C9	23199414	23199894	BolC9t55819H	0	+	64	332	480	0.6916667
C9	23201203	23201314	BolC9t55820H	0	+	1	12	111	0.1081081
C9	23201740	23201971	BolC9t55821H	0	+	50	102	231	0.4415585
C9	23215646	23216958	BolC9t55822H	0	-	19	595	1312	0.4535061
C9	23228515	23229238	BolC9t55823H	0	-	54	482	723	0.6666667
C9	23261738	23262629	BolC9t55824H	0	+	73	788	891	0.8843995
C9	23278953	23279551	BolC9t55825H	0	-	6	204	598	0.3411371
C9	23282524	23284531	BolC9t55826H	0	-	195	1104	2007	0.5500748
C9	23283055	23283434	BolC9t55827H	0	-	0	0	379	0.0000000
C9	23284918	23285871	BolC9t55828H	0	+	293	651	953	0.6831060
C9	23287732	23291230	BolC9t55829H	0	+	334	2331	3498	0.6663808
C9	23299292	23300328	BolC9t55830H	0	-	649	1036	1036	1.0000000
C9	23301876	23302071	BolC9t55831H	0	-	113	195	195	1.0000000
C9	23303332	23303485	BolC9t55832H	0	-	135	153	153	1.0000000
C9	23304904	23305033	BolC9t55833H	0	+	0	0	129	0.0000000
C9	23316489	23316714	BolC9t55834H	0	+	14	218	225	0.9688889
C9	23318349	23321180	BolC9t55835H	0	-	166	1810	2831	0.6393501
C9	23352466	23353666	BolC9t55836H	0	+	58	877	1200	0.7308334
C9	23354836	23359650	BolC9t55837H	0	-	3276	4792	4814	0.9954300
C9	23361312	23361748	BolC9t55838H	0	+	0	0	436	0.0000000
C9	23381333	23384681	BolC9t55839H	0	+	2920	3348	3348	1.0000000
C9	23385323	23385608	BolC9t55840H	0	+	138	242	285	0.8491228
C9	23389605	23390420	BolC9t55841H	0	-	118	269	815	0.3300613
C9	23392681	23402378	BolC9t55842H	0	+	2994	7407	9697	0.7638445
C9	23402660	23408864	BolC9t55843H	0	+	761	5175	6204	0.8341393
C9	23411133	23411872	BolC9t55844H	0	-	226	710	739	0.9607578
C9	23413370	23414937	BolC9t55845H	0	+	1078	1567	1567	1.0000000
C9	23426655	23427673	BolC9t55846H	0	+	183	984	1018	0.9666012
C9	23445003	23445351	BolC9t55847H	0	-	26	213	348	0.6120690
C9	23455664	23457981	BolC9t55848H	0	-	866	1314	2317	0.5671126
C9	23460397	23464192	BolC9t55849H	0	-	1738	3731	3795	0.9831357
C9	23477367	23477886	BolC9t55850H	0	-	627	519	519	1.0000000
C9	23487936	23488500	BolC9t55851H	0	+	193	564	564	1.0000000
C9	23488789	23490517	BolC9t55852H	0	-	1022	1728	1728	1.0000000
C9	23491165	23492111	BolC9t55853H	0	+	932	946	946	1.0000000
C9	23492466	23493162	BolC9t55854H	0	+	219	597	696	0.8577586
C9	23493354	23494633	BolC9t55855H	0	-	477	1242	1279	0.9710711
C9	23496349	23498910	BolC9t55856H	0	+	788	2407	2561	0.9398673
C9	23505100	23506969	BolC9t55857H	0	-	653	1826	1869	0.9769930
C9	23509617	23511511	BolC9t55858H	0	-	524	1783	1894	0.9413939
C9	23514372	23514786	BolC9t55859H	0	-	321	343	414	0.8285024
C9	23523336	23523540	BolC9t55860H	0	-	130	204	204	1.0000000
C9	23525993	23529794	BolC9t55861H	0	+	17	195	3801	0.0513023
C9	23541351	23541801	BolC9t55862H	0	+	115	450	450	1.0000000
C9	23543781	23544854	BolC9t55863H	0	-	252	1024	1073	0.9543337
C9	23547861	23548862	BolC9t55864H	0	+	594	1001	1001	1.0000000
C9	23549970	23550228	BolC9t55865H	0	-	229	258	258	1.0000000
C9	23565664	23567637	BolC9t55866H	0	+	650	1930	1973	0.9782058
C9	23568731	23569990	BolC9t55867H	0	-	175	1181	1259	0.9380461
C9	23575786	23576254	BolC9t55868H	0	-	73	408	468	0.8717949
C9	23584741	23587736	BolC9t55869H	0	-	215	1478	2995	0.4934891
C9	23603753	23604419	BolC9t55870H	0	-	462	666	666	1.0000000
C9	23624906	23626113	BolC9t55871H	0	+	160	1075	1207	0.8906379
C9	23627692	23627881	BolC9t55872H	0	+	74	161	189	0.8518519
C9	23630867	23632019	BolC9t55873H	0	-	150	908	1152	0.7881944
C9	23634095	23634515	BolC9t55874H	0	-	90	418	420	0.9952381
C9	23640538	23640970	BolC9t55875H	0	-	113	432	432	1.0000000
C9	23691286	23691637	BolC9t55876H	0	-	355	351	351	1.0000000
C9	23698998	23699669	BolC9t55877H	0	-	665	671	671	1.0000000
C9	23734622	23735882	BolC9t55878H	0	-	389	1260	1260	1.0000000
C9	23735897	23736348	BolC9t55879H	0	-	28	451	451	1.0000000
C9	23742167	23744831	BolC9t55880H	0	+	353	2411	2664	0.9050300
C9	23746759	23747086	BolC9t55881H	0	-	182	327	327	1.0000000
C9	23747433	23747746	BolC9t55882H	0	-	145	149	313	0.4760383
C9	23760574	23760892	BolC9t55883H	0	-	16	296	318	0.9308176
C9	23763297	23765847	BolC9t55884H	0	-	1636	2550	2550	1.0000000
C9	23773793	23774098	BolC9t55885H	0	+	60	300	305	0.9836066
C9	23779714	23780621	BolC9t55886H	0	+	388	907	907	1.0000000
C9	23786333	23786495	BolC9t55887H	0	+	56	162	162	1.0000000
C9	23855861	23856328	BolC9t55888H	0	-	326	467	467	1.0000000
C9	23874172	23874949	BolC9t55889H	0	+	420	706	777	0.9086229
C9	23883448	23884309	BolC9t55890H	0	-	78	744	861	0.8641115
C9	23902977	23904530	BolC9t55891H	0	-	284	1547	1553	0.9961365
C9	23908388	23909793	BolC9t55892H	0	+	160	861	1405	0.6128114
C9	23913788	23914108	BolC9t55893H	0	-	316	320	320	1.0000000
C9	23920630	23921609	BolC9t55894H	0	+	0	0	979	0.0000000
C9	23922642	23923138	BolC9t55895H	0	+	29	300	496	0.6048387
C9	23925640	23927309	BolC9t55896H	0	+	16	112	1669	0.0671061
C9	23948686	23950396	BolC9t55897H	0	-	108	1151	1710	0.6730994
C9	23954125	23954308	BolC9t55898H	0	+	194	183	183	1.0000000
C9	23993819	23994362	BolC9t55899H	0	-	73	372	543	0.6850829
C9	24004045	24004323	BolC9t55900H	0	+	198	278	278	1.0000000
C9	24007557	24008235	BolC9t55901H	0	+	440	678	678	1.0000000
C9	24024452	24025067	BolC9t55902H	0	-	90	542	615	0.8813008
C9	24040973	24041150	BolC9t55903H	0	-	175	177	177	1.0000000
C9	24042044	24046289	BolC9t55904H	0	-	1231	3865	4245	0.9104829
C9	24055491	24056945	BolC9t55905H	0	-	341	1376	1454	0.9463549
C9	24057868	24059545	BolC9t55906H	0	-	307	1657	1677	0.9880739
C9	24064546	24065181	BolC9t55907H	0	-	12	123	635	0.1937008
C9	24065954	24072277	BolC9t55908H	0	-	399	1301	6323	0.2057568
C9	24080190	24080370	BolC9t55909H	0	+	77	180	180	1.0000000
C9	24080633	24081920	BolC9t55910H	0	-	95	1222	1287	0.9494950
C9	24086639	24087171	BolC9t55911H	0	-	2835	532	532	1.0000000
C9	24120773	24121640	BolC9t55912H	0	-	160	831	867	0.9584775
C9	24143282	24145577	BolC9t55913H	0	+	496	1645	2295	0.7167756
C9	24209675	24212153	BolC9t55914H	0	-	392	2123	2478	0.8567393
C9	24216905	24217568	BolC9t55915H	0	-	5	154	663	0.2322775
C9	24221397	24221735	BolC9t55916H	0	+	5	183	338	0.5414201
C9	24233780	24239649	BolC9t55917H	0	+	282	2769	5869	0.4718010
C9	24240141	24242518	BolC9t55918H	0	-	225	1703	2377	0.7164493
C9	24249854	24251195	BolC9t55919H	0	+	7	149	1341	0.1111111
C9	24256633	24271643	BolC9t55920H	0	+	4232	12859	15010	0.8566955
C9	24258751	24259603	BolC9t55921H	0	+	98	271	852	0.3180751
C9	24272489	24272798	BolC9t55922H	0	+	67	309	309	1.0000000
C9	24294360	24296301	BolC9t55923H	0	+	625	1924	1941	0.9912416
C9	24298488	24298629	BolC9t55924H	0	-	1	79	141	0.5602837
C9	24309021	24309222	BolC9t55925H	0	+	472	201	201	1.0000000
C9	24321081	24325617	BolC9t55926H	0	+	351	2952	4536	0.6507937
C9	24364169	24367054	BolC9t55927H	0	-	125	1397	2885	0.4842288
C9	24371176	24371914	BolC9t55928H	0	-	745	738	738	1.0000000
C9	24394858	24396010	BolC9t55929H	0	-	399	862	1152	0.7482639
C9	24402012	24402402	BolC9t55930H	0	+	53	329	390	0.8435897
C9	24402601	24402855	BolC9t55931H	0	-	2	5	254	0.0196850
C9	24409939	24413627	BolC9t55932H	0	+	1119	3552	3688	0.9631236
C9	24418471	24419047	BolC9t55933H	0	+	394	576	576	1.0000000
C9	24430059	24433063	BolC9t55934H	0	-	1594	2954	3004	0.9833555
C9	24446646	24448697	BolC9t55935H	0	+	451	2018	2051	0.9839103
C9	24456237	24456945	BolC9t55936H	0	+	199	708	708	1.0000000
C9	24459920	24462215	BolC9t55937H	0	+	1497	2286	2295	0.9960784
C9	24493560	24493824	BolC9t55938H	0	-	1	1	264	0.0037879
C9	24502936	24505486	BolC9t55939H	0	+	485	2182	2550	0.8556862
C9	24513697	24515845	BolC9t55940H	0	+	608	1499	2148	0.6978585
C9	24516858	24518594	BolC9t55941H	0	+	507	1707	1736	0.9832949
C9	24531151	24531898	BolC9t55942H	0	+	606	747	747	1.0000000
C9	24537099	24537756	BolC9t55943H	0	+	135	644	657	0.9802131
C9	24539383	24541118	BolC9t55944H	0	+	114	725	1735	0.4178674
C9	24541427	24543257	BolC9t55945H	0	-	740	1830	1830	1.0000000
C9	24543870	24545863	BolC9t55946H	0	-	525	1948	1993	0.9774210
C9	24566940	24594213	BolC9t55947H	0	+	5354	16870	27273	0.6185605
C9	24572338	24581430	BolC9t55948H	0	-	2096	6099	9092	0.6708095
C9	24597098	24598025	BolC9t55949H	0	+	167	832	927	0.8975189
C9	24599861	24601391	BolC9t55950H	0	-	229	1494	1530	0.9764706
C9	24619475	24619865	BolC9t55951H	0	+	614	390	390	1.0000000
C9	24626723	24628043	BolC9t55952H	0	+	322	1060	1320	0.8030303
C9	24643900	24645163	BolC9t55953H	0	-	66	914	1263	0.7236738
C9	24663709	24666709	BolC9t55954H	0	+	1443	2977	3000	0.9923334
C9	24670305	24673026	BolC9t55955H	0	+	1167	2672	2721	0.9819919
C9	24675754	24677250	BolC9t55956H	0	-	0	0	1496	0.0000000
C9	24678774	24681031	BolC9t55957H	0	+	894	2079	2257	0.9211342
C9	24683165	24683288	BolC9t55958H	0	-	72	123	123	1.0000000
C9	24684987	24691380	BolC9t55959H	0	+	1331	3789	6393	0.5926795
C9	24704771	24704942	BolC9t55960H	0	+	1	27	171	0.1578947
C9	24707475	24708089	BolC9t55961H	0	+	0	0	614	0.0000000
C9	24708664	24709472	BolC9t55962H	0	-	51	235	808	0.2908416
C9	24712644	24713887	BolC9t55963H	0	+	277	1231	1243	0.9903460
C9	24734862	24743147	BolC9t55964H	0	+	12700	8144	8285	0.9829813
C9	24747956	24748253	BolC9t55965H	0	+	289	297	297	1.0000000
C9	24749132	24749612	BolC9t55966H	0	+	327	480	480	1.0000000
C9	24755784	24757164	BolC9t55967H	0	-	63	684	1380	0.4956522
C9	24758529	24759796	BolC9t55968H	0	+	972	1267	1267	1.0000000
C9	24800338	24801815	BolC9t55969H	0	-	630	1477	1477	1.0000000
C9	24802896	24819040	BolC9t55970H	0	-	8479	15726	16144	0.9741080
C9	24853063	24860192	BolC9t55971H	0	-	2917	5807	7129	0.8145602
C9	24865023	24867223	BolC9t55972H	0	+	609	1909	2200	0.8677273
C9	24867944	24869940	BolC9t55973H	0	-	2164	1996	1996	1.0000000
C9	24872846	24873529	BolC9t55974H	0	-	45	318	683	0.4655930
C9	24880437	24881424	BolC9t55975H	0	+	901	987	987	1.0000000
C9	24882395	24884105	BolC9t55976H	0	-	79	973	1710	0.5690058
C9	24896676	24898892	BolC9t55977H	0	+	1003	2054	2216	0.9268953
C9	24898995	24899776	BolC9t55978H	0	-	144	598	781	0.7656850
C9	24900100	24901409	BolC9t55979H	0	-	342	1294	1309	0.9885409
C9	24906368	24906572	BolC9t55980H	0	+	169	204	204	1.0000000
C9	24917445	24920389	BolC9t55981H	0	+	483	2454	2944	0.8335598
C9	24930593	24932485	BolC9t55982H	0	+	858	1720	1892	0.9090909
C9	24934868	24935818	BolC9t55983H	0	-	367	950	950	1.0000000
C9	24944138	24945056	BolC9t55984H	0	-	72	410	918	0.4466231
C9	24959436	24959928	BolC9t55985H	0	-	152	492	492	1.0000000
C9	24961872	24962199	BolC9t55986H	0	+	4	20	327	0.0611621
C9	24978733	24980442	BolC9t55987H	0	-	2	19	1709	0.0111176
C9	24987899	24988389	BolC9t55988H	0	+	16	135	490	0.2755102
C9	24995826	24997843	BolC9t55989H	0	+	96	870	2017	0.4313337
C9	24998272	24998905	BolC9t55990H	0	+	22	356	633	0.5624012
C9	25003083	25003515	BolC9t55991H	0	-	1	23	432	0.0532407
C9	25011755	25012167	BolC9t55992H	0	+	141	412	412	1.0000000
C9	25012227	25023885	BolC9t55993H	0	+	1140	6262	11658	0.5371419
C9	25023983	25024664	BolC9t55994H	0	+	40	510	681	0.7488987
C9	25037299	25037464	BolC9t55995H	0	+	22	158	165	0.9575757
C9	25044594	25045047	BolC9t55996H	0	+	14	239	453	0.5275938
C9	25053694	25054309	BolC9t55997H	0	+	1	56	615	0.0910569
C9	25058230	25071980	BolC9t55998H	0	+	891	5410	13750	0.3934546
C9	25060210	25060601	BolC9t55999H	0	+	0	0	391	0.0000000
C9	25082799	25082964	BolC9t56000H	0	+	381	165	165	1.0000000
C9	25087986	25089404	BolC9t56001H	0	+	1297	1418	1418	1.0000000
C9	25089460	25121780	BolC9t56002H	0	+	2534	11361	32320	0.3515161
C9	25126604	25142878	BolC9t56003H	0	+	2198	6831	16274	0.4197493
C9	25144942	25145354	BolC9t56004H	0	+	265	412	412	1.0000000
C9	25173806	25175891	BolC9t56005H	0	+	447	1751	2085	0.8398082
C9	25176499	25177995	BolC9t56006H	0	+	1007	1448	1496	0.9679145
C9	25179259	25179838	BolC9t56007H	0	-	0	0	579	0.0000000
C9	25192062	25193034	BolC9t56008H	0	-	393	972	972	1.0000000
C9	25215803	25216943	BolC9t56009H	0	+	741	1140	1140	1.0000000
C9	25218516	25223299	BolC9t56010H	0	-	2110	4011	4783	0.8385950
C9	25244224	25245196	BolC9t56011H	0	-	578	972	972	1.0000000
C9	25254019	25258451	BolC9t56012H	0	+	448	2605	4432	0.5877708
C9	25262417	25263998	BolC9t56013H	0	+	609	1581	1581	1.0000000
C9	25265365	25266037	BolC9t56014H	0	+	127	657	672	0.9776786
C9	25289959	25290832	BolC9t56015H	0	-	103	873	873	1.0000000
C9	25304607	25305060	BolC9t56016H	0	+	202	393	453	0.8675497
C9	25307988	25309227	BolC9t56017H	0	-	4	175	1239	0.1412429
C9	25319571	25319883	BolC9t56018H	0	+	109	153	312	0.4903846
C9	25321373	25322345	BolC9t56019H	0	-	65	824	972	0.8477366
C9	25348084	25353159	BolC9t56020H	0	-	1156	3742	5075	0.7373399
C9	25360403	25361732	BolC9t56021H	0	+	484	1268	1329	0.9541008
C9	25364782	25365769	BolC9t56022H	0	+	45	548	987	0.5552178
C9	25370181	25371363	BolC9t56023H	0	+	91	703	1182	0.5947546
C9	25375597	25377132	BolC9t56024H	0	+	165	865	1535	0.5635179
C9	25381210	25381899	BolC9t56025H	0	+	1758	689	689	1.0000000
C9	25387304	25393478	BolC9t56026H	0	+	506	3722	6174	0.6028507
C9	25394859	25395761	BolC9t56027H	0	+	0	0	902	0.0000000
C9	25406613	25407661	BolC9t56028H	0	+	512	956	1048	0.9122137
C9	25414204	25415283	BolC9t56029H	0	-	12996	1079	1079	1.0000000
C9	25442743	25443988	BolC9t56030H	0	+	185	1077	1245	0.8650603
C9	25448332	25448689	BolC9t56031H	0	-	37	268	357	0.7507003
C9	25452348	25453286	BolC9t56032H	0	-	0	0	938	0.0000000
C9	25454667	25456250	BolC9t56033H	0	-	6	188	1583	0.1187618
C9	25459434	25461007	BolC9t56034H	0	-	518	1161	1573	0.7380801
C9	25477289	25477544	BolC9t56035H	0	-	31	165	255	0.6470588
C9	25487141	25490206	BolC9t56036H	0	+	952	1601	3065	0.5223491
C9	25492175	25496013	BolC9t56037H	0	+	837	2638	3838	0.6873372
C9	25509923	25510067	BolC9t56038H	0	-	136	144	144	1.0000000
C9	25522490	25523021	BolC9t56039H	0	+	2	109	531	0.2052731
C9	25540261	25540498	BolC9t56040H	0	+	13	120	237	0.5063291
C9	25543565	25575650	BolC9t56041H	0	-	7694	22219	32085	0.6925043
C9	25546557	25547613	BolC9t56042H	0	+	18	822	1056	0.7784091
C9	25553896	25554608	BolC9t56043H	0	-	0	0	712	0.0000000
C9	25556191	25557997	BolC9t56044H	0	-	28	302	1806	0.1672204
C9	25560019	25560423	BolC9t56045H	0	+	943	404	404	1.0000000
C9	25572589	25573498	BolC9t56046H	0	+	60	768	909	0.8448845
C9	25583018	25584125	BolC9t56047H	0	+	87	1033	1107	0.9331527
C9	25608796	25609282	BolC9t56048H	0	+	51	301	486	0.6193416
C9	25617132	25619405	BolC9t56049H	0	-	583	2030	2273	0.8930928
C9	25619831	25622312	BolC9t56050H	0	+	1043	2317	2481	0.9338976
C9	25630351	25630507	BolC9t56051H	0	-	32	156	156	1.0000000
C9	25635693	25636554	BolC9t56052H	0	+	8	202	861	0.2346109
C9	25640884	25642168	BolC9t56053H	0	-	131	1193	1284	0.9291278
C9	25645563	25646442	BolC9t56054H	0	+	108	672	879	0.7645051
C9	25669805	25672648	BolC9t56055H	0	+	200	1564	2843	0.5501231
C9	25686531	25688519	BolC9t56056H	0	-	1122	1937	1988	0.9743461
C9	25690291	25700213	BolC9t56057H	0	-	3362	8528	9922	0.8595041
C9	25700527	25709719	BolC9t56058H	0	+	546	4837	9192	0.5262185
C9	25710768	25711146	BolC9t56059H	0	-	13	222	378	0.5873016
C9	25719340	25720693	BolC9t56060H	0	-	549	1305	1353	0.9645233
C9	25751501	25751780	BolC9t56061H	0	-	333	279	279	1.0000000
C9	25754299	25754658	BolC9t56062H	0	-	393	359	359	1.0000000
C9	25757931	25759043	BolC9t56063H	0	-	589	1044	1112	0.9388489
C9	25759883	25760985	BolC9t56064H	0	+	415	1066	1102	0.9673321
C9	25762993	25764303	BolC9t56065H	0	-	328	1019	1310	0.7778626
C9	25772063	25773443	BolC9t56066H	0	+	128	1160	1380	0.8405797
C9	25773992	25776899	BolC9t56067H	0	+	630	2192	2907	0.7540420
C9	25778224	25780303	BolC9t56068H	0	+	490	1916	2079	0.9215969
C9	25781618	25781975	BolC9t56069H	0	+	0	0	357	0.0000000
C9	25791135	25791655	BolC9t56070H	0	+	0	0	520	0.0000000
C9	25810375	25811092	BolC9t56071H	0	-	3	21	717	0.0292887
C9	25815899	25817510	BolC9t56072H	0	+	2	41	1611	0.0254500
C9	25823399	25825392	BolC9t56073H	0	-	9	226	1993	0.1133969
C9	25829822	25830616	BolC9t56074H	0	+	0	0	794	0.0000000
C9	25840225	25842448	BolC9t56075H	0	-	997	2154	2223	0.9689609
C9	25843656	25844895	BolC9t56076H	0	-	84	835	1239	0.6739306
C9	25845867	25850117	BolC9t56077H	0	-	612	3617	4250	0.8510588
C9	25865726	25867400	BolC9t56078H	0	+	90	874	1674	0.5221028
C9	25867830	25873517	BolC9t56079H	0	-	309	2085	5687	0.3666256
C9	25874494	25876496	BolC9t56080H	0	+	280	1382	2002	0.6903097
C9	25878119	25878863	BolC9t56081H	0	-	130	718	744	0.9650537
C9	25879779	25881391	BolC9t56082H	0	-	242	1228	1612	0.7617866
C9	25888139	25891484	BolC9t56083H	0	-	577	2777	3345	0.8301943
C9	25906415	25908126	BolC9t56084H	0	+	131	1105	1711	0.6458212
C9	25908873	25909017	BolC9t56085H	0	-	161	144	144	1.0000000
C9	25928218	25928836	BolC9t56086H	0	-	14	273	618	0.4417476
C9	25931345	25932041	BolC9t56087H	0	+	5	110	696	0.1580460
C9	25932191	25934437	BolC9t56088H	0	-	646	1891	2246	0.8419412
C9	25934919	25937973	BolC9t56089H	0	+	1297	2642	3054	0.8650950
C9	25938314	25942307	BolC9t56090H	0	-	1216	3181	3993	0.7966442
C9	25942887	25944268	BolC9t56091H	0	+	200	813	1381	0.5887038
C9	25946231	25947589	BolC9t56092H	0	+	342	1081	1358	0.7960235
C9	25953746	25955985	BolC9t56093H	0	-	406	1929	2239	0.8615453
C9	25969573	25971269	BolC9t56094H	0	-	840	1684	1696	0.9929245
C9	25971757	25974209	BolC9t56095H	0	-	234	1843	2452	0.7516313
C9	25974999	25975248	BolC9t56096H	0	+	1	65	249	0.2610442
C9	25976708	25977304	BolC9t56097H	0	-	75	42	596	0.0704698
C9	25984035	25984856	BolC9t56098H	0	+	0	0	821	0.0000000
C9	25984868	25985336	BolC9t56099H	0	+	0	0	468	0.0000000
C9	25988897	25989176	BolC9t56100H	0	+	510	279	279	1.0000000
C9	25994600	25995998	BolC9t56101H	0	-	182	726	1398	0.5193133
C9	26011256	26013290	BolC9t56102H	0	+	41	384	2034	0.1887906
C9	26014667	26015465	BolC9t56103H	0	-	20	104	798	0.1303258
C9	26039329	26041275	BolC9t56104H	0	+	120	1054	1946	0.5416238
C9	26064803	26078153	BolC9t56105H	0	+	2569	9087	13350	0.6806741
C9	26129648	26130871	BolC9t56106H	0	-	0	0	1223	0.0000000
C9	26141050	26143177	BolC9t56107H	0	-	224	1589	2127	0.7470616
C9	26148324	26148974	BolC9t56108H	0	-	128	620	650	0.9538462
C9	26154078	26154324	BolC9t56109H	0	+	112	246	246	1.0000000
C9	26155181	26156192	BolC9t56110H	0	+	443	1011	1011	1.0000000
C9	26156842	26157301	BolC9t56111H	0	+	532	459	459	1.0000000
C9	26158094	26161747	BolC9t56112H	0	-	573	2928	3653	0.8015330
C9	26168216	26168897	BolC9t56113H	0	-	7	208	681	0.3054332
C9	26200686	26201328	BolC9t56114H	0	-	147	553	642	0.8613707
C9	26207141	26208289	BolC9t56115H	0	-	53	363	1148	0.3162021
C9	26227108	26229130	BolC9t56116H	0	-	15	171	2022	0.0845697
C9	26247277	26251022	BolC9t56117H	0	+	438	2461	3745	0.6571429
C9	26251376	26251853	BolC9t56118H	0	-	62	353	477	0.7400419
C9	26257740	26263127	BolC9t56119H	0	-	277	1962	5387	0.3642101
C9	26268341	26270408	BolC9t56120H	0	-	342	1817	2067	0.8790517
C9	26278471	26279002	BolC9t56121H	0	-	16	342	531	0.6440678
C9	26279230	26279613	BolC9t56122H	0	-	109	383	383	1.0000000
C9	26281603	26281925	BolC9t56123H	0	-	0	0	322	0.0000000
C9	26289714	26293211	BolC9t56124H	0	+	1379	3315	3497	0.9479554
C9	26307910	26309381	BolC9t56125H	0	+	107	667	1471	0.4534330
C9	26312441	26312949	BolC9t56126H	0	+	431	508	508	1.0000000
C9	26320100	26320827	BolC9t56127H	0	-	595	727	727	1.0000000
C9	26321756	26322902	BolC9t56128H	0	+	1302	1146	1146	1.0000000
C9	26323761	26325509	BolC9t56129H	0	-	22	560	1748	0.3203661
C9	26328038	26334948	BolC9t56130H	0	-	1340	4169	6910	0.6033285
C9	26340520	26346021	BolC9t56131H	0	+	654	3420	5501	0.6217051
C9	26355796	26356869	BolC9t56132H	0	+	156	776	1073	0.7232060
C9	26359813	26364757	BolC9t56133H	0	+	1238	4040	4944	0.8171521
C9	26366609	26366822	BolC9t56134H	0	-	91	213	213	1.0000000
C9	26368093	26368727	BolC9t56135H	0	+	0	0	634	0.0000000
C9	26385914	26386238	BolC9t56136H	0	+	0	0	324	0.0000000
C9	26386872	26387232	BolC9t56137H	0	-	56	334	360	0.9277778
C9	26399127	26403387	BolC9t56138H	0	+	1120	3093	4260	0.7260563
C9	26404593	26407797	BolC9t56139H	0	-	300	1745	3204	0.5446317
C9	26413065	26415036	BolC9t56140H	0	+	523	1291	1971	0.6549975
C9	26420224	26422050	BolC9t56141H	0	+	461	1330	1826	0.7283680
C9	26422697	26424517	BolC9t56142H	0	-	1156	1601	1820	0.8796703
C9	26428428	26429073	BolC9t56143H	0	+	55	480	645	0.7441860
C9	26432538	26436656	BolC9t56144H	0	-	573	3430	4118	0.8329286
C9	26450040	26451285	BolC9t56145H	0	-	490	1240	1245	0.9959840
C9	26457698	26461640	BolC9t56146H	0	+	1612	3596	3942	0.9122273
C9	26461950	26462911	BolC9t56147H	0	-	1048	961	961	1.0000000
C9	26473822	26475137	BolC9t56148H	0	+	926	1315	1315	1.0000000
C9	26476180	26477920	BolC9t56149H	0	+	551	1733	1740	0.9959770
C9	26478593	26486881	BolC9t56150H	0	-	1822	6772	8288	0.8170850
C9	26508198	26508618	BolC9t56151H	0	+	384	420	420	1.0000000
C9	26509083	26509908	BolC9t56152H	0	+	89	556	825	0.6739394
C9	26515108	26516236	BolC9t56153H	0	+	127	836	1128	0.7411348
C9	26521215	26521668	BolC9t56154H	0	+	481	453	453	1.0000000
C9	26570529	26570718	BolC9t56155H	0	-	42	189	189	1.0000000
C9	26582187	26583127	BolC9t56156H	0	+	335	881	940	0.9372340
C9	26583832	26584336	BolC9t56157H	0	+	1	65	504	0.1289683
C9	26605375	26605531	BolC9t56158H	0	-	59	156	156	1.0000000
C9	26606372	26606543	BolC9t56159H	0	+	0	0	171	0.0000000
C9	26610396	26611339	BolC9t56160H	0	+	40	335	943	0.3552492
C9	26613498	26614045	BolC9t56161H	0	+	33	547	547	1.0000000
C9	26614631	26615799	BolC9t56162H	0	-	90	796	1168	0.6815069
C9	26620997	26621630	BolC9t56163H	0	-	2258	633	633	1.0000000
C9	26623000	26625157	BolC9t56164H	0	-	379	1977	2157	0.9165508
C9	26633107	26633759	BolC9t56165H	0	+	302	571	652	0.8757669
C9	26634346	26635975	BolC9t56166H	0	-	634	1629	1629	1.0000000
C9	26661261	26663432	BolC9t56167H	0	+	1065	2170	2171	0.9995394
C9	26664744	26665244	BolC9t56168H	0	-	273	500	500	1.0000000
C9	26665409	26665682	BolC9t56169H	0	-	192	273	273	1.0000000
C9	26673484	26680671	BolC9t56170H	0	-	2324	5823	7187	0.8102129
C9	26689893	26696109	BolC9t56171H	0	+	2333	5499	6216	0.8846525
C9	26697391	26697751	BolC9t56172H	0	-	140	360	360	1.0000000
C9	26761793	26762056	BolC9t56173H	0	+	127	263	263	1.0000000
C9	26763992	26764643	BolC9t56174H	0	+	407	651	651	1.0000000
C9	26769174	26769658	BolC9t56175H	0	-	171	484	484	1.0000000
C9	26778361	26778540	BolC9t56176H	0	-	71	179	179	1.0000000
C9	26784401	26784978	BolC9t56177H	0	+	42	538	577	0.9324090
C9	26787284	26791677	BolC9t56178H	0	-	552	2925	4393	0.6658320
C9	26813261	26814447	BolC9t56179H	0	+	238	1053	1186	0.8878583
C9	26816241	26817101	BolC9t56180H	0	+	898	860	860	1.0000000
C9	26830268	26839029	BolC9t56181H	0	+	4512	8219	8761	0.9381349
C9	26847555	26849038	BolC9t56182H	0	-	1080	1483	1483	1.0000000
C9	26853749	26856667	BolC9t56183H	0	-	1170	2896	2918	0.9924606
C9	26864482	26865691	BolC9t56184H	0	-	262	945	1209	0.7816377
C9	26866372	26867625	BolC9t56185H	0	+	338	1100	1253	0.8778930
C9	26867844	26868086	BolC9t56186H	0	-	83	242	242	1.0000000
C9	26873333	26876199	BolC9t56187H	0	-	274	2190	2866	0.7641312
C9	26893867	26896933	BolC9t56188H	0	+	869	2455	3066	0.8007175
C9	26913032	26913608	BolC9t56189H	0	+	460	576	576	1.0000000
C9	26918470	26919884	BolC9t56190H	0	-	862	1414	1414	1.0000000
C9	26920375	26920543	BolC9t56191H	0	+	116	168	168	1.0000000
C9	26939339	26940469	BolC9t56192H	0	+	46	476	1130	0.4212389
C9	26940671	26941633	BolC9t56193H	0	-	388	939	962	0.9760915
C9	26941926	26942378	BolC9t56194H	0	+	276	452	452	1.0000000
C9	26942747	26945967	BolC9t56195H	0	-	556	2733	3220	0.8487577
C9	26946894	26949971	BolC9t56196H	0	-	1130	2505	3077	0.8141047
C9	26953507	26954436	BolC9t56197H	0	+	829	929	929	1.0000000
C9	26955464	26956643	BolC9t56198H	0	-	478	1161	1179	0.9847328
C9	26959815	26963346	BolC9t56199H	0	-	1114	2181	3531	0.6176720
C9	26974966	26981213	BolC9t56200H	0	-	1742	6002	6247	0.9607812
C9	26995147	26996454	BolC9t56201H	0	-	1009	1307	1307	1.0000000
C9	26997529	26997865	BolC9t56202H	0	-	186	336	336	1.0000000
C9	27001362	27003077	BolC9t56203H	0	-	950	1594	1715	0.9294460
C9	27017826	27019971	BolC9t56204H	0	+	525	2074	2145	0.9668998
C9	27020813	27024212	BolC9t56205H	0	+	2326	3271	3399	0.9623418
C9	27052068	27053482	BolC9t56206H	0	+	760	1414	1414	1.0000000
C9	27053758	27056956	BolC9t56207H	0	-	1046	2942	3198	0.9199499
C9	27065147	27067558	BolC9t56208H	0	-	576	2363	2411	0.9800913
C9	27079813	27081236	BolC9t56209H	0	+	313	541	1423	0.3801827
C9	27081586	27081895	BolC9t56210H	0	-	0	0	309	0.0000000
C9	27104482	27104800	BolC9t56211H	0	+	47	214	318	0.6729560
C9	27107527	27108756	BolC9t56212H	0	+	79	222	1229	0.1806347
C9	27109088	27110922	BolC9t56213H	0	-	151	1538	1834	0.8386042
C9	27140026	27140944	BolC9t56214H	0	+	584	918	918	1.0000000
C9	27151600	27154051	BolC9t56215H	0	+	462	865	2451	0.3529172
C9	27157627	27160427	BolC9t56216H	0	+	344	1922	2800	0.6864285
C9	27163194	27164765	BolC9t56217H	0	-	540	1571	1571	1.0000000
C9	27167334	27168249	BolC9t56218H	0	+	22	240	915	0.2622951
C9	27188887	27189678	BolC9t56219H	0	-	736	791	791	1.0000000
C9	27190228	27197343	BolC9t56220H	0	-	4788	6532	7115	0.9180604
C9	27198358	27200695	BolC9t56221H	0	+	677	2196	2337	0.9396662
C9	27201883	27202300	BolC9t56222H	0	+	65	359	417	0.8609113
C9	27203873	27207155	BolC9t56223H	0	+	697	2214	3282	0.6745887
C9	27214181	27217142	BolC9t56224H	0	-	2380	2961	2961	1.0000000
C9	27228816	27229353	BolC9t56225H	0	-	118	537	537	1.0000000
C9	27242570	27244060	BolC9t56226H	0	+	1431	1490	1490	1.0000000
C9	27246818	27248624	BolC9t56227H	0	+	949	1735	1806	0.9606866
C9	27272966	27273284	BolC9t56228H	0	+	116	242	318	0.7610063
C9	27273753	27276664	BolC9t56229H	0	-	321	2400	2911	0.8244590
C9	27287147	27287408	BolC9t56230H	0	+	77	260	261	0.9961686
C9	27307593	27308023	BolC9t56231H	0	+	275	430	430	1.0000000
C9	27330498	27333566	BolC9t56232H	0	-	843	1965	3068	0.6404824
C9	27334026	27335554	BolC9t56233H	0	+	1115	1528	1528	1.0000000
C9	27339677	27339860	BolC9t56234H	0	+	460	183	183	1.0000000
C9	27349496	27350168	BolC9t56235H	0	-	668	672	672	1.0000000
C9	27352220	27352484	BolC9t56236H	0	-	254	264	264	1.0000000
C9	27367263	27367653	BolC9t56237H	0	-	196	338	390	0.8666667
C9	27391308	27392986	BolC9t56238H	0	+	857	1664	1678	0.9916567
C9	27402987	27403497	BolC9t56239H	0	+	4	196	510	0.3843137
C9	27408544	27409961	BolC9t56240H	0	+	98	1082	1417	0.7635850
C9	27432266	27433103	BolC9t56241H	0	+	4	100	837	0.1194743
C9	27460878	27461244	BolC9t56242H	0	-	28	77	366	0.2103825
C9	27464379	27465129	BolC9t56243H	0	+	790	750	750	1.0000000
C9	27467610	27471026	BolC9t56244H	0	-	2610	3416	3416	1.0000000
C9	27471528	27472347	BolC9t56245H	0	-	988	819	819	1.0000000
C9	27491349	27491832	BolC9t56246H	0	+	49	98	483	0.2028985
C9	27502269	27502884	BolC9t56247H	0	-	6	77	615	0.1252033
C9	27503793	27504539	BolC9t56248H	0	-	346	743	746	0.9959785
C9	27513565	27515527	BolC9t56249H	0	+	687	1929	1962	0.9831804
C9	27521458	27521647	BolC9t56250H	0	-	205	189	189	1.0000000
C9	27563605	27564475	BolC9t56251H	0	+	545	870	870	1.0000000
C9	27579457	27579883	BolC9t56252H	0	+	165	426	426	1.0000000
C9	27583035	27583712	BolC9t56253H	0	-	345	677	677	1.0000000
C9	27584972	27585304	BolC9t56254H	0	-	74	332	332	1.0000000
C9	27585376	27585885	BolC9t56255H	0	-	229	509	509	1.0000000
C9	27586082	27587370	BolC9t56256H	0	-	545	1288	1288	1.0000000
C9	27594593	27594992	BolC9t56257H	0	+	74	399	399	1.0000000
C9	27604404	27604515	BolC9t56258H	0	-	136	111	111	1.0000000
C9	27605208	27605451	BolC9t56259H	0	-	215	243	243	1.0000000
C9	27616642	27617088	BolC9t56260H	0	-	452	446	446	1.0000000
C9	27635437	27637621	BolC9t56261H	0	-	327	1673	2184	0.7660257
C9	27664878	27666194	BolC9t56262H	0	+	908	1316	1316	1.0000000
C9	27669607	27670675	BolC9t56263H	0	+	4385	1068	1068	1.0000000
C9	27676560	27677085	BolC9t56264H	0	+	84	451	525	0.8590476
C9	27682454	27684460	BolC9t56265H	0	+	204	1251	2006	0.6236291
C9	27688458	27689446	BolC9t56266H	0	-	989	988	988	1.0000000
C9	27695771	27696217	BolC9t56267H	0	+	415	446	446	1.0000000
C9	27722017	27723325	BolC9t56268H	0	+	190	1084	1308	0.8287462
C9	27730491	27731562	BolC9t56269H	0	-	227	1015	1071	0.9477124
C9	27737772	27742640	BolC9t56270H	0	+	1588	4560	4868	0.9367297
C9	27742726	27743328	BolC9t56271H	0	+	44	346	602	0.5747508
C9	27747699	27747946	BolC9t56272H	0	+	271	247	247	1.0000000
C9	27756323	27756605	BolC9t56273H	0	-	233	282	282	1.0000000
C9	27762280	27770675	BolC9t56274H	0	-	3098	7855	8395	0.9356760
C9	27770789	27774602	BolC9t56275H	0	-	2459	3813	3813	1.0000000
C9	27775616	27779410	BolC9t56276H	0	+	1988	3476	3794	0.9161835
C9	27790476	27792031	BolC9t56277H	0	-	92	1225	1555	0.7877814
C9	27793441	27794972	BolC9t56278H	0	+	1184	1531	1531	1.0000000
C9	27827959	27832193	BolC9t56279H	0	+	3025	4008	4234	0.9466226
C9	27851060	27853971	BolC9t56280H	0	-	1167	2743	2911	0.9422879
C9	27855048	27855322	BolC9t56281H	0	-	317	274	274	1.0000000
C9	27859892	27861068	BolC9t56282H	0	+	737	1176	1176	1.0000000
C9	27863679	27864441	BolC9t56283H	0	+	363	611	762	0.8018373
C9	27868783	27869481	BolC9t56284H	0	+	23	178	698	0.2550143
C9	27881448	27885052	BolC9t56285H	0	+	18	469	3604	0.1301332
C9	27897317	27897845	BolC9t56286H	0	-	64	398	528	0.7537879
C9	27930675	27932757	BolC9t56287H	0	-	41	820	2082	0.3938521
C9	27947607	27948213	BolC9t56288H	0	+	115	550	606	0.9075907
C9	27975708	27979475	BolC9t56289H	0	-	1005	3537	3767	0.9389434
C9	27994163	27999361	BolC9t56290H	0	+	1593	4635	5198	0.8916891
C9	28000551	28002495	BolC9t56291H	0	+	271	1742	1944	0.8960905
C9	28013047	28013506	BolC9t56292H	0	-	680	459	459	1.0000000
C9	28017260	28022468	BolC9t56293H	0	+	2007	4540	5208	0.8717358
C9	28023757	28024699	BolC9t56294H	0	+	4	191	942	0.2027601
C9	28028133	28030868	BolC9t56295H	0	+	1254	2645	2735	0.9670932
C9	28049484	28050937	BolC9t56296H	0	-	1785	1453	1453	1.0000000
C9	28053891	28055064	BolC9t56297H	0	-	237	1082	1173	0.9224212
C9	28086933	28090778	BolC9t56298H	0	-	4436	3801	3845	0.9885566
C9	28092098	28092461	BolC9t56299H	0	+	347	363	363	1.0000000
C9	28095414	28095664	BolC9t56300H	0	-	369	250	250	1.0000000
C9	28102556	28104654	BolC9t56301H	0	+	374	1798	2098	0.8570067
C9	28132515	28132761	BolC9t56302H	0	-	80	246	246	1.0000000
C9	28133920	28136360	BolC9t56303H	0	-	508	2301	2440	0.9430328
C9	28201447	28201735	BolC9t56304H	0	+	61	288	288	1.0000000
C9	28213501	28216897	BolC9t56305H	0	+	1598	3396	3396	1.0000000
C9	28230623	28234208	BolC9t56306H	0	+	1209	3105	3585	0.8661088
C9	28242645	28245465	BolC9t56307H	0	+	474	2064	2820	0.7319149
C9	28246872	28249750	BolC9t56308H	0	-	394	2291	2878	0.7960389
C9	28274373	28278960	BolC9t56309H	0	+	1232	3530	4587	0.7695662
C9	28279337	28281673	BolC9t56310H	0	-	575	1682	2336	0.7200342
C9	28288442	28288802	BolC9t56311H	0	+	401	360	360	1.0000000
C9	28291910	28294142	BolC9t56312H	0	-	313	1920	2232	0.8602151
C9	28295951	28296704	BolC9t56313H	0	+	117	747	753	0.9920319
C9	28305757	28323797	BolC9t56314H	0	+	8271	15559	18040	0.8624723
C9	28312883	28315869	BolC9t56315H	0	+	1656	2986	2986	1.0000000
C9	28325704	28328566	BolC9t56316H	0	-	408	2386	2862	0.8336827
C9	28351984	28354986	BolC9t56317H	0	-	432	2854	3002	0.9506995
C9	28354603	28365771	BolC9t56318H	0	+	3606	11156	11168	0.9989255
C9	28368373	28368925	BolC9t56319H	0	+	524	552	552	1.0000000
C9	28378926	28383110	BolC9t56320H	0	-	422	3251	4184	0.7770076
C9	28384819	28386547	BolC9t56321H	0	-	145	1524	1728	0.8819444
C9	28389763	28390012	BolC9t56322H	0	-	254	249	249	1.0000000
C9	28391011	28393075	BolC9t56323H	0	+	852	1854	2064	0.8982558
C9	28401733	28409361	BolC9t56324H	0	+	362	3308	7628	0.4336655
C9	28409490	28410670	BolC9t56325H	0	-	100	947	1180	0.8025424
C9	28415322	28415511	BolC9t56326H	0	-	241	189	189	1.0000000
C9	28418637	28420347	BolC9t56327H	0	-	848	1678	1710	0.9812865
C9	28446617	28447095	BolC9t56328H	0	+	1056	478	478	1.0000000
C9	28473241	28475348	BolC9t56329H	0	+	1537	2107	2107	1.0000000
C9	28483049	28483698	BolC9t56330H	0	+	44	434	649	0.6687211
C9	28484268	28486742	BolC9t56331H	0	-	302	2173	2474	0.8783347
C9	28514987	28515507	BolC9t56332H	0	-	67	520	520	1.0000000
C9	28517762	28519023	BolC9t56333H	0	-	801	1261	1261	1.0000000
C9	28520549	28525750	BolC9t56334H	0	-	960	3905	5201	0.7508172
C9	28528990	28529269	BolC9t56335H	0	+	33	279	279	1.0000000
C9	28532501	28534319	BolC9t56336H	0	+	165	1144	1818	0.6292629
C9	28536987	28538082	BolC9t56337H	0	-	197	431	1095	0.3936073
C9	28549520	28550576	BolC9t56338H	0	+	11	329	1056	0.3115530
C9	28552657	28552816	BolC9t56339H	0	-	168	159	159	1.0000000
C9	28554147	28563400	BolC9t56340H	0	+	1097	6380	9253	0.6895061
C9	28562506	28563659	BolC9t56341H	0	+	84	1134	1153	0.9835212
C9	28566807	28569132	BolC9t56342H	0	+	248	1604	2325	0.6898925
C9	28586464	28596623	BolC9t56343H	0	-	813	6800	10159	0.6693572
C9	28594690	28595510	BolC9t56344H	0	-	21	491	820	0.5987805
C9	28605963	28612897	BolC9t56345H	0	+	4472	6934	6934	1.0000000
C9	28618655	28622592	BolC9t56346H	0	+	381	2013	3937	0.5113030
C9	28623496	28625277	BolC9t56347H	0	+	344	1639	1781	0.9202695
C9	28630498	28630600	BolC9t56348H	0	-	12	66	102	0.6470588
C9	28631066	28631524	BolC9t56349H	0	-	125	405	458	0.8842795
C9	28632314	28632663	BolC9t56350H	0	+	242	349	349	1.0000000
C9	28632511	28635126	BolC9t56351H	0	+	568	2005	2615	0.7667304
C9	28643062	28643476	BolC9t56352H	0	-	58	407	414	0.9830918
C9	28654701	28657159	BolC9t56353H	0	+	603	1275	2458	0.5187144
C9	28667912	28676043	BolC9t56354H	0	+	2808	6024	8131	0.7408683
C9	28677610	28678230	BolC9t56355H	0	+	9	420	620	0.6774194
C9	28684531	28684973	BolC9t56356H	0	+	29	362	442	0.8190045
C9	28689713	28690799	BolC9t56357H	0	+	72	992	1086	0.9134438
C9	28693524	28694345	BolC9t56358H	0	+	0	0	821	0.0000000
C9	28694357	28694825	BolC9t56359H	0	+	0	0	468	0.0000000
C9	28712655	28713182	BolC9t56360H	0	+	736	527	527	1.0000000
C9	28723011	28723341	BolC9t56361H	0	-	435	330	330	1.0000000
C9	28731652	28731856	BolC9t56362H	0	-	123	204	204	1.0000000
C9	28743775	28745562	BolC9t56363H	0	-	178	1198	1787	0.6703973
C9	28760125	28765111	BolC9t56364H	0	-	869	3513	4986	0.7045728
C9	28783282	28783777	BolC9t56365H	0	-	14	48	495	0.0969697
C9	28787607	28793471	BolC9t56366H	0	-	2931	5090	5864	0.8680082
C9	28868619	28868763	BolC9t56367H	0	-	91	144	144	1.0000000
C9	28896300	28905856	BolC9t56368H	0	-	3497	7984	9556	0.8354960
C9	28910189	28911269	BolC9t56369H	0	+	137	922	1080	0.8537037
C9	28917745	28919138	BolC9t56370H	0	-	180	859	1393	0.6166547
C9	28923961	28925713	BolC9t56371H	0	-	468	1476	1752	0.8424658
C9	28942997	28948021	BolC9t56372H	0	-	1140	3546	5024	0.7058121
C9	28954093	28954600	BolC9t56373H	0	-	230	507	507	1.0000000
C9	28960508	28960866	BolC9t56374H	0	+	72	358	358	1.0000000
C9	28965019	28965632	BolC9t56375H	0	+	56	183	613	0.2985318
C9	28966194	28968603	BolC9t56376H	0	-	427	1848	2409	0.7671233
C9	28970024	28970447	BolC9t56377H	0	+	390	423	423	1.0000000
C9	28970795	28972817	BolC9t56378H	0	+	1621	2022	2022	1.0000000
C9	28973286	28974758	BolC9t56379H	0	-	493	678	1472	0.4605978
C9	28982608	28984944	BolC9t56380H	0	+	58	1277	2336	0.5466610
C9	28997938	28998822	BolC9t56381H	0	+	193	797	884	0.9015837
C9	29012066	29019127	BolC9t56382H	0	-	1737	5404	7061	0.7653307
C9	29023078	29023615	BolC9t56383H	0	-	28	220	537	0.4096834
C9	29025247	29028439	BolC9t56384H	0	-	750	2819	3192	0.8831454
C9	29036085	29036649	BolC9t56385H	0	+	1011	564	564	1.0000000
C9	29037033	29037168	BolC9t56386H	0	-	164	135	135	1.0000000
C9	29045061	29047239	BolC9t56387H	0	-	4457	2178	2178	1.0000000
C9	29053963	29054371	BolC9t56388H	0	+	224	399	408	0.9779412
C9	29060218	29060362	BolC9t56389H	0	+	422	144	144	1.0000000
C9	29062114	29064821	BolC9t56390H	0	+	722	2152	2707	0.7949760
C9	29067052	29067677	BolC9t56391H	0	-	768	625	625	1.0000000
C9	29068154	29068416	BolC9t56392H	0	-	360	262	262	1.0000000
C9	29082456	29083110	BolC9t56393H	0	-	136	579	654	0.8853211
C9	29109221	29110658	BolC9t56394H	0	-	665	1437	1437	1.0000000
C9	29122641	29126535	BolC9t56395H	0	-	531	2743	3894	0.7044170
C9	29139087	29139666	BolC9t56396H	0	+	401	579	579	1.0000000
C9	29148632	29152946	BolC9t56397H	0	-	916	3556	4314	0.8242930
C9	29164483	29164952	BolC9t56398H	0	+	491	469	469	1.0000000
C9	29178938	29179792	BolC9t56399H	0	-	764	854	854	1.0000000
C9	29198273	29199161	BolC9t56400H	0	+	627	888	888	1.0000000
C9	29217094	29217493	BolC9t56401H	0	-	134	399	399	1.0000000
C9	29220869	29221236	BolC9t56402H	0	-	7	225	367	0.6130790
C9	29221748	29222132	BolC9t56403H	0	+	19	290	384	0.7552083
C9	29229321	29230960	BolC9t56404H	0	+	384	1573	1639	0.9597315
C9	29231470	29233381	BolC9t56405H	0	+	774	1899	1911	0.9937206
C9	29233807	29235057	BolC9t56406H	0	+	586	1250	1250	1.0000000
C9	29245787	29248476	BolC9t56407H	0	-	1493	2689	2689	1.0000000
C9	29295398	29299964	BolC9t56408H	0	-	1340	4198	4566	0.9194043
C9	29322906	29325531	BolC9t56409H	0	+	1857	2625	2625	1.0000000
C9	29325788	29326222	BolC9t56410H	0	-	278	434	434	1.0000000
C9	29326303	29327360	BolC9t56411H	0	-	432	1057	1057	1.0000000
C9	29340957	29344373	BolC9t56412H	0	+	2144	3416	3416	1.0000000
C9	29345010	29345779	BolC9t56413H	0	-	572	769	769	1.0000000
C9	29353161	29355650	BolC9t56414H	0	+	237	2042	2489	0.8204098
C9	29356501	29357851	BolC9t56415H	0	+	282	1114	1350	0.8251852
C9	29358729	29360582	BolC9t56416H	0	+	366	1703	1853	0.9190502
C9	29366503	29367428	BolC9t56417H	0	+	218	919	925	0.9935135
C9	29387171	29387399	BolC9t56418H	0	-	17	120	228	0.5263158
C9	29395871	29397763	BolC9t56419H	0	-	264	1336	1892	0.7061311
C9	29397924	29398506	BolC9t56420H	0	+	0	0	582	0.0000000
C9	29425668	29427243	BolC9t56421H	0	-	267	1145	1575	0.7269841
C9	29463963	29464933	BolC9t56422H	0	+	175	919	970	0.9474227
C9	29465947	29466363	BolC9t56423H	0	+	34	398	416	0.9567308
C9	29476007	29477429	BolC9t56424H	0	-	34	450	1422	0.3164557
C9	29479168	29479519	BolC9t56425H	0	-	0	0	351	0.0000000
C9	29481940	29483107	BolC9t56426H	0	+	36	305	1167	0.2613539
C9	29483556	29483806	BolC9t56427H	0	+	34	250	250	1.0000000
C9	29497763	29498003	BolC9t56428H	0	+	0	0	240	0.0000000
C9	29505175	29505595	BolC9t56429H	0	+	29	361	420	0.8595238
C9	29518618	29519431	BolC9t56430H	0	-	9	450	813	0.5535055
C9	29522531	29525130	BolC9t56431H	0	+	3	172	2599	0.0661793
C9	29557377	29564231	BolC9t56432H	0	-	652	4042	6854	0.5897287
C9	29591397	29592775	BolC9t56433H	0	-	0	0	1378	0.0000000
C9	29614383	29615761	BolC9t56434H	0	-	0	0	1378	0.0000000
C9	29674587	29676489	BolC9t56435H	0	+	241	1706	1902	0.8969506
C9	29676798	29677227	BolC9t56436H	0	-	6	232	429	0.5407925
C9	29682527	29682710	BolC9t56437H	0	-	134	183	183	1.0000000
C9	29697605	29698214	BolC9t56438H	0	-	229	609	609	1.0000000
C9	29699762	29700065	BolC9t56439H	0	+	114	303	303	1.0000000
C9	29700179	29700992	BolC9t56440H	0	-	299	813	813	1.0000000
C9	29701049	29702318	BolC9t56441H	0	-	586	1269	1269	1.0000000
C9	29741342	29746484	BolC9t56442H	0	+	2901	4534	5142	0.8817581
C9	29760474	29763331	BolC9t56443H	0	+	773	2485	2857	0.8697935
C9	29764238	29765318	BolC9t56444H	0	-	59	612	1080	0.5666667
C9	29772742	29786436	BolC9t56445H	0	+	240	2635	13694	0.1924200
C9	29777038	29778521	BolC9t56446H	0	-	0	0	1483	0.0000000
C9	29781398	29792533	BolC9t56447H	0	+	217	2179	11135	0.1956893
C9	29786789	29787137	BolC9t56448H	0	-	0	0	348	0.0000000
C9	29795166	29797824	BolC9t56449H	0	+	1174	1890	2658	0.7110609
C9	29799978	29800647	BolC9t56450H	0	-	50	629	669	0.9402093
C9	29810982	29814030	BolC9t56451H	0	+	302	1844	3048	0.6049869
C9	29819533	29821576	BolC9t56452H	0	-	117	1178	2043	0.5766031
C9	29822549	29822796	BolC9t56453H	0	-	75	180	247	0.7287449
C9	29832606	29834269	BolC9t56454H	0	-	1127	1540	1663	0.9260373
C9	29844134	29844993	BolC9t56455H	0	+	173	784	859	0.9126891
C9	29844993	29845518	BolC9t56456H	0	+	216	525	525	1.0000000
C9	29852877	29853457	BolC9t56457H	0	+	1012	580	580	1.0000000
C9	29854370	29856058	BolC9t56458H	0	+	103	986	1688	0.5841232
C9	29856965	29858102	BolC9t56459H	0	+	524	1137	1137	1.0000000
C9	29868692	29870687	BolC9t56460H	0	-	689	1806	1995	0.9052632
C9	29879776	29880921	BolC9t56461H	0	-	72	857	1145	0.7484716
C9	29882385	29882550	BolC9t56462H	0	+	389	165	165	1.0000000
C9	29903259	29903588	BolC9t56463H	0	+	1	128	329	0.3890578
C9	29903458	29903770	BolC9t56464H	0	+	3	145	312	0.4647436
C9	29912485	29913292	BolC9t56465H	0	-	41	232	807	0.2874845
C9	29928029	29930309	BolC9t56466H	0	-	291	1698	2280	0.7447369
C9	29938366	29938990	BolC9t56467H	0	+	116	428	624	0.6858974
C9	29943109	29944855	BolC9t56468H	0	-	3800	1746	1746	1.0000000
C9	29980743	29981437	BolC9t56469H	0	-	638	694	694	1.0000000
C9	29983964	29984243	BolC9t56470H	0	+	302	279	279	1.0000000
C9	29996636	29998215	BolC9t56471H	0	-	234	1282	1579	0.8119063
C9	30033089	30034420	BolC9t56472H	0	-	49	754	1331	0.5664914
C9	30064317	30064635	BolC9t56473H	0	-	221	318	318	1.0000000
C9	30079352	30079863	BolC9t56474H	0	-	7	169	511	0.3307241
C9	30091268	30091639	BolC9t56475H	0	+	225	371	371	1.0000000
C9	30096870	30097780	BolC9t56476H	0	+	260	910	910	1.0000000
C9	30107275	30108673	BolC9t56477H	0	-	195	1037	1398	0.7417740
C9	30111837	30112071	BolC9t56478H	0	-	352	234	234	1.0000000
C9	30146104	30146862	BolC9t56479H	0	+	151	758	758	1.0000000
C9	30148172	30150359	BolC9t56480H	0	+	32	711	2187	0.3251029
C9	30190485	30191920	BolC9t56481H	0	+	236	962	1435	0.6703833
C9	30211976	30213821	BolC9t56482H	0	+	209	950	1845	0.5149052
C9	30214430	30215771	BolC9t56483H	0	-	328	1177	1341	0.8777032
C9	30255631	30259677	BolC9t56484H	0	-	989	3330	4046	0.8230351
C9	30262101	30263058	BolC9t56485H	0	+	603	957	957	1.0000000
C9	30274546	30276051	BolC9t56486H	0	+	163	1137	1505	0.7554817
C9	30292662	30297547	BolC9t56487H	0	-	1650	4291	4885	0.8784032
C9	30324210	30324764	BolC9t56488H	0	+	14	108	554	0.1949458
C9	30337594	30340833	BolC9t56489H	0	-	2865	3217	3239	0.9932078
C9	30344353	30344958	BolC9t56490H	0	-	532	605	605	1.0000000
C9	30348821	30350553	BolC9t56491H	0	-	781	1693	1732	0.9774827
C9	30357812	30358367	BolC9t56492H	0	+	399	555	555	1.0000000
C9	30363156	30369498	BolC9t56493H	0	+	3523	6342	6342	1.0000000
C9	30385203	30386116	BolC9t56494H	0	+	801	908	913	0.9945235
C9	30386613	30389798	BolC9t56495H	0	-	1104	2677	3185	0.8405024
C9	30392285	30392986	BolC9t56496H	0	-	256	689	701	0.9828816
C9	30393754	30396191	BolC9t56497H	0	+	83	672	2437	0.2757489
C9	30406290	30407283	BolC9t56498H	0	+	492	993	993	1.0000000
C9	30407617	30409389	BolC9t56499H	0	-	656	1462	1772	0.8250564
C9	30415055	30416246	BolC9t56500H	0	-	724	1182	1191	0.9924433
C9	30422234	30423028	BolC9t56501H	0	-	446	794	794	1.0000000
C9	30433603	30436056	BolC9t56502H	0	+	240	1908	2453	0.7778231
C9	30436950	30440273	BolC9t56503H	0	-	556	2882	3323	0.8672886
C9	30468208	30471669	BolC9t56504H	0	+	732	2713	3461	0.7838775
C9	30473179	30473780	BolC9t56505H	0	-	130	573	601	0.9534110
C9	30473712	30473948	BolC9t56506H	0	+	54	236	236	1.0000000
C9	30489298	30489859	BolC9t56507H	0	+	342	561	561	1.0000000
C9	30501544	30503967	BolC9t56508H	0	+	235	2053	2423	0.8472967
C9	30502390	30502925	BolC9t56509H	0	+	17	320	535	0.5981308
C9	30504211	30543771	BolC9t56510H	0	-	7907	32368	39560	0.8182002
C9	30511525	30513538	BolC9t56511H	0	-	167	1510	2013	0.7501242
C9	30538979	30540664	BolC9t56512H	0	+	3	399	1685	0.2367952
C9	30570138	30571247	BolC9t56513H	0	+	124	689	1109	0.6212804
C9	30571629	30574503	BolC9t56514H	0	-	300	1905	2874	0.6628392
C9	30593371	30595319	BolC9t56515H	0	-	1238	1948	1948	1.0000000
C9	30618255	30619802	BolC9t56516H	0	+	438	1513	1547	0.9780220
C9	30624950	30628824	BolC9t56517H	0	+	576	3082	3874	0.7955601
C9	30631507	30631929	BolC9t56518H	0	-	166	422	422	1.0000000
C9	30660879	30661338	BolC9t56519H	0	-	298	459	459	1.0000000
C9	30740251	30741622	BolC9t56520H	0	-	518	1315	1371	0.9591539
C9	30786391	30787777	BolC9t56521H	0	+	705	1386	1386	1.0000000
C9	30810066	30813884	BolC9t56522H	0	+	146	1762	3818	0.4614982
C9	30817982	30818700	BolC9t56523H	0	+	20	107	718	0.1490251
C9	30821641	30822311	BolC9t56524H	0	-	291	670	670	1.0000000
C9	30823697	30824203	BolC9t56525H	0	-	228	492	506	0.9723320
C9	30836739	30839484	BolC9t56526H	0	-	851	2119	2745	0.7719490
C9	30891131	30893389	BolC9t56527H	0	-	765	2096	2258	0.9282551
C9	30898460	30898844	BolC9t56528H	0	-	288	384	384	1.0000000
C9	30908996	30910140	BolC9t56529H	0	+	720	1144	1144	1.0000000
C9	30920888	30921236	BolC9t56530H	0	+	272	348	348	1.0000000
C9	30938500	30938848	BolC9t56531H	0	+	154	348	348	1.0000000
C9	30940146	30940494	BolC9t56532H	0	+	175	348	348	1.0000000
C9	30941754	30942093	BolC9t56533H	0	+	23	339	339	1.0000000
C9	30945034	30945382	BolC9t56534H	0	+	127	348	348	1.0000000
C9	30946663	30947011	BolC9t56535H	0	+	140	348	348	1.0000000
C9	30948303	30948651	BolC9t56536H	0	+	274	348	348	1.0000000
C9	30949945	30950293	BolC9t56537H	0	+	233	348	348	1.0000000
C9	30951586	30951934	BolC9t56538H	0	+	366	348	348	1.0000000
C9	30953230	30953578	BolC9t56539H	0	+	221	348	348	1.0000000
C9	30954876	30955224	BolC9t56540H	0	+	155	348	348	1.0000000
C9	30956744	30956870	BolC9t56541H	0	+	87	126	126	1.0000000
C9	30958168	30958516	BolC9t56542H	0	+	215	348	348	1.0000000
C9	30967593	30967719	BolC9t56543H	0	+	93	126	126	1.0000000
C9	30970692	30971040	BolC9t56544H	0	+	100	348	348	1.0000000
C9	30972334	30972682	BolC9t56545H	0	+	51	319	348	0.9166667
C9	30973976	30974324	BolC9t56546H	0	+	19	190	348	0.5459770
C9	30979129	30979255	BolC9t56547H	0	+	13	126	126	1.0000000
C9	30980551	30980899	BolC9t56548H	0	+	159	348	348	1.0000000
C9	30982195	30982543	BolC9t56549H	0	+	205	346	348	0.9942529
C9	30983841	30984189	BolC9t56550H	0	+	18	348	348	1.0000000
C9	30988776	30989154	BolC9t56551H	0	+	1	128	378	0.3386243
C9	30990420	30990768	BolC9t56552H	0	+	80	348	348	1.0000000
C9	30992064	30992412	BolC9t56553H	0	+	25	292	348	0.8390805
C9	30993708	30994056	BolC9t56554H	0	+	154	348	348	1.0000000
C9	30998640	30998988	BolC9t56555H	0	+	41	348	348	1.0000000
C9	31000010	31000349	BolC9t56556H	0	+	118	339	339	1.0000000
C9	31001654	31002002	BolC9t56557H	0	+	295	348	348	1.0000000
C9	31003298	31003646	BolC9t56558H	0	+	152	348	348	1.0000000
C9	31004937	31009653	BolC9t56559H	0	+	90	927	4716	0.1965649
C9	31012592	31012940	BolC9t56560H	0	+	35	281	348	0.8074713
C9	31014235	31014547	BolC9t56561H	0	+	0	0	312	0.0000000
C9	31017460	31017808	BolC9t56562H	0	+	86	348	348	1.0000000
C9	31019036	31019384	BolC9t56563H	0	+	125	348	348	1.0000000
C9	31020697	31021044	BolC9t56564H	0	+	1888	347	347	1.0000000
C9	31022278	31022626	BolC9t56565H	0	+	264	348	348	1.0000000
C9	31025319	31025667	BolC9t56566H	0	+	873	348	348	1.0000000
C9	31037712	31038065	BolC9t56567H	0	+	146	353	353	1.0000000
C9	31048764	31051184	BolC9t56568H	0	+	1538	2420	2420	1.0000000
C9	31054779	31055042	BolC9t56569H	0	+	222	263	263	1.0000000
C9	31062404	31063119	BolC9t56570H	0	+	442	715	715	1.0000000
C9	31067966	31069604	BolC9t56571H	0	+	42	804	1638	0.4908425
C9	31069834	31073826	BolC9t56572H	0	-	475	2300	3992	0.5761523
C9	31088230	31088647	BolC9t56573H	0	+	4	24	417	0.0575540
C9	31111608	31112948	BolC9t56574H	0	-	332	1340	1340	1.0000000
C9	31113737	31114815	BolC9t56575H	0	+	624	1078	1078	1.0000000
C9	31131557	31132465	BolC9t56576H	0	-	649	908	908	1.0000000
C9	31133806	31135054	BolC9t56577H	0	+	405	1248	1248	1.0000000
C9	31160901	31161273	BolC9t56578H	0	-	28	354	372	0.9516129
C9	31240315	31244764	BolC9t56579H	0	+	222	2308	4449	0.5187683
C9	31313285	31313558	BolC9t56580H	0	+	205	273	273	1.0000000
C9	31316408	31321489	BolC9t56581H	0	-	3258	5081	5081	1.0000000
C9	31322490	31327884	BolC9t56582H	0	-	2814	4453	5394	0.8255469
C9	31335519	31336317	BolC9t56583H	0	-	27	320	798	0.4010025
C9	31344295	31345749	BolC9t56584H	0	-	431	1429	1454	0.9828060
C9	31395031	31397639	BolC9t56585H	0	-	768	2549	2608	0.9773773
C9	31399765	31403406	BolC9t56586H	0	-	598	2877	3641	0.7901675
C9	31403853	31404477	BolC9t56587H	0	+	411	624	624	1.0000000
C9	31423409	31424990	BolC9t56588H	0	-	1759	1581	1581	1.0000000
C9	31438132	31440365	BolC9t56589H	0	+	1387	2233	2233	1.0000000
C9	31467862	31469475	BolC9t56590H	0	+	662	1613	1613	1.0000000
C9	31480452	31481214	BolC9t56591H	0	+	73	617	762	0.8097113
C9	31505590	31506295	BolC9t56592H	0	+	7	173	705	0.2453901
C9	31517751	31523427	BolC9t56593H	0	+	626	2935	5676	0.5170895
C9	31524190	31524691	BolC9t56594H	0	+	124	501	501	1.0000000
C9	31551447	31553331	BolC9t56595H	0	+	1363	1884	1884	1.0000000
C9	31555914	31557518	BolC9t56596H	0	+	845	1486	1604	0.9264339
C9	31599508	31599964	BolC9t56597H	0	+	323	456	456	1.0000000
C9	31603038	31603474	BolC9t56598H	0	+	413	436	436	1.0000000
C9	31607144	31607455	BolC9t56599H	0	-	96	311	311	1.0000000
C9	31608465	31609314	BolC9t56600H	0	-	665	849	849	1.0000000
C9	31614097	31614496	BolC9t56601H	0	-	517	399	399	1.0000000
C9	31635872	31636732	BolC9t56602H	0	+	813	860	860	1.0000000
C9	31647795	31649420	BolC9t56603H	0	-	518	1604	1625	0.9870769
C9	31660588	31661733	BolC9t56604H	0	-	714	1145	1145	1.0000000
C9	31695985	31696840	BolC9t56605H	0	-	167	855	855	1.0000000
C9	31697011	31697122	BolC9t56606H	0	-	52	111	111	1.0000000
C9	31697341	31697589	BolC9t56607H	0	-	426	248	248	1.0000000
C9	31697755	31698232	BolC9t56608H	0	-	419	477	477	1.0000000
C9	31707179	31708406	BolC9t56609H	0	-	542	1184	1227	0.9649552
C9	31720129	31721353	BolC9t56610H	0	+	149	597	1224	0.4877451
C9	31743196	31743471	BolC9t56611H	0	+	142	275	275	1.0000000
C9	31749278	31751883	BolC9t56612H	0	-	489	2235	2605	0.8579655
C9	31775596	31775972	BolC9t56613H	0	-	279	376	376	1.0000000
C9	31789174	31793409	BolC9t56614H	0	+	1258	4200	4235	0.9917355
C9	31804025	31804513	BolC9t56615H	0	+	641	488	488	1.0000000
C9	31811911	31812227	BolC9t56616H	0	-	1320	316	316	1.0000000
C9	31814149	31816088	BolC9t56617H	0	+	170	877	1939	0.4522950
C9	31817761	31818115	BolC9t56618H	0	-	22	345	354	0.9745763
C9	31819227	31819692	BolC9t56619H	0	+	262	465	465	1.0000000
C9	31822375	31823428	BolC9t56620H	0	-	28	148	1053	0.1405508
C9	31875946	31879991	BolC9t56621H	0	+	704	3596	4045	0.8889987
C9	31883106	31884861	BolC9t56622H	0	-	140	1681	1755	0.9578348
C9	31902176	31904295	BolC9t56623H	0	+	938	1981	2119	0.9348750
C9	31905011	31908169	BolC9t56624H	0	-	1507	2946	3158	0.9328689
C9	31946619	31947693	BolC9t56625H	0	+	19	461	1074	0.4292365
C9	31950209	31950461	BolC9t56626H	0	-	130	252	252	1.0000000
C9	31954092	31955733	BolC9t56627H	0	+	1191	1641	1641	1.0000000
C9	31962611	31962749	BolC9t56628H	0	+	151	138	138	1.0000000
C9	31976652	31978006	BolC9t56629H	0	-	358	1336	1354	0.9867061
C9	31995274	31996027	BolC9t56630H	0	+	85	730	753	0.9694555
C9	32007075	32007210	BolC9t56631H	0	-	97	135	135	1.0000000
C9	32014551	32014683	BolC9t56632H	0	-	36	132	132	1.0000000
C9	32024187	32024814	BolC9t56633H	0	-	12	331	627	0.5279107
C9	32037108	32037972	BolC9t56634H	0	+	482	864	864	1.0000000
C9	32068299	32079569	BolC9t56635H	0	-	3838	10114	11270	0.8974268
C9	32082457	32085306	BolC9t56636H	0	-	25	991	2849	0.3478414
C9	32090511	32090997	BolC9t56637H	0	-	160	486	486	1.0000000
C9	32095642	32095915	BolC9t56638H	0	-	217	273	273	1.0000000
C9	32100469	32100773	BolC9t56639H	0	-	15	225	304	0.7401316
C9	32115374	32117856	BolC9t56640H	0	+	483	2285	2482	0.9206285
C9	32123432	32124613	BolC9t56641H	0	-	140	1060	1181	0.8975444
C9	32131079	32131292	BolC9t56642H	0	+	162	213	213	1.0000000
C9	32133898	32134351	BolC9t56643H	0	+	323	453	453	1.0000000
C9	32134591	32136790	BolC9t56644H	0	-	1558	2199	2199	1.0000000
C9	32196032	32198943	BolC9t56645H	0	+	497	2627	2911	0.9024390
C9	32222219	32224174	BolC9t56646H	0	+	3655	1955	1955	1.0000000
C9	32229995	32230945	BolC9t56647H	0	+	34	459	950	0.4831579
C9	32318845	32319196	BolC9t56648H	0	-	241	351	351	1.0000000
C9	32319464	32319659	BolC9t56649H	0	-	242	195	195	1.0000000
C9	32329384	32336282	BolC9t56650H	0	+	1075	5510	6898	0.7987822
C9	32381813	32384285	BolC9t56651H	0	+	551	1885	2472	0.7625405
C9	32404263	32404494	BolC9t56652H	0	-	519	231	231	1.0000000
C9	32575646	32576123	BolC9t56653H	0	+	279	477	477	1.0000000
C9	32662095	32666090	BolC9t56654H	0	-	699	2836	3995	0.7098874
C9	32731644	32734668	BolC9t56655H	0	-	1141	2381	3024	0.7873677
C9	32867744	32868646	BolC9t56656H	0	+	236	902	902	1.0000000
C9	32870824	32871292	BolC9t56657H	0	-	256	460	468	0.9829060
C9	32947913	32948138	BolC9t56658H	0	+	200	225	225	1.0000000
C9	33209800	33209998	BolC9t56659H	0	-	14	198	198	1.0000000
C9	33229318	33232710	BolC9t56660H	0	+	241	3036	3392	0.8950472
C9	33302618	33303536	BolC9t56661H	0	+	662	918	918	1.0000000
C9	33325313	33326121	BolC9t56662H	0	+	655	808	808	1.0000000
C9	33328604	33331926	BolC9t56663H	0	-	861	2476	3322	0.7453341
C9	33334789	33335859	BolC9t56664H	0	+	832	1070	1070	1.0000000
C9	33339972	33340143	BolC9t56665H	0	+	101	171	171	1.0000000
C9	33341803	33343025	BolC9t56666H	0	-	701	1222	1222	1.0000000
C9	33342292	33342692	BolC9t56667H	0	+	207	400	400	1.0000000
C9	33352121	33353384	BolC9t56668H	0	+	722	1263	1263	1.0000000
C9	33354079	33354439	BolC9t56669H	0	+	198	360	360	1.0000000
C9	33356749	33357567	BolC9t56670H	0	+	72	789	818	0.9645477
C9	33358547	33360991	BolC9t56671H	0	-	4431	2444	2444	1.0000000
C9	33364342	33364804	BolC9t56672H	0	+	170	462	462	1.0000000
C9	33366653	33366836	BolC9t56673H	0	-	33	156	183	0.8524590
C9	33373715	33373871	BolC9t56674H	0	-	1	107	156	0.6858974
C9	33402929	33403301	BolC9t56675H	0	+	210	372	372	1.0000000
C9	33426289	33426610	BolC9t56676H	0	+	66	321	321	1.0000000
C9	33487361	33487847	BolC9t56677H	0	+	145	442	486	0.9094650
C9	33492095	33497938	BolC9t56678H	0	+	2221	4569	5843	0.7819613
C9	33514985	33517306	BolC9t56679H	0	+	1318	2321	2321	1.0000000
C9	33515499	33517531	BolC9t56680H	0	+	1059	2032	2032	1.0000000
C9	33518319	33519591	BolC9t56681H	0	+	1153	1272	1272	1.0000000
C9	33574503	33575084	BolC9t56682H	0	-	262	581	581	1.0000000
C9	33582492	33582810	BolC9t56683H	0	-	186	318	318	1.0000000
C9	33632233	33633372	BolC9t56684H	0	-	81	1139	1139	1.0000000
C9	33639698	33640596	BolC9t56685H	0	+	817	898	898	1.0000000
C9	33651859	33653886	BolC9t56686H	0	+	1391	2027	2027	1.0000000
C9	33664099	33666066	BolC9t56687H	0	+	938	1912	1967	0.9720386
C9	33668749	33669818	BolC9t56688H	0	-	470	1069	1069	1.0000000
C9	33679700	33680916	BolC9t56689H	0	-	8	254	1216	0.2088816
C9	33683341	33684517	BolC9t56690H	0	+	44	278	1176	0.2363946
C9	33697508	33698027	BolC9t56691H	0	-	321	519	519	1.0000000
C9	33700034	33703834	BolC9t56692H	0	-	1326	3800	3800	1.0000000
C9	33706193	33707134	BolC9t56693H	0	+	262	941	941	1.0000000
C9	33710733	33711144	BolC9t56694H	0	+	153	411	411	1.0000000
C9	33712773	33713690	BolC9t56695H	0	-	328	917	917	1.0000000
C9	33860888	33861059	BolC9t56696H	0	-	106	171	171	1.0000000
C9	33901989	33906720	BolC9t56697H	0	-	5478	4731	4731	1.0000000
C9	33916529	33922289	BolC9t56698H	0	+	6998	5760	5760	1.0000000
C9	33944119	33946783	BolC9t56699H	0	-	970	2664	2664	1.0000000
C9	33962430	33963252	BolC9t56700H	0	+	844	822	822	1.0000000
C9	33964303	33966252	BolC9t56701H	0	+	1117	1949	1949	1.0000000
C9	33966337	33966567	BolC9t56702H	0	+	200	230	230	1.0000000
C9	33967355	33967690	BolC9t56703H	0	-	188	335	335	1.0000000
C9	33977984	33984838	BolC9t56704H	0	-	6456	6854	6854	1.0000000
C9	33987026	33987161	BolC9t56705H	0	-	83	135	135	1.0000000
C9	33987612	33988094	BolC9t56706H	0	-	269	482	482	1.0000000
C9	34309966	34310212	BolC9t56707H	0	+	35	246	246	1.0000000
C9	34353818	34355087	BolC9t56708H	0	-	1822	1269	1269	1.0000000
C9	34372228	34382371	BolC9t56709H	0	-	4263	10143	10143	1.0000000
C9	34396574	34398129	BolC9t56710H	0	+	851	1555	1555	1.0000000
C9	34400861	34403889	BolC9t56711H	0	+	3631	3028	3028	1.0000000
C9	34472733	34472884	BolC9t56712H	0	-	82	151	151	1.0000000
C9	34472955	34473292	BolC9t56713H	0	-	184	337	337	1.0000000
C9	34555851	34559440	BolC9t56714H	0	+	5116	3589	3589	1.0000000
C9	34639542	34640595	BolC9t56715H	0	-	1430	1053	1053	1.0000000
C9	34641672	34641933	BolC9t56716H	0	-	453	261	261	1.0000000
C9	34664107	34665416	BolC9t56717H	0	-	1396	1309	1309	1.0000000
C9	34673187	34673517	BolC9t56718H	0	+	411	330	330	1.0000000
C9	34673858	34674166	BolC9t56719H	0	-	273	308	308	1.0000000
C9	34687620	34687722	BolC9t56720H	0	-	74	102	102	1.0000000
C9	34744019	34744424	BolC9t56721H	0	-	71	385	405	0.9506173
C9	34746934	34751382	BolC9t56722H	0	-	4809	4448	4448	1.0000000
C9	34801091	34804530	BolC9t56723H	0	+	4825	3439	3439	1.0000000
C9	34805245	34811677	BolC9t56724H	0	-	6129	6432	6432	1.0000000
C9	34818646	34820635	BolC9t56725H	0	-	2273	1989	1989	1.0000000
C9	34833071	34833495	BolC9t56726H	0	+	271	424	424	1.0000000
C9	34861359	34864621	BolC9t56727H	0	+	3918	3262	3262	1.0000000
C9	34942669	34944694	BolC9t56728H	0	+	1299	2025	2025	1.0000000
C9	34955501	34958042	BolC9t56729H	0	+	2656	2541	2541	1.0000000
C9	34963717	34964458	BolC9t56730H	0	+	405	741	741	1.0000000
C9	34965912	34966581	BolC9t56731H	0	+	422	669	669	1.0000000
C9	34978530	34979431	BolC9t56732H	0	-	703	901	901	1.0000000
C9	34985658	34988907	BolC9t56733H	0	+	3392	3249	3249	1.0000000
C9	34992455	34992680	BolC9t56734H	0	-	230	225	225	1.0000000
C9	35027919	35028081	BolC9t56735H	0	+	117	162	162	1.0000000
C9	35053064	35053361	BolC9t56736H	0	+	234	297	297	1.0000000
C9	35060471	35062409	BolC9t56737H	0	-	618	1936	1938	0.9989680
C9	35067285	35067453	BolC9t56738H	0	+	215	168	168	1.0000000
C9	35081416	35081755	BolC9t56739H	0	+	292	339	339	1.0000000
C9	35203166	35203505	BolC9t56740H	0	-	205	339	339	1.0000000
C9	35224330	35224547	BolC9t56741H	0	-	28	217	217	1.0000000
C9	35273777	35278052	BolC9t56742H	0	-	4219	4275	4275	1.0000000
C9	35289184	35291285	BolC9t56743H	0	+	728	1540	2101	0.7329843
C9	35298645	35305244	BolC9t56744H	0	-	1900	4802	6599	0.7276860
C9	35320259	35321008	BolC9t56745H	0	-	308	749	749	1.0000000
C9	35341937	35359954	BolC9t56746H	0	+	16583	17219	18017	0.9557085
C9	35379171	35379492	BolC9t56747H	0	+	202	321	321	1.0000000
C9	35399623	35401197	BolC9t56748H	0	-	443	1573	1574	0.9993647
C9	35414640	35415651	BolC9t56749H	0	+	1192	1011	1011	1.0000000
C9	35415937	35416312	BolC9t56750H	0	-	242	375	375	1.0000000
C9	35416487	35416802	BolC9t56751H	0	-	279	315	315	1.0000000
C9	35442626	35445590	BolC9t56752H	0	+	3420	2964	2964	1.0000000
C9	35449704	35450040	BolC9t56753H	0	+	55	336	336	1.0000000
C9	35450853	35451316	BolC9t56754H	0	-	23	420	463	0.9071274
C9	35457689	35465155	BolC9t56755H	0	-	4309	4840	7466	0.6482722
C9	35465245	35465701	BolC9t56756H	0	-	453	456	456	1.0000000
C9	35466519	35467268	BolC9t56757H	0	+	441	749	749	1.0000000
C9	35478523	35478886	BolC9t56758H	0	+	74	363	363	1.0000000
C9	35500158	35500781	BolC9t56759H	0	-	318	623	623	1.0000000
C9	35523222	35523507	BolC9t56760H	0	+	304	285	285	1.0000000
C9	35523638	35525948	BolC9t56761H	0	+	1955	2310	2310	1.0000000
C9	35527441	35528270	BolC9t56762H	0	+	40	320	829	0.3860072
C9	35530374	35532054	BolC9t56763H	0	-	1769	1680	1680	1.0000000
C9	35542446	35542923	BolC9t56764H	0	-	387	477	477	1.0000000
C9	35543771	35544125	BolC9t56765H	0	-	310	354	354	1.0000000
C9	35545248	35546212	BolC9t56766H	0	+	80	815	964	0.8454357
C9	35549391	35550493	BolC9t56767H	0	-	605	1102	1102	1.0000000
C9	35553153	35562059	BolC9t56768H	0	+	3739	8906	8906	1.0000000
C9	35565735	35566390	BolC9t56769H	0	+	518	655	655	1.0000000
C9	35576258	35576888	BolC9t56770H	0	-	455	630	630	1.0000000
C9	35577190	35578043	BolC9t56771H	0	-	511	853	853	1.0000000
C9	35600853	35601390	BolC9t56772H	0	+	388	537	537	1.0000000
C9	35638960	35639341	BolC9t56773H	0	+	202	381	381	1.0000000
C9	35681627	35681765	BolC9t56774H	0	-	141	138	138	1.0000000
C9	35687035	35687485	BolC9t56775H	0	-	254	450	450	1.0000000
C9	35689039	35691249	BolC9t56776H	0	+	1295	2210	2210	1.0000000
C9	35690566	35690974	BolC9t56777H	0	+	329	408	408	1.0000000
C9	35735473	35738346	BolC9t56778H	0	-	3560	2873	2873	1.0000000
C9	35742513	35743522	BolC9t56779H	0	-	627	1009	1009	1.0000000
C9	35745890	35747395	BolC9t56780H	0	-	749	1505	1505	1.0000000
C9	35747515	35747830	BolC9t56781H	0	-	248	315	315	1.0000000
C9	35801086	35801311	BolC9t56782H	0	-	368	225	225	1.0000000
C9	35811550	35811823	BolC9t56783H	0	+	195	273	273	1.0000000
C9	35905436	35906964	BolC9t56784H	0	-	825	1476	1528	0.9659686
C9	35911424	35913482	BolC9t56785H	0	-	40	785	2058	0.3814383
C9	35977319	35979527	BolC9t56786H	0	-	51	916	2208	0.4148551
C9	35979910	35980123	BolC9t56787H	0	-	136	213	213	1.0000000
C9	35982057	35982309	BolC9t56788H	0	+	84	252	252	1.0000000
C9	35983800	35984245	BolC9t56789H	0	-	222	445	445	1.0000000
C9	35985490	35987054	BolC9t56790H	0	-	385	1564	1564	1.0000000
C9	35988770	35991080	BolC9t56791H	0	-	773	2290	2310	0.9913420
C9	36087293	36088868	BolC9t56792H	0	-	87	1170	1575	0.7428572
C9	36092561	36094187	BolC9t56793H	0	+	29	887	1626	0.5455105
C9	36127178	36127481	BolC9t56794H	0	+	20	165	303	0.5445545
C9	36130921	36131119	BolC9t56795H	0	-	792	198	198	1.0000000
C9	36132604	36132802	BolC9t56796H	0	-	145	198	198	1.0000000
C9	36222372	36225385	BolC9t56797H	0	+	1669	2982	3013	0.9897112
C9	36238901	36241494	BolC9t56798H	0	-	178	1822	2593	0.7026610
C9	36255227	36255461	BolC9t56799H	0	+	646	234	234	1.0000000
C9	36258725	36259565	BolC9t56800H	0	+	953	840	840	1.0000000
C9	36262456	36264276	BolC9t56801H	0	+	172	1284	1820	0.7054945
C9	36271332	36274319	BolC9t56802H	0	+	425	2374	2987	0.7947774
C9	36272463	36272928	BolC9t56803H	0	+	82	436	465	0.9376344
C9	36274935	36278430	BolC9t56804H	0	-	2021	3493	3495	0.9994277
C9	36288542	36290391	BolC9t56805H	0	-	745	1849	1849	1.0000000
C9	36293359	36293639	BolC9t56806H	0	+	127	280	280	1.0000000
C9	36294566	36294692	BolC9t56807H	0	+	2	110	126	0.8730159
C9	36295990	36296158	BolC9t56808H	0	-	1	19	168	0.1130952
C9	36297343	36297502	BolC9t56809H	0	-	120	159	159	1.0000000
C9	36299036	36299758	BolC9t56810H	0	+	111	658	722	0.9113573
C9	36300518	36300842	BolC9t56811H	0	-	69	324	324	1.0000000
C9	36354660	36356179	BolC9t56812H	0	+	543	1519	1519	1.0000000
C9	36408411	36408624	BolC9t56813H	0	-	11	133	213	0.6244131
C9	36416217	36416547	BolC9t56814H	0	-	0	0	330	0.0000000
C9	36424635	36425862	BolC9t56815H	0	-	95	498	1227	0.4058680
C9	36429730	36430392	BolC9t56816H	0	-	36	454	662	0.6858006
C9	36433021	36433782	BolC9t56817H	0	-	56	560	761	0.7358739
C9	36444376	36445981	BolC9t56818H	0	-	1031	1605	1605	1.0000000
C9	36536433	36536716	BolC9t56819H	0	-	305	283	283	1.0000000
C9	36553646	36555513	BolC9t56820H	0	+	54	1134	1867	0.6073915
C9	36577288	36578818	BolC9t56821H	0	+	783	1530	1530	1.0000000
C9	36601635	36603080	BolC9t56822H	0	-	947	1445	1445	1.0000000
C9	36610398	36610776	BolC9t56823H	0	-	200	378	378	1.0000000
C9	36622032	36622357	BolC9t56824H	0	-	149	325	325	1.0000000
C9	36622420	36623522	BolC9t56825H	0	-	242	1102	1102	1.0000000
C9	36623749	36623851	BolC9t56826H	0	-	111	102	102	1.0000000
C9	36631731	36632226	BolC9t56827H	0	-	365	495	495	1.0000000
C9	36657227	36657413	BolC9t56828H	0	-	230	186	186	1.0000000
C9	36657537	36657657	BolC9t56829H	0	-	145	120	120	1.0000000
C9	36687464	36688982	BolC9t56830H	0	-	115	1128	1518	0.7430830
C9	36689691	36690395	BolC9t56831H	0	+	222	704	704	1.0000000
C9	36739581	36739958	BolC9t56832H	0	-	368	377	377	1.0000000
C9	36740417	36741476	BolC9t56833H	0	-	541	1059	1059	1.0000000
C9	36748958	36749904	BolC9t56834H	0	+	1066	946	946	1.0000000
C9	36755632	36757534	BolC9t56835H	0	-	1079	1902	1902	1.0000000
C9	36757988	36758318	BolC9t56836H	0	-	290	330	330	1.0000000
C9	36761711	36762935	BolC9t56837H	0	+	770	1224	1224	1.0000000
C9	36859348	36859702	BolC9t56838H	0	+	293	354	354	1.0000000
C9	36863936	36865730	BolC9t56839H	0	-	237	1249	1794	0.6962096
C9	36866748	36866985	BolC9t56840H	0	-	158	237	237	1.0000000
C9	36872118	36872322	BolC9t56841H	0	+	57	204	204	1.0000000
C9	36878587	36879170	BolC9t56842H	0	+	359	583	583	1.0000000
C9	36906516	36907572	BolC9t56843H	0	+	646	1056	1056	1.0000000
C9	36916388	36922789	BolC9t56844H	0	+	927	2901	6401	0.4532104
C9	36924323	36926184	BolC9t56845H	0	+	2047	1861	1861	1.0000000
C9	36926435	36926717	BolC9t56846H	0	+	558	282	282	1.0000000
C9	36929994	36931533	BolC9t56847H	0	+	2239	1539	1539	1.0000000
C9	36934298	36934517	BolC9t56848H	0	-	362	219	219	1.0000000
C9	36935017	36935932	BolC9t56849H	0	-	1153	915	915	1.0000000
C9	36947778	36949982	BolC9t56850H	0	+	522	1499	2204	0.6801270
C9	36951666	36951960	BolC9t56851H	0	-	195	294	294	1.0000000
C9	36985738	36985942	BolC9t56852H	0	-	208	204	204	1.0000000
C9	36989609	36990481	BolC9t56853H	0	+	321	872	872	1.0000000
C9	36994111	36994613	BolC9t56854H	0	-	187	502	502	1.0000000
C9	37008010	37010043	BolC9t56855H	0	+	986	2033	2033	1.0000000
C9	37012205	37014305	BolC9t56856H	0	+	698	2100	2100	1.0000000
C9	37039372	37068294	BolC9t56857H	0	-	10497	27977	28922	0.9673259
C9	37040571	37041851	BolC9t56858H	0	+	570	1280	1280	1.0000000
C9	37042497	37043745	BolC9t56859H	0	+	387	1248	1248	1.0000000
C9	37075907	37076603	BolC9t56860H	0	+	476	696	696	1.0000000
C9	37077393	37077660	BolC9t56861H	0	+	131	267	267	1.0000000
C9	37097159	37097306	BolC9t56862H	0	+	156	147	147	1.0000000
C9	37098021	37098144	BolC9t56863H	0	+	172	123	123	1.0000000
C9	37101718	37101895	BolC9t56864H	0	-	217	177	177	1.0000000
C9	37102192	37102345	BolC9t56865H	0	-	143	153	153	1.0000000
C9	37127444	37127615	BolC9t56866H	0	+	216	171	171	1.0000000
C9	37143296	37144237	BolC9t56867H	0	-	507	941	941	1.0000000
C9	37144772	37178856	BolC9t56868H	0	-	12577	34040	34084	0.9987091
C9	37150889	37152286	BolC9t56869H	0	-	928	1397	1397	1.0000000
C9	37158164	37159875	BolC9t56870H	0	+	369	1667	1711	0.9742841
C9	37161869	37162262	BolC9t56871H	0	-	126	393	393	1.0000000
C9	37178550	37179123	BolC9t56872H	0	-	260	573	573	1.0000000
C9	37184751	37184919	BolC9t56873H	0	+	156	168	168	1.0000000
C9	37220981	37221242	BolC9t56874H	0	-	138	261	261	1.0000000
C9	37257827	37261809	BolC9t56875H	0	+	2722	3982	3982	1.0000000
C9	37264995	37267064	BolC9t56876H	0	-	510	2057	2069	0.9942001
C9	37275800	37276044	BolC9t56877H	0	+	268	244	244	1.0000000
C9	37286973	37289101	BolC9t56878H	0	+	1144	2128	2128	1.0000000
C9	37291087	37294912	BolC9t56879H	0	-	1540	3648	3825	0.9537255
C9	37307345	37307971	BolC9t56880H	0	-	928	626	626	1.0000000
C9	37310308	37311900	BolC9t56881H	0	+	209	1331	1592	0.8360553
C9	37326940	37329075	BolC9t56882H	0	+	828	1867	2135	0.8744731
C9	37360272	37362546	BolC9t56883H	0	+	369	2038	2274	0.8962181
C9	37363054	37364710	BolC9t56884H	0	-	538	1624	1656	0.9806764
C9	37379670	37382015	BolC9t56885H	0	+	814	1851	2345	0.7893390
C9	37383175	37383838	BolC9t56886H	0	-	172	469	663	0.7073907
C9	37386763	37388031	BolC9t56887H	0	+	467	1069	1268	0.8430600
C9	37389149	37390396	BolC9t56888H	0	-	839	1247	1247	1.0000000
C9	37425991	37426378	BolC9t56889H	0	-	167	387	387	1.0000000
C9	37427371	37427655	BolC9t56890H	0	+	0	0	284	0.0000000
C9	37430685	37433232	BolC9t56891H	0	-	288	1986	2547	0.7797409
C9	37485650	37486195	BolC9t56892H	0	+	32	375	545	0.6880734
C9	37488982	37489822	BolC9t56893H	0	+	633	840	840	1.0000000
C9	37504100	37504662	BolC9t56894H	0	+	42	385	562	0.6850534
C9	37505368	37505755	BolC9t56895H	0	-	16	280	387	0.7235142
C9	37506260	37510761	BolC9t56896H	0	-	1623	4425	4501	0.9831148
C9	37536890	37537173	BolC9t56897H	0	-	901	283	283	1.0000000
C9	37539525	37540551	BolC9t56898H	0	-	316	1026	1026	1.0000000
C9	37562532	37563153	BolC9t56899H	0	+	0	0	621	0.0000000
C9	37569229	37569460	BolC9t56900H	0	-	427	231	231	1.0000000
C9	37579043	37583858	BolC9t56901H	0	-	1115	4461	4815	0.9264798
C9	37601790	37602114	BolC9t56902H	0	-	218	324	324	1.0000000
C9	37606927	37608959	BolC9t56903H	0	+	1829	2032	2032	1.0000000
C9	37658435	37658702	BolC9t56904H	0	+	133	267	267	1.0000000
C9	37685172	37685451	BolC9t56905H	0	+	68	263	279	0.9426523
C9	37685512	37685968	BolC9t56906H	0	+	7	270	456	0.5921053
C9	37688028	37688226	BolC9t56907H	0	+	543	198	198	1.0000000
C9	37690495	37690684	BolC9t56908H	0	+	0	0	189	0.0000000
C9	37691634	37691916	BolC9t56909H	0	-	0	0	282	0.0000000
C9	37695013	37696027	BolC9t56910H	0	-	11	389	1014	0.3836292
C9	37699771	37699999	BolC9t56911H	0	+	0	0	228	0.0000000
C9	37700138	37700723	BolC9t56912H	0	+	4	108	585	0.1846154
C9	37701325	37731353	BolC9t56913H	0	+	31873	20131	30028	0.6704076
C9	37702970	37731667	BolC9t56914H	0	+	31569	18889	28697	0.6582221
C9	37714020	37714575	BolC9t56915H	0	+	3358	555	555	1.0000000
C9	37716281	37716587	BolC9t56916H	0	+	29	157	306	0.5130719
C9	37719657	37719843	BolC9t56917H	0	+	0	0	186	0.0000000
C9	37720035	37720431	BolC9t56918H	0	-	215	396	396	1.0000000
C9	37722287	37723069	BolC9t56919H	0	+	23323	782	782	1.0000000
C9	37725000	37725447	BolC9t56920H	0	+	11	356	447	0.7964206
C9	37727970	37728462	BolC9t56921H	0	+	0	0	492	0.0000000
C9	37732272	37732803	BolC9t56922H	0	+	33	481	531	0.9058380
C9	37733059	37733365	BolC9t56923H	0	+	175	306	306	1.0000000
C9	37733611	37733818	BolC9t56924H	0	+	732	207	207	1.0000000
C9	37734031	37734196	BolC9t56925H	0	+	790	165	165	1.0000000
C9	37736176	37736422	BolC9t56926H	0	+	190	224	246	0.9105691
C9	37736631	37737279	BolC9t56927H	0	+	799	628	648	0.9691358
C9	37739945	37740500	BolC9t56928H	0	-	649	555	555	1.0000000
C9	37741373	37741532	BolC9t56929H	0	-	7	106	159	0.6666667
C9	37743979	37744663	BolC9t56930H	0	+	43	558	684	0.8157895
C9	37750981	37751155	BolC9t56931H	0	+	0	0	174	0.0000000
C9	37752148	37752280	BolC9t56932H	0	-	7	69	132	0.5227273
C9	37755519	37756530	BolC9t56933H	0	-	1	91	1011	0.0900099
C9	37757772	37757889	BolC9t56934H	0	-	3	65	117	0.5555556
C9	37758799	37758955	BolC9t56935H	0	-	91	6	156	0.0384615
C9	37760748	37761012	BolC9t56936H	0	-	23	264	264	1.0000000
C9	37764587	37764947	BolC9t56937H	0	-	2	56	360	0.1555556
C9	37768639	37768993	BolC9t56938H	0	-	31	278	354	0.7853107
C9	37831391	37834831	BolC9t56939H	0	-	1405	3331	3440	0.9683139
C9	37845882	37848030	BolC9t56940H	0	-	16	376	2148	0.1750465
C9	37932182	37932583	BolC9t56941H	0	-	323	401	401	1.0000000
C9	37945800	37948875	BolC9t56942H	0	+	472	2694	3075	0.8760976
C9	37961853	37963740	BolC9t56943H	0	+	649	1871	1887	0.9915209
C9	37969197	37971367	BolC9t56944H	0	+	515	2117	2170	0.9755760
C9	37973358	37973875	BolC9t56945H	0	-	87	517	517	1.0000000
C9	37979440	37979749	BolC9t56946H	0	-	227	309	309	1.0000000
C9	37980281	37981722	BolC9t56947H	0	-	512	1411	1441	0.9791811
C9	37991482	37991962	BolC9t56948H	0	-	62	381	480	0.7937500
C9	38003102	38004893	BolC9t56949H	0	-	901	1791	1791	1.0000000
C9	38012541	38013675	BolC9t56950H	0	+	202	1134	1134	1.0000000
C9	38014892	38018375	BolC9t56951H	0	-	2909	2906	3483	0.8343382
C9	38018638	38019215	BolC9t56952H	0	+	363	577	577	1.0000000
C9	38047651	38049608	BolC9t56953H	0	+	322	1876	1957	0.9586101
C9	38053140	38053482	BolC9t56954H	0	+	358	342	342	1.0000000
C9	38073987	38076449	BolC9t56955H	0	+	1789	2462	2462	1.0000000
C9	38076768	38078542	BolC9t56956H	0	-	328	1496	1774	0.8432920
C9	38083749	38084067	BolC9t56957H	0	-	53	248	318	0.7798742
C9	38100432	38102944	BolC9t56958H	0	-	550	1691	2512	0.6731688
C9	38110593	38112924	BolC9t56959H	0	+	1650	2310	2331	0.9909910
C9	38122243	38122775	BolC9t56960H	0	-	730	532	532	1.0000000
C9	38130203	38130437	BolC9t56961H	0	-	216	234	234	1.0000000
C9	38131385	38132431	BolC9t56962H	0	+	378	1046	1046	1.0000000
C9	38177782	38178970	BolC9t56963H	0	-	707	1188	1188	1.0000000
C9	38324605	38324995	BolC9t56964H	0	-	17	390	390	1.0000000
C9	38328947	38331167	BolC9t56965H	0	+	113	1537	2220	0.6923423
C9	38332065	38333004	BolC9t56966H	0	+	40	533	939	0.5676251
C9	38349809	38352657	BolC9t56967H	0	-	1255	2848	2848	1.0000000
C9	38355722	38356337	BolC9t56968H	0	+	53	373	615	0.6065041
C9	38375853	38380369	BolC9t56969H	0	-	389	2037	4516	0.4510629
C9	38384270	38384996	BolC9t56970H	0	+	344	726	726	1.0000000
C9	38396219	38396441	BolC9t56971H	0	-	134	222	222	1.0000000
C9	38407533	38407752	BolC9t56972H	0	+	0	0	219	0.0000000
C9	38417704	38419637	BolC9t56973H	0	-	177	1825	1933	0.9441283
C9	38423069	38425793	BolC9t56974H	0	+	355	2435	2724	0.8939060
C9	38443691	38446372	BolC9t56975H	0	-	996	2679	2681	0.9992540
C9	38455195	38455610	BolC9t56976H	0	-	0	0	415	0.0000000
C9	38477974	38478351	BolC9t56977H	0	-	152	377	377	1.0000000
C9	38479701	38479989	BolC9t56978H	0	-	70	288	288	1.0000000
C9	38480522	38480699	BolC9t56979H	0	+	153	177	177	1.0000000
C9	38504954	38507626	BolC9t56980H	0	-	1748	2672	2672	1.0000000
C9	38520914	38521334	BolC9t56981H	0	+	81	410	420	0.9761904
C9	38522569	38522855	BolC9t56982H	0	+	10	20	286	0.0699301
C9	38524332	38526370	BolC9t56983H	0	+	112	944	2038	0.4631992
C9	38533420	38536854	BolC9t56984H	0	+	514	3377	3434	0.9834013
C9	38550262	38551534	BolC9t56985H	0	+	622	1251	1272	0.9834906
C9	38552892	38557197	BolC9t56986H	0	+	1691	2834	4305	0.6583043
C9	38566313	38568404	BolC9t56987H	0	-	831	2063	2091	0.9866093
C9	38571940	38572812	BolC9t56988H	0	-	816	872	872	1.0000000
C9	38573473	38574506	BolC9t56989H	0	+	178	941	1033	0.9109390
C9	38603900	38605328	BolC9t56990H	0	-	988	1428	1428	1.0000000
C9	38639434	38639783	BolC9t56991H	0	+	33	212	349	0.6074498
C9	38644567	38645428	BolC9t56992H	0	+	526	839	861	0.9744483
C9	38652085	38653719	BolC9t56993H	0	+	491	1594	1634	0.9755202
C9	38655283	38655589	BolC9t56994H	0	-	332	306	306	1.0000000
C9	38666841	38667087	BolC9t56995H	0	+	250	246	246	1.0000000
C9	38670838	38673166	BolC9t56996H	0	+	245	1453	2328	0.6241409
C9	38726944	38727256	BolC9t56997H	0	+	237	312	312	1.0000000
C9	38728054	38729518	BolC9t56998H	0	+	140	1109	1464	0.7575136
C9	38751152	38754837	BolC9t56999H	0	+	353	1582	3685	0.4293080
C9	38774082	38774220	BolC9t57000H	0	+	42	138	138	1.0000000
C9	38807841	38812701	BolC9t57001H	0	+	3244	4860	4860	1.0000000
C9	38844562	38845956	BolC9t57002H	0	-	38	659	1394	0.4727403
C9	38858603	38858906	BolC9t57003H	0	+	130	303	303	1.0000000
C9	38863283	38863883	BolC9t57004H	0	-	554	600	600	1.0000000
C9	38898985	38903545	BolC9t57005H	0	-	1602	3726	4560	0.8171052
C9	38904202	38904454	BolC9t57006H	0	+	215	252	252	1.0000000
C9	38909836	38911258	BolC9t57007H	0	+	457	1386	1422	0.9746835
C9	38911857	38913647	BolC9t57008H	0	+	2146	1790	1790	1.0000000
C9	38930489	38932156	BolC9t57009H	0	+	666	1532	1667	0.9190162
C9	38945787	38948242	BolC9t57010H	0	-	1408	2425	2455	0.9877800
C9	38962725	38966819	BolC9t57011H	0	-	1097	3948	4094	0.9643381
C9	38971174	38971429	BolC9t57012H	0	+	150	255	255	1.0000000
C9	38978793	38979009	BolC9t57013H	0	+	397	216	216	1.0000000
C9	39002765	39003962	BolC9t57014H	0	+	490	1114	1197	0.9306600
C9	39004219	39005391	BolC9t57015H	0	-	7	197	1172	0.1680887
C9	39021444	39022278	BolC9t57016H	0	+	88	817	834	0.9796163
C9	39082280	39083925	BolC9t57017H	0	-	69	1143	1645	0.6948328
C9	39085322	39086067	BolC9t57018H	0	+	613	745	745	1.0000000
C9	39087911	39088816	BolC9t57019H	0	+	599	905	905	1.0000000
C9	39090812	39115290	BolC9t57020H	0	-	4376	13142	24478	0.5368903
C9	39090967	39092050	BolC9t57021H	0	-	35	374	1083	0.3453370
C9	39119034	39122434	BolC9t57022H	0	-	149	2465	3400	0.7250000
C9	39146999	39147278	BolC9t57023H	0	+	216	279	279	1.0000000
C9	39148542	39151874	BolC9t57024H	0	+	344	805	3332	0.2415966
C9	39149191	39149494	BolC9t57025H	0	-	0	0	303	0.0000000
C9	39154152	39155564	BolC9t57026H	0	+	378	1197	1412	0.8477337
C9	39157880	39158186	BolC9t57027H	0	-	283	306	306	1.0000000
C9	39161426	39164249	BolC9t57028H	0	-	202	1445	2823	0.5118668
C9	39164147	39166235	BolC9t57029H	0	-	407	1608	2088	0.7701150
C9	39170408	39171071	BolC9t57030H	0	-	246	547	663	0.8250377
C9	39177521	39178232	BolC9t57031H	0	-	189	424	711	0.5963432
C9	39188803	39189730	BolC9t57032H	0	+	448	927	927	1.0000000
C9	39231686	39232960	BolC9t57033H	0	+	917	1274	1274	1.0000000
C9	39239735	39240481	BolC9t57034H	0	-	19	639	746	0.8565683
C9	39253203	39255602	BolC9t57035H	0	-	930	2177	2399	0.9074615
C9	39256825	39257467	BolC9t57036H	0	-	374	587	642	0.9143302
C9	39264617	39265781	BolC9t57037H	0	-	329	1164	1164	1.0000000
C9	39265028	39266552	BolC9t57038H	0	-	373	1524	1524	1.0000000
C9	39266826	39267294	BolC9t57039H	0	-	305	468	468	1.0000000
C9	39268400	39268550	BolC9t57040H	0	-	158	150	150	1.0000000
C9	39281203	39281443	BolC9t57041H	0	+	24	233	240	0.9708334
C9	39303312	39306633	BolC9t57042H	0	-	717	2831	3321	0.8524541
C9	39319338	39322305	BolC9t57043H	0	+	498	2414	2967	0.8136165
C9	39322518	39323844	BolC9t57044H	0	-	199	1234	1326	0.9306184
C9	39338552	39338714	BolC9t57045H	0	+	115	162	162	1.0000000
C9	39338724	39338862	BolC9t57046H	0	+	58	126	138	0.9130435
C9	39340690	39341770	BolC9t57047H	0	-	3	121	1080	0.1120370
C9	39361541	39362525	BolC9t57048H	0	-	194	699	984	0.7103658
C9	39363804	39364822	BolC9t57049H	0	+	211	654	1018	0.6424361
C9	39365274	39365723	BolC9t57050H	0	-	144	449	449	1.0000000
C9	39366143	39366245	BolC9t57051H	0	-	184	102	102	1.0000000
C9	39387240	39387994	BolC9t57052H	0	-	395	754	754	1.0000000
C9	39422038	39423087	BolC9t57053H	0	+	127	814	1049	0.7759771
C9	39427730	39431050	BolC9t57054H	0	-	304	2180	3320	0.6566265
C9	39459193	39460051	BolC9t57055H	0	-	38	179	858	0.2086247
C9	39492366	39492633	BolC9t57056H	0	-	225	267	267	1.0000000
C9	39554986	39556734	BolC9t57057H	0	-	452	1629	1748	0.9319222
C9	39577815	39577998	BolC9t57058H	0	+	225	183	183	1.0000000
C9	39590458	39591028	BolC9t57059H	0	-	5	84	570	0.1473684
C9	39645203	39646537	BolC9t57060H	0	+	467	1205	1334	0.9032984
C9	39647124	39648433	BolC9t57061H	0	-	1231	1309	1309	1.0000000
C9	39650371	39650817	BolC9t57062H	0	+	155	446	446	1.0000000
C9	39659562	39660428	BolC9t57063H	0	+	176	551	866	0.6362587
C9	39660885	39662602	BolC9t57064H	0	-	389	1717	1717	1.0000000
C9	39700126	39700844	BolC9t57065H	0	-	225	718	718	1.0000000
C9	39710117	39710606	BolC9t57066H	0	-	410	489	489	1.0000000
C9	39739919	39740543	BolC9t57067H	0	+	8278	624	624	1.0000000
C9	39752126	39752489	BolC9t57068H	0	-	300	363	363	1.0000000
C9	39779178	39779334	BolC9t57069H	0	+	72	156	156	1.0000000
C9	39788963	39789351	BolC9t57070H	0	-	6	281	388	0.7242268
C9	39789625	39790058	BolC9t57071H	0	-	0	0	433	0.0000000
C9	39792256	39792671	BolC9t57072H	0	-	0	0	415	0.0000000
C9	39798874	39800114	BolC9t57073H	0	+	516	1239	1240	0.9991935
C9	39810198	39811952	BolC9t57074H	0	-	837	1754	1754	1.0000000
C9	39841719	39843576	BolC9t57075H	0	+	243	1114	1857	0.5998923
C9	39856981	39857262	BolC9t57076H	0	-	285	281	281	1.0000000
C9	39857542	39858261	BolC9t57077H	0	-	1364	719	719	1.0000000
C9	39886642	39889405	BolC9t57078H	0	+	1904	2730	2763	0.9880565
C9	39896325	39900481	BolC9t57079H	0	-	1511	3860	4156	0.9287777
C9	39901263	39901437	BolC9t57080H	0	-	0	0	174	0.0000000
C9	39915221	39915506	BolC9t57081H	0	-	310	285	285	1.0000000
C9	39965967	39966273	BolC9t57082H	0	+	126	306	306	1.0000000
C9	39973792	39976155	BolC9t57083H	0	+	461	2186	2363	0.9250952
C9	39995837	39996448	BolC9t57084H	0	-	185	611	611	1.0000000
C9	39998558	40000759	BolC9t57085H	0	+	225	2126	2201	0.9659246
C9	40020578	40052162	BolC9t57086H	0	+	2482	21654	31584	0.6856003
C9	40071819	40072587	BolC9t57087H	0	-	581	768	768	1.0000000
C9	40085967	40087836	BolC9t57088H	0	-	1574	1869	1869	1.0000000
C9	40101464	40102430	BolC9t57089H	0	+	1502	966	966	1.0000000
C9	40106711	40107517	BolC9t57090H	0	-	1241	806	806	1.0000000
C9	40123434	40123593	BolC9t57091H	0	+	1	121	159	0.7610063
C9	40126275	40126425	BolC9t57092H	0	-	230	150	150	1.0000000
C9	40132869	40140059	BolC9t57093H	0	-	3335	6594	7190	0.9171071
C9	40152653	40154429	BolC9t57094H	0	+	124	961	1776	0.5411036
C9	40187850	40188206	BolC9t57095H	0	-	471	356	356	1.0000000
C9	40189569	40192095	BolC9t57096H	0	+	1563	2440	2526	0.9659541
C9	40193033	40194403	BolC9t57097H	0	-	1088	1370	1370	1.0000000
C9	40195651	40197622	BolC9t57098H	0	-	1003	1922	1971	0.9751395
C9	40199693	40200448	BolC9t57099H	0	-	1696	755	755	1.0000000
C9	40222469	40222903	BolC9t57100H	0	-	7	133	434	0.3064516
C9	40223537	40223858	BolC9t57101H	0	-	7	231	321	0.7196262
C9	40236453	40237030	BolC9t57102H	0	+	78	573	577	0.9930676
C9	40246437	40246848	BolC9t57103H	0	+	64	384	411	0.9343066
C9	40254992	40255403	BolC9t57104H	0	+	0	0	411	0.0000000
C9	40300667	40304298	BolC9t57105H	0	+	438	3399	3631	0.9361057
C9	40305261	40305939	BolC9t57106H	0	+	0	0	678	0.0000000
C9	40307205	40307994	BolC9t57107H	0	-	12	327	789	0.4144487
C9	40309978	40310497	BolC9t57108H	0	-	2	57	519	0.1098266
C9	40310803	40311471	BolC9t57109H	0	-	8	220	668	0.3293413
C9	40312018	40313428	BolC9t57110H	0	+	297	1410	1410	1.0000000
C9	40313963	40315717	BolC9t57111H	0	-	0	0	1754	0.0000000
C9	40313980	40318234	BolC9t57112H	0	-	22	926	4254	0.2176775
C9	40319300	40319727	BolC9t57113H	0	+	335	427	427	1.0000000
C9	40326893	40327951	BolC9t57114H	0	+	645	1058	1058	1.0000000
C9	40329515	40329968	BolC9t57115H	0	-	322	453	453	1.0000000
C9	40330520	40331075	BolC9t57116H	0	-	397	555	555	1.0000000
C9	40331203	40333005	BolC9t57117H	0	-	1170	1802	1802	1.0000000
C9	40333143	40334823	BolC9t57118H	0	-	1477	1680	1680	1.0000000
C9	40338739	40341556	BolC9t57119H	0	-	39	915	2817	0.3248136
C9	40349341	40349813	BolC9t57120H	0	+	386	472	472	1.0000000
C9	40369824	40372000	BolC9t57121H	0	+	968	2124	2176	0.9761029
C9	40401126	40404392	BolC9t57122H	0	+	652	2474	3266	0.7575015
C9	40414053	40414442	BolC9t57123H	0	-	891	389	389	1.0000000
C9	40416583	40417462	BolC9t57124H	0	+	494	879	879	1.0000000
C9	40417598	40420256	BolC9t57125H	0	-	580	1442	2658	0.5425132
C9	40466114	40467202	BolC9t57126H	0	-	228	771	1088	0.7086397
C9	40479225	40481079	BolC9t57127H	0	-	601	1783	1854	0.9617044
C9	40487930	40488313	BolC9t57128H	0	+	174	383	383	1.0000000
C9	40491360	40491861	BolC9t57129H	0	-	500	501	501	1.0000000
C9	40497053	40497462	BolC9t57130H	0	+	539	409	409	1.0000000
C9	40501409	40503763	BolC9t57131H	0	-	745	2259	2354	0.9596432
C9	40549076	40550478	BolC9t57132H	0	+	79	788	1402	0.5620542
C9	40553466	40557970	BolC9t57133H	0	-	1170	4072	4504	0.9040853
C9	40562688	40563183	BolC9t57134H	0	+	992	495	495	1.0000000
C9	40578813	40579035	BolC9t57135H	0	+	229	222	222	1.0000000
C9	40614028	40614136	BolC9t57136H	0	-	39	108	108	1.0000000
C9	40617777	40623503	BolC9t57137H	0	-	2491	5603	5726	0.9785190
C9	40626228	40629550	BolC9t57138H	0	-	1966	3307	3322	0.9954847
C9	40687474	40688170	BolC9t57139H	0	-	84	505	696	0.7255747
C9	40690139	40690439	BolC9t57140H	0	-	371	300	300	1.0000000
C9	40775936	40781460	BolC9t57141H	0	-	144	2568	5524	0.4648805
C9	40781906	40784657	BolC9t57142H	0	+	1116	2718	2751	0.9880044
C9	40786290	40789342	BolC9t57143H	0	-	1783	2972	3052	0.9737877
C9	40789640	40790601	BolC9t57144H	0	+	395	953	961	0.9916753
C9	40791226	40792399	BolC9t57145H	0	-	552	1173	1173	1.0000000
C9	40792851	40793655	BolC9t57146H	0	+	302	804	804	1.0000000
C9	40794280	40796292	BolC9t57147H	0	-	849	1988	2012	0.9880716
C9	40799938	40802128	BolC9t57148H	0	+	96	1076	2190	0.4913242
C9	40813256	40814215	BolC9t57149H	0	+	128	445	959	0.4640250
C9	40815082	40815997	BolC9t57150H	0	-	248	788	915	0.8612022
C9	40826993	40827859	BolC9t57151H	0	-	198	731	866	0.8441108
C9	40828955	40831747	BolC9t57152H	0	-	846	2714	2792	0.9720631
C9	40845809	40848360	BolC9t57153H	0	+	306	2148	2551	0.8420227
C9	40856292	40857572	BolC9t57154H	0	+	368	1021	1280	0.7976562
C9	40862794	40886771	BolC9t57155H	0	+	5813	15555	23977	0.6487467
C9	40878246	40878698	BolC9t57156H	0	-	53	252	452	0.5575221
C9	40895505	40896420	BolC9t57157H	0	+	485	915	915	1.0000000
C9	40903392	40905558	BolC9t57158H	0	+	445	1933	2166	0.8924285
C9	40965469	40966566	BolC9t57159H	0	+	669	1057	1097	0.9635369
C9	40969150	40971280	BolC9t57160H	0	+	63	466	2130	0.2187793
C9	40973968	40975771	BolC9t57161H	0	-	414	1509	1803	0.8369384
C9	40981313	40988869	BolC9t57162H	0	+	1661	3933	7556	0.5205135
C9	40993313	40995809	BolC9t57163H	0	-	677	1828	2496	0.7323718
C9	41002610	41004199	BolC9t57164H	0	-	609	1445	1589	0.9093770
C9	41009711	41010616	BolC9t57165H	0	+	503	905	905	1.0000000
C9	41034859	41042349	BolC9t57166H	0	-	4664	7314	7490	0.9765020
C9	41044388	41044915	BolC9t57167H	0	-	83	486	527	0.9222012
C9	41079291	41080250	BolC9t57168H	0	+	33	444	959	0.4629823
C9	41085005	41085397	BolC9t57169H	0	-	246	392	392	1.0000000
C9	41105236	41107143	BolC9t57170H	0	+	1860	1907	1907	1.0000000
C9	41108190	41108636	BolC9t57171H	0	-	173	446	446	1.0000000
C9	41109747	41112725	BolC9t57172H	0	-	766	2788	2978	0.9361988
C9	41116189	41117981	BolC9t57173H	0	+	1342	1792	1792	1.0000000
C9	41119962	41120751	BolC9t57174H	0	+	322	789	789	1.0000000
C9	41190457	41191986	BolC9t57175H	0	-	895	1529	1529	1.0000000
C9	41197085	41197390	BolC9t57176H	0	+	16	234	305	0.7672131
C9	41201336	41201531	BolC9t57177H	0	+	322	195	195	1.0000000
C9	41210711	41211850	BolC9t57178H	0	+	418	1132	1139	0.9938543
C9	41216336	41218756	BolC9t57179H	0	-	2598	2420	2420	1.0000000
C9	41239617	41239920	BolC9t57180H	0	+	299	303	303	1.0000000
C9	41272962	41274048	BolC9t57181H	0	-	132	1086	1086	1.0000000
C9	41298971	41300393	BolC9t57182H	0	-	408	1393	1422	0.9796062
C9	41316078	41320191	BolC9t57183H	0	-	2457	4060	4113	0.9871140
C9	41321200	41324940	BolC9t57184H	0	-	755	3578	3740	0.9566845
C9	41394163	41396739	BolC9t57185H	0	-	1512	2552	2576	0.9906833
C9	41397631	41398601	BolC9t57186H	0	+	801	970	970	1.0000000
C9	41398981	41400059	BolC9t57187H	0	-	846	1078	1078	1.0000000
C9	41401151	41401418	BolC9t57188H	0	+	240	267	267	1.0000000
C9	41409931	41413137	BolC9t57189H	0	+	1073	3061	3206	0.9547723
C9	41415563	41416038	BolC9t57190H	0	-	4	257	475	0.5410526
C9	41423289	41424452	BolC9t57191H	0	+	657	1163	1163	1.0000000
C9	41424859	41427211	BolC9t57192H	0	-	1298	2332	2352	0.9914966
C9	41437221	41440722	BolC9t57193H	0	+	1583	3376	3501	0.9642959
C9	41441170	41443030	BolC9t57194H	0	-	178	1541	1860	0.8284946
C9	41480797	41482739	BolC9t57195H	0	-	0	0	1942	0.0000000
C9	41487161	41489105	BolC9t57196H	0	-	0	0	1944	0.0000000
C9	41512058	41512262	BolC9t57197H	0	+	210	204	204	1.0000000
C9	41516558	41516931	BolC9t57198H	0	-	434	373	373	1.0000000
C9	41531573	41532408	BolC9t57199H	0	+	0	0	835	0.0000000
C9	41532825	41534957	BolC9t57200H	0	-	446	1492	2132	0.6998124
C9	41542177	41542536	BolC9t57201H	0	-	2	115	359	0.3203343
C9	41559159	41559459	BolC9t57202H	0	+	35	300	300	1.0000000
C9	41563786	41564754	BolC9t57203H	0	+	670	968	968	1.0000000
C9	41584042	41585688	BolC9t57204H	0	+	707	1548	1646	0.9404618
C9	41587910	41588939	BolC9t57205H	0	+	622	1029	1029	1.0000000
C9	41590825	41592443	BolC9t57206H	0	-	531	1618	1618	1.0000000
C9	41623394	41630961	BolC9t57207H	0	-	1721	7504	7567	0.9916744
C9	41660003	41660246	BolC9t57208H	0	-	125	243	243	1.0000000
C9	41662885	41665043	BolC9t57209H	0	+	403	1923	2158	0.8911029
C9	41667902	41673178	BolC9t57210H	0	+	696	3994	5276	0.7570129
C9	41679954	41683019	BolC9t57211H	0	+	1537	2943	3065	0.9601958
C9	41684413	41687123	BolC9t57212H	0	+	35	210	2710	0.0774908
C9	41689239	41689404	BolC9t57213H	0	+	177	165	165	1.0000000
C9	41705518	41706224	BolC9t57214H	0	+	225	704	706	0.9971671
C9	41723951	41725057	BolC9t57215H	0	-	363	1056	1106	0.9547920
C9	41726537	41728724	BolC9t57216H	0	-	59	1057	2187	0.4833105
C9	41733702	41733906	BolC9t57217H	0	-	1	38	204	0.1862745
C9	41735218	41735326	BolC9t57218H	0	-	23	108	108	1.0000000
C9	41744490	41744837	BolC9t57219H	0	+	188	347	347	1.0000000
C9	41752177	41752713	BolC9t57220H	0	+	199	536	536	1.0000000
C9	41766546	41769784	BolC9t57221H	0	+	156	1588	3238	0.4904262
C9	41771207	41771590	BolC9t57222H	0	+	136	383	383	1.0000000
C9	41772218	41773476	BolC9t57223H	0	+	224	1086	1258	0.8632751
C9	41774124	41776498	BolC9t57224H	0	+	587	2202	2374	0.9275485
C9	41784298	41786618	BolC9t57225H	0	-	797	2020	2320	0.8706896
C9	41795872	41796956	BolC9t57226H	0	-	19	540	1084	0.4981550
C9	41817998	41819524	BolC9t57227H	0	-	257	1261	1526	0.8263434
C9	41830923	41831957	BolC9t57228H	0	+	657	1030	1034	0.9961315
C9	41856831	41857326	BolC9t57229H	0	+	57	393	495	0.7939394
C9	41857419	41860222	BolC9t57230H	0	+	619	1831	2803	0.6532287
C9	41870238	41870971	BolC9t57231H	0	+	230	733	733	1.0000000
C9	41871568	41873624	BolC9t57232H	0	-	1407	2056	2056	1.0000000
C9	41877081	41878585	BolC9t57233H	0	-	450	1252	1504	0.8324468
C9	41908081	41908671	BolC9t57234H	0	+	288	574	590	0.9728814
C9	41929162	41929849	BolC9t57235H	0	+	322	687	687	1.0000000
C9	41931721	41975884	BolC9t57236H	0	+	14630	33264	44163	0.7532097
C9	41970732	41971513	BolC9t57237H	0	-	2	155	781	0.1984635
C9	41972036	41973201	BolC9t57238H	0	-	24	796	1165	0.6832618
C9	41976710	41977255	BolC9t57239H	0	-	436	545	545	1.0000000
C9	41985705	41985861	BolC9t57240H	0	-	134	156	156	1.0000000
C9	41985899	41988029	BolC9t57241H	0	-	1253	2130	2130	1.0000000
C9	41988252	41988492	BolC9t57242H	0	-	13	116	240	0.4833333
C9	41993259	41993499	BolC9t57243H	0	-	30	56	240	0.2333333
C9	42008299	42008641	BolC9t57244H	0	-	186	342	342	1.0000000
C9	42010702	42010916	BolC9t57245H	0	-	62	214	214	1.0000000
C9	42011060	42016952	BolC9t57246H	0	-	1516	5280	5892	0.8961303
C9	42018732	42019281	BolC9t57247H	0	-	305	549	549	1.0000000
C9	42020107	42020854	BolC9t57248H	0	-	169	708	747	0.9477912
C9	42025247	42028770	BolC9t57249H	0	-	1519	3304	3523	0.9378371
C9	42057786	42058335	BolC9t57250H	0	+	519	549	549	1.0000000
C9	42058945	42059164	BolC9t57251H	0	-	4	204	219	0.9315069
C9	42077174	42077816	BolC9t57252H	0	-	45	519	642	0.8084112
C9	42095485	42096916	BolC9t57253H	0	+	875	1431	1431	1.0000000
C9	42110725	42111976	BolC9t57254H	0	+	490	1251	1251	1.0000000
C9	42114375	42116135	BolC9t57255H	0	+	2297	1760	1760	1.0000000
C9	42126207	42127272	BolC9t57256H	0	-	738	1065	1065	1.0000000
C9	42130583	42135291	BolC9t57257H	0	+	206	2326	4708	0.4940527
C9	42146618	42149377	BolC9t57258H	0	+	611	2511	2759	0.9101124
C9	42149707	42152507	BolC9t57259H	0	+	1710	2800	2800	1.0000000
C9	42158616	42159894	BolC9t57260H	0	+	1221	1278	1278	1.0000000
C9	42199546	42204082	BolC9t57261H	0	+	5146	4536	4536	1.0000000
C9	42205495	42210743	BolC9t57262H	0	+	1362	4919	5248	0.9373094
C9	42213365	42213734	BolC9t57263H	0	-	77	369	369	1.0000000
C9	42213898	42214423	BolC9t57264H	0	-	176	525	525	1.0000000
C9	42216070	42216447	BolC9t57265H	0	+	11	265	377	0.7029178
C9	42223444	42224176	BolC9t57266H	0	+	17	186	732	0.2540984
C9	42243286	42246325	BolC9t57267H	0	+	315	2044	3039	0.6725897
C9	42246695	42250402	BolC9t57268H	0	-	1577	3491	3707	0.9417319
C9	42277957	42280780	BolC9t57269H	0	+	1085	2730	2823	0.9670563
C9	42284973	42286066	BolC9t57270H	0	-	133	1009	1093	0.9231473
C9	42319527	42320505	BolC9t57271H	0	+	0	0	978	0.0000000
C9	42327907	42330940	BolC9t57272H	0	+	231	2356	3033	0.7767887
C9	42331120	42331950	BolC9t57273H	0	-	245	830	830	1.0000000
C9	42332283	42332769	BolC9t57274H	0	-	155	481	486	0.9897119
C9	42345602	42346289	BolC9t57275H	0	+	475	687	687	1.0000000
C9	42353243	42354259	BolC9t57276H	0	-	239	997	1016	0.9812992
C9	42366103	42366376	BolC9t57277H	0	+	3	173	273	0.6336997
C9	42367424	42367848	BolC9t57278H	0	+	1	2	424	0.0047170
C9	42368796	42369123	BolC9t57279H	0	+	8	186	327	0.5688074
C9	42372160	42373513	BolC9t57280H	0	-	168	678	1353	0.5011086
C9	42375578	42375884	BolC9t57281H	0	+	0	0	306	0.0000000
C9	42413597	42414391	BolC9t57282H	0	+	0	0	794	0.0000000
C9	42417414	42419136	BolC9t57283H	0	-	22	527	1722	0.3060395
C9	42444343	42445105	BolC9t57284H	0	-	289	697	762	0.9146982
C9	42445169	42445409	BolC9t57285H	0	-	16	234	240	0.9750000
C9	42458512	42459128	BolC9t57286H	0	-	132	616	616	1.0000000
C9	42468259	42469666	BolC9t57287H	0	-	126	753	1407	0.5351812
C9	42475689	42477271	BolC9t57288H	0	-	347	1051	1582	0.6643489
C9	42479932	42480649	BolC9t57289H	0	+	152	662	717	0.9232915
C9	42481789	42482300	BolC9t57290H	0	-	91	459	511	0.8982387
C9	42482920	42485096	BolC9t57291H	0	-	532	2036	2176	0.9356618
C9	42501525	42502784	BolC9t57292H	0	+	447	1221	1259	0.9698173
C9	42510776	42511967	BolC9t57293H	0	+	184	670	1191	0.5625525
C9	42523500	42523980	BolC9t57294H	0	-	7	170	480	0.3541667
C9	42539412	42540112	BolC9t57295H	0	-	23	402	700	0.5742857
C9	42544946	42546502	BolC9t57296H	0	-	22	526	1556	0.3380463
C9	42553623	42555743	BolC9t57297H	0	+	164	1268	2120	0.5981132
C9	42557137	42558144	BolC9t57298H	0	+	260	936	1007	0.9294935
C9	42563345	42563765	BolC9t57299H	0	+	2	32	420	0.0761905
C9	42576916	42577555	BolC9t57300H	0	+	18	283	639	0.4428795
C9	42579361	42580906	BolC9t57301H	0	+	285	1508	1545	0.9760518
C9	42581235	42581511	BolC9t57302H	0	-	200	276	276	1.0000000
C9	42592567	42593082	BolC9t57303H	0	-	514	485	515	0.9417475
C9	42603249	42604782	BolC9t57304H	0	-	193	1201	1533	0.7834312
C9	42637414	42638789	BolC9t57305H	0	+	7	163	1375	0.1185455
C9	42648543	42648735	BolC9t57306H	0	+	39	192	192	1.0000000
C9	42663033	42663273	BolC9t57307H	0	-	24	240	240	1.0000000
C9	42666394	42667449	BolC9t57308H	0	-	30	731	1055	0.6928910
C9	42689857	42690016	BolC9t57309H	0	+	39	159	159	1.0000000
C9	42694055	42694504	BolC9t57310H	0	+	6	167	449	0.3719376
C9	42695232	42695842	BolC9t57311H	0	-	187	459	610	0.7524590
C9	42722391	42722586	BolC9t57312H	0	-	8	130	195	0.6666667
C9	42724878	42725158	BolC9t57313H	0	+	5	232	280	0.8285714
C9	42725175	42729736	BolC9t57314H	0	+	636	2739	4561	0.6005262
C9	42728824	42729406	BolC9t57315H	0	+	462	564	582	0.9690722
C9	42731566	42733165	BolC9t57316H	0	-	323	1490	1599	0.9318324
C9	42737479	42737635	BolC9t57317H	0	+	0	0	156	0.0000000
C9	42758033	42762081	BolC9t57318H	0	+	1366	3533	4048	0.8727767
C9	42768362	42770225	BolC9t57319H	0	-	375	1245	1863	0.6682770
C9	42772560	42774158	BolC9t57320H	0	+	50	686	1598	0.4292866
C9	42775619	42776136	BolC9t57321H	0	-	8	390	517	0.7543520
C9	42776648	42777416	BolC9t57322H	0	-	205	752	768	0.9791667
C9	42778281	42781495	BolC9t57323H	0	-	403	2270	3214	0.7062850
C9	42804562	42805929	BolC9t57324H	0	-	500	1242	1367	0.9085589
C9	42813862	42819738	BolC9t57325H	0	-	1954	4847	5876	0.8248809
C9	42829748	42832173	BolC9t57326H	0	+	3766	2425	2425	1.0000000
C9	42832964	42833238	BolC9t57327H	0	-	350	274	274	1.0000000
C9	42836420	42836740	BolC9t57328H	0	-	277	320	320	1.0000000
C9	42836934	42837653	BolC9t57329H	0	-	1137	719	719	1.0000000
C9	42841124	42845321	BolC9t57330H	0	+	332	2466	4197	0.5875626
C9	42847932	42848900	BolC9t57331H	0	+	32	307	968	0.3171488
C9	42849106	42854970	BolC9t57332H	0	-	1533	4747	5864	0.8095157
C9	42870705	42871233	BolC9t57333H	0	-	207	525	528	0.9943182
C9	42877602	42878470	BolC9t57334H	0	+	72	676	868	0.7788019
C9	42882046	42882658	BolC9t57335H	0	+	112	612	612	1.0000000
C9	42884048	42884751	BolC9t57336H	0	+	627	703	703	1.0000000
C9	42885245	42885630	BolC9t57337H	0	+	2776	385	385	1.0000000
C9	42888837	42889200	BolC9t57338H	0	-	74	363	363	1.0000000
C9	42909680	42910517	BolC9t57339H	0	+	550	837	837	1.0000000
C9	42923856	42924912	BolC9t57340H	0	-	131	895	1056	0.8475379
C9	42932950	42937831	BolC9t57341H	0	-	1723	3948	4881	0.8088506
C9	42963272	42964465	BolC9t57342H	0	+	751	1193	1193	1.0000000
C9	42968789	42971357	BolC9t57343H	0	-	171	1476	2568	0.5747663
C9	42995678	42997357	BolC9t57344H	0	-	550	1675	1679	0.9976176
C9	42999887	43001583	BolC9t57345H	0	+	713	1589	1696	0.9369104
C9	43002272	43009436	BolC9t57346H	0	-	2658	4960	7164	0.6923506
C9	43021857	43022328	BolC9t57347H	0	+	454	393	471	0.8343949
C9	43025903	43026197	BolC9t57348H	0	+	0	0	294	0.0000000
C9	43028615	43029584	BolC9t57349H	0	-	4	398	969	0.4107327
C9	43032836	43033548	BolC9t57350H	0	-	558	712	712	1.0000000
C9	43043488	43043792	BolC9t57351H	0	+	200	304	304	1.0000000
C9	43044028	43044749	BolC9t57352H	0	+	233	721	721	1.0000000
C9	43054992	43055535	BolC9t57353H	0	-	618	543	543	1.0000000
C9	43058552	43060742	BolC9t57354H	0	+	203	1870	2190	0.8538813
C9	43075458	43075854	BolC9t57355H	0	+	69	259	396	0.6540404
C9	43089739	43091064	BolC9t57356H	0	+	125	799	1325	0.6030189
C9	43091417	43092312	BolC9t57357H	0	-	498	818	895	0.9139665
C9	43109570	43111026	BolC9t57358H	0	+	288	1048	1456	0.7197802
C9	43119252	43120856	BolC9t57359H	0	+	901	1449	1604	0.9033666
C9	43121726	43124190	BolC9t57360H	0	-	718	2340	2464	0.9496753
C9	43125841	43126203	BolC9t57361H	0	+	273	362	362	1.0000000
C9	43128115	43129357	BolC9t57362H	0	+	1022	1242	1242	1.0000000
C9	43137410	43143094	BolC9t57363H	0	+	1157	4125	5684	0.7257213
C9	43139047	43139401	BolC9t57364H	0	-	22	294	354	0.8305085
C9	43140668	43141244	BolC9t57365H	0	-	15	225	576	0.3906250
C9	43141933	43142303	BolC9t57366H	0	-	36	359	370	0.9702703
C9	43151002	43153007	BolC9t57367H	0	+	0	0	2005	0.0000000
C9	43161274	43161673	BolC9t57368H	0	+	0	0	399	0.0000000
C9	43163644	43164601	BolC9t57369H	0	-	0	0	957	0.0000000
C9	43168059	43170105	BolC9t57370H	0	+	666	1877	2046	0.9173998
C9	43170444	43171448	BolC9t57371H	0	+	476	992	1004	0.9880478
C9	43191546	43192803	BolC9t57372H	0	+	8291	1257	1257	1.0000000
C9	43192879	43193292	BolC9t57373H	0	-	1635	413	413	1.0000000
C9	43210604	43212726	BolC9t57374H	0	-	277	1138	2122	0.5362865
C9	43226185	43228100	BolC9t57375H	0	-	1216	1915	1915	1.0000000
C9	43247485	43248159	BolC9t57376H	0	+	328	674	674	1.0000000
C9	43248658	43251914	BolC9t57377H	0	-	1195	2836	3256	0.8710074
C9	43261475	43263861	BolC9t57378H	0	+	1298	2386	2386	1.0000000
C9	43279121	43279843	BolC9t57379H	0	+	87	543	722	0.7520776
C9	43282063	43282927	BolC9t57380H	0	-	281	864	864	1.0000000
C9	43288185	43288407	BolC9t57381H	0	-	55	102	222	0.4594595
C9	43304184	43308120	BolC9t57382H	0	+	528	3050	3936	0.7748984
C9	43323003	43324523	BolC9t57383H	0	+	1180	1520	1520	1.0000000
C9	43325001	43327642	BolC9t57384H	0	-	635	2378	2641	0.9004165
C9	43329716	43330110	BolC9t57385H	0	-	4	67	394	0.1700508
C9	43334439	43334553	BolC9t57386H	0	-	209	114	114	1.0000000
C9	43338060	43341012	BolC9t57387H	0	-	710	2818	2952	0.9546071
C9	43358300	43378283	BolC9t57388H	0	-	9701	15182	19983	0.7597458
C9	43363880	43364360	BolC9t57389H	0	-	153	374	480	0.7791666
C9	43373019	43376408	BolC9t57390H	0	+	2027	3207	3389	0.9462969
C9	43377093	43377818	BolC9t57391H	0	-	26	417	725	0.5751724
C9	43386440	43388685	BolC9t57392H	0	+	487	1502	2245	0.6690423
C9	43389850	43390309	BolC9t57393H	0	-	288	459	459	1.0000000
C9	43391870	43392638	BolC9t57394H	0	-	606	768	768	1.0000000
C9	43427188	43427451	BolC9t57395H	0	+	0	0	263	0.0000000
C9	43431337	43432463	BolC9t57396H	0	-	486	1126	1126	1.0000000
C9	43444429	43444789	BolC9t57397H	0	+	275	360	360	1.0000000
C9	43445301	43445721	BolC9t57398H	0	-	290	420	420	1.0000000
C9	43475895	43476726	BolC9t57399H	0	+	856	831	831	1.0000000
C9	43480582	43482544	BolC9t57400H	0	+	502	1637	1962	0.8343527
C9	43486130	43488005	BolC9t57401H	0	-	143	1521	1875	0.8112000
C9	43489163	43500606	BolC9t57402H	0	-	1492	7370	11443	0.6440619
C9	43506472	43506955	BolC9t57403H	0	-	72	483	483	1.0000000
C9	43511137	43511557	BolC9t57404H	0	+	79	420	420	1.0000000
C9	43544753	43545095	BolC9t57405H	0	+	0	0	342	0.0000000
C9	43549302	43549473	BolC9t57406H	0	-	0	0	171	0.0000000
C9	43549815	43549965	BolC9t57407H	0	-	6	21	150	0.1400000
C9	43553923	43555362	BolC9t57408H	0	-	100	605	1439	0.4204309
C9	43562014	43562863	BolC9t57409H	0	-	1646	849	849	1.0000000
C9	43564753	43565281	BolC9t57410H	0	-	29	76	528	0.1439394
C9	43571966	43574219	BolC9t57411H	0	+	525	1758	2253	0.7802929
C9	43577850	43580286	BolC9t57412H	0	+	216	1542	2436	0.6330049
C9	43580813	43583098	BolC9t57413H	0	+	561	1967	2285	0.8608315
C9	43583830	43586777	BolC9t57414H	0	-	139	1221	2947	0.4143196
C9	43589541	43590415	BolC9t57415H	0	-	79	613	874	0.7013730
C9	43595442	43595781	BolC9t57416H	0	-	32	300	339	0.8849558
C9	43607384	43609208	BolC9t57417H	0	-	132	1551	1824	0.8503289
C9	43614128	43616394	BolC9t57418H	0	+	721	2266	2266	1.0000000
C9	43617801	43618202	BolC9t57419H	0	+	102	382	401	0.9526185
C9	43618812	43619202	BolC9t57420H	0	+	128	390	390	1.0000000
C9	43620426	43621155	BolC9t57421H	0	+	48	729	729	1.0000000
C9	43622348	43622519	BolC9t57422H	0	+	109	171	171	1.0000000
C9	43630501	43631861	BolC9t57423H	0	-	450	1314	1360	0.9661765
C9	43643416	43644088	BolC9t57424H	0	-	61	413	672	0.6145833
C9	43647794	43648031	BolC9t57425H	0	-	91	237	237	1.0000000
C9	43659090	43659518	BolC9t57426H	0	+	450	428	428	1.0000000
C9	43662672	43663591	BolC9t57427H	0	+	109	840	919	0.9140370
C9	43668681	43669817	BolC9t57428H	0	+	423	1126	1136	0.9911972
C9	43670546	43672500	BolC9t57429H	0	-	1121	1746	1954	0.8935517
C9	43693569	43695841	BolC9t57430H	0	+	298	1853	2272	0.8155810
C9	43699206	43704945	BolC9t57431H	0	+	3826	5346	5739	0.9315212
C9	43718725	43726670	BolC9t57432H	0	+	2488	6501	7945	0.8182505
C9	43728203	43730300	BolC9t57433H	0	-	1612	2097	2097	1.0000000
C9	43732718	43734206	BolC9t57434H	0	-	286	1184	1488	0.7956989
C9	43740556	43741823	BolC9t57435H	0	-	725	1190	1267	0.9392265
C9	43754817	43755309	BolC9t57436H	0	+	6	186	492	0.3780488
C9	43759586	43759817	BolC9t57437H	0	+	75	227	231	0.9826840
C9	43760198	43762947	BolC9t57438H	0	-	1132	2459	2749	0.8945071
C9	43764255	43764378	BolC9t57439H	0	+	0	0	123	0.0000000
C9	43766215	43766661	BolC9t57440H	0	+	182	446	446	1.0000000
C9	43786142	43786606	BolC9t57441H	0	+	408	464	464	1.0000000
C9	43787561	43788538	BolC9t57442H	0	-	656	977	977	1.0000000
C9	43803435	43805223	BolC9t57443H	0	+	397	1476	1788	0.8255033
C9	43807589	43809268	BolC9t57444H	0	+	501	1637	1679	0.9749851
C9	43826328	43826597	BolC9t57445H	0	-	0	0	269	0.0000000
C9	43826544	43827220	BolC9t57446H	0	-	0	0	676	0.0000000
C9	43830941	43831401	BolC9t57447H	0	-	401	460	460	1.0000000
C9	43835441	43837126	BolC9t57448H	0	+	614	1685	1685	1.0000000
C9	43837511	43838154	BolC9t57449H	0	-	302	643	643	1.0000000
C9	43838714	43839668	BolC9t57450H	0	-	17	259	954	0.2714885
C9	43845034	43846225	BolC9t57451H	0	+	1409	1191	1191	1.0000000
C9	43846672	43847197	BolC9t57452H	0	+	185	525	525	1.0000000
C9	43847374	43854469	BolC9t57453H	0	+	3022	6439	7095	0.9075405
C9	43862193	43863465	BolC9t57454H	0	+	140	1066	1272	0.8380503
C9	43863995	43867954	BolC9t57455H	0	-	268	2101	3959	0.5306896
C9	43878855	43880514	BolC9t57456H	0	-	426	1502	1659	0.9053647
C9	43881046	43885007	BolC9t57457H	0	-	919	3478	3961	0.8780611
C9	43885497	43885743	BolC9t57458H	0	+	69	246	246	1.0000000
C9	43898983	43899127	BolC9t57459H	0	-	0	0	144	0.0000000
C9	43931876	43932980	BolC9t57460H	0	-	137	509	1104	0.4610507
C9	43938266	43938401	BolC9t57461H	0	+	211	115	135	0.8518519
C9	43938892	43939361	BolC9t57462H	0	+	793	469	469	1.0000000
C9	43945386	43945695	BolC9t57463H	0	-	2	6	309	0.0194175
C9	43972858	43973167	BolC9t57464H	0	+	15	102	309	0.3300971
C9	43977129	43978229	BolC9t57465H	0	+	550	1100	1100	1.0000000
C9	43982977	43983295	BolC9t57466H	0	-	239	318	318	1.0000000
C9	43983362	43984536	BolC9t57467H	0	-	635	1174	1174	1.0000000
C9	43984910	43987034	BolC9t57468H	0	-	1073	2123	2124	0.9995292
C9	43987613	43988338	BolC9t57469H	0	+	734	725	725	1.0000000
C9	43992015	43993035	BolC9t57470H	0	-	74	687	1020	0.6735294
C9	43995215	43996235	BolC9t57471H	0	-	403	930	1020	0.9117647
C9	44023318	44024353	BolC9t57472H	0	-	322	677	1035	0.6541063
C9	44030064	44030322	BolC9t57473H	0	-	270	258	258	1.0000000
C9	44055698	44055890	BolC9t57474H	0	+	1387	192	192	1.0000000
C9	44093601	44093802	BolC9t57475H	0	-	297	201	201	1.0000000
C9	44157005	44162061	BolC9t57476H	0	-	2029	4746	5056	0.9386867
C9	44213671	44214019	BolC9t57477H	0	+	9	57	348	0.1637931
C9	44230761	44230965	BolC9t57478H	0	+	364	204	204	1.0000000
C9	44231434	44234247	BolC9t57479H	0	-	1183	2559	2813	0.9097049
C9	44246002	44248023	BolC9t57480H	0	-	902	1985	2021	0.9821870
C9	44249361	44250350	BolC9t57481H	0	+	697	989	989	1.0000000
C9	44255486	44255981	BolC9t57482H	0	+	268	495	495	1.0000000
C9	44257895	44259399	BolC9t57483H	0	-	763	1504	1504	1.0000000
C9	44260599	44263087	BolC9t57484H	0	-	1518	2488	2488	1.0000000
C9	44265295	44266498	BolC9t57485H	0	+	223	1203	1203	1.0000000
C9	44267160	44271359	BolC9t57486H	0	-	459	3332	4199	0.7935222
C9	44279439	44280369	BolC9t57487H	0	-	160	930	930	1.0000000
C9	44293059	44293625	BolC9t57488H	0	+	129	549	566	0.9699647
C9	44301348	44302608	BolC9t57489H	0	-	217	956	1260	0.7587302
C9	44304218	44304575	BolC9t57490H	0	-	41	357	357	1.0000000
C9	44304721	44305407	BolC9t57491H	0	-	247	686	686	1.0000000
C9	44307994	44308183	BolC9t57492H	0	+	110	189	189	1.0000000
C9	44314429	44314849	BolC9t57493H	0	+	677	420	420	1.0000000
C9	44318149	44318386	BolC9t57494H	0	+	6	64	237	0.2700422
C9	44321163	44321571	BolC9t57495H	0	-	423	408	408	1.0000000
C9	44334964	44336446	BolC9t57496H	0	-	105	659	1482	0.4446694
C9	44362731	44363522	BolC9t57497H	0	-	313	768	791	0.9709229
C9	44364750	44365447	BolC9t57498H	0	-	32	485	697	0.6958393
C9	44370241	44370550	BolC9t57499H	0	-	55	309	309	1.0000000
C9	44376875	44377205	BolC9t57500H	0	+	58	227	330	0.6878788
C9	44388104	44388599	BolC9t57501H	0	-	111	433	495	0.8747475
C9	44405328	44405460	BolC9t57502H	0	-	109	132	132	1.0000000
C9	44437778	44439256	BolC9t57503H	0	-	2	126	1478	0.0852503
C9	44460688	44461116	BolC9t57504H	0	-	429	428	428	1.0000000
C9	44461311	44463909	BolC9t57505H	0	+	3083	2598	2598	1.0000000
C9	44473183	44474074	BolC9t57506H	0	-	12	200	891	0.2244669
C9	44482957	44483330	BolC9t57507H	0	+	5	53	373	0.1420912
C9	44489554	44491224	BolC9t57508H	0	+	744	1529	1670	0.9155689
C9	44491877	44494556	BolC9t57509H	0	-	2238	2679	2679	1.0000000
C9	44495185	44496933	BolC9t57510H	0	+	691	1585	1748	0.9067506
C9	44498339	44498645	BolC9t57511H	0	+	58	248	306	0.8104575
C9	44506955	44507195	BolC9t57512H	0	-	284	240	240	1.0000000
C9	44509831	44510974	BolC9t57513H	0	+	284	1107	1143	0.9685040
C9	44511406	44512225	BolC9t57514H	0	-	643	819	819	1.0000000
C9	44523767	44524599	BolC9t57515H	0	+	169	832	832	1.0000000
C9	44532137	44532287	BolC9t57516H	0	-	106	150	150	1.0000000
C9	44543305	44543803	BolC9t57517H	0	+	175	498	498	1.0000000
C9	44566761	44570274	BolC9t57518H	0	+	2360	3428	3513	0.9758042
C9	44571826	44573881	BolC9t57519H	0	-	447	1880	2055	0.9148418
C9	44576274	44578234	BolC9t57520H	0	-	495	1746	1960	0.8908163
C9	44586064	44586310	BolC9t57521H	0	-	86	195	246	0.7926829
C9	44603308	44605783	BolC9t57522H	0	-	442	2225	2475	0.8989899
C9	44606825	44607287	BolC9t57523H	0	-	230	462	462	1.0000000
C9	44608702	44610553	BolC9t57524H	0	-	672	1824	1851	0.9854133
C9	44612651	44613515	BolC9t57525H	0	+	15	463	864	0.5358796
C9	44617583	44619270	BolC9t57526H	0	-	298	1537	1687	0.9110848
C9	44627517	44630206	BolC9t57527H	0	+	914	2433	2689	0.9047973
C9	44631048	44634537	BolC9t57528H	0	+	1275	3468	3489	0.9939811
C9	44634641	44635394	BolC9t57529H	0	+	1077	753	753	1.0000000
C9	44637828	44647748	BolC9t57530H	0	-	721	4651	9920	0.4688508
C9	44648511	44649126	BolC9t57531H	0	-	0	0	615	0.0000000
C9	44651824	44652154	BolC9t57532H	0	+	195	330	330	1.0000000
C9	44653122	44659838	BolC9t57533H	0	+	1584	5335	6716	0.7943717
C9	44660215	44662239	BolC9t57534H	0	+	331	1616	2024	0.7984190
C9	44664061	44665748	BolC9t57535H	0	+	543	1687	1687	1.0000000
C9	44666081	44667657	BolC9t57536H	0	-	59	882	1576	0.5596447
C9	44673015	44676429	BolC9t57537H	0	-	671	2692	3414	0.7885179
C9	44677269	44678905	BolC9t57538H	0	-	467	1589	1636	0.9712714
C9	44679285	44681368	BolC9t57539H	0	-	821	2054	2083	0.9860778
C9	44684520	44685223	BolC9t57540H	0	+	405	703	703	1.0000000
C9	44714796	44716563	BolC9t57541H	0	-	182	1541	1767	0.8720996
C9	44731739	44733767	BolC9t57542H	0	+	249	1480	2028	0.7297831
C9	44739435	44740410	BolC9t57543H	0	+	196	911	975	0.9343590
C9	44777616	44778876	BolC9t57544H	0	+	320	1101	1260	0.8738095
C9	44790944	44791274	BolC9t57545H	0	+	353	330	330	1.0000000
C9	44799153	44799984	BolC9t57546H	0	+	617	828	831	0.9963899
C9	44802425	44803088	BolC9t57547H	0	+	511	663	663	1.0000000
C9	44803343	44803697	BolC9t57548H	0	-	297	354	354	1.0000000
C9	44812884	44813501	BolC9t57549H	0	+	57	214	617	0.3468395
C9	44815716	44816127	BolC9t57550H	0	+	3	22	411	0.0535280
C9	44844752	44845201	BolC9t57551H	0	-	3	144	449	0.3207127
C9	44850097	44852089	BolC9t57552H	0	-	366	1651	1992	0.8288153
C9	44854972	44855836	BolC9t57553H	0	-	34	429	864	0.4965278
C9	44867863	44868061	BolC9t57554H	0	-	11	119	198	0.6010101
C9	44875838	44875967	BolC9t57555H	0	-	56	129	129	1.0000000
C9	44877267	44877595	BolC9t57556H	0	-	5	133	328	0.4054878
C9	44901244	44902496	BolC9t57557H	0	+	842	1252	1252	1.0000000
C9	44903068	44903460	BolC9t57558H	0	-	325	381	392	0.9719388
C9	44910512	44910892	BolC9t57559H	0	+	388	380	380	1.0000000
C9	44911024	44911352	BolC9t57560H	0	+	270	328	328	1.0000000
C9	44913282	44913765	BolC9t57561H	0	-	104	474	483	0.9813665
C9	44914509	44915498	BolC9t57562H	0	-	306	935	989	0.9453994
C9	44932510	44935856	BolC9t57563H	0	+	505	2200	3346	0.6575015
C9	44940138	44940435	BolC9t57564H	0	+	110	297	297	1.0000000
C9	44942257	44944255	BolC9t57565H	0	+	281	1692	1998	0.8468468
C9	44944806	44947747	BolC9t57566H	0	-	2194	2921	2941	0.9931996
C9	44951833	44952112	BolC9t57567H	0	-	100	278	279	0.9964158
C9	44957599	44958445	BolC9t57568H	0	-	157	680	846	0.8037825
C9	44966363	44966954	BolC9t57569H	0	+	54	225	591	0.3807107
C9	44974193	44975156	BolC9t57570H	0	-	22	188	963	0.1952233
C9	44979485	44979743	BolC9t57571H	0	+	243	161	258	0.6240310
C9	44981600	44983333	BolC9t57572H	0	+	1529	1733	1733	1.0000000
C9	44984074	44989222	BolC9t57573H	0	+	2386	3692	5148	0.7171717
C9	44989672	44991527	BolC9t57574H	0	+	347	1634	1855	0.8808625
C9	44993938	44994994	BolC9t57575H	0	+	803	1056	1056	1.0000000
C9	44995024	44995859	BolC9t57576H	0	+	730	835	835	1.0000000
C9	44996945	45005621	BolC9t57577H	0	-	2525	4688	8676	0.5403412
C9	45036848	45037154	BolC9t57578H	0	+	385	306	306	1.0000000
C9	45037166	45037721	BolC9t57579H	0	+	450	555	555	1.0000000
C9	45040017	45048588	BolC9t57580H	0	+	1445	6987	8571	0.8151907
C9	45049477	45050455	BolC9t57581H	0	-	1530	978	978	1.0000000
C9	45063375	45064239	BolC9t57582H	0	+	14	21	864	0.0243056
C9	45069246	45070717	BolC9t57583H	0	+	394	484	1471	0.3290279
C9	45072955	45073657	BolC9t57584H	0	+	208	702	702	1.0000000
C9	45074386	45076567	BolC9t57585H	0	-	722	1965	2181	0.9009629
C9	45080343	45082853	BolC9t57586H	0	+	405	1997	2510	0.7956175
C9	45085205	45085738	BolC9t57587H	0	+	645	533	533	1.0000000
C9	45090261	45091239	BolC9t57588H	0	+	450	978	978	1.0000000
C9	45093120	45097238	BolC9t57589H	0	+	370	2846	4118	0.6911122
C9	45104784	45106527	BolC9t57590H	0	-	1193	1743	1743	1.0000000
C9	45112436	45116054	BolC9t57591H	0	-	356	3065	3618	0.8471531
C9	45116750	45117828	BolC9t57592H	0	+	30	481	1078	0.4461967
C9	45118222	45168075	BolC9t57593H	0	-	16751	37970	49853	0.7616392
C9	45119483	45120287	BolC9t57594H	0	+	4	268	804	0.3333333
C9	45143685	45146218	BolC9t57595H	0	+	3223	2533	2533	1.0000000
C9	45153722	45154388	BolC9t57596H	0	-	428	666	666	1.0000000
C9	45155172	45155783	BolC9t57597H	0	-	165	611	611	1.0000000
C9	45172022	45174144	BolC9t57598H	0	+	395	1868	2122	0.8803016
C9	45180364	45181771	BolC9t57599H	0	+	95	1015	1407	0.7213930
C9	45184507	45185444	BolC9t57600H	0	-	609	929	937	0.9914621
C9	45188272	45191188	BolC9t57601H	0	+	372	2616	2916	0.8971193
C9	45195760	45196339	BolC9t57602H	0	-	91	498	579	0.8601036
C9	45198405	45201777	BolC9t57603H	0	-	1203	3042	3372	0.9021353
C9	45207033	45207542	BolC9t57604H	0	-	134	509	509	1.0000000
C9	45208547	45210643	BolC9t57605H	0	+	1366	1193	2096	0.5691794
C9	45263388	45265333	BolC9t57606H	0	-	1074	1898	1945	0.9758355
C9	45272137	45272272	BolC9t57607H	0	-	400	135	135	1.0000000
C9	45287635	45289867	BolC9t57608H	0	+	317	1994	2232	0.8933692
C9	45290322	45292140	BolC9t57609H	0	-	1684	1818	1818	1.0000000
C9	45300157	45304861	BolC9t57610H	0	+	1483	3545	4704	0.7536139
C9	45329418	45330035	BolC9t57611H	0	-	295	617	617	1.0000000
C9	45336636	45337056	BolC9t57612H	0	-	93	420	420	1.0000000
C9	45343987	45346062	BolC9t57613H	0	-	40	850	2075	0.4096386
C9	45350869	45351253	BolC9t57614H	0	+	13	45	384	0.1171875
C9	45352309	45352523	BolC9t57615H	0	+	2	2	214	0.0093458
C9	45372393	45372612	BolC9t57616H	0	-	127	219	219	1.0000000
C9	45375746	45375914	BolC9t57617H	0	-	34	165	168	0.9821429
C9	45379774	45380227	BolC9t57618H	0	+	32	118	453	0.2604856
C9	45411027	45411327	BolC9t57619H	0	+	132	298	300	0.9933333
C9	45454649	45455456	BolC9t57620H	0	+	551	807	807	1.0000000
C9	45470987	45472274	BolC9t57621H	0	+	660	1287	1287	1.0000000
C9	45474187	45475231	BolC9t57622H	0	+	355	1044	1044	1.0000000
C9	45475972	45478748	BolC9t57623H	0	-	1320	2709	2776	0.9758645
C9	45479728	45483616	BolC9t57624H	0	-	2214	3459	3888	0.8896605
C9	45485138	45486266	BolC9t57625H	0	-	171	958	1128	0.8492908
C9	45492958	45494362	BolC9t57626H	0	-	31	246	1404	0.1752137
C9	45498201	45508244	BolC9t57627H	0	+	2420	6663	10043	0.6634472
C9	45521831	45522350	BolC9t57628H	0	+	119	518	519	0.9980732
C9	45532904	45533538	BolC9t57629H	0	-	2	207	634	0.3264984
C9	45537225	45537807	BolC9t57630H	0	-	5	309	582	0.5309278
C9	45540022	45540259	BolC9t57631H	0	+	2	19	237	0.0801688
C9	45552226	45552436	BolC9t57632H	0	-	0	0	210	0.0000000
C9	45558170	45563534	BolC9t57633H	0	-	221	2905	5364	0.5415735
C9	45587813	45592339	BolC9t57634H	0	-	540	2750	4526	0.6076005
C9	45603499	45606542	BolC9t57635H	0	-	369	2102	3043	0.6907657
C9	45608088	45609808	BolC9t57636H	0	+	18	326	1720	0.1895349
C9	45611496	45611717	BolC9t57637H	0	+	0	0	221	0.0000000
C9	45637042	45637222	BolC9t57638H	0	+	0	0	180	0.0000000
C9	45637860	45638746	BolC9t57639H	0	-	0	0	886	0.0000000
C9	45640097	45642105	BolC9t57640H	0	-	141	1019	2008	0.5074701
C9	45672600	45673329	BolC9t57641H	0	-	422	729	729	1.0000000
C9	45673795	45673897	BolC9t57642H	0	-	135	102	102	1.0000000
C9	45677148	45677601	BolC9t57643H	0	-	245	453	453	1.0000000
C9	45685104	45686301	BolC9t57644H	0	-	19	198	1197	0.1654135
C9	45689446	45689722	BolC9t57645H	0	+	207	276	276	1.0000000
C9	45702935	45705120	BolC9t57646H	0	+	299	1621	2185	0.7418764
C9	45707064	45709834	BolC9t57647H	0	+	63	1235	2770	0.4458484
C9	45710013	45710136	BolC9t57648H	0	+	28	123	123	1.0000000
C9	45712161	45713139	BolC9t57649H	0	+	311	934	978	0.9550102
C9	45726244	45726526	BolC9t57650H	0	-	0	0	282	0.0000000
C9	45729794	45731989	BolC9t57651H	0	+	635	2011	2195	0.9161731
C9	45733672	45735474	BolC9t57652H	0	+	1169	1719	1802	0.9539401
C9	45756589	45756928	BolC9t57653H	0	+	322	339	339	1.0000000
C9	45760110	45762111	BolC9t57654H	0	+	145	1195	2001	0.5972014
C9	45765469	45766227	BolC9t57655H	0	-	380	699	758	0.9221636
C9	45775522	45776173	BolC9t57656H	0	-	0	0	651	0.0000000
C9	45779164	45781928	BolC9t57657H	0	+	2431	2764	2764	1.0000000
C9	45792466	45794445	BolC9t57658H	0	+	832	1947	1979	0.9838302
C9	45795533	45797327	BolC9t57659H	0	+	6374	1794	1794	1.0000000
C9	45798655	45800585	BolC9t57660H	0	-	2120	1930	1930	1.0000000
C9	45802580	45802880	BolC9t57661H	0	+	235	300	300	1.0000000
C9	45810150	45812158	BolC9t57662H	0	-	164	1107	2008	0.5512948
C9	45813343	45813986	BolC9t57663H	0	-	5	376	643	0.5847589
C9	45818196	45820050	BolC9t57664H	0	+	844	1784	1854	0.9622438
C9	45823735	45823918	BolC9t57665H	0	+	15	120	183	0.6557377
C9	45832630	45832906	BolC9t57666H	0	-	283	276	276	1.0000000
C9	45878414	45880307	BolC9t57667H	0	+	2050	1893	1893	1.0000000
C9	45884442	45885996	BolC9t57668H	0	+	634	1554	1554	1.0000000
C9	45899317	45901147	BolC9t57669H	0	-	1230	1830	1830	1.0000000
C9	45907018	45908990	BolC9t57670H	0	+	451	1882	1972	0.9543611
C9	45909496	45910433	BolC9t57671H	0	-	373	915	937	0.9765208
C9	45910651	45912139	BolC9t57672H	0	+	432	1412	1488	0.9489247
C9	45912209	45915395	BolC9t57673H	0	-	569	2508	3186	0.7871940
C9	45928104	45930253	BolC9t57674H	0	+	390	1842	2149	0.8571429
C9	45938168	45939859	BolC9t57675H	0	+	1013	1691	1691	1.0000000
C9	45940116	45940794	BolC9t57676H	0	-	612	678	678	1.0000000
C9	45940910	45943150	BolC9t57677H	0	+	524	2125	2240	0.9486607
C9	45944314	45945120	BolC9t57678H	0	-	242	806	806	1.0000000
C9	45946727	45947949	BolC9t57679H	0	+	66	966	1222	0.7905074
C9	45948090	45953407	BolC9t57680H	0	-	627	3691	5317	0.6941885
C9	45953851	45960107	BolC9t57681H	0	-	1622	3420	6256	0.5466752
C9	45961010	45963464	BolC9t57682H	0	+	1426	2292	2454	0.9339854
C9	45964429	45965445	BolC9t57683H	0	-	372	1016	1016	1.0000000
C9	45965748	45967619	BolC9t57684H	0	-	1931	1828	1871	0.9770176
C9	45969790	45972529	BolC9t57685H	0	+	605	2626	2739	0.9587440
C9	45977178	45978759	BolC9t57686H	0	+	754	1581	1581	1.0000000
C9	45988872	45989354	BolC9t57687H	0	-	2	80	482	0.1659751
C9	46024291	46024738	BolC9t57688H	0	+	283	447	447	1.0000000
C9	46034188	46035585	BolC9t57689H	0	+	973	1397	1397	1.0000000
C9	46066972	46068645	BolC9t57690H	0	-	854	1673	1673	1.0000000
C9	46099292	46099772	BolC9t57691H	0	-	284	480	480	1.0000000
C9	46107592	46108180	BolC9t57692H	0	-	11	109	588	0.1853742
C9	46116236	46116707	BolC9t57693H	0	-	407	471	471	1.0000000
C9	46118395	46122845	BolC9t57694H	0	-	1925	4221	4450	0.9485393
C9	46145156	46148105	BolC9t57695H	0	-	945	2400	2949	0.8138352
C9	46159270	46160034	BolC9t57696H	0	+	642	741	764	0.9698953
C9	46161745	46162147	BolC9t57697H	0	+	211	402	402	1.0000000
C9	46163336	46163714	BolC9t57698H	0	+	229	368	378	0.9735450
C9	46177260	46177620	BolC9t57699H	0	+	28	273	360	0.7583333
C9	46196393	46196567	BolC9t57700H	0	-	37	174	174	1.0000000
C9	46200842	46203539	BolC9t57701H	0	+	586	2509	2697	0.9302929
C9	46210881	46211324	BolC9t57702H	0	-	450	443	443	1.0000000
C9	46212081	46212564	BolC9t57703H	0	+	1215	483	483	1.0000000
C9	46264713	46266786	BolC9t57704H	0	-	1388	2073	2073	1.0000000
C9	46266999	46267605	BolC9t57705H	0	-	443	606	606	1.0000000
C9	46323377	46324001	BolC9t57706H	0	+	418	624	624	1.0000000
C9	46353437	46356200	BolC9t57707H	0	-	88	911	2763	0.3297141
C9	46359929	46360181	BolC9t57708H	0	-	125	252	252	1.0000000
C9	46368856	46369182	BolC9t57709H	0	+	118	326	326	1.0000000
C9	46413554	46414544	BolC9t57710H	0	-	23	553	990	0.5585859
C9	46503913	46505555	BolC9t57711H	0	-	1144	1633	1642	0.9945189
C9	46514048	46514390	BolC9t57712H	0	-	316	342	342	1.0000000
C9	46519670	46522792	BolC9t57713H	0	+	807	2786	3122	0.8923767
C9	46523076	46523411	BolC9t57714H	0	+	0	0	335	0.0000000
C9	46523524	46524357	BolC9t57715H	0	+	0	0	833	0.0000000
C9	46530707	46531982	BolC9t57716H	0	+	390	1275	1275	1.0000000
C9	46533136	46535556	BolC9t57717H	0	+	1085	2347	2420	0.9698347
C9	46537875	46542584	BolC9t57718H	0	+	1981	4174	4709	0.8863878
C9	46543715	46544713	BolC9t57719H	0	-	523	904	998	0.9058116
C9	46549135	46549273	BolC9t57720H	0	+	19	86	138	0.6231884
C9	46566687	46568271	BolC9t57721H	0	+	529	1540	1584	0.9722222
C9	46569833	46570642	BolC9t57722H	0	+	626	809	809	1.0000000
C9	46575355	46577077	BolC9t57723H	0	+	119	1155	1722	0.6707317
C9	46587314	46592721	BolC9t57724H	0	+	3230	5386	5407	0.9961162
C9	46606394	46606695	BolC9t57725H	0	-	317	301	301	1.0000000
C9	46612526	46614090	BolC9t57726H	0	+	577	1564	1564	1.0000000
C9	46614305	46621578	BolC9t57727H	0	-	1614	5182	7273	0.7124983
C9	46633071	46633497	BolC9t57728H	0	-	77	426	426	1.0000000
C9	46636955	46638619	BolC9t57729H	0	-	1135	1664	1664	1.0000000
C9	46639557	46640724	BolC9t57730H	0	-	165	869	1167	0.7446444
C9	46640882	46641490	BolC9t57731H	0	-	153	608	608	1.0000000
C9	46643631	46645534	BolC9t57732H	0	+	1990	1448	1903	0.7609038
C9	46662536	46662740	BolC9t57733H	0	-	102	204	204	1.0000000
C9	46664825	46667282	BolC9t57734H	0	+	699	2332	2457	0.9491249
C9	46686944	46687323	BolC9t57735H	0	-	0	0	379	0.0000000
C9	46698582	46698870	BolC9t57736H	0	-	18	273	288	0.9479167
C9	46712285	46712599	BolC9t57737H	0	+	58	212	314	0.6751592
C9	46722788	46723028	BolC9t57738H	0	-	444	240	240	1.0000000
C9	46727689	46731751	BolC9t57739H	0	+	516	3442	4062	0.8473659
C9	46732674	46733455	BolC9t57740H	0	+	619	781	781	1.0000000
C9	46735371	46735609	BolC9t57741H	0	-	69	213	238	0.8949580
C9	46737336	46746931	BolC9t57742H	0	-	1467	7102	9595	0.7401772
C9	46760477	46760999	BolC9t57743H	0	+	300	522	522	1.0000000
C9	46762430	46762607	BolC9t57744H	0	+	112	164	177	0.9265537
C9	46768929	46771439	BolC9t57745H	0	+	0	0	2510	0.0000000
C9	46777784	46778095	BolC9t57746H	0	-	351	202	311	0.6495177
C9	46778722	46780598	BolC9t57747H	0	+	268	1481	1876	0.7894456
C9	46789377	46792780	BolC9t57748H	0	+	674	2886	3403	0.8480752
C9	46793368	46799782	BolC9t57749H	0	-	2278	5894	6414	0.9189274
C9	46804196	46806306	BolC9t57750H	0	+	1206	2015	2110	0.9549763
C9	46806745	46807462	BolC9t57751H	0	-	278	691	717	0.9637378
C9	46818769	46821126	BolC9t57752H	0	+	1250	2332	2357	0.9893933
C9	46821486	46826605	BolC9t57753H	0	-	2991	5041	5119	0.9847627
C9	46830176	46833177	BolC9t57754H	0	+	1233	2940	3001	0.9796734
C9	46834069	46836910	BolC9t57755H	0	-	832	2597	2841	0.9141148
C9	46863744	46863942	BolC9t57756H	0	+	126	197	198	0.9949495
C9	46873884	46876170	BolC9t57757H	0	+	446	2030	2286	0.8880140
C9	46888964	46890336	BolC9t57758H	0	+	934	1372	1372	1.0000000
C9	46919237	46921011	BolC9t57759H	0	+	966	1629	1774	0.9182638
C9	46921202	46924091	BolC9t57760H	0	-	1294	2889	2889	1.0000000
C9	46924957	46926961	BolC9t57761H	0	-	653	2004	2004	1.0000000
C9	46949211	46949770	BolC9t57762H	0	-	235	559	559	1.0000000
C9	46950149	46951928	BolC9t57763H	0	-	325	1445	1779	0.8122541
C9	46955375	46960091	BolC9t57764H	0	+	1006	3558	4716	0.7544529
C9	46960636	46992202	BolC9t57765H	0	-	13508	24548	31566	0.7776722
C9	46969644	46972181	BolC9t57766H	0	-	1510	2534	2537	0.9988175
C9	46979679	46980276	BolC9t57767H	0	+	1009	597	597	1.0000000
C9	46983058	46983411	BolC9t57768H	0	-	520	353	353	1.0000000
C9	46984970	46985324	BolC9t57769H	0	-	208	354	354	1.0000000
C9	46986673	46987462	BolC9t57770H	0	-	810	789	789	1.0000000
C9	46987565	46988630	BolC9t57771H	0	-	428	845	1065	0.7934272
C9	46992419	46994732	BolC9t57772H	0	+	1274	2307	2313	0.9974059
C9	47019022	47020139	BolC9t57773H	0	+	339	855	1117	0.7654431
C9	47022491	47024134	BolC9t57774H	0	-	1500	1643	1643	1.0000000
C9	47031643	47031853	BolC9t57775H	0	-	222	210	210	1.0000000
C9	47034278	47040193	BolC9t57776H	0	-	2174	5157	5915	0.8718512
C9	47044277	47047617	BolC9t57777H	0	+	191	2558	3340	0.7658682
C9	47064176	47064806	BolC9t57778H	0	+	804	630	630	1.0000000
C9	47066438	47067666	BolC9t57779H	0	-	377	986	1228	0.8029316
C9	47073315	47074242	BolC9t57780H	0	+	109	554	927	0.5976267
C9	47078050	47080393	BolC9t57781H	0	-	655	2267	2343	0.9675630
C9	47080805	47082713	BolC9t57782H	0	+	383	1521	1908	0.7971698
C9	47088601	47090140	BolC9t57783H	0	-	537	1417	1539	0.9207277
C9	47098128	47100279	BolC9t57784H	0	-	2385	2151	2151	1.0000000
C9	47101789	47103159	BolC9t57785H	0	-	239	1347	1370	0.9832117
C9	47130068	47130793	BolC9t57786H	0	+	251	509	725	0.7020690
C9	47132988	47133288	BolC9t57787H	0	-	0	0	300	0.0000000
C9	47162847	47164865	BolC9t57788H	0	+	917	979	2018	0.4851338
C9	47168656	47168893	BolC9t57789H	0	-	135	237	237	1.0000000
C9	47193581	47193902	BolC9t57790H	0	-	7	227	321	0.7071651
C9	47199874	47202476	BolC9t57791H	0	-	359	1667	2602	0.6406610
C9	47203829	47206963	BolC9t57792H	0	-	808	3134	3134	1.0000000
C9	47213125	47213266	BolC9t57793H	0	+	0	0	141	0.0000000
C9	47216879	47217272	BolC9t57794H	0	+	185	393	393	1.0000000
C9	47227690	47238157	BolC9t57795H	0	-	2788	6618	10467	0.6322728
C9	47243919	47244849	BolC9t57796H	0	-	74	371	930	0.3989247
C9	47260128	47261058	BolC9t57797H	0	-	42	525	930	0.5645161
C9	47262544	47265374	BolC9t57798H	0	-	1065	2646	2830	0.9349824
C9	47266242	47270359	BolC9t57799H	0	-	3006	4094	4117	0.9944134
C9	47273212	47273680	BolC9t57800H	0	-	1119	468	468	1.0000000
C9	47297609	47298624	BolC9t57801H	0	+	2	19	1015	0.0187192
C9	47312667	47314264	BolC9t57802H	0	+	947	1597	1597	1.0000000
C9	47326876	47327241	BolC9t57803H	0	+	54	365	365	1.0000000
C9	47340228	47342156	BolC9t57804H	0	-	165	1232	1928	0.6390042
C9	47354261	47354888	BolC9t57805H	0	+	137	361	627	0.5757576
C9	47358143	47361005	BolC9t57806H	0	+	1633	2709	2862	0.9465409
C9	47376922	47377150	BolC9t57807H	0	+	0	0	228	0.0000000
C9	47379506	47380018	BolC9t57808H	0	-	0	0	512	0.0000000
C9	47391247	47392400	BolC9t57809H	0	+	180	959	1153	0.8317433
C9	47398878	47401743	BolC9t57810H	0	-	523	1709	2865	0.5965096
C9	47409667	47410111	BolC9t57811H	0	-	30	280	444	0.6306306
C9	47456430	47457351	BolC9t57812H	0	+	0	0	921	0.0000000
C9	47471029	47474097	BolC9t57813H	0	+	286	2142	3068	0.6981747
C9	47483128	47484067	BolC9t57814H	0	-	235	669	939	0.7124600
C9	47501883	47504027	BolC9t57815H	0	-	398	1881	2144	0.8773321
C9	47512385	47512908	BolC9t57816H	0	+	157	186	523	0.3556405
C9	47517417	47520003	BolC9t57817H	0	-	263	1997	2586	0.7722351
C9	47528647	47529142	BolC9t57818H	0	-	16	119	495	0.2404040
C9	47540769	47540991	BolC9t57819H	0	-	35	207	222	0.9324324
C9	47547029	47548221	BolC9t57820H	0	-	807	1189	1192	0.9974832
C9	47575402	47578619	BolC9t57821H	0	+	1013	2323	3217	0.7221013
C9	47579107	47580427	BolC9t57822H	0	-	193	846	1320	0.6409091
C9	47584195	47584745	BolC9t57823H	0	+	31	532	550	0.9672727
C9	47584960	47586933	BolC9t57824H	0	-	771	1973	1973	1.0000000
C9	47587309	47588160	BolC9t57825H	0	+	229	634	851	0.7450058
C9	47588739	47588841	BolC9t57826H	0	+	206	102	102	1.0000000
C9	47599914	47603955	BolC9t57827H	0	+	1056	3017	4041	0.7465973
C9	47604212	47605376	BolC9t57828H	0	-	146	971	1164	0.8341925
C9	47605688	47606874	BolC9t57829H	0	-	660	1050	1186	0.8853288
C9	47609995	47611238	BolC9t57830H	0	+	727	1243	1243	1.0000000
C9	47612399	47616264	BolC9t57831H	0	-	1090	3669	3865	0.9492885
C9	47620117	47622376	BolC9t57832H	0	+	674	2096	2259	0.9278442
C9	47653588	47656127	BolC9t57833H	0	+	565	2139	2539	0.8424577
C9	47663898	47664181	BolC9t57834H	0	+	255	283	283	1.0000000
C9	47666082	47667360	BolC9t57835H	0	-	239	1146	1278	0.8967136
C9	47668492	47669647	BolC9t57836H	0	+	362	1101	1155	0.9532468
C9	47669746	47670896	BolC9t57837H	0	+	167	841	1150	0.7313043
C9	47671712	47673752	BolC9t57838H	0	+	523	1696	2040	0.8313726
C9	47677860	47678928	BolC9t57839H	0	+	202	993	1068	0.9297753
C9	47687774	47688529	BolC9t57840H	0	-	5	35	755	0.0463576
C9	47687927	47688353	BolC9t57841H	0	-	0	0	426	0.0000000
C9	47704463	47704817	BolC9t57842H	0	+	0	0	354	0.0000000
C9	47721001	47721865	BolC9t57843H	0	-	0	0	864	0.0000000
C9	47725797	47726190	BolC9t57844H	0	-	0	0	393	0.0000000
C9	47741387	47741740	BolC9t57845H	0	+	0	0	353	0.0000000
C9	47755693	47758168	BolC9t57846H	0	-	1979	2475	2475	1.0000000
C9	47760722	47763306	BolC9t57847H	0	-	193	1171	2584	0.4531734
C9	47767870	47768175	BolC9t57848H	0	-	99	227	305	0.7442623
C9	47768646	47773338	BolC9t57849H	0	+	1496	3730	4692	0.7949702
C9	47774015	47777651	BolC9t57850H	0	-	713	2556	3636	0.7029703
C9	47778336	47779812	BolC9t57851H	0	+	612	1420	1476	0.9620596
C9	47780212	47780848	BolC9t57852H	0	-	236	636	636	1.0000000
C9	47783545	47785544	BolC9t57853H	0	-	718	1855	1999	0.9279640
C9	47789700	47796472	BolC9t57854H	0	+	1653	5626	6772	0.8307738
C9	47796940	47798017	BolC9t57855H	0	+	390	1077	1077	1.0000000
C9	47798338	47800694	BolC9t57856H	0	-	691	2312	2356	0.9813243
C9	47801638	47806376	BolC9t57857H	0	+	2801	4626	4738	0.9763613
C9	47807501	47813349	BolC9t57858H	0	+	2223	5179	5848	0.8856019
C9	47814801	47815056	BolC9t57859H	0	-	177	255	255	1.0000000
C9	47816332	47818126	BolC9t57860H	0	+	677	1478	1794	0.8238573
C9	47818445	47819321	BolC9t57861H	0	-	458	876	876	1.0000000
C9	47819541	47820333	BolC9t57862H	0	+	556	792	792	1.0000000
C9	47828438	47838117	BolC9t57863H	0	+	1813	4065	9679	0.4199814
C9	47838576	47840003	BolC9t57864H	0	-	1093	1427	1427	1.0000000
C9	47844904	47847030	BolC9t57865H	0	-	141	782	2126	0.3678269
C9	47847934	47849194	BolC9t57866H	0	+	161	920	1260	0.7301587
C9	47862493	47862760	BolC9t57867H	0	+	22	228	267	0.8539326
C9	47867184	47868657	BolC9t57868H	0	+	89	534	1473	0.3625255
C9	47870627	47871395	BolC9t57869H	0	-	0	0	768	0.0000000
C9	47882041	47882880	BolC9t57870H	0	-	11	331	839	0.3945173
C9	47891537	47894817	BolC9t57871H	0	+	101	1003	3280	0.3057927
C9	47933400	47933823	BolC9t57872H	0	+	436	423	423	1.0000000
C9	47936444	47937423	BolC9t57873H	0	+	204	900	979	0.9193054
C9	47961213	47962515	BolC9t57874H	0	-	0	0	1302	0.0000000
C9	47974784	47976817	BolC9t57875H	0	+	708	1686	2033	0.8293163
C9	47979931	47981692	BolC9t57876H	0	+	505	1761	1761	1.0000000
C9	47982055	47984227	BolC9t57877H	0	-	854	1998	2172	0.9198895
C9	47984558	47986178	BolC9t57878H	0	+	442	1548	1620	0.9555556
C9	47987364	47989500	BolC9t57879H	0	+	488	1975	2136	0.9246255
C9	47989616	47990657	BolC9t57880H	0	-	274	952	1041	0.9145053
C9	47991842	47994124	BolC9t57881H	0	+	508	2149	2282	0.9417178
C9	47994792	47995130	BolC9t57882H	0	+	33	267	338	0.7899408
C9	47995493	47996882	BolC9t57883H	0	-	294	1205	1389	0.8675306
C9	48007760	48008151	BolC9t57884H	0	+	324	391	391	1.0000000
C9	48018738	48026072	BolC9t57885H	0	+	951	3737	7334	0.5095446
C9	48026366	48028848	BolC9t57886H	0	+	1012	2376	2482	0.9572925
C9	48029553	48031969	BolC9t57887H	0	-	241	1586	2416	0.6564569
C9	48032436	48037287	BolC9t57888H	0	+	588	4233	4851	0.8726036
C9	48037434	48038171	BolC9t57889H	0	-	67	737	737	1.0000000
C9	48038944	48041698	BolC9t57890H	0	-	172	1732	2754	0.6289034
C9	48054148	48054330	BolC9t57891H	0	-	36	182	182	1.0000000
C9	48059819	48062007	BolC9t57892H	0	-	648	2070	2188	0.9460695
C9	48062410	48064011	BolC9t57893H	0	-	253	1249	1601	0.7801374
C9	48064218	48065699	BolC9t57894H	0	+	317	1209	1481	0.8163403
C9	48066804	48067365	BolC9t57895H	0	-	96	479	561	0.8538324
C9	48079872	48083042	BolC9t57896H	0	-	531	2828	3170	0.8921136
C9	48084889	48101593	BolC9t57897H	0	-	2192	9705	16704	0.5809985
C9	48091115	48092654	BolC9t57898H	0	-	0	0	1539	0.0000000
C9	48103989	48104151	BolC9t57899H	0	-	168	162	162	1.0000000
C9	48107867	48108647	BolC9t57900H	0	+	538	779	780	0.9987180
C9	48109660	48110206	BolC9t57901H	0	-	124	401	546	0.7344322
C9	48114740	48114992	BolC9t57902H	0	+	18	202	252	0.8015873
C9	48117254	48123169	BolC9t57903H	0	-	562	2789	5915	0.4715131
C9	48143387	48144246	BolC9t57904H	0	-	4	262	859	0.3050058
C9	48148088	48148925	BolC9t57905H	0	+	72	625	837	0.7467145
C9	48153105	48154681	BolC9t57906H	0	+	45	1057	1576	0.6706853
C9	48157809	48158551	BolC9t57907H	0	-	6	152	742	0.2048517
C9	48158378	48158709	BolC9t57908H	0	-	0	0	331	0.0000000
C9	48162647	48164359	BolC9t57909H	0	+	519	1531	1712	0.8942757
C9	48164994	48168537	BolC9t57910H	0	-	410	3194	3543	0.9014959
C9	48172939	48174683	BolC9t57911H	0	+	1093	1744	1744	1.0000000
C9	48174895	48175171	BolC9t57912H	0	-	37	276	276	1.0000000
C9	48179303	48180257	BolC9t57913H	0	-	766	954	954	1.0000000
C9	48182836	48183346	BolC9t57914H	0	+	439	510	510	1.0000000
C9	48192235	48192598	BolC9t57915H	0	-	282	363	363	1.0000000
C9	48208446	48208854	BolC9t57916H	0	-	219	408	408	1.0000000
C9	48222053	48223421	BolC9t57917H	0	-	556	1289	1368	0.9422514
C9	48233428	48237680	BolC9t57918H	0	-	1937	3817	4252	0.8976952
C9	48241007	48241533	BolC9t57919H	0	-	38	507	526	0.9638783
C9	48264069	48265809	BolC9t57920H	0	+	449	1740	1740	1.0000000
C9	48266225	48267390	BolC9t57921H	0	-	456	1165	1165	1.0000000
C9	48272547	48273777	BolC9t57922H	0	+	398	1047	1230	0.8512195
C9	48274164	48274474	BolC9t57923H	0	-	49	287	310	0.9258065
C9	48276577	48302043	BolC9t57924H	0	+	8299	20787	25466	0.8162648
C9	48297310	48298246	BolC9t57925H	0	-	249	936	936	1.0000000
C9	48302895	48305388	BolC9t57926H	0	-	282	1418	2493	0.5687926
C9	48309672	48312348	BolC9t57927H	0	-	484	2465	2676	0.9211510
C9	48313360	48315834	BolC9t57928H	0	-	140	1523	2474	0.6156023
C9	48316815	48318375	BolC9t57929H	0	+	60	762	1560	0.4884615
C9	48319127	48319648	BolC9t57930H	0	+	0	0	521	0.0000000
C9	48319654	48321177	BolC9t57931H	0	+	8	106	1523	0.0695995
C9	48321374	48322681	BolC9t57932H	0	-	0	0	1307	0.0000000
C9	48325017	48326433	BolC9t57933H	0	-	0	0	1416	0.0000000
C9	48337067	48338276	BolC9t57934H	0	+	0	0	1209	0.0000000
C9	48349192	48351681	BolC9t57935H	0	-	3	274	2489	0.1100844
C9	48352662	48354252	BolC9t57936H	0	+	94	225	1590	0.1415094
C9	48366019	48366731	BolC9t57937H	0	-	0	0	712	0.0000000
C9	48377408	48378011	BolC9t57938H	0	+	0	0	603	0.0000000
C9	48391219	48391884	BolC9t57939H	0	-	3	36	665	0.0541353
C9	48393264	48394613	BolC9t57940H	0	+	3	98	1349	0.0726464
C9	48395607	48397209	BolC9t57941H	0	-	1045	1602	1602	1.0000000
C9	48397798	48399476	BolC9t57942H	0	-	1500	1678	1678	1.0000000
C9	48409100	48410261	BolC9t57943H	0	+	165	660	1161	0.5684754
C9	48419444	48420712	BolC9t57944H	0	+	760	1268	1268	1.0000000
C9	48423435	48431284	BolC9t57945H	0	-	1848	6623	7849	0.8438017
C9	48429127	48429613	BolC9t57946H	0	+	29	427	486	0.8786008
C9	48429693	48430099	BolC9t57947H	0	+	6	197	406	0.4852217
C9	48435652	48435832	BolC9t57948H	0	+	119	180	180	1.0000000
C9	48437088	48445571	BolC9t57949H	0	+	3922	8483	8483	1.0000000
C9	48445519	48445822	BolC9t57950H	0	+	76	303	303	1.0000000
C9	48446130	48447693	BolC9t57951H	0	-	1298	1563	1563	1.0000000
C9	48453671	48453911	BolC9t57952H	0	+	209	240	240	1.0000000
C9	48465066	48465556	BolC9t57953H	0	-	512	490	490	1.0000000
C9	48466629	48468171	BolC9t57954H	0	+	974	1542	1542	1.0000000
C9	48472036	48472526	BolC9t57955H	0	-	83	437	490	0.8918368
C9	48493665	48494183	BolC9t57956H	0	+	387	518	518	1.0000000
C9	48496220	48499457	BolC9t57957H	0	+	440	2404	3237	0.7426630
C9	48499717	48500218	BolC9t57958H	0	+	77	346	501	0.6906188
C9	48512692	48512998	BolC9t57959H	0	+	53	201	306	0.6568627
C9	48513582	48517034	BolC9t57960H	0	-	1604	2966	3452	0.8592120
C9	48528002	48529693	BolC9t57961H	0	-	405	1525	1691	0.9018332
C9	48532768	48536754	BolC9t57962H	0	+	1048	3547	3986	0.8898645
C9	48539284	48539758	BolC9t57963H	0	+	389	474	474	1.0000000
C9	48559738	48560644	BolC9t57964H	0	+	136	790	906	0.8719647
C9	48561381	48562632	BolC9t57965H	0	-	408	1246	1251	0.9960032
C9	48573234	48573677	BolC9t57966H	0	+	49	429	443	0.9683973
C9	48578521	48581158	BolC9t57967H	0	-	174	1267	2637	0.4804702
C9	48596311	48597475	BolC9t57968H	0	+	2	156	1164	0.1340206
C9	48601416	48601807	BolC9t57969H	0	+	596	391	391	1.0000000
C9	48601981	48603475	BolC9t57970H	0	-	1100	1494	1494	1.0000000
C9	48609929	48612107	BolC9t57971H	0	+	285	1221	2178	0.5606061
C9	48612688	48614330	BolC9t57972H	0	-	931	1642	1642	1.0000000
C9	48614564	48615663	BolC9t57973H	0	+	684	1095	1099	0.9963603
C9	48616523	48616898	BolC9t57974H	0	-	5	204	375	0.5440000
C9	48623045	48641400	BolC9t57975H	0	-	4500	16635	18355	0.9062926
C9	48642642	48644385	BolC9t57976H	0	+	932	1743	1743	1.0000000
C9	48657438	48658170	BolC9t57977H	0	-	167	724	732	0.9890710
C9	48665254	48667887	BolC9t57978H	0	+	931	2512	2633	0.9540448
C9	48668131	48670421	BolC9t57979H	0	-	2021	2290	2290	1.0000000
C9	48670853	48670961	BolC9t57980H	0	-	86	108	108	1.0000000
C9	48674920	48677663	BolC9t57981H	0	+	763	2568	2743	0.9362012
C9	48691766	48698838	BolC9t57982H	0	+	2610	6768	7072	0.9570135
C9	48703921	48705155	BolC9t57983H	0	-	232	1116	1234	0.9043760
C9	48705812	48706175	BolC9t57984H	0	-	66	363	363	1.0000000
C9	48713397	48715171	BolC9t57985H	0	+	806	1774	1774	1.0000000
C9	48733436	48734686	BolC9t57986H	0	+	253	1124	1250	0.8992000
C9	48735094	48737309	BolC9t57987H	0	-	987	2126	2215	0.9598194
C9	48750118	48750755	BolC9t57988H	0	+	584	637	637	1.0000000
C9	48766257	48766374	BolC9t57989H	0	-	119	117	117	1.0000000
C9	48769758	48772187	BolC9t57990H	0	-	3144	2429	2429	1.0000000
C9	48777160	48777514	BolC9t57991H	0	+	18	148	354	0.4180791
C9	48779398	48782155	BolC9t57992H	0	-	925	2402	2757	0.8712369
C9	48783246	48784291	BolC9t57993H	0	-	786	1045	1045	1.0000000
C9	48825068	48826926	BolC9t57994H	0	+	373	1524	1858	0.8202368
C9	48830108	48834753	BolC9t57995H	0	+	2111	4592	4645	0.9885899
C9	48834785	48838041	BolC9t57996H	0	-	1381	3049	3256	0.9364251
C9	48838605	48839593	BolC9t57997H	0	-	1090	988	988	1.0000000
C9	48843308	48844747	BolC9t57998H	0	-	690	1439	1439	1.0000000
C9	48846356	48846584	BolC9t57999H	0	-	6	228	228	1.0000000
C9	48848596	48848972	BolC9t58000H	0	-	11	147	376	0.3909574
C9	48850679	48852412	BolC9t58001H	0	-	1385	1556	1733	0.8978650
C9	48857143	48858042	BolC9t58002H	0	+	1145	899	899	1.0000000
C9	48863705	48866714	BolC9t58003H	0	+	703	2721	3009	0.9042872
C9	48881096	48882187	BolC9t58004H	0	+	584	1091	1091	1.0000000
C9	48887273	48887685	BolC9t58005H	0	+	121	412	412	1.0000000
C9	48893169	48893895	BolC9t58006H	0	+	257	709	726	0.9765840
C9	48897427	48900184	BolC9t58007H	0	+	1849	2757	2757	1.0000000
C9	48903911	48904376	BolC9t58008H	0	-	16	215	465	0.4623656
C9	48912141	48913090	BolC9t58009H	0	-	113	457	949	0.4815595
C9	48925505	48925807	BolC9t58010H	0	+	183	302	302	1.0000000
C9	48946238	48947367	BolC9t58011H	0	-	113	675	1129	0.5978742
C9	48958401	48958893	BolC9t58012H	0	+	10	284	492	0.5772358
C9	48961252	48961823	BolC9t58013H	0	+	387	571	571	1.0000000
C9	48977637	48977862	BolC9t58014H	0	+	271	225	225	1.0000000
C9	48984190	48986235	BolC9t58015H	0	+	325	1761	2045	0.8611247
C9	48986422	48987574	BolC9t58016H	0	-	750	1134	1152	0.9843750
C9	48988891	48991081	BolC9t58017H	0	-	1147	2065	2190	0.9429224
C9	48991203	48991668	BolC9t58018H	0	+	15	222	465	0.4774193
C9	48992851	48993184	BolC9t58019H	0	-	290	333	333	1.0000000
C9	49008251	49008577	BolC9t58020H	0	+	131	326	326	1.0000000
C9	49009324	49009758	BolC9t58021H	0	+	78	367	434	0.8456221
C9	49010020	49015042	BolC9t58022H	0	-	10204	5022	5022	1.0000000
C9	49012937	49013240	BolC9t58023H	0	+	1026	303	303	1.0000000
C9	49018571	49019908	BolC9t58024H	0	+	935	1337	1337	1.0000000
C9	49023634	49024211	BolC9t58025H	0	-	30	127	577	0.2201040
C9	49027365	49028208	BolC9t58026H	0	+	307	843	843	1.0000000
C9	49035926	49037090	BolC9t58027H	0	+	181	687	1164	0.5902062
C9	49038161	49038421	BolC9t58028H	0	-	6	185	260	0.7115384
C9	49038506	49039088	BolC9t58029H	0	-	2	4	582	0.0068729
C9	49046579	49047578	BolC9t58030H	0	-	376	999	999	1.0000000
C9	49048128	49048449	BolC9t58031H	0	-	296	321	321	1.0000000
C9	49053975	49054238	BolC9t58032H	0	-	0	0	263	0.0000000
C9	49054323	49054905	BolC9t58033H	0	-	8	28	582	0.0481100
C9	49055395	49055576	BolC9t58034H	0	-	1	4	181	0.0220994
C9	49068792	49070087	BolC9t58035H	0	-	111	791	1295	0.6108108
C9	49142361	49147855	BolC9t58036H	0	+	378	2096	5494	0.3815071
C9	49166428	49167082	BolC9t58037H	0	+	52	463	654	0.7079511
C9	49187899	49188370	BolC9t58038H	0	-	71	348	471	0.7388535
C9	49208172	49209438	BolC9t58039H	0	-	48	686	1266	0.5418642
C9	49210579	49215071	BolC9t58040H	0	+	1676	4366	4492	0.9719501
C9	49216753	49218889	BolC9t58041H	0	+	515	1950	2136	0.9129214
C9	49219559	49221159	BolC9t58042H	0	+	212	1214	1600	0.7587500
C9	49221847	49224337	BolC9t58043H	0	+	1275	2490	2490	1.0000000
C9	49234824	49235603	BolC9t58044H	0	-	4	215	779	0.2759949
C9	49236839	49245592	BolC9t58045H	0	+	2612	5327	8753	0.6085913
C9	49257894	49262040	BolC9t58046H	0	+	1366	3954	4146	0.9536903
C9	49273561	49273750	BolC9t58047H	0	-	250	189	189	1.0000000
C9	49277665	49279462	BolC9t58048H	0	+	2950	1509	1797	0.8397329
C9	49279802	49281028	BolC9t58049H	0	-	302	1226	1226	1.0000000
C9	49284010	49285763	BolC9t58050H	0	-	1343	1740	1753	0.9925842
C9	49287853	49289747	BolC9t58051H	0	-	487	1825	1894	0.9635692
C9	49294028	49294286	BolC9t58052H	0	+	62	258	258	1.0000000
C9	49296172	49297348	BolC9t58053H	0	+	66	1000	1176	0.8503401
C9	49300917	49301349	BolC9t58054H	0	+	7	215	432	0.4976852
C9	49302223	49302707	BolC9t58055H	0	-	308	484	484	1.0000000
C9	49309661	49310855	BolC9t58056H	0	-	448	1087	1194	0.9103853
C9	49327421	49328249	BolC9t58057H	0	-	477	828	828	1.0000000
C9	49330326	49330749	BolC9t58058H	0	-	269	423	423	1.0000000
C9	49349318	49353058	BolC9t58059H	0	-	1928	3735	3740	0.9986631
C9	49353299	49354983	BolC9t58060H	0	+	855	1684	1684	1.0000000
C9	49355298	49356357	BolC9t58061H	0	+	332	967	1059	0.9131256
C9	49358003	49359059	BolC9t58062H	0	+	742	1056	1056	1.0000000
C9	49360164	49361208	BolC9t58063H	0	+	943	1044	1044	1.0000000
C9	49361958	49362297	BolC9t58064H	0	-	196	339	339	1.0000000
C9	49374408	49375073	BolC9t58065H	0	-	188	637	665	0.9578947
C9	49375990	49380621	BolC9t58066H	0	+	1139	4052	4631	0.8749730
C9	49383371	49394714	BolC9t58067H	0	+	8300	10587	11343	0.9333510
C9	49397152	49397611	BolC9t58068H	0	+	525	459	459	1.0000000
C9	49398322	49405730	BolC9t58069H	0	+	4882	7261	7408	0.9801566
C9	49405908	49407403	BolC9t58070H	0	+	918	1495	1495	1.0000000
C9	49408382	49409000	BolC9t58071H	0	-	479	618	618	1.0000000
C9	49412246	49412911	BolC9t58072H	0	+	317	665	665	1.0000000
C9	49414727	49416852	BolC9t58073H	0	-	89	1155	2125	0.5435294
C9	49420531	49420741	BolC9t58074H	0	-	0	0	210	0.0000000
C9	49423599	49424008	BolC9t58075H	0	-	12	40	409	0.0977995
C9	49424364	49424475	BolC9t58076H	0	+	131	111	111	1.0000000
C9	49425537	49426766	BolC9t58077H	0	+	1534	1229	1229	1.0000000
C9	49442929	49464692	BolC9t58078H	0	+	6212	17220	21763	0.7912512
C9	49483526	49484381	BolC9t58079H	0	-	684	855	855	1.0000000
C9	49485335	49486766	BolC9t58080H	0	+	1925	1431	1431	1.0000000
C9	49501029	49503490	BolC9t58081H	0	+	2852	2461	2461	1.0000000
C9	49503952	49506092	BolC9t58082H	0	+	1485	2140	2140	1.0000000
C9	49508797	49511213	BolC9t58083H	0	-	1922	2336	2416	0.9668874
C9	49519917	49522410	BolC9t58084H	0	-	399	2170	2493	0.8704372
C9	49527883	49528743	BolC9t58085H	0	+	287	475	860	0.5523256
C9	49530696	49531179	BolC9t58086H	0	+	106	471	483	0.9751553
C9	49537525	49538131	BolC9t58087H	0	+	6	160	606	0.2640264
C9	49552110	49553991	BolC9t58088H	0	-	147	1214	1881	0.6454014
C9	49558341	49560322	BolC9t58089H	0	-	1545	1947	1981	0.9828370
C9	49562167	49562404	BolC9t58090H	0	-	151	221	237	0.9324895
C9	49565976	49566627	BolC9t58091H	0	+	218	561	651	0.8617511
C9	49575926	49576082	BolC9t58092H	0	-	70	156	156	1.0000000
C9	49582909	49583232	BolC9t58093H	0	-	85	323	323	1.0000000
C9	49588591	49589335	BolC9t58094H	0	-	197	744	744	1.0000000
C9	49591296	49591851	BolC9t58095H	0	-	402	555	555	1.0000000
C9	49604025	49611521	BolC9t58096H	0	+	17486	7476	7496	0.9973319
C9	49657075	49658903	BolC9t58097H	0	+	363	1562	1828	0.8544858
C9	49662558	49666129	BolC9t58098H	0	-	1846	3537	3571	0.9904789
C9	49668763	49668992	BolC9t58099H	0	-	7	226	229	0.9868996
C9	49680450	49681530	BolC9t58100H	0	-	21	740	1080	0.6851852
C9	49696094	49696580	BolC9t58101H	0	+	372	486	486	1.0000000
C9	49698075	49699446	BolC9t58102H	0	-	294	1371	1371	1.0000000
C9	49700865	49702343	BolC9t58103H	0	-	1738	1478	1478	1.0000000
C9	49707262	49707673	BolC9t58104H	0	+	60	401	411	0.9756691
C9	49717185	49717549	BolC9t58105H	0	+	459	364	364	1.0000000
C9	49723270	49723996	BolC9t58106H	0	-	615	726	726	1.0000000
C9	49724894	49725658	BolC9t58107H	0	-	568	764	764	1.0000000
C9	49725976	49726501	BolC9t58108H	0	-	112	423	525	0.8057143
C9	49731632	49733623	BolC9t58109H	0	-	34	731	1991	0.3671522
C9	49743774	49751158	BolC9t58110H	0	+	3071	7057	7384	0.9557151
C9	49752698	49755386	BolC9t58111H	0	-	1954	2479	2688	0.9222471
C9	49755841	49756294	BolC9t58112H	0	+	132	453	453	1.0000000
C9	49758309	49759555	BolC9t58113H	0	+	485	1246	1246	1.0000000
C9	49760334	49762812	BolC9t58114H	0	-	1335	2401	2478	0.9689265
C9	49763446	49765745	BolC9t58115H	0	+	1146	2299	2299	1.0000000
C9	49767232	49769359	BolC9t58116H	0	-	1927	2062	2127	0.9694405
C9	49785536	49785887	BolC9t58117H	0	-	87	351	351	1.0000000
C9	49800609	49803228	BolC9t58118H	0	-	1441	2619	2619	1.0000000
C9	49837763	49840023	BolC9t58119H	0	+	716	2258	2260	0.9991150
C9	49847658	49847932	BolC9t58120H	0	-	121	274	274	1.0000000
C9	49850903	49851650	BolC9t58121H	0	+	386	719	747	0.9625167
C9	49851923	49852347	BolC9t58122H	0	-	9	231	424	0.5448113
C9	49862524	49863612	BolC9t58123H	0	+	974	1088	1088	1.0000000
C9	49863103	49873030	BolC9t58124H	0	+	6029	8389	9927	0.8450690
C9	49874609	49875081	BolC9t58125H	0	-	186	472	472	1.0000000
C9	49875950	49878121	BolC9t58126H	0	-	1295	2171	2171	1.0000000
C9	49879369	49880365	BolC9t58127H	0	+	125	820	996	0.8232931
C9	49897126	49899964	BolC9t58128H	0	+	2330	2786	2838	0.9816772
C9	49900918	49901953	BolC9t58129H	0	-	314	693	1035	0.6695652
C9	49904262	49904575	BolC9t58130H	0	-	111	313	313	1.0000000
C9	49905316	49910415	BolC9t58131H	0	+	348	3101	5099	0.6081585
C9	49913584	49915982	BolC9t58132H	0	+	2208	2398	2398	1.0000000
C9	49917595	49918600	BolC9t58133H	0	-	331	1005	1005	1.0000000
C9	49919590	49920887	BolC9t58134H	0	-	311	952	1297	0.7340015
C9	49933255	49933612	BolC9t58135H	0	-	90	357	357	1.0000000
C9	49934312	49935428	BolC9t58136H	0	+	1043	1116	1116	1.0000000
C9	49945621	49946482	BolC9t58137H	0	+	260	690	861	0.8013937
C9	49951777	49955783	BolC9t58138H	0	-	686	3545	4006	0.8849226
C9	49963898	49967223	BolC9t58139H	0	+	980	2898	3325	0.8715789
C9	49985923	49988664	BolC9t58140H	0	+	1177	2309	2741	0.8423933
C9	49989539	49992740	BolC9t58141H	0	-	1109	2569	3201	0.8025617
C9	49993888	49994191	BolC9t58142H	0	-	264	303	303	1.0000000
C9	50003747	50042609	BolC9t58143H	0	+	15048	35876	38862	0.9231640
C9	50016065	50016599	BolC9t58144H	0	+	6	158	534	0.2958801
C9	50018819	50019452	BolC9t58145H	0	+	497	633	633	1.0000000
C9	50020535	50058366	BolC9t58146H	0	+	14564	35467	37831	0.9375116
C9	50020832	50021597	BolC9t58147H	0	+	465	765	765	1.0000000
C9	50065456	50065750	BolC9t58148H	0	-	325	294	294	1.0000000
C9	50081789	50083012	BolC9t58149H	0	-	99	578	1223	0.4726083
C9	50096135	50096338	BolC9t58150H	0	-	330	203	203	1.0000000
C9	50096537	50098552	BolC9t58151H	0	-	1857	1909	2015	0.9473945
C9	50118964	50120734	BolC9t58152H	0	-	1303	1770	1770	1.0000000
C9	50127539	50127722	BolC9t58153H	0	-	183	183	183	1.0000000
C9	50128689	50128962	BolC9t58154H	0	+	8	82	273	0.3003663
C9	50144603	50146613	BolC9t58155H	0	+	251	1643	2010	0.8174129
C9	50147453	50149457	BolC9t58156H	0	+	405	1938	2004	0.9670659
C9	50168724	50170866	BolC9t58157H	0	+	160	1469	2142	0.6858076
C9	50171663	50177884	BolC9t58158H	0	+	3184	5311	6221	0.8537213
C9	50179027	50179900	BolC9t58159H	0	+	9	265	873	0.3035510
C9	50182774	50214945	BolC9t58160H	0	+	5838	17440	32171	0.5421031
C9	50189095	50190339	BolC9t58161H	0	-	0	0	1244	0.0000000
C9	50190728	50191185	BolC9t58162H	0	-	2	30	457	0.0656455
C9	50202788	50203840	BolC9t58163H	0	-	78	913	1052	0.8678707
C9	50209295	50209808	BolC9t58164H	0	+	9	182	513	0.3547758
C9	50218639	50219506	BolC9t58165H	0	-	7	361	867	0.4163783
C9	50223232	50223337	BolC9t58166H	0	-	42	105	105	1.0000000
C9	50229624	50229996	BolC9t58167H	0	+	114	372	372	1.0000000
C9	50244716	50245619	BolC9t58168H	0	+	369	844	903	0.9346622
C9	50249187	50251182	BolC9t58169H	0	+	1036	1987	1995	0.9959900
C9	50251713	50254643	BolC9t58170H	0	-	2383	2870	2930	0.9795222
C9	50258184	50258289	BolC9t58171H	0	-	146	105	105	1.0000000
C9	50279577	50281628	BolC9t58172H	0	+	1029	2051	2051	1.0000000
C9	50285802	50286075	BolC9t58173H	0	+	14	273	273	1.0000000
C9	50290533	50291969	BolC9t58174H	0	-	1875	1434	1436	0.9986072
C9	50308241	50308940	BolC9t58175H	0	+	424	699	699	1.0000000
C9	50312044	50313481	BolC9t58176H	0	+	649	1427	1437	0.9930410
C9	50314202	50314604	BolC9t58177H	0	-	50	302	402	0.7512438
C9	50324964	50329750	BolC9t58178H	0	+	1772	4166	4786	0.8704555
C9	50331737	50333264	BolC9t58179H	0	-	391	1527	1527	1.0000000
C9	50333565	50335210	BolC9t58180H	0	+	849	1645	1645	1.0000000
C9	50339919	50340183	BolC9t58181H	0	+	159	264	264	1.0000000
C9	50341020	50344123	BolC9t58182H	0	-	1060	3103	3103	1.0000000
C9	50348427	50349616	BolC9t58183H	0	+	665	825	1189	0.6938604
C9	50366274	50366394	BolC9t58184H	0	-	291	120	120	1.0000000
C9	50366724	50370102	BolC9t58185H	0	-	2288	3378	3378	1.0000000
C9	50377213	50377858	BolC9t58186H	0	-	397	645	645	1.0000000
C9	50391754	50392084	BolC9t58187H	0	-	37	229	330	0.6939394
C9	50395407	50396223	BolC9t58188H	0	+	203	799	816	0.9791667
C9	50399056	50402858	BolC9t58189H	0	+	514	2530	3802	0.6654392
C9	50403481	50404297	BolC9t58190H	0	+	127	522	816	0.6397059
C9	50404699	50405781	BolC9t58191H	0	-	209	921	1082	0.8512015
C9	50412013	50413419	BolC9t58192H	0	-	387	1147	1406	0.8157895
C9	50418302	50419957	BolC9t58193H	0	-	1211	1655	1655	1.0000000
C9	50421875	50422004	BolC9t58194H	0	-	1	71	129	0.5503876
C9	50425594	50427719	BolC9t58195H	0	+	920	2125	2125	1.0000000
C9	50429146	50430286	BolC9t58196H	0	+	76	822	1140	0.7210526
C9	50447437	50450063	BolC9t58197H	0	+	1434	2587	2626	0.9851485
C9	50454881	50456460	BolC9t58198H	0	+	1007	1579	1579	1.0000000
C9	50459058	50460198	BolC9t58199H	0	-	361	1140	1140	1.0000000
C9	50461936	50462738	BolC9t58200H	0	+	24	293	802	0.3653367
C9	50464458	50464593	BolC9t58201H	0	-	102	135	135	1.0000000
C9	50467236	50471516	BolC9t58202H	0	-	2022	4280	4280	1.0000000
C9	50472166	50473556	BolC9t58203H	0	+	876	1390	1390	1.0000000
C9	50474792	50482066	BolC9t58204H	0	+	2174	6559	7274	0.9017047
C9	50482523	50482894	BolC9t58205H	0	-	172	371	371	1.0000000
C9	50483158	50485294	BolC9t58206H	0	+	1782	2136	2136	1.0000000
C9	50486847	50489091	BolC9t58207H	0	+	310	1928	2244	0.8591800
C9	50491448	50492123	BolC9t58208H	0	-	265	609	675	0.9022222
C9	50493363	50496024	BolC9t58209H	0	+	1327	2364	2661	0.8883878
C9	50496503	50499810	BolC9t58210H	0	-	1135	3225	3307	0.9752041
C9	50501949	50502384	BolC9t58211H	0	-	374	435	435	1.0000000
C9	50503855	50505264	BolC9t58212H	0	-	707	1383	1409	0.9815472
C9	50519119	50519620	BolC9t58213H	0	-	79	353	501	0.7045908
C9	50541613	50542093	BolC9t58214H	0	+	96	458	480	0.9541667
C9	50551714	50552646	BolC9t58215H	0	-	1620	589	932	0.6319742
C9	50584993	50588983	BolC9t58216H	0	+	754	3680	3990	0.9223058
C9	50589481	50592672	BolC9t58217H	0	-	334	2753	3191	0.8627390
C9	50598566	50602676	BolC9t58218H	0	+	1146	3291	4110	0.8007299
C9	50602973	50603185	BolC9t58219H	0	+	6	145	212	0.6839623
C9	50613893	50614172	BolC9t58220H	0	-	4	138	279	0.4946237
C9	50617872	50619102	BolC9t58221H	0	-	5	160	1230	0.1300813
C9	50632892	50636886	BolC9t58222H	0	-	464	3372	3994	0.8442664
C9	50651371	50652755	BolC9t58223H	0	-	598	1304	1384	0.9421965
C9	50679516	50683025	BolC9t58224H	0	+	2624	3408	3509	0.9712169
C9	50697601	50701220	BolC9t58225H	0	+	902	3352	3619	0.9262227
C9	50706442	50710800	BolC9t58226H	0	+	1059	3301	4358	0.7574576
C9	50717183	50719886	BolC9t58227H	0	+	1198	2703	2703	1.0000000
C9	50721131	50721275	BolC9t58228H	0	+	379	144	144	1.0000000
C9	50733583	50735450	BolC9t58229H	0	+	276	1115	1867	0.5972148
C9	50741407	50741527	BolC9t58230H	0	-	179	120	120	1.0000000
C9	50742985	50744186	BolC9t58231H	0	+	1100	1201	1201	1.0000000
C9	50757463	50758484	BolC9t58232H	0	-	323	821	1021	0.8041136
C9	50764409	50764628	BolC9t58233H	0	+	26	92	219	0.4200913
C9	50768677	50770400	BolC9t58234H	0	-	424	1596	1723	0.9262913
C9	50777778	50778774	BolC9t58235H	0	+	418	745	996	0.7479920
C9	50782648	50783022	BolC9t58236H	0	-	49	362	374	0.9679145
C9	50783834	50784314	BolC9t58237H	0	+	33	263	480	0.5479167
C9	50784618	50786704	BolC9t58238H	0	-	286	1702	2086	0.8159156
C9	50802386	50803690	BolC9t58239H	0	-	544	1304	1304	1.0000000
C9	50813297	50814901	BolC9t58240H	0	-	274	1354	1604	0.8441396
C9	50828795	50830127	BolC9t58241H	0	+	463	1130	1332	0.8483483
C9	50832006	50835259	BolC9t58242H	0	-	913	3253	3253	1.0000000
C9	50836008	50836851	BolC9t58243H	0	-	55	541	843	0.6417556
C9	50838034	50838930	BolC9t58244H	0	+	60	587	896	0.6551339
C9	50873074	50874205	BolC9t58245H	0	+	24	354	1131	0.3129973
C9	50880156	50881420	BolC9t58246H	0	+	810	1264	1264	1.0000000
C9	50881829	50882344	BolC9t58247H	0	+	155	515	515	1.0000000
C9	50883426	50883528	BolC9t58248H	0	+	115	102	102	1.0000000
C9	50887467	50887683	BolC9t58249H	0	-	277	216	216	1.0000000
C9	50891857	50893024	BolC9t58250H	0	+	191	1046	1167	0.8963153
C9	50895588	50896014	BolC9t58251H	0	+	165	426	426	1.0000000
C9	50896497	50896804	BolC9t58252H	0	-	359	307	307	1.0000000
C9	50899577	50902232	BolC9t58253H	0	+	1063	2615	2655	0.9849341
C9	50903242	50905244	BolC9t58254H	0	+	822	2001	2002	0.9995005
C9	50905733	50908910	BolC9t58255H	0	-	2231	3177	3177	1.0000000
C9	50932006	50933239	BolC9t58256H	0	+	416	1013	1233	0.8215734
C9	50933601	50935002	BolC9t58257H	0	-	1417	1401	1401	1.0000000
C9	50935051	50936568	BolC9t58258H	0	-	896	1517	1517	1.0000000
C9	50943542	50945384	BolC9t58259H	0	+	620	1826	1842	0.9913138
C9	50945758	50946076	BolC9t58260H	0	+	329	318	318	1.0000000
C9	50951034	50959290	BolC9t58261H	0	+	2490	6736	8256	0.8158914
C9	50962768	50970903	BolC9t58262H	0	-	191	2095	8135	0.2575292
C9	50981507	50988049	BolC9t58263H	0	+	2790	5775	6542	0.8827575
C9	50988195	50989482	BolC9t58264H	0	-	1250	1287	1287	1.0000000
C9	50990911	50994839	BolC9t58265H	0	-	1418	3822	3928	0.9730142
C9	51004164	51005463	BolC9t58266H	0	-	249	944	1299	0.7267129
C9	51005524	51005813	BolC9t58267H	0	+	377	289	289	1.0000000
C9	51024227	51024650	BolC9t58268H	0	-	62	423	423	1.0000000
C9	51070166	51071319	BolC9t58269H	0	+	35	793	1153	0.6877710
C9	51073167	51073380	BolC9t58270H	0	-	35	179	213	0.8403756
C9	51078071	51079633	BolC9t58271H	0	+	106	1027	1562	0.6574904
C9	51114098	51116351	BolC9t58272H	0	+	29	750	2253	0.3328895
C9	51117296	51118750	BolC9t58273H	0	+	84	438	1454	0.3012380
C9	51121062	51122405	BolC9t58274H	0	+	104	1070	1343	0.7967237
C9	51124157	51125901	BolC9t58275H	0	-	477	1488	1744	0.8532110
C9	51130459	51133127	BolC9t58276H	0	+	1119	2281	2668	0.8549475
C9	51133728	51136009	BolC9t58277H	0	+	352	933	2281	0.4090311
C9	51136951	51138209	BolC9t58278H	0	+	93	1075	1258	0.8545310
C9	51160884	51161673	BolC9t58279H	0	-	1644	789	789	1.0000000
C9	51167159	51170674	BolC9t58280H	0	-	1277	3107	3515	0.8839260
C9	51183825	51187677	BolC9t58281H	0	+	1888	3852	3852	1.0000000
C9	51188062	51188770	BolC9t58282H	0	-	253	681	708	0.9618644
C9	51200449	51204006	BolC9t58283H	0	-	2055	3557	3557	1.0000000
C9	51205389	51208106	BolC9t58284H	0	+	1320	2564	2717	0.9436879
C9	51221783	51227436	BolC9t58285H	0	+	354	3154	5653	0.5579339
C9	51254051	51254965	BolC9t58286H	0	+	401	883	914	0.9660832
C9	51255330	51261127	BolC9t58287H	0	-	4136	5277	5797	0.9102984
C9	51277609	51280299	BolC9t58288H	0	-	2131	2690	2690	1.0000000
C9	51283607	51288235	BolC9t58289H	0	-	639	2595	4628	0.5607173
C9	51319703	51320273	BolC9t58290H	0	-	13	410	570	0.7192982
C9	51353558	51355118	BolC9t58291H	0	-	1451	1560	1560	1.0000000
C9	51389052	51389264	BolC9t58292H	0	+	88	212	212	1.0000000
C9	51389593	51391282	BolC9t58293H	0	+	737	1689	1689	1.0000000
C9	51395839	51396400	BolC9t58294H	0	+	130	561	561	1.0000000
C9	51414002	51414997	BolC9t58295H	0	+	3	182	995	0.1829146
C9	51416981	51417173	BolC9t58296H	0	-	141	192	192	1.0000000
C9	51417939	51418053	BolC9t58297H	0	-	89	114	114	1.0000000
C9	51422050	51424550	BolC9t58298H	0	+	1309	2364	2500	0.9456000
C9	51427844	51430500	BolC9t58299H	0	+	1636	2656	2656	1.0000000
C9	51430901	51432981	BolC9t58300H	0	+	1079	2039	2080	0.9802884
C9	51436495	51437245	BolC9t58301H	0	-	25	481	750	0.6413333
C9	51441054	51442655	BolC9t58302H	0	+	606	1557	1601	0.9725172
C9	51444426	51444642	BolC9t58303H	0	-	70	216	216	1.0000000
C9	51447706	51447814	BolC9t58304H	0	-	84	108	108	1.0000000
C9	51450179	51451148	BolC9t58305H	0	+	580	958	969	0.9886481
C9	51458101	51458377	BolC9t58306H	0	+	314	276	276	1.0000000
C9	51459171	51459423	BolC9t58307H	0	+	262	252	252	1.0000000
C9	51462399	51465217	BolC9t58308H	0	+	1255	2706	2818	0.9602555
C9	51466160	51467012	BolC9t58309H	0	+	181	836	852	0.9812207
C9	51467762	51468209	BolC9t58310H	0	-	168	392	447	0.8769575
C9	51469821	51473537	BolC9t58311H	0	-	992	2559	3716	0.6886437
C9	51474770	51475013	BolC9t58312H	0	-	37	243	243	1.0000000
C9	51476854	51477863	BolC9t58313H	0	-	225	912	1009	0.9038652
C9	51485023	51485905	BolC9t58314H	0	-	385	812	882	0.9206349
C9	51517071	51518256	BolC9t58315H	0	+	699	1185	1185	1.0000000
C9	51518617	51519150	BolC9t58316H	0	+	322	533	533	1.0000000
C9	51522839	51524762	BolC9t58317H	0	+	369	1669	1923	0.8679147
C9	51530872	51531244	BolC9t58318H	0	+	253	372	372	1.0000000
C9	51539633	51546906	BolC9t58319H	0	-	1607	5831	7273	0.8017324
C9	51547632	51548838	BolC9t58320H	0	+	1151	1206	1206	1.0000000
C9	51548167	51549260	BolC9t58321H	0	+	1353	1093	1093	1.0000000
C9	51551376	51552843	BolC9t58322H	0	+	797	1467	1467	1.0000000
C9	51553791	51555729	BolC9t58323H	0	-	1547	1668	1938	0.8606811
C9	51556657	51558097	BolC9t58324H	0	+	589	1342	1440	0.9319444
C9	51562801	51563744	BolC9t58325H	0	+	624	943	943	1.0000000
C9	51596396	51596757	BolC9t58326H	0	+	262	361	361	1.0000000
C9	51599349	51600747	BolC9t58327H	0	+	484	1364	1398	0.9756795
C9	51604369	51606789	BolC9t58328H	0	+	2209	2420	2420	1.0000000
C9	51616601	51616754	BolC9t58329H	0	+	22	153	153	1.0000000
C9	51646103	51651616	BolC9t58330H	0	+	1893	4850	5513	0.8797388
C9	51652254	51654045	BolC9t58331H	0	+	520	1791	1791	1.0000000
C9	51655307	51660804	BolC9t58332H	0	-	3374	5458	5497	0.9929052
C9	51674962	51676298	BolC9t58333H	0	+	429	1335	1336	0.9992515
C9	51676508	51677867	BolC9t58334H	0	-	273	1325	1359	0.9749816
C9	51686831	51687515	BolC9t58335H	0	+	30	315	684	0.4605263
C9	51702801	51703623	BolC9t58336H	0	+	276	822	822	1.0000000
C9	51703811	51704222	BolC9t58337H	0	+	144	411	411	1.0000000
C9	51716396	51722209	BolC9t58338H	0	+	1139	5361	5813	0.9222432
C9	51723044	51723260	BolC9t58339H	0	+	309	216	216	1.0000000
C9	51738816	51739650	BolC9t58340H	0	+	327	829	834	0.9940048
C9	51742179	51747065	BolC9t58341H	0	-	1065	3895	4886	0.7971756
C9	51747460	51748622	BolC9t58342H	0	+	553	1162	1162	1.0000000
C9	51748876	51749200	BolC9t58343H	0	-	85	270	324	0.8333333
C9	51770953	51773998	BolC9t58344H	0	-	494	2624	3045	0.8617405
C9	51776339	51777155	BolC9t58345H	0	-	18	530	816	0.6495098
C9	51798326	51799381	BolC9t58346H	0	-	568	1042	1055	0.9876778
C9	51799955	51803049	BolC9t58347H	0	-	1550	3039	3094	0.9822236
C9	51812244	51813194	BolC9t58348H	0	+	507	950	950	1.0000000
C9	51813749	51817622	BolC9t58349H	0	-	2067	3873	3873	1.0000000
C9	51818710	51821006	BolC9t58350H	0	-	590	1962	2296	0.8545296
C9	51832177	51836788	BolC9t58351H	0	+	1564	4424	4611	0.9594448
C9	51838667	51841159	BolC9t58352H	0	-	666	1672	2492	0.6709470
C9	51841191	51847948	BolC9t58353H	0	-	1025	2693	6757	0.3985496
C9	51851257	51853177	BolC9t58354H	0	-	111	566	1920	0.2947917
C9	51866028	51870676	BolC9t58355H	0	-	568	3337	4648	0.7179432
C9	51882343	51884093	BolC9t58356H	0	+	554	1530	1750	0.8742857
C9	51884291	51885986	BolC9t58357H	0	-	190	1378	1695	0.8129793
C9	51894847	51903692	BolC9t58358H	0	-	1514	5059	8845	0.5719616
C9	51911459	51914344	BolC9t58359H	0	-	925	2697	2885	0.9348354
C9	51918890	51919307	BolC9t58360H	0	-	49	226	417	0.5419664
C9	51919819	51920845	BolC9t58361H	0	-	432	1026	1026	1.0000000
C9	51936833	51940441	BolC9t58362H	0	-	878	3523	3608	0.9764413
C9	51947829	51950068	BolC9t58363H	0	-	632	2239	2239	1.0000000
C9	51952394	51953580	BolC9t58364H	0	-	835	1186	1186	1.0000000
C9	51956187	51959259	BolC9t58365H	0	+	2312	3072	3072	1.0000000
C9	51959464	51960514	BolC9t58366H	0	-	634	1050	1050	1.0000000
C9	51961105	51962716	BolC9t58367H	0	+	367	1503	1611	0.9329609
C9	51965932	51970474	BolC9t58368H	0	+	404	2840	4542	0.6252752
C9	51971268	51972640	BolC9t58369H	0	-	1298	1367	1372	0.9963557
C9	51973840	51974698	BolC9t58370H	0	+	459	780	858	0.9090909
C9	51974857	51978975	BolC9t58371H	0	+	1036	3924	4118	0.9528897
C9	51979237	51980151	BolC9t58372H	0	-	153	742	914	0.8118162
C9	51980728	51987237	BolC9t58373H	0	-	2007	5813	6509	0.8930711
C9	51997817	51998090	BolC9t58374H	0	+	79	273	273	1.0000000
C9	51999535	52000066	BolC9t58375H	0	+	351	531	531	1.0000000
C9	52009910	52014722	BolC9t58376H	0	-	2027	4812	4812	1.0000000
C9	52025275	52028150	BolC9t58377H	0	+	1197	2725	2875	0.9478261
C9	52041880	52046228	BolC9t58378H	0	-	1663	3228	4348	0.7424103
C9	52048420	52049749	BolC9t58379H	0	-	1466	1329	1329	1.0000000
C9	52050511	52057440	BolC9t58380H	0	-	1110	4632	6929	0.6684948
C9	52056416	52056887	BolC9t58381H	0	+	379	471	471	1.0000000
C9	52059227	52060985	BolC9t58382H	0	+	9	246	1758	0.1399317
C9	52063072	52063665	BolC9t58383H	0	+	0	0	593	0.0000000
C9	52074635	52091813	BolC9t58384H	0	+	212	2592	17178	0.1508907
C9	52078482	52079077	BolC9t58385H	0	+	0	0	595	0.0000000
C9	52093900	52094489	BolC9t58386H	0	+	0	0	589	0.0000000
C9	52124906	52125320	BolC9t58387H	0	+	334	414	414	1.0000000
C9	52130359	52131746	BolC9t58388H	0	-	17	194	1387	0.1398702
C9	52133083	52134157	BolC9t58389H	0	-	222	1072	1074	0.9981378
C9	52134743	52137326	BolC9t58390H	0	+	438	2400	2583	0.9291521
C9	52141557	52142079	BolC9t58391H	0	+	18	258	522	0.4942529
C9	52158114	52158669	BolC9t58392H	0	+	6	217	555	0.3909910
C9	52166839	52167388	BolC9t58393H	0	+	35	421	549	0.7668488
C9	52179273	52179828	BolC9t58394H	0	+	2	196	555	0.3531531
C9	52194375	52195123	BolC9t58395H	0	-	152	741	748	0.9906417
C9	52202242	52204226	BolC9t58396H	0	+	719	1681	1984	0.8472782
C9	52205529	52211220	BolC9t58397H	0	+	2309	4946	5691	0.8690916
C9	52218111	52221502	BolC9t58398H	0	+	512	3087	3391	0.9103509
C9	52225968	52226812	BolC9t58399H	0	-	505	844	844	1.0000000
C9	52231063	52231447	BolC9t58400H	0	+	122	351	384	0.9140625
C9	52233030	52233598	BolC9t58401H	0	+	219	568	568	1.0000000
C9	52238642	52238798	BolC9t58402H	0	+	27	156	156	1.0000000
C9	52246634	52247138	BolC9t58403H	0	-	251	466	504	0.9246032
C9	52258942	52259509	BolC9t58404H	0	+	511	567	567	1.0000000
C9	52272748	52273339	BolC9t58405H	0	+	643	591	591	1.0000000
C9	52286478	52291275	BolC9t58406H	0	+	1833	4467	4797	0.9312070
C9	52291636	52292906	BolC9t58407H	0	-	221	1217	1270	0.9582677
C9	52294005	52294345	BolC9t58408H	0	+	0	0	340	0.0000000
C9	52299711	52303648	BolC9t58409H	0	-	124	1378	3937	0.3500127
C9	52301768	52302092	BolC9t58410H	0	+	1	128	324	0.3950617
C9	52305905	52309545	BolC9t58411H	0	-	851	2960	3640	0.8131868
C9	52312194	52315010	BolC9t58412H	0	+	864	1595	2816	0.5664062
C9	52315507	52315730	BolC9t58413H	0	+	4	71	223	0.3183857
C9	52316329	52316581	BolC9t58414H	0	+	79	252	252	1.0000000
C9	52324428	52331791	BolC9t58415H	0	-	1731	5838	7363	0.7928833
C9	52332807	52334619	BolC9t58416H	0	+	1776	1812	1812	1.0000000
C9	52341790	52342644	BolC9t58417H	0	+	714	854	854	1.0000000
C9	52344364	52346734	BolC9t58418H	0	-	28	854	2370	0.3603376
C9	52347856	52351211	BolC9t58419H	0	-	1665	2989	3355	0.8909091
C9	52363162	52363630	BolC9t58420H	0	+	53	354	468	0.7564102
C9	52365438	52365873	BolC9t58421H	0	+	128	435	435	1.0000000
C9	52370877	52373656	BolC9t58422H	0	+	977	2551	2779	0.9179561
C9	52375760	52376672	BolC9t58423H	0	+	12	197	912	0.2160088
C9	52379997	52380699	BolC9t58424H	0	+	15	236	702	0.3361823
C9	52395887	52396523	BolC9t58425H	0	+	41	629	636	0.9889937
C9	52397358	52398251	BolC9t58426H	0	-	174	893	893	1.0000000
C9	52399286	52401676	BolC9t58427H	0	-	752	1495	2390	0.6255230
C9	52403415	52407874	BolC9t58428H	0	-	1243	4188	4459	0.9392241
C9	52409841	52411416	BolC9t58429H	0	+	259	1195	1575	0.7587302
C9	52411664	52414126	BolC9t58430H	0	-	775	2379	2462	0.9662876
C9	52419918	52420890	BolC9t58431H	0	+	274	832	972	0.8559671
C9	52421611	52422658	BolC9t58432H	0	-	429	1047	1047	1.0000000
C9	52423239	52423780	BolC9t58433H	0	+	599	541	541	1.0000000
C9	52427804	52428417	BolC9t58434H	0	+	81	569	613	0.9282219
C9	52443071	52445045	BolC9t58435H	0	+	1146	1970	1974	0.9979737
C9	52446390	52448444	BolC9t58436H	0	+	1850	2054	2054	1.0000000
C9	52448714	52449756	BolC9t58437H	0	-	387	1042	1042	1.0000000
C9	52452298	52455466	BolC9t58438H	0	-	830	2696	3168	0.8510101
C9	52470530	52470839	BolC9t58439H	0	-	55	309	309	1.0000000
C9	52484388	52485817	BolC9t58440H	0	+	185	1211	1429	0.8474458
C9	52486270	52486861	BolC9t58441H	0	+	11	233	591	0.3942470
C9	52487577	52488294	BolC9t58442H	0	-	2	229	717	0.3193863
C9	52490288	52490654	BolC9t58443H	0	-	0	0	366	0.0000000
C9	52490781	52491735	BolC9t58444H	0	-	6	20	954	0.0209644
C9	52495687	52500276	BolC9t58445H	0	+	623	3549	4589	0.7733711
C9	52500732	52503088	BolC9t58446H	0	-	1490	2321	2356	0.9851443
C9	52508797	52510103	BolC9t58447H	0	-	667	1236	1306	0.9464012
C9	52512235	52512574	BolC9t58448H	0	+	35	339	339	1.0000000
C9	52519333	52519903	BolC9t58449H	0	+	148	470	570	0.8245614
C9	52521308	52525344	BolC9t58450H	0	-	997	3110	4036	0.7705649
C9	52531569	52533396	BolC9t58451H	0	+	433	1073	1827	0.5873016
C9	52543987	52545025	BolC9t58452H	0	-	173	862	1038	0.8304431
C9	52546753	52547169	BolC9t58453H	0	+	4	154	416	0.3701923
C9	52554560	52554763	BolC9t58454H	0	-	11	203	203	1.0000000
C9	52556292	52565669	BolC9t58455H	0	+	1786	5568	9377	0.5937933
C9	52566403	52567600	BolC9t58456H	0	-	154	793	1197	0.6624895
C9	52571887	52574545	BolC9t58457H	0	+	400	2058	2658	0.7742664
C9	52574959	52576530	BolC9t58458H	0	+	492	1526	1571	0.9713558
C9	52578433	52583555	BolC9t58459H	0	+	1308	4116	5122	0.8035923
C9	52590325	52591001	BolC9t58460H	0	+	386	676	676	1.0000000
C9	52592254	52594504	BolC9t58461H	0	+	716	1254	2250	0.5573334
C9	52607706	52608087	BolC9t58462H	0	-	404	381	381	1.0000000
C9	52608841	52611991	BolC9t58463H	0	+	680	1896	3150	0.6019047
C9	52612450	52615604	BolC9t58464H	0	-	390	2605	3154	0.8259353
C9	52630713	52632818	BolC9t58465H	0	-	341	1780	2105	0.8456057
C9	52635108	52636686	BolC9t58466H	0	-	740	1279	1578	0.8105196
C9	52654326	52657238	BolC9t58467H	0	-	448	2827	2912	0.9708104
C9	52662818	52664837	BolC9t58468H	0	-	611	1598	2019	0.7914810
C9	52676026	52677086	BolC9t58469H	0	-	492	1060	1060	1.0000000
C9	52681062	52681896	BolC9t58470H	0	+	566	770	834	0.9232614
C9	52682334	52689179	BolC9t58471H	0	+	1231	4120	6845	0.6018992
C9	52689583	52690069	BolC9t58472H	0	-	361	486	486	1.0000000
C9	52700811	52702691	BolC9t58473H	0	+	1351	1880	1880	1.0000000
C9	52705717	52708282	BolC9t58474H	0	-	796	2313	2565	0.9017544
C9	52709332	52710002	BolC9t58475H	0	-	41	563	670	0.8402985
C9	52714339	52715377	BolC9t58476H	0	+	108	602	1038	0.5799615
C9	52715940	52718285	BolC9t58477H	0	+	1223	2266	2345	0.9663113
C9	52718473	52719426	BolC9t58478H	0	-	340	945	953	0.9916055
C9	52719657	52721378	BolC9t58479H	0	+	952	1721	1721	1.0000000
C9	52722378	52727199	BolC9t58480H	0	+	2186	4815	4821	0.9987555
C9	52728471	52729866	BolC9t58481H	0	+	390	1242	1395	0.8903226
C9	52731684	52732074	BolC9t58482H	0	+	294	390	390	1.0000000
C9	52734747	52736439	BolC9t58483H	0	+	271	988	1692	0.5839244
C9	52739894	52740218	BolC9t58484H	0	-	86	324	324	1.0000000
C9	52749615	52751345	BolC9t58485H	0	+	341	1347	1730	0.7786127
C9	52754608	52754980	BolC9t58486H	0	+	2016	372	372	1.0000000
C9	52763718	52765066	BolC9t58487H	0	+	768	1348	1348	1.0000000
C9	52769853	52771753	BolC9t58488H	0	+	487	1609	1900	0.8468421
C9	52774367	52774739	BolC9t58489H	0	-	35	274	372	0.7365592
C9	52778375	52778714	BolC9t58490H	0	-	577	339	339	1.0000000
C9	52783678	52784800	BolC9t58491H	0	-	99	622	1122	0.5543672
C9	52801399	52803873	BolC9t58492H	0	+	2470	2474	2474	1.0000000
C9	52807530	52807902	BolC9t58493H	0	-	63	295	372	0.7930108
C9	52809953	52812664	BolC9t58494H	0	-	80	1097	2711	0.4046477
C9	52823477	52823969	BolC9t58495H	0	-	587	492	492	1.0000000
C9	52835685	52836860	BolC9t58496H	0	-	522	1175	1175	1.0000000
C9	52836875	52837056	BolC9t58497H	0	-	227	181	181	1.0000000
C9	52841716	52842864	BolC9t58498H	0	+	328	1099	1148	0.9573171
C9	52843549	52844669	BolC9t58499H	0	+	793	1120	1120	1.0000000
C9	52845604	52847344	BolC9t58500H	0	+	381	1346	1740	0.7735632
C9	52851075	52856903	BolC9t58501H	0	+	817	4455	5828	0.7644132
C9	52858296	52859064	BolC9t58502H	0	+	268	768	768	1.0000000
C9	52859598	52861059	BolC9t58503H	0	-	18	375	1461	0.2566735
C9	52865061	52865533	BolC9t58504H	0	+	153	472	472	1.0000000
C9	52865954	52867161	BolC9t58505H	0	-	291	1207	1207	1.0000000
C9	52868499	52868884	BolC9t58506H	0	+	116	385	385	1.0000000
C9	52868734	52869385	BolC9t58507H	0	+	208	651	651	1.0000000
C9	52870807	52872490	BolC9t58508H	0	+	121	1393	1683	0.8276886
C9	52873329	52875122	BolC9t58509H	0	+	867	1705	1793	0.9509202
C9	52875623	52880150	BolC9t58510H	0	-	1367	4262	4527	0.9414623
C9	52882029	52882296	BolC9t58511H	0	+	1	45	267	0.1685393
C9	52883163	52885883	BolC9t58512H	0	-	120	1399	2720	0.5143383
C9	52888044	52889571	BolC9t58513H	0	-	2225	1527	1527	1.0000000
C9	52895208	52900983	BolC9t58514H	0	-	1975	4503	5775	0.7797403
C9	52903192	52904909	BolC9t58515H	0	-	896	1712	1717	0.9970880
C9	52906198	52908688	BolC9t58516H	0	-	633	1942	2490	0.7799197
C9	52910246	52910994	BolC9t58517H	0	+	382	748	748	1.0000000
C9	52911079	52911507	BolC9t58518H	0	+	581	428	428	1.0000000
C9	52914234	52914879	BolC9t58519H	0	+	653	645	645	1.0000000
C9	52917077	52919353	BolC9t58520H	0	-	681	1701	2276	0.7473638
C9	52923604	52927975	BolC9t58521H	0	-	2057	3966	4371	0.9073439
C9	52930513	52934882	BolC9t58522H	0	+	409	2917	4369	0.6676585
C9	52957363	52957819	BolC9t58523H	0	+	38	379	456	0.8311403
C9	52964434	52964896	BolC9t58524H	0	-	5	264	462	0.5714286
C9	52966410	52968500	BolC9t58525H	0	+	147	1293	2090	0.6186603
C9	52969210	52971962	BolC9t58526H	0	-	582	1712	2752	0.6220930
C9	52975041	52978283	BolC9t58527H	0	-	624	2833	3242	0.8738433
C9	53008355	53010185	BolC9t58528H	0	+	195	1398	1830	0.7639344
C9	53017721	53019524	BolC9t58529H	0	+	1302	1803	1803	1.0000000
C9	53025648	53026595	BolC9t58530H	0	-	2	64	947	0.0675818
C9	53027311	53029956	BolC9t58531H	0	-	236	1380	2645	0.5217391
C9	53032978	53035339	BolC9t58532H	0	-	287	1434	2361	0.6073698
C9	53040708	53041923	BolC9t58533H	0	+	479	1215	1215	1.0000000
C9	53042282	53044244	BolC9t58534H	0	-	406	1747	1962	0.8904179
C9	53046189	53051911	BolC9t58535H	0	+	1936	3330	5722	0.5819644
C9	53054201	53054952	BolC9t58536H	0	-	78	445	751	0.5925433
C9	53057670	53058502	BolC9t58537H	0	-	154	832	832	1.0000000
C9	53059216	53061252	BolC9t58538H	0	-	279	1956	2036	0.9607072
C9	53062604	53064859	BolC9t58539H	0	+	606	2063	2255	0.9148559
C9	53070847	53072458	BolC9t58540H	0	-	763	1603	1611	0.9950342
C9	53074714	53075361	BolC9t58541H	0	+	365	647	647	1.0000000
C9	53077191	53082062	BolC9t58542H	0	+	2027	4448	4871	0.9131595
C9	53083353	53085258	BolC9t58543H	0	+	537	1707	1905	0.8960630
C9	53085645	53089672	BolC9t58544H	0	-	2635	3956	4027	0.9823690
C9	53091447	53097391	BolC9t58545H	0	-	5673	5396	5944	0.9078062
C9	53098869	53100952	BolC9t58546H	0	+	2266	2083	2083	1.0000000
C9	53101477	53103651	BolC9t58547H	0	-	1325	2174	2174	1.0000000
C9	53114173	53114935	BolC9t58548H	0	+	117	742	762	0.9737533
C9	53116953	53124010	BolC9t58549H	0	+	1315	4941	7057	0.7001559
C9	53129652	53130683	BolC9t58550H	0	+	260	1031	1031	1.0000000
C9	53142218	53157881	BolC9t58551H	0	+	3362	6917	15663	0.4416140
C9	53160277	53161304	BolC9t58552H	0	+	383	1027	1027	1.0000000
C9	53164131	53164404	BolC9t58553H	0	+	55	263	273	0.9633700
C9	53170061	53170520	BolC9t58554H	0	-	62	433	459	0.9433551
C9	53175135	53175615	BolC9t58555H	0	-	2	31	480	0.0645833
C9	53186520	53197400	BolC9t58556H	0	+	1021	4070	10880	0.3740809
C9	53202214	53204871	BolC9t58557H	0	-	491	1663	2657	0.6258939
C9	53225975	53226362	BolC9t58558H	0	+	64	333	387	0.8604651
C9	53231117	53231797	BolC9t58559H	0	-	544	680	680	1.0000000
C9	53234677	53237062	BolC9t58560H	0	-	1345	1863	2385	0.7811321
C9	53242406	53242669	BolC9t58561H	0	-	375	242	263	0.9201521
C9	53257591	53258593	BolC9t58562H	0	-	121	707	1002	0.7055888
C9	53259639	53261230	BolC9t58563H	0	+	68	100	1591	0.0628536
C9	53265716	53268608	BolC9t58564H	0	-	1832	2892	2892	1.0000000
C9	53269365	53269917	BolC9t58565H	0	-	432	552	552	1.0000000
C9	53278538	53278949	BolC9t58566H	0	-	129	411	411	1.0000000
C9	53279376	53280070	BolC9t58567H	0	-	359	694	694	1.0000000
C9	53280096	53280216	BolC9t58568H	0	-	65	120	120	1.0000000
C9	53284461	53285298	BolC9t58569H	0	+	99	584	837	0.6977300
C9	53301690	53304463	BolC9t58570H	0	+	793	2412	2773	0.8698161
C9	53304747	53311145	BolC9t58571H	0	-	582	4085	6398	0.6384808
C9	53312234	53312600	BolC9t58572H	0	-	59	366	366	1.0000000
C9	53314106	53316549	BolC9t58573H	0	-	898	2381	2443	0.9746214
C9	53323310	53324867	BolC9t58574H	0	-	203	1422	1557	0.9132948
C9	53329150	53331617	BolC9t58575H	0	-	1753	2298	2467	0.9314957
C9	53336672	53337050	BolC9t58576H	0	+	0	0	378	0.0000000
C9	53341600	53344405	BolC9t58577H	0	+	1945	2805	2805	1.0000000
C9	53344633	53345785	BolC9t58578H	0	-	357	1110	1152	0.9635417
C9	53347770	53348612	BolC9t58579H	0	+	1173	842	842	1.0000000
C9	53352119	53353007	BolC9t58580H	0	-	611	888	888	1.0000000
C9	53363252	53363618	BolC9t58581H	0	+	393	366	366	1.0000000
C9	53368789	53370347	BolC9t58582H	0	+	391	1028	1558	0.6598203
C9	53404422	53404662	BolC9t58583H	0	+	319	240	240	1.0000000
C9	53412601	53433847	BolC9t58584H	0	+	15696	21000	21246	0.9884213
C9	53431570	53453008	BolC9t58585H	0	+	12554	20209	21438	0.9426719
C9	53435445	53435772	BolC9t58586H	0	+	310	327	327	1.0000000
C9	53437342	53438905	BolC9t58587H	0	-	209	1435	1563	0.9181062
C9	53444818	53446134	BolC9t58588H	0	+	832	1316	1316	1.0000000
C9	53449046	53449538	BolC9t58589H	0	+	617	492	492	1.0000000
C9	53453753	53453936	BolC9t58590H	0	+	86	183	183	1.0000000
C9	53457763	53458316	BolC9t58591H	0	-	22	271	553	0.4900542
C9	53461133	53461437	BolC9t58592H	0	+	115	304	304	1.0000000
C9	53461668	53462385	BolC9t58593H	0	+	374	717	717	1.0000000
C9	53464187	53464409	BolC9t58594H	0	-	205	222	222	1.0000000
C9	53464847	53465875	BolC9t58595H	0	+	67	679	1028	0.6605058
C9	53466006	53466224	BolC9t58596H	0	+	224	218	218	1.0000000
C9	53485148	53488731	BolC9t58597H	0	+	1782	3467	3583	0.9676249
C9	53487354	53487773	BolC9t58598H	0	-	38	345	419	0.8233890
C9	53493513	53494380	BolC9t58599H	0	-	458	846	867	0.9757785
C9	53513639	53516301	BolC9t58600H	0	-	1255	2328	2662	0.8745304
C9	53531970	53532608	BolC9t58601H	0	-	201	638	638	1.0000000
C9	53541471	53542198	BolC9t58602H	0	+	352	727	727	1.0000000
C9	53550482	53553931	BolC9t58603H	0	+	1051	3449	3449	1.0000000
C9	53555801	53600250	BolC9t58604H	0	-	18081	34059	44449	0.7662489
C9	53560581	53562386	BolC9t58605H	0	+	1373	1805	1805	1.0000000
C9	53562503	53562812	BolC9t58606H	0	-	216	309	309	1.0000000
C9	53573467	53573848	BolC9t58607H	0	-	477	381	381	1.0000000
C9	53578445	53580212	BolC9t58608H	0	-	456	1760	1767	0.9960385
C9	53586668	53587156	BolC9t58609H	0	+	160	468	488	0.9590164
C9	53600960	53602971	BolC9t58610H	0	-	1063	2011	2011	1.0000000
C9	53606604	53608302	BolC9t58611H	0	-	524	1625	1698	0.9570082
C9	53614747	53616945	BolC9t58612H	0	-	793	2062	2198	0.9381256
C9	53661234	53662239	BolC9t58613H	0	+	256	973	1005	0.9681592
C9	53669374	53673269	BolC9t58614H	0	+	2689	3734	3895	0.9586650
C9	53677247	53679679	BolC9t58615H	0	+	1145	2432	2432	1.0000000
C9	53680145	53682298	BolC9t58616H	0	-	1390	2153	2153	1.0000000
C9	53696137	53697082	BolC9t58617H	0	+	598	945	945	1.0000000
C9	53697437	53702892	BolC9t58618H	0	-	365	997	5455	0.1827681
C9	53710524	53733026	BolC9t58619H	0	+	6316	18855	22502	0.8379255
C9	53711650	53712178	BolC9t58620H	0	-	352	528	528	1.0000000
C9	53724723	53726187	BolC9t58621H	0	-	889	1464	1464	1.0000000
C9	53733438	53734188	BolC9t58622H	0	+	92	735	750	0.9800000
C9	53734500	53735007	BolC9t58623H	0	-	358	507	507	1.0000000
C9	53735077	53735503	BolC9t58624H	0	-	334	426	426	1.0000000
C9	53736999	53737891	BolC9t58625H	0	+	428	892	892	1.0000000
C9	53739097	53739304	BolC9t58626H	0	+	492	207	207	1.0000000
C9	53757024	53758524	BolC9t58627H	0	+	829	1500	1500	1.0000000
C9	53758899	53760908	BolC9t58628H	0	-	1184	2009	2009	1.0000000
C9	53793578	53794619	BolC9t58629H	0	+	194	1037	1041	0.9961575
C9	53809315	53810974	BolC9t58630H	0	+	278	1647	1659	0.9927667
C9	53811359	53816790	BolC9t58631H	0	-	2194	4691	5431	0.8637452
C9	53823648	53823837	BolC9t58632H	0	-	429	189	189	1.0000000
C9	53824903	53827924	BolC9t58633H	0	-	1226	2969	3021	0.9827871
C9	53841814	53845861	BolC9t58634H	0	-	1639	3844	4047	0.9498394
C9	53859049	53859292	BolC9t58635H	0	+	0	0	243	0.0000000
C9	53875019	53875403	BolC9t58636H	0	+	54	279	384	0.7265625
C9	53875848	53876055	BolC9t58637H	0	+	34	177	207	0.8550724
C9	53876294	53876917	BolC9t58638H	0	+	0	0	623	0.0000000
C9	53880884	53881285	BolC9t58639H	0	+	10	271	401	0.6758105
C9	53881853	53882422	BolC9t58640H	0	-	318	569	569	1.0000000
C9	53883063	53883240	BolC9t58641H	0	+	91	177	177	1.0000000
C9	53884303	53886850	BolC9t58642H	0	-	335	1925	2547	0.7557911
C9	53889535	53891293	BolC9t58643H	0	-	543	1647	1758	0.9368601
C9	53893518	53894133	BolC9t58644H	0	-	288	615	615	1.0000000
C9	53896959	53902312	BolC9t58645H	0	+	548	3534	5353	0.6601905
C9	53905186	53905594	BolC9t58646H	0	+	3	128	408	0.3137255
C9	53912220	53914031	BolC9t58647H	0	+	660	1607	1811	0.8873550
C9	53932131	53934048	BolC9t58648H	0	-	796	1716	1917	0.8951487
C9	53936862	53937027	BolC9t58649H	0	+	125	165	165	1.0000000
C9	53937458	53938724	BolC9t58650H	0	+	600	1199	1266	0.9470774
C9	53939103	53941165	BolC9t58651H	0	-	1014	2062	2062	1.0000000
C9	53943707	53950308	BolC9t58652H	0	-	3221	6336	6601	0.9598545
C9	53951054	53957037	BolC9t58653H	0	+	2390	4501	5983	0.7522982
C9	53957600	53959867	BolC9t58654H	0	-	617	2109	2267	0.9303043
C9	54003536	54003791	BolC9t58655H	0	-	80	255	255	1.0000000
C9	54011313	54011622	BolC9t58656H	0	+	66	286	309	0.9255663
C9	54014406	54017948	BolC9t58657H	0	+	2639	3542	3542	1.0000000
C9	54018337	54021503	BolC9t58658H	0	-	1486	3128	3166	0.9879975
C9	54055707	54056718	BolC9t58659H	0	+	5	176	1011	0.1740851
C9	54058943	54060955	BolC9t58660H	0	-	1026	1946	2012	0.9671968
C9	54067256	54067734	BolC9t58661H	0	+	1541	478	478	1.0000000
C9	54071971	54073780	BolC9t58662H	0	-	897	1788	1809	0.9883914
C9	54074084	54080729	BolC9t58663H	0	+	843	4341	6645	0.6532732
C9	54081360	54082689	BolC9t58664H	0	-	277	942	1329	0.7088036
C9	54113811	54114618	BolC9t58665H	0	+	43	434	807	0.5377943
C9	54116736	54117913	BolC9t58666H	0	-	135	1095	1177	0.9303313
C9	54118415	54120781	BolC9t58667H	0	+	401	1662	2366	0.7024514
C9	54125783	54127784	BolC9t58668H	0	-	362	1627	2001	0.8130934
C9	54130246	54132018	BolC9t58669H	0	+	646	1042	1772	0.5880361
C9	54149879	54151529	BolC9t58670H	0	+	21	792	1650	0.4800000
C9	54155021	54155627	BolC9t58671H	0	+	4	154	606	0.2541254
C9	54163774	54166223	BolC9t58672H	0	-	49	564	2449	0.2302981
C9	54173843	54174735	BolC9t58673H	0	-	275	643	892	0.7208520
C9	54194246	54195392	BolC9t58674H	0	+	2	250	1146	0.2181501
C9	54195931	54196243	BolC9t58675H	0	+	50	304	312	0.9743590
C9	54196385	54196937	BolC9t58676H	0	-	0	0	552	0.0000000
C9	54197804	54199691	BolC9t58677H	0	+	21	281	1887	0.1489136
C9	54205805	54208141	BolC9t58678H	0	-	57	814	2336	0.3484589
C9	54213230	54215309	BolC9t58679H	0	-	754	1868	2079	0.8985089
C9	54215753	54216273	BolC9t58680H	0	-	124	491	520	0.9442308
C9	54239480	54240032	BolC9t58681H	0	-	0	0	552	0.0000000
C9	54240706	54242370	BolC9t58682H	0	+	18	652	1664	0.3918269
C9	54248448	54249560	BolC9t58683H	0	-	53	729	1112	0.6555755
C9	54250954	54251637	BolC9t58684H	0	-	409	683	683	1.0000000
C9	54252641	54256031	BolC9t58685H	0	-	625	2744	3390	0.8094395
C9	54257479	54259351	BolC9t58686H	0	-	1059	1872	1872	1.0000000
C9	54259455	54260181	BolC9t58687H	0	-	617	726	726	1.0000000
C9	54261254	54261722	BolC9t58688H	0	+	279	468	468	1.0000000
C9	54279489	54280056	BolC9t58689H	0	+	54	510	567	0.8994709
C9	54280785	54283224	BolC9t58690H	0	-	707	2321	2439	0.9516195
C9	54284116	54287549	BolC9t58691H	0	+	593	3157	3433	0.9196038
C9	54293226	54293562	BolC9t58692H	0	-	200	336	336	1.0000000
C9	54293961	54304425	BolC9t58693H	0	+	13945	9279	10464	0.8867546
C9	54305394	54305835	BolC9t58694H	0	+	154	441	441	1.0000000
C9	54319385	54319757	BolC9t58695H	0	+	0	0	372	0.0000000
C9	54329077	54331978	BolC9t58696H	0	+	116	966	2901	0.3329886
C9	54341827	54346790	BolC9t58697H	0	+	161	2475	4963	0.4986903
C9	54350798	54352020	BolC9t58698H	0	-	0	0	1222	0.0000000
C9	54355653	54355845	BolC9t58699H	0	-	15	192	192	1.0000000
C9	54360627	54362407	BolC9t58700H	0	+	631	1780	1780	1.0000000
C9	54366408	54430444	BolC9t58701H	0	+	22366	43988	64036	0.6869261
C9	54369534	54405027	BolC9t58702H	0	+	16617	29655	35493	0.8355169
C9	54407413	54422172	BolC9t58703H	0	+	2769	6998	14759	0.4741514
C9	54422201	54422976	BolC9t58704H	0	+	0	0	775	0.0000000
C9	54455240	54456833	BolC9t58705H	0	+	867	1593	1593	1.0000000
C9	54463242	54463926	BolC9t58706H	0	-	306	396	684	0.5789474
C9	54466814	54467057	BolC9t58707H	0	-	11	41	243	0.1687243
C9	54474667	54476288	BolC9t58708H	0	+	247	1332	1621	0.8217150
C9	54507687	54510493	BolC9t58709H	0	+	320	2210	2806	0.7875980
C9	54527233	54527335	BolC9t58710H	0	+	0	0	102	0.0000000
C9	54528041	54528434	BolC9t58711H	0	+	12	199	393	0.5063613
C9	54542390	54544057	BolC9t58712H	0	+	80	1072	1667	0.6430714
C9	54548886	54550138	BolC9t58713H	0	+	323	1230	1252	0.9824281
C9	54551118	54552652	BolC9t58714H	0	-	505	1471	1534	0.9589309
C9	54556855	54558683	BolC9t58715H	0	+	1872	1828	1828	1.0000000
C9	54559962	54560364	BolC9t58716H	0	+	0	0	402	0.0000000
C9	54567528	54572706	BolC9t58717H	0	+	1343	4884	5178	0.9432213
C9	54573428	54575019	BolC9t58718H	0	+	560	1506	1591	0.9465745
C9	54575178	54576042	BolC9t58719H	0	-	360	864	864	1.0000000
C9	54577186	54578451	BolC9t58720H	0	-	455	1265	1265	1.0000000
C9	54579959	54583076	BolC9t58721H	0	+	893	2731	3117	0.8761630
C9	54583748	54584475	BolC9t58722H	0	+	608	727	727	1.0000000
C9	54584764	54586817	BolC9t58723H	0	-	1295	2053	2053	1.0000000
C9	54590517	54590883	BolC9t58724H	0	+	182	364	366	0.9945355
C9	54590940	54591391	BolC9t58725H	0	+	991	357	451	0.7915743
C9	54599705	54600027	BolC9t58726H	0	+	356	322	322	1.0000000
C9	54600332	54601991	BolC9t58727H	0	-	1252	1618	1659	0.9752863
C9	54602799	54638966	BolC9t58728H	0	-	5114	22590	36167	0.6246026
C9	54625957	54626983	BolC9t58729H	0	-	88	914	1026	0.8908382
C9	54639761	54641047	BolC9t58730H	0	-	1123	1286	1286	1.0000000
C9	54646082	54648425	BolC9t58731H	0	+	1075	1397	2343	0.5962442
C9	54648902	54650386	BolC9t58732H	0	-	2092	1484	1484	1.0000000
C9	54651071	54659863	BolC9t58733H	0	+	1717	4539	8792	0.5162648
C9	54660582	54661878	BolC9t58734H	0	-	461	1120	1296	0.8641976
C9	54664203	54664500	BolC9t58735H	0	-	69	297	297	1.0000000
C9	54665527	54667234	BolC9t58736H	0	-	248	1605	1707	0.9402460
C9	54667999	54668278	BolC9t58737H	0	+	103	251	279	0.8996416
C9	54669128	54669425	BolC9t58738H	0	-	26	279	297	0.9393939
C9	54670704	54670902	BolC9t58739H	0	-	86	198	198	1.0000000
C9	54679284	54679578	BolC9t58740H	0	-	148	294	294	1.0000000
C9	54680750	54681044	BolC9t58741H	0	-	83	294	294	1.0000000
C9	54681850	54682142	BolC9t58742H	0	+	3	178	292	0.6095890
C9	54683077	54683356	BolC9t58743H	0	-	20	279	279	1.0000000
C9	54684517	54684799	BolC9t58744H	0	+	63	282	282	1.0000000
C9	54686035	54686329	BolC9t58745H	0	+	96	269	294	0.9149660
C9	54689850	54692127	BolC9t58746H	0	-	1166	2277	2277	1.0000000
C9	54692941	54696097	BolC9t58747H	0	-	613	2979	3156	0.9439163
C9	54700773	54700950	BolC9t58748H	0	+	228	177	177	1.0000000
C9	54703861	54704203	BolC9t58749H	0	+	309	342	342	1.0000000
C9	54707079	54710615	BolC9t58750H	0	+	1861	3536	3536	1.0000000
C9	54711524	54727653	BolC9t58751H	0	+	2004	7539	16129	0.4674189
C9	54725220	54726108	BolC9t58752H	0	+	198	327	888	0.3682432
C9	54728668	54731064	BolC9t58753H	0	-	126	1622	2396	0.6769616
C9	54735981	54740595	BolC9t58754H	0	-	1839	4359	4614	0.9447334
C9	54757142	54757436	BolC9t58755H	0	-	91	294	294	1.0000000
C9	54766895	54767316	BolC9t58756H	0	-	232	421	421	1.0000000
C9	54779432	54779612	BolC9t58757H	0	-	144	180	180	1.0000000
C9	54782630	54783224	BolC9t58758H	0	-	363	594	594	1.0000000
C9	54784267	54785798	BolC9t58759H	0	-	352	1512	1531	0.9875898
C9	54793145	54795929	BolC9t58760H	0	-	2009	2784	2784	1.0000000
C9	54796037	54802811	BolC9t58761H	0	-	1140	3598	6774	0.5311485
C9	54814828	54820147	BolC9t58762H	0	+	3041	5254	5319	0.9877797
C9	54820648	54820942	BolC9t58763H	0	-	171	294	294	1.0000000
C9	54827135	54830083	BolC9t58764H	0	+	1699	2948	2948	1.0000000
C9	54830574	54830907	BolC9t58765H	0	-	41	250	333	0.7507508
C9	54832178	54832953	BolC9t58766H	0	+	0	0	775	0.0000000
C9	54849738	54851466	BolC9t58767H	0	+	65	1290	1728	0.7465278
C9	54852905	54854531	BolC9t58768H	0	-	584	1626	1626	1.0000000
C9	54861576	54863706	BolC9t58769H	0	-	937	2069	2130	0.9713615
C9	54880532	54880661	BolC9t58770H	0	+	95	129	129	1.0000000
C9	54880835	54881245	BolC9t58771H	0	+	240	410	410	1.0000000
C9	54886119	54887117	BolC9t58772H	0	+	110	534	998	0.5350701
C9	54889491	54891374	BolC9t58773H	0	-	109	1130	1883	0.6001062
C9	54896038	54898540	BolC9t58774H	0	-	521	2045	2502	0.8173461
C9	54900920	54903485	BolC9t58775H	0	+	1324	2534	2565	0.9879142
C9	54905233	54905877	BolC9t58776H	0	-	266	644	644	1.0000000
C9	54909126	54911885	BolC9t58777H	0	-	919	2699	2759	0.9782530
C9	54911913	54912021	BolC9t58778H	0	-	62	108	108	1.0000000
C9	54912627	54916685	BolC9t58779H	0	+	1305	4007	4058	0.9874322
C9	54919199	54920853	BolC9t58780H	0	+	227	1331	1654	0.8047158
C9	54921820	54924297	BolC9t58781H	0	+	351	2252	2477	0.9091643
C9	54929025	54929271	BolC9t58782H	0	+	252	246	246	1.0000000
C9	54930108	54931692	BolC9t58783H	0	-	499	1584	1584	1.0000000
C9	54953755	54955648	BolC9t58784H	0	+	981	1889	1893	0.9978870
C9	55004781	55007373	BolC9t58785H	0	+	658	2064	2592	0.7962963
C9	55009879	55011807	BolC9t58786H	0	+	792	1928	1928	1.0000000
C9	55012299	55012506	BolC9t58787H	0	-	216	207	207	1.0000000
C9	55021594	55023357	BolC9t58788H	0	+	956	1763	1763	1.0000000
C9	55024059	55024786	BolC9t58789H	0	+	216	460	727	0.6327373
C9	55029821	55031347	BolC9t58790H	0	-	541	1526	1526	1.0000000
C9	55047095	55048495	BolC9t58791H	0	+	86	844	1400	0.6028572
C9	55048731	55049937	BolC9t58792H	0	-	114	899	1206	0.7454395
C9	55051350	55104102	BolC9t58793H	0	+	4193	10482	52752	0.1987034
C9	55104335	55105274	BolC9t58794H	0	-	64	524	939	0.5580404
C9	55108179	55108326	BolC9t58795H	0	+	82	147	147	1.0000000
C9	55114148	55114727	BolC9t58796H	0	+	99	505	579	0.8721935
C9	55115220	55119169	BolC9t58797H	0	-	309	2666	3949	0.6751076
C9	55132709	55133860	BolC9t58798H	0	-	564	1151	1151	1.0000000
C9	55140341	55140702	BolC9t58799H	0	+	282	361	361	1.0000000
C9	55147946	55149374	BolC9t58800H	0	+	992	1428	1428	1.0000000
C9	55162363	55164583	BolC9t58801H	0	+	1714	2220	2220	1.0000000
C9	55165004	55166655	BolC9t58802H	0	+	619	1515	1651	0.9176257
C9	55168049	55170623	BolC9t58803H	0	-	122	1308	2574	0.5081585
C9	55172586	55174164	BolC9t58804H	0	+	304	1497	1578	0.9486692
C9	55176403	55176655	BolC9t58805H	0	-	272	252	252	1.0000000
C9	55178914	55184725	BolC9t58806H	0	+	2316	4253	5811	0.7318878
C9	55185949	55186330	BolC9t58807H	0	+	428	381	381	1.0000000
C9	55187424	55188858	BolC9t58808H	0	-	50	613	1434	0.4274756
C9	55192692	55196409	BolC9t58809H	0	-	1822	3320	3717	0.8931934
C9	55204418	55205229	BolC9t58810H	0	+	3	83	811	0.1023428
C9	55206326	55209508	BolC9t58811H	0	+	1017	2676	3182	0.8409805
C9	55210101	55210509	BolC9t58812H	0	-	355	408	408	1.0000000
C9	55216085	55216721	BolC9t58813H	0	-	247	636	636	1.0000000
C9	55217992	55218474	BolC9t58814H	0	+	169	482	482	1.0000000
C9	55228629	55233771	BolC9t58815H	0	-	3355	4854	5142	0.9439906
C9	55234350	55235674	BolC9t58816H	0	+	320	1312	1324	0.9909366
C9	55235862	55236877	BolC9t58817H	0	-	117	659	1015	0.6492611
C9	55239083	55240862	BolC9t58818H	0	+	272	1595	1779	0.8965711
C9	55250447	55250963	BolC9t58819H	0	-	170	516	516	1.0000000
C9	55252281	55252836	BolC9t58820H	0	-	54	273	555	0.4918919
C9	55262536	55262815	BolC9t58821H	0	+	0	0	279	0.0000000
C9	55271641	55272052	BolC9t58822H	0	+	69	405	411	0.9854015
C9	55272781	55276489	BolC9t58823H	0	-	1132	3413	3708	0.9204423
C9	55289322	55295144	BolC9t58824H	0	+	568	3925	5822	0.6741670
C9	55304145	55305952	BolC9t58825H	0	+	767	1807	1807	1.0000000
C9	55306503	55308865	BolC9t58826H	0	+	1880	2302	2362	0.9745978
C9	55309085	55309484	BolC9t58827H	0	-	175	399	399	1.0000000
C9	55309705	55314918	BolC9t58828H	0	-	1779	5181	5213	0.9938615
C9	55317512	55320778	BolC9t58829H	0	+	1377	2923	3266	0.8949786
C9	55337239	55341482	BolC9t58830H	0	+	2928	4243	4243	1.0000000
C9	55356838	55358893	BolC9t58831H	0	+	1368	2055	2055	1.0000000
C9	55359462	55360307	BolC9t58832H	0	-	492	845	845	1.0000000
C9	55374524	55375693	BolC9t58833H	0	-	1014	1122	1169	0.9597947
C9	55390529	55390664	BolC9t58834H	0	+	123	135	135	1.0000000
C9	55393337	55395278	BolC9t58835H	0	+	953	1804	1941	0.9294178
C9	55395468	55395864	BolC9t58836H	0	-	69	376	396	0.9494950
C9	55401364	55401778	BolC9t58837H	0	-	186	414	414	1.0000000
C9	55402047	55403329	BolC9t58838H	0	-	674	1252	1282	0.9765990
C9	55405552	55408147	BolC9t58839H	0	+	2206	2544	2595	0.9803468
C9	55409214	55410238	BolC9t58840H	0	+	691	985	1024	0.9619141
C9	55411871	55412618	BolC9t58841H	0	+	33	252	747	0.3373494
C9	55413017	55414738	BolC9t58842H	0	-	1034	1587	1721	0.9221383
C9	55418986	55419133	BolC9t58843H	0	+	358	147	147	1.0000000
C9	55422759	55423179	BolC9t58844H	0	+	43	154	420	0.3666667
C9	55429718	55430144	BolC9t58845H	0	+	4	288	426	0.6760563
C9	55430623	55432246	BolC9t58846H	0	-	669	1344	1623	0.8280961
C9	55434620	55442244	BolC9t58847H	0	-	1703	5755	7624	0.7548531
C9	55446585	55448120	BolC9t58848H	0	+	663	1444	1535	0.9407166
C9	55448502	55450328	BolC9t58849H	0	-	407	1678	1826	0.9189485
C9	55450416	55451470	BolC9t58850H	0	-	351	918	1054	0.8709677
C9	55452328	55456536	BolC9t58851H	0	-	1090	3827	4208	0.9094582
C9	55458093	55460313	BolC9t58852H	0	-	1300	2209	2220	0.9950451
C9	55464968	55466435	BolC9t58853H	0	-	581	1463	1467	0.9972733
C9	55468032	55469508	BolC9t58854H	0	+	1298	1476	1476	1.0000000
C9	55470402	55472955	BolC9t58855H	0	-	940	2553	2553	1.0000000
C9	55473413	55479846	BolC9t58856H	0	+	1775	6161	6433	0.9577180
C9	55480007	55482115	BolC9t58857H	0	-	1555	2063	2108	0.9786528
C9	55483080	55484784	BolC9t58858H	0	+	596	1524	1704	0.8943662
C9	55485679	55487662	BolC9t58859H	0	+	1050	1983	1983	1.0000000
C9	55488091	55490276	BolC9t58860H	0	-	1025	2185	2185	1.0000000
C9	55491290	55492782	BolC9t58861H	0	+	983	1492	1492	1.0000000
C9	55496815	55500663	BolC9t58862H	0	+	311	2403	3848	0.6244802
C9	55501997	55505031	BolC9t58863H	0	-	606	2650	3034	0.8734344
C9	55519918	55520878	BolC9t58864H	0	-	136	399	960	0.4156250
C9	55521459	55525955	BolC9t58865H	0	+	600	3442	4496	0.7655694
C9	55526573	55534393	BolC9t58866H	0	-	1439	6335	7820	0.8101023
C9	55534890	55537520	BolC9t58867H	0	-	521	2466	2630	0.9376426
C9	55538972	55541469	BolC9t58868H	0	-	981	2288	2497	0.9162996
C9	55543512	55551803	BolC9t58869H	0	-	2214	7503	8291	0.9049572
C9	55552209	55554365	BolC9t58870H	0	+	838	2071	2156	0.9605752
C9	55566756	55567394	BolC9t58871H	0	-	0	0	638	0.0000000
C9	55572050	55572777	BolC9t58872H	0	-	71	522	727	0.7180192
C9	55596255	55598473	BolC9t58873H	0	-	65	1055	2218	0.4756537
C9	55599110	55599908	BolC9t58874H	0	-	20	430	798	0.5388471
C9	55604747	55607464	BolC9t58875H	0	-	629	1908	2717	0.7022451
C9	55608075	55608666	BolC9t58876H	0	-	5	184	591	0.3113367
C9	55619396	55624471	BolC9t58877H	0	-	1277	4312	5075	0.8496552
C9	55625783	55630741	BolC9t58878H	0	+	1154	3864	4958	0.7793465
C9	55631077	55632214	BolC9t58879H	0	+	663	1137	1137	1.0000000
C9	55632709	55634155	BolC9t58880H	0	+	1254	1446	1446	1.0000000
C9	55635113	55636619	BolC9t58881H	0	-	549	1506	1506	1.0000000
C9	55638030	55641499	BolC9t58882H	0	-	1308	3414	3469	0.9841453
C9	55642007	55644937	BolC9t58883H	0	-	2386	2930	2930	1.0000000
C9	55650432	55653387	BolC9t58884H	0	+	1250	2937	2955	0.9939086
C9	55659235	55661219	BolC9t58885H	0	-	152	1023	1984	0.5156250
C9	55687025	55687268	BolC9t58886H	0	-	39	243	243	1.0000000
C9	55691036	55692073	BolC9t58887H	0	-	299	1015	1037	0.9787850
C9	55694288	55696288	BolC9t58888H	0	-	528	1841	2000	0.9205000
C9	55703413	55703689	BolC9t58889H	0	+	266	276	276	1.0000000
C9	55706878	55709377	BolC9t58890H	0	+	745	2310	2499	0.9243698
C9	55713655	55716793	BolC9t58891H	0	+	264	2530	3138	0.8062460
C9	55718302	55718796	BolC9t58892H	0	+	370	494	494	1.0000000
C9	55733267	55738788	BolC9t58893H	0	+	2717	5205	5521	0.9427640
C9	55739472	55740412	BolC9t58894H	0	-	479	940	940	1.0000000
C9	55741286	55743218	BolC9t58895H	0	-	1419	1588	1932	0.8219461
C9	55749770	55750817	BolC9t58896H	0	-	697	938	1047	0.8958930
C9	55752267	55754064	BolC9t58897H	0	-	357	1530	1797	0.8514190
C9	55759263	55761436	BolC9t58898H	0	+	283	1936	2173	0.8909342
C9	55762777	55763407	BolC9t58899H	0	+	100	491	630	0.7793651
C9	55764629	55765829	BolC9t58900H	0	+	906	1200	1200	1.0000000
C9	55766109	55766646	BolC9t58901H	0	-	564	537	537	1.0000000
C9	55767780	55768092	BolC9t58902H	0	-	102	312	312	1.0000000
C9	55776534	55777369	BolC9t58903H	0	+	889	835	835	1.0000000
C9	55780276	55780591	BolC9t58904H	0	-	28	309	315	0.9809524
C9	55785120	55786081	BolC9t58905H	0	+	100	869	961	0.9042664
C9	55800345	55801330	BolC9t58906H	0	+	372	985	985	1.0000000
C9	55815708	55816063	BolC9t58907H	0	+	2	133	355	0.3746479
C9	55816989	55818327	BolC9t58908H	0	-	605	1338	1338	1.0000000
C9	55819421	55823330	BolC9t58909H	0	-	974	3248	3909	0.8309031
C9	55824377	55831995	BolC9t58910H	0	+	3106	5432	7618	0.7130480
C9	55832579	55833118	BolC9t58911H	0	+	118	451	539	0.8367347
C9	55835007	55842998	BolC9t58912H	0	+	2062	4794	7991	0.5999249
C9	55847944	55853651	BolC9t58913H	0	-	3722	5414	5707	0.9486595
C9	55854688	55858472	BolC9t58914H	0	-	2118	3724	3784	0.9841437
C9	55859064	55859619	BolC9t58915H	0	+	90	465	555	0.8378378
C9	55859587	55862718	BolC9t58916H	0	-	1572	3048	3131	0.9734909
C9	55863147	55864152	BolC9t58917H	0	-	589	1005	1005	1.0000000
C9	55865457	55868446	BolC9t58918H	0	-	532	2362	2989	0.7902309
C9	55872483	55874016	BolC9t58919H	0	+	11	50	1533	0.0326158
C9	55878843	55880821	BolC9t58920H	0	+	547	1854	1978	0.9373104
C9	55881486	55884135	BolC9t58921H	0	+	770	2221	2649	0.8384296
C9	55885796	55886294	BolC9t58922H	0	+	140	498	498	1.0000000
C9	55897286	55900179	BolC9t58923H	0	+	257	1475	2893	0.5098513
C9	55900660	55901061	BolC9t58924H	0	-	2	61	401	0.1521197
C9	55901066	55901829	BolC9t58925H	0	+	0	0	763	0.0000000
C9	55903485	55905110	BolC9t58926H	0	-	977	1471	1625	0.9052308
C9	55906155	55908899	BolC9t58927H	0	-	1358	2646	2744	0.9642857
C9	55910371	55911597	BolC9t58928H	0	+	699	1226	1226	1.0000000
C9	55912603	55913401	BolC9t58929H	0	-	333	798	798	1.0000000
C9	55914742	55916671	BolC9t58930H	0	-	250	1772	1929	0.9186107
C9	55921762	55922463	BolC9t58931H	0	+	208	701	701	1.0000000
C9	55924292	55926141	BolC9t58932H	0	+	453	1672	1849	0.9042726
C9	55926718	55929571	BolC9t58933H	0	+	1231	2784	2853	0.9758149
C9	55933692	55936486	BolC9t58934H	0	+	348	2359	2794	0.8443092
C9	55956375	55957164	BolC9t58935H	0	+	481	645	789	0.8174905
C9	55959128	55966232	BolC9t58936H	0	+	3117	5410	7104	0.7615428
C9	55966863	55969489	BolC9t58937H	0	+	594	2349	2626	0.8945163
C9	55979544	55980546	BolC9t58938H	0	+	322	958	1002	0.9560878
C9	55982160	55982905	BolC9t58939H	0	+	0	0	745	0.0000000
C9	55987413	55987746	BolC9t58940H	0	+	0	0	333	0.0000000
C9	55988673	55988970	BolC9t58941H	0	-	4	19	297	0.0639731
C9	55990034	55993277	BolC9t58942H	0	-	0	0	3243	0.0000000
C9	55996754	56000132	BolC9t58943H	0	+	3504	3265	3378	0.9665483
C9	56000404	56001323	BolC9t58944H	0	-	682	919	919	1.0000000
C9	56001685	56004167	BolC9t58945H	0	+	1265	2343	2482	0.9439968
C9	56004354	56006684	BolC9t58946H	0	-	1365	2330	2330	1.0000000
C9	56028878	56029031	BolC9t58947H	0	+	49	138	153	0.9019608
C9	56029364	56031870	BolC9t58948H	0	-	1254	2309	2506	0.9213887
C9	56032507	56033437	BolC9t58949H	0	-	328	930	930	1.0000000
C9	56041960	56045502	BolC9t58950H	0	-	1601	3542	3542	1.0000000
C9	56046761	56049277	BolC9t58951H	0	-	1019	2247	2516	0.8930843
C9	56063867	56065844	BolC9t58952H	0	-	861	1893	1977	0.9575114
C9	56066620	56067220	BolC9t58953H	0	-	364	600	600	1.0000000
C9	56070290	56071394	BolC9t58954H	0	-	361	1104	1104	1.0000000
C9	56085495	56085741	BolC9t58955H	0	-	200	246	246	1.0000000
C9	56087023	56091569	BolC9t58956H	0	+	1089	4261	4546	0.9373075
C9	56091748	56093266	BolC9t58957H	0	-	686	1460	1518	0.9617918
C9	56094227	56095097	BolC9t58958H	0	+	0	0	870	0.0000000
C9	56099264	56100153	BolC9t58959H	0	+	66	854	889	0.9606299
C9	56100441	56100954	BolC9t58960H	0	-	502	513	513	1.0000000
C9	56102088	56104764	BolC9t58961H	0	+	1687	2655	2676	0.9921525
C9	56127970	56128978	BolC9t58962H	0	+	706	1008	1008	1.0000000
C9	56138234	56139522	BolC9t58963H	0	+	667	1122	1288	0.8711180
C9	56141501	56141852	BolC9t58964H	0	+	79	351	351	1.0000000
C9	56143864	56144416	BolC9t58965H	0	-	143	552	552	1.0000000
C9	56161517	56161832	BolC9t58966H	0	+	654	315	315	1.0000000
C9	56165479	56166499	BolC9t58967H	0	-	1494	1020	1020	1.0000000
C9	56170867	56173685	BolC9t58968H	0	-	1735	2818	2818	1.0000000
C9	56174373	56175355	BolC9t58969H	0	+	520	960	982	0.9775968
C9	56180868	56183273	BolC9t58970H	0	+	845	2015	2405	0.8378378
C9	56183855	56184805	BolC9t58971H	0	-	617	950	950	1.0000000
C9	56184901	56185584	BolC9t58972H	0	-	308	683	683	1.0000000
C9	56188523	56189702	BolC9t58973H	0	+	190	1094	1179	0.9279050
C9	56190266	56190749	BolC9t58974H	0	+	157	483	483	1.0000000
C9	56190879	56191750	BolC9t58975H	0	-	251	792	871	0.9092997
C9	56194211	56194563	BolC9t58976H	0	-	131	352	352	1.0000000
C9	56196295	56196436	BolC9t58977H	0	-	261	141	141	1.0000000
C9	56202546	56204648	BolC9t58978H	0	+	574	1991	2102	0.9471931
C9	56206007	56207567	BolC9t58979H	0	-	856	1560	1560	1.0000000
C9	56209220	56209970	BolC9t58980H	0	-	94	594	750	0.7920000
C9	56211018	56211293	BolC9t58981H	0	+	220	182	275	0.6618182
C9	56212280	56217957	BolC9t58982H	0	+	3961	5677	5677	1.0000000
C9	56218333	56244308	BolC9t58983H	0	-	10669	16295	25975	0.6273340
C9	56245958	56247928	BolC9t58984H	0	-	339	1585	1970	0.8045685
C9	56247953	56248454	BolC9t58985H	0	-	184	258	501	0.5149701
C9	56251014	56251224	BolC9t58986H	0	-	16	210	210	1.0000000
C9	56254069	56255583	BolC9t58987H	0	-	273	1466	1514	0.9682959
C9	56261673	56262140	BolC9t58988H	0	-	189	467	467	1.0000000
C9	56271785	56272376	BolC9t58989H	0	+	228	591	591	1.0000000
C9	56272601	56276571	BolC9t58990H	0	-	1328	2838	3970	0.7148615
C9	56279234	56279540	BolC9t58991H	0	-	50	275	306	0.8986928
C9	56298373	56301590	BolC9t58992H	0	+	1536	3217	3217	1.0000000
C9	56308512	56311188	BolC9t58993H	0	+	1212	2664	2676	0.9955157
C9	56312923	56313287	BolC9t58994H	0	-	303	364	364	1.0000000
C9	56313872	56314148	BolC9t58995H	0	+	55	276	276	1.0000000
C9	56314473	56314757	BolC9t58996H	0	+	32	281	284	0.9894366
C9	56314881	56315693	BolC9t58997H	0	+	197	683	812	0.8411330
C9	56318152	56319009	BolC9t58998H	0	+	317	857	857	1.0000000
C9	56325155	56326474	BolC9t58999H	0	-	784	1319	1319	1.0000000
C9	56328756	56330605	BolC9t59000H	0	+	604	1782	1849	0.9637642
C9	56331388	56332362	BolC9t59001H	0	+	804	974	974	1.0000000
C9	56332527	56332773	BolC9t59002H	0	+	161	246	246	1.0000000
C9	56333726	56349016	BolC9t59003H	0	-	1681	7290	15290	0.4767822
C9	56353036	56362351	BolC9t59004H	0	+	2376	6845	9315	0.7348363
C9	56363166	56364626	BolC9t59005H	0	-	1365	1460	1460	1.0000000
C9	56371023	56373104	BolC9t59006H	0	+	652	1892	2081	0.9091783
C9	56375173	56377494	BolC9t59007H	0	+	413	2232	2321	0.9616545
C9	56378674	56379860	BolC9t59008H	0	-	179	494	1186	0.4165261
C9	56388679	56392387	BolC9t59009H	0	+	1253	3446	3708	0.9293420
C9	56401492	56404742	BolC9t59010H	0	+	1012	2955	3250	0.9092308
C9	56405560	56410671	BolC9t59011H	0	+	1877	4335	5111	0.8481706
C9	56411060	56412458	BolC9t59012H	0	-	429	1379	1398	0.9864091
C9	56413729	56417247	BolC9t59013H	0	+	741	3412	3518	0.9698693
C9	56417526	56418973	BolC9t59014H	0	-	431	1311	1447	0.9060124
C9	56421303	56427210	BolC9t59015H	0	-	1972	5093	5907	0.8621974
C9	56429181	56429652	BolC9t59016H	0	-	490	471	471	1.0000000
C9	56434047	56435975	BolC9t59017H	0	-	124	1317	1928	0.6830913
C9	56436728	56437883	BolC9t59018H	0	-	339	1058	1155	0.9160173
C9	56444117	56445284	BolC9t59019H	0	+	151	1156	1167	0.9905741
C9	56450546	56452160	BolC9t59020H	0	+	931	1614	1614	1.0000000
C9	56452433	56452867	BolC9t59021H	0	-	434	434	434	1.0000000
C9	56453513	56456537	BolC9t59022H	0	-	2931	3010	3024	0.9953704
C9	56459183	56460288	BolC9t59023H	0	-	1229	1105	1105	1.0000000
C9	56470818	56471484	BolC9t59024H	0	+	375	666	666	1.0000000
C9	56472315	56477569	BolC9t59025H	0	+	522	4480	5254	0.8526837
C9	56482960	56483506	BolC9t59026H	0	-	0	0	546	0.0000000
C9	56494393	56494870	BolC9t59027H	0	+	47	314	477	0.6582809
C9	56497019	56523578	BolC9t59028H	0	-	3464	14213	26559	0.5351481
C9	56515270	56516987	BolC9t59029H	0	+	106	1261	1717	0.7344205
C9	56526466	56526788	BolC9t59030H	0	-	54	260	322	0.8074534
C9	56530025	56531615	BolC9t59031H	0	+	526	1136	1590	0.7144654
C9	56532912	56533704	BolC9t59032H	0	+	41	330	792	0.4166667
C9	56534567	56535452	BolC9t59033H	0	+	255	832	885	0.9401130
C9	56536967	56537282	BolC9t59034H	0	+	217	315	315	1.0000000
C9	56540979	56542627	BolC9t59035H	0	-	126	617	1648	0.3743932
C9	56558532	56559584	BolC9t59036H	0	+	12	399	1052	0.3792776
C9	56577503	56581374	BolC9t59037H	0	+	711	2644	3871	0.6830276
C9	56584826	56586883	BolC9t59038H	0	-	170	1688	2057	0.8206125
C9	56587387	56590023	BolC9t59039H	0	-	211	1972	2636	0.7481032
C9	56596489	56596684	BolC9t59040H	0	-	68	195	195	1.0000000
C9	56600084	56602072	BolC9t59041H	0	+	2	235	1988	0.1182093
C9	56617437	56623066	BolC9t59042H	0	-	1694	5171	5629	0.9186357
C9	56619259	56620243	BolC9t59043H	0	+	449	908	984	0.9227642
C9	56629951	56630607	BolC9t59044H	0	+	9	225	656	0.3429878
C9	56639042	56640937	BolC9t59045H	0	-	206	1321	1895	0.6970976
C9	56642817	56644888	BolC9t59046H	0	+	355	1039	2071	0.5016900
C9	56645903	56647387	BolC9t59047H	0	+	872	1484	1484	1.0000000
C9	56648097	56667595	BolC9t59048H	0	-	9040	18619	19498	0.9549184
C9	56651471	56652672	BolC9t59049H	0	+	777	1201	1201	1.0000000
C9	56673959	56674298	BolC9t59050H	0	-	185	339	339	1.0000000
C9	56677223	56677478	BolC9t59051H	0	-	265	255	255	1.0000000
C9	56687292	56688934	BolC9t59052H	0	+	409	1642	1642	1.0000000
C9	56690573	56693545	BolC9t59053H	0	+	55	921	2972	0.3098923
C9	56705991	56717354	BolC9t59054H	0	+	2291	8982	11363	0.7904603
C9	56717403	56717665	BolC9t59055H	0	+	0	0	262	0.0000000
C9	56727614	56727876	BolC9t59056H	0	+	0	0	262	0.0000000
C9	56738147	56739678	BolC9t59057H	0	+	170	1106	1531	0.7224036
C9	56753524	56757005	BolC9t59058H	0	+	411	1572	3481	0.4515944
C9	56758159	56761438	BolC9t59059H	0	-	324	622	3279	0.1896920
C9	56760857	56763134	BolC9t59060H	0	-	930	1263	2277	0.5546772
C9	56771491	56771728	BolC9t59061H	0	-	132	237	237	1.0000000
C9	56776151	56777031	BolC9t59062H	0	-	173	876	880	0.9954545
C9	56787451	56788293	BolC9t59063H	0	-	0	0	842	0.0000000
C9	56798071	56798593	BolC9t59064H	0	-	299	522	522	1.0000000
C9	56799450	56801836	BolC9t59065H	0	-	1109	2054	2386	0.8608550
C9	56802231	56803254	BolC9t59066H	0	-	547	1023	1023	1.0000000
C9	56804096	56804470	BolC9t59067H	0	-	31	290	374	0.7754011
C9	56826610	56827270	BolC9t59068H	0	-	544	660	660	1.0000000
C9	56827593	56828840	BolC9t59069H	0	-	1629	1247	1247	1.0000000
C9	56831770	56831968	BolC9t59070H	0	-	12	174	198	0.8787879
C9	56835376	56838494	BolC9t59071H	0	+	1769	2762	3118	0.8858243
C9	56838791	56840633	BolC9t59072H	0	-	329	1506	1842	0.8175896
C9	56844404	56845906	BolC9t59073H	0	+	467	1498	1502	0.9973369
C9	56846531	56847967	BolC9t59074H	0	-	395	1365	1436	0.9505571
C9	56850582	56853404	BolC9t59075H	0	-	587	1896	2822	0.6718639
C9	56853935	56856722	BolC9t59076H	0	+	457	2509	2787	0.9002512
C9	56857456	56860385	BolC9t59077H	0	-	1091	2760	2929	0.9423012
C9	56867210	56869792	BolC9t59078H	0	+	1200	2559	2582	0.9910922
C9	56893747	56894524	BolC9t59079H	0	-	387	777	777	1.0000000
C9	56901231	56905510	BolC9t59080H	0	+	1184	3293	4279	0.7695723
C9	56912690	56915090	BolC9t59081H	0	-	1247	2353	2400	0.9804167
C9	56923405	56926333	BolC9t59082H	0	+	384	2264	2928	0.7732241
C9	56935266	56935860	BolC9t59083H	0	+	148	589	594	0.9915825
C9	56936408	56937705	BolC9t59084H	0	+	829	1216	1297	0.9375482
C9	56940530	56942175	BolC9t59085H	0	+	384	1525	1645	0.9270517
C9	56942982	56944968	BolC9t59086H	0	-	102	1189	1986	0.5986908
C9	56946672	56946929	BolC9t59087H	0	+	27	33	257	0.1284047
C9	56947384	56948876	BolC9t59088H	0	+	295	715	1492	0.4792225
C9	56949274	56949730	BolC9t59089H	0	+	3	185	456	0.4057018
C9	56949835	56954692	BolC9t59090H	0	+	620	3442	4857	0.7086679
C9	56955079	56956379	BolC9t59091H	0	-	209	1195	1300	0.9192308
C9	56957016	56961722	BolC9t59092H	0	+	398	3499	4706	0.7435189
C9	56964913	56967468	BolC9t59093H	0	+	1675	2521	2555	0.9866928
C9	56979468	56982795	BolC9t59094H	0	-	2156	3307	3327	0.9939886
C9	57010397	57012208	BolC9t59095H	0	-	685	1311	1811	0.7239094
C9	57021739	57022931	BolC9t59096H	0	-	1025	1192	1192	1.0000000
C9	57029220	57029619	BolC9t59097H	0	+	243	399	399	1.0000000
C9	57030629	57031255	BolC9t59098H	0	+	492	626	626	1.0000000
C9	57045951	57046377	BolC9t59099H	0	+	369	426	426	1.0000000
C9	57050374	57051171	BolC9t59100H	0	-	635	797	797	1.0000000
C9	57088433	57091118	BolC9t59101H	0	+	1437	2679	2685	0.9977654
C9	57092767	57093206	BolC9t59102H	0	-	74	330	439	0.7517084
C9	57097421	57097949	BolC9t59103H	0	+	444	528	528	1.0000000
C9	57106439	57106804	BolC9t59104H	0	+	337	365	365	1.0000000
C9	57107342	57108458	BolC9t59105H	0	-	988	1116	1116	1.0000000
C9	57119113	57120310	BolC9t59106H	0	-	1118	1197	1197	1.0000000
C9	57134315	57135888	BolC9t59107H	0	-	645	1573	1573	1.0000000
C9	57138279	57140541	BolC9t59108H	0	+	1035	2242	2262	0.9911582
C9	57141036	57143246	BolC9t59109H	0	+	1094	2203	2210	0.9968325
C9	57143427	57144943	BolC9t59110H	0	-	402	1464	1516	0.9656992
C9	57147619	57149630	BolC9t59111H	0	+	962	1858	2011	0.9239184
C9	57150401	57151010	BolC9t59112H	0	+	473	609	609	1.0000000
C9	57151508	57154226	BolC9t59113H	0	-	794	2608	2718	0.9595290
C9	57158082	57159974	BolC9t59114H	0	+	427	1795	1892	0.9487315
C9	57160892	57161351	BolC9t59115H	0	+	85	395	459	0.8605664
C9	57165234	57166820	BolC9t59116H	0	+	516	1355	1586	0.8543506
C9	57167344	57168030	BolC9t59117H	0	-	806	686	686	1.0000000
C9	57179774	57180889	BolC9t59118H	0	-	941	1115	1115	1.0000000
C9	57186957	57187431	BolC9t59119H	0	+	361	474	474	1.0000000
C9	57194295	57194904	BolC9t59120H	0	-	463	609	609	1.0000000
C9	57196026	57196554	BolC9t59121H	0	+	70	499	528	0.9450758
C9	57197818	57199090	BolC9t59122H	0	-	211	1071	1272	0.8419811
C9	57202250	57202475	BolC9t59123H	0	+	402	225	225	1.0000000
C9	57203851	57204563	BolC9t59124H	0	+	494	629	712	0.8834270
C9	57204925	57206637	BolC9t59125H	0	-	907	1712	1712	1.0000000
C9	57208012	57208237	BolC9t59126H	0	-	94	225	225	1.0000000
C9	57210853	57211621	BolC9t59127H	0	-	286	768	768	1.0000000
C9	57212461	57218143	BolC9t59128H	0	-	2579	5682	5682	1.0000000
C9	57218478	57219597	BolC9t59129H	0	+	513	1119	1119	1.0000000
C9	57219977	57223618	BolC9t59130H	0	-	1432	3573	3641	0.9813238
C9	57227479	57231253	BolC9t59131H	0	+	3023	3774	3774	1.0000000
C9	57233190	57237879	BolC9t59132H	0	+	1429	4467	4689	0.9526551
C9	57239463	57242191	BolC9t59133H	0	+	708	2485	2728	0.9109238
C9	57247751	57249495	BolC9t59134H	0	+	366	1713	1744	0.9822248
C9	57250480	57252039	BolC9t59135H	0	+	709	1470	1559	0.9429121
C9	57252261	57255175	BolC9t59136H	0	-	1602	2835	2914	0.9728895
C9	57263249	57263462	BolC9t59137H	0	+	12	156	213	0.7323943
C9	57264382	57265136	BolC9t59138H	0	+	179	693	754	0.9190981
C9	57267200	57271276	BolC9t59139H	0	+	533	1660	4076	0.4072620
C9	57275081	57276549	BolC9t59140H	0	-	464	1332	1468	0.9073570
C9	57276938	57277287	BolC9t59141H	0	+	509	349	349	1.0000000
C9	57280268	57282284	BolC9t59142H	0	+	463	1749	2016	0.8675596
C9	57283075	57283411	BolC9t59143H	0	-	182	336	336	1.0000000
C9	57287649	57289305	BolC9t59144H	0	+	517	1562	1656	0.9432367
C9	57290317	57291658	BolC9t59145H	0	-	1073	1337	1341	0.9970171
C9	57292819	57293205	BolC9t59146H	0	+	94	382	386	0.9896373
C9	57294383	57296196	BolC9t59147H	0	+	779	1802	1813	0.9939327
C9	57297233	57297695	BolC9t59148H	0	-	560	462	462	1.0000000
C9	57306427	57307367	BolC9t59149H	0	-	344	902	940	0.9595745
C9	57308513	57310574	BolC9t59150H	0	+	207	1734	2061	0.8413392
C9	57312050	57313411	BolC9t59151H	0	+	549	1361	1361	1.0000000
C9	57314592	57317903	BolC9t59152H	0	+	980	2991	3311	0.9033524
C9	57318632	57319895	BolC9t59153H	0	-	43	867	1263	0.6864608
C9	57322560	57326313	BolC9t59154H	0	+	744	2700	3753	0.7194245
C9	57332644	57333989	BolC9t59155H	0	+	936	1338	1345	0.9947956
C9	57334112	57334309	BolC9t59156H	0	+	369	197	197	1.0000000
C9	57334830	57335748	BolC9t59157H	0	+	292	918	918	1.0000000
C9	57337756	57338299	BolC9t59158H	0	+	448	543	543	1.0000000
C9	57339983	57341229	BolC9t59159H	0	+	268	1153	1246	0.9253612
C9	57344220	57345102	BolC9t59160H	0	-	493	851	882	0.9648526
C9	57345570	57346703	BolC9t59161H	0	-	590	1133	1133	1.0000000
C9	57347612	57348034	BolC9t59162H	0	+	0	0	422	0.0000000
C9	57351617	57352449	BolC9t59163H	0	+	61	684	832	0.8221154
C9	57362688	57365077	BolC9t59164H	0	-	2146	2389	2389	1.0000000
C9	57380254	57380512	BolC9t59165H	0	-	0	0	258	0.0000000
C9	57381039	57381201	BolC9t59166H	0	-	159	162	162	1.0000000
C9	57383796	57384576	BolC9t59167H	0	-	533	780	780	1.0000000
C9	57385868	57387617	BolC9t59168H	0	+	1157	1749	1749	1.0000000
C9	57388718	57389438	BolC9t59169H	0	+	58	590	720	0.8194444
C9	57390444	57392495	BolC9t59170H	0	-	228	1708	2051	0.8327645
C9	57392897	57395527	BolC9t59171H	0	+	258	2212	2630	0.8410646
C9	57419430	57421022	BolC9t59172H	0	-	6	535	1592	0.3360553
C9	57424785	57427140	BolC9t59173H	0	+	436	2155	2355	0.9150743
C9	57447709	57449338	BolC9t59174H	0	-	6	246	1629	0.1510129
C9	57474461	57477066	BolC9t59175H	0	+	4481	2604	2605	0.9996161
C9	57478980	57479436	BolC9t59176H	0	+	97	456	456	1.0000000
C9	57480124	57482265	BolC9t59177H	0	+	1714	2018	2141	0.9425502
C9	57482523	57482943	BolC9t59178H	0	-	103	420	420	1.0000000
C9	57483911	57486772	BolC9t59179H	0	-	9573	2737	2861	0.9566585
C9	57490467	57498772	BolC9t59180H	0	-	1080	4740	8305	0.5707405
C9	57501925	57502278	BolC9t59181H	0	-	232	353	353	1.0000000
C9	57504241	57506638	BolC9t59182H	0	+	357	2181	2397	0.9098874
C9	57509553	57510065	BolC9t59183H	0	+	32	329	512	0.6425781
C9	57532546	57534179	BolC9t59184H	0	+	834	1587	1633	0.9718310
C9	57534584	57535710	BolC9t59185H	0	-	148	954	1126	0.8472469
C9	57545733	57547047	BolC9t59186H	0	-	64	789	1314	0.6004566
C9	57571261	57579171	BolC9t59187H	0	+	1124	3720	7910	0.4702908
C9	57581037	57585532	BolC9t59188H	0	+	1056	4381	4495	0.9746385
C9	57586992	57588801	BolC9t59189H	0	+	1018	1809	1809	1.0000000
C9	57589296	57592741	BolC9t59190H	0	-	1856	3312	3445	0.9613933
C9	57593877	57597456	BolC9t59191H	0	-	1605	3473	3579	0.9703828
C9	57603938	57606577	BolC9t59192H	0	+	2167	2639	2639	1.0000000
C9	57607088	57608982	BolC9t59193H	0	-	803	1808	1894	0.9545935
C9	57609772	57612203	BolC9t59194H	0	-	857	2313	2431	0.9514603
C9	57615599	57619142	BolC9t59195H	0	+	1532	3393	3543	0.9576630
C9	57619767	57622635	BolC9t59196H	0	-	1048	2678	2868	0.9337518
C9	57623524	57625255	BolC9t59197H	0	-	1671	1731	1731	1.0000000
C9	57625566	57630105	BolC9t59198H	0	+	2477	4435	4539	0.9770874
C9	57636944	57639533	BolC9t59199H	0	+	982	2456	2589	0.9486288
C9	57640096	57641096	BolC9t59200H	0	+	341	976	1000	0.9760000
C9	57646570	57648897	BolC9t59201H	0	+	1245	2266	2327	0.9737860
C9	57649029	57649686	BolC9t59202H	0	-	133	657	657	1.0000000
C9	57650095	57652066	BolC9t59203H	0	-	886	1971	1971	1.0000000
C9	57653028	57654342	BolC9t59204H	0	-	174	952	1314	0.7245053
C9	57655950	57656884	BolC9t59205H	0	-	629	934	934	1.0000000
C9	57663197	57664617	BolC9t59206H	0	+	813	1349	1420	0.9500000
C9	57666208	57667489	BolC9t59207H	0	+	562	1281	1281	1.0000000
C9	57668385	57670654	BolC9t59208H	0	+	880	2242	2269	0.9881005
C9	57671586	57675726	BolC9t59209H	0	-	575	3316	4140	0.8009662
C9	57683729	57684455	BolC9t59210H	0	-	351	726	726	1.0000000
C9	57684470	57684990	BolC9t59211H	0	-	1049	520	520	1.0000000
C9	57695730	57698214	BolC9t59212H	0	-	1359	2333	2484	0.9392110
C9	57698689	57699949	BolC9t59213H	0	+	1268	1260	1260	1.0000000
C9	57711267	57713600	BolC9t59214H	0	-	1998	2333	2333	1.0000000
C9	57718368	57720593	BolC9t59215H	0	-	1005	2091	2225	0.9397753
C9	57731433	57735899	BolC9t59216H	0	+	1554	4244	4466	0.9502911
C9	57736565	57736688	BolC9t59217H	0	-	261	123	123	1.0000000
C9	57737365	57738645	BolC9t59218H	0	+	200	715	1280	0.5585938
C9	57738874	57741762	BolC9t59219H	0	-	835	2824	2888	0.9778394
C9	57742041	57744297	BolC9t59220H	0	+	381	2221	2256	0.9844858
C9	57744536	57746243	BolC9t59221H	0	-	1169	1677	1707	0.9824253
C9	57746622	57747994	BolC9t59222H	0	-	681	1356	1372	0.9883382
C9	57750905	57759443	BolC9t59223H	0	-	4969	7811	8538	0.9148512
C9	57784448	57786128	BolC9t59224H	0	+	136	1209	1680	0.7196429
C9	57786428	57788888	BolC9t59225H	0	-	589	2181	2460	0.8865854
C9	57796067	57797656	BolC9t59226H	0	-	449	1450	1589	0.9125236
C9	57805992	57807996	BolC9t59227H	0	-	461	1978	2004	0.9870260
C9	57808475	57809758	BolC9t59228H	0	+	804	1283	1283	1.0000000
C9	57815864	57816881	BolC9t59229H	0	-	338	1002	1017	0.9852507
C9	57828170	57828422	BolC9t59230H	0	+	134	252	252	1.0000000
C9	57854658	57855875	BolC9t59231H	0	+	671	1211	1217	0.9950699
C9	57857301	57859472	BolC9t59232H	0	-	1211	2129	2171	0.9806541
C9	57862630	57864571	BolC9t59233H	0	+	410	1807	1941	0.9309634
C9	57865564	57866746	BolC9t59234H	0	+	308	933	1182	0.7893401
C9	57872890	57873688	BolC9t59235H	0	-	191	663	798	0.8308271
C9	57874721	57877269	BolC9t59236H	0	-	1408	2515	2548	0.9870487
C9	57877732	57878949	BolC9t59237H	0	-	184	1116	1217	0.9170091
C9	57880942	57881725	BolC9t59238H	0	+	346	783	783	1.0000000
C9	57890339	57891023	BolC9t59239H	0	+	560	684	684	1.0000000
C9	57891828	57892839	BolC9t59240H	0	+	359	1008	1011	0.9970326
C9	57893616	57894345	BolC9t59241H	0	-	49	435	729	0.5967078
C9	57895538	57898611	BolC9t59242H	0	-	1264	2639	3073	0.8587700
C9	57902394	57904553	BolC9t59243H	0	+	1031	1956	2159	0.9059750
C9	57904842	57907681	BolC9t59244H	0	-	1117	2660	2839	0.9369496
C9	57908761	57910965	BolC9t59245H	0	+	1339	2204	2204	1.0000000
C9	57912014	57922061	BolC9t59246H	0	+	4317	9807	10047	0.9761122
C9	57922698	57923302	BolC9t59247H	0	+	166	568	604	0.9403973
C9	57925200	57927269	BolC9t59248H	0	+	2369	2069	2069	1.0000000
C9	57927535	57929845	BolC9t59249H	0	-	269	1819	2310	0.7874459
C9	57932380	57933622	BolC9t59250H	0	-	1094	1192	1242	0.9597424
C9	57943975	57944749	BolC9t59251H	0	+	196	774	774	1.0000000
C9	57949329	57950463	BolC9t59252H	0	-	560	1073	1134	0.9462081
C9	57957554	57959232	BolC9t59253H	0	-	358	1282	1678	0.7640048
C9	57961144	57961914	BolC9t59254H	0	-	153	770	770	1.0000000
C9	57965589	57965691	BolC9t59255H	0	-	22	102	102	1.0000000
C9	57967104	57967446	BolC9t59256H	0	-	26	342	342	1.0000000
C9	57968690	57971028	BolC9t59257H	0	-	165	2282	2338	0.9760479
C9	57971739	57972270	BolC9t59258H	0	-	81	497	531	0.9359699
C9	57974242	57975367	BolC9t59259H	0	-	423	1125	1125	1.0000000
C9	57984389	57985454	BolC9t59260H	0	+	921	1065	1065	1.0000000
C9	57986716	57987130	BolC9t59261H	0	+	361	414	414	1.0000000
C9	57989232	57989532	BolC9t59262H	0	+	399	300	300	1.0000000
C9	57992142	57992547	BolC9t59263H	0	-	247	405	405	1.0000000
C9	58005484	58007661	BolC9t59264H	0	+	620	2015	2177	0.9255857
C9	58008867	58010322	BolC9t59265H	0	+	184	1144	1455	0.7862543
C9	58023257	58023488	BolC9t59266H	0	+	133	231	231	1.0000000
C9	58028237	58030373	BolC9t59267H	0	+	2070	2136	2136	1.0000000
C9	58033995	58036157	BolC9t59268H	0	+	434	1770	2162	0.8186864
C9	58036696	58038622	BolC9t59269H	0	-	443	1867	1926	0.9693666
C9	58042272	58043930	BolC9t59270H	0	+	784	1658	1658	1.0000000
C9	58044937	58047094	BolC9t59271H	0	+	467	2101	2157	0.9740380
C9	58047611	58049749	BolC9t59272H	0	+	1727	2138	2138	1.0000000
C9	58050077	58051914	BolC9t59273H	0	-	705	1780	1837	0.9689711
C9	58053873	58055959	BolC9t59274H	0	-	922	2026	2086	0.9712368
C9	58065988	58069533	BolC9t59275H	0	-	1758	3540	3545	0.9985896
C9	58069688	58072027	BolC9t59276H	0	-	689	2211	2339	0.9452758
C9	58073683	58082563	BolC9t59277H	0	-	1817	7795	8880	0.8778153
C9	58085305	58090311	BolC9t59278H	0	-	2842	5006	5006	1.0000000
C9	58092611	58093366	BolC9t59279H	0	+	1	1	755	0.0013245
C9	58098319	58100628	BolC9t59280H	0	+	387	1962	2309	0.8497185
C9	58102760	58108277	BolC9t59281H	0	+	1620	4659	5517	0.8444807
C9	58108934	58110671	BolC9t59282H	0	+	1534	1737	1737	1.0000000
C9	58111337	58118938	BolC9t59283H	0	-	2625	7100	7601	0.9340876
C9	58143710	58144634	BolC9t59284H	0	+	384	924	924	1.0000000
C9	58144913	58146369	BolC9t59285H	0	-	402	1389	1456	0.9539835
C9	58146464	58152512	BolC9t59286H	0	+	2799	5907	6048	0.9766865
C9	58153284	58154404	BolC9t59287H	0	+	805	1120	1120	1.0000000
C9	58154790	58158967	BolC9t59288H	0	-	1224	3464	4177	0.8293033
C9	58161890	58164279	BolC9t59289H	0	+	1107	1963	2389	0.8216827
C9	58168284	58169540	BolC9t59290H	0	+	207	1156	1256	0.9203821
C9	58174096	58175112	BolC9t59291H	0	-	880	1016	1016	1.0000000
C9	58175517	58176954	BolC9t59292H	0	+	664	1388	1437	0.9659012
C9	58177755	58178847	BolC9t59293H	0	+	83	867	1092	0.7939560
C9	58179226	58181386	BolC9t59294H	0	-	688	2096	2160	0.9703704
C9	58190360	58192388	BolC9t59295H	0	+	395	1631	2028	0.8042406
C9	58193035	58194525	BolC9t59296H	0	+	1861	1490	1490	1.0000000
C9	58195277	58195962	BolC9t59297H	0	-	67	258	685	0.3766423
C9	58197994	58198859	BolC9t59298H	0	+	24	348	865	0.4023121
C9	58205951	58206941	BolC9t59299H	0	+	776	990	990	1.0000000
C9	58208785	58211112	BolC9t59300H	0	-	1265	2327	2327	1.0000000
C9	58211468	58215453	BolC9t59301H	0	+	1929	3918	3985	0.9831870
C9	58219463	58225618	BolC9t59302H	0	+	3582	6155	6155	1.0000000
C9	58229692	58234610	BolC9t59303H	0	+	2412	4775	4918	0.9709231
C9	58235120	58235520	BolC9t59304H	0	+	125	400	400	1.0000000
C9	58236170	58238663	BolC9t59305H	0	-	1657	2493	2493	1.0000000
C9	58245891	58247670	BolC9t59306H	0	+	299	1615	1779	0.9078134
C9	58248062	58249381	BolC9t59307H	0	-	368	1211	1319	0.9181198
C9	58249922	58252376	BolC9t59308H	0	-	228	2236	2454	0.9111654
C9	58263382	58266243	BolC9t59309H	0	+	523	2569	2861	0.8979378
C9	58269046	58270054	BolC9t59310H	0	-	258	1008	1008	1.0000000
C9	58271488	58271758	BolC9t59311H	0	+	395	270	270	1.0000000
C9	58272232	58274413	BolC9t59312H	0	-	1560	2168	2181	0.9940394
C9	58276031	58276496	BolC9t59313H	0	+	187	465	465	1.0000000
C9	58276972	58278427	BolC9t59314H	0	-	468	1455	1455	1.0000000
C9	58295405	58296923	BolC9t59315H	0	+	343	1390	1518	0.9156785
C9	58297876	58300602	BolC9t59316H	0	+	851	2430	2726	0.8914160
C9	58310302	58310536	BolC9t59317H	0	+	378	234	234	1.0000000
C9	58312925	58315259	BolC9t59318H	0	+	1311	2334	2334	1.0000000
C9	58317748	58319205	BolC9t59319H	0	-	531	1454	1457	0.9979410
C9	58337035	58337458	BolC9t59320H	0	+	33	177	423	0.4184397
C9	58340427	58342748	BolC9t59321H	0	-	770	2047	2321	0.8819475
C9	58344540	58346131	BolC9t59322H	0	+	194	1507	1591	0.9472030
C9	58346532	58348177	BolC9t59323H	0	-	665	1516	1645	0.9215806
C9	58349824	58350682	BolC9t59324H	0	-	163	826	858	0.9627039
C9	58354385	58357128	BolC9t59325H	0	-	1711	2743	2743	1.0000000
C9	58363712	58365718	BolC9t59326H	0	+	646	1947	2006	0.9705882
C9	58366073	58367750	BolC9t59327H	0	-	680	1671	1677	0.9964222
C9	58369407	58370541	BolC9t59328H	0	+	215	966	1134	0.8518519
C9	58371713	58372214	BolC9t59329H	0	+	310	501	501	1.0000000
C9	58372472	58374170	BolC9t59330H	0	-	1029	1698	1698	1.0000000
C9	58374972	58379060	BolC9t59331H	0	+	727	1859	4088	0.4547456
C9	58379723	58381608	BolC9t59332H	0	-	1188	1779	1885	0.9437666
C9	58383259	58384704	BolC9t59333H	0	+	525	1424	1445	0.9854671
C9	58385556	58386807	BolC9t59334H	0	-	750	1132	1251	0.9048761
C9	58388272	58388557	BolC9t59335H	0	+	4	89	285	0.3122807
C9	58393590	58393785	BolC9t59336H	0	-	65	195	195	1.0000000
C9	58401234	58402648	BolC9t59337H	0	-	444	1338	1414	0.9462517
C9	58403699	58406983	BolC9t59338H	0	-	1053	3019	3284	0.9193057
C9	58408508	58416485	BolC9t59339H	0	+	1073	5854	7977	0.7338598
C9	58417732	58420063	BolC9t59340H	0	-	524	2074	2331	0.8897469
C9	58422316	58422650	BolC9t59341H	0	+	48	289	334	0.8652695
C9	58425014	58427373	BolC9t59342H	0	-	45	605	2359	0.2564646
C9	58444867	58472846	BolC9t59343H	0	-	2943	11078	27979	0.3959398
C9	58466835	58467695	BolC9t59344H	0	-	47	362	860	0.4209302
C9	58488466	58491913	BolC9t59345H	0	-	1067	2729	3447	0.7917029
C9	58501315	58503045	BolC9t59346H	0	-	237	1651	1730	0.9543353
C9	58505648	58507393	BolC9t59347H	0	-	1058	1703	1745	0.9759312
C9	58508398	58508803	BolC9t59348H	0	-	170	405	405	1.0000000
C9	58509201	58510281	BolC9t59349H	0	+	164	977	1080	0.9046296
C9	58511191	58513469	BolC9t59350H	0	+	865	2024	2278	0.8884987
C9	58521518	58522253	BolC9t59351H	0	+	108	610	735	0.8299320
C9	58538541	58540504	BolC9t59352H	0	+	219	1941	1963	0.9887927
C9	58550747	58567508	BolC9t59353H	0	+	4327	12525	16761	0.7472705
C9	58568205	58569120	BolC9t59354H	0	+	203	915	915	1.0000000
C9	58574408	58575047	BolC9t59355H	0	+	355	554	639	0.8669797
C9	58595109	58595532	BolC9t59356H	0	+	196	423	423	1.0000000
C9	58596787	58603411	BolC9t59357H	0	-	1305	3739	6624	0.5644625
C9	58618484	58618757	BolC9t59358H	0	-	126	273	273	1.0000000
C9	58619421	58643902	BolC9t59359H	0	-	15833	20527	24481	0.8384870
C9	58645526	58646921	BolC9t59360H	0	-	605	1395	1395	1.0000000
C9	58647410	58651195	BolC9t59361H	0	-	1579	3673	3785	0.9704095
C9	58662121	58664993	BolC9t59362H	0	-	270	2569	2872	0.8944986
C9	58667341	58668804	BolC9t59363H	0	+	837	1463	1463	1.0000000
C9	58676407	58680185	BolC9t59364H	0	+	2295	3712	3778	0.9825304
C9	58688952	58689919	BolC9t59365H	0	+	1165	967	967	1.0000000
C9	58690665	58692646	BolC9t59366H	0	-	1538	1981	1981	1.0000000
C9	58693229	58693912	BolC9t59367H	0	+	574	683	683	1.0000000
C9	58698252	58698561	BolC9t59368H	0	-	16	130	309	0.4207120
C9	58702046	58704067	BolC9t59369H	0	-	1006	2021	2021	1.0000000
C9	58717681	58719536	BolC9t59370H	0	+	1049	1855	1855	1.0000000
C9	58720512	58721961	BolC9t59371H	0	+	138	966	1449	0.6666667
C9	58722842	58739875	BolC9t59372H	0	+	2236	9483	17033	0.5567428
C9	58740429	58741776	BolC9t59373H	0	+	836	1347	1347	1.0000000
C9	58742106	58744328	BolC9t59374H	0	-	532	1708	2222	0.7686769
C9	58745205	58752279	BolC9t59375H	0	-	3315	6557	7074	0.9269155
C9	58753393	58754734	BolC9t59376H	0	-	659	1279	1341	0.9537659
C9	58755061	58756492	BolC9t59377H	0	+	475	1263	1431	0.8825996
C9	58762927	58765494	BolC9t59378H	0	+	1176	2035	2567	0.7927542
C9	58768986	58771356	BolC9t59379H	0	+	788	2139	2370	0.9025316
C9	58777045	58778913	BolC9t59380H	0	-	913	1744	1868	0.9336188
C9	58781005	58783545	BolC9t59381H	0	+	949	2390	2540	0.9409449
C9	58784305	58785219	BolC9t59382H	0	-	576	675	914	0.7385120
C9	58785447	58786775	BolC9t59383H	0	+	791	1328	1328	1.0000000
C9	58788163	58789252	BolC9t59384H	0	+	588	1089	1089	1.0000000
C9	58807629	58811226	BolC9t59385H	0	+	2843	3597	3597	1.0000000
C9	58811797	58815300	BolC9t59386H	0	-	5347	3503	3503	1.0000000
C9	58815557	58816931	BolC9t59387H	0	+	1331	1374	1374	1.0000000
C9	58817856	58818909	BolC9t59388H	0	-	230	1012	1053	0.9610636
C9	58840762	58841692	BolC9t59389H	0	-	252	912	930	0.9806452
C9	58848242	58851505	BolC9t59390H	0	-	754	2582	3263	0.7912964
C9	58852169	58855137	BolC9t59391H	0	+	424	1841	2968	0.6202830
C9	58855602	58857240	BolC9t59392H	0	-	953	1638	1638	1.0000000
C9	58875977	58877139	BolC9t59393H	0	+	1040	1162	1162	1.0000000
C9	58878122	58879285	BolC9t59394H	0	+	317	1163	1163	1.0000000
C9	58879596	58882871	BolC9t59395H	0	-	900	3248	3275	0.9917557
C9	58884243	58884798	BolC9t59396H	0	-	101	555	555	1.0000000
C9	58893423	58893582	BolC9t59397H	0	+	136	159	159	1.0000000
C9	58893927	58894608	BolC9t59398H	0	-	308	681	681	1.0000000
C9	58902538	58902955	BolC9t59399H	0	-	176	417	417	1.0000000
C9	58907158	58907941	BolC9t59400H	0	-	338	753	783	0.9616858
C9	58912885	58913335	BolC9t59401H	0	+	118	427	450	0.9488889
C9	58916818	58921600	BolC9t59402H	0	-	437	3976	4782	0.8314513
C9	58921992	58925618	BolC9t59403H	0	+	1962	3409	3626	0.9401544
C9	58927360	58929776	BolC9t59404H	0	+	1226	2416	2416	1.0000000
C9	58930540	58931314	BolC9t59405H	0	-	183	752	774	0.9715762
C9	58932182	58932843	BolC9t59406H	0	-	320	661	661	1.0000000
C9	58935142	58936306	BolC9t59407H	0	+	417	1164	1164	1.0000000
C9	58938638	58939085	BolC9t59408H	0	-	19	437	447	0.9776286
C9	58944468	58945197	BolC9t59409H	0	-	99	570	729	0.7818930
C9	58951269	58952112	BolC9t59410H	0	-	438	843	843	1.0000000
C9	58970342	58974812	BolC9t59411H	0	+	1502	3909	4470	0.8744966
C9	58980187	58981501	BolC9t59412H	0	+	262	1130	1314	0.8599696
C9	58982674	58982902	BolC9t59413H	0	+	135	159	228	0.6973684
C9	58983161	58985052	BolC9t59414H	0	-	698	1744	1891	0.9222633
C9	58985763	58987569	BolC9t59415H	0	-	1338	1806	1806	1.0000000
C9	58988273	58989370	BolC9t59416H	0	+	832	1097	1097	1.0000000
C9	58991609	58995924	BolC9t59417H	0	+	1088	3813	4315	0.8836616
C9	58996666	58997783	BolC9t59418H	0	+	273	1090	1117	0.9758281
C9	58999831	59000221	BolC9t59419H	0	+	88	390	390	1.0000000
C9	59000945	59002976	BolC9t59420H	0	+	46	972	2031	0.4785820
C9	59008022	59010090	BolC9t59421H	0	+	925	2068	2068	1.0000000
C9	59016595	59031013	BolC9t59422H	0	+	2058	6834	14418	0.4739909
C9	59036821	59037448	BolC9t59423H	0	+	99	542	627	0.8644338
C9	59038109	59039444	BolC9t59424H	0	+	830	1335	1335	1.0000000
C9	59043700	59045613	BolC9t59425H	0	+	2387	1913	1913	1.0000000
C9	59056783	59058542	BolC9t59426H	0	+	1115	1600	1759	0.9096077
C9	59062910	59064338	BolC9t59427H	0	-	1511	1428	1428	1.0000000
C9	59068878	59069367	BolC9t59428H	0	+	200	465	489	0.9509202
C9	59070575	59074249	BolC9t59429H	0	-	1359	3485	3674	0.9485574
C9	59080503	59080785	BolC9t59430H	0	+	333	282	282	1.0000000
C9	59081124	59081328	BolC9t59431H	0	-	142	204	204	1.0000000
C9	59081917	59082994	BolC9t59432H	0	-	610	1077	1077	1.0000000
C9	59086479	59086725	BolC9t59433H	0	+	2	47	246	0.1910569
C9	59092769	59096026	BolC9t59434H	0	+	2124	3257	3257	1.0000000
C9	59096396	59096857	BolC9t59435H	0	-	754	461	461	1.0000000
C9	59099319	59099598	BolC9t59436H	0	-	5	148	279	0.5304660
C9	59099693	59100371	BolC9t59437H	0	-	121	483	678	0.7123894
C9	59100514	59101038	BolC9t59438H	0	-	100	524	524	1.0000000
C9	59102640	59104397	BolC9t59439H	0	+	0	0	1757	0.0000000
C9	59109885	59110215	BolC9t59440H	0	-	115	329	330	0.9969697
C9	59112552	59114319	BolC9t59441H	0	+	502	1706	1767	0.9654782
C9	59114820	59116317	BolC9t59442H	0	-	288	1044	1497	0.6973948
C9	59117999	59120057	BolC9t59443H	0	-	4026	2058	2058	1.0000000
C9	59122589	59123243	BolC9t59444H	0	+	1056	654	654	1.0000000
C9	59124093	59124359	BolC9t59445H	0	-	196	266	266	1.0000000
C9	59130094	59130424	BolC9t59446H	0	-	612	330	330	1.0000000
C9	59137755	59138865	BolC9t59447H	0	+	749	1107	1110	0.9972973
C9	59139369	59140872	BolC9t59448H	0	-	306	779	1503	0.5182967
C9	59141681	59143175	BolC9t59449H	0	-	180	1386	1494	0.9277108
C9	59148830	59150164	BolC9t59450H	0	-	613	1285	1334	0.9632683
C9	59153985	59155442	BolC9t59451H	0	-	375	1387	1457	0.9519561
C9	59157768	59161241	BolC9t59452H	0	+	1941	3407	3473	0.9809963
C9	59165748	59167373	BolC9t59453H	0	+	347	1509	1625	0.9286154
C9	59167705	59168119	BolC9t59454H	0	-	297	414	414	1.0000000
C9	59170503	59172647	BolC9t59455H	0	+	1119	2100	2144	0.9794776
C9	59173217	59177024	BolC9t59456H	0	-	1897	3787	3807	0.9947465
C9	59186612	59189226	BolC9t59457H	0	-	680	1939	2614	0.7417750
C9	59190278	59193751	BolC9t59458H	0	+	2525	3471	3473	0.9994241
C9	59194058	59195775	BolC9t59459H	0	+	1656	1717	1717	1.0000000
C9	59196404	59200834	BolC9t59460H	0	-	1618	4019	4430	0.9072235
C9	59200912	59209240	BolC9t59461H	0	-	4254	6939	8328	0.8332133
C9	59206879	59207177	BolC9t59462H	0	+	344	298	298	1.0000000
C9	59211125	59211681	BolC9t59463H	0	+	474	556	556	1.0000000
C9	59215127	59216153	BolC9t59464H	0	+	233	1024	1026	0.9980507
C9	59219889	59220316	BolC9t59465H	0	-	34	112	427	0.2622951
C9	59224067	59235475	BolC9t59466H	0	-	2728	1582	11408	0.1386746
C9	59238060	59238415	BolC9t59467H	0	+	518	355	355	1.0000000
C9	59240278	59241938	BolC9t59468H	0	+	1200	1600	1660	0.9638554
C9	59243936	59244365	BolC9t59469H	0	+	878	429	429	1.0000000
C9	59254382	59261416	BolC9t59470H	0	+	2294	6069	7034	0.8628092
C9	59286232	59286757	BolC9t59471H	0	-	353	525	525	1.0000000
C9	59288676	59305637	BolC9t59472H	0	+	8151	14392	16961	0.8485349
C9	59307204	59308420	BolC9t59473H	0	-	88	559	1216	0.4597040
C9	59310959	59311370	BolC9t59474H	0	+	280	411	411	1.0000000
C9	59312342	59312753	BolC9t59475H	0	+	245	411	411	1.0000000
C9	59312989	59313859	BolC9t59476H	0	-	476	870	870	1.0000000
C9	59314524	59320172	BolC9t59477H	0	-	2323	5430	5648	0.9614022
C9	59321218	59322528	BolC9t59478H	0	+	687	1310	1310	1.0000000
C9	59322835	59323725	BolC9t59479H	0	-	109	863	890	0.9696629
C9	59324084	59326463	BolC9t59480H	0	+	2097	2365	2379	0.9941152
C9	59329977	59330468	BolC9t59481H	0	+	205	491	491	1.0000000
C9	59331526	59332748	BolC9t59482H	0	-	414	1017	1222	0.8322423
C9	59335010	59338571	BolC9t59483H	0	-	618	2074	3561	0.5824206
C9	59339218	59339594	BolC9t59484H	0	+	148	366	376	0.9734042
C9	59351737	59352891	BolC9t59485H	0	-	188	784	1154	0.6793761
C9	59370390	59373110	BolC9t59486H	0	+	751	2661	2720	0.9783088
C9	59373429	59374943	BolC9t59487H	0	-	1234	1435	1514	0.9478204
C9	59376695	59379191	BolC9t59488H	0	+	3027	2496	2496	1.0000000
C9	59380569	59381517	BolC9t59489H	0	+	3	35	948	0.0369198
C9	59381960	59383041	BolC9t59490H	0	+	179	658	1081	0.6086956
C9	59384070	59385837	BolC9t59491H	0	+	130	1261	1767	0.7136390
C9	59386031	59386613	BolC9t59492H	0	-	28	309	582	0.5309278
C9	59390180	59392184	BolC9t59493H	0	-	144	1488	2004	0.7425150
C9	59402808	59406205	BolC9t59494H	0	-	1131	2138	3397	0.6293789
C9	59414703	59416916	BolC9t59495H	0	+	635	2122	2213	0.9588794
C9	59460431	59465008	BolC9t59496H	0	+	380	3686	4577	0.8053310
C9	59467154	59467711	BolC9t59497H	0	+	56	557	557	1.0000000
C9	59467813	59485123	BolC9t59498H	0	+	1748	9923	17310	0.5732524
C9	59469692	59469975	BolC9t59499H	0	+	12	217	283	0.7667844
C9	59478083	59483593	BolC9t59500H	0	+	267	2440	5510	0.4428312
C9	59491107	59495263	BolC9t59501H	0	+	286	2867	4156	0.6898460
C9	59497944	59499334	BolC9t59502H	0	+	534	1377	1390	0.9906475
C9	59500460	59500758	BolC9t59503H	0	+	19	298	298	1.0000000
C9	59511892	59512777	BolC9t59504H	0	-	39	361	885	0.4079096
C9	59528030	59530026	BolC9t59505H	0	+	659	1590	1996	0.7965932
C9	59530273	59532274	BolC9t59506H	0	-	898	2001	2001	1.0000000
C9	59536212	59539224	BolC9t59507H	0	+	1802	3012	3012	1.0000000
C9	59539695	59540592	BolC9t59508H	0	+	839	897	897	1.0000000
C9	59542797	59545056	BolC9t59509H	0	-	1686	2259	2259	1.0000000
C9	59545626	59547344	BolC9t59510H	0	+	977	1616	1718	0.9406286
C9	59548384	59548609	BolC9t59511H	0	-	246	225	225	1.0000000
C9	59549671	59549910	BolC9t59512H	0	+	138	239	239	1.0000000
C9	59557000	59558653	BolC9t59513H	0	+	627	1590	1653	0.9618875
C9	59564189	59565737	BolC9t59514H	0	-	90	1031	1548	0.6660207
C9	59567860	59571166	BolC9t59515H	0	-	1571	3306	3306	1.0000000
C9	59572929	59576057	BolC9t59516H	0	-	1953	3081	3128	0.9849744
C9	59577190	59577640	BolC9t59517H	0	-	408	450	450	1.0000000
C9	59578597	59579758	BolC9t59518H	0	+	1222	1161	1161	1.0000000
C9	59579983	59580328	BolC9t59519H	0	-	228	345	345	1.0000000
C9	59582804	59583232	BolC9t59520H	0	-	41	343	428	0.8014019
C9	59590177	59591902	BolC9t59521H	0	-	173	1062	1725	0.6156522
C9	59596054	59596361	BolC9t59522H	0	-	81	307	307	1.0000000
C9	59603859	59604402	BolC9t59523H	0	-	124	543	543	1.0000000
C9	59606400	59609388	BolC9t59524H	0	+	1749	2800	2988	0.9370816
C9	59609956	59610991	BolC9t59525H	0	-	311	965	1035	0.9323671
C9	59612151	59614345	BolC9t59526H	0	+	1115	2194	2194	1.0000000
C9	59615083	59618371	BolC9t59527H	0	+	1840	3047	3288	0.9267032
C9	59619300	59619564	BolC9t59528H	0	-	191	264	264	1.0000000
C9	59621910	59623439	BolC9t59529H	0	+	938	1529	1529	1.0000000
C9	59625186	59627942	BolC9t59530H	0	-	1663	2755	2756	0.9996371
C9	59628164	59629065	BolC9t59531H	0	+	629	901	901	1.0000000
C9	59630084	59631476	BolC9t59532H	0	-	555	1348	1392	0.9683908
C9	59638825	59639134	BolC9t59533H	0	-	299	309	309	1.0000000
C9	59651712	59653365	BolC9t59534H	0	+	587	1604	1653	0.9703569
C9	59655221	59656434	BolC9t59535H	0	-	62	401	1213	0.3305853
C9	59656632	59657084	BolC9t59536H	0	+	279	452	452	1.0000000
C9	59658641	59666982	BolC9t59537H	0	-	2217	6342	8341	0.7603405
C9	59680700	59682230	BolC9t59538H	0	-	5	275	1530	0.1797386
C9	59687194	59688037	BolC9t59539H	0	+	32	622	843	0.7378411
C9	59691384	59692056	BolC9t59540H	0	+	561	672	672	1.0000000
C9	59710291	59712576	BolC9t59541H	0	+	851	2103	2285	0.9203501
C9	59713462	59720277	BolC9t59542H	0	+	2524	6645	6815	0.9750550
C9	59720876	59722330	BolC9t59543H	0	+	398	1419	1454	0.9759285
C9	59724266	59739468	BolC9t59544H	0	-	3557	10566	15202	0.6950401
C9	59744420	59745857	BolC9t59545H	0	+	748	1437	1437	1.0000000
C9	59748907	59750144	BolC9t59546H	0	-	594	1133	1237	0.9159256
C9	59750883	59751993	BolC9t59547H	0	-	641	1061	1110	0.9558558
C9	59752779	59755115	BolC9t59548H	0	-	1249	2245	2336	0.9610445
C9	59755646	59756519	BolC9t59549H	0	+	621	873	873	1.0000000
C9	59757525	59763527	BolC9t59550H	0	+	1924	3555	6002	0.5923026
C9	59775684	59777269	BolC9t59551H	0	+	1445	1573	1585	0.9924290
C9	59781266	59782160	BolC9t59552H	0	-	115	778	894	0.8702461
C9	59782820	59783072	BolC9t59553H	0	+	123	252	252	1.0000000
C9	59800704	59801785	BolC9t59554H	0	-	513	1081	1081	1.0000000
C9	59803377	59806719	BolC9t59555H	0	-	1392	3329	3342	0.9961101
C9	59808440	59813149	BolC9t59556H	0	-	2000	4675	4709	0.9927798
C9	59813917	59815874	BolC9t59557H	0	-	356	1861	1957	0.9509453
C9	59816423	59818216	BolC9t59558H	0	+	824	1793	1793	1.0000000
C9	59823628	59823844	BolC9t59559H	0	+	69	162	216	0.7500000
C9	59830216	59833059	BolC9t59560H	0	+	1829	2843	2843	1.0000000
C9	59834917	59836559	BolC9t59561H	0	+	525	1642	1642	1.0000000
C9	59836855	59839516	BolC9t59562H	0	+	716	2608	2661	0.9800827
C9	59840065	59840245	BolC9t59563H	0	+	157	170	180	0.9444444
C9	59840742	59842073	BolC9t59564H	0	+	171	1038	1331	0.7798648
C9	59842363	59845009	BolC9t59565H	0	-	1080	2623	2646	0.9913076
C9	59845425	59846262	BolC9t59566H	0	+	441	837	837	1.0000000
C9	59848122	59850117	BolC9t59567H	0	-	316	1605	1995	0.8045112
C9	59859259	59860291	BolC9t59568H	0	+	339	1032	1032	1.0000000
C9	59860559	59861687	BolC9t59569H	0	-	861	1074	1128	0.9521276
C9	59861985	59862879	BolC9t59570H	0	+	215	894	894	1.0000000
C9	59873927	59875194	BolC9t59571H	0	-	508	1251	1267	0.9873717
C9	59877281	59879581	BolC9t59572H	0	+	540	2269	2300	0.9865217
C9	59881309	59883467	BolC9t59573H	0	+	1483	2158	2158	1.0000000
C9	59883920	59887619	BolC9t59574H	0	+	1743	3622	3699	0.9791836
C9	59895720	59898252	BolC9t59575H	0	-	1106	2532	2532	1.0000000
C9	59898675	59901123	BolC9t59576H	0	+	893	2185	2448	0.8925654
C9	59901579	59904455	BolC9t59577H	0	-	1130	2722	2876	0.9464534
C9	59907469	59909260	BolC9t59578H	0	-	500	1765	1791	0.9854830
C9	59911104	59914178	BolC9t59579H	0	+	264	2268	3074	0.7378009
C9	59914664	59922184	BolC9t59580H	0	-	1743	6252	7520	0.8313830
C9	59922769	59924947	BolC9t59581H	0	-	1251	2129	2178	0.9775023
C9	59926291	59927941	BolC9t59582H	0	+	651	1644	1650	0.9963636
C9	59929504	59931937	BolC9t59583H	0	-	1215	2369	2433	0.9736950
C9	59934830	59937168	BolC9t59584H	0	+	1015	2279	2338	0.9747648
C9	59937905	59941960	BolC9t59585H	0	+	801	3447	4055	0.8500617
C9	59942353	59943909	BolC9t59586H	0	-	1203	1556	1556	1.0000000
C9	59944451	59945492	BolC9t59587H	0	-	722	946	1041	0.9087416
C9	59946555	59948016	BolC9t59588H	0	+	130	1122	1461	0.7679672
C9	59949988	59951579	BolC9t59589H	0	+	922	1477	1591	0.9283469
C9	59951838	59953461	BolC9t59590H	0	-	655	1551	1623	0.9556377
C9	59954531	59954847	BolC9t59591H	0	+	207	310	316	0.9810126
C9	59958021	59958613	BolC9t59592H	0	-	100	510	592	0.8614865
C9	59959778	59960720	BolC9t59593H	0	+	1053	942	942	1.0000000
C9	59973983	59974820	BolC9t59594H	0	+	1436	837	837	1.0000000
C9	59994123	59996966	BolC9t59595H	0	-	371	2010	2843	0.7069997
C9	59997969	59998566	BolC9t59596H	0	-	150	482	597	0.8073702
C9	60000163	60006694	BolC9t59597H	0	-	1568	4311	6531	0.6600827
C9	60006981	60011605	BolC9t59598H	0	-	1479	4312	4624	0.9325259
C9	60014399	60021057	BolC9t59599H	0	+	1727	4386	6658	0.6587564
C9	60021322	60026570	BolC9t59600H	0	-	2931	5165	5248	0.9841844
C9	60029260	60030797	BolC9t59601H	0	-	77	957	1537	0.6226415
C9	60033195	60035606	BolC9t59602H	0	-	597	2022	2411	0.8386562
C9	60035883	60036392	BolC9t59603H	0	-	114	130	509	0.2554027
C9	60036895	60037606	BolC9t59604H	0	-	128	656	711	0.9226441
C9	60038173	60039508	BolC9t59605H	0	+	42	962	1335	0.7205992
C9	60042612	60042942	BolC9t59606H	0	+	156	330	330	1.0000000
C9	60043461	60045936	BolC9t59607H	0	+	1133	2255	2475	0.9111111
C9	60046066	60046332	BolC9t59608H	0	+	77	266	266	1.0000000
C9	60046394	60046568	BolC9t59609H	0	+	120	174	174	1.0000000
C9	60046937	60049074	BolC9t59610H	0	-	862	2102	2137	0.9836219
C9	60050619	60051178	BolC9t59611H	0	-	110	497	559	0.8890877
C9	60051634	60053577	BolC9t59612H	0	+	740	1943	1943	1.0000000
C9	60053792	60055380	BolC9t59613H	0	-	380	1586	1588	0.9987406
C9	60056135	60061985	BolC9t59614H	0	-	2522	5500	5850	0.9401709
C9	60062932	60070659	BolC9t59615H	0	-	161	2234	7727	0.2891161
C9	60073022	60074024	BolC9t59616H	0	+	137	862	1002	0.8602794
C9	60074500	60074638	BolC9t59617H	0	-	2	105	138	0.7608696
C9	60076595	60077141	BolC9t59618H	0	-	342	546	546	1.0000000
C9	60079048	60080254	BolC9t59619H	0	+	223	1119	1206	0.9278607
C9	60081046	60086855	BolC9t59620H	0	+	1327	4915	5809	0.8461009
C9	60089438	60091495	BolC9t59621H	0	-	1329	2053	2057	0.9980554
C9	60093236	60094042	BolC9t59622H	0	-	606	806	806	1.0000000
C9	60094866	60095031	BolC9t59623H	0	-	259	165	165	1.0000000
C9	60097449	60098807	BolC9t59624H	0	+	931	1358	1358	1.0000000
C9	60099427	60101888	BolC9t59625H	0	+	1200	2427	2461	0.9861845
C9	60102331	60104299	BolC9t59626H	0	+	777	1968	1968	1.0000000
C9	60107839	60108256	BolC9t59627H	0	+	729	417	417	1.0000000
C9	60110221	60111373	BolC9t59628H	0	-	507	1146	1152	0.9947917
C9	60121102	60123932	BolC9t59629H	0	+	1795	2779	2830	0.9819788
C9	60124916	60126797	BolC9t59630H	0	+	1291	1881	1881	1.0000000
C9	60127378	60133521	BolC9t59631H	0	+	2805	5916	6143	0.9630474
C9	60133783	60135194	BolC9t59632H	0	+	1068	1409	1411	0.9985825
C9	60144632	60145025	BolC9t59633H	0	-	399	393	393	1.0000000
C9	60145341	60145693	BolC9t59634H	0	+	326	349	352	0.9914773
C9	60148646	60150258	BolC9t59635H	0	+	503	1605	1612	0.9956576
C9	60150722	60152486	BolC9t59636H	0	-	1635	1764	1764	1.0000000
C9	60164910	60165216	BolC9t59637H	0	-	14	199	306	0.6503268
C9	60166307	60167965	BolC9t59638H	0	-	226	1390	1658	0.8383595
C9	60169032	60171822	BolC9t59639H	0	-	246	1700	2790	0.6093190
C9	60184291	60184911	BolC9t59640H	0	+	0	0	620	0.0000000
C9	60186212	60187137	BolC9t59641H	0	-	538	745	925	0.8054054
C9	60187382	60187697	BolC9t59642H	0	+	187	315	315	1.0000000
C9	60188573	60191575	BolC9t59643H	0	+	1614	2962	3002	0.9866756
C9	60191617	60193965	BolC9t59644H	0	+	629	1861	2348	0.7925894
C9	60194172	60196943	BolC9t59645H	0	-	1027	2536	2771	0.9151931
C9	60202167	60203637	BolC9t59646H	0	+	829	1470	1470	1.0000000
C9	60208278	60210794	BolC9t59647H	0	+	725	1953	2516	0.7762321
C9	60218616	60221871	BolC9t59648H	0	-	1169	2186	3255	0.6715822
C9	60223640	60230924	BolC9t59649H	0	-	4453	7058	7284	0.9689731
C9	60232181	60242612	BolC9t59650H	0	+	2615	6621	10431	0.6347426
C9	60243318	60244683	BolC9t59651H	0	-	250	1092	1365	0.8000000
C9	60245970	60246794	BolC9t59652H	0	-	267	795	824	0.9648058
C9	60247080	60247475	BolC9t59653H	0	-	276	395	395	1.0000000
C9	60247807	60247981	BolC9t59654H	0	+	146	174	174	1.0000000
C9	60248611	60255459	BolC9t59655H	0	-	1311	5275	6848	0.7702979
C9	60261939	60263254	BolC9t59656H	0	+	816	1315	1315	1.0000000
C9	60263723	60264473	BolC9t59657H	0	+	132	694	750	0.9253333
C9	60267706	60268813	BolC9t59658H	0	-	88	730	1107	0.6594399
C9	60284611	60285973	BolC9t59659H	0	-	360	1193	1362	0.8759178
C9	60287869	60289914	BolC9t59660H	0	-	308	1636	2045	0.8000000
C9	60292467	60292941	BolC9t59661H	0	+	91	407	474	0.8586498
C9	60293218	60295219	BolC9t59662H	0	-	1145	1650	2001	0.8245877
C9	60304641	60306375	BolC9t59663H	0	-	840	1734	1734	1.0000000
C9	60307078	60308419	BolC9t59664H	0	-	80	820	1341	0.6114840
C9	60309349	60310744	BolC9t59665H	0	-	255	1298	1395	0.9304659
C9	60312677	60313123	BolC9t59666H	0	-	99	299	446	0.6704036
C9	60314661	60316490	BolC9t59667H	0	+	346	1618	1829	0.8846364
C9	60316555	60318445	BolC9t59668H	0	+	822	1823	1890	0.9645503
C9	60318945	60320916	BolC9t59669H	0	-	430	1929	1971	0.9786910
C9	60321615	60323577	BolC9t59670H	0	+	618	1835	1962	0.9352701
C9	60323929	60328733	BolC9t59671H	0	+	936	4189	4804	0.8719817
C9	60330960	60331657	BolC9t59672H	0	-	129	626	697	0.8981349
C9	60334617	60339733	BolC9t59673H	0	-	3389	5089	5116	0.9947224
C9	60343497	60345098	BolC9t59674H	0	+	920	1601	1601	1.0000000
C9	60359309	60360735	BolC9t59675H	0	+	1539	1426	1426	1.0000000
C9	60367215	60368597	BolC9t59676H	0	-	111	1119	1382	0.8096961
C9	60379743	60383719	BolC9t59677H	0	+	1873	3415	3976	0.8589034
C9	60386055	60387161	BolC9t59678H	0	-	116	966	1106	0.8734177
C9	60388538	60388826	BolC9t59679H	0	+	83	233	288	0.8090278
C9	60389801	60391297	BolC9t59680H	0	+	157	1065	1496	0.7118984
C9	60391652	60393077	BolC9t59681H	0	-	1742	1425	1425	1.0000000
C9	60393876	60395428	BolC9t59682H	0	-	1117	1552	1552	1.0000000
C9	60395839	60398348	BolC9t59683H	0	+	936	2372	2509	0.9453965
C9	60406487	60410180	BolC9t59684H	0	+	639	3031	3693	0.8207420
C9	60418045	60420164	BolC9t59685H	0	+	596	1760	2119	0.8305805
C9	60424387	60425876	BolC9t59686H	0	+	28	361	1489	0.2424446
C9	60431809	60432067	BolC9t59687H	0	-	17	119	258	0.4612403
C9	60432267	60432694	BolC9t59688H	0	-	125	349	427	0.8173302
C9	60441807	60445983	BolC9t59689H	0	+	1922	4011	4176	0.9604885
C9	60447308	60450716	BolC9t59690H	0	+	2150	3332	3408	0.9776995
C9	60452342	60453420	BolC9t59691H	0	+	113	710	1078	0.6586271
C9	60453471	60464362	BolC9t59692H	0	+	4154	8285	10891	0.7607198
C9	60465353	60465833	BolC9t59693H	0	+	484	480	480	1.0000000
C9	60466290	60469303	BolC9t59694H	0	-	1399	3013	3013	1.0000000
C9	60479781	60480633	BolC9t59695H	0	+	271	779	852	0.9143193
C9	60481061	60484203	BolC9t59696H	0	+	1330	3097	3142	0.9856779
C9	60484565	60488435	BolC9t59697H	0	-	782	3151	3870	0.8142119
C9	60490420	60492086	BolC9t59698H	0	+	386	1557	1666	0.9345738
C9	60494465	60496108	BolC9t59699H	0	+	647	970	1643	0.5903835
C9	60498848	60500838	BolC9t59700H	0	+	632	1698	1990	0.8532664
C9	60501331	60502075	BolC9t59701H	0	-	160	604	744	0.8118280
C9	60504769	60505468	BolC9t59702H	0	-	199	696	699	0.9957082
C9	60506472	60507383	BolC9t59703H	0	-	369	876	911	0.9615807
C9	60509042	60509907	BolC9t59704H	0	-	443	865	865	1.0000000
C9	60512047	60515070	BolC9t59705H	0	+	816	2642	3023	0.8739663
C9	60516578	60517319	BolC9t59706H	0	+	75	585	741	0.7894737
C9	60518424	60519305	BolC9t59707H	0	-	291	808	881	0.9171396
C9	60522171	60522890	BolC9t59708H	0	-	491	712	719	0.9902642
C9	60525991	60527266	BolC9t59709H	0	-	623	1208	1275	0.9474510
C9	60530911	60532272	BolC9t59710H	0	-	1628	1109	1361	0.8148420
C9	60533859	60534559	BolC9t59711H	0	-	9	145	700	0.2071429
C9	60537572	60538193	BolC9t59712H	0	+	85	525	621	0.8454106
C9	60539812	60542307	BolC9t59713H	0	-	977	2122	2495	0.8505010
C9	60543537	60545220	BolC9t59714H	0	-	1019	1659	1683	0.9857398
C9	60550111	60558606	BolC9t59715H	0	+	4051	7485	8495	0.8811066
C9	60559046	60560506	BolC9t59716H	0	+	373	1451	1460	0.9938356
C9	60568786	60569212	BolC9t59717H	0	+	181	391	426	0.9178404
C9	60573573	60573681	BolC9t59718H	0	-	25	94	108	0.8703704
C9	60575000	60575982	BolC9t59719H	0	-	37	646	982	0.6578411
C9	60576461	60576662	BolC9t59720H	0	-	5	115	201	0.5721393
C9	60577256	60578412	BolC9t59721H	0	+	538	1156	1156	1.0000000
C9	60589212	60591523	BolC9t59722H	0	+	1091	2112	2311	0.9138901
C9	60604043	60608248	BolC9t59723H	0	+	2924	4154	4205	0.9878716
C9	60609029	60609506	BolC9t59724H	0	+	233	477	477	1.0000000
C9	60610184	60611783	BolC9t59725H	0	-	1153	1599	1599	1.0000000
C9	60613385	60616072	BolC9t59726H	0	+	1061	2595	2687	0.9657611
C9	60616205	60618833	BolC9t59727H	0	-	827	2277	2628	0.8664383
C9	60621036	60621812	BolC9t59728H	0	-	49	723	776	0.9317010
C9	60622302	60623435	BolC9t59729H	0	-	305	997	1133	0.8799647
C9	60625000	60626102	BolC9t59730H	0	-	871	1076	1102	0.9764065
C9	60626898	60628013	BolC9t59731H	0	-	130	920	1115	0.8251121
C9	60636675	60637138	BolC9t59732H	0	+	820	463	463	1.0000000
C9	60638189	60644973	BolC9t59733H	0	-	779	5054	6784	0.7449882
C9	60645949	60648407	BolC9t59734H	0	+	1686	2458	2458	1.0000000
C9	60649355	60651267	BolC9t59735H	0	-	369	1720	1912	0.8995816
C9	60653293	60656664	BolC9t59736H	0	-	2645	3371	3371	1.0000000
C9	60659338	60661643	BolC9t59737H	0	-	2233	2305	2305	1.0000000
C9	60665229	60666104	BolC9t59738H	0	-	6	362	875	0.4137143
C9	60675942	60676608	BolC9t59739H	0	+	550	666	666	1.0000000
C9	60678804	60680644	BolC9t59740H	0	+	1207	1744	1840	0.9478261
C9	60681341	60681908	BolC9t59741H	0	+	273	567	567	1.0000000
C9	60682900	60684560	BolC9t59742H	0	+	1203	1660	1660	1.0000000
C9	60684752	60686711	BolC9t59743H	0	-	291	1387	1959	0.7080143
C9	60690978	60691293	BolC9t59744H	0	-	496	315	315	1.0000000
C9	60693728	60695223	BolC9t59745H	0	+	270	1401	1495	0.9371238
C9	60699838	60700287	BolC9t59746H	0	-	0	0	449	0.0000000
C9	60703686	60705151	BolC9t59747H	0	+	691	1454	1465	0.9924915
C9	60714388	60716444	BolC9t59748H	0	+	815	1830	2056	0.8900778
C9	60717767	60720201	BolC9t59749H	0	-	539	2121	2434	0.8714051
C9	60721983	60723119	BolC9t59750H	0	+	1223	1136	1136	1.0000000
C9	60724330	60724705	BolC9t59751H	0	-	264	375	375	1.0000000
C9	60725280	60729267	BolC9t59752H	0	+	948	3340	3987	0.8377226
C9	60730330	60731657	BolC9t59753H	0	-	267	1037	1327	0.7814620
C9	60734086	60736775	BolC9t59754H	0	+	1246	2296	2689	0.8538490
C9	60738804	60740445	BolC9t59755H	0	-	877	1641	1641	1.0000000
C9	60740873	60741164	BolC9t59756H	0	-	270	291	291	1.0000000
C9	60753967	60755000	BolC9t59757H	0	+	17	418	1033	0.4046467
C9	60756140	60756520	BolC9t59758H	0	-	10	58	380	0.1526316
C9	60757835	60759668	BolC9t59759H	0	-	177	702	1833	0.3829787
C9	60762178	60763435	BolC9t59760H	0	+	458	1020	1257	0.8114558
C9	60767579	60768001	BolC9t59761H	0	+	54	253	422	0.5995260
C9	60775908	60777556	BolC9t59762H	0	-	809	1648	1648	1.0000000
C9	60778798	60782521	BolC9t59763H	0	+	2374	3723	3723	1.0000000
C9	60783247	60787235	BolC9t59764H	0	+	1838	3833	3988	0.9611334
C9	60790887	60792482	BolC9t59765H	0	+	548	1595	1595	1.0000000
C9	60793031	60794913	BolC9t59766H	0	+	321	1470	1882	0.7810839
C9	60795058	60796897	BolC9t59767H	0	+	480	1777	1839	0.9662860
C9	60812676	60817585	BolC9t59768H	0	+	1495	4531	4909	0.9229985
C9	60820369	60820778	BolC9t59769H	0	-	192	409	409	1.0000000
C9	60822058	60824476	BolC9t59770H	0	+	151	1225	2418	0.5066170
C9	60824837	60825902	BolC9t59771H	0	-	534	1065	1065	1.0000000
C9	60827718	60828483	BolC9t59772H	0	-	45	225	765	0.2941177
C9	60832405	60832975	BolC9t59773H	0	+	73	455	570	0.7982456
C9	60833434	60834013	BolC9t59774H	0	-	5	135	579	0.2331606
C9	60837371	60837938	BolC9t59775H	0	+	0	0	567	0.0000000
C9	60840590	60841355	BolC9t59776H	0	-	54	271	765	0.3542484
C9	60843264	60843831	BolC9t59777H	0	+	34	170	567	0.2998236
C9	60844755	60845245	BolC9t59778H	0	+	493	490	490	1.0000000
C9	60846567	60847290	BolC9t59779H	0	+	84	591	723	0.8174274
C9	60847457	60851285	BolC9t59780H	0	-	777	3241	3828	0.8466562
C9	60871219	60873369	BolC9t59781H	0	+	860	2094	2150	0.9739535
C9	60874241	60874896	BolC9t59782H	0	+	138	655	655	1.0000000
C9	60878606	60881045	BolC9t59783H	0	+	906	2439	2439	1.0000000
C9	60881434	60882810	BolC9t59784H	0	+	591	1368	1376	0.9941860
C9	60883044	60886083	BolC9t59785H	0	-	978	3039	3039	1.0000000
C9	60887612	60889650	BolC9t59786H	0	-	975	1986	2038	0.9744848
C9	60895305	60895812	BolC9t59787H	0	-	413	507	507	1.0000000
C9	60897499	60899056	BolC9t59788H	0	-	761	1557	1557	1.0000000
C9	60899771	60904264	BolC9t59789H	0	-	1360	4217	4493	0.9385711
C9	60904900	60906338	BolC9t59790H	0	-	1530	1438	1438	1.0000000
C9	60908179	60908380	BolC9t59791H	0	+	112	201	201	1.0000000
C9	60910730	60911444	BolC9t59792H	0	+	47	558	714	0.7815126
C9	60912017	60912917	BolC9t59793H	0	+	684	899	900	0.9988889
C9	60914896	60917065	BolC9t59794H	0	-	1739	2169	2169	1.0000000
C9	60917591	60920682	BolC9t59795H	0	-	1395	3091	3091	1.0000000
C9	60924734	60927920	BolC9t59796H	0	+	1593	2999	3186	0.9413057
C9	60929489	60931042	BolC9t59797H	0	-	937	1553	1553	1.0000000
C9	60932244	60932706	BolC9t59798H	0	+	112	462	462	1.0000000
C9	60932892	60933772	BolC9t59799H	0	-	892	880	880	1.0000000
C9	60940184	60940556	BolC9t59800H	0	-	27	309	372	0.8306451
C9	60946253	60946580	BolC9t59801H	0	+	482	327	327	1.0000000
C9	60949195	60949777	BolC9t59802H	0	+	7	354	582	0.6082474
C9	60955062	60955368	BolC9t59803H	0	+	383	306	306	1.0000000
C9	60957006	60957790	BolC9t59804H	0	-	15	598	784	0.7627551
C9	60959998	60960502	BolC9t59805H	0	+	937	504	504	1.0000000
C9	60962507	60966315	BolC9t59806H	0	-	2298	2917	3808	0.7660189
C9	60963671	60963977	BolC9t59807H	0	+	33	306	306	1.0000000
C9	60970104	60971053	BolC9t59808H	0	-	638	949	949	1.0000000
C9	60973913	60974618	BolC9t59809H	0	-	614	705	705	1.0000000
C9	60976629	60977205	BolC9t59810H	0	+	827	576	576	1.0000000
C9	60982080	60982278	BolC9t59811H	0	+	82	198	198	1.0000000
C9	60985431	60985737	BolC9t59812H	0	+	328	306	306	1.0000000
C9	60987650	60988487	BolC9t59813H	0	-	62	369	837	0.4408602
C9	60995065	61003422	BolC9t59814H	0	-	1561	5591	8357	0.6690200
C9	61003871	61003982	BolC9t59815H	0	+	3	105	111	0.9459459
C9	61006104	61006941	BolC9t59816H	0	-	2	167	837	0.1995221
C9	61008522	61009098	BolC9t59817H	0	+	570	576	576	1.0000000
C9	61010370	61010774	BolC9t59818H	0	-	286	404	404	1.0000000
C9	61011297	61013531	BolC9t59819H	0	+	1268	2219	2234	0.9932856
C9	61023950	61025819	BolC9t59820H	0	+	835	1765	1869	0.9443552
C9	61028140	61028945	BolC9t59821H	0	-	604	805	805	1.0000000
C9	61029154	61033917	BolC9t59822H	0	-	2717	4591	4763	0.9638883
C9	61040869	61043071	BolC9t59823H	0	-	1680	2202	2202	1.0000000
C9	61043925	61045732	BolC9t59824H	0	-	309	1515	1807	0.8384062
C9	61050725	61053592	BolC9t59825H	0	+	1963	2835	2867	0.9888385
C9	61054197	61055153	BolC9t59826H	0	+	710	956	956	1.0000000
C9	61056543	61056987	BolC9t59827H	0	-	166	444	444	1.0000000
C9	61068409	61077427	BolC9t59828H	0	-	1377	5408	9018	0.5996895
C9	61079161	61080350	BolC9t59829H	0	-	73	775	1189	0.6518083
C9	61086594	61101161	BolC9t59830H	0	-	550	4127	14567	0.2833116
C9	61088450	61089081	BolC9t59831H	0	+	8	150	631	0.2377179
C9	61102555	61103188	BolC9t59832H	0	+	1	39	633	0.0616114
C9	61107002	61107841	BolC9t59833H	0	+	204	806	839	0.9606675
C9	61117211	61118979	BolC9t59834H	0	+	1164	1768	1768	1.0000000
C9	61119389	61122388	BolC9t59835H	0	-	1398	2840	2999	0.9469823
C9	61123780	61127201	BolC9t59836H	0	+	1015	3186	3421	0.9313067
C9	61127521	61132060	BolC9t59837H	0	-	1697	3540	4539	0.7799075
C9	61132111	61133469	BolC9t59838H	0	-	1123	1358	1358	1.0000000
C9	61133730	61134653	BolC9t59839H	0	+	1031	923	923	1.0000000
C9	61135188	61139103	BolC9t59840H	0	+	2976	3664	3915	0.9358876
C9	61140083	61144018	BolC9t59841H	0	-	1390	3462	3935	0.8797967
C9	61147345	61148657	BolC9t59842H	0	+	653	1003	1312	0.7644817
C9	61149104	61149458	BolC9t59843H	0	-	218	354	354	1.0000000
C9	61150440	61150980	BolC9t59844H	0	-	147	540	540	1.0000000
C9	61151048	61153842	BolC9t59845H	0	-	1782	2752	2794	0.9849678
C9	61156579	61158594	BolC9t59846H	0	+	2142	2015	2015	1.0000000
C9	61159204	61160829	BolC9t59847H	0	+	500	1586	1625	0.9760000
C9	61161339	61163317	BolC9t59848H	0	-	128	1176	1978	0.5945399
C9	61169908	61170531	BolC9t59849H	0	-	0	0	623	0.0000000
C9	61171151	61173138	BolC9t59850H	0	-	202	1265	1987	0.6366382
C9	61180100	61182213	BolC9t59851H	0	-	126	965	2113	0.4566966
C9	61187279	61189132	BolC9t59852H	0	-	1379	1853	1853	1.0000000
C9	61189729	61191594	BolC9t59853H	0	-	1348	1801	1865	0.9656836
C9	61193834	61194125	BolC9t59854H	0	+	243	291	291	1.0000000
C9	61198688	61200320	BolC9t59855H	0	-	429	1427	1632	0.8743873
C9	61201630	61203635	BolC9t59856H	0	-	766	1891	2005	0.9431421
C9	61204175	61206519	BolC9t59857H	0	-	1120	2344	2344	1.0000000
C9	61207194	61208908	BolC9t59858H	0	-	901	1714	1714	1.0000000
C9	61209442	61211485	BolC9t59859H	0	-	1002	2043	2043	1.0000000
C9	61212179	61214573	BolC9t59860H	0	-	732	2212	2394	0.9239766
C9	61218236	61222256	BolC9t59861H	0	-	203	2082	4020	0.5179104
C9	61223379	61225521	BolC9t59862H	0	+	368	1957	2142	0.9136321
C9	61229370	61231738	BolC9t59863H	0	+	374	1729	2368	0.7301520
C9	61232122	61233036	BolC9t59864H	0	-	805	914	914	1.0000000
C9	61235411	61237231	BolC9t59865H	0	+	1090	1684	1820	0.9252747
C9	61241224	61242460	BolC9t59866H	0	-	191	1135	1236	0.9182848
C9	61245132	61246920	BolC9t59867H	0	+	1106	1772	1788	0.9910514
C9	61249145	61250082	BolC9t59868H	0	+	96	573	937	0.6115261
C9	61275591	61278082	BolC9t59869H	0	-	1991	2491	2491	1.0000000
C9	61279439	61280137	BolC9t59870H	0	-	281	431	698	0.6174785
C9	61291460	61291694	BolC9t59871H	0	+	357	234	234	1.0000000
C9	61292058	61293892	BolC9t59872H	0	-	524	1485	1834	0.8097056
C9	61299436	61301976	BolC9t59873H	0	+	1077	2508	2540	0.9874015
C9	61302522	61303743	BolC9t59874H	0	-	1473	1221	1221	1.0000000
C9	61305212	61305832	BolC9t59875H	0	-	1096	620	620	1.0000000
C9	61306589	61311633	BolC9t59876H	0	+	3538	5037	5044	0.9986122
C9	61322253	61326205	BolC9t59877H	0	+	1591	3666	3952	0.9276316
C9	61326566	61330255	BolC9t59878H	0	-	1511	3049	3689	0.8265113
C9	61330656	61332045	BolC9t59879H	0	+	438	1312	1389	0.9445645
C9	61332737	61333073	BolC9t59880H	0	+	233	314	336	0.9345238
C9	61334727	61338777	BolC9t59881H	0	+	977	3982	4050	0.9832098
C9	61339173	61340637	BolC9t59882H	0	-	453	1464	1464	1.0000000
C9	61342814	61350013	BolC9t59883H	0	-	1443	5488	7199	0.7623281
C9	61350695	61351619	BolC9t59884H	0	+	905	924	924	1.0000000
C9	61352371	61354476	BolC9t59885H	0	-	956	2083	2105	0.9895487
C9	61354857	61356697	BolC9t59886H	0	+	775	1840	1840	1.0000000
C9	61357170	61357728	BolC9t59887H	0	-	174	558	558	1.0000000
C9	61358230	61365092	BolC9t59888H	0	-	5750	6862	6862	1.0000000
C9	61365197	61366435	BolC9t59889H	0	-	593	1054	1238	0.8513732
C9	61368824	61369439	BolC9t59890H	0	-	468	615	615	1.0000000
C9	61373236	61374241	BolC9t59891H	0	-	892	1005	1005	1.0000000
C9	61376276	61377731	BolC9t59892H	0	+	432	1411	1455	0.9697595
C9	61378726	61379064	BolC9t59893H	0	-	287	338	338	1.0000000
C9	61386639	61387287	BolC9t59894H	0	-	165	648	648	1.0000000
C9	61387627	61388319	BolC9t59895H	0	+	192	653	692	0.9436416
C9	61388695	61389058	BolC9t59896H	0	-	11	269	363	0.7410468
C9	61390359	61391140	BolC9t59897H	0	-	99	612	781	0.7836108
C9	61392528	61392744	BolC9t59898H	0	-	92	216	216	1.0000000
C9	61393676	61394948	BolC9t59899H	0	-	1160	1232	1272	0.9685535
C9	61401157	61402714	BolC9t59900H	0	+	920	1454	1557	0.9338471
C9	61403200	61404442	BolC9t59901H	0	+	1381	1242	1242	1.0000000
C9	61404771	61407503	BolC9t59902H	0	-	2498	2732	2732	1.0000000
C9	61408581	61408920	BolC9t59903H	0	+	360	339	339	1.0000000
C9	61409421	61410797	BolC9t59904H	0	-	861	1288	1376	0.9360465
C9	61415539	61416082	BolC9t59905H	0	+	205	522	543	0.9613259
C9	61421907	61422951	BolC9t59906H	0	-	1052	1044	1044	1.0000000
C9	61424874	61426729	BolC9t59907H	0	+	1134	1634	1855	0.8808625
C9	61427897	61428587	BolC9t59908H	0	+	573	690	690	1.0000000
C9	61435463	61437545	BolC9t59909H	0	+	1012	2031	2082	0.9755043
C9	61438043	61439738	BolC9t59910H	0	-	1098	1695	1695	1.0000000
C9	61442711	61443125	BolC9t59911H	0	-	224	414	414	1.0000000
C9	61444004	61448384	BolC9t59912H	0	-	1106	4199	4380	0.9586758
C9	61449045	61451583	BolC9t59913H	0	+	336	2233	2538	0.8798267
C9	61453124	61453352	BolC9t59914H	0	-	179	228	228	1.0000000
C9	61465697	61465975	BolC9t59915H	0	-	428	278	278	1.0000000
C9	61470752	61472714	BolC9t59916H	0	-	190	1554	1962	0.7920489
C9	61475341	61477269	BolC9t59917H	0	-	1302	1911	1928	0.9911826
C9	61480692	61484892	BolC9t59918H	0	-	660	3078	4200	0.7328572
C9	61488941	61490015	BolC9t59919H	0	-	815	1073	1074	0.9990689
C9	61491998	61492511	BolC9t59920H	0	-	80	433	513	0.8440546
C9	61496523	61497309	BolC9t59921H	0	-	73	603	786	0.7671756
C9	61501931	61502751	BolC9t59922H	0	+	81	502	820	0.6121951
C9	61503620	61520281	BolC9t59923H	0	-	6300	15134	16661	0.9083489
C9	61511426	61511757	BolC9t59924H	0	-	165	331	331	1.0000000
C9	61527539	61535622	BolC9t59925H	0	+	2610	4790	8083	0.5926018
C9	61536905	61540015	BolC9t59926H	0	-	510	1941	3110	0.6241158
C9	61540950	61544525	BolC9t59927H	0	+	967	3438	3575	0.9616783
C9	61546688	61549798	BolC9t59928H	0	+	512	2675	3110	0.8601286
C9	61551229	61552183	BolC9t59929H	0	+	193	849	954	0.8899371
C9	61553368	61558669	BolC9t59930H	0	+	1574	4956	5301	0.9349179
C9	61559100	61562995	BolC9t59931H	0	-	641	3560	3895	0.9139923
C9	61564942	61566778	BolC9t59932H	0	+	764	1814	1836	0.9880174
C9	61567091	61568031	BolC9t59933H	0	-	308	937	940	0.9968085
C9	61568514	61570068	BolC9t59934H	0	+	172	1272	1554	0.8185328
C9	61570902	61576153	BolC9t59935H	0	-	938	4759	5251	0.9063036
C9	61577472	61578618	BolC9t59936H	0	-	187	797	1146	0.6954625
C9	61582312	61582801	BolC9t59937H	0	-	392	453	489	0.9263804
C9	61583487	61586896	BolC9t59938H	0	-	925	3194	3409	0.9369317
C9	61587432	61588462	BolC9t59939H	0	+	1200	1030	1030	1.0000000
C9	61589139	61589566	BolC9t59940H	0	+	432	427	427	1.0000000
C9	61590406	61593203	BolC9t59941H	0	+	860	2500	2797	0.8938148
C9	61593407	61594079	BolC9t59942H	0	-	98	654	672	0.9732143
C9	61598408	61601124	BolC9t59943H	0	+	1354	2657	2716	0.9782768
C9	61602064	61603453	BolC9t59944H	0	+	1268	1389	1389	1.0000000
C9	61604137	61607670	BolC9t59945H	0	-	179	1199	3533	0.3393717
C9	61610694	61611194	BolC9t59946H	0	+	17	318	500	0.6360000
C9	61618653	61618973	BolC9t59947H	0	+	290	320	320	1.0000000
C9	61643108	61648928	BolC9t59948H	0	+	559	3527	5820	0.6060138
C9	61650320	61651901	BolC9t59949H	0	-	667	1581	1581	1.0000000
C9	61654739	61656284	BolC9t59950H	0	+	1426	1545	1545	1.0000000
C9	61658685	61659465	BolC9t59951H	0	-	524	780	780	1.0000000
C9	61664289	61665752	BolC9t59952H	0	+	1661	1463	1463	1.0000000
C9	61666459	61670588	BolC9t59953H	0	-	1307	3929	4129	0.9515621
C9	61671300	61671711	BolC9t59954H	0	-	107	411	411	1.0000000
C9	61673623	61677619	BolC9t59955H	0	+	2605	3923	3996	0.9817317
C9	61678084	61681938	BolC9t59956H	0	-	1762	3837	3854	0.9955890
C9	61682688	61682859	BolC9t59957H	0	-	200	171	171	1.0000000
C9	61683710	61686027	BolC9t59958H	0	+	1304	2310	2317	0.9969789
C9	61688350	61689445	BolC9t59959H	0	-	1164	1095	1095	1.0000000
C9	61689834	61691328	BolC9t59960H	0	-	566	1489	1494	0.9966533
C9	61691958	61694315	BolC9t59961H	0	-	1144	2246	2357	0.9529063
C9	61694632	61695847	BolC9t59962H	0	+	668	1215	1215	1.0000000
C9	61695984	61697353	BolC9t59963H	0	-	1376	1369	1369	1.0000000
C9	61697973	61700784	BolC9t59964H	0	-	2083	2772	2811	0.9861259
C9	61702585	61710260	BolC9t59965H	0	-	4099	7264	7675	0.9464495
C9	61721234	61723007	BolC9t59966H	0	+	1149	1773	1773	1.0000000
C9	61724097	61729293	BolC9t59967H	0	+	2818	5049	5196	0.9717090
C9	61732787	61734179	BolC9t59968H	0	+	991	1392	1392	1.0000000
C9	61737831	61740385	BolC9t59969H	0	-	1584	2129	2554	0.8335944
C9	61742079	61744851	BolC9t59970H	0	-	1401	2620	2772	0.9451659
C9	61747498	61749439	BolC9t59971H	0	-	433	1614	1941	0.8315302
C9	61752229	61757746	BolC9t59972H	0	+	2298	5165	5517	0.9361972
C9	61774226	61774628	BolC9t59973H	0	+	22	147	402	0.3656716
C9	61780557	61783926	BolC9t59974H	0	-	318	2964	3369	0.8797863
C9	61787167	61788551	BolC9t59975H	0	-	977	1320	1384	0.9537572
C9	61790094	61793264	BolC9t59976H	0	+	1520	3053	3170	0.9630915
C9	61804207	61804567	BolC9t59977H	0	-	170	360	360	1.0000000
C9	61805847	61808048	BolC9t59978H	0	-	816	2195	2201	0.9972740
C9	61809291	61810329	BolC9t59979H	0	-	13	282	1038	0.2716763
C9	61812622	61842678	BolC9t59980H	0	-	5720	19516	30056	0.6493213
C9	61844079	61845206	BolC9t59981H	0	-	32	281	1127	0.2493345
C9	61848844	61855426	BolC9t59982H	0	-	86	858	6582	0.1303555
C9	61860216	61860339	BolC9t59983H	0	-	0	0	123	0.0000000
C9	61893124	61897760	BolC9t59984H	0	-	931	3296	4636	0.7109577
C9	61898860	61900058	BolC9t59985H	0	-	109	731	1198	0.6101837
C9	61918016	61920637	BolC9t59986H	0	-	1325	2532	2621	0.9660435
C9	61921152	61921539	BolC9t59987H	0	-	344	387	387	1.0000000
C9	61923152	61923548	BolC9t59988H	0	-	123	396	396	1.0000000
C9	61926939	61927287	BolC9t59989H	0	-	281	268	348	0.7701150
C9	61928539	61929256	BolC9t59990H	0	+	373	717	717	1.0000000
C9	61930423	61930696	BolC9t59991H	0	-	560	273	273	1.0000000
C9	61936456	61937123	BolC9t59992H	0	-	23	184	667	0.2758621
C9	61938679	61940487	BolC9t59993H	0	+	929	1808	1808	1.0000000
C9	61961295	61962007	BolC9t59994H	0	-	434	294	712	0.4129213
C9	61964140	61965863	BolC9t59995H	0	+	4	29	1723	0.0168311
C9	61969894	61973845	BolC9t59996H	0	-	3230	3748	3951	0.9486206
C9	61974740	61975437	BolC9t59997H	0	+	190	638	697	0.9153515
C9	61977790	61981922	BolC9t59998H	0	+	2017	4021	4132	0.9731365
C9	61982658	61988687	BolC9t59999H	0	-	3545	5202	6029	0.8628297
C9	62004880	62006578	BolC9t60000H	0	+	1711	1698	1698	1.0000000
C9	62006906	62007859	BolC9t60001H	0	+	1194	953	953	1.0000000
C9	62008272	62010208	BolC9t60002H	0	-	2451	1936	1936	1.0000000
C9	62011593	62015922	BolC9t60003H	0	-	2378	4252	4329	0.9822130
C9	62026358	62029116	BolC9t60004H	0	+	1818	2730	2758	0.9898477
C9	62029384	62030356	BolC9t60005H	0	-	346	963	972	0.9907407
C9	62031170	62032385	BolC9t60006H	0	-	209	1093	1215	0.8995885
C9	62033829	62035224	BolC9t60007H	0	+	173	939	1395	0.6731183
C9	62038488	62040320	BolC9t60008H	0	-	854	1832	1832	1.0000000
C9	62041236	62043010	BolC9t60009H	0	+	1535	1774	1774	1.0000000
C9	62044392	62044980	BolC9t60010H	0	-	386	588	588	1.0000000
C9	62046239	62053881	BolC9t60011H	0	-	1069	5940	7642	0.7772834
C9	62056059	62057348	BolC9t60012H	0	-	60	663	1289	0.5143522
C9	62067485	62070194	BolC9t60013H	0	+	217	2339	2709	0.8634182
C9	62073589	62073991	BolC9t60014H	0	-	75	255	402	0.6343284
C9	62075361	62080203	BolC9t60015H	0	-	2915	4638	4842	0.9578686
C9	62081896	62084152	BolC9t60016H	0	-	614	1695	2256	0.7513298
C9	62086532	62096351	BolC9t60017H	0	-	4201	9313	9819	0.9484673
C9	62098123	62098369	BolC9t60018H	0	+	355	246	246	1.0000000
C9	62101400	62105845	BolC9t60019H	0	+	2177	4325	4445	0.9730034
C9	62109131	62111583	BolC9t60020H	0	+	1417	2245	2452	0.9155791
C9	62151648	62151951	BolC9t60021H	0	-	320	303	303	1.0000000
C9	62154094	62155599	BolC9t60022H	0	-	1255	1505	1505	1.0000000
C9	62157189	62158293	BolC9t60023H	0	+	518	1058	1104	0.9583333
C9	62158932	62160654	BolC9t60024H	0	+	688	1616	1722	0.9384437
C9	62165200	62167591	BolC9t60025H	0	+	175	1398	2391	0.5846926
C9	62168385	62169323	BolC9t60026H	0	+	260	739	938	0.7878465
C9	62172138	62172456	BolC9t60027H	0	+	0	0	318	0.0000000
C9	62172953	62173688	BolC9t60028H	0	+	0	0	735	0.0000000
C9	62175575	62177398	BolC9t60029H	0	+	916	1754	1823	0.9621503
C9	62180322	62180496	BolC9t60030H	0	-	102	174	174	1.0000000
C9	62181963	62182625	BolC9t60031H	0	-	360	662	662	1.0000000
C9	62194556	62196157	BolC9t60032H	0	+	978	1601	1601	1.0000000
C9	62201424	62202879	BolC9t60033H	0	-	717	1455	1455	1.0000000
C9	62208056	62210956	BolC9t60034H	0	+	1647	2864	2900	0.9875862
C9	62211657	62214606	BolC9t60035H	0	+	1235	2908	2949	0.9860970
C9	62214865	62216062	BolC9t60036H	0	-	990	1197	1197	1.0000000
C9	62216823	62219674	BolC9t60037H	0	-	1621	2688	2851	0.9428271
C9	62220440	62220959	BolC9t60038H	0	-	45	403	519	0.7764933
C9	62226365	62228554	BolC9t60039H	0	+	1116	2189	2189	1.0000000
C9	62230792	62231020	BolC9t60040H	0	-	1	120	228	0.5263158
C9	62232342	62233326	BolC9t60041H	0	+	81	610	984	0.6199187
C9	62234880	62235814	BolC9t60042H	0	-	90	853	934	0.9132763
C9	62236136	62237280	BolC9t60043H	0	+	1081	1144	1144	1.0000000
C9	62241412	62242480	BolC9t60044H	0	+	53	842	1068	0.7883895
C9	62258455	62258932	BolC9t60045H	0	-	630	477	477	1.0000000
C9	62259675	62262398	BolC9t60046H	0	+	1255	2355	2723	0.8648549
C9	62263730	62265462	BolC9t60047H	0	-	473	1337	1732	0.7719399
C9	62291226	62291755	BolC9t60048H	0	+	32	434	529	0.8204159
C9	62294068	62294426	BolC9t60049H	0	-	97	316	358	0.8826815
C9	62294587	62295451	BolC9t60050H	0	-	4	142	864	0.1643519
C9	62299578	62302388	BolC9t60051H	0	-	1525	2643	2810	0.9405694
C9	62308030	62312575	BolC9t60052H	0	+	2390	4275	4545	0.9405941
C9	62314187	62315653	BolC9t60053H	0	-	846	1466	1466	1.0000000
C9	62320839	62325942	BolC9t60054H	0	+	1836	4553	5103	0.8922203
C9	62327248	62329084	BolC9t60055H	0	+	1028	1437	1836	0.7826797
C9	62338864	62339697	BolC9t60056H	0	-	297	833	833	1.0000000
C9	62346995	62348444	BolC9t60057H	0	+	187	1208	1449	0.8336784
C9	62349094	62350497	BolC9t60058H	0	+	279	1288	1403	0.9180328
C9	62353479	62356330	BolC9t60059H	0	-	609	2117	2851	0.7425465
C9	62367945	62371062	BolC9t60060H	0	-	1029	2802	3117	0.8989413
C9	62379696	62381268	BolC9t60061H	0	-	1150	1572	1572	1.0000000
C9	62382326	62387971	BolC9t60062H	0	-	2817	5363	5645	0.9500443
C9	62389592	62392647	BolC9t60063H	0	-	486	2242	3055	0.7338789
C9	62397511	62397926	BolC9t60064H	0	+	143	317	415	0.7638554
C9	62400980	62401118	BolC9t60065H	0	-	2	15	138	0.1086956
C9	62402599	62402985	BolC9t60066H	0	-	133	369	386	0.9559585
C9	62404091	62405922	BolC9t60067H	0	-	684	1747	1831	0.9541234
C9	62407273	62411038	BolC9t60068H	0	-	1569	3520	3765	0.9349270
C9	62416058	62417331	BolC9t60069H	0	+	926	1273	1273	1.0000000
C9	62417955	62418753	BolC9t60070H	0	-	173	720	798	0.9022557
C9	62422703	62423008	BolC9t60071H	0	-	414	305	305	1.0000000
C9	62428455	62429197	BolC9t60072H	0	-	684	742	742	1.0000000
C9	62430759	62431378	BolC9t60073H	0	+	1014	619	619	1.0000000
C9	62432495	62435778	BolC9t60074H	0	+	1730	3252	3283	0.9905574
C9	62436208	62441627	BolC9t60075H	0	-	4706	5363	5419	0.9896660
C9	62442317	62443919	BolC9t60076H	0	+	1278	1602	1602	1.0000000
C9	62452309	62453906	BolC9t60077H	0	-	448	1325	1597	0.8296806
C9	62454739	62456606	BolC9t60078H	0	-	1749	1781	1867	0.9539368
C9	62488383	62488707	BolC9t60079H	0	+	792	324	324	1.0000000
C9	62489060	62493775	BolC9t60080H	0	-	3147	4483	4715	0.9507954
C9	62494063	62494246	BolC9t60081H	0	-	99	183	183	1.0000000
C9	62494630	62499141	BolC9t60082H	0	-	669	3402	4511	0.7541565
C9	62504988	62507433	BolC9t60083H	0	+	484	1912	2445	0.7820041
C9	62507775	62510793	BolC9t60084H	0	-	1300	3005	3018	0.9956925
C9	62520194	62520725	BolC9t60085H	0	-	91	476	531	0.8964218
C9	62520830	62522695	BolC9t60086H	0	+	704	1793	1865	0.9613941
C9	62530345	62530537	BolC9t60087H	0	+	1	58	192	0.3020833
C9	62539406	62545227	BolC9t60088H	0	+	3441	5762	5821	0.9898643
C9	62546078	62547146	BolC9t60089H	0	+	454	1011	1068	0.9466292
C9	62548017	62548215	BolC9t60090H	0	+	210	198	198	1.0000000
C9	62559363	62560016	BolC9t60091H	0	+	865	653	653	1.0000000
C9	62577789	62579528	BolC9t60092H	0	+	890	1686	1739	0.9695227
C9	62580819	62583624	BolC9t60093H	0	+	1159	2726	2805	0.9718360
C9	62584038	62586275	BolC9t60094H	0	-	806	2062	2237	0.9217702
C9	62588054	62590775	BolC9t60095H	0	-	667	2393	2721	0.8794561
C9	62597169	62597688	BolC9t60096H	0	-	8	103	519	0.1984586
C9	62598174	62623045	BolC9t60097H	0	+	4833	16981	24871	0.6827630
C9	62606425	62632119	BolC9t60098H	0	+	2344	12249	25694	0.4767261
C9	62610435	62611320	BolC9t60099H	0	+	45	469	885	0.5299435
C9	62612034	62612667	BolC9t60100H	0	+	195	633	633	1.0000000
C9	62620088	62620769	BolC9t60101H	0	-	13	365	681	0.5359765
C9	62633484	62634369	BolC9t60102H	0	+	0	0	885	0.0000000
C9	62635045	62635698	BolC9t60103H	0	+	150	653	653	1.0000000
C9	62638582	62640243	BolC9t60104H	0	+	888	1661	1661	1.0000000
C9	62641009	62641629	BolC9t60105H	0	+	430	620	620	1.0000000
C9	62642022	62644122	BolC9t60106H	0	-	666	1871	2100	0.8909524
C9	62644949	62645951	BolC9t60107H	0	+	675	1002	1002	1.0000000
C9	62646416	62648001	BolC9t60108H	0	-	570	1585	1585	1.0000000
C9	62648763	62650579	BolC9t60109H	0	-	1178	1816	1816	1.0000000
C9	62653391	62655149	BolC9t60110H	0	-	1092	1758	1758	1.0000000
C9	62679992	62680359	BolC9t60111H	0	+	147	367	367	1.0000000
C9	62684401	62686216	BolC9t60112H	0	+	606	1715	1815	0.9449036
C9	62687399	62688439	BolC9t60113H	0	+	344	971	1040	0.9336538
C9	62691312	62692876	BolC9t60114H	0	-	508	1564	1564	1.0000000
C9	62693544	62697277	BolC9t60115H	0	-	2961	3733	3733	1.0000000
C9	62697593	62701610	BolC9t60116H	0	+	1519	3753	4017	0.9342793
C9	62701866	62703281	BolC9t60117H	0	-	316	1213	1415	0.8572438
C9	62704385	62707303	BolC9t60118H	0	+	932	2895	2918	0.9921179
C9	62708527	62708833	BolC9t60119H	0	-	157	306	306	1.0000000
C9	62709541	62710473	BolC9t60120H	0	+	652	932	932	1.0000000
C9	62712152	62712698	BolC9t60121H	0	+	522	546	546	1.0000000
C9	62713586	62715851	BolC9t60122H	0	+	769	2202	2265	0.9721854
C9	62717684	62717810	BolC9t60123H	0	-	37	52	126	0.4126984
C9	62717693	62718177	BolC9t60124H	0	+	380	419	484	0.8657025
C9	62719264	62720143	BolC9t60125H	0	+	396	879	879	1.0000000
C9	62721400	62722759	BolC9t60126H	0	-	227	1303	1359	0.9587932
C9	62728391	62728601	BolC9t60127H	0	+	242	210	210	1.0000000
C9	62729849	62730695	BolC9t60128H	0	-	71	554	846	0.6548463
C9	62732358	62733799	BolC9t60129H	0	-	1168	1368	1441	0.9493408
C9	62741716	62742277	BolC9t60130H	0	-	45	330	561	0.5882353
C9	62742852	62743942	BolC9t60131H	0	+	468	806	1090	0.7394496
C9	62744210	62745049	BolC9t60132H	0	-	331	839	839	1.0000000
C9	62778805	62779291	BolC9t60133H	0	+	295	486	486	1.0000000
C9	62781476	62783507	BolC9t60134H	0	-	678	1946	2031	0.9581487
C9	62785174	62786718	BolC9t60135H	0	-	1185	1544	1544	1.0000000
C9	62786746	62787928	BolC9t60136H	0	+	755	1150	1182	0.9729272
C9	62801063	62803824	BolC9t60137H	0	-	1493	2593	2761	0.9391525
C9	62809627	62810906	BolC9t60138H	0	+	1111	1279	1279	1.0000000
C9	62811276	62814064	BolC9t60139H	0	+	1196	2749	2788	0.9860115
C9	62814666	62815590	BolC9t60140H	0	+	645	924	924	1.0000000
C9	62817969	62820214	BolC9t60141H	0	+	787	2035	2245	0.9064588
C9	62820864	62822391	BolC9t60142H	0	-	709	1487	1527	0.9738048
C9	62828074	62829885	BolC9t60143H	0	+	1904	1800	1811	0.9939260
C9	62831629	62833063	BolC9t60144H	0	+	460	1306	1434	0.9107392
C9	62840218	62840518	BolC9t60145H	0	-	0	0	300	0.0000000
C9	62870155	62872047	BolC9t60146H	0	-	532	1881	1892	0.9941860
C9	62873979	62874306	BolC9t60147H	0	-	347	327	327	1.0000000
C9	62878363	62878567	BolC9t60148H	0	-	25	114	204	0.5588235
C9	62879370	62881544	BolC9t60149H	0	+	2581	2174	2174	1.0000000
C9	62885769	62888171	BolC9t60150H	0	-	735	2177	2402	0.9063281
C9	62889315	62892554	BolC9t60151H	0	+	1834	3108	3239	0.9595554
C9	62894153	62894552	BolC9t60152H	0	+	141	399	399	1.0000000
C9	62894934	62897950	BolC9t60153H	0	-	3048	3016	3016	1.0000000
C9	62904716	62905182	BolC9t60154H	0	-	529	466	466	1.0000000
C9	62929370	62931764	BolC9t60155H	0	+	2475	2394	2394	1.0000000
C9	62938452	62938608	BolC9t60156H	0	-	45	61	156	0.3910256
C9	62942897	62944588	BolC9t60157H	0	+	899	1691	1691	1.0000000
C9	62944823	62945675	BolC9t60158H	0	-	508	852	852	1.0000000
C9	62946001	62947683	BolC9t60159H	0	+	1280	1682	1682	1.0000000
C9	62950173	62952106	BolC9t60160H	0	-	1583	1913	1933	0.9896534
C9	62956508	62960613	BolC9t60161H	0	-	1147	2984	4105	0.7269184
C9	62960943	62962389	BolC9t60162H	0	-	792	1446	1446	1.0000000
C9	62963331	62964698	BolC9t60163H	0	-	773	1353	1367	0.9897586
C9	62977184	62977406	BolC9t60164H	0	+	129	222	222	1.0000000
C9	62977860	62979194	BolC9t60165H	0	-	489	729	1334	0.5464768
C9	62980055	62980376	BolC9t60166H	0	+	87	321	321	1.0000000
C9	62981078	62983654	BolC9t60167H	0	-	1983	2564	2576	0.9953416
C9	62985354	62985937	BolC9t60168H	0	-	364	583	583	1.0000000
C9	62986207	62987031	BolC9t60169H	0	-	418	772	824	0.9368932
C9	62988396	62990533	BolC9t60170H	0	+	1306	2101	2137	0.9831539
C9	62991844	62993426	BolC9t60171H	0	-	1017	1582	1582	1.0000000
C9	62995312	62997492	BolC9t60172H	0	-	1191	2180	2180	1.0000000
C9	62998270	62998879	BolC9t60173H	0	-	710	609	609	1.0000000
C9	63004110	63012664	BolC9t60174H	0	+	3823	7887	8554	0.9220248
C9	63005205	63006762	BolC9t60175H	0	-	1281	1501	1557	0.9640334
C9	63018183	63021774	BolC9t60176H	0	-	537	2414	3591	0.6722361
C9	63032199	63032547	BolC9t60177H	0	-	169	348	348	1.0000000
C9	63036247	63037541	BolC9t60178H	0	+	1676	1294	1294	1.0000000
C9	63039786	63042014	BolC9t60179H	0	-	520	1326	2228	0.5951526
C9	63065177	63065453	BolC9t60180H	0	+	1005	276	276	1.0000000
C9	63074773	63077048	BolC9t60181H	0	+	2333	2275	2275	1.0000000
C9	63077564	63080013	BolC9t60182H	0	+	1165	2428	2449	0.9914251
C9	63081213	63081532	BolC9t60183H	0	-	146	319	319	1.0000000
C9	63085352	63088539	BolC9t60184H	0	-	2574	3187	3187	1.0000000
C9	63096025	63097737	BolC9t60185H	0	+	925	1492	1712	0.8714953
C9	63098596	63101956	BolC9t60186H	0	+	3171	3360	3360	1.0000000
C9	63104644	63106279	BolC9t60187H	0	+	1434	1635	1635	1.0000000
C9	63106730	63108653	BolC9t60188H	0	-	209	1654	1923	0.8601144
C9	63112435	63115188	BolC9t60189H	0	-	1065	2632	2753	0.9560480
C9	63121744	63122173	BolC9t60190H	0	+	80	383	429	0.8927739
C9	63123570	63124934	BolC9t60191H	0	-	184	1226	1364	0.8988270
C9	63129222	63132763	BolC9t60192H	0	+	101	1031	3541	0.2911607
C9	63133739	63134972	BolC9t60193H	0	-	7	420	1233	0.3406326
C9	63136391	63136744	BolC9t60194H	0	-	23	233	353	0.6600567
C9	63137673	63140111	BolC9t60195H	0	+	455	2173	2438	0.8913044
C9	63141030	63143095	BolC9t60196H	0	-	1820	2065	2065	1.0000000
C9	63172021	63174569	BolC9t60197H	0	-	3699	2548	2548	1.0000000
C9	63186399	63195164	BolC9t60198H	0	+	6193	7804	8765	0.8903594
C9	63192261	63192915	BolC9t60199H	0	-	618	653	654	0.9984710
C9	63194728	63195160	BolC9t60200H	0	+	545	432	432	1.0000000
C9	63195870	63196983	BolC9t60201H	0	+	75	823	1113	0.7394429
C9	63197409	63200759	BolC9t60202H	0	-	447	1935	3350	0.5776119
C9	63202676	63204163	BolC9t60203H	0	-	27	664	1487	0.4465367
C9	63206648	63207284	BolC9t60204H	0	-	115	598	636	0.9402516
C9	63208649	63209561	BolC9t60205H	0	+	66	225	912	0.2467105
C9	63210727	63211039	BolC9t60206H	0	+	66	263	312	0.8429487
C9	63217520	63220303	BolC9t60207H	0	-	82	771	2783	0.2770392
C9	63232185	63233144	BolC9t60208H	0	+	0	0	959	0.0000000
C9	63237759	63237924	BolC9t60209H	0	-	0	0	165	0.0000000
C9	63238656	63239592	BolC9t60210H	0	+	121	854	936	0.9123932
