A01	3697	7856	A01p00010.2_BraZ1	969.467	-	755	2728	4159	0.6559269
A01	14535	15110	A01p00020.2_BraZ1	36	-	241	553	575	0.9617391
A01	15110	20637	A01p00030.2_BraZ1	756	+	1856	5383	5527	0.9739461
A01	21141	22778	A01p00040.2_BraZ1	1211.57	-	28	651	1637	0.3976787
A01	23297	24146	A01p00050.2_BraZ1	774	+	51	276	849	0.3250884
A01	29223	32749	A01p00060.2_BraZ1	3375.73	+	178	1466	3526	0.4157686
A01	33089	35334	A01p00070.2_BraZ1	273	-	1097	2136	2245	0.9514477
A01	38146	39132	A01p00080.2_BraZ1	810	-	53	775	986	0.7860041
A01	40389	41461	A01p00090.2_BraZ1	954	+	162	703	1072	0.6557836
A01	45347	49174	A01p00100.2_BraZ1	1231.49	+	293	2252	3827	0.5884505
A01	49127	49706	A01p00110.2_BraZ1	348.886	-	54	477	579	0.8238342
A01	51909	53049	A01p00120.2_BraZ1	763.125	-	122	921	1140	0.8078948
A01	53665	53812	A01p00130.2_BraZ1	14.7	-	120	147	147	1.0000000
A01	54012	54787	A01p00140.2_BraZ1	591	+	1923	727	775	0.9380645
A01	72987	73346	A01p00150.2_BraZ1	29.1	+	171	359	359	1.0000000
A01	74103	74685	A01p00160.2_BraZ1	58.2	-	40	361	582	0.6202749
A01	79496	80639	A01p00170.2_BraZ1	999	-	174	1035	1143	0.9055118
A01	82701	83239	A01p00180.2_BraZ1	387	-	25	257	538	0.4776952
A01	88310	88628	A01p00190.2_BraZ1	31.8	+	4	197	318	0.6194969
A01	92427	94123	A01p00200.2_BraZ1	162.9	+	262	1148	1696	0.6768868
A01	94303	97216	A01p00210.2_BraZ1	1877.78	-	1515	2571	2913	0.8825952
A01	98109	111633	A01p00220.2_BraZ1	1614	-	3341	8188	13524	0.6054422
A01	105903	106500	A01p00230.2_BraZ1	59.7	+	423	428	597	0.7169179
A01	106500	107582	A01p00240.2_BraZ1	771	+	110	533	1082	0.4926063
A01	113526	115569	A01p00250.2_BraZ1	1081.64	-	342	1565	2043	0.7660304
A01	117064	119388	A01p00260.2_BraZ1	1426.18	-	538	2270	2324	0.9767642
A01	120976	124222	A01p00270.2_BraZ1	1420.36	-	774	2898	3246	0.8927912
A01	131461	134406	A01p00280.2_BraZ1	1529.93	+	1099	2713	2945	0.9212224
A01	136168	137614	A01p00290.2_BraZ1	5760	-	623	1166	1446	0.8063624
A01	141806	146351	A01p00300.2_BraZ1	2212.43	+	1543	3971	4545	0.8737074
A01	147299	148615	A01p00310.2_BraZ1	1044.86	-	471	1316	1316	1.0000000
A01	149448	149895	A01p00320.2_BraZ1	339	-	6	150	447	0.3355705
A01	150978	153684	A01p00330.2_BraZ1	270.6	-	165	2242	2706	0.8285292
A01	153972	155033	A01p00340.2_BraZ1	462	-	748	1061	1061	1.0000000
A01	155251	155854	A01p00350.2_BraZ1	450	-	634	603	603	1.0000000
A01	156630	158143	A01p00360.2_BraZ1	1250.8	-	1371	1513	1513	1.0000000
A01	159614	161494	A01p00370.2_BraZ1	1014.3	-	886	1880	1880	1.0000000
A01	162076	162734	A01p00380.2_BraZ1	373.895	+	458	658	658	1.0000000
A01	163498	163923	A01p00390.2_BraZ1	40.8	-	390	425	425	1.0000000
A01	167006	167807	A01p00400.2_BraZ1	51.6	-	198	801	801	1.0000000
A01	169139	169496	A01p00410.2_BraZ1	276	+	244	357	357	1.0000000
A01	171329	171872	A01p00420.2_BraZ1	447	+	183	478	543	0.8802947
A01	172486	172876	A01p00430.2_BraZ1	39	-	352	390	390	1.0000000
A01	175383	175770	A01p00440.2_BraZ1	38.7	+	42	387	387	1.0000000
A01	180635	185223	A01p00450.2_BraZ1	3043.03	+	1224	4452	4588	0.9703575
A01	186588	186930	A01p00460.2_BraZ1	34.2	+	196	342	342	1.0000000
A01	191335	191545	A01p00470.2_BraZ1	21	+	172	210	210	1.0000000
A01	193890	195172	A01p00480.2_BraZ1	994.56	+	331	1133	1282	0.8837754
A01	200012	200234	A01p00490.2_BraZ1	117	+	0	0	222	0.0000000
A01	201806	202325	A01p00500.2_BraZ1	171	+	43	348	519	0.6705202
A01	205158	208743	A01p00510.2_BraZ1	358.5	+	826	3104	3585	0.8658298
A01	217047	219216	A01p00520.2_BraZ1	8970	-	1097	2081	2169	0.9594283
A01	225960	240777	A01p00530.2_BraZ1	8894.69	+	2138	8463	14817	0.5711682
A01	241721	241904	A01p00540.2_BraZ1	147	-	235	183	183	1.0000000
A01	242133	243645	A01p00550.2_BraZ1	151.2	-	572	1483	1512	0.9808201
A01	244450	247186	A01p00560.2_BraZ1	1007.22	-	2472	2736	2736	1.0000000
A01	247493	250149	A01p00570.2_BraZ1	576.136	+	2715	2656	2656	1.0000000
A01	250418	260417	A01p00580.2_BraZ1	1545	-	3514	6139	9999	0.6139614
A01	261300	262539	A01p00590.2_BraZ1	123.9	-	273	1162	1239	0.9378531
A01	263171	267551	A01p00600.2_BraZ1	2322	-	2658	4216	4380	0.9625571
A01	268536	272643	A01p00610.2_BraZ1	3496.28	+	883	3793	4107	0.9235452
A01	273497	274158	A01p00620.2_BraZ1	222	+	576	661	661	1.0000000
A01	274681	276823	A01p00630.2_BraZ1	14868	+	1092	1779	2142	0.8305322
A01	278500	281208	A01p00640.2_BraZ1	1485.84	+	565	2683	2708	0.9907681
A01	281773	282460	A01p00650.2_BraZ1	1092	-	241	665	687	0.9679767
A01	283547	286071	A01p00660.2_BraZ1	1119.81	+	928	2461	2524	0.9750396
A01	287507	289699	A01p00670.2_BraZ1	1320.27	+	939	2132	2192	0.9726278
A01	292894	293288	A01p00680.2_BraZ1	21.6	+	63	240	394	0.6091371
A01	293658	295952	A01p00690.2_BraZ1	1258.43	-	483	2255	2294	0.9829991
A01	296243	301593	A01p00700.2_BraZ1	809.952	+	1389	2264	5350	0.4231776
A01	298242	299034	A01p00710.2_BraZ1	729	-	0	0	792	0.0000000
A01	303544	304296	A01p00720.2_BraZ1	477	+	20	279	752	0.3710106
A01	304339	304450	A01p00730.2_BraZ1	11.1	-	16	111	111	1.0000000
A01	305331	306610	A01p00740.2_BraZ1	2204.12	-	418	1197	1279	0.9358874
A01	308684	309557	A01p00750.2_BraZ1	87.3	-	365	859	873	0.9839634
A01	319354	320862	A01p00760.2_BraZ1	779.318	-	276	1412	1508	0.9363395
A01	321132	322960	A01p00770.2_BraZ1	1099.31	+	630	1626	1828	0.8894967
A01	342288	343119	A01p00780.2_BraZ1	83.1	-	389	820	831	0.9867629
A01	347619	350189	A01p00790.2_BraZ1	1802.29	-	711	2300	2570	0.8949416
A01	350663	350870	A01p00800.2_BraZ1	20.7	+	198	207	207	1.0000000
A01	355093	356088	A01p00810.2_BraZ1	304.107	-	9	335	995	0.3366834
A01	358148	358850	A01p00820.2_BraZ1	387	+	212	644	702	0.9173789
A01	360534	363734	A01p00830.2_BraZ1	1199.85	-	1473	2999	3200	0.9371875
A01	365333	366534	A01p00840.2_BraZ1	316.556	-	475	1149	1201	0.9567028
A01	367236	368037	A01p00850.2_BraZ1	726	-	872	801	801	1.0000000
A01	372081	373464	A01p00860.2_BraZ1	138.3	+	58	804	1383	0.5813449
A01	374652	376413	A01p00870.2_BraZ1	944.036	+	315	1759	1761	0.9988643
A01	377586	379119	A01p00880.2_BraZ1	845.286	+	1201	1486	1533	0.9693412
A01	379784	380324	A01p00890.2_BraZ1	54	+	330	540	540	1.0000000
A01	380935	382875	A01p00900.2_BraZ1	712.833	-	839	1362	1940	0.7020618
A01	384130	384919	A01p00910.2_BraZ1	288	-	4	285	789	0.3612167
A01	385524	387524	A01p00920.2_BraZ1	1085.56	-	1074	1845	2000	0.9225000
A01	388672	390228	A01p00930.2_BraZ1	814.154	+	1093	1556	1556	1.0000000
A01	395277	397144	A01p00940.2_BraZ1	1677	+	267	1559	1867	0.8350295
A01	398082	400422	A01p00950.2_BraZ1	234	+	841	2293	2340	0.9799145
A01	401556	403808	A01p00960.2_BraZ1	1334.68	+	1151	1821	2252	0.8086146
A01	404641	404845	A01p00970.2_BraZ1	117	+	231	204	204	1.0000000
A01	407602	409531	A01p00980.2_BraZ1	1557	+	1112	1847	1929	0.9574909
A01	410333	411248	A01p00990.2_BraZ1	714	+	718	915	915	1.0000000
A01	412601	413153	A01p01000.2_BraZ1	168	-	715	552	552	1.0000000
A01	415519	418743	A01p01010.2_BraZ1	1938	-	1481	3130	3224	0.9708437
A01	419474	421939	A01p01020.2_BraZ1	958.891	-	524	2196	2465	0.8908722
A01	423849	425613	A01p01030.2_BraZ1	176.4	-	237	1517	1764	0.8599773
A01	426470	427168	A01p01040.2_BraZ1	6206.1	-	856	698	698	1.0000000
A01	428011	428287	A01p01050.2_BraZ1	27.6	+	57	276	276	1.0000000
A01	428587	429100	A01p01060.2_BraZ1	51.3	-	667	513	513	1.0000000
A01	429912	432383	A01p01070.2_BraZ1	1293.75	-	416	2426	2471	0.9817888
A01	435348	436551	A01p01080.2_BraZ1	120.3	+	1279	1203	1203	1.0000000
A01	441485	442613	A01p01090.2_BraZ1	751.385	-	158	924	1128	0.8191490
A01	445192	446358	A01p01100.2_BraZ1	1077	+	479	1081	1166	0.9271012
A01	446959	447391	A01p01110.2_BraZ1	43.2	-	26	214	432	0.4953704
A01	451931	452492	A01p01120.2_BraZ1	405	+	19	440	561	0.7843137
A01	453842	456848	A01p01130.2_BraZ1	2049.13	+	1108	2539	3006	0.8446441
A01	457114	458683	A01p01140.2_BraZ1	1209.5	-	281	1535	1569	0.9783301
A01	460936	464468	A01p01150.2_BraZ1	1515.81	+	533	2529	3532	0.7160249
A01	464791	466182	A01p01160.2_BraZ1	1020	-	285	1298	1391	0.9331416
A01	467145	467874	A01p01170.2_BraZ1	72.9	-	309	729	729	1.0000000
A01	471583	473064	A01p01180.2_BraZ1	998.632	-	235	1059	1481	0.7150574
A01	474810	477988	A01p01190.2_BraZ1	964.543	-	2011	3125	3178	0.9833229
A01	484786	487772	A01p01200.2_BraZ1	648.929	+	2782	2967	2986	0.9936370
A01	488363	491107	A01p01210.2_BraZ1	1462	+	1462	2720	2744	0.9912537
A01	491648	493396	A01p01220.2_BraZ1	1257.14	+	873	1741	1748	0.9959954
A01	493607	496048	A01p01230.2_BraZ1	1784.04	+	450	2279	2441	0.9336337
A01	496664	497810	A01p01240.2_BraZ1	114.6	-	187	1088	1146	0.9493892
A01	501712	504914	A01p01250.2_BraZ1	1723.68	+	753	2882	3202	0.9000624
A01	505854	507238	A01p01260.2_BraZ1	909.804	+	1897	1384	1384	1.0000000
A01	507343	508150	A01p01270.2_BraZ1	108	+	1169	807	807	1.0000000
A01	513468	514754	A01p01280.2_BraZ1	981.316	+	1271	1286	1286	1.0000000
A01	519640	520024	A01p01290.2_BraZ1	38.4	-	357	384	384	1.0000000
A01	522705	524854	A01p01300.2_BraZ1	1326.61	+	993	1910	2149	0.8887855
A01	525641	526203	A01p01310.2_BraZ1	360.4	+	728	562	562	1.0000000
A01	530602	531131	A01p01320.2_BraZ1	360.214	-	98	529	529	1.0000000
A01	535756	536191	A01p01330.2_BraZ1	43.5	+	285	425	435	0.9770115
A01	545943	546977	A01p01340.2_BraZ1	849	-	77	909	1034	0.8791103
A01	557770	558932	A01p01350.2_BraZ1	892.5	+	281	989	1162	0.8511187
A01	564832	566596	A01p01360.2_BraZ1	1381.52	-	277	1084	1764	0.6145124
A01	575110	577388	A01p01370.2_BraZ1	1517	-	1386	2063	2278	0.9056190
A01	580323	582722	A01p01380.2_BraZ1	1599	-	958	2192	2399	0.9137141
A01	602603	604339	A01p01390.2_BraZ1	1054.67	+	635	1548	1736	0.8917051
A01	605207	606039	A01p01400.2_BraZ1	74.1	-	37	579	832	0.6959134
A01	609862	611571	A01p01410.2_BraZ1	1072.67	-	653	1656	1709	0.9689877
A01	613211	615667	A01p01420.2_BraZ1	1643.2	+	849	2456	2456	1.0000000
A01	617688	619290	A01p01430.2_BraZ1	160.2	-	64	511	1602	0.3189763
A01	625370	633813	A01p01440.2_BraZ1	1140	+	420	2887	8443	0.3419401
A01	637465	639074	A01p01450.2_BraZ1	1185.65	-	715	1510	1609	0.9384711
A01	647429	649764	A01p01460.2_BraZ1	1412.93	-	1627	2335	2335	1.0000000
A01	650211	652262	A01p01470.2_BraZ1	1294.29	-	499	2028	2051	0.9887860
A01	656322	657196	A01p01480.2_BraZ1	714	+	770	874	874	1.0000000
A01	660182	660952	A01p01490.2_BraZ1	70	-	973	770	770	1.0000000
A01	660874	661256	A01p01500.2_BraZ1	255	-	670	382	382	1.0000000
A01	663192	664524	A01p01510.2_BraZ1	1040.45	-	697	1332	1332	1.0000000
A01	669278	671755	A01p01520.2_BraZ1	1599	+	1023	2402	2477	0.9697214
A01	672522	674309	A01p01530.2_BraZ1	781.565	+	1062	1737	1787	0.9720201
A01	674843	675115	A01p01540.2_BraZ1	111	-	163	240	272	0.8823529
A01	677904	684428	A01p01550.2_BraZ1	2558.22	+	5875	6286	6524	0.9635193
A01	686173	686878	A01p01560.2_BraZ1	537	+	157	686	705	0.9730496
A01	694152	697599	A01p01570.2_BraZ1	992.411	+	1450	2498	3447	0.7246881
A01	698188	699085	A01p01580.2_BraZ1	254.625	+	70	219	897	0.2441472
A01	700320	704172	A01p01590.2_BraZ1	342.063	+	1900	3661	3852	0.9504154
A01	704692	706137	A01p01600.2_BraZ1	1001.7	-	200	1224	1445	0.8470588
A01	710347	711877	A01p01610.2_BraZ1	577.029	+	148	1145	1530	0.7483660
A01	712225	714237	A01p01620.2_BraZ1	1105.26	-	562	1980	2012	0.9840955
A01	716364	718040	A01p01630.2_BraZ1	1497	-	365	1482	1676	0.8842482
A01	721112	722831	A01p01640.2_BraZ1	171.9	-	311	1369	1719	0.7963933
A01	725352	727115	A01p01650.2_BraZ1	1506	-	247	1184	1763	0.6715825
A01	733506	735594	A01p01660.2_BraZ1	1500	-	460	1941	2088	0.9295977
A01	743260	745354	A01p01670.2_BraZ1	1690.5	-	205	1831	2094	0.8744031
A01	754800	756802	A01p01680.2_BraZ1	1250.31	+	1249	1870	2002	0.9340659
A01	758360	761706	A01p01690.2_BraZ1	880	+	2198	3162	3346	0.9450090
A01	764964	767546	A01p01700.2_BraZ1	12721.5	+	1229	2497	2582	0.9670798
A01	767999	769888	A01p01710.2_BraZ1	361.727	-	396	1593	1889	0.8433033
A01	773542	773803	A01p01720.2_BraZ1	25.8	+	34	197	261	0.7547893
A01	774377	776737	A01p01730.2_BraZ1	766.774	+	1234	2287	2360	0.9690678
A01	777110	781087	A01p01740.2_BraZ1	2347.3	+	907	3256	3977	0.8187076
A01	781486	782473	A01p01750.2_BraZ1	98.7	-	142	705	987	0.7142857
A01	795665	795908	A01p01760.2_BraZ1	24.3	+	0	0	243	0.0000000
A01	796049	796770	A01p01770.2_BraZ1	234	+	0	0	721	0.0000000
A01	803312	805694	A01p01780.2_BraZ1	2743.2	+	304	2112	2382	0.8866498
A01	806352	808194	A01p01790.2_BraZ1	1015.63	-	318	1411	1842	0.7660152
A01	809041	810526	A01p01800.2_BraZ1	148.5	+	164	1372	1485	0.9239057
A01	812847	815045	A01p01810.2_BraZ1	1645.26	-	1869	2156	2198	0.9808917
A01	827243	827831	A01p01820.2_BraZ1	58.8	+	283	576	588	0.9795918
A01	831130	831481	A01p01830.2_BraZ1	165	-	454	351	351	1.0000000
A01	836265	836382	A01p01840.2_BraZ1	11.7	-	224	117	117	1.0000000
A01	837493	839628	A01p01850.2_BraZ1	1087.5	+	549	1833	2135	0.8585480
A01	845274	847095	A01p01860.2_BraZ1	459	+	1364	1549	1821	0.8506315
A01	852361	854106	A01p01870.2_BraZ1	983.348	+	743	1732	1745	0.9925501
A01	856205	857270	A01p01880.2_BraZ1	106.5	-	426	1065	1065	1.0000000
A01	858891	859708	A01p01890.2_BraZ1	341.182	+	1231	817	817	1.0000000
A01	860297	861879	A01p01900.2_BraZ1	1467.07	-	980	1582	1582	1.0000000
A01	864287	864685	A01p01910.2_BraZ1	40.3333	-	469	398	398	1.0000000
A01	864708	867222	A01p01920.2_BraZ1	1309.51	-	2623	2514	2514	1.0000000
A01	871858	872862	A01p01930.2_BraZ1	861	+	426	1004	1004	1.0000000
A01	874017	876663	A01p01940.2_BraZ1	1272.84	+	850	2065	2646	0.7804233
A01	879629	881587	A01p01950.2_BraZ1	989.623	+	975	1816	1958	0.9274770
A01	881773	884166	A01p01960.2_BraZ1	1181.05	-	965	2392	2393	0.9995821
A01	886094	893142	A01p01970.2_BraZ1	1499.12	-	3098	6649	7048	0.9433882
A01	899420	901954	A01p01980.2_BraZ1	1375.07	+	1348	2534	2534	1.0000000
A01	902639	903904	A01p01990.2_BraZ1	549.643	+	869	1265	1265	1.0000000
A01	905719	908257	A01p02000.2_BraZ1	253.8	-	776	2459	2538	0.9688731
A01	911023	912609	A01p02010.2_BraZ1	1061.11	-	526	1558	1586	0.9823455
A01	913835	915723	A01p02020.2_BraZ1	1414.09	+	455	1730	1888	0.9163136
A01	916096	917217	A01p02030.2_BraZ1	774	-	230	956	1121	0.8528100
A01	918186	928783	A01p02040.2_BraZ1	2702.25	-	3108	7840	10597	0.7398320
A01	932807	934108	A01p02050.2_BraZ1	1253.57	+	1387	1301	1301	1.0000000
A01	935566	936932	A01p02060.2_BraZ1	801.167	-	1439	1366	1366	1.0000000
A01	937279	939036	A01p02070.2_BraZ1	710.214	+	1427	1753	1757	0.9977234
A01	939652	941158	A01p02080.2_BraZ1	479.769	+	463	1244	1506	0.8260292
A01	946572	947100	A01p02090.2_BraZ1	52.8	+	337	528	528	1.0000000
A01	951684	952402	A01p02100.2_BraZ1	960	-	152	687	718	0.9568245
A01	953277	955681	A01p02110.2_BraZ1	984.903	+	1054	2347	2404	0.9762895
A01	955905	960375	A01p02120.2_BraZ1	1717.3	-	1569	4049	4470	0.9058166
A01	966949	971924	A01p02130.2_BraZ1	1545.12	+	1935	4638	4975	0.9322613
A01	974849	977152	A01p02140.2_BraZ1	1008.96	+	2549	2303	2303	1.0000000
A01	977884	978987	A01p02150.2_BraZ1	993	-	203	993	1103	0.9002720
A01	985780	987114	A01p02160.2_BraZ1	1104	-	705	1328	1334	0.9955022
A01	988354	989257	A01p02170.2_BraZ1	510.171	+	798	903	903	1.0000000
A01	989476	991441	A01p02180.2_BraZ1	1461	-	923	1960	1965	0.9974555
A01	994086	995409	A01p02190.2_BraZ1	912	+	242	1175	1323	0.8881330
A01	996745	998134	A01p02200.2_BraZ1	138.9	+	298	1349	1389	0.9712023
A01	1001239	1001955	A01p02210.2_BraZ1	204	+	1286	716	716	1.0000000
A01	1002567	1005607	A01p02220.2_BraZ1	1636.61	-	2265	3040	3040	1.0000000
A01	1005967	1007408	A01p02230.2_BraZ1	10854	-	812	1441	1441	1.0000000
A01	1017143	1018919	A01p02240.2_BraZ1	654	+	511	1581	1776	0.8902027
A01	1021917	1023588	A01p02250.2_BraZ1	912.372	+	1506	1671	1671	1.0000000
A01	1023748	1026895	A01p02260.2_BraZ1	1230.99	-	1621	3123	3147	0.9923737
A01	1035596	1037553	A01p02270.2_BraZ1	964.091	+	1002	1928	1957	0.9851814
A01	1039894	1043111	A01p02280.2_BraZ1	1898.11	+	1287	3087	3217	0.9595897
A01	1043882	1044327	A01p02290.2_BraZ1	68.1818	+	237	439	445	0.9865168
A01	1044982	1046932	A01p02300.2_BraZ1	12187.5	+	550	1806	1950	0.9261538
A01	1052456	1053690	A01p02310.2_BraZ1	1158.4	+	93	721	1234	0.5842788
A01	1057860	1058840	A01p02320.2_BraZ1	672	+	7	150	980	0.1530612
A01	1060436	1061798	A01p02330.2_BraZ1	696	+	93	673	1362	0.4941263
A01	1066884	1069453	A01p02340.2_BraZ1	11060	+	848	1887	2569	0.7345271
A01	1070335	1071717	A01p02350.2_BraZ1	842.368	+	691	1382	1382	1.0000000
A01	1071816	1074420	A01p02360.2_BraZ1	1685.6	-	696	2265	2604	0.8698156
A01	1077904	1078144	A01p02370.2_BraZ1	24	-	28	237	240	0.9875000
A01	1084365	1086888	A01p02380.2_BraZ1	2290.47	+	542	2428	2523	0.9623464
A01	1089223	1090692	A01p02390.2_BraZ1	786.26	+	898	1447	1469	0.9850238
A01	1095639	1099839	A01p02400.2_BraZ1	3318.81	+	2053	4060	4200	0.9666666
A01	1100195	1100567	A01p02410.2_BraZ1	37.2	+	39	256	372	0.6881720
A01	1101828	1102200	A01p02420.2_BraZ1	37.2	+	15	121	372	0.3252688
A01	1102760	1104223	A01p02430.2_BraZ1	944.364	-	79	988	1463	0.6753247
A01	1108373	1111251	A01p02440.2_BraZ1	1241.44	+	1765	2804	2878	0.9742877
A01	1111846	1120347	A01p02450.2_BraZ1	2023.72	+	3709	7776	8501	0.9147159
A01	1121746	1122982	A01p02460.2_BraZ1	996	+	233	1132	1236	0.9158576
A01	1125219	1126149	A01p02470.2_BraZ1	436.27	-	337	850	930	0.9139785
A01	1128453	1131685	A01p02480.2_BraZ1	1861.7	+	876	3140	3232	0.9715347
A01	1134172	1139434	A01p02490.2_BraZ1	1314.13	+	831	3759	5262	0.7143672
A01	1145801	1149847	A01p02500.2_BraZ1	2286.86	+	3284	4046	4046	1.0000000
A01	1153374	1161252	A01p02510.2_BraZ1	407.1	+	1745	6611	7878	0.8391724
A01	1167472	1168797	A01p02520.2_BraZ1	942	+	645	1287	1325	0.9713207
A01	1173731	1176374	A01p02530.2_BraZ1	1413.14	-	1180	2558	2643	0.9678396
A01	1178884	1179901	A01p02540.2_BraZ1	459	+	606	966	1017	0.9498525
A01	1180442	1181234	A01p02550.2_BraZ1	77.4	-	974	792	792	1.0000000
A01	1183642	1184569	A01p02560.2_BraZ1	168	+	509	584	927	0.6299892
A01	1183747	1184437	A01p02570.2_BraZ1	318.6	-	354	347	690	0.5028986
A01	1191205	1193175	A01p02580.2_BraZ1	1524.88	+	235	1497	1970	0.7598985
A01	1198499	1202252	A01p02590.2_BraZ1	1899.89	-	1200	3646	3753	0.9714895
A01	1202852	1205197	A01p02600.2_BraZ1	1282.91	-	1481	2345	2345	1.0000000
A01	1205554	1209429	A01p02610.2_BraZ1	3230.18	+	877	3249	3875	0.8384516
A01	1223018	1225007	A01p02620.2_BraZ1	1088.1	+	425	1793	1989	0.9014580
A01	1230116	1234891	A01p02630.2_BraZ1	17051	-	3954	4705	4775	0.9853403
A01	1235078	1239388	A01p02640.2_BraZ1	3894.09	+	3545	4282	4310	0.9935035
A01	1240715	1242021	A01p02650.2_BraZ1	807	-	341	1242	1306	0.9509954
A01	1243235	1246643	A01p02660.2_BraZ1	2018.28	+	1541	3193	3408	0.9369131
A01	1250464	1255827	A01p02670.2_BraZ1	390	-	1623	4379	5363	0.8165206
A01	1256745	1257692	A01p02680.2_BraZ1	9798	-	508	873	947	0.9218585
A01	1258649	1260715	A01p02690.2_BraZ1	1367.79	+	1016	1895	2066	0.9172314
A01	1262736	1279359	A01p02700.2_BraZ1	10708.8	+	1091	7321	16623	0.4404139
A01	1279464	1280741	A01p02710.2_BraZ1	900	-	1151	1277	1277	1.0000000
A01	1281104	1283550	A01p02720.2_BraZ1	1514.31	+	1847	2401	2446	0.9816026
A01	1285626	1286109	A01p02730.2_BraZ1	48.3	+	327	483	483	1.0000000
A01	1288812	1289649	A01p02740.2_BraZ1	83.7	+	530	837	837	1.0000000
A01	1291686	1293145	A01p02750.2_BraZ1	843	+	609	1459	1459	1.0000000
A01	1293907	1295496	A01p02760.2_BraZ1	1052.33	-	893	1555	1589	0.9786029
A01	1295785	1296256	A01p02770.2_BraZ1	267	+	261	471	471	1.0000000
A01	1296512	1297886	A01p02780.2_BraZ1	775	-	966	1374	1374	1.0000000
A01	1298865	1300367	A01p02790.2_BraZ1	599.767	+	1357	1502	1502	1.0000000
A01	1300807	1302165	A01p02800.2_BraZ1	923.029	-	1132	1358	1358	1.0000000
A01	1312939	1313269	A01p02810.2_BraZ1	33	+	341	328	330	0.9939394
A01	1313660	1314031	A01p02820.2_BraZ1	189	+	232	371	371	1.0000000
A01	1314713	1317253	A01p02830.2_BraZ1	1080.88	+	847	2320	2540	0.9133858
A01	1322968	1323274	A01p02840.2_BraZ1	30.6	-	0	0	306	0.0000000
A01	1325920	1327005	A01p02850.2_BraZ1	544	-	770	1085	1085	1.0000000
A01	1332516	1335383	A01p02860.2_BraZ1	1764.71	-	2881	2686	2867	0.9368678
A01	1336672	1339046	A01p02870.2_BraZ1	1520.87	-	1046	2271	2374	0.9566133
A01	1340634	1342043	A01p02880.2_BraZ1	610.56	+	746	1409	1409	1.0000000
A01	1342467	1345344	A01p02890.2_BraZ1	1146.86	-	1259	2876	2877	0.9996524
A01	1346774	1347866	A01p02900.2_BraZ1	714	-	667	1081	1092	0.9899268
A01	1351318	1371761	A01p02910.2_BraZ1	5454.29	+	7494	19676	20443	0.9624810
A01	1356290	1358059	A01p02920.2_BraZ1	479.88	-	1016	1653	1769	0.9344262
A01	1360160	1361883	A01p02930.2_BraZ1	770.88	-	463	1526	1723	0.8856645
A01	1362481	1364119	A01p02940.2_BraZ1	747.371	-	709	1587	1638	0.9688644
A01	1377024	1378712	A01p02950.2_BraZ1	156	+	1178	1648	1688	0.9763033
A01	1380768	1380957	A01p02960.2_BraZ1	18.9	-	266	189	189	1.0000000
A01	1384135	1384997	A01p02970.2_BraZ1	5695.88	-	370	862	862	1.0000000
A01	1385357	1387796	A01p02980.2_BraZ1	928.125	+	826	2230	2439	0.9143091
A01	1386309	1386867	A01p02990.2_BraZ1	267	+	30	349	558	0.6254480
A01	1388657	1389434	A01p03000.2_BraZ1	598.688	+	241	777	777	1.0000000
A01	1391037	1392905	A01p03010.2_BraZ1	1226.52	-	662	1868	1868	1.0000000
A01	1394381	1399358	A01p03020.2_BraZ1	867	-	2205	4903	4977	0.9851316
A01	1396927	1397686	A01p03030.2_BraZ1	75.9	-	212	725	759	0.9552042
A01	1401258	1402152	A01p03040.2_BraZ1	89.4	-	438	894	894	1.0000000
A01	1407279	1408077	A01p03050.2_BraZ1	79.8	+	406	798	798	1.0000000
A01	1408734	1411291	A01p03060.2_BraZ1	1155.6	-	1477	2457	2557	0.9608917
A01	1412851	1414849	A01p03070.2_BraZ1	934.286	-	1143	1930	1998	0.9659660
A01	1415743	1420652	A01p03080.2_BraZ1	506.25	+	3665	4794	4909	0.9765736
A01	1423685	1425007	A01p03090.2_BraZ1	768	+	896	1322	1322	1.0000000
A01	1425224	1426634	A01p03100.2_BraZ1	141	-	364	1380	1410	0.9787234
A01	1427184	1428501	A01p03110.2_BraZ1	585	+	1661	1317	1317	1.0000000
A01	1431033	1431798	A01p03120.2_BraZ1	76.5	+	698	765	765	1.0000000
A01	1434789	1436638	A01p03130.2_BraZ1	4539	-	731	1571	1849	0.8496485
A01	1439937	1440651	A01p03140.2_BraZ1	71.4	+	307	639	714	0.8949580
A01	1444806	1447108	A01p03150.2_BraZ1	1662	-	699	2214	2302	0.9617724
A01	1450853	1452537	A01p03160.2_BraZ1	994.969	-	769	1615	1684	0.9590262
A01	1453080	1456275	A01p03170.2_BraZ1	1530.98	+	1053	3184	3195	0.9965571
A01	1457031	1458414	A01p03180.2_BraZ1	438.6	+	856	1383	1383	1.0000000
A01	1458564	1460267	A01p03190.2_BraZ1	7938	-	533	1560	1703	0.9160305
A01	1461168	1461990	A01p03200.2_BraZ1	467.419	-	235	821	822	0.9987835
A01	1464745	1465654	A01p03210.2_BraZ1	90.9	-	33	313	909	0.3443344
A01	1468839	1475533	A01p03220.2_BraZ1	4628.9	-	580	4320	6694	0.6453540
A01	1477066	1477821	A01p03230.2_BraZ1	285.714	-	191	481	755	0.6370861
A01	1478523	1480727	A01p03240.2_BraZ1	1007.65	+	631	2111	2204	0.9578040
A01	1481022	1482307	A01p03250.2_BraZ1	1047.2	-	187	1137	1285	0.8848249
A01	1482649	1485279	A01p03260.2_BraZ1	832.06	-	877	2375	2630	0.9030418
A01	1486375	1486801	A01p03270.2_BraZ1	42.6	+	113	379	426	0.8896714
A01	1488345	1490995	A01p03280.2_BraZ1	1399.13	-	1195	2539	2650	0.9581132
A01	1494976	1497938	A01p03290.2_BraZ1	2177.94	+	486	2679	2962	0.9044564
A01	1498595	1502143	A01p03300.2_BraZ1	2089.14	-	481	2958	3548	0.8337091
A01	1505673	1508176	A01p03310.2_BraZ1	1395	+	1379	2273	2503	0.9081103
A01	1512274	1512844	A01p03320.2_BraZ1	423	+	100	527	570	0.9245614
A01	1520122	1525473	A01p03330.2_BraZ1	2653.75	+	2351	5084	5351	0.9501028
A01	1526868	1528860	A01p03340.2_BraZ1	1094.56	+	1293	1989	1992	0.9984940
A01	1529312	1531725	A01p03350.2_BraZ1	1023.9	-	1170	2336	2413	0.9680895
A01	1540783	1543657	A01p03360.2_BraZ1	2599.22	+	1242	2767	2874	0.9627697
A01	1545836	1548536	A01p03370.2_BraZ1	1263.48	+	982	2658	2700	0.9844444
A01	1549934	1551489	A01p03380.2_BraZ1	108.75	+	982	1555	1555	1.0000000
A01	1551489	1553988	A01p03390.2_BraZ1	955.364	+	1837	2488	2499	0.9955983
A01	1556413	1557049	A01p03400.2_BraZ1	369	-	193	636	636	1.0000000
A01	1561660	1562061	A01p03410.2_BraZ1	186	+	1216	401	401	1.0000000
A01	1562205	1563044	A01p03420.2_BraZ1	340.167	+	2525	839	839	1.0000000
A01	1564865	1566168	A01p03430.2_BraZ1	709.5	-	921	1257	1303	0.9646968
A01	1566690	1567976	A01p03440.2_BraZ1	657.13	-	239	938	1286	0.7293935
A01	1569526	1570084	A01p03450.2_BraZ1	55.8	-	386	558	558	1.0000000
A01	1574051	1575933	A01p03460.2_BraZ1	1245.17	+	378	1420	1882	0.7545165
A01	1577821	1579813	A01p03470.2_BraZ1	1430.94	+	737	1955	1992	0.9814257
A01	1580536	1582966	A01p03480.2_BraZ1	242.1	+	1311	2430	2430	1.0000000
A01	1583164	1586411	A01p03490.2_BraZ1	2286	-	2150	3240	3247	0.9978442
A01	1589439	1590646	A01p03500.2_BraZ1	1113	+	159	1074	1207	0.8898094
A01	1591400	1591784	A01p03510.2_BraZ1	38.4	-	6	109	384	0.2838542
A01	1594314	1595593	A01p03520.2_BraZ1	802.241	-	1077	1238	1279	0.9679437
A01	1602730	1603216	A01p03530.2_BraZ1	2010	-	551	486	486	1.0000000
A01	1605790	1607980	A01p03540.2_BraZ1	26970	+	535	2036	2190	0.9296803
A01	1608686	1610317	A01p03550.2_BraZ1	11119.5	-	986	1631	1631	1.0000000
A01	1617613	1618354	A01p03560.2_BraZ1	666	-	206	726	741	0.9797571
A01	1628082	1628623	A01p03570.2_BraZ1	462	+	303	539	541	0.9963031
A01	1631581	1632375	A01p03580.2_BraZ1	717	-	391	785	794	0.9886650
A01	1633195	1633411	A01p03590.2_BraZ1	21.6	-	235	216	216	1.0000000
A01	1641150	1642970	A01p03600.2_BraZ1	1272.44	-	1025	1763	1820	0.9686813
A01	1645272	1646707	A01p03610.2_BraZ1	514.083	-	1333	1426	1435	0.9937282
A01	1647691	1651711	A01p03620.2_BraZ1	2131.92	+	1191	3497	4020	0.8699005
A01	1657329	1658476	A01p03630.2_BraZ1	86.7	+	532	1147	1147	1.0000000
A01	1660433	1660953	A01p03640.2_BraZ1	399	-	4	183	520	0.3519231
A01	1664401	1665985	A01p03650.2_BraZ1	630.978	-	1243	1545	1584	0.9753788
A01	1668663	1669848	A01p03660.2_BraZ1	118.5	+	627	1185	1185	1.0000000
A01	1673518	1675840	A01p03670.2_BraZ1	1834.16	+	130	1753	2322	0.7549526
A01	1676623	1678630	A01p03680.2_BraZ1	200.7	-	288	2001	2007	0.9970105
A01	1680349	1683353	A01p03690.2_BraZ1	1579.05	-	1278	2918	3004	0.9713715
A01	1683744	1690128	A01p03700.2_BraZ1	3710.47	+	2132	5916	6384	0.9266917
A01	1690204	1693112	A01p03710.2_BraZ1	1328.55	-	1807	2908	2908	1.0000000
A01	1693678	1694272	A01p03720.2_BraZ1	59.4	-	132	552	594	0.9292929
A01	1697345	1699309	A01p03730.2_BraZ1	1626.8	+	802	1931	1964	0.9831976
A01	1699539	1700892	A01p03740.2_BraZ1	1148.51	-	241	1137	1353	0.8403547
A01	1701541	1707365	A01p03750.2_BraZ1	3337.71	+	1506	5362	5824	0.9206731
A01	1707830	1708160	A01p03760.2_BraZ1	31.5	-	456	330	330	1.0000000
A01	1710337	1710616	A01p03770.2_BraZ1	27.9	-	47	218	279	0.7813620
A01	1712620	1712938	A01p03780.2_BraZ1	31.8	-	45	318	318	1.0000000
A01	1715284	1715575	A01p03790.2_BraZ1	29.1	+	85	288	291	0.9896907
A01	1716338	1716653	A01p03800.2_BraZ1	31.5	-	23	113	315	0.3587302
A01	1727389	1727850	A01p03810.2_BraZ1	3366	+	5	200	461	0.4338395
A01	1731721	1732571	A01p03820.2_BraZ1	421.667	-	26	115	850	0.1352941
A01	1737106	1737430	A01p03830.2_BraZ1	32.4	+	30	252	324	0.7777778
A01	1744502	1744934	A01p03840.2_BraZ1	43.2	-	264	432	432	1.0000000
A01	1746186	1751028	A01p03850.2_BraZ1	1175.89	+	2994	4641	4842	0.9584882
A01	1754395	1758036	A01p03860.2_BraZ1	200.4	+	1507	2173	3641	0.5968140
A01	1759721	1763426	A01p03870.2_BraZ1	9735	+	542	3170	3705	0.8556005
A01	1763915	1765208	A01p03880.2_BraZ1	281.206	-	900	1293	1293	1.0000000
A01	1766408	1767308	A01p03890.2_BraZ1	11097	-	42	487	900	0.5411111
A01	1768793	1770237	A01p03900.2_BraZ1	501	+	384	1388	1444	0.9612188
A01	1771937	1773215	A01p03910.2_BraZ1	251.016	-	791	1278	1278	1.0000000
A01	1773731	1776130	A01p03920.2_BraZ1	1054.71	+	1638	2365	2399	0.9858274
A01	1776788	1784155	A01p03930.2_BraZ1	1917.35	-	6217	7367	7367	1.0000000
A01	1785144	1785777	A01p03940.2_BraZ1	63.3	+	256	632	633	0.9984202
A01	1786813	1787710	A01p03950.2_BraZ1	342	+	745	897	897	1.0000000
A01	1789999	1790555	A01p03960.2_BraZ1	240	-	62	479	556	0.8615108
A01	1793191	1793611	A01p03970.2_BraZ1	41.4	+	202	381	420	0.9071429
A01	1797531	1800453	A01p03980.2_BraZ1	540	-	2329	2381	2922	0.8148528
A01	1801321	1804507	A01p03990.2_BraZ1	1513.91	-	266	2250	3186	0.7062147
A01	1806183	1808714	A01p04000.2_BraZ1	1406.87	+	1586	2461	2531	0.9723430
A01	1811387	1812020	A01p04010.2_BraZ1	63.3	-	213	633	633	1.0000000
A01	1815258	1816506	A01p04020.2_BraZ1	832.295	-	722	1235	1248	0.9895833
A01	1818045	1819485	A01p04030.2_BraZ1	901.338	-	378	1234	1440	0.8569444
A01	1831620	1834271	A01p04040.2_BraZ1	1278.95	+	949	2497	2651	0.9419087
A01	1834701	1837488	A01p04050.2_BraZ1	1364.42	+	1486	2698	2787	0.9680660
A01	1839018	1845066	A01p04060.2_BraZ1	2153.98	+	2473	5900	6048	0.9755291
A01	1845729	1850333	A01p04070.2_BraZ1	2520	-	2448	3878	4604	0.8423110
A01	1851486	1854284	A01p04080.2_BraZ1	1881.65	-	1583	2696	2798	0.9635454
A01	1854965	1858423	A01p04090.2_BraZ1	2079.08	-	1343	3404	3458	0.9843841
A01	1859308	1863179	A01p04100.2_BraZ1	831.6	-	683	3250	3871	0.8395764
A01	1864549	1866647	A01p04110.2_BraZ1	303.333	+	1185	2090	2098	0.9961869
A01	1867124	1867916	A01p04120.2_BraZ1	79.2	-	434	792	792	1.0000000
A01	1871683	1871920	A01p04130.2_BraZ1	23.7	-	59	237	237	1.0000000
A01	1875053	1877875	A01p04140.2_BraZ1	1881.6	-	1920	2782	2822	0.9858257
A01	1881333	1882773	A01p04150.2_BraZ1	144	-	484	1390	1440	0.9652778
A01	1884306	1887078	A01p04160.2_BraZ1	1707.69	-	2289	2688	2772	0.9696970
A01	1888124	1889964	A01p04170.2_BraZ1	587.613	-	1509	1840	1840	1.0000000
A01	1890912	1893139	A01p04180.2_BraZ1	1258.78	+	1309	2054	2227	0.9223170
A01	1893989	1895033	A01p04190.2_BraZ1	104.4	+	308	955	1044	0.9147509
A01	1895472	1900376	A01p04200.2_BraZ1	2986.55	-	1926	3782	4904	0.7712072
A01	1900771	1901595	A01p04210.2_BraZ1	414	-	661	824	824	1.0000000
A01	1902054	1906029	A01p04220.2_BraZ1	1852.19	-	1792	3915	3975	0.9849057
A01	1906469	1907549	A01p04230.2_BraZ1	405.769	+	480	1051	1080	0.9731482
A01	1908214	1909923	A01p04240.2_BraZ1	810.643	+	1763	1709	1709	1.0000000
A01	1911103	1911615	A01p04250.2_BraZ1	330	-	465	512	512	1.0000000
A01	1913592	1914040	A01p04260.2_BraZ1	309	-	508	448	448	1.0000000
A01	1915262	1919323	A01p04270.2_BraZ1	2468.2	-	1926	4014	4061	0.9884265
A01	1921759	1923190	A01p04280.2_BraZ1	143.1	-	396	1388	1431	0.9699511
A01	1926556	1929433	A01p04290.2_BraZ1	1318.13	-	996	2792	2877	0.9704553
A01	1935321	1937179	A01p04300.2_BraZ1	984.5	+	534	1735	1858	0.9337998
A01	1938568	1941311	A01p04310.2_BraZ1	332.571	+	348	2116	2743	0.7714182
A01	1943790	1946174	A01p04320.2_BraZ1	1760.79	+	243	2055	2384	0.8619967
A01	1946971	1948694	A01p04330.2_BraZ1	789.75	+	345	1458	1723	0.8461985
A01	1950431	1953000	A01p04340.2_BraZ1	1744.18	+	866	2448	2569	0.9528999
A01	1953794	1954565	A01p04350.2_BraZ1	431.667	+	172	767	771	0.9948120
A01	1955128	1958360	A01p04360.2_BraZ1	1191.12	-	1717	2890	3232	0.8941832
A01	1960434	1961947	A01p04370.2_BraZ1	1008	+	73	760	1513	0.5023133
A01	1971130	1972497	A01p04380.2_BraZ1	1106.42	-	329	837	1367	0.6122897
A01	1973386	1978856	A01p04390.2_BraZ1	1215.09	-	4777	5430	5470	0.9926874
A01	1979105	1980727	A01p04400.2_BraZ1	1488	+	177	1513	1622	0.9327990
A01	1981533	1982994	A01p04410.2_BraZ1	146.1	+	334	1237	1461	0.8466803
A01	1985255	1986993	A01p04420.2_BraZ1	1449	+	801	1733	1738	0.9971231
A01	1987258	1988873	A01p04430.2_BraZ1	453.143	-	1882	1615	1615	1.0000000
A01	1989596	1992888	A01p04440.2_BraZ1	1498.78	-	2170	3286	3292	0.9981774
A01	1994477	1998601	A01p04450.2_BraZ1	2807.26	-	1200	3683	4124	0.8930650
A01	1999356	2005426	A01p04460.2_BraZ1	2880.34	-	1939	5593	6070	0.9214168
A01	2006478	2009640	A01p04470.2_BraZ1	760.5	+	197	546	3162	0.1726755
A01	2010481	2012483	A01p04480.2_BraZ1	1327.68	+	680	1853	2002	0.9255744
A01	2013292	2014895	A01p04490.2_BraZ1	799.765	-	1131	1603	1603	1.0000000
A01	2019504	2020936	A01p04500.2_BraZ1	6360	+	1176	1337	1432	0.9336592
A01	2021825	2024047	A01p04510.2_BraZ1	208.5	+	2982	2153	2222	0.9689469
A01	2028259	2028457	A01p04520.2_BraZ1	19.8	-	6	121	198	0.6111111
A01	2033446	2035541	A01p04530.2_BraZ1	925.913	-	753	1990	2095	0.9498807
A01	2037177	2039851	A01p04540.2_BraZ1	1219.33	-	2100	2674	2674	1.0000000
A01	2040320	2041460	A01p04550.2_BraZ1	664.63	-	1769	1140	1140	1.0000000
A01	2042293	2044336	A01p04560.2_BraZ1	610	-	1437	2043	2043	1.0000000
A01	2051085	2052673	A01p04570.2_BraZ1	1029.5	+	577	1481	1588	0.9326196
A01	2055589	2057066	A01p04580.2_BraZ1	1014.57	+	569	1477	1477	1.0000000
A01	2059783	2060696	A01p04590.2_BraZ1	393.143	+	439	913	913	1.0000000
A01	2063558	2068967	A01p04600.2_BraZ1	1209.12	+	1389	4500	5409	0.8319467
A01	2070461	2071509	A01p04610.2_BraZ1	362.267	+	2045	1048	1048	1.0000000
A01	2075761	2078133	A01p04620.2_BraZ1	948.444	+	729	2235	2372	0.9422429
A01	2078796	2082204	A01p04630.2_BraZ1	1874.01	+	1114	3239	3408	0.9504108
A01	2084270	2085578	A01p04640.2_BraZ1	130.8	-	1153	1308	1308	1.0000000
A01	2087166	2087685	A01p04650.2_BraZ1	51.9	-	176	481	519	0.9267823
A01	2089646	2090171	A01p04660.2_BraZ1	52.5	-	43	299	525	0.5695238
A01	2093939	2096522	A01p04670.2_BraZ1	1180.76	+	875	2111	2583	0.8172668
A01	2096863	2097829	A01p04680.2_BraZ1	765	-	1035	966	966	1.0000000
A01	2098334	2101342	A01p04690.2_BraZ1	1343.92	+	1995	3008	3008	1.0000000
A01	2101593	2101845	A01p04700.2_BraZ1	25.2	-	106	252	252	1.0000000
A01	2102796	2103209	A01p04710.2_BraZ1	222	+	110	378	413	0.9152542
A01	2104236	2109050	A01p04720.2_BraZ1	2249.42	-	3159	4814	4814	1.0000000
A01	2110331	2110819	A01p04730.2_BraZ1	288	+	461	488	488	1.0000000
A01	2111531	2112809	A01p04740.2_BraZ1	469.8	+	597	1278	1278	1.0000000
A01	2113059	2118377	A01p04750.2_BraZ1	2155.14	-	4024	5318	5318	1.0000000
A01	2119269	2124638	A01p04760.2_BraZ1	1704.37	-	3075	5349	5369	0.9962749
A01	2125628	2129110	A01p04770.2_BraZ1	2411.03	+	863	3024	3482	0.8684664
A01	2129706	2134545	A01p04780.2_BraZ1	2798.94	-	2912	4669	4839	0.9648688
A01	2135411	2138231	A01p04790.2_BraZ1	1385.18	-	1280	2792	2820	0.9900709
A01	2140231	2143679	A01p04800.2_BraZ1	1814.06	+	1794	3431	3448	0.9950696
A01	2144641	2145889	A01p04810.2_BraZ1	124.8	+	620	1248	1248	1.0000000
A01	2146317	2148002	A01p04820.2_BraZ1	1254.82	+	762	1595	1685	0.9465876
A01	2148767	2151086	A01p04830.2_BraZ1	953.75	+	688	2314	2319	0.9978439
A01	2151604	2154064	A01p04840.2_BraZ1	1122.08	+	1306	2460	2460	1.0000000
A01	2159464	2159844	A01p04850.2_BraZ1	3150	+	390	380	380	1.0000000
A01	2160298	2161819	A01p04860.2_BraZ1	812.214	+	828	1514	1521	0.9953977
A01	2163788	2164639	A01p04870.2_BraZ1	756	+	192	836	851	0.9823737
A01	2166590	2169424	A01p04880.2_BraZ1	1338.9	-	891	2703	2834	0.9537756
A01	2171920	2174971	A01p04890.2_BraZ1	1789.3	+	1151	2974	3051	0.9747624
A01	2175545	2187524	A01p04900.2_BraZ1	944.762	-	730	5189	11979	0.4331747
A01	2177212	2177509	A01p04910.2_BraZ1	150	+	0	0	297	0.0000000
A01	2189157	2190475	A01p04920.2_BraZ1	1155.1	-	723	1318	1318	1.0000000
A01	2192439	2194807	A01p04930.2_BraZ1	1935	+	581	1884	2368	0.7956081
A01	2195144	2200411	A01p04940.2_BraZ1	4270.91	-	2686	5077	5267	0.9639263
A01	2200948	2202952	A01p04950.2_BraZ1	662.444	+	1346	2004	2004	1.0000000
A01	2204559	2207948	A01p04960.2_BraZ1	2107.83	+	1211	3364	3389	0.9926232
A01	2212490	2216268	A01p04970.2_BraZ1	5602.5	+	2787	3778	3778	1.0000000
A01	2217613	2221827	A01p04980.2_BraZ1	1228.28	+	2312	4065	4214	0.9646417
A01	2223534	2230318	A01p04990.2_BraZ1	4753.25	+	2808	6630	6784	0.9772995
A01	2230516	2233875	A01p05000.2_BraZ1	158.7	-	1037	2852	3359	0.8490622
A01	2235920	2240698	A01p05010.2_BraZ1	2552.73	+	2470	4734	4778	0.9907911
A01	2244392	2256840	A01p05020.2_BraZ1	413.1	+	1862	6789	12448	0.5453888
A01	2257625	2259434	A01p05030.2_BraZ1	12630.4	-	1209	1709	1809	0.9447209
A01	2259891	2262858	A01p05040.2_BraZ1	296.7	+	1027	2967	2967	1.0000000
A01	2262971	2264207	A01p05050.2_BraZ1	122.7	-	771	1236	1236	1.0000000
A01	2268482	2274111	A01p05060.2_BraZ1	2837.01	+	4589	5539	5629	0.9840114
A01	2274587	2274776	A01p05070.2_BraZ1	18.9	+	163	189	189	1.0000000
A01	2276053	2276239	A01p05080.2_BraZ1	18.6	+	299	186	186	1.0000000
A01	2277363	2277549	A01p05090.2_BraZ1	18.6	+	54	186	186	1.0000000
A01	2280412	2280598	A01p05100.2_BraZ1	18.6	+	54	186	186	1.0000000
A01	2281244	2283049	A01p05110.2_BraZ1	1020	-	1653	1805	1805	1.0000000
A01	2285962	2287260	A01p05120.2_BraZ1	557.467	+	933	1298	1298	1.0000000
A01	2288736	2292409	A01p05130.2_BraZ1	1090.23	+	2092	3673	3673	1.0000000
A01	2293497	2295794	A01p05140.2_BraZ1	1035.64	+	1830	2284	2297	0.9943404
A01	2296110	2296574	A01p05150.2_BraZ1	255	-	306	464	464	1.0000000
A01	2297352	2301617	A01p05160.2_BraZ1	2557.3	+	2515	4265	4265	1.0000000
A01	2303721	2308125	A01p05170.2_BraZ1	1347.27	-	1181	4003	4404	0.9089464
A01	2310254	2313168	A01p05180.2_BraZ1	1420.43	-	949	2764	2914	0.9485244
A01	2320444	2320879	A01p05190.2_BraZ1	43.5	+	10	88	435	0.2022988
A01	2322128	2322257	A01p05200.2_BraZ1	12.9	+	32	121	129	0.9379845
A01	2324201	2326734	A01p05210.2_BraZ1	604.457	-	1511	2468	2533	0.9743387
A01	2327590	2329952	A01p05220.2_BraZ1	927	+	1460	2246	2362	0.9508891
A01	2331827	2336112	A01p05230.2_BraZ1	2645.58	+	507	3862	4285	0.9012836
A01	2336772	2338204	A01p05240.2_BraZ1	728.816	-	945	1432	1432	1.0000000
A01	2342277	2343965	A01p05250.2_BraZ1	4469.86	+	1467	1656	1688	0.9810427
A01	2344424	2344891	A01p05260.2_BraZ1	2371.5	-	598	467	467	1.0000000
A01	2345585	2346023	A01p05270.2_BraZ1	267	+	463	438	438	1.0000000
A01	2346692	2348677	A01p05280.2_BraZ1	165.767	-	2058	1985	1985	1.0000000
A01	2349832	2350249	A01p05290.2_BraZ1	522	-	1207	417	417	1.0000000
A01	2358703	2359229	A01p05300.2_BraZ1	35.7	+	254	422	526	0.8022814
A01	2360610	2362993	A01p05310.2_BraZ1	1500.6	+	552	2084	2383	0.8745279
A01	2363159	2364334	A01p05320.2_BraZ1	484	-	343	1175	1175	1.0000000
A01	2366618	2373492	A01p05330.2_BraZ1	4002.95	+	1614	6263	6874	0.9111143
A01	2374312	2378029	A01p05340.2_BraZ1	2028.65	-	503	2888	3717	0.7769707
A01	2378526	2380182	A01p05350.2_BraZ1	527.637	+	924	1495	1656	0.9027778
A01	2382927	2384060	A01p05360.2_BraZ1	942	-	517	1133	1133	1.0000000
A01	2391309	2395744	A01p05370.2_BraZ1	2384.89	+	564	2590	4435	0.5839910
A01	2398294	2398786	A01p05380.2_BraZ1	49.2	-	97	492	492	1.0000000
A01	2402485	2403067	A01p05390.2_BraZ1	58.2	+	419	582	582	1.0000000
A01	2404060	2409035	A01p05400.2_BraZ1	1988.57	-	1951	4442	4975	0.8928643
A01	2411492	2414603	A01p05410.2_BraZ1	1359.31	+	1021	2740	3111	0.8807458
A01	2415157	2416968	A01p05420.2_BraZ1	817.47	-	1391	1811	1811	1.0000000
A01	2417962	2427339	A01p05430.2_BraZ1	4942.06	+	2561	7255	9377	0.7737016
A01	2427817	2431022	A01p05440.2_BraZ1	1625.71	-	1047	2781	3205	0.8677067
A01	2441357	2442047	A01p05450.2_BraZ1	69	-	59	526	690	0.7623188
A01	2447728	2450999	A01p05460.2_BraZ1	1196.27	-	944	2626	3271	0.8028126
A01	2452463	2454511	A01p05470.2_BraZ1	520.2	-	1561	2048	2048	1.0000000
A01	2454941	2456134	A01p05480.2_BraZ1	888.375	-	760	1193	1193	1.0000000
A01	2464238	2465348	A01p05490.2_BraZ1	111	-	730	1110	1110	1.0000000
A01	2465884	2470019	A01p05500.2_BraZ1	1730.9	-	1935	4135	4135	1.0000000
A01	2470857	2477827	A01p05510.2_BraZ1	665.125	+	5817	6696	6970	0.9606887
A01	2478295	2482524	A01p05520.2_BraZ1	2567.92	-	2007	3774	4229	0.8924096
A01	2484034	2486257	A01p05530.2_BraZ1	1186.67	-	336	2112	2223	0.9500675
A01	2488280	2489021	A01p05540.2_BraZ1	288	-	711	741	741	1.0000000
A01	2490103	2490572	A01p05550.2_BraZ1	294	-	263	469	469	1.0000000
A01	2491606	2492954	A01p05560.2_BraZ1	333	-	500	1276	1348	0.9465876
A01	2493363	2493803	A01p05570.2_BraZ1	300	-	233	347	440	0.7886364
A01	2494369	2498688	A01p05580.2_BraZ1	1918.26	-	1211	3678	4319	0.8515860
A01	2499705	2515089	A01p05590.2_BraZ1	6113.79	-	5381	14291	15384	0.9289522
A01	2515543	2517536	A01p05600.2_BraZ1	6696	+	1328	1943	1993	0.9749122
A01	2518214	2521414	A01p05610.2_BraZ1	2030.44	+	2366	3164	3200	0.9887500
A01	2521930	2525388	A01p05620.2_BraZ1	5580.25	+	5103	3458	3458	1.0000000
A01	2525812	2528449	A01p05630.2_BraZ1	975.611	-	1725	2622	2637	0.9943117
A01	2531400	2535070	A01p05640.2_BraZ1	1906.39	+	1046	2545	3670	0.6934605
A01	2536039	2543560	A01p05650.2_BraZ1	3186.98	-	5272	7418	7521	0.9863050
A01	2544713	2553854	A01p05660.2_BraZ1	5025.25	-	1972	6539	9141	0.7153484
A01	2556343	2562431	A01p05670.2_BraZ1	847.108	+	4414	5847	6088	0.9604139
A01	2577436	2578426	A01p05680.2_BraZ1	351	-	1606	990	990	1.0000000
A01	2582242	2582470	A01p05690.2_BraZ1	22.8	+	81	228	228	1.0000000
A01	2582482	2584029	A01p05700.2_BraZ1	927	+	828	1547	1547	1.0000000
A01	2584688	2585927	A01p05710.2_BraZ1	934.8	+	855	1239	1239	1.0000000
A01	2586596	2588145	A01p05720.2_BraZ1	1219.17	-	905	1549	1549	1.0000000
A01	2589290	2595070	A01p05730.2_BraZ1	432.727	-	1174	4757	5780	0.8230104
A01	2596588	2598507	A01p05740.2_BraZ1	969.183	+	1387	1919	1919	1.0000000
A01	2599031	2599271	A01p05750.2_BraZ1	24	+	165	240	240	1.0000000
A01	2599694	2601783	A01p05760.2_BraZ1	879.12	-	1147	2038	2089	0.9755864
A01	2602190	2607271	A01p05770.2_BraZ1	2567.25	-	1680	4819	5081	0.9484354
A01	2620064	2621987	A01p05780.2_BraZ1	1204.62	-	269	1307	1923	0.6796672
A01	2627297	2628922	A01p05790.2_BraZ1	1365	-	971	1563	1625	0.9618462
A01	2629562	2630750	A01p05800.2_BraZ1	468.612	+	778	1143	1188	0.9621212
A01	2631756	2637850	A01p05810.2_BraZ1	2542.14	+	3055	6094	6094	1.0000000
A01	2638615	2641939	A01p05820.2_BraZ1	2142.67	-	1670	3020	3324	0.9085439
A01	2643587	2644760	A01p05830.2_BraZ1	333.125	+	1106	1173	1173	1.0000000
A01	2650112	2652404	A01p05840.2_BraZ1	1207.8	+	371	1901	2292	0.8294066
A01	2652948	2657992	A01p05850.2_BraZ1	8736	-	2065	4662	5044	0.9242665
A01	2655448	2655853	A01p05860.2_BraZ1	40.5	-	34	405	405	1.0000000
A01	2661388	2664053	A01p05870.2_BraZ1	2361	-	1130	2665	2665	1.0000000
A01	2664310	2668604	A01p05880.2_BraZ1	2124.46	+	3571	4185	4294	0.9746158
A01	2669469	2674344	A01p05890.2_BraZ1	2899.4	+	1866	4853	4875	0.9954872
A01	2674857	2676359	A01p05900.2_BraZ1	1179.24	-	1008	1378	1502	0.9174434
A01	2679601	2680657	A01p05910.2_BraZ1	105.6	-	168	845	1056	0.8001894
A01	2681834	2682924	A01p05920.2_BraZ1	966	-	134	484	1090	0.4440367
A01	2683593	2687032	A01p05930.2_BraZ1	1122.54	-	873	3074	3439	0.8938645
A01	2688068	2690640	A01p05940.2_BraZ1	1410.15	-	1152	2357	2572	0.9164075
A01	2691755	2693177	A01p05950.2_BraZ1	747	+	964	1422	1422	1.0000000
A01	2694049	2696020	A01p05960.2_BraZ1	1243.1	-	2064	1971	1971	1.0000000
A01	2697005	2697221	A01p05970.2_BraZ1	18.6	+	15	184	216	0.8518519
A01	2701321	2706802	A01p05980.2_BraZ1	4809	-	2887	5217	5481	0.9518336
A01	2712379	2713646	A01p05990.2_BraZ1	755.44	-	542	1212	1267	0.9565904
A01	2715210	2715546	A01p06000.2_BraZ1	33.6	+	93	336	336	1.0000000
A01	2722693	2723537	A01p06010.2_BraZ1	49.2	+	301	844	844	1.0000000
A01	2725621	2727508	A01p06020.2_BraZ1	188.7	-	482	1795	1887	0.9512454
A01	2729618	2730655	A01p06030.2_BraZ1	5877.33	-	1383	1037	1037	1.0000000
A01	2739482	2740535	A01p06040.2_BraZ1	552	+	901	1053	1053	1.0000000
A01	2741176	2742367	A01p06050.2_BraZ1	5629.5	+	501	1141	1191	0.9580185
A01	2742623	2746978	A01p06060.2_BraZ1	1647.16	-	2197	4154	4355	0.9538462
A01	2750941	2752365	A01p06070.2_BraZ1	73.2	+	52	673	1424	0.4726124
A01	2753607	2756117	A01p06080.2_BraZ1	3095.37	-	1193	2510	2510	1.0000000
A01	2757416	2762744	A01p06090.2_BraZ1	2701.83	+	3581	5247	5328	0.9847973
A01	2763070	2766926	A01p06100.2_BraZ1	2106.77	-	1589	3568	3856	0.9253112
A01	2767461	2767938	A01p06110.2_BraZ1	29.7	-	524	477	477	1.0000000
A01	2768872	2777449	A01p06120.2_BraZ1	1124.45	+	5865	8335	8577	0.9717850
A01	2777822	2780460	A01p06130.2_BraZ1	267.273	+	1349	2170	2638	0.8225929
A01	2784163	2784676	A01p06140.2_BraZ1	268.364	+	60	446	513	0.8693957
A01	2786206	2786755	A01p06150.2_BraZ1	375	+	20	89	549	0.1621129
A01	2787773	2790018	A01p06160.2_BraZ1	2169	+	180	1625	2245	0.7238308
A01	2791037	2793271	A01p06170.2_BraZ1	1469.65	-	509	1817	2234	0.8133393
A01	2793762	2797983	A01p06180.2_BraZ1	1632.88	-	3210	4177	4221	0.9895759
A01	2799068	2801019	A01p06190.2_BraZ1	1137.81	-	518	1914	1951	0.9810354
A01	2802174	2804385	A01p06200.2_BraZ1	545.31	-	407	2147	2211	0.9710538
A01	2805530	2805693	A01p06210.2_BraZ1	11.4	+	106	163	163	1.0000000
A01	2806379	2807009	A01p06220.2_BraZ1	63	-	52	390	630	0.6190476
A01	2813768	2819189	A01p06230.2_BraZ1	1321.06	+	2592	4997	5421	0.9217857
A01	2819839	2821431	A01p06240.2_BraZ1	203.357	-	1573	1592	1592	1.0000000
A01	2822969	2824289	A01p06250.2_BraZ1	577.5	-	416	1320	1320	1.0000000
A01	2827136	2834176	A01p06260.2_BraZ1	2541.72	-	1063	4501	7040	0.6393466
A01	2839058	2844398	A01p06270.2_BraZ1	2222.1	-	914	3361	5340	0.6294007
A01	2852089	2853364	A01p06280.2_BraZ1	720.5	+	701	1275	1275	1.0000000
A01	2858959	2860845	A01p06290.2_BraZ1	1539	+	1138	1851	1886	0.9814422
A01	2864199	2869367	A01p06300.2_BraZ1	2433.53	+	1172	3824	5168	0.7399381
A01	2878851	2881360	A01p06310.2_BraZ1	267	+	2261	2397	2509	0.9553607
A01	2881225	2883752	A01p06320.2_BraZ1	501	+	1710	2435	2527	0.9635932
A01	2884518	2887821	A01p06330.2_BraZ1	330.3	-	1740	3303	3303	1.0000000
A01	2888511	2889149	A01p06340.2_BraZ1	510	-	367	638	638	1.0000000
A01	2889812	2890115	A01p06350.2_BraZ1	30.3	+	23	209	303	0.6897690
A01	2897029	2900389	A01p06360.2_BraZ1	1661.75	+	1904	3360	3360	1.0000000
A01	2900841	2901986	A01p06370.2_BraZ1	111.3	+	862	1145	1145	1.0000000
A01	2903230	2904539	A01p06380.2_BraZ1	883.5	-	1533	1309	1309	1.0000000
A01	2909015	2910255	A01p06390.2_BraZ1	83.4	-	641	1240	1240	1.0000000
A01	2911160	2913431	A01p06400.2_BraZ1	1306.29	-	1470	2271	2271	1.0000000
A01	2915702	2917622	A01p06410.2_BraZ1	660	+	2450	1920	1920	1.0000000
A01	2918100	2919825	A01p06420.2_BraZ1	477.833	-	1099	1725	1725	1.0000000
A01	2921322	2921475	A01p06430.2_BraZ1	15.3	-	35	153	153	1.0000000
A01	2921518	2922019	A01p06440.2_BraZ1	50.1	-	48	254	501	0.5069860
A01	2927384	2929575	A01p06450.2_BraZ1	375.375	+	2725	2191	2191	1.0000000
A01	2929915	2931683	A01p06460.2_BraZ1	111.3	-	176	960	1768	0.5429865
A01	2932734	2933446	A01p06470.2_BraZ1	192	-	771	712	712	1.0000000
A01	2934160	2935429	A01p06480.2_BraZ1	620.93	+	694	1269	1269	1.0000000
A01	2936217	2943332	A01p06490.2_BraZ1	2037.83	+	3889	6996	7115	0.9832748
A01	2939298	2940914	A01p06500.2_BraZ1	3974.4	-	1656	1616	1616	1.0000000
A01	2945768	2945924	A01p06510.2_BraZ1	15.6	+	188	156	156	1.0000000
A01	2946248	2951735	A01p06520.2_BraZ1	1569.75	+	2944	4321	5487	0.7874977
A01	2952455	2952785	A01p06530.2_BraZ1	33	-	416	330	330	1.0000000
A01	2954088	2959499	A01p06540.2_BraZ1	2122.36	-	5739	5325	5411	0.9841064
A01	2959895	2966597	A01p06550.2_BraZ1	1493.53	+	3523	6408	6702	0.9561325
A01	2967831	2975177	A01p06560.2_BraZ1	3393	-	2979	6852	7346	0.9327525
A01	2976866	2978343	A01p06570.2_BraZ1	810.682	+	6575	1477	1477	1.0000000
A01	2978325	2979300	A01p06580.2_BraZ1	454.591	+	3626	975	975	1.0000000
A01	2984341	2986099	A01p06590.2_BraZ1	905.556	+	376	1738	1758	0.9886234
A01	2988654	2990688	A01p06600.2_BraZ1	203.4	+	478	1930	2034	0.9488692
A01	2991415	2993504	A01p06610.2_BraZ1	6156	-	404	1715	2089	0.8209670
A01	2995185	2995881	A01p06620.2_BraZ1	375	-	179	646	696	0.9281609
A01	2997343	2997865	A01p06630.2_BraZ1	375	-	274	522	522	1.0000000
A01	3000571	3001114	A01p06640.2_BraZ1	41.5	-	219	415	543	0.7642726
A01	3001658	3001863	A01p06650.2_BraZ1	183	+	4	141	205	0.6878049
A01	3002727	3004797	A01p06660.2_BraZ1	1539	-	650	1971	2070	0.9521739
A01	3011638	3014895	A01p06670.2_BraZ1	99170.5	-	313	2182	3257	0.6699417
A01	3015677	3016980	A01p06680.2_BraZ1	639	+	82	553	1303	0.4244052
A01	3017401	3018764	A01p06690.2_BraZ1	1200	-	415	1261	1363	0.9251651
A01	3020702	3022153	A01p06700.2_BraZ1	130.2	-	346	1435	1451	0.9889731
A01	3023485	3026694	A01p06710.2_BraZ1	1388.05	-	1731	3142	3209	0.9791212
A01	3027900	3029503	A01p06720.2_BraZ1	1697.14	+	910	1603	1603	1.0000000
A01	3030021	3031101	A01p06730.2_BraZ1	984	-	513	970	1080	0.8981481
A01	3035773	3039097	A01p06740.2_BraZ1	1870	-	1647	3211	3324	0.9660048
A01	3042458	3042833	A01p06750.2_BraZ1	37.5	-	19	228	375	0.6080000
A01	3045677	3046509	A01p06760.2_BraZ1	332.75	+	89	666	832	0.8004808
A01	3047958	3049153	A01p06770.2_BraZ1	540	-	1469	1195	1195	1.0000000
A01	3049799	3051903	A01p06780.2_BraZ1	1108.15	-	2007	2104	2104	1.0000000
A01	3053157	3054383	A01p06790.2_BraZ1	1098	+	576	1112	1226	0.9070147
A01	3055428	3058429	A01p06800.2_BraZ1	1246.53	-	1805	2946	3001	0.9816728
A01	3060533	3061333	A01p06810.2_BraZ1	723	-	396	800	800	1.0000000
A01	3069378	3069846	A01p06820.2_BraZ1	46.8	+	0	0	468	0.0000000
A01	3071635	3071758	A01p06830.2_BraZ1	12.3	-	0	0	123	0.0000000
A01	3071838	3072432	A01p06840.2_BraZ1	59.4	+	0	0	594	0.0000000
A01	3074267	3074834	A01p06850.2_BraZ1	56.7	+	261	517	567	0.9118166
A01	3076804	3078924	A01p06860.2_BraZ1	700.356	-	1791	2093	2120	0.9872642
A01	3079429	3080778	A01p06870.2_BraZ1	687	-	1957	1349	1349	1.0000000
A01	3083620	3098981	A01p06880.2_BraZ1	4108.27	+	5321	12110	15361	0.7883601
A01	3099184	3105710	A01p06890.2_BraZ1	3109.09	-	4930	6478	6526	0.9926448
A01	3106244	3108390	A01p06900.2_BraZ1	1899	+	970	2025	2146	0.9436160
A01	3108956	3111396	A01p06910.2_BraZ1	1672.92	-	605	1693	2440	0.6938525
A01	3112412	3113732	A01p06920.2_BraZ1	1242	+	351	1320	1320	1.0000000
A01	3115222	3117208	A01p06930.2_BraZ1	1452	-	568	1986	1986	1.0000000
A01	3122418	3123265	A01p06940.2_BraZ1	1512	+	413	847	847	1.0000000
A01	3125545	3128095	A01p06950.2_BraZ1	3325.5	-	1933	2550	2550	1.0000000
A01	3132472	3134934	A01p06960.2_BraZ1	330	-	2010	2462	2462	1.0000000
A01	3136652	3139258	A01p06970.2_BraZ1	2786.14	+	1761	2533	2606	0.9719877
A01	3139716	3142638	A01p06980.2_BraZ1	1114.36	-	1695	2855	2922	0.9770705
A01	3143024	3144945	A01p06990.2_BraZ1	1073.81	+	1026	1921	1921	1.0000000
A01	3147485	3148745	A01p07000.2_BraZ1	853.393	+	530	1236	1260	0.9809524
A01	3149214	3151431	A01p07010.2_BraZ1	1191.27	-	754	2110	2217	0.9517366
A01	3152314	3153307	A01p07020.2_BraZ1	4731	-	203	977	993	0.9838872
A01	3153779	3154149	A01p07030.2_BraZ1	29.1	-	230	370	370	1.0000000
A01	3154149	3155643	A01p07040.2_BraZ1	627.828	-	679	1466	1494	0.9812584
A01	3157730	3159544	A01p07050.2_BraZ1	743.353	-	829	1722	1814	0.9492834
A01	3161351	3162491	A01p07060.2_BraZ1	423.281	+	653	1107	1140	0.9710526
A01	3164682	3165164	A01p07070.2_BraZ1	204	-	89	253	482	0.5248963
A01	3178662	3179295	A01p07080.2_BraZ1	63.3	-	59	515	633	0.8135861
A01	3183028	3184351	A01p07090.2_BraZ1	132.3	-	156	1155	1323	0.8730159
A01	3198935	3201027	A01p07100.2_BraZ1	1242.3	+	1322	2075	2092	0.9918738
A01	3205658	3207013	A01p07110.2_BraZ1	758.333	+	1280	1355	1355	1.0000000
A01	3207672	3210292	A01p07120.2_BraZ1	1715.95	+	788	2155	2620	0.8225191
A01	3210607	3212433	A01p07130.2_BraZ1	867	-	320	1345	1826	0.7365827
A01	3214088	3216452	A01p07140.2_BraZ1	1207.22	+	1473	2364	2364	1.0000000
A01	3216954	3217308	A01p07150.2_BraZ1	35.4	-	313	354	354	1.0000000
A01	3221394	3223169	A01p07160.2_BraZ1	1074	+	549	1640	1775	0.9239436
A01	3223835	3224419	A01p07170.2_BraZ1	120	+	71	160	584	0.2739726
A01	3225448	3226426	A01p07180.2_BraZ1	963	+	724	978	978	1.0000000
A01	3226773	3229413	A01p07190.2_BraZ1	264	-	935	2291	2640	0.8678030
A01	3230079	3232826	A01p07200.2_BraZ1	1155.82	-	624	2177	2747	0.7925009
A01	3236076	3236481	A01p07210.2_BraZ1	40.5	-	0	0	405	0.0000000
A01	3238726	3241347	A01p07220.2_BraZ1	1446	-	480	2242	2621	0.8553987
A01	3258105	3261828	A01p07230.2_BraZ1	19475.2	+	1185	3716	3723	0.9981198
A01	3262335	3264494	A01p07240.2_BraZ1	1443.96	-	438	1918	2159	0.8883743
A01	3267079	3267710	A01p07250.2_BraZ1	462	-	0	0	631	0.0000000
A01	3270141	3270603	A01p07260.2_BraZ1	46.2	+	65	335	462	0.7251082
A01	3274969	3280144	A01p07270.2_BraZ1	3766.25	+	1528	4562	5175	0.8815459
A01	3280943	3284025	A01p07280.2_BraZ1	118.75	+	284	2189	3082	0.7102531
A01	3289646	3290806	A01p07290.2_BraZ1	723.333	+	105	376	1160	0.3241379
A01	3292273	3292856	A01p07300.2_BraZ1	201	+	120	583	583	1.0000000
A01	3295890	3296589	A01p07310.2_BraZ1	69.9	+	280	536	699	0.7668097
A01	3298447	3299222	A01p07320.2_BraZ1	1075.09	-	69	404	775	0.5212903
A01	3299714	3305411	A01p07330.2_BraZ1	17335.9	-	17095	3541	5697	0.6215552
A01	3306010	3307374	A01p07340.2_BraZ1	1022.78	-	282	1266	1364	0.9281525
A01	3309960	3317011	A01p07350.2_BraZ1	2737.39	+	264	2887	7051	0.4094455
A01	3317833	3318841	A01p07360.2_BraZ1	5025	-	889	1008	1008	1.0000000
A01	3321428	3321755	A01p07370.2_BraZ1	32.7	+	43	199	327	0.6085627
A01	3323015	3333373	A01p07380.2_BraZ1	441	+	1418	6921	10358	0.6681792
A01	3334954	3335578	A01p07390.2_BraZ1	324	-	1001	624	624	1.0000000
A01	3336073	3336381	A01p07400.2_BraZ1	225	-	266	308	308	1.0000000
A01	3336882	3337903	A01p07410.2_BraZ1	5131.5	-	251	917	1021	0.8981391
A01	3343136	3344330	A01p07420.2_BraZ1	119.4	+	192	964	1194	0.8073702
A01	3344986	3345931	A01p07430.2_BraZ1	605.091	-	756	945	945	1.0000000
A01	3347813	3348033	A01p07440.2_BraZ1	19.2	-	58	220	220	1.0000000
A01	3350023	3350189	A01p07450.2_BraZ1	14.1	-	4	158	166	0.9518072
A01	3352092	3354505	A01p07460.2_BraZ1	1869	+	1111	2393	2413	0.9917116
A01	3355894	3357124	A01p07470.2_BraZ1	770.929	-	136	653	1230	0.5308943
A01	3361732	3362467	A01p07480.2_BraZ1	219	+	539	724	735	0.9850340
A01	3363776	3366494	A01p07490.2_BraZ1	881.571	+	2366	2718	2718	1.0000000
A01	3370621	3371750	A01p07500.2_BraZ1	476.325	-	876	1129	1129	1.0000000
A01	3372008	3372210	A01p07510.2_BraZ1	102	+	74	202	202	1.0000000
A01	3377010	3378165	A01p07520.2_BraZ1	309	-	452	967	1155	0.8372294
A01	3378153	3378774	A01p07530.2_BraZ1	62.1	+	25	175	621	0.2818035
A01	3386291	3386618	A01p07540.2_BraZ1	32.7	+	0	0	327	0.0000000
A01	3388949	3390239	A01p07550.2_BraZ1	129	+	89	690	1290	0.5348837
A01	3393930	3395245	A01p07560.2_BraZ1	780	+	541	1210	1315	0.9201521
A01	3395365	3397045	A01p07570.2_BraZ1	748	-	90	963	1680	0.5732143
A01	3400052	3402491	A01p07580.2_BraZ1	18468	-	82	797	2439	0.3267733
A01	3404147	3404820	A01p07590.2_BraZ1	588	+	78	323	673	0.4799406
A01	3406897	3408316	A01p07600.2_BraZ1	141.9	-	169	821	1419	0.5785764
A01	3411508	3412078	A01p07610.2_BraZ1	303	+	51	545	570	0.9561403
A01	3418017	3418592	A01p07620.2_BraZ1	378	-	219	395	575	0.6869565
A01	3421161	3421650	A01p07630.2_BraZ1	48.9	+	155	393	489	0.8036810
A01	3422724	3426674	A01p07640.2_BraZ1	2309.84	+	1597	3619	3950	0.9162025
A01	3430120	3432998	A01p07650.2_BraZ1	2796.75	-	928	2464	2878	0.8561501
A01	3446100	3448741	A01p07660.2_BraZ1	1275.56	+	1119	2619	2641	0.9916698
A01	3449581	3450088	A01p07670.2_BraZ1	50.7	-	422	507	507	1.0000000
A01	3452066	3453223	A01p07680.2_BraZ1	105.3	+	94	974	1157	0.8418323
A01	3454591	3455694	A01p07690.2_BraZ1	1010	+	150	786	1103	0.7126020
A01	3457081	3458196	A01p07700.2_BraZ1	896.167	+	216	859	1115	0.7704036
A01	3460830	3461118	A01p07710.2_BraZ1	28.8	-	0	0	288	0.0000000
A01	3463395	3464490	A01p07720.2_BraZ1	109.5	+	162	1068	1095	0.9753425
A01	3465972	3467016	A01p07730.2_BraZ1	4138.88	+	166	893	1044	0.8553640
A01	3470519	3472025	A01p07740.2_BraZ1	1377	+	260	951	1506	0.6314741
A01	3476583	3477747	A01p07750.2_BraZ1	13600	+	1047	1164	1164	1.0000000
A01	3481300	3483034	A01p07760.2_BraZ1	173.4	+	887	1472	1734	0.8489043
A01	3484795	3486152	A01p07770.2_BraZ1	905.357	+	1112	1357	1357	1.0000000
A01	3487747	3488506	A01p07780.2_BraZ1	75.9	-	760	759	759	1.0000000
A01	3491975	3495715	A01p07790.2_BraZ1	1864.77	-	2411	3740	3740	1.0000000
A01	3506714	3508982	A01p07800.2_BraZ1	1956	+	1008	2267	2268	0.9995591
A01	3525852	3530295	A01p07810.2_BraZ1	2536.64	+	1255	4005	4443	0.9014180
A01	3531781	3532270	A01p07820.2_BraZ1	48.9	-	5	203	489	0.4151329
A01	3539961	3541527	A01p07830.2_BraZ1	190.588	-	1283	1419	1566	0.9061303
A01	3545424	3545957	A01p07840.2_BraZ1	396	-	245	501	533	0.9399625
A01	3548719	3553560	A01p07850.2_BraZ1	2339.71	-	2007	4699	4841	0.9706672
A01	3557562	3558768	A01p07860.2_BraZ1	240	-	550	1180	1206	0.9784411
A01	3563048	3569684	A01p07870.2_BraZ1	5027.02	-	2860	6271	6636	0.9449970
A01	3571016	3573358	A01p07880.2_BraZ1	1803.36	-	1126	2235	2342	0.9543126
A01	3576119	3579260	A01p07890.2_BraZ1	1979.44	+	1936	3074	3141	0.9786692
A01	3586853	3590981	A01p07900.2_BraZ1	2450.03	+	1904	3873	4128	0.9382268
A01	3594676	3595216	A01p07910.2_BraZ1	54	-	263	540	540	1.0000000
A01	3596591	3596775	A01p07920.2_BraZ1	108	-	0	0	184	0.0000000
A01	3597398	3599817	A01p07930.2_BraZ1	1034.73	+	557	2115	2419	0.8743283
A01	3604133	3606514	A01p07940.2_BraZ1	1926	+	1121	2381	2381	1.0000000
A01	3613671	3614082	A01p07950.2_BraZ1	237	-	452	411	411	1.0000000
A01	3616430	3617726	A01p07960.2_BraZ1	129.6	+	661	1296	1296	1.0000000
A01	3617972	3621226	A01p07970.2_BraZ1	2289.17	-	1660	3168	3254	0.9735710
A01	3625256	3625495	A01p07980.2_BraZ1	17.1	+	0	0	239	0.0000000
A01	3627667	3629035	A01p07990.2_BraZ1	136.8	-	837	1368	1368	1.0000000
A01	3633946	3634335	A01p08000.2_BraZ1	351	-	479	389	389	1.0000000
A01	3635662	3637686	A01p08010.2_BraZ1	1140.48	+	1278	2024	2024	1.0000000
A01	3639190	3642719	A01p08020.2_BraZ1	2360	+	1021	2852	3529	0.8081610
A01	3644072	3645424	A01p08030.2_BraZ1	3660.3	+	781	1321	1352	0.9770710
A01	3646353	3649234	A01p08040.2_BraZ1	3366.41	-	947	2881	2881	1.0000000
A01	3656179	3656527	A01p08050.2_BraZ1	34.8	+	93	334	348	0.9597701
A01	3658696	3662038	A01p08060.2_BraZ1	2256.44	+	1501	3270	3342	0.9784560
A01	3662585	3665054	A01p08070.2_BraZ1	5148	-	500	1934	2469	0.7833131
A01	3675815	3692262	A01p08080.2_BraZ1	3666.41	+	9560	14492	16447	0.8811333
A01	3700149	3701765	A01p08090.2_BraZ1	848.345	-	478	1580	1616	0.9777228
A01	3705586	3706550	A01p08100.2_BraZ1	645	-	543	964	964	1.0000000
A01	3707370	3711120	A01p08110.2_BraZ1	1054.17	+	2056	3290	3750	0.8773333
A01	3711418	3712561	A01p08120.2_BraZ1	1757.14	-	424	1143	1143	1.0000000
A01	3712827	3732907	A01p08130.2_BraZ1	553.136	+	2474	10087	20080	0.5023406
A01	3734075	3734279	A01p08140.2_BraZ1	20.4	+	310	204	204	1.0000000
A01	3737000	3740699	A01p08150.2_BraZ1	270.3	-	3	56	3699	0.0151392
A01	3740893	3742387	A01p08160.2_BraZ1	777	-	44	58	1494	0.0388220
A01	3745881	3753299	A01p08170.2_BraZ1	2623.69	+	3933	7296	7418	0.9835535
A01	3754223	3754745	A01p08180.2_BraZ1	52.2	-	203	522	522	1.0000000
A01	3755044	3757466	A01p08190.2_BraZ1	1114.32	+	969	2375	2422	0.9805946
A01	3757886	3758784	A01p08200.2_BraZ1	6552	+	851	898	898	1.0000000
A01	3759431	3761015	A01p08210.2_BraZ1	158.4	+	633	1551	1584	0.9791667
A01	3761204	3762329	A01p08220.2_BraZ1	966	-	232	978	1125	0.8693333
A01	3762538	3763912	A01p08230.2_BraZ1	570.952	+	1054	1297	1374	0.9439592
A01	3764605	3766461	A01p08240.2_BraZ1	996.146	+	1910	1856	1856	1.0000000
A01	3768078	3769756	A01p08250.2_BraZ1	16020	+	426	1577	1678	0.9398093
A01	3770410	3776369	A01p08260.2_BraZ1	2231.6	-	3767	5947	5959	0.9979863
A01	3784426	3785995	A01p08270.2_BraZ1	156.9	-	491	1504	1569	0.9585723
A01	3789709	3796197	A01p08280.2_BraZ1	1684.8	+	9502	6488	6488	1.0000000
A01	3794652	3795109	A01p08290.2_BraZ1	237	-	917	457	457	1.0000000
A01	3796515	3799633	A01p08300.2_BraZ1	1352.61	+	1620	3001	3118	0.9624760
A01	3801995	3802772	A01p08310.2_BraZ1	77.7	-	74	380	777	0.4890605
A01	3806099	3807725	A01p08320.2_BraZ1	162.6	+	142	1476	1626	0.9077491
A01	3819439	3819667	A01p08330.2_BraZ1	14.7	+	403	228	228	1.0000000
A01	3820855	3821167	A01p08340.2_BraZ1	31.2	-	262	312	312	1.0000000
A01	3824308	3825658	A01p08350.2_BraZ1	135	+	165	488	1350	0.3614815
A01	3826562	3827942	A01p08360.2_BraZ1	138	+	653	1318	1380	0.9550725
A01	3829779	3833391	A01p08370.2_BraZ1	1839.51	+	2391	3215	3612	0.8900886
A01	3833958	3834528	A01p08380.2_BraZ1	321	+	300	570	570	1.0000000
A01	3834983	3835565	A01p08390.2_BraZ1	58.2	+	201	582	582	1.0000000
A01	3838629	3840492	A01p08400.2_BraZ1	629.64	-	1170	1863	1863	1.0000000
A01	3844604	3846160	A01p08410.2_BraZ1	754.68	-	1123	1556	1556	1.0000000
A01	3853567	3855819	A01p08420.2_BraZ1	942	+	982	2072	2252	0.9200711
A01	3856503	3857265	A01p08430.2_BraZ1	330	-	1424	762	762	1.0000000
A01	3857648	3858703	A01p08440.2_BraZ1	1182.75	-	1125	1055	1055	1.0000000
A01	3861433	3864324	A01p08450.2_BraZ1	898.408	+	1868	2599	2891	0.8989969
A01	3864556	3866493	A01p08460.2_BraZ1	976.909	-	1327	1937	1937	1.0000000
A01	3866930	3870271	A01p08470.2_BraZ1	1302.36	-	2692	3280	3341	0.9817420
A01	3872542	3873151	A01p08480.2_BraZ1	369	+	478	609	609	1.0000000
A01	3873408	3873622	A01p08490.2_BraZ1	138	+	301	214	214	1.0000000
A01	3873909	3874648	A01p08500.2_BraZ1	591	+	313	739	739	1.0000000
A01	3875074	3876015	A01p08510.2_BraZ1	388.818	+	526	891	941	0.9468650
A01	3876726	3882975	A01p08520.2_BraZ1	1990.02	+	2042	5508	6249	0.8814210
A01	3884124	3887496	A01p08530.2_BraZ1	2155.78	+	1848	3082	3372	0.9139977
A01	3888043	3888896	A01p08540.2_BraZ1	385.244	-	263	822	853	0.9636577
A01	3889119	3890982	A01p08550.2_BraZ1	1338	+	575	1745	1863	0.9366613
A01	3891033	3893188	A01p08560.2_BraZ1	242.4	+	793	2011	2155	0.9331787
A01	3894434	3895950	A01p08570.2_BraZ1	891	-	642	1419	1516	0.9360158
A01	3896428	3897063	A01p08580.2_BraZ1	2184	+	210	635	635	1.0000000
A01	3897495	3904369	A01p08590.2_BraZ1	3404.17	-	521	4415	6874	0.6422752
A01	3906503	3911988	A01p08600.2_BraZ1	1694.22	-	2991	5485	5485	1.0000000
A01	3912193	3914990	A01p08610.2_BraZ1	1065	-	1365	2797	2797	1.0000000
A01	3913800	3914718	A01p08620.2_BraZ1	544	-	395	918	918	1.0000000
A01	3914990	3918660	A01p08630.2_BraZ1	570.857	-	2503	3670	3670	1.0000000
A01	3920535	3921187	A01p08640.2_BraZ1	435	-	16	369	652	0.5659509
A01	3922988	3924988	A01p08650.2_BraZ1	1350	+	711	1991	2000	0.9955000
A01	3925464	3926155	A01p08660.2_BraZ1	396	-	255	691	691	1.0000000
A01	3928220	3928913	A01p08670.2_BraZ1	312	+	702	693	693	1.0000000
A01	3929900	3930881	A01p08680.2_BraZ1	405	-	142	658	981	0.6707441
A01	3931840	3933675	A01p08690.2_BraZ1	614.583	-	999	1835	1835	1.0000000
A01	3940611	3943057	A01p08700.2_BraZ1	5525	+	753	2178	2446	0.8904334
A01	3948645	3948997	A01p08710.2_BraZ1	237	+	307	352	352	1.0000000
A01	3957608	3959274	A01p08720.2_BraZ1	441	+	641	1510	1666	0.9063625
A01	3964837	3965187	A01p08730.2_BraZ1	237	+	236	350	350	1.0000000
A01	3968046	3969538	A01p08740.2_BraZ1	4192	+	404	1429	1492	0.9577748
A01	3971017	3975761	A01p08750.2_BraZ1	1227.45	-	718	3519	4744	0.7417791
A01	3986111	3986724	A01p08760.2_BraZ1	540	-	87	469	613	0.7650898
A01	3988185	3990610	A01p08770.2_BraZ1	1480.17	+	134	1649	2425	0.6800000
A01	3990921	3993695	A01p08780.2_BraZ1	1762.75	-	1027	2673	2774	0.9635905
A01	4007210	4009060	A01p08790.2_BraZ1	1007.45	-	694	1376	1850	0.7437838
A01	4010399	4011557	A01p08800.2_BraZ1	625.547	-	818	1158	1158	1.0000000
A01	4020481	4022098	A01p08810.2_BraZ1	161.7	-	11	67	1617	0.0414348
A01	4033235	4033755	A01p08820.2_BraZ1	369	+	689	520	520	1.0000000
A01	4049110	4049492	A01p08830.2_BraZ1	219	-	1118	382	382	1.0000000
A01	4049880	4050021	A01p08840.2_BraZ1	14.1	-	523	141	141	1.0000000
A01	4057220	4061068	A01p08850.2_BraZ1	981.143	-	552	2975	3848	0.7731289
A01	4070536	4070834	A01p08860.2_BraZ1	15.9	-	606	298	298	1.0000000
A01	4082994	4084102	A01p08870.2_BraZ1	597	-	1233	1091	1108	0.9846570
A01	4094826	4096979	A01p08880.2_BraZ1	5040	+	458	1623	2153	0.7538319
A01	4097649	4105766	A01p08890.2_BraZ1	2976.06	-	2703	7558	8117	0.9311322
A01	4107724	4109923	A01p08900.2_BraZ1	1305.36	-	1693	2192	2199	0.9968168
A01	4111280	4119366	A01p08910.2_BraZ1	1005.76	-	2808	6943	8086	0.8586445
A01	4113802	4114138	A01p08920.2_BraZ1	33.6	-	275	336	336	1.0000000
A01	4121122	4121566	A01p08930.2_BraZ1	44.4	-	218	444	444	1.0000000
A01	4125254	4129550	A01p08940.2_BraZ1	2117.02	+	1130	3838	4296	0.8933892
A01	4130138	4137734	A01p08950.2_BraZ1	2798.85	-	4054	7135	7596	0.9393101
A01	4138411	4139641	A01p08960.2_BraZ1	488.25	-	968	1170	1230	0.9512195
A01	4140762	4146410	A01p08970.2_BraZ1	3996.79	-	1149	3857	5648	0.6828966
A01	4147875	4150219	A01p08980.2_BraZ1	913.5	-	506	2008	2344	0.8566553
A01	4159990	4160383	A01p08990.2_BraZ1	162	+	548	393	393	1.0000000
A01	4160408	4161752	A01p09000.2_BraZ1	1369.29	+	1009	1344	1344	1.0000000
A01	4163801	4165055	A01p09010.2_BraZ1	125.4	+	135	1048	1254	0.8357257
A01	4174313	4176693	A01p09020.2_BraZ1	1236.59	-	1385	2380	2380	1.0000000
A01	4177901	4179453	A01p09030.2_BraZ1	852.364	-	664	1385	1552	0.8923969
A01	4181312	4182997	A01p09040.2_BraZ1	526.5	-	331	1478	1685	0.8771513
A01	4189911	4191249	A01p09050.2_BraZ1	618.469	-	543	1317	1338	0.9843049
A01	4191545	4192767	A01p09060.2_BraZ1	447.015	+	976	1166	1222	0.9541735
A01	4192981	4199140	A01p09070.2_BraZ1	486.68	-	621	3387	6159	0.5499269
A01	4201322	4205557	A01p09080.2_BraZ1	481.152	-	474	2632	4235	0.6214876
A01	4207671	4209837	A01p09090.2_BraZ1	1002.24	-	568	2055	2166	0.9487535
A01	4214489	4216834	A01p09100.2_BraZ1	979.761	-	373	2064	2345	0.8801706
A01	4219416	4220823	A01p09110.2_BraZ1	702.436	+	894	1407	1407	1.0000000
A01	4221177	4225008	A01p09120.2_BraZ1	1699.75	-	2142	3759	3831	0.9812059
A01	4230120	4230923	A01p09130.2_BraZ1	422.609	+	697	803	803	1.0000000
A01	4231300	4232578	A01p09140.2_BraZ1	413.6	-	1336	1243	1278	0.9726135
A01	4238111	4239756	A01p09150.2_BraZ1	1404.34	-	654	1591	1645	0.9671733
A01	4257969	4259176	A01p09160.2_BraZ1	1113	-	221	1018	1207	0.8434134
A01	4259941	4273120	A01p09170.2_BraZ1	4437.86	-	5119	12191	13179	0.9250323
A01	4277827	4278285	A01p09180.2_BraZ1	342	-	156	458	458	1.0000000
A01	4280385	4281891	A01p09190.2_BraZ1	150.6	-	391	1222	1506	0.8114210
A01	4282585	4288377	A01p09200.2_BraZ1	1929.05	-	4052	5740	5792	0.9910221
A01	4292098	4294585	A01p09210.2_BraZ1	902.857	-	776	2250	2487	0.9047045
A01	4294783	4295623	A01p09220.2_BraZ1	3885	-	341	840	840	1.0000000
A01	4297866	4300982	A01p09230.2_BraZ1	3051	+	189	2213	3116	0.7102054
A01	4301375	4302690	A01p09240.2_BraZ1	712.5	-	573	1294	1315	0.9840304
A01	4304103	4306772	A01p09250.2_BraZ1	2197.89	+	1514	2648	2669	0.9921319
A01	4307839	4309755	A01p09260.2_BraZ1	1198.75	+	1136	1916	1916	1.0000000
A01	4310211	4312650	A01p09270.2_BraZ1	2214	-	695	2323	2439	0.9524395
A01	4317547	4320082	A01p09280.2_BraZ1	837.857	+	294	1688	2535	0.6658777
A01	4321341	4325181	A01p09290.2_BraZ1	140.7	-	123	1652	3840	0.4302083
A01	4327123	4328449	A01p09300.2_BraZ1	132.6	+	601	1326	1326	1.0000000
A01	4334864	4337677	A01p09310.2_BraZ1	1391.68	-	898	2764	2813	0.9825809
A01	4364303	4367622	A01p09320.2_BraZ1	1035	+	1419	2973	3319	0.8957517
A01	4371236	4373238	A01p09330.2_BraZ1	2805	-	270	1583	2002	0.7907093
A01	4374139	4375940	A01p09340.2_BraZ1	704.512	+	777	1650	1801	0.9161577
A01	4376417	4378734	A01p09350.2_BraZ1	868.25	-	769	1789	2317	0.7721191
A01	4381443	4384525	A01p09360.2_BraZ1	38961	-	781	2926	3082	0.9493835
A01	4386541	4387227	A01p09370.2_BraZ1	603	+	193	686	686	1.0000000
A01	4387373	4389040	A01p09380.2_BraZ1	953.1	-	669	1597	1667	0.9580084
A01	4389375	4394742	A01p09390.2_BraZ1	2552.88	+	506	3744	5367	0.6975964
A01	4395400	4395622	A01p09400.2_BraZ1	22.2	-	210	222	222	1.0000000
A01	4398900	4400078	A01p09410.2_BraZ1	6132	-	641	1178	1178	1.0000000
A01	4400381	4404779	A01p09420.2_BraZ1	1822.97	-	2172	4267	4398	0.9702137
A01	4409018	4409361	A01p09430.2_BraZ1	162	-	1	22	343	0.0641399
A01	4410681	4412259	A01p09440.2_BraZ1	651.6	-	566	1486	1578	0.9416984
A01	4542971	4543355	A01p09450.2_BraZ1	37.5	+	364	384	384	1.0000000
A01	4543683	4545140	A01p09460.2_BraZ1	2225.36	-	121	1128	1457	0.7741935
A01	4547457	4548390	A01p09470.2_BraZ1	93.3	-	125	902	933	0.9667739
A01	4556404	4557127	A01p09480.2_BraZ1	72.3	+	69	593	723	0.8201936
A01	4557768	4559219	A01p09490.2_BraZ1	667.545	-	336	1053	1451	0.7257064
A01	4559775	4561437	A01p09500.2_BraZ1	1024.48	+	749	1662	1662	1.0000000
A01	4561863	4563668	A01p09510.2_BraZ1	588.194	-	1167	1805	1805	1.0000000
A01	4564266	4565882	A01p09520.2_BraZ1	861.091	+	895	1615	1616	0.9993812
A01	4566092	4567773	A01p09530.2_BraZ1	5638.5	-	390	1623	1681	0.9654967
A01	4572137	4573798	A01p09540.2_BraZ1	1131	-	1488	1661	1661	1.0000000
A01	4575198	4575705	A01p09550.2_BraZ1	429	-	71	486	507	0.9585799
A01	4580805	4583255	A01p09560.2_BraZ1	1451.24	-	782	2340	2450	0.9551020
A01	4587898	4590909	A01p09570.2_BraZ1	2370	-	739	2633	3011	0.8744603
A01	4591953	4600734	A01p09580.2_BraZ1	5049.39	-	2800	7840	8781	0.8928368
A01	4608528	4610550	A01p09590.2_BraZ1	622.347	+	418	1820	2022	0.9000989
A01	4611815	4615012	A01p09600.2_BraZ1	1412.65	+	2035	2941	3197	0.9199249
A01	4615549	4616973	A01p09610.2_BraZ1	671.278	+	1039	1424	1424	1.0000000
A01	4617672	4618659	A01p09620.2_BraZ1	738.095	+	518	987	987	1.0000000
A01	4621471	4622114	A01p09630.2_BraZ1	459	-	622	643	643	1.0000000
A01	4636996	4638543	A01p09640.2_BraZ1	129.9	+	293	1462	1547	0.9450549
A01	4641401	4641937	A01p09650.2_BraZ1	2700	+	753	536	536	1.0000000
A01	4644415	4646423	A01p09660.2_BraZ1	43.8	-	1695	1985	2008	0.9885458
A01	4647554	4648610	A01p09670.2_BraZ1	105.6	+	236	243	1056	0.2301136
A01	4649836	4652408	A01p09680.2_BraZ1	896.318	-	65	1002	2572	0.3895801
A01	4663439	4663682	A01p09690.2_BraZ1	24.3	-	131	243	243	1.0000000
A01	4664675	4665859	A01p09700.2_BraZ1	909	-	229	1184	1184	1.0000000
A01	4667090	4668552	A01p09710.2_BraZ1	830.413	+	518	1458	1462	0.9972640
A01	4669158	4670561	A01p09720.2_BraZ1	1299	-	238	1100	1403	0.7840342
A01	4673939	4675847	A01p09730.2_BraZ1	190.8	-	239	884	1908	0.4633124
A01	4678363	4679951	A01p09740.2_BraZ1	1022.07	-	49	712	1588	0.4483627
A01	4688924	4689953	A01p09750.2_BraZ1	774	+	163	785	1029	0.7628766
A01	4693212	4694094	A01p09760.2_BraZ1	88.2	-	5	39	882	0.0442177
A01	4723133	4723742	A01p09770.2_BraZ1	60.9	+	1	57	609	0.0935961
A01	4729962	4732292	A01p09780.2_BraZ1	999.888	+	895	2277	2330	0.9772532
A01	4732471	4734082	A01p09790.2_BraZ1	1151.61	-	330	1486	1611	0.9224085
A01	4738102	4739036	A01p09800.2_BraZ1	629	+	315	934	934	1.0000000
A01	4743266	4746273	A01p09810.2_BraZ1	513.4	+	238	1866	3007	0.6205521
A01	4748325	4748678	A01p09820.2_BraZ1	189	-	272	353	353	1.0000000
A01	4750483	4751187	A01p09830.2_BraZ1	57.9	+	63	693	704	0.9843750
A01	4753407	4753810	A01p09840.2_BraZ1	288	-	335	290	403	0.7196030
A01	4760573	4762346	A01p09850.2_BraZ1	177.3	-	48	1031	1773	0.5815003
A01	4765250	4767527	A01p09860.2_BraZ1	1056	+	1204	2277	2277	1.0000000
A01	4776112	4777769	A01p09870.2_BraZ1	2622	+	668	1652	1657	0.9969825
A01	4781172	4782102	A01p09880.2_BraZ1	92.1	-	31	330	930	0.3548387
A01	4785722	4786607	A01p09890.2_BraZ1	88.5	-	33	476	885	0.5378531
A01	4788742	4789599	A01p09900.2_BraZ1	680.87	+	458	857	857	1.0000000
A01	4790114	4791648	A01p09910.2_BraZ1	1134.98	-	765	1532	1534	0.9986962
A01	4794909	4796053	A01p09920.2_BraZ1	480	+	994	1144	1144	1.0000000
A01	4800556	4801729	A01p09930.2_BraZ1	879	-	28	355	1173	0.3026428
A01	4807621	4807912	A01p09940.2_BraZ1	29.1	+	310	291	291	1.0000000
A01	4807957	4808125	A01p09950.2_BraZ1	16.8	+	175	168	168	1.0000000
A01	4808874	4811461	A01p09960.2_BraZ1	1232.94	-	840	2465	2587	0.9528411
A01	4815265	4815597	A01p09970.2_BraZ1	117	+	0	0	332	0.0000000
A01	4815504	4816367	A01p09980.2_BraZ1	392.7	+	1	7	863	0.0081112
A01	4817840	4820649	A01p09990.2_BraZ1	1565.2	-	988	2739	2809	0.9750801
A01	4836981	4839651	A01p10000.2_BraZ1	1382.06	-	642	2193	2670	0.8213483
A01	4849828	4852970	A01p10010.2_BraZ1	1726.68	-	1237	2931	3142	0.9328453
A01	4854472	4855584	A01p10020.2_BraZ1	672.065	-	744	1112	1112	1.0000000
A01	4856364	4856985	A01p10030.2_BraZ1	402	-	165	566	621	0.9114332
A01	4858628	4861322	A01p10040.2_BraZ1	1784.37	+	920	2603	2694	0.9662212
A01	4861614	4865132	A01p10050.2_BraZ1	3266.05	-	1259	3206	3518	0.9113132
A01	4867886	4871294	A01p10060.2_BraZ1	1823.76	+	1865	3366	3408	0.9876761
A01	4873067	4874822	A01p10070.2_BraZ1	6888	+	68	1316	1755	0.7498575
A01	4875525	4875872	A01p10080.2_BraZ1	252	+	252	347	347	1.0000000
A01	4889899	4891049	A01p10090.2_BraZ1	933	+	74	922	1150	0.8017392
A01	4899069	4901382	A01p10100.2_BraZ1	774	+	563	2123	2313	0.9178556
A01	4902114	4903299	A01p10110.2_BraZ1	1113	+	465	798	1185	0.6734177
A01	4903824	4906516	A01p10120.2_BraZ1	1138.5	+	890	2472	2692	0.9182764
A01	4906856	4907947	A01p10130.2_BraZ1	711.779	-	1040	1091	1091	1.0000000
A01	4914736	4922203	A01p10140.2_BraZ1	1962.15	+	951	5078	7467	0.6800589
A01	4922942	4925902	A01p10150.2_BraZ1	3049.8	-	3178	2960	2960	1.0000000
A01	4927808	4930108	A01p10160.2_BraZ1	276	-	2720	2272	2300	0.9878261
A01	4941054	4941367	A01p10170.2_BraZ1	240	-	109	275	313	0.8785942
A01	4951297	4954327	A01p10180.2_BraZ1	1887.99	+	983	2985	3030	0.9851485
A01	4954804	4955320	A01p10190.2_BraZ1	51.6	+	253	516	516	1.0000000
A01	4956298	4958079	A01p10200.2_BraZ1	1134.21	-	143	789	1781	0.4430096
A01	4969751	4970497	A01p10210.2_BraZ1	183	+	820	746	746	1.0000000
A01	4984188	4985934	A01p10220.2_BraZ1	174.6	+	117	602	1746	0.3447881
A01	4986827	4987612	A01p10230.2_BraZ1	70.8	-	2259	785	785	1.0000000
A01	4991554	4993717	A01p10240.2_BraZ1	1049.97	-	1907	2163	2163	1.0000000
A01	4996977	4998435	A01p10250.2_BraZ1	807.72	+	1522	1458	1458	1.0000000
A01	4998597	4998939	A01p10260.2_BraZ1	34.2	-	132	329	342	0.9619883
A01	5000100	5002359	A01p10270.2_BraZ1	8687.6	+	1331	2250	2259	0.9960160
A01	5006385	5007516	A01p10280.2_BraZ1	113.1	+	121	988	1131	0.8735632
A01	5013184	5014255	A01p10290.2_BraZ1	107.1	-	127	1065	1071	0.9943978
A01	5020808	5020997	A01p10300.2_BraZ1	18.9	+	305	189	189	1.0000000
A01	5021165	5022032	A01p10310.2_BraZ1	306	-	523	867	867	1.0000000
A01	5026425	5028198	A01p10320.2_BraZ1	1053	-	750	1075	1773	0.6063170
A01	5028401	5028638	A01p10330.2_BraZ1	23.7	+	62	237	237	1.0000000
A01	5029005	5029251	A01p10340.2_BraZ1	24.6	-	1	50	246	0.2032520
A01	5030835	5031234	A01p10350.2_BraZ1	39.9	-	269	399	399	1.0000000
A01	5032269	5032944	A01p10360.2_BraZ1	67.5	-	73	475	675	0.7037037
A01	5035570	5036781	A01p10370.2_BraZ1	4905	-	61	622	1211	0.5136251
A01	5038286	5041823	A01p10380.2_BraZ1	2112.86	-	2099	3537	3537	1.0000000
A01	5051803	5054209	A01p10390.2_BraZ1	1164.3	+	1014	2138	2406	0.8886118
A01	5054492	5055567	A01p10400.2_BraZ1	458.28	-	121	974	1075	0.9060465
A01	5055849	5060351	A01p10410.2_BraZ1	1826.59	+	3745	4501	4502	0.9997779
A01	5060641	5062122	A01p10420.2_BraZ1	1060	-	297	1262	1481	0.8521270
A01	5064986	5069349	A01p10430.2_BraZ1	784	-	2027	4160	4363	0.9534724
A01	5069961	5071522	A01p10440.2_BraZ1	1314	-	404	1497	1561	0.9590006
A01	5071564	5071711	A01p10450.2_BraZ1	14.7	+	91	147	147	1.0000000
A01	5074494	5075431	A01p10460.2_BraZ1	399	+	476	937	937	1.0000000
A01	5079998	5086018	A01p10470.2_BraZ1	1376.64	+	3775	6017	6020	0.9995016
A01	5087756	5091854	A01p10480.2_BraZ1	2229.34	+	2052	4010	4098	0.9785261
A01	5092065	5099708	A01p10490.2_BraZ1	366	+	1888	5795	7643	0.7582101
A01	5100961	5104951	A01p10500.2_BraZ1	1438.5	+	1485	3272	3990	0.8200501
A01	5102066	5102720	A01p10510.2_BraZ1	291	-	538	308	654	0.4709480
A01	5109672	5109909	A01p10520.2_BraZ1	23.7	+	9	114	237	0.4810127
A01	5115384	5116957	A01p10530.2_BraZ1	551.25	-	894	1573	1573	1.0000000
A01	5117840	5119953	A01p10540.2_BraZ1	1089.7	+	857	2067	2113	0.9782300
A01	5123626	5125500	A01p10550.2_BraZ1	15675	-	332	1804	1874	0.9626467
A01	5128586	5131054	A01p10560.2_BraZ1	1106.77	-	890	1773	2468	0.7183955
A01	5136436	5139258	A01p10570.2_BraZ1	1756.02	+	581	2584	2822	0.9156626
A01	5139537	5140335	A01p10580.2_BraZ1	393.75	-	645	798	798	1.0000000
A01	5141323	5143965	A01p10590.2_BraZ1	1240.31	+	1819	2567	2642	0.9716124
A01	5144397	5144970	A01p10600.2_BraZ1	57.3	+	32	573	573	1.0000000
A01	5145373	5153056	A01p10610.2_BraZ1	6250.25	-	626	4354	7683	0.5667057
A01	5156988	5157579	A01p10620.2_BraZ1	59.1	+	39	298	591	0.5042301
A01	5158402	5164335	A01p10630.2_BraZ1	1449	-	5854	5932	5933	0.9998314
A01	5169280	5169781	A01p10640.2_BraZ1	50.1	+	39	131	501	0.2614771
A01	5172773	5174322	A01p10650.2_BraZ1	1431	+	153	1121	1549	0.7236927
A01	5175921	5178877	A01p10660.2_BraZ1	1983	+	255	1770	2956	0.5987821
A01	5181706	5182704	A01p10670.2_BraZ1	720	-	43	582	998	0.5831664
A01	5191085	5193303	A01p10680.2_BraZ1	840	+	1197	1928	2218	0.8692515
A01	5197646	5200079	A01p10690.2_BraZ1	243.3	-	1395	1445	2433	0.5939170
A01	5201640	5202817	A01p10700.2_BraZ1	323	+	899	1177	1177	1.0000000
A01	5205337	5206822	A01p10710.2_BraZ1	148.5	-	228	1396	1485	0.9400674
A01	5212761	5214395	A01p10720.2_BraZ1	1075.55	+	985	1634	1634	1.0000000
A01	5215301	5216232	A01p10730.2_BraZ1	608.114	+	663	931	931	1.0000000
A01	5216470	5217366	A01p10740.2_BraZ1	728.85	-	1104	896	896	1.0000000
A01	5217655	5220265	A01p10750.2_BraZ1	261	+	701	2571	2610	0.9850575
A01	5225295	5227021	A01p10760.2_BraZ1	1305	+	1093	1726	1726	1.0000000
A01	5228189	5229434	A01p10770.2_BraZ1	124.5	-	266	768	1245	0.6168675
A01	5231433	5232948	A01p10780.2_BraZ1	1593.43	-	1086	1515	1515	1.0000000
A01	5234428	5235298	A01p10790.2_BraZ1	645	-	244	870	870	1.0000000
A01	5241778	5242918	A01p10800.2_BraZ1	114	-	393	804	1140	0.7052631
A01	5308505	5309243	A01p10810.2_BraZ1	73.8	-	761	738	738	1.0000000
A01	5309475	5312714	A01p10820.2_BraZ1	1565.55	-	1015	3169	3239	0.9783884
A01	5317635	5321619	A01p10830.2_BraZ1	2853.55	+	1323	3804	3984	0.9548193
A01	5323727	5324711	A01p10840.2_BraZ1	98.4	+	449	984	984	1.0000000
A01	5324858	5326505	A01p10850.2_BraZ1	1608	-	893	1546	1647	0.9386764
A01	5328468	5328663	A01p10860.2_BraZ1	19.5	+	135	195	195	1.0000000
A01	5329981	5330617	A01p10870.2_BraZ1	108	+	553	636	636	1.0000000
A01	5330647	5331612	A01p10880.2_BraZ1	1935	-	902	965	965	1.0000000
A01	5333293	5335602	A01p10890.2_BraZ1	1554	-	1838	2252	2309	0.9753140
A01	5345302	5347884	A01p10900.2_BraZ1	5401.5	+	819	2223	2582	0.8609605
A01	5349784	5352470	A01p10910.2_BraZ1	1242.53	+	2153	2558	2686	0.9523455
A01	5357825	5359881	A01p10920.2_BraZ1	834.4	+	634	2029	2056	0.9868677
A01	5360608	5365138	A01p10930.2_BraZ1	901.607	+	1282	4169	4530	0.9203091
A01	5366376	5366815	A01p10940.2_BraZ1	357	-	0	0	439	0.0000000
A01	5369514	5371826	A01p10950.2_BraZ1	1279.8	+	644	2166	2312	0.9368512
A01	5376511	5381159	A01p10960.2_BraZ1	686.171	+	3629	4630	4648	0.9961274
A01	5384021	5385453	A01p10970.2_BraZ1	808.783	-	855	1353	1432	0.9448324
A01	5389469	5389808	A01p10980.2_BraZ1	33.9	+	31	266	339	0.7846608
A01	5390783	5392922	A01p10990.2_BraZ1	938.667	-	214	1797	2139	0.8401122
A01	5395694	5398092	A01p11000.2_BraZ1	1421.4	-	666	2384	2398	0.9941618
A01	5401588	5407406	A01p11010.2_BraZ1	3233.99	+	635	3496	5818	0.6008938
A01	5408206	5413709	A01p11020.2_BraZ1	2050.68	-	1732	5112	5503	0.9289479
A01	5415128	5418671	A01p11030.2_BraZ1	3459	-	726	3218	3543	0.9082698
A01	5420171	5421308	A01p11040.2_BraZ1	113.7	-	385	1101	1137	0.9683377
A01	5423815	5426176	A01p11050.2_BraZ1	1721.51	-	552	2294	2361	0.9716222
A01	5431721	5433044	A01p11060.2_BraZ1	744.926	+	741	1323	1323	1.0000000
A01	5433241	5434434	A01p11070.2_BraZ1	8316	-	1033	1193	1193	1.0000000
A01	5444052	5444590	A01p11080.2_BraZ1	441	-	90	259	538	0.4814126
A01	5445402	5447398	A01p11090.2_BraZ1	1135.54	+	778	1883	1996	0.9433868
A01	5449610	5451401	A01p11100.2_BraZ1	179.1	+	188	1682	1791	0.9391401
A01	5455772	5458058	A01p11110.2_BraZ1	2208	-	960	2286	2286	1.0000000
A01	5459254	5461763	A01p11120.2_BraZ1	1114.35	-	1278	2198	2509	0.8760462
A01	5462077	5464602	A01p11130.2_BraZ1	1622.77	+	880	2204	2525	0.8728713
A01	5469013	5470094	A01p11140.2_BraZ1	153.616	+	628	1050	1081	0.9713228
A01	5470578	5473278	A01p11150.2_BraZ1	1329.07	-	1982	2579	2700	0.9551852
A01	5474281	5475384	A01p11160.2_BraZ1	849.391	+	504	1065	1103	0.9655485
A01	5477216	5479654	A01p11170.2_BraZ1	1396.6	+	1192	2422	2438	0.9934372
A01	5499699	5501802	A01p11180.2_BraZ1	1293.75	+	410	1992	2103	0.9472182
A01	5505852	5507421	A01p11190.2_BraZ1	521.844	-	862	1569	1569	1.0000000
A01	5507586	5509044	A01p11200.2_BraZ1	2993.25	+	205	990	1458	0.6790124
A01	5512904	5513440	A01p11210.2_BraZ1	332.481	+	254	536	536	1.0000000
A01	5517671	5519110	A01p11220.2_BraZ1	986.4	+	87	1096	1439	0.7616400
A01	5521487	5523490	A01p11230.2_BraZ1	685	+	150	1369	2003	0.6834748
A01	5531984	5533419	A01p11240.2_BraZ1	1022.5	+	71	462	1435	0.3219512
A01	5535552	5536311	A01p11250.2_BraZ1	3633	+	181	643	759	0.8471673
A01	5538586	5539819	A01p11260.2_BraZ1	651	-	136	348	1233	0.2822385
A01	5540510	5546558	A01p11270.2_BraZ1	2265.65	-	2606	5316	6048	0.8789682
A01	5552696	5554107	A01p11280.2_BraZ1	722.812	-	746	1369	1411	0.9702339
A01	5559040	5559202	A01p11290.2_BraZ1	16.2	+	130	162	162	1.0000000
A01	5561500	5566711	A01p11300.2_BraZ1	1238.4	-	2101	4607	5211	0.8840913
A01	5570820	5577968	A01p11310.2_BraZ1	909.63	-	4279	6490	7148	0.9079463
A01	5591415	5591796	A01p11320.2_BraZ1	38.1	-	498	381	381	1.0000000
A01	5597526	5597804	A01p11330.2_BraZ1	183	+	0	0	278	0.0000000
A01	5598082	5598611	A01p11340.2_BraZ1	42.6	-	0	0	529	0.0000000
A01	5598740	5599327	A01p11350.2_BraZ1	54.3	+	4	246	587	0.4190801
A01	5601133	5601742	A01p11360.2_BraZ1	60.9	-	80	228	609	0.3743842
A01	5605508	5605790	A01p11370.2_BraZ1	26.7	-	287	282	282	1.0000000
A01	5610568	5610907	A01p11380.2_BraZ1	33.9	-	0	0	339	0.0000000
A01	5614982	5618965	A01p11390.2_BraZ1	1893.67	+	580	2863	3983	0.7188049
A01	5619498	5621061	A01p11400.2_BraZ1	156.3	-	154	979	1563	0.6263596
A01	5627927	5632903	A01p11410.2_BraZ1	3511.2	+	1577	3730	4976	0.7495981
A01	5633372	5633683	A01p11420.2_BraZ1	237	+	30	198	311	0.6366559
A01	5633931	5634220	A01p11430.2_BraZ1	19.2	+	135	289	289	1.0000000
A01	5634231	5640726	A01p11440.2_BraZ1	2882.77	+	3689	6246	6495	0.9616628
A01	5641555	5643144	A01p11450.2_BraZ1	893.793	+	1357	1589	1589	1.0000000
A01	5644086	5646290	A01p11460.2_BraZ1	1215.31	+	1711	2204	2204	1.0000000
A01	5648166	5653129	A01p11470.2_BraZ1	2169	+	5089	4820	4963	0.9711868
A01	5654150	5661674	A01p11480.2_BraZ1	2563.78	+	2908	7369	7524	0.9793993
A01	5662953	5663535	A01p11490.2_BraZ1	498	-	289	582	582	1.0000000
A01	5666747	5667482	A01p11500.2_BraZ1	189	+	394	735	735	1.0000000
A01	5668758	5671356	A01p11510.2_BraZ1	705.25	-	1051	1576	2598	0.6066205
A01	5674906	5676680	A01p11520.2_BraZ1	930	-	879	1774	1774	1.0000000
A01	5678226	5679593	A01p11530.2_BraZ1	586.577	-	343	1299	1367	0.9502560
A01	5681362	5682730	A01p11540.2_BraZ1	801.217	-	511	1289	1368	0.9422514
A01	5687406	5688075	A01p11550.2_BraZ1	501	-	554	669	669	1.0000000
A01	5688289	5689302	A01p11560.2_BraZ1	111	+	802	1013	1013	1.0000000
A01	5689494	5691261	A01p11570.2_BraZ1	176.7	+	456	1686	1767	0.9541596
A01	5691789	5694615	A01p11580.2_BraZ1	1831.93	-	1421	2810	2826	0.9943383
A01	5696474	5698476	A01p11590.2_BraZ1	1664.57	-	559	1920	2002	0.9590409
A01	5699821	5702189	A01p11600.2_BraZ1	1626	-	848	2312	2368	0.9763514
A01	5704938	5706211	A01p11610.2_BraZ1	5169.6	+	59	538	1273	0.4226237
A01	5715075	5716292	A01p11620.2_BraZ1	15570	+	471	1217	1217	1.0000000
A01	5718894	5721000	A01p11630.2_BraZ1	927.273	+	1035	1879	2106	0.8922127
A01	5726848	5727121	A01p11640.2_BraZ1	27.3	+	87	273	273	1.0000000
A01	5730561	5731833	A01p11650.2_BraZ1	991.667	+	103	517	1272	0.4064465
A01	5733975	5734125	A01p11660.2_BraZ1	15	+	52	150	150	1.0000000
A01	5740878	5741906	A01p11670.2_BraZ1	891	-	205	933	1028	0.9075875
A01	5773569	5778143	A01p11680.2_BraZ1	2024	+	807	3887	4574	0.8498032
A01	5780426	5782803	A01p11690.2_BraZ1	1140	-	886	2338	2377	0.9835927
A01	5794367	5796002	A01p11700.2_BraZ1	612.72	+	1931	1635	1635	1.0000000
A01	5797862	5798515	A01p11710.2_BraZ1	656.25	+	90	414	653	0.6339970
A01	5799854	5802279	A01p11720.2_BraZ1	1496.73	-	1350	2425	2425	1.0000000
A01	5803991	5813420	A01p11730.2_BraZ1	6322.22	-	550	3833	9429	0.4065118
A01	5814774	5816877	A01p11740.2_BraZ1	210.3	-	636	1993	2103	0.9476938
A01	5823902	5827126	A01p11750.2_BraZ1	2366.41	+	369	2714	3224	0.8418114
A01	5828567	5831039	A01p11760.2_BraZ1	1119	+	910	2074	2472	0.8389968
A01	5834585	5834966	A01p11770.2_BraZ1	38.1	-	503	381	381	1.0000000
A01	5839596	5840779	A01p11780.2_BraZ1	762.72	-	1325	1183	1183	1.0000000
A01	5841689	5844186	A01p11790.2_BraZ1	1926.42	+	1040	2496	2497	0.9995995
A01	5849403	5850024	A01p11800.2_BraZ1	62.1	+	698	621	621	1.0000000
A01	5853494	5855564	A01p11810.2_BraZ1	1152	-	625	1646	2070	0.7951691
A01	5855841	5856728	A01p11820.2_BraZ1	481.667	+	1040	887	887	1.0000000
A01	5856818	5858430	A01p11830.2_BraZ1	1499.18	-	594	1490	1612	0.9243176
A01	5860288	5862584	A01p11840.2_BraZ1	854	-	1061	2271	2296	0.9891115
A01	5866267	5870554	A01p11850.2_BraZ1	3252.93	-	4395	4287	4287	1.0000000
A01	5872373	5874314	A01p11860.2_BraZ1	194.1	-	711	1638	1941	0.8438949
A01	5881592	5884537	A01p11870.2_BraZ1	1732.25	+	1408	2568	2945	0.8719864
A01	5887874	5891877	A01p11880.2_BraZ1	3765	+	1561	3930	4003	0.9817637
A01	5893361	5893687	A01p11890.2_BraZ1	249	-	257	326	326	1.0000000
A01	5896532	5900767	A01p11900.2_BraZ1	3051	+	1397	3541	4235	0.8361275
A01	5902857	5904936	A01p11910.2_BraZ1	1497	+	522	1955	2079	0.9403560
A01	5907310	5908486	A01p11920.2_BraZ1	117.6	-	375	1153	1176	0.9804422
A01	5909316	5912360	A01p11930.2_BraZ1	1518	-	1776	3044	3044	1.0000000
A01	5919838	5922578	A01p11940.2_BraZ1	1390.95	-	1165	2560	2740	0.9343066
A01	5929855	5931552	A01p11950.2_BraZ1	717.5	+	391	1477	1697	0.8703595
A01	5939555	5944159	A01p11960.2_BraZ1	18373	+	624	3169	4604	0.6883145
A01	5947142	5948146	A01p11970.2_BraZ1	366.275	-	339	554	1004	0.5517928
A01	5953897	5959224	A01p11980.2_BraZ1	1108.38	+	1920	5180	5327	0.9724047
A01	5959878	5961865	A01p11990.2_BraZ1	1492.73	+	878	1933	1987	0.9728234
A01	5965480	5975385	A01p12000.2_BraZ1	10651.6	-	3207	8330	9905	0.8409894
A01	5995534	5999337	A01p12010.2_BraZ1	1696.6	+	1254	3706	3803	0.9744938
A01	6000360	6007810	A01p12020.2_BraZ1	1336.8	+	5513	7079	7450	0.9502013
A01	6004457	6004971	A01p12030.2_BraZ1	243	-	479	514	514	1.0000000
A01	6004601	6005281	A01p12040.2_BraZ1	291	-	341	556	680	0.8176470
A01	6008067	6009483	A01p12050.2_BraZ1	141.3	+	174	918	1416	0.6483051
A01	6010848	6013037	A01p12060.2_BraZ1	733.227	+	1603	2189	2189	1.0000000
A01	6013217	6015273	A01p12070.2_BraZ1	567.039	-	1957	2056	2056	1.0000000
A01	6017130	6018307	A01p12080.2_BraZ1	1062.4	+	1168	1177	1177	1.0000000
A01	6019723	6024326	A01p12090.2_BraZ1	2805.24	+	997	4027	4603	0.8748642
A01	6024842	6027199	A01p12100.2_BraZ1	785.543	-	1634	2357	2357	1.0000000
A01	6027734	6028154	A01p12110.2_BraZ1	42	+	589	420	420	1.0000000
A01	6028319	6031763	A01p12120.2_BraZ1	2445.22	-	706	2533	3444	0.7354820
A01	6033921	6034626	A01p12130.2_BraZ1	603	-	133	605	705	0.8581560
A01	6035819	6037691	A01p12140.2_BraZ1	1197.24	-	630	1835	1872	0.9802350
A01	6042637	6044881	A01p12150.2_BraZ1	224.4	+	301	1554	2244	0.6925133
A01	6048118	6049546	A01p12160.2_BraZ1	903.314	+	751	1428	1428	1.0000000
A01	6049734	6052044	A01p12170.2_BraZ1	231	-	1269	2118	2310	0.9168831
A01	6054213	6054751	A01p12180.2_BraZ1	46.8	-	346	538	538	1.0000000
A01	6055826	6057228	A01p12190.2_BraZ1	335.625	-	879	1402	1402	1.0000000
A01	6063117	6064739	A01p12200.2_BraZ1	1545	-	405	1386	1622	0.8545006
A01	6067116	6068700	A01p12210.2_BraZ1	158.4	+	16	549	1584	0.3465909
A01	6069511	6071098	A01p12220.2_BraZ1	158.1	+	735	1445	1587	0.9105230
A01	6072083	6073745	A01p12230.2_BraZ1	860.444	-	50	641	1662	0.3856799
A01	6076994	6078602	A01p12240.2_BraZ1	160.8	+	218	1248	1608	0.7761194
A01	6079603	6080429	A01p12250.2_BraZ1	332.75	+	136	763	826	0.9237288
A01	6084918	6087011	A01p12260.2_BraZ1	8535	+	989	2084	2093	0.9956999
A01	6088951	6089677	A01p12270.2_BraZ1	72.6	+	11	264	726	0.3636364
A01	6096477	6098784	A01p12280.2_BraZ1	1734	+	534	1485	2307	0.6436931
A01	6101308	6110049	A01p12290.2_BraZ1	3951.83	-	4191	8324	8741	0.9522938
A01	6114875	6116487	A01p12300.2_BraZ1	156.9	+	79	824	1612	0.5111663
A01	6119489	6120937	A01p12310.2_BraZ1	652.68	-	717	1346	1448	0.9295580
A01	6125231	6126431	A01p12320.2_BraZ1	120	-	602	1200	1200	1.0000000
A01	6128786	6130306	A01p12330.2_BraZ1	1347.77	+	686	1506	1520	0.9907895
A01	6130839	6142607	A01p12340.2_BraZ1	4635.71	-	5824	11517	11768	0.9786710
A01	6145129	6149077	A01p12350.2_BraZ1	1590.48	+	766	3498	3948	0.8860182
A01	6155007	6156978	A01p12360.2_BraZ1	477.143	+	1746	1971	1971	1.0000000
A01	6159613	6160888	A01p12370.2_BraZ1	127.5	+	1120	1275	1275	1.0000000
A01	6162053	6163285	A01p12380.2_BraZ1	795	+	317	1116	1232	0.9058442
A01	6165460	6186112	A01p12390.2_BraZ1	1788.6	+	16908	19363	20652	0.9375848
A01	6191270	6191561	A01p12400.2_BraZ1	22.8	+	1	48	291	0.1649484
A01	6193262	6193612	A01p12410.2_BraZ1	17.7	-	4	127	350	0.3628571
A01	6194276	6194760	A01p12420.2_BraZ1	372	+	450	484	484	1.0000000
A01	6195067	6198928	A01p12430.2_BraZ1	1843.12	+	1732	3568	3861	0.9241129
A01	6199907	6206533	A01p12440.2_BraZ1	3800.08	+	4578	6274	6626	0.9468759
A01	6206947	6208339	A01p12450.2_BraZ1	596.154	-	1276	1392	1392	1.0000000
A01	6209903	6210436	A01p12460.2_BraZ1	252	+	281	533	533	1.0000000
A01	6211128	6212725	A01p12470.2_BraZ1	156.6	-	442	1450	1597	0.9079524
A01	6219366	6220394	A01p12480.2_BraZ1	428.045	+	631	1028	1028	1.0000000
A01	6221362	6222094	A01p12490.2_BraZ1	73.2	-	421	732	732	1.0000000
A01	6223181	6233922	A01p12500.2_BraZ1	321.9	+	3655	9880	10741	0.9198399
A01	6234032	6235754	A01p12510.2_BraZ1	172.2	-	484	1539	1722	0.8937282
A01	6236552	6239260	A01p12520.2_BraZ1	1526.97	+	1027	2634	2708	0.9726735
A01	6239548	6245647	A01p12530.2_BraZ1	679.286	-	1924	4916	6099	0.8060338
A01	6250369	6254542	A01p12540.2_BraZ1	972.783	+	1299	3506	4173	0.8401629
A01	6255248	6256810	A01p12550.2_BraZ1	1191	+	145	1151	1562	0.7368758
A01	6258445	6260954	A01p12560.2_BraZ1	799.333	-	507	1990	2509	0.7931447
A01	6265694	6268182	A01p12570.2_BraZ1	1083.75	-	1719	2488	2488	1.0000000
A01	6269733	6271314	A01p12580.2_BraZ1	1347	+	145	948	1581	0.5996205
A01	6272022	6272868	A01p12590.2_BraZ1	69.3	+	380	846	846	1.0000000
A01	6273823	6276361	A01p12600.2_BraZ1	253.8	+	1108	2487	2538	0.9799054
A01	6276434	6277108	A01p12610.2_BraZ1	507	-	132	535	674	0.7937685
A01	6278525	6280561	A01p12620.2_BraZ1	1107.4	+	1374	2020	2036	0.9921414
A01	6281976	6282979	A01p12630.2_BraZ1	172.8	+	1	80	1003	0.0797607
A01	6285037	6286655	A01p12640.2_BraZ1	832.386	+	977	1618	1618	1.0000000
A01	6288513	6289629	A01p12650.2_BraZ1	111.6	-	376	1104	1116	0.9892473
A01	6292332	6296108	A01p12660.2_BraZ1	2281.44	-	529	2569	3776	0.6803496
A01	6297943	6299030	A01p12670.2_BraZ1	50.7	-	0	0	1087	0.0000000
A01	6301178	6301475	A01p12680.2_BraZ1	150	+	2	103	297	0.3468013
A01	6304772	6304955	A01p12690.2_BraZ1	18.3	+	0	0	183	0.0000000
A01	6310495	6313911	A01p12700.2_BraZ1	2308.15	-	1294	3345	3416	0.9792154
A01	6315426	6318706	A01p12710.2_BraZ1	1717	-	1290	2894	3280	0.8823171
A01	6321537	6322140	A01p12720.2_BraZ1	60.3	+	520	603	603	1.0000000
A01	6322526	6326708	A01p12730.2_BraZ1	2377.51	-	2701	3939	4182	0.9418938
A01	6331983	6333927	A01p12740.2_BraZ1	441.15	-	0	0	1944	0.0000000
A01	6342876	6344135	A01p12750.2_BraZ1	1065	-	69	753	1259	0.5980937
A01	6354415	6355310	A01p12760.2_BraZ1	519	+	249	895	895	1.0000000
A01	6356660	6358470	A01p12770.2_BraZ1	820.4	+	487	1744	1810	0.9635359
A01	6359004	6360846	A01p12780.2_BraZ1	1021.78	+	1556	1842	1842	1.0000000
A01	6361152	6363717	A01p12790.2_BraZ1	1477.75	-	901	2175	2565	0.8479532
A01	6365105	6365461	A01p12800.2_BraZ1	183	-	395	356	356	1.0000000
A01	6366657	6367398	A01p12810.2_BraZ1	74.1	-	593	741	741	1.0000000
A01	6374666	6375454	A01p12820.2_BraZ1	611.52	-	58	237	788	0.3007614
A01	6375975	6378821	A01p12830.2_BraZ1	1160.12	-	2353	2846	2846	1.0000000
A01	6379241	6384320	A01p12840.2_BraZ1	2135.92	+	3482	5052	5079	0.9946840
A01	6385107	6390477	A01p12850.2_BraZ1	1860.63	+	3665	5363	5370	0.9986964
A01	6391000	6391630	A01p12860.2_BraZ1	63	-	424	630	630	1.0000000
A01	6393155	6394289	A01p12870.2_BraZ1	719.062	-	647	1134	1134	1.0000000
A01	6396347	6397529	A01p12880.2_BraZ1	118.2	+	468	1137	1182	0.9619290
A01	6398476	6400400	A01p12890.2_BraZ1	1349.58	-	940	1924	1924	1.0000000
A01	6402350	6403832	A01p12900.2_BraZ1	801.779	+	658	1438	1482	0.9703104
A01	6404696	6406415	A01p12910.2_BraZ1	835.096	+	1046	1719	1719	1.0000000
A01	6412987	6414849	A01p12920.2_BraZ1	895.714	+	1624	1652	1862	0.8872181
A01	6415630	6416734	A01p12930.2_BraZ1	110.4	+	1210	1085	1104	0.9827899
A01	6417407	6420718	A01p12940.2_BraZ1	2081.62	-	1678	3299	3311	0.9963757
A01	6421234	6426647	A01p12950.2_BraZ1	1648.29	-	976	4187	5413	0.7735083
A01	6430374	6434637	A01p12960.2_BraZ1	2384.13	+	1272	3517	4263	0.8250059
A01	6435694	6437722	A01p12970.2_BraZ1	1725.45	-	97	1137	2028	0.5606509
A01	6450655	6450826	A01p12980.2_BraZ1	17.1	-	229	171	171	1.0000000
A01	6456781	6459544	A01p12990.2_BraZ1	276.3	+	688	2428	2763	0.8787550
A01	6460398	6471301	A01p13000.2_BraZ1	1265.29	+	6668	10744	10903	0.9854168
A01	6467509	6467993	A01p13010.2_BraZ1	594	-	499	484	484	1.0000000
A01	6469165	6469938	A01p13020.2_BraZ1	372	-	168	773	773	1.0000000
A01	6471698	6477943	A01p13030.2_BraZ1	2928.03	-	647	3708	6245	0.5937550
A01	6478229	6479698	A01p13040.2_BraZ1	428.87	+	1136	1469	1469	1.0000000
A01	6480437	6480863	A01p13050.2_BraZ1	42.6	+	204	426	426	1.0000000
A01	6490289	6490794	A01p13060.2_BraZ1	258	+	379	505	505	1.0000000
A01	6493946	6495020	A01p13070.2_BraZ1	370.286	+	196	954	1074	0.8882682
A01	6503046	6514008	A01p13080.2_BraZ1	2042.53	+	5377	9696	10962	0.8845101
A01	6514331	6516530	A01p13090.2_BraZ1	1348.7	-	1070	2185	2199	0.9936334
A01	6520006	6520357	A01p13100.2_BraZ1	35.1	+	12	212	351	0.6039886
A01	6521728	6531343	A01p13110.2_BraZ1	560.34	+	1461	6588	9615	0.6851794
A01	6534883	6539510	A01p13120.2_BraZ1	1441.15	+	2913	4456	4627	0.9630430
A01	6539883	6541488	A01p13130.2_BraZ1	711.07	-	901	1605	1605	1.0000000
A01	6542747	6549235	A01p13140.2_BraZ1	3671.64	+	1154	4721	6488	0.7276511
A01	6549678	6550526	A01p13150.2_BraZ1	599.062	-	560	848	848	1.0000000
A01	6551468	6551994	A01p13160.2_BraZ1	417	-	124	526	526	1.0000000
A01	6557827	6562342	A01p13170.2_BraZ1	2218.86	+	1404	3849	4515	0.8524917
A01	6562450	6564346	A01p13180.2_BraZ1	189.6	-	129	1343	1896	0.7083333
A01	6565168	6565990	A01p13190.2_BraZ1	82.2	-	324	822	822	1.0000000
A01	6569704	6577342	A01p13200.2_BraZ1	195	+	1219	4960	7638	0.6493847
A01	6571162	6571963	A01p13210.2_BraZ1	80.1	-	2	150	801	0.1872659
A01	6578728	6579529	A01p13220.2_BraZ1	80.1	-	50	702	801	0.8764045
A01	6582122	6593913	A01p13230.2_BraZ1	2599.28	-	4727	9628	11791	0.8165550
A01	6608201	6608723	A01p13240.2_BraZ1	52.2	+	133	506	522	0.9693487
A01	6618123	6620521	A01p13250.2_BraZ1	1642.86	+	1035	2042	2398	0.8515429
A01	6637301	6639054	A01p13260.2_BraZ1	965.818	-	8	253	1753	0.1443240
A01	6644444	6644695	A01p13270.2_BraZ1	192	+	9	198	251	0.7888446
A01	6644759	6645221	A01p13280.2_BraZ1	46.2	+	1	98	462	0.2121212
A01	6648313	6649460	A01p13290.2_BraZ1	306.188	-	286	1010	1147	0.8805580
A01	6651116	6651905	A01p13300.2_BraZ1	357.469	+	218	712	789	0.9024081
A01	6652292	6653865	A01p13310.2_BraZ1	7386.75	-	631	1563	1573	0.9936427
A01	6657584	6657977	A01p13320.2_BraZ1	39.3	-	123	393	393	1.0000000
A01	6662097	6663442	A01p13330.2_BraZ1	56.4	+	189	1184	1345	0.8802974
A01	6668193	6671675	A01p13340.2_BraZ1	1522.53	+	833	2670	3482	0.7668007
A01	6683556	6685167	A01p13350.2_BraZ1	161.1	+	9500	1611	1611	1.0000000
A01	6687523	6690550	A01p13360.2_BraZ1	1487.64	-	539	2391	3027	0.7898910
A01	6693969	6698291	A01p13370.2_BraZ1	1221.87	-	1478	3581	4322	0.8285516
A01	6700504	6700956	A01p13380.2_BraZ1	264	-	388	452	452	1.0000000
A01	6701812	6704356	A01p13390.2_BraZ1	1114.29	-	1710	2544	2544	1.0000000
A01	6707008	6709785	A01p13400.2_BraZ1	2226.9	-	326	2304	2777	0.8296723
A01	6710390	6710610	A01p13410.2_BraZ1	108	+	78	220	220	1.0000000
A01	6717911	6718121	A01p13420.2_BraZ1	21	-	0	0	210	0.0000000
A01	6718907	6719081	A01p13430.2_BraZ1	17.4	-	4	174	174	1.0000000
A01	6721772	6725493	A01p13440.2_BraZ1	2003.17	+	1376	3363	3721	0.9037893
A01	6726587	6728122	A01p13450.2_BraZ1	603.636	-	782	1535	1535	1.0000000
A01	6730000	6731225	A01p13460.2_BraZ1	833.25	-	449	1060	1225	0.8653061
A01	6732349	6732923	A01p13470.2_BraZ1	480	+	35	105	574	0.1829268
A01	6733524	6735189	A01p13480.2_BraZ1	932.8	-	342	1526	1665	0.9165165
A01	6736168	6737302	A01p13490.2_BraZ1	113.4	+	608	884	1134	0.7795414
A01	6737921	6739116	A01p13500.2_BraZ1	396	+	374	1145	1195	0.9581590
A01	6741016	6747908	A01p13510.2_BraZ1	11422.4	+	3350	4712	6892	0.6836913
A01	6744124	6745581	A01p13520.2_BraZ1	754.667	-	720	1226	1457	0.8414550
A01	6749092	6750271	A01p13530.2_BraZ1	117.3	+	320	1031	1179	0.8744699
A01	6751437	6752439	A01p13540.2_BraZ1	100.2	-	180	734	1002	0.7325349
A01	6757090	6758106	A01p13550.2_BraZ1	553.5	+	388	1003	1016	0.9872047
A01	6759058	6760003	A01p13560.2_BraZ1	831	+	1421	945	945	1.0000000
A01	6763148	6768166	A01p13570.2_BraZ1	1973.74	-	1059	3917	5018	0.7805899
A01	6768400	6769813	A01p13580.2_BraZ1	128.483	-	591	980	1413	0.6935598
A01	6770169	6770707	A01p13590.2_BraZ1	258	+	47	538	538	1.0000000
A01	6780996	6781379	A01p13600.2_BraZ1	282	+	135	182	383	0.4751958
A01	6781752	6782562	A01p13610.2_BraZ1	418.723	-	360	547	810	0.6753086
A01	6784707	6784920	A01p13620.2_BraZ1	21.3	+	51	213	213	1.0000000
A01	6785515	6786563	A01p13630.2_BraZ1	10080	-	143	904	1048	0.8625954
A01	6787528	6790724	A01p13640.2_BraZ1	1186.64	-	1356	3185	3196	0.9965582
A01	6792225	6794525	A01p13650.2_BraZ1	1342.31	+	660	2195	2300	0.9543478
A01	6795534	6797338	A01p13660.2_BraZ1	1254.78	-	336	1359	1804	0.7533259
A01	6806629	6807643	A01p13670.2_BraZ1	236.645	+	1085	1014	1014	1.0000000
A01	6809109	6811603	A01p13680.2_BraZ1	266	+	2	163	2494	0.0653569
A01	6815266	6816344	A01p13690.2_BraZ1	289.269	+	193	966	1078	0.8961039
A01	6817039	6818527	A01p13700.2_BraZ1	594	-	953	1248	1488	0.8387097
A01	6819520	6819679	A01p13710.2_BraZ1	15.9	+	339	159	159	1.0000000
A01	6825992	6826749	A01p13720.2_BraZ1	67.2	-	341	757	757	1.0000000
A01	6834738	6835659	A01p13730.2_BraZ1	849	+	311	801	921	0.8697069
A01	6836028	6838218	A01p13740.2_BraZ1	1194.13	-	740	2064	2190	0.9424658
A01	6839841	6842595	A01p13750.2_BraZ1	1410.56	-	694	2209	2754	0.8021060
A01	6843839	6845826	A01p13760.2_BraZ1	1053	+	686	1979	1987	0.9959738
A01	6850526	6851784	A01p13770.2_BraZ1	816.033	-	960	1258	1258	1.0000000
A01	6852215	6852783	A01p13780.2_BraZ1	11481	-	516	568	568	1.0000000
A01	6853060	6854677	A01p13790.2_BraZ1	584.42	+	1195	1571	1617	0.9715523
A01	6854735	6854900	A01p13800.2_BraZ1	16.5	+	171	165	165	1.0000000
A01	6857033	6858634	A01p13810.2_BraZ1	1718.5	-	666	1574	1601	0.9831355
A01	6861735	6862152	A01p13820.2_BraZ1	41.7	+	4	56	417	0.1342926
A01	6863382	6868370	A01p13830.2_BraZ1	1890	-	2771	4485	4988	0.8991580
A01	6865825	6866282	A01p13840.2_BraZ1	56.4706	+	56	394	457	0.8621444
A01	6870209	6870554	A01p13850.2_BraZ1	34.5	+	23	67	345	0.1942029
A01	6871211	6874906	A01p13860.2_BraZ1	459.875	-	1410	3520	3695	0.9526387
A01	6875642	6879872	A01p13870.2_BraZ1	2016	-	631	3346	4230	0.7910165
A01	6892927	6893176	A01p13880.2_BraZ1	24.9	+	288	249	249	1.0000000
A01	6894967	6895603	A01p13890.2_BraZ1	63.6	-	940	636	636	1.0000000
A01	6897835	6898057	A01p13900.2_BraZ1	22.2	+	390	222	222	1.0000000
A01	6898597	6899083	A01p13910.2_BraZ1	48.6	+	460	486	486	1.0000000
A01	6899816	6901133	A01p13920.2_BraZ1	131.7	-	205	918	1317	0.6970387
A01	6902058	6903738	A01p13930.2_BraZ1	940	-	486	1456	1680	0.8666667
A01	6908366	6908821	A01p13940.2_BraZ1	237	-	66	316	455	0.6945055
A01	6911764	6912592	A01p13950.2_BraZ1	82.5	-	191	649	828	0.7838164
A01	6917151	6917634	A01p13960.2_BraZ1	48.3	+	43	483	483	1.0000000
A01	6926372	6927269	A01p13970.2_BraZ1	486	+	23	442	897	0.4927536
A01	6928956	6931160	A01p13980.2_BraZ1	1081.48	+	2152	2204	2204	1.0000000
A01	6934991	6936317	A01p13990.2_BraZ1	804	-	1330	1326	1326	1.0000000
A01	6943563	6945216	A01p14000.2_BraZ1	165.3	+	218	1057	1653	0.6394435
A01	6946787	6948497	A01p14010.2_BraZ1	6737.5	+	558	1710	1710	1.0000000
A01	6951573	6953952	A01p14020.2_BraZ1	1898.88	+	767	2245	2379	0.9436738
A01	6954713	6960958	A01p14030.2_BraZ1	3329.33	+	2005	5373	6245	0.8603683
A01	6956731	6957946	A01p14040.2_BraZ1	121.5	-	151	904	1215	0.7440329
A01	6963243	6965519	A01p14050.2_BraZ1	738	-	1597	2239	2276	0.9837434
A01	6968642	6970553	A01p14060.2_BraZ1	265.2	-	373	1486	1911	0.7776033
A01	6970553	6972737	A01p14070.2_BraZ1	751.469	-	47	560	2184	0.2564103
A01	6975757	6983592	A01p14080.2_BraZ1	285.75	-	1759	5247	7835	0.6696873
A01	6983592	6985775	A01p14090.2_BraZ1	557.775	-	347	705	2183	0.3229501
A01	6988515	7001476	A01p14100.2_BraZ1	1146.53	-	4139	11074	12961	0.8544094
A01	7009296	7013303	A01p14110.2_BraZ1	1567.63	+	1758	4001	4007	0.9985026
A01	7013433	7014891	A01p14120.2_BraZ1	606.033	-	368	1368	1458	0.9382716
A01	7018984	7020964	A01p14130.2_BraZ1	336	-	2315	1980	1980	1.0000000
A01	7028015	7030242	A01p14140.2_BraZ1	1177.2	-	234	2059	2227	0.9245622
A01	7038551	7040066	A01p14150.2_BraZ1	151.5	-	105	1046	1515	0.6904290
A01	7050198	7051179	A01p14160.2_BraZ1	98.1	+	35	692	981	0.7054027
A01	7053816	7054764	A01p14170.2_BraZ1	571.833	-	383	948	948	1.0000000
A01	7055715	7061635	A01p14180.2_BraZ1	2023.03	+	2757	5654	5920	0.9550676
A01	7062276	7063911	A01p14190.2_BraZ1	1077	-	1162	1635	1635	1.0000000
A01	7065682	7067305	A01p14200.2_BraZ1	913.846	+	1284	1603	1623	0.9876772
A01	7068645	7069030	A01p14210.2_BraZ1	324	+	28	312	385	0.8103896
A01	7070564	7072602	A01p14220.2_BraZ1	1198.11	+	1130	1854	2038	0.9097154
A01	7073375	7077816	A01p14230.2_BraZ1	960.878	-	2165	3982	4441	0.8966449
A01	7079132	7081735	A01p14240.2_BraZ1	4623.75	+	891	2458	2603	0.9442950
A01	7079356	7082902	A01p14250.2_BraZ1	102	-	1679	3401	3546	0.9591088
A01	7082245	7084772	A01p14260.2_BraZ1	903	+	1715	2527	2527	1.0000000
A01	7090223	7105339	A01p14270.2_BraZ1	2488.54	+	6765	13702	15116	0.9064567
A01	7105407	7112750	A01p14280.2_BraZ1	1283.91	-	2939	6198	7343	0.8440692
A01	7115189	7115941	A01p14290.2_BraZ1	657	-	191	681	752	0.9055851
A01	7117256	7120936	A01p14300.2_BraZ1	1786.6	+	1814	3248	3680	0.8826087
A01	7126443	7136574	A01p14310.2_BraZ1	4432.35	-	1890	7624	10131	0.7525417
A01	7139008	7140660	A01p14320.2_BraZ1	774	-	186	1406	1652	0.8510896
A01	7144840	7146457	A01p14330.2_BraZ1	873.231	-	483	1491	1617	0.9220779
A01	7149370	7151160	A01p14340.2_BraZ1	831	-	96	693	1790	0.3871508
A01	7154895	7156610	A01p14350.2_BraZ1	777	-	1331	1715	1715	1.0000000
A01	7159455	7161171	A01p14360.2_BraZ1	171.6	-	447	1631	1716	0.9504662
A01	7164143	7167537	A01p14370.2_BraZ1	1740.99	-	2141	3319	3394	0.9779022
A01	7176509	7180441	A01p14380.2_BraZ1	976.595	-	4348	3880	3932	0.9867752
A01	7185599	7187748	A01p14390.2_BraZ1	9163.5	-	3693	2149	2149	1.0000000
A01	7194244	7195783	A01p14400.2_BraZ1	153.9	+	1670	1539	1539	1.0000000
A01	7205721	7206386	A01p14410.2_BraZ1	333	+	179	503	665	0.7563910
A01	7206558	7207091	A01p14420.2_BraZ1	168.3	+	21	460	533	0.8630394
A01	7211497	7211758	A01p14430.2_BraZ1	26.1	+	6	100	261	0.3831418
A01	7218710	7221713	A01p14440.2_BraZ1	1497	+	1254	2889	3003	0.9620380
A01	7221992	7223398	A01p14450.2_BraZ1	933.636	-	679	1406	1406	1.0000000
A01	7235207	7236231	A01p14460.2_BraZ1	6612	+	547	1024	1024	1.0000000
A01	7239798	7242816	A01p14470.2_BraZ1	1201.69	-	1778	2914	3018	0.9655401
A01	7248768	7255435	A01p14480.2_BraZ1	21862	-	3706	6306	6667	0.9458527
A01	7256917	7259449	A01p14490.2_BraZ1	23653.9	+	1365	2405	2532	0.9498420
A01	7259747	7262534	A01p14500.2_BraZ1	1237.26	-	402	2516	2787	0.9027628
A01	7263355	7263556	A01p14510.2_BraZ1	20.1	-	162	201	201	1.0000000
A01	7263772	7264111	A01p14520.2_BraZ1	33.9	-	77	218	339	0.6430678
A01	7269439	7280672	A01p14530.2_BraZ1	1876.02	+	5916	10697	11233	0.9522834
A01	7275231	7276419	A01p14540.2_BraZ1	118.8	+	645	1156	1188	0.9730639
A01	7281062	7283935	A01p14550.2_BraZ1	448.421	-	2002	2873	2873	1.0000000
A01	7285966	7292639	A01p14560.2_BraZ1	1720.54	-	2541	6607	6673	0.9901094
A01	7294681	7319382	A01p14570.2_BraZ1	1282.5	+	2558	16117	24701	0.6524837
A01	7298650	7304812	A01p14580.2_BraZ1	313.2	+	625	3763	6162	0.6106784
A01	7305874	7306294	A01p14590.2_BraZ1	261	+	4	189	420	0.4500000
A01	7306129	7308363	A01p14600.2_BraZ1	145.5	+	89	1617	2234	0.7238138
A01	7310851	7311715	A01p14610.2_BraZ1	396	-	23	658	864	0.7615741
A01	7314422	7315689	A01p14620.2_BraZ1	726	-	169	836	1267	0.6598263
A01	7320435	7323478	A01p14630.2_BraZ1	1004.54	+	2557	3043	3043	1.0000000
A01	7325041	7333163	A01p14640.2_BraZ1	306.34	+	2226	4833	8122	0.5950505
A01	7327181	7327838	A01p14650.2_BraZ1	603	+	4	244	657	0.3713851
A01	7330717	7331602	A01p14660.2_BraZ1	88.5	+	106	786	885	0.8881356
A01	7335027	7342988	A01p14670.2_BraZ1	3095.43	-	2566	6642	7961	0.8343173
A01	7348638	7349608	A01p14680.2_BraZ1	313.816	+	796	970	970	1.0000000
A01	7350030	7359491	A01p14690.2_BraZ1	1132.75	-	5593	8722	9461	0.9218898
A01	7362364	7363619	A01p14700.2_BraZ1	864.161	+	106	887	1255	0.7067729
A01	7363977	7364142	A01p14710.2_BraZ1	16.5	+	181	165	165	1.0000000
A01	7364320	7367762	A01p14720.2_BraZ1	814.5	+	2525	3442	3442	1.0000000
A01	7369192	7370218	A01p14730.2_BraZ1	408	+	269	840	1026	0.8187134
A01	7376794	7379602	A01p14740.2_BraZ1	280.8	+	967	2772	2808	0.9871795
A01	7380103	7380870	A01p14750.2_BraZ1	2376	-	515	767	767	1.0000000
A01	7388625	7391051	A01p14760.2_BraZ1	1041	+	295	916	2426	0.3775763
A01	7392585	7396557	A01p14770.2_BraZ1	969	+	5564	3171	3972	0.7983384
A01	7399075	7399642	A01p14780.2_BraZ1	56.7	+	189	567	567	1.0000000
A01	7401210	7402753	A01p14790.2_BraZ1	663.72	+	614	1543	1543	1.0000000
A01	7403311	7405501	A01p14800.2_BraZ1	1596	-	151	1507	2190	0.6881279
A01	7410364	7410716	A01p14810.2_BraZ1	270	-	73	160	352	0.4545455
A01	7412427	7412800	A01p14820.2_BraZ1	300	-	12	152	373	0.4075067
A01	7424264	7427015	A01p14830.2_BraZ1	1482	+	822	2077	2751	0.7549982
A01	7427277	7432627	A01p14840.2_BraZ1	4483.93	-	1915	4658	5350	0.8706542
A01	7434386	7435490	A01p14850.2_BraZ1	110.4	-	99	1043	1104	0.9447464
A01	7443255	7449050	A01p14860.2_BraZ1	1128	-	7689	5733	5795	0.9893011
A01	7451838	7452948	A01p14870.2_BraZ1	111	-	100	865	1110	0.7792793
A01	7460265	7461351	A01p14880.2_BraZ1	108.6	+	285	773	1086	0.7117864
A01	7470138	7473756	A01p14890.2_BraZ1	1431	-	2015	3513	3618	0.9709784
A01	7478622	7480043	A01p14900.2_BraZ1	2466	-	1227	1421	1421	1.0000000
A01	7485477	7487142	A01p14910.2_BraZ1	977.3	-	22	544	1665	0.3267267
A01	7491487	7492657	A01p14920.2_BraZ1	117	+	123	1096	1170	0.9367521
A01	7492825	7498127	A01p14930.2_BraZ1	2879.95	-	5029	5302	5302	1.0000000
A01	7517648	7518209	A01p14940.2_BraZ1	56.1	+	725	561	561	1.0000000
A01	7520058	7520169	A01p14950.2_BraZ1	11.1	+	502	111	111	1.0000000
A01	7520364	7521195	A01p14960.2_BraZ1	698.625	+	355	814	831	0.9795427
A01	7529297	7530645	A01p14970.2_BraZ1	891	+	1676	1348	1348	1.0000000
A01	7533386	7535869	A01p14980.2_BraZ1	1353.37	-	1243	2433	2483	0.9798630
A01	7539105	7540961	A01p14990.2_BraZ1	583.987	+	2059	1856	1856	1.0000000
A01	7543532	7543682	A01p15000.2_BraZ1	15	-	0	0	150	0.0000000
A01	7550866	7552196	A01p15010.2_BraZ1	663	+	303	1330	1330	1.0000000
A01	7558806	7561447	A01p15020.2_BraZ1	425	+	1241	2557	2641	0.9681939
A01	7572668	7574829	A01p15030.2_BraZ1	1164.81	+	1119	2063	2161	0.9546506
A01	7577147	7577876	A01p15040.2_BraZ1	72	+	550	729	729	1.0000000
A01	7578004	7579719	A01p15050.2_BraZ1	5245.5	-	784	1359	1715	0.7924199
A01	7581482	7582706	A01p15060.2_BraZ1	769.236	+	1073	1224	1224	1.0000000
A01	7583604	7586851	A01p15070.2_BraZ1	2242.23	-	1363	3090	3247	0.9516477
A01	7588186	7590604	A01p15080.2_BraZ1	1452.48	-	1154	2418	2418	1.0000000
A01	7591261	7593623	A01p15090.2_BraZ1	1074.17	-	2177	2236	2362	0.9466554
A01	7599331	7602193	A01p15100.2_BraZ1	5928	-	2185	2527	2862	0.8829490
A01	7621743	7622215	A01p15110.2_BraZ1	381	+	1	80	472	0.1694915
A01	7626719	7627280	A01p15120.2_BraZ1	56.1	-	145	449	561	0.8003565
A01	7630393	7631439	A01p15130.2_BraZ1	1506.94	+	548	1046	1046	1.0000000
A01	7637751	7638009	A01p15140.2_BraZ1	192	-	0	0	258	0.0000000
A01	7645732	7650082	A01p15150.2_BraZ1	2269.95	-	1477	3839	4350	0.8825287
A01	7664083	7664603	A01p15160.2_BraZ1	290.032	+	508	520	520	1.0000000
A01	7673685	7673967	A01p15170.2_BraZ1	171	-	55	282	282	1.0000000
A01	7684533	7684980	A01p15180.2_BraZ1	44.7	+	557	447	447	1.0000000
A01	7687137	7693143	A01p15190.2_BraZ1	1886.51	+	1992	5465	6006	0.9099234
A01	7694698	7695182	A01p15200.2_BraZ1	387	-	658	484	484	1.0000000
A01	7704378	7705476	A01p15210.2_BraZ1	190	-	70	709	1098	0.6457195
A01	7706185	7706343	A01p15220.2_BraZ1	12.6	-	0	0	158	0.0000000
A01	7706851	7707383	A01p15230.2_BraZ1	171	-	4	36	532	0.0676692
A01	7709800	7710748	A01p15240.2_BraZ1	94.8	+	341	948	948	1.0000000
A01	7725511	7727692	A01p15250.2_BraZ1	1376.57	+	1037	1972	2181	0.9041724
A01	7727836	7728955	A01p15260.2_BraZ1	951	-	47	897	1119	0.8016086
A01	7733078	7733662	A01p15270.2_BraZ1	300	-	75	569	584	0.9743150
A01	7736664	7739621	A01p15280.2_BraZ1	1242.13	-	504	2229	2957	0.7538045
A01	7741434	7745580	A01p15290.2_BraZ1	1907.83	-	775	3444	4146	0.8306802
A01	7747496	7749297	A01p15300.2_BraZ1	1087.33	+	383	1759	1801	0.9766796
A01	7751986	7752340	A01p15310.2_BraZ1	35.4	+	9	49	354	0.1384181
A01	7753674	7754246	A01p15320.2_BraZ1	561	-	56	132	572	0.2307692
A01	7762985	7763966	A01p15330.2_BraZ1	280.5	+	743	981	981	1.0000000
A01	7764123	7764942	A01p15340.2_BraZ1	81.9	-	338	775	819	0.9462759
A01	7765609	7767779	A01p15350.2_BraZ1	548.591	+	1360	2156	2170	0.9935484
A01	7769790	7772080	A01p15360.2_BraZ1	519.409	+	678	2290	2290	1.0000000
A01	7776584	7783004	A01p15370.2_BraZ1	994.65	+	1760	2833	6420	0.4412773
A01	7783415	7784021	A01p15380.2_BraZ1	60.6	-	291	606	606	1.0000000
A01	7786195	7790697	A01p15390.2_BraZ1	1246.88	-	1278	4215	4502	0.9362506
A01	7792066	7793621	A01p15400.2_BraZ1	141	-	45	1100	1555	0.7073955
A01	7794132	7801274	A01p15410.2_BraZ1	3740.27	+	5284	7095	7142	0.9934192
A01	7812601	7825149	A01p15420.2_BraZ1	2006.31	+	4601	10800	12548	0.8606949
A01	7817833	7820384	A01p15430.2_BraZ1	284.091	-	1168	2000	2551	0.7840063
A01	7826099	7829108	A01p15440.2_BraZ1	366.208	+	1368	2238	3009	0.7437687
A01	7829311	7830623	A01p15450.2_BraZ1	635.727	-	30	562	1312	0.4283537
A01	7847179	7847562	A01p15460.2_BraZ1	1236	+	305	383	383	1.0000000
A01	7853020	7853363	A01p15470.2_BraZ1	258	-	1	75	343	0.2186589
A01	7855144	7858830	A01p15480.2_BraZ1	2307.91	+	526	2005	3686	0.5439501
A01	7859857	7860094	A01p15490.2_BraZ1	23.7	+	3	26	237	0.1097046
A01	7860197	7865157	A01p15500.2_BraZ1	1696.38	+	1011	3748	4960	0.7556452
A01	7872268	7874665	A01p15510.2_BraZ1	986.026	+	481	1949	2397	0.8130997
A01	7881777	7883340	A01p15520.2_BraZ1	1041	+	139	459	1563	0.2936660
A01	7901703	7903024	A01p15530.2_BraZ1	9000	-	422	1173	1321	0.8879637
A01	7904567	7905611	A01p15540.2_BraZ1	9075	+	360	1044	1044	1.0000000
A01	7906573	7913904	A01p15550.2_BraZ1	2531.67	+	2256	6774	7331	0.9240213
A01	7914471	7915308	A01p15560.2_BraZ1	83.7	-	371	837	837	1.0000000
A01	7920280	7922776	A01p15570.2_BraZ1	1993.33	+	146	1696	2496	0.6794872
A01	7930903	7931462	A01p15580.2_BraZ1	474	+	52	445	559	0.7960644
A01	7940326	7943808	A01p15590.2_BraZ1	1341.9	-	2066	1979	3482	0.5683515
A01	7948724	7949336	A01p15600.2_BraZ1	309	-	659	612	612	1.0000000
A01	7951953	7953437	A01p15610.2_BraZ1	1136.25	+	613	1421	1484	0.9575472
A01	7954550	7956546	A01p15620.2_BraZ1	1185.84	+	835	1889	1996	0.9463928
A01	7957682	7961910	A01p15630.2_BraZ1	3410.73	+	2116	4001	4228	0.9463103
A01	7971647	7973170	A01p15640.2_BraZ1	743.7	+	509	1462	1523	0.9599475
A01	7974176	7975030	A01p15650.2_BraZ1	1927.5	-	314	843	854	0.9871194
A01	7975751	7979462	A01p15660.2_BraZ1	2156.76	-	2048	3711	3711	1.0000000
A01	7982192	7982762	A01p15670.2_BraZ1	489	-	2	86	570	0.1508772
A01	7984514	7984955	A01p15680.2_BraZ1	44.1	+	80	236	441	0.5351474
A01	7985898	7987150	A01p15690.2_BraZ1	1173	+	485	1205	1252	0.9624600
A01	7988024	7989581	A01p15700.2_BraZ1	969.8	-	1696	1557	1557	1.0000000
A01	7990451	7993440	A01p15710.2_BraZ1	835	+	1685	2836	2989	0.9488123
A01	7994064	7999523	A01p15720.2_BraZ1	1855.29	-	1963	4906	5459	0.8986994
A01	7999753	8000218	A01p15730.2_BraZ1	46.5	-	337	456	465	0.9806452
A01	8000871	8000982	A01p15740.2_BraZ1	11.1	-	17	111	111	1.0000000
A01	8005578	8010471	A01p15750.2_BraZ1	1817.65	-	2981	4468	4893	0.9131413
A01	8011216	8011546	A01p15760.2_BraZ1	33	+	66	329	330	0.9969697
A01	8013357	8016162	A01p15770.2_BraZ1	2105.49	+	2674	2805	2805	1.0000000
A01	8019444	8021684	A01p15780.2_BraZ1	795	+	503	1579	2240	0.7049107
A01	8023617	8026279	A01p15790.2_BraZ1	1812	+	518	2434	2662	0.9143501
A01	8027950	8028613	A01p15800.2_BraZ1	66.3	+	123	663	663	1.0000000
A01	8029104	8030256	A01p15810.2_BraZ1	115.2	-	252	1057	1152	0.9175347
A01	8031004	8033155	A01p15820.2_BraZ1	1416	-	678	1710	2151	0.7949791
A01	8035492	8037643	A01p15830.2_BraZ1	990.818	+	1553	2151	2151	1.0000000
A01	8039824	8041993	A01p15840.2_BraZ1	764.864	+	549	1649	2169	0.7602582
A01	8042267	8042780	A01p15850.2_BraZ1	51.3	-	112	513	513	1.0000000
A01	8043234	8044279	A01p15860.2_BraZ1	7969.5	+	455	966	1045	0.9244019
A01	8044466	8046896	A01p15870.2_BraZ1	1776.68	-	693	1928	2430	0.7934157
A01	8049005	8051799	A01p15880.2_BraZ1	966.968	+	1359	2558	2794	0.9155333
A01	8068492	8071794	A01p15890.2_BraZ1	1839.7	+	715	2687	3302	0.8137493
A01	8076818	8086209	A01p15900.2_BraZ1	1384.04	+	3573	8250	9391	0.8785007
A01	8087084	8089553	A01p15910.2_BraZ1	1215.64	+	2914	2469	2469	1.0000000
A01	8090669	8092649	A01p15920.2_BraZ1	823.574	+	1112	1968	1980	0.9939394
A01	8095892	8100089	A01p15930.2_BraZ1	2715.56	+	1822	3755	4197	0.8946867
A01	8100706	8104601	A01p15940.2_BraZ1	1515.68	-	671	3219	3895	0.8264441
A01	8104779	8110403	A01p15950.2_BraZ1	2292	+	1027	4662	5624	0.8289474
A01	8111208	8115068	A01p15960.2_BraZ1	2058.34	+	1346	3760	3860	0.9740933
A01	8115694	8119702	A01p15970.2_BraZ1	2110.06	-	2117	3953	4008	0.9862775
A01	8120244	8126103	A01p15980.2_BraZ1	1376.27	-	1221	4817	5859	0.8221539
A01	8133751	8136707	A01p15990.2_BraZ1	1219.15	+	1953	2956	2956	1.0000000
A01	8137204	8141596	A01p16000.2_BraZ1	2721.36	-	2226	4073	4392	0.9273679
A01	8143435	8144383	A01p16010.2_BraZ1	94.8	+	314	846	948	0.8924051
A01	8144716	8151016	A01p16020.2_BraZ1	251.034	-	1226	4879	6300	0.7744445
A01	8157418	8158585	A01p16030.2_BraZ1	2404.56	+	1140	1167	1167	1.0000000
A01	8159225	8166068	A01p16040.2_BraZ1	3277.5	-	998	4787	6843	0.6995470
A01	8167821	8168284	A01p16050.2_BraZ1	201	-	94	463	463	1.0000000
A01	8168667	8171863	A01p16060.2_BraZ1	1851	-	2586	3196	3196	1.0000000
A01	8176464	8178652	A01p16070.2_BraZ1	1230	+	610	1554	2188	0.7102377
A01	8181897	8182821	A01p16080.2_BraZ1	552	+	521	845	924	0.9145021
A01	8185659	8186337	A01p16090.2_BraZ1	67.8	-	293	670	678	0.9882006
A01	8191204	8195320	A01p16100.2_BraZ1	1454.8	-	577	3562	4116	0.8654033
A01	8197349	8202848	A01p16110.2_BraZ1	3715.83	+	169	2665	5499	0.4846336
A01	8204458	8207414	A01p16120.2_BraZ1	1957.43	+	876	2776	2956	0.9391069
A01	8207875	8217205	A01p16130.2_BraZ1	1669.7	-	3820	7746	9330	0.8302251
A01	8217269	8224858	A01p16140.2_BraZ1	2470	-	4849	7502	7589	0.9885361
A01	8225849	8227843	A01p16150.2_BraZ1	1146.87	-	891	1821	1994	0.9132397
A01	8236848	8238720	A01p16160.2_BraZ1	887.727	-	1930	1773	1872	0.9471154
A01	8241445	8243001	A01p16170.2_BraZ1	1298.94	-	243	1294	1556	0.8316196
A01	8251465	8255315	A01p16180.2_BraZ1	1420.71	+	1511	3849	3850	0.9997402
A01	8256429	8258744	A01p16190.2_BraZ1	2020.74	+	489	2196	2315	0.9485961
A01	8259000	8259789	A01p16200.2_BraZ1	78.9	+	37	248	789	0.3143219
A01	8261638	8263777	A01p16210.2_BraZ1	1066.74	-	1241	2102	2139	0.9827022
A01	8264264	8266708	A01p16220.2_BraZ1	1086.02	-	1363	2444	2444	1.0000000
A01	8267294	8271345	A01p16230.2_BraZ1	2079	-	825	3085	4051	0.7615404
A01	8271874	8272484	A01p16240.2_BraZ1	2349	-	91	548	610	0.8983607
A01	8273819	8277409	A01p16250.2_BraZ1	3072	+	725	3123	3590	0.8699164
A01	8278220	8281129	A01p16260.2_BraZ1	1691.04	-	781	2009	2909	0.6906154
A01	8283028	8284598	A01p16270.2_BraZ1	958.75	+	1283	1568	1570	0.9987261
A01	8285333	8286266	A01p16280.2_BraZ1	93.3	-	421	895	933	0.9592712
A01	8287561	8287995	A01p16290.2_BraZ1	210	-	332	434	434	1.0000000
A01	8288798	8289771	A01p16300.2_BraZ1	708.762	-	982	973	973	1.0000000
A01	8290220	8293384	A01p16310.2_BraZ1	777.44	+	2406	3164	3164	1.0000000
A01	8293703	8296186	A01p16320.2_BraZ1	1142.14	+	1656	2483	2483	1.0000000
A01	8296891	8297473	A01p16330.2_BraZ1	120	+	382	582	582	1.0000000
A01	8300362	8304265	A01p16340.2_BraZ1	1943.86	+	1554	3347	3903	0.8575455
A01	8305770	8305878	A01p16350.2_BraZ1	10.8	+	3	55	108	0.5092593
A01	8306338	8307964	A01p16360.2_BraZ1	271.304	+	833	1552	1626	0.9544895
A01	8308997	8315723	A01p16370.2_BraZ1	501.261	-	2010	5592	6726	0.8314005
A01	8319865	8320217	A01p16380.2_BraZ1	237	-	219	352	352	1.0000000
A01	8320656	8322686	A01p16390.2_BraZ1	957.538	+	592	1904	2030	0.9379311
A01	8326716	8328713	A01p16400.2_BraZ1	6721	+	1684	1997	1997	1.0000000
A01	8328368	8329663	A01p16410.2_BraZ1	1853.83	+	1154	1270	1295	0.9806950
A01	8331573	8332854	A01p16420.2_BraZ1	690	+	1507	1261	1281	0.9843872
A01	8333827	8334261	A01p16430.2_BraZ1	354	-	312	434	434	1.0000000
A01	8334800	8335735	A01p16440.2_BraZ1	60.6	+	278	919	935	0.9828877
A01	8336518	8337301	A01p16450.2_BraZ1	4485	-	34	670	783	0.8556833
A01	8338641	8339918	A01p16460.2_BraZ1	1444.74	-	888	1274	1277	0.9976507
A01	8343096	8350800	A01p16470.2_BraZ1	441	+	7724	7261	7704	0.9424974
A01	8357590	8357776	A01p16480.2_BraZ1	15.6	-	0	0	186	0.0000000
A01	8358293	8359361	A01p16490.2_BraZ1	233.75	-	705	926	1068	0.8670412
A01	8362910	8363060	A01p16500.2_BraZ1	15	+	0	0	150	0.0000000
A01	8364165	8364466	A01p16510.2_BraZ1	207	+	0	0	301	0.0000000
A01	8365796	8365946	A01p16520.2_BraZ1	15	+	0	0	150	0.0000000
A01	8368685	8368835	A01p16530.2_BraZ1	15	+	0	0	150	0.0000000
A01	8376140	8377046	A01p16540.2_BraZ1	180	+	172	665	906	0.7339956
A01	8378676	8379633	A01p16550.2_BraZ1	144	+	269	880	957	0.9195402
A01	8385969	8387023	A01p16560.2_BraZ1	498.409	+	334	999	1054	0.9478179
A01	8391065	8391865	A01p16570.2_BraZ1	558	-	87	511	800	0.6387500
A01	8393278	8394004	A01p16580.2_BraZ1	392.318	+	180	726	726	1.0000000
A01	8394978	8396406	A01p16590.2_BraZ1	549.48	+	107	891	1428	0.6239496
A01	8396643	8400222	A01p16600.2_BraZ1	1598.4	+	1506	3021	3579	0.8440905
A01	8400626	8401638	A01p16610.2_BraZ1	942	+	119	765	1012	0.7559289
A01	8402038	8403693	A01p16620.2_BraZ1	752.25	-	529	1350	1655	0.8157099
A01	8404177	8405514	A01p16630.2_BraZ1	673.636	-	319	1327	1337	0.9925206
A01	8406404	8408256	A01p16640.2_BraZ1	471.842	-	1024	1750	1852	0.9449244
A01	8410326	8412668	A01p16650.2_BraZ1	1328	-	771	2065	2342	0.8817250
A01	8413358	8414507	A01p16660.2_BraZ1	771	-	40	596	1149	0.5187119
A01	8414889	8415739	A01p16670.2_BraZ1	564	+	308	850	850	1.0000000
A01	8416347	8417489	A01p16680.2_BraZ1	779.864	-	332	910	1142	0.7968476
A01	8418007	8421522	A01p16690.2_BraZ1	1930.04	-	373	2646	3515	0.7527738
A01	8425139	8433776	A01p16700.2_BraZ1	714.831	+	318	2164	8637	0.2505500
A01	8439243	8441281	A01p16710.2_BraZ1	983.545	+	555	2001	2038	0.9818450
A01	8449007	8450182	A01p16720.2_BraZ1	19656	-	22	796	1175	0.6774468
A01	8452717	8454807	A01p16730.2_BraZ1	904.75	-	897	2090	2090	1.0000000
A01	8455550	8457131	A01p16740.2_BraZ1	543.857	-	1400	1581	1581	1.0000000
A01	8458183	8458902	A01p16750.2_BraZ1	642	+	538	719	719	1.0000000
A01	8460837	8461893	A01p16760.2_BraZ1	105.6	+	563	1056	1056	1.0000000
A01	8467139	8469150	A01p16770.2_BraZ1	1515	+	241	1371	2011	0.6817504
A01	8469394	8469565	A01p16780.2_BraZ1	17.1	-	96	171	171	1.0000000
A01	8470656	8479795	A01p16790.2_BraZ1	1733.59	+	5278	9091	9139	0.9947478
A01	8482019	8482619	A01p16800.2_BraZ1	60	+	140	355	600	0.5916666
A01	8486167	8486767	A01p16810.2_BraZ1	60	+	154	590	600	0.9833333
A01	8493830	8494418	A01p16820.2_BraZ1	58.8	+	105	477	588	0.8112245
A01	8496141	8496801	A01p16830.2_BraZ1	66	-	55	345	660	0.5227273
A01	8497424	8499008	A01p16840.2_BraZ1	158.4	-	150	1404	1584	0.8863636
A01	8499204	8500708	A01p16850.2_BraZ1	742.156	-	493	1427	1504	0.9488032
A01	8502102	8506225	A01p16860.2_BraZ1	1273.88	+	1712	3571	4123	0.8661169
A01	8506626	8507625	A01p16870.2_BraZ1	481.091	-	672	999	999	1.0000000
A01	8508903	8510525	A01p16880.2_BraZ1	1102.18	+	735	1511	1622	0.9315659
A01	8511343	8513982	A01p16890.2_BraZ1	1269.17	-	616	2441	2639	0.9249716
A01	8515789	8517996	A01p16900.2_BraZ1	1535.22	+	1040	1989	2207	0.9012234
A01	8520984	8523509	A01p16910.2_BraZ1	291	+	1716	2505	2525	0.9920792
A01	8525975	8526471	A01p16920.2_BraZ1	39.6	+	3	33	496	0.0665323
A01	8537739	8538609	A01p16930.2_BraZ1	641.889	+	67	336	870	0.3862069
A01	8548112	8549701	A01p16940.2_BraZ1	1281	-	276	1429	1589	0.8993077
A01	8566094	8566373	A01p16950.2_BraZ1	27.9	+	0	0	279	0.0000000
A01	8567080	8568071	A01p16960.2_BraZ1	444	+	920	991	991	1.0000000
A01	8569654	8574059	A01p16970.2_BraZ1	607.75	-	3022	3863	4405	0.8769580
A01	8577549	8578239	A01p16980.2_BraZ1	780	-	54	690	690	1.0000000
A01	8582261	8582714	A01p16990.2_BraZ1	45.3	-	50	341	453	0.7527594
A01	8584268	8595134	A01p17000.2_BraZ1	420	+	6271	10504	10866	0.9666851
A01	8594849	8603681	A01p17010.2_BraZ1	768.059	-	22829	7840	8832	0.8876812
A01	8605212	8607281	A01p17020.2_BraZ1	963.353	-	1142	1922	2069	0.9289512
A01	8609298	8611318	A01p17030.2_BraZ1	891	+	702	1989	2020	0.9846535
A01	8620221	8620547	A01p17040.2_BraZ1	240	+	0	0	326	0.0000000
A01	8621796	8622644	A01p17050.2_BraZ1	634.5	-	53	606	848	0.7146226
A01	8622806	8624668	A01p17060.2_BraZ1	827.556	+	2102	1862	1862	1.0000000
A01	8629456	8629914	A01p17070.2_BraZ1	351	+	158	458	458	1.0000000
A01	8634633	8636869	A01p17080.2_BraZ1	815.486	+	117	777	2236	0.3474955
A01	8638691	8639072	A01p17090.2_BraZ1	282	-	24	315	381	0.8267717
A01	8639503	8642770	A01p17100.2_BraZ1	591.837	+	1912	2884	3267	0.8827671
A01	8644664	8645651	A01p17110.2_BraZ1	735.571	+	1537	987	987	1.0000000
A01	8646117	8647136	A01p17120.2_BraZ1	156	-	1302	1019	1019	1.0000000
A01	8648368	8649744	A01p17130.2_BraZ1	296.371	-	310	1098	1376	0.7979651
A01	8650102	8666577	A01p17140.2_BraZ1	708.016	+	8179	14394	16475	0.8736874
A01	8658260	8659701	A01p17150.2_BraZ1	13320	-	509	1415	1441	0.9819570
A01	8667727	8670634	A01p17160.2_BraZ1	1232	-	805	2658	2907	0.9143447
A01	8671862	8674018	A01p17170.2_BraZ1	1386.14	-	651	1928	2156	0.8942486
A01	8674743	8675957	A01p17180.2_BraZ1	667.714	+	816	1214	1214	1.0000000
A01	8676349	8680744	A01p17190.2_BraZ1	834	-	2753	4036	4395	0.9183162
A01	8678665	8681624	A01p17200.2_BraZ1	398.829	+	1876	2886	2959	0.9753295
A01	8686463	8688431	A01p17210.2_BraZ1	757.742	-	929	1904	1968	0.9674796
A01	8689970	8690443	A01p17220.2_BraZ1	267	+	555	473	473	1.0000000
A01	8694764	8697019	A01p17230.2_BraZ1	825.444	-	1474	2044	2255	0.9064302
A01	8698111	8699512	A01p17240.2_BraZ1	521.455	-	545	1390	1401	0.9921485
A01	8701626	8703348	A01p17250.2_BraZ1	172.2	-	462	1553	1722	0.9018583
A01	8714339	8714756	A01p17260.2_BraZ1	41.7	+	100	292	417	0.7002398
A01	8716243	8718261	A01p17270.2_BraZ1	1181.25	-	1124	1919	2018	0.9509415
A01	8719849	8720458	A01p17280.2_BraZ1	60.9	+	25	266	609	0.4367816
A01	8723937	8724819	A01p17290.2_BraZ1	468	-	17	535	882	0.6065760
A01	8725104	8725324	A01p17300.2_BraZ1	120	+	78	220	220	1.0000000
A01	8726138	8727347	A01p17310.2_BraZ1	6300	-	97	1042	1209	0.8618693
A01	8730527	8731493	A01p17320.2_BraZ1	231	+	167	576	966	0.5962733
A01	8735778	8738103	A01p17330.2_BraZ1	1626.91	+	476	1970	2325	0.8473119
A01	8740134	8758464	A01p17340.2_BraZ1	2588	+	10845	17704	18330	0.9658483
A01	8751836	8752788	A01p17350.2_BraZ1	507.692	+	686	952	952	1.0000000
A01	8758623	8758786	A01p17360.2_BraZ1	11.4	+	401	136	163	0.8343558
A01	8762810	8768291	A01p17370.2_BraZ1	1081.14	+	1889	4556	5481	0.8312352
A01	8776098	8777211	A01p17380.2_BraZ1	774	-	201	572	1113	0.5139263
A01	8779856	8782108	A01p17390.2_BraZ1	501.058	+	1777	2252	2252	1.0000000
A01	8782366	8784358	A01p17400.2_BraZ1	1016.93	-	1120	1786	1992	0.8965864
A01	8788664	8791608	A01p17410.2_BraZ1	2137.27	+	1495	2890	2944	0.9816576
A01	8792470	8799612	A01p17420.2_BraZ1	3125.85	-	3676	6343	7142	0.8881266
A01	8811767	8812593	A01p17430.2_BraZ1	738	+	12	218	826	0.2639225
A01	8812899	8813207	A01p17440.2_BraZ1	198	+	1	37	308	0.1201299
A01	8813369	8813762	A01p17450.2_BraZ1	288	+	45	270	393	0.6870229
A01	8817652	8819487	A01p17460.2_BraZ1	995.737	+	1967	1808	1835	0.9852861
A01	8820734	8825265	A01p17470.2_BraZ1	870.721	+	2043	4471	4531	0.9867579
A01	8825465	8825741	A01p17480.2_BraZ1	27.6	+	168	276	276	1.0000000
A01	8827420	8828391	A01p17490.2_BraZ1	717	+	775	971	971	1.0000000
A01	8828780	8831702	A01p17500.2_BraZ1	1584.99	-	949	2401	2922	0.8216975
A01	8832610	8833102	A01p17510.2_BraZ1	327	-	87	467	492	0.9491870
A01	8834661	8840606	A01p17520.2_BraZ1	3492.89	+	1507	5532	5945	0.9305298
A01	8845792	8850611	A01p17530.2_BraZ1	1703.28	+	768	4006	4819	0.8312928
A01	8850931	8852965	A01p17540.2_BraZ1	963.333	+	1000	2022	2034	0.9941003
A01	8853521	8855114	A01p17550.2_BraZ1	1099.04	-	1380	1593	1593	1.0000000
A01	8866016	8868151	A01p17560.2_BraZ1	1267.35	+	1237	2114	2135	0.9901639
A01	8876706	8883832	A01p17570.2_BraZ1	2269.48	+	2020	5673	7126	0.7960988
A01	8892734	8899887	A01p17580.2_BraZ1	2032.22	+	5890	7153	7153	1.0000000
A01	8900796	8902229	A01p17590.2_BraZ1	961.655	+	173	1229	1433	0.8576413
A01	8922946	8927070	A01p17600.2_BraZ1	1160.73	+	1561	4031	4124	0.9774491
A01	8927826	8929411	A01p17610.2_BraZ1	1390.11	-	614	1541	1585	0.9722397
A01	8933386	8933914	A01p17620.2_BraZ1	198	+	190	517	528	0.9791667
A01	8935004	8937728	A01p17630.2_BraZ1	272.4	+	287	1105	2724	0.4056534
A01	8938176	8939481	A01p17640.2_BraZ1	130.5	-	117	1259	1305	0.9647509
A01	8940153	8942754	A01p17650.2_BraZ1	1320.94	-	950	2366	2601	0.9096501
A01	8943385	8945599	A01p17660.2_BraZ1	1613.91	+	307	1936	2214	0.8744354
A01	8957260	8959605	A01p17670.2_BraZ1	818.182	+	1448	2333	2345	0.9948827
A01	8961423	8963751	A01p17680.2_BraZ1	1767.5	+	784	2304	2328	0.9896907
A01	8965460	8966315	A01p17690.2_BraZ1	85.5	-	330	783	855	0.9157895
A01	8967396	8968016	A01p17700.2_BraZ1	362.25	-	23	454	620	0.7322581
A01	8972984	8977270	A01p17710.2_BraZ1	1963.66	-	1507	3546	4286	0.8273448
A01	8984053	8985778	A01p17720.2_BraZ1	1083	+	517	1613	1725	0.9350725
A01	8986655	8987780	A01p17730.2_BraZ1	572.5	+	893	1086	1125	0.9653333
A01	8988485	8996972	A01p17740.2_BraZ1	1389	+	3038	6666	8487	0.7854366
A01	8997334	8998782	A01p17750.2_BraZ1	926.348	-	696	1301	1448	0.8984807
A01	9018742	9020348	A01p17760.2_BraZ1	1365.2	+	147	778	1606	0.4844334
A01	9032420	9032864	A01p17770.2_BraZ1	10680	-	468	444	444	1.0000000
A01	9033611	9034588	A01p17780.2_BraZ1	74.1	-	378	977	977	1.0000000
A01	9036297	9037381	A01p17790.2_BraZ1	843.839	-	663	1084	1084	1.0000000
A01	9038174	9039012	A01p17800.2_BraZ1	452.323	-	171	787	838	0.9391408
A01	9039319	9039592	A01p17810.2_BraZ1	213	-	355	273	273	1.0000000
A01	9043899	9046649	A01p17820.2_BraZ1	1325.7	-	1303	2668	2750	0.9701818
A01	9048434	9049424	A01p17830.2_BraZ1	99	-	457	717	990	0.7242424
A01	9059136	9059857	A01p17840.2_BraZ1	456	+	197	699	721	0.9694868
A01	9060044	9064351	A01p17850.2_BraZ1	1791.62	-	2524	4126	4307	0.9579754
A01	9070544	9070724	A01p17860.2_BraZ1	18	-	44	180	180	1.0000000
A01	9072095	9072413	A01p17870.2_BraZ1	31.8	-	8	222	318	0.6981132
A01	9075005	9076430	A01p17880.2_BraZ1	6129.9	+	958	1425	1425	1.0000000
A01	9078125	9080161	A01p17890.2_BraZ1	816.75	-	1109	1938	2036	0.9518664
A01	9080695	9086717	A01p17900.2_BraZ1	1278	-	3766	5207	6022	0.8646629
A01	9082556	9084406	A01p17910.2_BraZ1	720.177	+	1578	1792	1850	0.9686487
A01	9095567	9095780	A01p17920.2_BraZ1	21.3	-	21	213	213	1.0000000
A01	9096292	9097871	A01p17930.2_BraZ1	1296	-	355	1533	1579	0.9708676
A01	9101815	9102348	A01p17940.2_BraZ1	423	-	3254	533	533	1.0000000
A01	9106571	9108511	A01p17950.2_BraZ1	957	+	1446	1940	1940	1.0000000
A01	9108770	9110611	A01p17960.2_BraZ1	1323.42	-	725	1610	1841	0.8745247
A01	9112122	9114342	A01p17970.2_BraZ1	1370.46	+	10	355	2220	0.1599099
A01	9116589	9118795	A01p17980.2_BraZ1	1370.46	+	200	917	2206	0.4156845
A01	9121046	9123280	A01p17990.2_BraZ1	1370.46	+	53	344	2234	0.1539839
A01	9134288	9136524	A01p18000.2_BraZ1	2058.79	+	573	1969	2236	0.8805903
A01	9137497	9139097	A01p18010.2_BraZ1	1488	+	852	1600	1600	1.0000000
A01	9149814	9151327	A01p18020.2_BraZ1	706.609	+	766	1392	1513	0.9200264
A01	9151829	9154559	A01p18030.2_BraZ1	930	-	1650	2659	2730	0.9739926
A01	9157988	9158825	A01p18040.2_BraZ1	83.7	-	900	837	837	1.0000000
A01	9159543	9160365	A01p18050.2_BraZ1	584.25	-	785	822	822	1.0000000
A01	9163888	9164680	A01p18060.2_BraZ1	79.2	+	125	748	792	0.9444444
A01	9165873	9166923	A01p18070.2_BraZ1	105	-	332	1050	1050	1.0000000
A01	9167889	9173136	A01p18080.2_BraZ1	1220.56	+	1477	4970	5247	0.9472079
A01	9175410	9178758	A01p18090.2_BraZ1	3279	-	797	2939	3348	0.8778375
A01	9188775	9190319	A01p18100.2_BraZ1	671.13	-	944	1493	1544	0.9669689
A01	9191670	9193223	A01p18110.2_BraZ1	242.381	-	357	1499	1553	0.9652286
A01	9195320	9196670	A01p18120.2_BraZ1	603.171	-	905	1305	1350	0.9666666
A01	9198237	9199269	A01p18130.2_BraZ1	103.2	-	186	871	1032	0.8439922
A01	9202960	9205868	A01p18140.2_BraZ1	1752.27	-	199	1567	2908	0.5388583
A01	9210253	9210604	A01p18150.2_BraZ1	35.1	-	0	0	351	0.0000000
A01	9211889	9215475	A01p18160.2_BraZ1	1615	+	1762	3376	3586	0.9414389
A01	9218487	9220095	A01p18170.2_BraZ1	1533	+	427	1489	1608	0.9259951
A01	9220413	9222585	A01p18180.2_BraZ1	1332	-	588	1965	2172	0.9046961
A01	9225583	9229986	A01p18190.2_BraZ1	1971.43	-	2618	4264	4403	0.9684306
A01	9231660	9231966	A01p18200.2_BraZ1	30.6	+	8	143	306	0.4673203
A01	9232103	9232967	A01p18210.2_BraZ1	198	+	0	0	864	0.0000000
A01	9236191	9239004	A01p18220.2_BraZ1	1450.44	-	1634	2813	2813	1.0000000
A01	9254108	9255688	A01p18230.2_BraZ1	763.95	+	772	1580	1580	1.0000000
A01	9269395	9269578	A01p18240.2_BraZ1	18.3	-	2	42	183	0.2295082
A01	9271580	9272724	A01p18250.2_BraZ1	633	+	650	1136	1144	0.9930070
A01	9272973	9273547	A01p18260.2_BraZ1	264	-	215	574	574	1.0000000
A01	9273917	9279854	A01p18270.2_BraZ1	2819.87	+	1262	4366	5937	0.7353882
A01	9280536	9283442	A01p18280.2_BraZ1	2233.39	-	305	2208	2906	0.7598073
A01	9292314	9309689	A01p18290.2_BraZ1	2278.09	+	8607	16452	17375	0.9468777
A01	9310207	9310741	A01p18300.2_BraZ1	94.5	-	201	491	534	0.9194757
A01	9311036	9312453	A01p18310.2_BraZ1	738	-	917	1366	1417	0.9640085
A01	9312983	9319176	A01p18320.2_BraZ1	2263.84	-	4637	6111	6193	0.9867592
A01	9319444	9321409	A01p18330.2_BraZ1	1346.42	+	252	1515	1965	0.7709923
A01	9321703	9323198	A01p18340.2_BraZ1	991.583	-	834	1495	1495	1.0000000
A01	9325413	9327308	A01p18350.2_BraZ1	662.625	+	82	870	1895	0.4591029
A01	9328282	9330240	A01p18360.2_BraZ1	1527	+	134	1122	1958	0.5730337
A01	9330674	9331075	A01p18370.2_BraZ1	309	-	21	267	401	0.6658354
A01	9331723	9332729	A01p18380.2_BraZ1	295.786	+	712	1006	1006	1.0000000
A01	9336735	9338635	A01p18390.2_BraZ1	1223.44	-	632	1605	1900	0.8447368
A01	9338847	9339134	A01p18400.2_BraZ1	25.5	-	176	287	287	1.0000000
A01	9342327	9343888	A01p18410.2_BraZ1	669.038	-	509	1559	1561	0.9987188
A01	9344521	9346196	A01p18420.2_BraZ1	582	-	1006	1654	1675	0.9874627
A01	9349024	9350392	A01p18430.2_BraZ1	136.8	+	592	1349	1368	0.9861111
A01	9352228	9355611	A01p18440.2_BraZ1	1100.57	+	1142	3125	3383	0.9237363
A01	9365238	9365770	A01p18450.2_BraZ1	322	-	256	532	532	1.0000000
A01	9365874	9368842	A01p18460.2_BraZ1	2841	-	324	2559	2968	0.8621967
A01	9369372	9371497	A01p18470.2_BraZ1	532.98	+	539	2099	2125	0.9877647
A01	9371836	9374684	A01p18480.2_BraZ1	1134.71	-	546	2072	2848	0.7275281
A01	9375114	9377986	A01p18490.2_BraZ1	654.288	-	1070	2710	2872	0.9435933
A01	9378374	9387908	A01p18500.2_BraZ1	6693.47	+	3562	8939	9534	0.9375918
A01	9388275	9390697	A01p18510.2_BraZ1	1429.09	-	1226	2422	2422	1.0000000
A01	9391065	9391962	A01p18520.2_BraZ1	89.7	+	514	897	897	1.0000000
A01	9392132	9393636	A01p18530.2_BraZ1	740.081	-	483	1031	1504	0.6855053
A01	9396429	9396543	A01p18540.2_BraZ1	11.4	-	41	114	114	1.0000000
A01	9396978	9400534	A01p18550.2_BraZ1	2646	-	708	2865	3556	0.8056805
A01	9400800	9401267	A01p18560.2_BraZ1	249.375	+	563	467	467	1.0000000
A01	9402009	9403059	A01p18570.2_BraZ1	288.253	-	474	1030	1050	0.9809524
A01	9403616	9406251	A01p18580.2_BraZ1	1050.96	+	1302	2635	2635	1.0000000
A01	9407077	9411252	A01p18590.2_BraZ1	1852.18	-	1609	3685	4175	0.8826348
A01	9412759	9414691	A01p18600.2_BraZ1	499.224	-	1051	1919	1932	0.9932712
A01	9415129	9416387	A01p18610.2_BraZ1	236.143	-	509	1226	1258	0.9745628
A01	9417055	9417598	A01p18620.2_BraZ1	54.3	+	67	481	543	0.8858195
A01	9422811	9423354	A01p18630.2_BraZ1	54.3	+	108	431	543	0.7937385
A01	9431286	9431835	A01p18640.2_BraZ1	54.9	+	13	302	549	0.5500911
A01	9433436	9433979	A01p18650.2_BraZ1	54.3	+	125	526	543	0.9686924
A01	9440314	9440863	A01p18660.2_BraZ1	54.9	+	12	459	549	0.8360656
A01	9450482	9451022	A01p18670.2_BraZ1	54	+	151	540	540	1.0000000
A01	9452643	9456113	A01p18680.2_BraZ1	1788.62	-	1147	3369	3470	0.9708934
A01	9457606	9460108	A01p18690.2_BraZ1	336	+	318	2253	2502	0.9004796
A01	9461058	9463890	A01p18700.2_BraZ1	283.2	+	12	25	2832	0.0088277
A01	9481405	9484360	A01p18710.2_BraZ1	295.5	+	346	2122	2955	0.7181049
A01	9484837	9485438	A01p18720.2_BraZ1	399	-	154	601	601	1.0000000
A01	9487913	9489352	A01p18730.2_BraZ1	9394	+	393	1439	1439	1.0000000
A01	9496453	9499916	A01p18740.2_BraZ1	610	-	2952	3438	3463	0.9927808
A01	9507854	9507965	A01p18750.2_BraZ1	11.1	-	1	106	111	0.9549550
A01	9508840	9509145	A01p18760.2_BraZ1	207	-	0	0	305	0.0000000
A01	9536051	9538546	A01p18770.2_BraZ1	1865.27	+	235	1885	2495	0.7555110
A01	9547930	9550582	A01p18780.2_BraZ1	160	-	975	2008	2652	0.7571644
A01	9554967	9557991	A01p18790.2_BraZ1	11937.6	+	709	2265	3024	0.7490079
A01	9558143	9561423	A01p18800.2_BraZ1	19694.7	-	307	1669	3280	0.5088415
A01	9565792	9566638	A01p18810.2_BraZ1	693	+	201	790	846	0.9338061
A01	9567055	9567265	A01p18820.2_BraZ1	21	-	0	0	210	0.0000000
A01	9571685	9572456	A01p18830.2_BraZ1	77.1	-	147	684	771	0.8871595
A01	9573751	9574919	A01p18840.2_BraZ1	953.55	-	252	1024	1168	0.8767123
A01	9579040	9581811	A01p18850.2_BraZ1	1600.5	-	1090	2677	2771	0.9660772
A01	9583328	9584936	A01p18860.2_BraZ1	849	-	220	1199	1608	0.7456468
A01	9587698	9588217	A01p18870.2_BraZ1	306	+	61	399	519	0.7687861
A01	9595023	9595602	A01p18880.2_BraZ1	312	+	222	512	579	0.8842832
A01	9596412	9597492	A01p18890.2_BraZ1	857.85	-	278	1071	1080	0.9916667
A01	9601050	9603533	A01p18900.2_BraZ1	1917	-	277	1595	2483	0.6423681
A01	9614307	9615682	A01p18910.2_BraZ1	226.2	-	855	1375	1375	1.0000000
A01	9622765	9626853	A01p18920.2_BraZ1	2560.81	+	1930	3820	4088	0.9344423
A01	9628367	9629433	A01p18930.2_BraZ1	504.6	+	71	940	1066	0.8818011
A01	9630273	9659230	A01p18940.2_BraZ1	1143	+	18483	26801	28957	0.9255448
A01	9632531	9633748	A01p18950.2_BraZ1	775.147	-	50	873	1217	0.7173377
A01	9641532	9641910	A01p18960.2_BraZ1	171	+	181	378	378	1.0000000
A01	9656125	9657450	A01p18970.2_BraZ1	1161	+	142	1166	1325	0.8800000
A01	9658099	9658465	A01p18980.2_BraZ1	36.6	-	356	366	366	1.0000000
A01	9659663	9661613	A01p18990.2_BraZ1	129.6	-	1389	1950	1950	1.0000000
A01	9665960	9667635	A01p19000.2_BraZ1	964.105	+	2069	1675	1675	1.0000000
A01	9668419	9671075	A01p19010.2_BraZ1	1831.37	+	782	1996	2656	0.7515060
A01	9671387	9673995	A01p19020.2_BraZ1	2063.15	-	1023	2526	2608	0.9685583
A01	9674345	9674486	A01p19030.2_BraZ1	14.1	+	29	141	141	1.0000000
A01	9676760	9677705	A01p19040.2_BraZ1	333	-	682	945	945	1.0000000
A01	9679173	9680246	A01p19050.2_BraZ1	987	-	158	848	1073	0.7903075
A01	9681750	9681942	A01p19060.2_BraZ1	19.2	-	319	192	192	1.0000000
A01	9684646	9684796	A01p19070.2_BraZ1	15	-	369	150	150	1.0000000
A01	9686456	9687685	A01p19080.2_BraZ1	7584	-	258	1158	1229	0.9422294
A01	9690274	9690691	A01p19090.2_BraZ1	336	-	314	417	417	1.0000000
A01	9691287	9693744	A01p19100.2_BraZ1	1082.06	-	1345	2408	2457	0.9800570
A01	9694145	9694857	A01p19110.2_BraZ1	438	-	142	573	712	0.8047753
A01	9696760	9697414	A01p19120.2_BraZ1	65.4	-	746	654	654	1.0000000
A01	9699503	9700043	A01p19130.2_BraZ1	456	+	23	347	540	0.6425926
A01	9701634	9701757	A01p19140.2_BraZ1	12.3	+	204	123	123	1.0000000
A01	9702274	9704235	A01p19150.2_BraZ1	1110.04	-	791	1773	1961	0.9041305
A01	9705376	9706867	A01p19160.2_BraZ1	978.143	-	718	1415	1491	0.9490275
A01	9711490	9714332	A01p19170.2_BraZ1	1288.8	+	558	2359	2842	0.8300493
A01	9715137	9715561	A01p19180.2_BraZ1	333	+	0	0	424	0.0000000
A01	9717834	9718005	A01p19190.2_BraZ1	17.1	+	143	171	171	1.0000000
A01	9718317	9720843	A01p19200.2_BraZ1	1008.04	+	1044	2337	2526	0.9251782
A01	9729802	9731134	A01p19210.2_BraZ1	133.2	+	1386	1154	1332	0.8663664
A01	9731670	9733064	A01p19220.2_BraZ1	960	-	604	1361	1394	0.9763271
A01	9734630	9738556	A01p19230.2_BraZ1	1272.38	-	2703	3818	3926	0.9724911
A01	9739277	9744312	A01p19240.2_BraZ1	2928.37	-	1950	4944	5035	0.9819265
A01	9745268	9748928	A01p19250.2_BraZ1	1138.92	-	3725	3626	3660	0.9907104
A01	9750503	9752190	A01p19260.2_BraZ1	104.1	+	661	1596	1687	0.9460581
A01	9758540	9759710	A01p19270.2_BraZ1	116.4	+	1041	1170	1170	1.0000000
A01	9776222	9776384	A01p19280.2_BraZ1	16.2	+	178	162	162	1.0000000
A01	9777000	9777381	A01p19290.2_BraZ1	38.1	+	242	381	381	1.0000000
A01	9777919	9778108	A01p19300.2_BraZ1	18.9	+	127	189	189	1.0000000
A01	9779144	9780704	A01p19310.2_BraZ1	630.818	-	569	836	1560	0.5358974
A01	9780955	9781646	A01p19320.2_BraZ1	108.182	-	0	0	691	0.0000000
A01	9782393	9783084	A01p19330.2_BraZ1	357	-	0	0	691	0.0000000
A01	9785401	9787324	A01p19340.2_BraZ1	1088.7	+	511	1892	1923	0.9838793
A01	9787773	9788153	A01p19350.2_BraZ1	273	-	94	348	380	0.9157895
A01	9794216	9794543	A01p19360.2_BraZ1	32.7	+	97	308	327	0.9418960
A01	9800013	9800299	A01p19370.2_BraZ1	18.9	+	177	286	286	1.0000000
A01	9802866	9805611	A01p19380.2_BraZ1	1971.81	+	3641	2745	2745	1.0000000
A01	9809181	9809612	A01p19390.2_BraZ1	360	+	346	431	431	1.0000000
A01	9810016	9810205	A01p19400.2_BraZ1	18.9	+	109	189	189	1.0000000
A01	9810580	9811324	A01p19410.2_BraZ1	486	-	376	744	744	1.0000000
A01	9820278	9820633	A01p19420.2_BraZ1	1066.5	+	82	355	355	1.0000000
A01	9828513	9829845	A01p19430.2_BraZ1	715	+	915	1277	1332	0.9587087
A01	9830357	9830970	A01p19440.2_BraZ1	258.75	-	50	573	613	0.9347472
A01	9838353	9838638	A01p19450.2_BraZ1	63	+	125	285	285	1.0000000
A01	9840644	9842043	A01p19460.2_BraZ1	219.545	+	291	1220	1399	0.8720515
A01	9849769	9850538	A01p19470.2_BraZ1	675	-	34	476	769	0.6189857
A01	9851096	9855288	A01p19480.2_BraZ1	1083.73	+	1423	4051	4192	0.9663645
A01	9855547	9856678	A01p19490.2_BraZ1	603.171	-	431	1131	1131	1.0000000
A01	9858466	9860703	A01p19500.2_BraZ1	1346.41	+	644	1868	2237	0.8350469
A01	9863348	9865522	A01p19510.2_BraZ1	1346.41	+	633	1961	2174	0.9020239
A01	9865960	9868662	A01p19520.2_BraZ1	2099.5	-	934	2491	2702	0.9219097
A01	9871624	9873156	A01p19530.2_BraZ1	553.333	-	1074	1532	1532	1.0000000
A01	9882587	9882993	A01p19540.2_BraZ1	318	+	37	304	406	0.7487684
A01	9884049	9884916	A01p19550.2_BraZ1	324	+	235	763	867	0.8800461
A01	9885383	9887014	A01p19560.2_BraZ1	897.136	+	300	1459	1631	0.8945432
A01	9887946	9890469	A01p19570.2_BraZ1	959.933	+	1015	1954	2523	0.7744749
A01	9891584	9893347	A01p19580.2_BraZ1	974.28	+	384	1614	1763	0.9154850
A01	9893768	9895178	A01p19590.2_BraZ1	978.75	+	18	327	1410	0.2319149
A01	9899024	9899743	A01p19600.2_BraZ1	585	-	14	350	719	0.4867872
A01	9907625	9907751	A01p19610.2_BraZ1	12.6	+	259	126	126	1.0000000
A01	9909191	9912265	A01p19620.2_BraZ1	1740	+	4099	2996	3074	0.9746259
A01	9912631	9914950	A01p19630.2_BraZ1	1649.38	+	548	2147	2319	0.9258301
A01	9924278	9928009	A01p19640.2_BraZ1	1952.78	+	1735	3594	3731	0.9632806
A01	9928833	9930003	A01p19650.2_BraZ1	96.9	+	312	1085	1170	0.9273504
A01	9931210	9932200	A01p19660.2_BraZ1	1740	+	222	866	990	0.8747475
A01	9937169	9937945	A01p19670.2_BraZ1	541.786	+	355	771	776	0.9935567
A01	9943171	9945440	A01p19680.2_BraZ1	1173.48	+	1898	2244	2269	0.9889819
A01	9946031	9947165	A01p19690.2_BraZ1	252.29	-	78	925	1134	0.8156967
A01	9966327	9967341	A01p19700.2_BraZ1	101.4	-	150	886	1014	0.8737673
A01	9976702	9981564	A01p19710.2_BraZ1	973.714	-	2635	4365	4862	0.8977787
A01	9992451	9992601	A01p19720.2_BraZ1	15	-	2	19	150	0.1266667
A01	9993269	9997278	A01p19730.2_BraZ1	2409.29	+	2473	3856	4009	0.9618359
A01	9997828	9998391	A01p19740.2_BraZ1	399	-	367	563	563	1.0000000
A01	10000838	10001649	A01p19750.2_BraZ1	582	+	397	811	811	1.0000000
A01	10009452	10012635	A01p19760.2_BraZ1	678.261	-	2707	3183	3183	1.0000000
A01	10014382	10014844	A01p19770.2_BraZ1	381	-	39	257	462	0.5562770
A01	10016316	10017739	A01p19780.2_BraZ1	844.667	+	310	1383	1423	0.9718904
A01	10018047	10019105	A01p19790.2_BraZ1	795	-	80	570	1058	0.5387524
A01	10019486	10019862	A01p19800.2_BraZ1	330	-	434	376	376	1.0000000
A01	10020701	10023107	A01p19810.2_BraZ1	1357.88	+	537	2277	2406	0.9463840
A01	10023703	10023952	A01p19820.2_BraZ1	24.9	+	30	249	249	1.0000000
A01	10027193	10027436	A01p19830.2_BraZ1	24.3	+	157	237	243	0.9753087
A01	10028057	10028394	A01p19840.2_BraZ1	234	-	115	337	337	1.0000000
A01	10030756	10032094	A01p19850.2_BraZ1	909	-	301	1067	1338	0.7974589
A01	10033835	10035028	A01p19860.2_BraZ1	840	-	160	1188	1193	0.9958089
A01	10039081	10039839	A01p19870.2_BraZ1	399	+	0	0	758	0.0000000
A01	10041042	10041924	A01p19880.2_BraZ1	88.2	-	116	796	882	0.9024943
A01	10043490	10043850	A01p19890.2_BraZ1	36	+	589	360	360	1.0000000
A01	10044188	10044356	A01p19900.2_BraZ1	16.8	-	210	168	168	1.0000000
A01	10044612	10045451	A01p19910.2_BraZ1	336	+	220	829	839	0.9880810
A01	10045798	10046575	A01p19920.2_BraZ1	77.7	-	140	541	777	0.6962677
A01	10048577	10049991	A01p19930.2_BraZ1	5246	+	491	1411	1414	0.9978784
A01	10051399	10052646	A01p19940.2_BraZ1	1032	+	546	1247	1247	1.0000000
A01	10053805	10053992	A01p19950.2_BraZ1	13.5	+	242	157	187	0.8395722
A01	10054900	10056073	A01p19960.2_BraZ1	117.3	-	210	991	1173	0.8448423
A01	10056773	10057034	A01p19970.2_BraZ1	26.1	-	98	174	261	0.6666667
A01	10071061	10072510	A01p19980.2_BraZ1	734.923	-	100	757	1449	0.5224293
A01	10084046	10084667	A01p19990.2_BraZ1	62.1	-	81	226	621	0.3639292
A01	10089684	10090416	A01p20000.2_BraZ1	469.091	+	51	358	732	0.4890710
A01	10096162	10096600	A01p20010.2_BraZ1	240	-	140	418	438	0.9543379
A01	10098731	10100309	A01p20020.2_BraZ1	1425	+	1123	1578	1578	1.0000000
A01	10102110	10102656	A01p20030.2_BraZ1	54.6	+	218	546	546	1.0000000
A01	10102816	10104481	A01p20040.2_BraZ1	1296	-	234	1246	1665	0.7483484
A01	10110037	10110847	A01p20050.2_BraZ1	81	-	56	680	810	0.8395061
A01	10123649	10123910	A01p20060.2_BraZ1	26.1	+	60	184	261	0.7049809
A01	10134192	10134569	A01p20070.2_BraZ1	204	-	241	377	377	1.0000000
A01	10138822	10140038	A01p20080.2_BraZ1	879.545	+	44	359	1216	0.2952303
A01	10151840	10153297	A01p20090.2_BraZ1	2469.6	-	1076	1457	1457	1.0000000
A01	10154397	10155144	A01p20100.2_BraZ1	633	-	43	480	747	0.6425703
A01	10157735	10158968	A01p20110.2_BraZ1	123.3	-	84	901	1233	0.7307380
A01	10159611	10162381	A01p20120.2_BraZ1	363.071	+	2477	2489	2770	0.8985559
A01	10162632	10163487	A01p20130.2_BraZ1	207.375	-	1530	855	855	1.0000000
A01	10164632	10166259	A01p20140.2_BraZ1	905.905	+	962	1439	1627	0.8844499
A01	10167497	10169004	A01p20150.2_BraZ1	692.778	+	603	1482	1507	0.9834108
A01	10174199	10175293	A01p20160.2_BraZ1	762.286	-	35	386	1094	0.3528336
A01	10186254	10188837	A01p20170.2_BraZ1	522.5	-	2746	2561	2583	0.9914828
A01	10188865	10190535	A01p20180.2_BraZ1	297	+	1076	1670	1670	1.0000000
A01	10196895	10197183	A01p20190.2_BraZ1	28.8	+	537	288	288	1.0000000
A01	10198962	10200384	A01p20200.2_BraZ1	1285.71	+	110	1167	1422	0.8206751
A01	10201107	10201212	A01p20210.2_BraZ1	10.5	+	23	105	105	1.0000000
A01	10209013	10210582	A01p20220.2_BraZ1	156.9	+	333	1270	1569	0.8094327
A01	10211163	10212958	A01p20230.2_BraZ1	791.267	+	566	1600	1795	0.8913649
A01	10215158	10216658	A01p20240.2_BraZ1	150	-	3985	1500	1500	1.0000000
A01	10219841	10235678	A01p20250.2_BraZ1	5481	-	9812	12335	15837	0.7788723
A01	10241011	10246822	A01p20260.2_BraZ1	2246.56	-	1811	5094	5811	0.8766133
A01	10248082	10249798	A01p20270.2_BraZ1	925.179	+	1345	1716	1716	1.0000000
A01	10250184	10251913	A01p20280.2_BraZ1	1111	-	835	1717	1729	0.9930596
A01	10253791	10254666	A01p20290.2_BraZ1	753	-	268	836	875	0.9554286
A01	10260890	10261942	A01p20300.2_BraZ1	228.231	+	599	1052	1052	1.0000000
A01	10272575	10274107	A01p20310.2_BraZ1	8037	-	202	1231	1532	0.8035248
A01	10282336	10283456	A01p20320.2_BraZ1	561	+	28	69	1120	0.0616071
A01	10287478	10290386	A01p20330.2_BraZ1	1611.43	-	1230	2856	2908	0.9821183
A01	10291610	10292987	A01p20340.2_BraZ1	1126.57	+	169	1130	1377	0.8206245
A01	10293361	10294436	A01p20350.2_BraZ1	270.4	-	952	1068	1075	0.9934884
A01	10294497	10295545	A01p20360.2_BraZ1	317.25	-	753	1048	1048	1.0000000
A01	10297821	10299452	A01p20370.2_BraZ1	3948.75	-	387	1346	1631	0.8252606
A01	10302347	10306355	A01p20380.2_BraZ1	1394.25	+	1926	4008	4008	1.0000000
A01	10303984	10304434	A01p20390.2_BraZ1	228	+	388	450	450	1.0000000
A01	10306679	10307263	A01p20400.2_BraZ1	237	+	0	0	584	0.0000000
A01	10307427	10309412	A01p20410.2_BraZ1	679	+	142	571	1985	0.2876574
A01	10310706	10312609	A01p20420.2_BraZ1	982.159	+	583	1644	1903	0.8638991
A01	10318663	10320274	A01p20430.2_BraZ1	161.1	+	459	1611	1611	1.0000000
A01	10321903	10324276	A01p20440.2_BraZ1	1238.57	+	404	1961	2373	0.8263801
A01	10324749	10330549	A01p20450.2_BraZ1	473.538	-	415	1584	5800	0.2731034
A01	10332518	10334181	A01p20460.2_BraZ1	990.47	+	1006	1491	1663	0.8965725
A01	10334528	10336163	A01p20470.2_BraZ1	10941	+	360	1294	1635	0.7914373
A01	10336375	10337929	A01p20480.2_BraZ1	1428	-	296	1356	1554	0.8725868
A01	10342956	10344331	A01p20490.2_BraZ1	659.351	+	632	1332	1375	0.9687273
A01	10347567	10348239	A01p20500.2_BraZ1	417	-	0	0	672	0.0000000
A01	10349430	10351323	A01p20510.2_BraZ1	1636.59	+	400	1758	1893	0.9286847
A01	10352583	10353701	A01p20520.2_BraZ1	2142	+	300	1118	1118	1.0000000
A01	10354859	10356907	A01p20530.2_BraZ1	1414.45	-	383	1912	2048	0.9335938
A01	10359629	10360436	A01p20540.2_BraZ1	80.7	-	8	389	807	0.4820322
A01	10366047	10369874	A01p20550.2_BraZ1	1527.86	+	959	3009	3827	0.7862555
A01	10370262	10375380	A01p20560.2_BraZ1	951.349	-	3848	5118	5118	1.0000000
A01	10375747	10383087	A01p20570.2_BraZ1	742.176	+	1604	4603	7340	0.6271117
A01	10390120	10391543	A01p20580.2_BraZ1	681.286	+	354	1362	1423	0.9571328
A01	10393129	10400435	A01p20590.2_BraZ1	2091.44	+	20590	6502	7306	0.8899534
A01	10400910	10402206	A01p20600.2_BraZ1	443.294	-	181	856	1296	0.6604939
A01	10403478	10406107	A01p20610.2_BraZ1	1390.71	+	304	2058	2629	0.7828072
A01	10412501	10412929	A01p20620.2_BraZ1	39.9	+	206	427	428	0.9976636
A01	10413896	10416555	A01p20630.2_BraZ1	1700.39	+	430	1938	2659	0.7288454
A01	10419118	10420389	A01p20640.2_BraZ1	727.5	-	315	1094	1271	0.8607396
A01	10422346	10426723	A01p20650.2_BraZ1	2542.86	+	3042	4170	4377	0.9527074
A01	10427564	10430031	A01p20660.2_BraZ1	120.9	-	1320	2452	2467	0.9939197
A01	10430162	10432109	A01p20670.2_BraZ1	194.7	-	383	1788	1947	0.9183359
A01	10432618	10439671	A01p20680.2_BraZ1	1008	-	7626	6941	7053	0.9841202
A01	10441209	10442748	A01p20690.2_BraZ1	153.9	-	114	1002	1539	0.6510721
A01	10462699	10464580	A01p20700.2_BraZ1	201	-	1898	1652	1881	0.8782563
A01	10468864	10471800	A01p20710.2_BraZ1	1055.97	+	487	2412	2936	0.8215259
A01	10476954	10477676	A01p20720.2_BraZ1	1950	-	3	277	722	0.3836565
A01	10477638	10478441	A01p20730.2_BraZ1	549.25	-	143	613	803	0.7633873
A01	10486118	10487555	A01p20740.2_BraZ1	143.7	+	507	1390	1437	0.9672930
A01	10488825	10489892	A01p20750.2_BraZ1	858	-	44	686	1067	0.6429241
A01	10500636	10500819	A01p20760.2_BraZ1	18.3	-	473	183	183	1.0000000
A01	10519539	10520256	A01p20770.2_BraZ1	354	-	487	690	717	0.9623431
A01	10521642	10523672	A01p20780.2_BraZ1	497.647	+	2622	2030	2030	1.0000000
A01	10531718	10531915	A01p20790.2_BraZ1	135	+	217	197	197	1.0000000
A01	10535103	10538639	A01p20800.2_BraZ1	1841.54	+	918	3143	3536	0.8888575
A01	10547671	10548217	A01p20810.2_BraZ1	54.6	+	59	241	546	0.4413919
A01	10559564	10560604	A01p20820.2_BraZ1	207	+	452	1040	1040	1.0000000
A01	10563319	10565292	A01p20830.2_BraZ1	3507.23	+	852	1973	1973	1.0000000
A01	10565190	10567090	A01p20840.2_BraZ1	4881.75	+	1328	1900	1900	1.0000000
A01	10566997	10567510	A01p20850.2_BraZ1	262.5	+	281	513	513	1.0000000
A01	10567944	10569175	A01p20860.2_BraZ1	448.5	+	415	1231	1231	1.0000000
A01	10569554	10570242	A01p20870.2_BraZ1	1610	-	394	688	688	1.0000000
A01	10570116	10571298	A01p20880.2_BraZ1	10987.5	-	1071	1182	1182	1.0000000
A01	10586271	10588362	A01p20890.2_BraZ1	1549.83	-	806	1873	2091	0.8957437
A01	10596680	10600139	A01p20900.2_BraZ1	1315.26	-	973	2878	3459	0.8320324
A01	10622884	10623971	A01p20910.2_BraZ1	3950.19	+	353	1047	1087	0.9632015
A01	10624608	10625296	A01p20920.2_BraZ1	520.788	-	368	684	688	0.9941860
A01	10625801	10628011	A01p20930.2_BraZ1	1271.1	+	1466	2117	2210	0.9579185
A01	10629022	10629265	A01p20940.2_BraZ1	204	-	292	243	243	1.0000000
A01	10631739	10632852	A01p20950.2_BraZ1	804.375	+	979	1113	1113	1.0000000
A01	10637972	10640687	A01p20960.2_BraZ1	270.6	+	543	1931	2715	0.7112339
A01	10641026	10643629	A01p20970.2_BraZ1	1115.92	-	1442	2375	2603	0.9124088
A01	10648752	10652674	A01p20980.2_BraZ1	621.094	-	1996	3621	3922	0.9232534
A01	10652890	10653282	A01p20990.2_BraZ1	237	-	275	392	392	1.0000000
A01	10653877	10656441	A01p21000.2_BraZ1	1623.6	-	995	2556	2564	0.9968799
A01	10682173	10683250	A01p21010.2_BraZ1	107.7	+	111	374	1077	0.3472609
A01	10684284	10690395	A01p21020.2_BraZ1	1187.51	+	3652	5986	6111	0.9795451
A01	10691631	10692016	A01p21030.2_BraZ1	330	-	183	385	385	1.0000000
A01	10699970	10700573	A01p21040.2_BraZ1	60.3	-	259	546	603	0.9054726
A01	10705080	10709344	A01p21050.2_BraZ1	1467	-	1358	3117	4264	0.7310038
A01	10712362	10713766	A01p21060.2_BraZ1	140.4	+	308	1226	1404	0.8732194
A01	10714399	10718267	A01p21070.2_BraZ1	1709.33	-	2425	3497	3868	0.9040848
A01	10719333	10720455	A01p21080.2_BraZ1	402.972	+	406	986	1122	0.8787879
A01	10721856	10722731	A01p21090.2_BraZ1	168	+	489	875	875	1.0000000
A01	10724494	10726111	A01p21100.2_BraZ1	161.7	+	195	1498	1617	0.9264069
A01	10729088	10729932	A01p21110.2_BraZ1	1287	+	217	844	844	1.0000000
A01	10730961	10732179	A01p21120.2_BraZ1	997.5	+	593	1154	1218	0.9474549
A01	10741248	10741542	A01p21130.2_BraZ1	15.9	-	461	294	294	1.0000000
A01	10742724	10743206	A01p21140.2_BraZ1	288	-	23	226	482	0.4688797
A01	10752402	10752942	A01p21150.2_BraZ1	54	-	15	341	540	0.6314815
A01	10755301	10755472	A01p21160.2_BraZ1	17.1	-	76	171	171	1.0000000
A01	10755689	10756608	A01p21170.2_BraZ1	268.412	+	946	919	919	1.0000000
A01	10758223	10761192	A01p21180.2_BraZ1	495.6	-	1779	2898	2969	0.9760862
A01	10762844	10763176	A01p21190.2_BraZ1	18.9	+	355	332	332	1.0000000
A01	10763859	10765370	A01p21200.2_BraZ1	345	+	1557	1511	1511	1.0000000
A01	10771134	10771482	A01p21210.2_BraZ1	34.8	+	80	348	348	1.0000000
A01	10774475	10774814	A01p21220.2_BraZ1	33.9	+	23	191	339	0.5634218
A01	10783016	10783534	A01p21230.2_BraZ1	348	-	450	518	518	1.0000000
A01	10789214	10790788	A01p21240.2_BraZ1	1407	+	201	1221	1574	0.7757306
A01	10791567	10793381	A01p21250.2_BraZ1	1746	-	145	1189	1814	0.6554576
A01	10798688	10800397	A01p21260.2_BraZ1	19332	+	718	1564	1709	0.9151551
A01	10800744	10804502	A01p21270.2_BraZ1	6905.25	-	915	2734	3758	0.7275146
A01	10816056	10816581	A01p21280.2_BraZ1	972	-	66	470	525	0.8952381
A01	10827172	10827557	A01p21290.2_BraZ1	321	-	48	303	385	0.7870130
A01	10828962	10829343	A01p21300.2_BraZ1	38.1	-	2	116	381	0.3044620
A01	10832160	10832739	A01p21310.2_BraZ1	57.9	-	253	573	579	0.9896373
A01	10833783	10834345	A01p21320.2_BraZ1	489	-	93	557	562	0.9911032
A01	10835227	10835465	A01p21330.2_BraZ1	19.2	+	174	238	238	1.0000000
A01	10847893	10849608	A01p21340.2_BraZ1	1928.5	+	2056	1712	1715	0.9982507
A01	10855342	10856339	A01p21350.2_BraZ1	618	+	1031	997	997	1.0000000
A01	10857721	10859884	A01p21360.2_BraZ1	1290	+	976	1874	2163	0.8663893
A01	10860185	10861562	A01p21370.2_BraZ1	137.7	-	225	749	1377	0.5439361
A01	10880022	10880567	A01p21380.2_BraZ1	279	+	295	545	545	1.0000000
A01	10880743	10887385	A01p21390.2_BraZ1	654	-	2441	6355	6642	0.9567901
A01	10881906	10882310	A01p21400.2_BraZ1	35.1	-	46	313	404	0.7747525
A01	10884284	10885277	A01p21410.2_BraZ1	304.5	-	207	971	993	0.9778449
A01	10887820	10889923	A01p21420.2_BraZ1	210.3	-	238	1416	2103	0.6733238
A01	10890700	10892026	A01p21430.2_BraZ1	81.3	-	574	1326	1326	1.0000000
A01	10896493	10896713	A01p21440.2_BraZ1	120	-	269	220	220	1.0000000
A01	10898554	10899829	A01p21450.2_BraZ1	477	-	682	1275	1275	1.0000000
A01	10904529	10918016	A01p21460.2_BraZ1	5198.41	+	5558	11693	13487	0.8669830
A01	10918661	10919928	A01p21470.2_BraZ1	1025.28	+	285	1142	1267	0.9013417
A01	10920821	10927719	A01p21480.2_BraZ1	2117.36	+	489	3140	6898	0.4552044
A01	10934667	10936072	A01p21490.2_BraZ1	1089.43	-	236	846	1405	0.6021352
A01	10937524	10938865	A01p21500.2_BraZ1	334.048	+	519	1341	1341	1.0000000
A01	10942757	10944558	A01p21510.2_BraZ1	1074	+	321	1442	1801	0.8006663
A01	10955033	10957756	A01p21520.2_BraZ1	2211.32	-	880	2551	2723	0.9368344
A01	10963838	10965594	A01p21530.2_BraZ1	885.163	+	849	1689	1756	0.9618451
A01	10970360	10971347	A01p21540.2_BraZ1	948	+	12726	987	987	1.0000000
A01	10975463	10977422	A01p21550.2_BraZ1	1047.96	-	306	1246	1959	0.6360388
A01	10977731	10982584	A01p21560.2_BraZ1	2357.44	+	751	2830	4853	0.5831444
A01	10982906	10986004	A01p21570.2_BraZ1	286.2	-	277	1772	3098	0.5719819
A01	10986191	10986863	A01p21580.2_BraZ1	67.2	-	86	564	672	0.8392857
A01	10988757	10990031	A01p21590.2_BraZ1	428.4	-	636	1274	1274	1.0000000
A01	10990433	10997731	A01p21600.2_BraZ1	1435.89	+	5668	7298	7298	1.0000000
A01	11007965	11012330	A01p21610.2_BraZ1	2062.5	+	1521	4144	4365	0.9493700
A01	11020152	11021893	A01p21620.2_BraZ1	317.143	+	692	1741	1741	1.0000000
A01	11034592	11034900	A01p21630.2_BraZ1	225	-	40	129	308	0.4188312
A01	11046866	11053901	A01p21640.2_BraZ1	778.909	+	4661	6934	7035	0.9856432
A01	11054332	11055543	A01p21650.2_BraZ1	390.25	+	785	1211	1211	1.0000000
A01	11055545	11055849	A01p21660.2_BraZ1	29.1	-	302	304	304	1.0000000
A01	11058336	11061133	A01p21670.2_BraZ1	1538.21	+	789	2455	2797	0.8777261
A01	11068071	11068883	A01p21680.2_BraZ1	540	+	485	812	812	1.0000000
A01	11071337	11072023	A01p21690.2_BraZ1	51.6	-	25	399	686	0.5816327
A01	11073215	11079812	A01p21700.2_BraZ1	2023.12	-	926	4823	6597	0.7310899
A01	11086258	11087381	A01p21710.2_BraZ1	2560	+	126	905	1123	0.8058771
A01	11092941	11094951	A01p21720.2_BraZ1	417.6	+	1157	1964	2010	0.9771144
A01	11097034	11098237	A01p21730.2_BraZ1	457.909	-	800	1202	1203	0.9991688
A01	11100407	11102871	A01p21740.2_BraZ1	1983	+	539	1641	2464	0.6659902
A01	11103643	11106211	A01p21750.2_BraZ1	1639.66	-	284	1838	2568	0.7157321
A01	11131353	11132793	A01p21760.2_BraZ1	1287	-	155	757	1440	0.5256944
A01	11142882	11143249	A01p21770.2_BraZ1	243	+	63	367	367	1.0000000
A01	11156846	11157148	A01p21780.2_BraZ1	162	+	228	302	302	1.0000000
A01	11167331	11167592	A01p21790.2_BraZ1	26.1	-	636	261	261	1.0000000
A01	11173365	11173785	A01p21800.2_BraZ1	41.4	+	782	420	420	1.0000000
A01	11176777	11178070	A01p21810.2_BraZ1	261.545	+	985	1293	1293	1.0000000
A01	11178124	11178496	A01p21820.2_BraZ1	204	+	307	372	372	1.0000000
A01	11183512	11183650	A01p21830.2_BraZ1	13.8	-	178	138	138	1.0000000
A01	11188405	11190367	A01p21840.2_BraZ1	196.2	-	223	1681	1962	0.8567788
A01	11204375	11211680	A01p21850.2_BraZ1	710.769	-	2411	6372	7305	0.8722793
A01	11215714	11216092	A01p21860.2_BraZ1	37.8	-	50	65	378	0.1719577
A01	11225200	11225862	A01p21870.2_BraZ1	300	-	755	662	662	1.0000000
A01	11227960	11228873	A01p21880.2_BraZ1	205.2	-	1144	913	913	1.0000000
A01	11232404	11234024	A01p21890.2_BraZ1	311.114	-	2806	1249	1620	0.7709876
A01	11238687	11239518	A01p21900.2_BraZ1	393	-	13	230	831	0.2767750
A01	11240602	11243364	A01p21910.2_BraZ1	1523.45	-	1075	2725	2762	0.9866039
A01	11245175	11245598	A01p21920.2_BraZ1	42.3	+	380	423	423	1.0000000
A01	11255341	11258572	A01p21930.2_BraZ1	1585.86	+	1461	3032	3231	0.9384091
A01	11258806	11259661	A01p21940.2_BraZ1	85.5	+	417	855	855	1.0000000
A01	11260675	11269049	A01p21950.2_BraZ1	2373.92	+	5762	8307	8374	0.9919990
A01	11270003	11271580	A01p21960.2_BraZ1	411.524	-	1293	1577	1577	1.0000000
A01	11272392	11277456	A01p21970.2_BraZ1	2270.15	-	2139	4964	5064	0.9802527
A01	11279540	11279814	A01p21980.2_BraZ1	17.1	+	40	274	274	1.0000000
A01	11280307	11280692	A01p21990.2_BraZ1	234	+	0	0	385	0.0000000
A01	11282018	11282189	A01p22000.2_BraZ1	17.1	+	87	171	171	1.0000000
A01	11292270	11292655	A01p22010.2_BraZ1	234	-	0	0	385	0.0000000
A01	11293101	11293719	A01p22020.2_BraZ1	61.8	+	147	498	618	0.8058252
A01	11299169	11301054	A01p22030.2_BraZ1	641.125	+	1283	1878	1885	0.9962865
A01	11302155	11302719	A01p22040.2_BraZ1	56.4	-	169	564	564	1.0000000
A01	11304243	11305145	A01p22050.2_BraZ1	106.465	+	42	329	902	0.3647450
A01	11306870	11307971	A01p22060.2_BraZ1	726.364	+	2	265	1101	0.2406903
A01	11310190	11310975	A01p22070.2_BraZ1	705	+	512	679	785	0.8649682
A01	11321405	11328049	A01p22080.2_BraZ1	1218	-	6204	5464	6644	0.8223962
A01	11328453	11328952	A01p22090.2_BraZ1	390	+	899	499	499	1.0000000
A01	11332787	11334108	A01p22100.2_BraZ1	110.7	+	81	654	1321	0.4950795
A01	11341301	11348430	A01p22110.2_BraZ1	1168.36	+	596	4224	7129	0.5925094
A01	11352660	11353366	A01p22120.2_BraZ1	351	+	479	706	706	1.0000000
A01	11358303	11362719	A01p22130.2_BraZ1	2517.12	+	1325	3954	4416	0.8953804
A01	11365305	11365614	A01p22140.2_BraZ1	30.9	-	124	309	309	1.0000000
A01	11374565	11374874	A01p22150.2_BraZ1	30.9	-	53	309	309	1.0000000
A01	11378834	11379158	A01p22160.2_BraZ1	32.4	-	6	149	324	0.4598765
A01	11383901	11384210	A01p22170.2_BraZ1	30.9	-	232	309	309	1.0000000
A01	11386914	11388420	A01p22180.2_BraZ1	657	-	1548	1506	1506	1.0000000
A01	11390072	11390387	A01p22190.2_BraZ1	31.5	-	277	315	315	1.0000000
A01	11397741	11404747	A01p22200.2_BraZ1	679.63	+	3132	6216	7006	0.8872395
A01	11401504	11401933	A01p22210.2_BraZ1	42.9	+	166	429	429	1.0000000
A01	11405151	11409798	A01p22220.2_BraZ1	2304.92	-	1623	4413	4647	0.9496449
A01	11410861	11411941	A01p22230.2_BraZ1	728.87	-	167	784	1080	0.7259259
A01	11414159	11417167	A01p22240.2_BraZ1	1417.85	-	692	2651	3008	0.8813165
A01	11425116	11426550	A01p22250.2_BraZ1	143.4	+	466	1284	1434	0.8953975
A01	11427183	11428918	A01p22260.2_BraZ1	848.077	-	562	1690	1735	0.9740634
A01	11429696	11430086	A01p22270.2_BraZ1	297.808	-	198	390	390	1.0000000
A01	11433423	11435998	A01p22280.2_BraZ1	251.625	+	2434	2575	2575	1.0000000
A01	11450121	11450284	A01p22290.2_BraZ1	13.5	-	1	30	163	0.1840491
A01	11456024	11457805	A01p22300.2_BraZ1	927.063	+	1750	1766	1781	0.9915777
A01	11459893	11465966	A01p22310.2_BraZ1	2624.91	+	1176	5711	6073	0.9403919
A01	11466493	11467797	A01p22320.2_BraZ1	663	-	124	1143	1304	0.8765337
A01	11468518	11469682	A01p22330.2_BraZ1	816	-	124	1007	1164	0.8651203
A01	11470084	11474919	A01p22340.2_BraZ1	2685.12	-	1007	3945	4835	0.8159255
A01	11479184	11480723	A01p22350.2_BraZ1	108.3	+	0	0	1539	0.0000000
A01	11490805	11496973	A01p22360.2_BraZ1	2832	+	3182	4077	6168	0.6609922
A01	11507099	11519018	A01p22370.2_BraZ1	746.429	-	200	5474	11919	0.4592667
A01	11520358	11521579	A01p22380.2_BraZ1	1068	+	21	361	1221	0.2956593
A01	11524589	11526996	A01p22390.2_BraZ1	268.8	+	1631	2407	2407	1.0000000
A01	11534738	11535029	A01p22400.2_BraZ1	29.1	-	87	291	291	1.0000000
A01	11552175	11553624	A01p22410.2_BraZ1	144.9	+	163	1186	1449	0.8184955
A01	11557800	11559237	A01p22420.2_BraZ1	143.1	+	530	1437	1437	1.0000000
A01	11564428	11566401	A01p22430.2_BraZ1	1034.17	-	408	1543	1973	0.7820578
A01	11567657	11568191	A01p22440.2_BraZ1	202.5	+	13	51	534	0.0955056
A01	11567987	11569795	A01p22450.2_BraZ1	386.88	+	55	185	1808	0.1023230
A01	11570930	11571452	A01p22460.2_BraZ1	1548	+	13	197	522	0.3773946
A01	11572578	11572887	A01p22470.2_BraZ1	30.9	-	8	51	309	0.1650485
A01	11574140	11575215	A01p22480.2_BraZ1	246.25	+	123	353	1075	0.3283721
A01	11575200	11575515	A01p22490.2_BraZ1	30	+	3	83	315	0.2634921
A01	11581780	11583790	A01p22500.2_BraZ1	4368.75	-	32	124	2010	0.0616915
A01	11583741	11584729	A01p22510.2_BraZ1	90.3	-	169	721	988	0.7297571
A01	11588087	11590478	A01p22520.2_BraZ1	239.1	+	187	1210	2391	0.5060644
A01	11590616	11593711	A01p22530.2_BraZ1	2022.34	-	168	1625	3095	0.5250404
A01	11602287	11603328	A01p22540.2_BraZ1	270.692	-	167	894	1041	0.8587896
A01	11603893	11608141	A01p22550.2_BraZ1	316.071	+	1188	3809	4248	0.8966572
A01	11611258	11612836	A01p22560.2_BraZ1	873.3	-	44	727	1578	0.4607098
A01	11617571	11619129	A01p22570.2_BraZ1	1488	-	336	1462	1558	0.9383826
A01	11628466	11632819	A01p22580.2_BraZ1	1380.65	-	1611	3118	4353	0.7162876
A01	11636746	11636905	A01p22590.2_BraZ1	15.9	+	170	159	159	1.0000000
A01	11666833	11666985	A01p22600.2_BraZ1	13.8	-	974	152	152	1.0000000
A01	11667016	11667835	A01p22610.2_BraZ1	522	-	1411	819	819	1.0000000
A01	11680198	11681524	A01p22620.2_BraZ1	131.7	+	185	1168	1326	0.8808447
A01	11682075	11683428	A01p22630.2_BraZ1	134.4	+	16	263	1353	0.1943828
A01	11687489	11688941	A01p22640.2_BraZ1	144.9	-	221	1202	1452	0.8278237
A01	11690682	11690832	A01p22650.2_BraZ1	15	-	0	0	150	0.0000000
A01	11696519	11699386	A01p22660.2_BraZ1	2205	-	91	633	2867	0.2207883
A01	11699642	11701455	A01p22670.2_BraZ1	218.147	+	74	717	1813	0.3954771
A01	11703660	11703951	A01p22680.2_BraZ1	29.1	+	375	291	291	1.0000000
A01	11707549	11707843	A01p22690.2_BraZ1	29.4	-	13	160	294	0.5442177
A01	11715156	11716800	A01p22700.2_BraZ1	1419	+	332	1431	1644	0.8704380
A01	11717725	11720582	A01p22710.2_BraZ1	602.344	+	745	2199	2857	0.7696885
A01	11720485	11720924	A01p22720.2_BraZ1	34.2	+	328	439	439	1.0000000
A01	11724815	11726531	A01p22730.2_BraZ1	1395	+	479	1651	1716	0.9621212
A01	11730566	11733670	A01p22740.2_BraZ1	9342	+	779	3039	3104	0.9790593
A01	11734142	11744166	A01p22750.2_BraZ1	6944	-	956	3832	10024	0.3822825
A01	11746969	11747474	A01p22760.2_BraZ1	9114	+	27	369	505	0.7306930
A01	11747884	11748657	A01p22770.2_BraZ1	489	+	16	620	773	0.8020698
A01	11749098	11750061	A01p22780.2_BraZ1	595	+	300	737	963	0.7653167
A01	11755213	11756107	A01p22790.2_BraZ1	89.1	-	1291	892	894	0.9977629
A01	11773162	11773300	A01p22800.2_BraZ1	13.8	+	181	138	138	1.0000000
A01	11774471	11774646	A01p22810.2_BraZ1	13.2	+	174	175	175	1.0000000
A01	11774977	11776499	A01p22820.2_BraZ1	621.649	-	125	1284	1522	0.8436268
A01	11780915	11781470	A01p22830.2_BraZ1	55.5	-	30	253	555	0.4558558
A01	11785462	11788407	A01p22840.2_BraZ1	1598.33	+	270	1685	2945	0.5721562
A01	11790751	11791237	A01p22850.2_BraZ1	48.6	-	769	486	486	1.0000000
A01	11798695	11801497	A01p22860.2_BraZ1	2142	+	1168	2361	2802	0.8426124
A01	11804158	11805670	A01p22870.2_BraZ1	1232.31	-	0	0	1512	0.0000000
A01	11811483	11817741	A01p22880.2_BraZ1	4802.93	-	536	1777	6258	0.2839565
A01	11834730	11835854	A01p22890.2_BraZ1	425.25	-	689	1124	1124	1.0000000
A01	11836411	11838016	A01p22900.2_BraZ1	907.714	+	15	88	1605	0.0548287
A01	11845975	11847869	A01p22910.2_BraZ1	1287.81	+	0	0	1894	0.0000000
A01	11852064	11852684	A01p22920.2_BraZ1	375	+	185	620	620	1.0000000
A01	11852699	11853005	A01p22930.2_BraZ1	30.6	+	121	298	306	0.9738562
A01	11857874	11859766	A01p22940.2_BraZ1	1282.39	+	205	670	1892	0.3541226
A01	11868473	11871401	A01p22950.2_BraZ1	1814.45	+	523	2290	2928	0.7821038
A01	11871477	11873808	A01p22960.2_BraZ1	710.182	-	844	2164	2331	0.9283569
A01	11884122	11886686	A01p22970.2_BraZ1	2156	-	214	2172	2564	0.8471139
A01	11887598	11889588	A01p22980.2_BraZ1	809.633	+	261	1593	1990	0.8005025
A01	11890322	11890730	A01p22990.2_BraZ1	40.8	-	145	408	408	1.0000000
A01	11894178	11897235	A01p23000.2_BraZ1	2178.83	+	1312	2865	3057	0.9371933
A01	11901011	11902980	A01p23010.2_BraZ1	925.989	-	985	1969	1969	1.0000000
A01	11906597	11907592	A01p23020.2_BraZ1	114	+	260	957	995	0.9618090
A01	11908554	11910874	A01p23030.2_BraZ1	1893.82	-	349	1994	2320	0.8594828
A01	11912807	11915159	A01p23040.2_BraZ1	904.929	-	1386	2281	2352	0.9698129
A01	11917042	11920262	A01p23050.2_BraZ1	1233.07	+	416	1773	3220	0.5506211
A01	11928233	11929247	A01p23060.2_BraZ1	100.8	+	63	529	1014	0.5216963
A01	11934111	11935452	A01p23070.2_BraZ1	134.1	+	574	1165	1341	0.8687547
A01	11936829	11937285	A01p23080.2_BraZ1	45.6	-	110	456	456	1.0000000
A01	11937913	11939902	A01p23090.2_BraZ1	924.667	+	1037	1950	1989	0.9803922
A01	11940284	11940806	A01p23100.2_BraZ1	52.2	-	181	482	522	0.9233717
A01	11940989	11941634	A01p23110.2_BraZ1	64.5	-	825	645	645	1.0000000
A01	11946884	11947082	A01p23120.2_BraZ1	19.8	+	306	198	198	1.0000000
A01	11948155	11950133	A01p23130.2_BraZ1	9510	+	801	1870	1978	0.9453994
A01	11953939	11954164	A01p23140.2_BraZ1	22.5	-	263	225	225	1.0000000
A01	11956337	11956658	A01p23150.2_BraZ1	32.1	-	24	235	321	0.7320873
A01	11959741	11960107	A01p23160.2_BraZ1	267	-	358	366	366	1.0000000
A01	11963000	11963493	A01p23170.2_BraZ1	348	-	146	493	493	1.0000000
A01	11965357	11966027	A01p23180.2_BraZ1	501.868	-	42	411	670	0.6134328
A01	11966370	11967797	A01p23190.2_BraZ1	605.391	-	785	1427	1427	1.0000000
A01	11968139	11971751	A01p23200.2_BraZ1	1340.88	+	1221	3224	3612	0.8925803
A01	11972369	11973692	A01p23210.2_BraZ1	366	-	712	1272	1323	0.9614512
A01	11974019	11975246	A01p23220.2_BraZ1	122.7	-	401	1174	1227	0.9568052
A01	11976105	11976228	A01p23230.2_BraZ1	12.3	+	39	123	123	1.0000000
A01	11979081	11980341	A01p23240.2_BraZ1	126	-	919	1260	1260	1.0000000
A01	12005517	12008902	A01p23250.2_BraZ1	1740.38	+	1337	3244	3385	0.9583457
A01	12009223	12014220	A01p23260.2_BraZ1	4683	-	1240	4579	4997	0.9163498
A01	12029463	12030764	A01p23270.2_BraZ1	7573.5	-	663	1258	1301	0.9669485
A01	12031711	12032014	A01p23280.2_BraZ1	30.3	+	2	90	303	0.2970297
A01	12032402	12033712	A01p23290.2_BraZ1	583.143	+	1	128	1310	0.0977099
A01	12047813	12049689	A01p23300.2_BraZ1	1704.55	-	62	749	1876	0.3992537
A01	12056952	12059244	A01p23310.2_BraZ1	1199.67	+	1846	2292	2292	1.0000000
A01	12074125	12075852	A01p23320.2_BraZ1	519.896	+	1123	1679	1727	0.9722061
A01	12093098	12096534	A01p23330.2_BraZ1	1289.75	+	469	2562	3436	0.7456344
A01	12098656	12098990	A01p23340.2_BraZ1	225	-	98	334	334	1.0000000
A01	12099601	12100801	A01p23350.2_BraZ1	683.077	-	793	1033	1200	0.8608333
A01	12105287	12109618	A01p23360.2_BraZ1	3502.5	+	573	3333	4331	0.7695682
A01	12110983	12114047	A01p23370.2_BraZ1	630.5	-	675	2893	3064	0.9441906
A01	12117837	12118173	A01p23380.2_BraZ1	33.6	-	308	336	336	1.0000000
A01	12141773	12142188	A01p23390.2_BraZ1	306	+	307	415	415	1.0000000
A01	12156297	12156751	A01p23400.2_BraZ1	38.1	-	955	454	454	1.0000000
A01	12164429	12165001	A01p23410.2_BraZ1	567	-	401	572	572	1.0000000
A01	12178166	12178583	A01p23420.2_BraZ1	255	-	476	417	417	1.0000000
A01	12193668	12195987	A01p23430.2_BraZ1	914.063	+	1236	2290	2319	0.9874946
A01	12197512	12198662	A01p23440.2_BraZ1	529.371	+	235	828	1150	0.7200000
A01	12201700	12201853	A01p23450.2_BraZ1	15.3	-	54	68	153	0.4444444
A01	12201930	12202592	A01p23460.2_BraZ1	189	+	135	551	662	0.8323263
A01	12202826	12203785	A01p23470.2_BraZ1	576	-	16	303	959	0.3159541
A01	12207754	12207883	A01p23480.2_BraZ1	12.9	-	27	127	129	0.9844961
A01	12209484	12211221	A01p23490.2_BraZ1	1248.88	+	214	1338	1737	0.7702936
A01	12214054	12217217	A01p23500.2_BraZ1	1149.22	+	426	2046	3163	0.6468543
A01	12220358	12231190	A01p23510.2_BraZ1	945	+	2448	8331	10832	0.7691100
A01	12221087	12224153	A01p23520.2_BraZ1	618	+	323	2375	3066	0.7746249
A01	12225717	12229728	A01p23530.2_BraZ1	1660.11	-	431	3238	4011	0.8072800
A01	12231798	12232808	A01p23540.2_BraZ1	588	-	379	802	1010	0.7940594
A01	12252173	12253452	A01p23550.2_BraZ1	1015	-	26	400	1279	0.3127443
A01	12254728	12255958	A01p23560.2_BraZ1	1040.8	+	285	1225	1230	0.9959350
A01	12265391	12267079	A01p23570.2_BraZ1	5335.2	-	794	1512	1688	0.8957346
A01	12273725	12276859	A01p23580.2_BraZ1	1312.67	+	1504	3113	3134	0.9932993
A01	12283287	12284355	A01p23590.2_BraZ1	106.8	+	451	1068	1068	1.0000000
A01	12294893	12297461	A01p23600.2_BraZ1	256.8	-	836	2421	2568	0.9427570
A01	12302285	12304863	A01p23610.2_BraZ1	130.8	-	259	1569	2578	0.6086113
A01	12318412	12322471	A01p23620.2_BraZ1	2988	-	252	2356	4059	0.5804386
A01	12323835	12326415	A01p23630.2_BraZ1	258	-	40	266	2580	0.1031008
A01	12338357	12338541	A01p23640.2_BraZ1	10.8	+	99	184	184	1.0000000
A01	12365263	12365714	A01p23650.2_BraZ1	294	+	10	271	451	0.6008869
A01	12365640	12365982	A01p23660.2_BraZ1	34.2	+	14	309	342	0.9035088
A01	12380533	12383748	A01p23670.2_BraZ1	2700	-	225	1655	3215	0.5147745
A01	12391667	12391856	A01p23680.2_BraZ1	18.9	+	0	0	189	0.0000000
A01	12402273	12403702	A01p23690.2_BraZ1	129.9	+	172	1235	1429	0.8642407
A01	12413050	12416236	A01p23700.2_BraZ1	2525.14	+	2395	2895	3186	0.9086629
A01	12424793	12428563	A01p23710.2_BraZ1	2050.96	-	773	3552	3770	0.9421751
A01	12432137	12436364	A01p23720.2_BraZ1	6192	+	3582	4227	4227	1.0000000
A01	12437556	12442411	A01p23730.2_BraZ1	1243.53	-	5349	4855	4855	1.0000000
A01	12448979	12450113	A01p23740.2_BraZ1	113.4	+	76	559	1134	0.4929453
A01	12451273	12454611	A01p23750.2_BraZ1	2407.02	+	996	2497	3338	0.7480527
A01	12454989	12456583	A01p23760.2_BraZ1	752.365	-	202	1189	1594	0.7459222
A01	12458900	12459098	A01p23770.2_BraZ1	19.8	-	266	198	198	1.0000000
A01	12472429	12476353	A01p23780.2_BraZ1	1464.8	-	858	3179	3924	0.8101427
A01	12483421	12491037	A01p23790.2_BraZ1	1971.07	+	1710	5703	7616	0.7488183
A01	12486383	12487207	A01p23800.2_BraZ1	519	-	4	156	824	0.1893204
A01	12496153	12501258	A01p23810.2_BraZ1	348	+	2457	4919	5105	0.9635651
A01	12523568	12526078	A01p23820.2_BraZ1	2418	-	273	1660	2510	0.6613546
A01	12527127	12527839	A01p23830.2_BraZ1	279	+	157	712	712	1.0000000
A01	12530256	12533661	A01p23840.2_BraZ1	2079.35	-	404	1776	3405	0.5215859
A01	12535653	12535866	A01p23850.2_BraZ1	18.3	+	7	198	213	0.9295775
A01	12541010	12543231	A01p23860.2_BraZ1	616	+	1476	2221	2221	1.0000000
A01	12545956	12548749	A01p23870.2_BraZ1	441	+	2331	2793	2793	1.0000000
A01	12553210	12553612	A01p23880.2_BraZ1	40.2	+	124	335	402	0.8333333
A01	12555406	12556634	A01p23890.2_BraZ1	1162.8	-	2357	1228	1228	1.0000000
A01	12560206	12560526	A01p23900.2_BraZ1	216	+	420	320	320	1.0000000
A01	12562075	12564763	A01p23910.2_BraZ1	268.2	+	513	2412	2688	0.8973214
A01	12565833	12567686	A01p23920.2_BraZ1	918.844	-	1507	1837	1853	0.9913654
A01	12568393	12569090	A01p23930.2_BraZ1	516	-	420	697	697	1.0000000
A01	12569587	12569902	A01p23940.2_BraZ1	31.5	-	128	306	315	0.9714286
A01	12573009	12575632	A01p23950.2_BraZ1	1999.18	+	681	2279	2623	0.8688524
A01	12576422	12577646	A01p23960.2_BraZ1	107.4	+	667	1175	1224	0.9599673
A01	12578504	12579919	A01p23970.2_BraZ1	524.376	-	214	850	1415	0.6007067
A01	12579713	12582489	A01p23980.2_BraZ1	860.965	-	1946	2776	2776	1.0000000
A01	12590215	12591703	A01p23990.2_BraZ1	945.455	-	219	1265	1488	0.8501344
A01	12594511	12596129	A01p24000.2_BraZ1	961.227	-	117	1011	1618	0.6248455
A01	12603055	12603892	A01p24010.2_BraZ1	83.7	+	42	251	837	0.2998805
A01	12605275	12607362	A01p24020.2_BraZ1	443.423	-	1857	2087	2087	1.0000000
A01	12611613	12613040	A01p24030.2_BraZ1	988.387	-	680	1427	1427	1.0000000
A01	12616617	12617538	A01p24040.2_BraZ1	287.85	+	1053	921	921	1.0000000
A01	12625800	12627486	A01p24050.2_BraZ1	3654.2	-	134	1018	1686	0.6037959
A01	12636845	12637172	A01p24060.2_BraZ1	21.6	+	283	327	327	1.0000000
A01	12640918	12641966	A01p24070.2_BraZ1	598.346	-	155	881	1048	0.8406488
A01	12643230	12643916	A01p24080.2_BraZ1	552	-	437	686	686	1.0000000
A01	12644285	12647001	A01p24090.2_BraZ1	1326.29	-	1842	2597	2716	0.9561856
A01	12649214	12650057	A01p24100.2_BraZ1	723	+	412	843	843	1.0000000
A01	12651563	12653363	A01p24110.2_BraZ1	1183	+	146	1243	1800	0.6905556
A01	12653686	12655230	A01p24120.2_BraZ1	1193.25	-	16	653	1544	0.4229275
A01	12657445	12657727	A01p24130.2_BraZ1	186	+	543	282	282	1.0000000
A01	12660519	12666256	A01p24140.2_BraZ1	24156	+	509	2942	5737	0.5128116
A01	12667422	12668298	A01p24150.2_BraZ1	327	-	502	876	876	1.0000000
A01	12670552	12673877	A01p24160.2_BraZ1	481.477	+	81	924	3325	0.2778947
A01	12673610	12676550	A01p24170.2_BraZ1	694.6	+	6	41	2940	0.0139456
A01	12686641	12686931	A01p24180.2_BraZ1	279	-	867	290	290	1.0000000
A01	12687803	12688760	A01p24190.2_BraZ1	95.7	-	2	23	957	0.0240334
A01	12689361	12689769	A01p24200.2_BraZ1	40.8	-	22	318	408	0.7794118
A01	12691115	12691421	A01p24210.2_BraZ1	19.8	+	282	306	306	1.0000000
A01	12697161	12698980	A01p24220.2_BraZ1	799.92	+	486	1771	1819	0.9736119
A01	12707473	12708416	A01p24230.2_BraZ1	357	-	185	943	943	1.0000000
A01	12721505	12725030	A01p24240.2_BraZ1	2591.22	-	452	1544	3525	0.4380142
A01	12726830	12727578	A01p24250.2_BraZ1	737.333	+	48	666	748	0.8903743
A01	12728174	12728508	A01p24260.2_BraZ1	135	+	222	334	334	1.0000000
A01	12735695	12737251	A01p24270.2_BraZ1	1074	-	150	1375	1556	0.8836761
A01	12754276	12755605	A01p24280.2_BraZ1	164.7	+	724	1329	1329	1.0000000
A01	12772894	12773651	A01p24290.2_BraZ1	681	+	86	476	757	0.6287979
A01	12776923	12780143	A01p24300.2_BraZ1	267.335	+	1299	2822	3220	0.8763975
A01	12780203	12780649	A01p24310.2_BraZ1	138	+	184	446	446	1.0000000
A01	12780975	12790211	A01p24320.2_BraZ1	1598.33	-	4841	8090	9236	0.8759203
A01	12790919	12794689	A01p24330.2_BraZ1	2708.75	-	2695	3770	3770	1.0000000
A01	12796948	12798998	A01p24340.2_BraZ1	722.4	-	2353	2050	2050	1.0000000
A01	12800204	12801333	A01p24350.2_BraZ1	771	+	445	779	1129	0.6899911
A01	12806906	12808218	A01p24360.2_BraZ1	1732.5	-	668	1296	1312	0.9878049
A01	12810651	12811425	A01p24370.2_BraZ1	77.4	-	35	593	774	0.7661499
A01	12812636	12812849	A01p24380.2_BraZ1	21.3	+	0	0	213	0.0000000
A01	12832245	12834312	A01p24390.2_BraZ1	494.4	-	3217	2067	2067	1.0000000
A01	12837680	12838022	A01p24400.2_BraZ1	34.2	-	7	13	342	0.0380117
A01	12841593	12841740	A01p24410.2_BraZ1	14.7	-	222	147	147	1.0000000
A01	12850194	12851652	A01p24420.2_BraZ1	792	-	2290	1458	1458	1.0000000
A01	12853134	12853506	A01p24430.2_BraZ1	270	+	400	372	372	1.0000000
A01	12860747	12862079	A01p24440.2_BraZ1	1127.25	+	34	314	1332	0.2357357
A01	12874972	12875350	A01p24450.2_BraZ1	246	-	185	378	378	1.0000000
A01	12876519	12881250	A01p24460.2_BraZ1	1452	+	957	2144	4731	0.4531811
A01	12877394	12880088	A01p24470.2_BraZ1	2616	+	900	1404	2694	0.5211582
A01	12883398	12884198	A01p24480.2_BraZ1	279	-	3	200	800	0.2500000
A01	12896115	12898469	A01p24490.2_BraZ1	873	+	2255	2354	2354	1.0000000
A01	12897968	12902374	A01p24500.2_BraZ1	651	+	2571	4335	4406	0.9838856
A01	12902904	12903081	A01p24510.2_BraZ1	17.7	+	206	177	177	1.0000000
A01	12904411	12905646	A01p24520.2_BraZ1	231	+	790	1235	1235	1.0000000
A01	12951109	12951289	A01p24530.2_BraZ1	18	+	170	180	180	1.0000000
A01	12966146	12968734	A01p24540.2_BraZ1	637.2	+	2125	2588	2588	1.0000000
A01	12977529	12979439	A01p24550.2_BraZ1	596.75	-	1179	1900	1910	0.9947644
A01	13004157	13007261	A01p24560.2_BraZ1	1384.29	+	583	1618	3104	0.5212629
A01	13030465	13031041	A01p24570.2_BraZ1	57.6	+	14	178	576	0.3090278
A01	13034395	13034704	A01p24580.2_BraZ1	309	-	385	309	309	1.0000000
A01	13034826	13035311	A01p24590.2_BraZ1	3024	-	680	485	485	1.0000000
A01	13041572	13041881	A01p24600.2_BraZ1	30.9	+	412	309	309	1.0000000
A01	13042690	13043269	A01p24610.2_BraZ1	495	-	638	579	579	1.0000000
A01	13055383	13056451	A01p24620.2_BraZ1	106.8	+	417	1068	1068	1.0000000
A01	13058021	13058465	A01p24630.2_BraZ1	44.4	+	636	444	444	1.0000000
A01	13068349	13070508	A01p24640.2_BraZ1	728.2	+	747	1997	2159	0.9249653
A01	13070542	13071998	A01p24650.2_BraZ1	664.2	-	957	1456	1456	1.0000000
A01	13071895	13072117	A01p24660.2_BraZ1	165	-	498	222	222	1.0000000
A01	13084934	13087619	A01p24670.2_BraZ1	806.25	+	812	2342	2685	0.8722532
A01	13094824	13095214	A01p24680.2_BraZ1	324	-	98	369	390	0.9461538
A01	13096756	13099297	A01p24690.2_BraZ1	1693.2	-	1143	2188	2541	0.8610783
A01	13105110	13105957	A01p24700.2_BraZ1	356.4	+	1170	847	847	1.0000000
A01	13109897	13110977	A01p24710.2_BraZ1	628.043	-	834	1080	1080	1.0000000
A01	13116466	13118002	A01p24720.2_BraZ1	745.714	-	1051	1536	1536	1.0000000
A01	13121052	13122815	A01p24730.2_BraZ1	1194	-	251	1503	1763	0.8525241
A01	13131246	13131807	A01p24740.2_BraZ1	54.6	+	631	561	561	1.0000000
A01	13134604	13136360	A01p24750.2_BraZ1	5187	-	457	1540	1756	0.8769932
A01	13141608	13144602	A01p24760.2_BraZ1	1653.6	-	1266	2370	2994	0.7915832
A01	13145642	13146350	A01p24770.2_BraZ1	70.8	-	111	429	708	0.6059322
A01	13147262	13147526	A01p24780.2_BraZ1	26.4	-	5	81	264	0.3068182
A01	13155087	13156990	A01p24790.2_BraZ1	1083.75	-	388	1372	1903	0.7209669
A01	13167588	13181741	A01p24800.2_BraZ1	8466.73	+	526	4675	14153	0.3303187
A01	13182459	13182807	A01p24810.2_BraZ1	34.8	+	560	348	348	1.0000000
A01	13183829	13184675	A01p24820.2_BraZ1	460.109	-	772	846	846	1.0000000
A01	13204765	13205980	A01p24830.2_BraZ1	121.5	+	68	557	1215	0.4584362
A01	13231827	13232520	A01p24840.2_BraZ1	69.3	+	368	644	693	0.9292929
A01	13246233	13247251	A01p24850.2_BraZ1	80.4	+	722	1018	1018	1.0000000
A01	13250108	13250764	A01p24860.2_BraZ1	546	-	448	656	656	1.0000000
A01	13253689	13255039	A01p24870.2_BraZ1	135	-	911	1350	1350	1.0000000
A01	13262896	13265832	A01p24880.2_BraZ1	7820.4	-	852	2543	2936	0.8661444
A01	13283049	13284973	A01p24890.2_BraZ1	1095	-	991	1924	1924	1.0000000
A01	13292415	13293015	A01p24900.2_BraZ1	60	+	479	600	600	1.0000000
A01	13295251	13297438	A01p24910.2_BraZ1	848.164	-	3376	2187	2187	1.0000000
A01	13299200	13300736	A01p24920.2_BraZ1	153.6	-	899	1536	1536	1.0000000
A01	13302476	13302686	A01p24930.2_BraZ1	21	+	292	210	210	1.0000000
A01	13313648	13314961	A01p24940.2_BraZ1	1059	+	266	1234	1313	0.9398324
A01	13317063	13320980	A01p24950.2_BraZ1	938.571	-	2534	3779	3917	0.9647689
A01	13326064	13327060	A01p24960.2_BraZ1	99.6	+	617	996	996	1.0000000
A01	13332386	13335368	A01p24970.2_BraZ1	1806.35	+	839	2982	2982	1.0000000
A01	13339814	13341209	A01p24980.2_BraZ1	1197.79	+	676	1369	1395	0.9813620
A01	13343170	13344847	A01p24990.2_BraZ1	167.7	+	95	540	1677	0.3220036
A01	13349579	13351821	A01p25000.2_BraZ1	1019.44	-	1800	2242	2242	1.0000000
A01	13359081	13359747	A01p25010.2_BraZ1	66.6	-	99	477	666	0.7162162
A01	13364061	13364502	A01p25020.2_BraZ1	44.1	-	60	417	441	0.9455782
A01	13366246	13368083	A01p25030.2_BraZ1	1527.2	+	228	1570	1837	0.8546543
A01	13369839	13371367	A01p25040.2_BraZ1	3366	-	252	934	1528	0.6112565
A01	13373071	13373874	A01p25050.2_BraZ1	2150	+	594	803	803	1.0000000
A01	13374525	13375670	A01p25060.2_BraZ1	13261	-	592	1060	1145	0.9257642
A01	13380011	13380592	A01p25070.2_BraZ1	324	-	44	401	581	0.6901893
A01	13383318	13383977	A01p25080.2_BraZ1	324.913	-	141	512	659	0.7769347
A01	13390150	13390784	A01p25090.2_BraZ1	300	+	1381	634	634	1.0000000
A01	13393900	13396011	A01p25100.2_BraZ1	1398	+	26	837	2111	0.3964945
A01	13400362	13400582	A01p25110.2_BraZ1	19.2	+	6	220	220	1.0000000
A01	13401228	13401630	A01p25120.2_BraZ1	40.2	-	164	402	402	1.0000000
A01	13409745	13411077	A01p25130.2_BraZ1	133.2	+	212	1011	1332	0.7590090
A01	13417312	13417996	A01p25140.2_BraZ1	548.625	+	1	23	684	0.0336257
A01	13420792	13422337	A01p25150.2_BraZ1	1800.9	+	1016	1535	1545	0.9935275
A01	13424161	13424551	A01p25160.2_BraZ1	165	+	262	390	390	1.0000000
A01	13424637	13425106	A01p25170.2_BraZ1	231	+	193	469	469	1.0000000
A01	13425503	13425614	A01p25180.2_BraZ1	11.1	+	211	111	111	1.0000000
A01	13428117	13429164	A01p25190.2_BraZ1	104.7	+	196	757	1047	0.7230182
A01	13443313	13444037	A01p25200.2_BraZ1	240	-	21	350	724	0.4834254
A01	13467439	13467727	A01p25210.2_BraZ1	28.8	+	110	283	288	0.9826389
A01	13470622	13470898	A01p25220.2_BraZ1	27.6	+	319	276	276	1.0000000
A01	13472284	13473673	A01p25230.2_BraZ1	246	-	1340	1358	1389	0.9776818
A01	13482180	13482802	A01p25240.2_BraZ1	195	-	458	622	622	1.0000000
A01	13485534	13486374	A01p25250.2_BraZ1	84	+	575	840	840	1.0000000
A01	13488991	13490479	A01p25260.2_BraZ1	3722.4	+	1012	1488	1488	1.0000000
A01	13491023	13491212	A01p25270.2_BraZ1	18.9	-	96	189	189	1.0000000
A01	13494258	13496598	A01p25280.2_BraZ1	1245.56	-	923	2340	2340	1.0000000
A01	13513062	13516736	A01p25290.2_BraZ1	944.509	-	2254	3674	3674	1.0000000
A01	13529077	13529245	A01p25300.2_BraZ1	16.8	-	121	168	168	1.0000000
A01	13529542	13532784	A01p25310.2_BraZ1	917.125	+	1011	3018	3242	0.9309068
A01	13534695	13535156	A01p25320.2_BraZ1	42.9	-	59	263	461	0.5704989
A01	13537498	13539867	A01p25330.2_BraZ1	413.091	-	4	237	2369	0.1000422
A01	13538899	13539430	A01p25340.2_BraZ1	180	-	0	0	531	0.0000000
A01	13545809	13546226	A01p25350.2_BraZ1	41.7	+	128	407	417	0.9760192
A01	13551881	13552538	A01p25360.2_BraZ1	279.632	+	1	38	657	0.0578387
A01	13553992	13554764	A01p25370.2_BraZ1	210	-	484	752	772	0.9740933
A01	13564088	13564550	A01p25380.2_BraZ1	318	-	1496	223	462	0.4826840
A01	13565929	13566342	A01p25390.2_BraZ1	387	+	0	0	413	0.0000000
A01	13572346	13572647	A01p25400.2_BraZ1	456	+	6	158	301	0.5249169
A01	13575174	13575541	A01p25410.2_BraZ1	354	+	42	334	367	0.9100817
A01	13576786	13580665	A01p25420.2_BraZ1	3699	+	158	1069	3879	0.2755865
A01	13584436	13587303	A01p25430.2_BraZ1	2097.32	+	1634	2666	2867	0.9298919
A01	13588779	13589052	A01p25440.2_BraZ1	27.3	-	242	273	273	1.0000000
A01	13592919	13599908	A01p25450.2_BraZ1	1872.2	-	3486	6916	6989	0.9895550
A01	13600581	13605312	A01p25460.2_BraZ1	2420.62	+	982	3300	4731	0.6975269
A01	13606134	13606533	A01p25470.2_BraZ1	39.9	-	104	348	399	0.8721805
A01	13614075	13616886	A01p25480.2_BraZ1	905.727	-	608	2458	2811	0.8744219
A01	13618072	13620624	A01p25490.2_BraZ1	646	+	837	2180	2552	0.8542320
A01	13634437	13636262	A01p25500.2_BraZ1	783	+	598	1644	1825	0.9008219
A01	13637456	13637705	A01p25510.2_BraZ1	24.3	+	484	249	249	1.0000000
A01	13670725	13672672	A01p25520.2_BraZ1	1531.2	+	301	1026	1947	0.5269645
A01	13673067	13675007	A01p25530.2_BraZ1	189	-	332	1780	1940	0.9175258
A01	13679783	13679891	A01p25540.2_BraZ1	10.8	+	17	108	108	1.0000000
A01	13686817	13688002	A01p25550.2_BraZ1	1032	+	558	1050	1185	0.8860760
A01	13693334	13693813	A01p25560.2_BraZ1	288	+	20	20	479	0.0417537
A01	13693937	13695216	A01p25570.2_BraZ1	424.32	+	4	75	1279	0.0586396
A01	13697366	13697630	A01p25580.2_BraZ1	26.4	-	269	264	264	1.0000000
A01	13703779	13709627	A01p25590.2_BraZ1	117.409	+	2156	3685	5848	0.6301299
A01	13713065	13715083	A01p25600.2_BraZ1	231.955	-	904	2001	2018	0.9915758
A01	13721232	13723530	A01p25610.2_BraZ1	246	+	836	2298	2298	1.0000000
A01	13730854	13735648	A01p25620.2_BraZ1	246	+	4093	4621	4794	0.9639132
A01	13736421	13738362	A01p25630.2_BraZ1	194.1	-	128	1498	1941	0.7717671
A01	13741919	13748402	A01p25640.2_BraZ1	1775.54	-	2340	5387	6483	0.8309425
A01	13754748	13758830	A01p25650.2_BraZ1	922.5	+	3480	4027	4082	0.9865262
A01	13762024	13762862	A01p25660.2_BraZ1	246	-	432	838	838	1.0000000
A01	13763217	13763663	A01p25670.2_BraZ1	285	-	320	440	446	0.9865471
A01	13776256	13781039	A01p25680.2_BraZ1	1133.83	+	1830	3968	4783	0.8296049
A01	13787450	13791618	A01p25690.2_BraZ1	585.222	+	2604	3368	4168	0.8080614
A01	13793777	13795720	A01p25700.2_BraZ1	1211.61	-	287	1261	1943	0.6489964
A01	13798971	13802824	A01p25710.2_BraZ1	1808.82	+	1467	2937	3853	0.7622632
A01	13799952	13800376	A01p25720.2_BraZ1	102	+	74	367	424	0.8655660
A01	13804904	13805145	A01p25730.2_BraZ1	198	+	489	241	241	1.0000000
A01	13807862	13812806	A01p25740.2_BraZ1	2425.33	+	794	3867	4944	0.7821602
A01	13829317	13829891	A01p25750.2_BraZ1	249	+	871	556	574	0.9686411
A01	13830303	13832845	A01p25760.2_BraZ1	969.231	-	139	1551	2542	0.6101495
A01	13846487	13846790	A01p25770.2_BraZ1	30.3	-	286	303	303	1.0000000
A01	13846940	13847966	A01p25780.2_BraZ1	156	+	271	938	1026	0.9142300
A01	13848369	13848941	A01p25790.2_BraZ1	318	-	1034	566	572	0.9895105
A01	13849664	13873800	A01p25800.2_BraZ1	149.333	+	80468	21226	24136	0.8794332
A01	13873872	13876959	A01p25810.2_BraZ1	1040.87	-	855	2605	3087	0.8438613
A01	13878274	13879215	A01p25820.2_BraZ1	603	+	269	935	941	0.9936238
A01	13879633	13880999	A01p25830.2_BraZ1	769.5	-	311	1302	1366	0.9531479
A01	13881242	13882649	A01p25840.2_BraZ1	140.7	-	194	853	1407	0.6062545
A01	13886640	13887459	A01p25850.2_BraZ1	496.726	+	430	802	819	0.9792430
A01	13889578	13890283	A01p25860.2_BraZ1	70.5	-	1	39	705	0.0553191
A01	13891748	13893055	A01p25870.2_BraZ1	717.75	+	626	1164	1307	0.8905891
A01	13895014	13895518	A01p25880.2_BraZ1	50.4	-	142	484	504	0.9603174
A01	13896005	13900215	A01p25890.2_BraZ1	1054.29	+	2470	4195	4210	0.9964371
A01	13901289	13902580	A01p25900.2_BraZ1	276	+	1633	1291	1291	1.0000000
A01	13905666	13906872	A01p25910.2_BraZ1	120.6	+	143	548	1206	0.4543947
A01	13910498	13914540	A01p25920.2_BraZ1	1537.5	-	4461	3992	4042	0.9876299
A01	13915036	13917271	A01p25930.2_BraZ1	223.2	+	2448	2235	2235	1.0000000
A01	13918258	13919169	A01p25940.2_BraZ1	198	+	2	249	911	0.2733260
A01	13920936	13921083	A01p25950.2_BraZ1	14.7	-	273	147	147	1.0000000
A01	13921679	13922670	A01p25960.2_BraZ1	930	-	190	889	991	0.8970737
A01	13924219	13927662	A01p25970.2_BraZ1	2615.98	+	514	2626	3443	0.7627069
A01	13927867	13928193	A01p25980.2_BraZ1	237	-	172	326	326	1.0000000
A01	13930087	13930663	A01p25990.2_BraZ1	40.2	+	83	565	576	0.9809028
A01	13932289	13932740	A01p26000.2_BraZ1	396	-	117	417	451	0.9246120
A01	13936019	13937997	A01p26010.2_BraZ1	196.5	-	144	942	1978	0.4762386
A01	13938820	13939476	A01p26020.2_BraZ1	576	-	659	656	656	1.0000000
A01	13943903	13944695	A01p26030.2_BraZ1	79.2	+	494	792	792	1.0000000
A01	13945479	13947781	A01p26040.2_BraZ1	1275.65	-	883	2280	2302	0.9904431
A01	13954335	13956245	A01p26050.2_BraZ1	830.37	-	1151	1897	1910	0.9931937
A01	14006955	14009677	A01p26060.2_BraZ1	811.376	+	381	2314	2722	0.8501102
A01	14011112	14011423	A01p26070.2_BraZ1	192	+	38	295	311	0.9485530
A01	14011459	14011912	A01p26080.2_BraZ1	252	+	52	453	453	1.0000000
A01	14017914	14018889	A01p26090.2_BraZ1	97.5	+	123	467	975	0.4789744
A01	14020993	14023655	A01p26100.2_BraZ1	990	+	0	0	2662	0.0000000
A01	14035682	14036873	A01p26110.2_BraZ1	1023	+	78	624	1191	0.5239295
A01	14037759	14037969	A01p26120.2_BraZ1	21	-	53	139	210	0.6619048
A01	14046561	14050086	A01p26130.2_BraZ1	1605.8	+	663	2514	3525	0.7131915
A01	14058294	14058923	A01p26140.2_BraZ1	306	+	962	629	629	1.0000000
A01	14070481	14072395	A01p26150.2_BraZ1	1848	-	599	1884	1914	0.9843260
A01	14075788	14079603	A01p26160.2_BraZ1	779.613	+	1699	3377	3815	0.8851900
A01	14084403	14084559	A01p26170.2_BraZ1	15.6	+	318	156	156	1.0000000
A01	14086637	14087999	A01p26180.2_BraZ1	2205	+	1098	1362	1362	1.0000000
A01	14103563	14103753	A01p26190.2_BraZ1	11.7	-	101	190	190	1.0000000
A01	14103797	14117223	A01p26200.2_BraZ1	2592	-	536	3867	13426	0.2880232
A01	14120968	14121110	A01p26210.2_BraZ1	13.2	-	284	142	142	1.0000000
A01	14121648	14121904	A01p26220.2_BraZ1	14.1	-	559	256	256	1.0000000
A01	14128390	14130349	A01p26230.2_BraZ1	195.9	+	594	1709	1959	0.8723839
A01	14152844	14153093	A01p26240.2_BraZ1	24.9	-	76	249	249	1.0000000
A01	14178467	14179028	A01p26250.2_BraZ1	6765	-	11	275	561	0.4901961
A01	14190792	14192682	A01p26260.2_BraZ1	165.3	-	197	1514	1890	0.8010582
A01	14192808	14193111	A01p26270.2_BraZ1	30.3	-	179	303	303	1.0000000
A01	14195567	14197689	A01p26280.2_BraZ1	656.172	+	1145	2122	2122	1.0000000
A01	14197880	14200116	A01p26290.2_BraZ1	1245.33	-	633	2221	2236	0.9932916
A01	14213238	14213595	A01p26300.2_BraZ1	35.7	+	332	357	357	1.0000000
A01	14232090	14232504	A01p26310.2_BraZ1	41.4	+	463	414	414	1.0000000
A01	14234087	14234987	A01p26320.2_BraZ1	90	+	199	842	900	0.9355556
A01	14237144	14237486	A01p26330.2_BraZ1	34.2	+	265	342	342	1.0000000
A01	14238643	14241690	A01p26340.2_BraZ1	1875	-	989	2887	3047	0.9474893
A01	14257313	14258880	A01p26350.2_BraZ1	1458	-	51	607	1567	0.3873644
A01	14264195	14266449	A01p26360.2_BraZ1	477	+	1196	2254	2254	1.0000000
A01	14277198	14277735	A01p26370.2_BraZ1	53.7	-	250	537	537	1.0000000
A01	14286509	14288063	A01p26380.2_BraZ1	11178	-	17	579	1554	0.3725869
A01	14298492	14300673	A01p26390.2_BraZ1	199.5	+	34	809	2181	0.3709308
A01	14303585	14303738	A01p26400.2_BraZ1	15.3	+	45	153	153	1.0000000
A01	14306112	14307655	A01p26410.2_BraZ1	1461	-	650	1435	1543	0.9300065
A01	14326554	14327281	A01p26420.2_BraZ1	376.071	-	172	212	727	0.2916093
A01	14328729	14329240	A01p26430.2_BraZ1	288	-	324	511	511	1.0000000
A01	14332940	14333607	A01p26440.2_BraZ1	258	-	403	667	667	1.0000000
A01	14347187	14350993	A01p26450.2_BraZ1	2557.91	+	754	2334	3806	0.6132423
A01	14374702	14375432	A01p26460.2_BraZ1	415	-	509	730	730	1.0000000
A01	14380247	14380647	A01p26470.2_BraZ1	672	+	460	400	400	1.0000000
A01	14383840	14384080	A01p26480.2_BraZ1	24	+	5	59	240	0.2458333
A01	14384697	14388356	A01p26490.2_BraZ1	1382.37	-	1490	3523	3659	0.9628314
A01	14394433	14394783	A01p26500.2_BraZ1	162	-	386	350	350	1.0000000
A01	14396723	14398762	A01p26510.2_BraZ1	17370	+	688	1254	2039	0.6150073
A01	14407814	14407967	A01p26520.2_BraZ1	15.3	-	169	153	153	1.0000000
A01	14412810	14422999	A01p26530.2_BraZ1	167.7	+	47077	10189	10189	1.0000000
A01	14419225	14420176	A01p26540.2_BraZ1	78.9	-	4061	951	951	1.0000000
A01	14420715	14421926	A01p26550.2_BraZ1	83.4	+	7671	1211	1211	1.0000000
A01	14423701	14446934	A01p26560.2_BraZ1	105.9	-	36584	21095	23233	0.9079757
A01	14446984	14447276	A01p26570.2_BraZ1	237	-	3012	292	292	1.0000000
A01	14447305	14453704	A01p26580.2_BraZ1	84.3	-	6997	4569	6399	0.7140178
A01	14454208	14454784	A01p26590.2_BraZ1	41.1	-	619	576	576	1.0000000
A01	14467062	14467407	A01p26600.2_BraZ1	34.5	-	10	169	345	0.4898551
A01	14475797	14477521	A01p26610.2_BraZ1	646.14	+	487	1667	1724	0.9669374
A01	14494454	14496511	A01p26620.2_BraZ1	1897.6	+	41	629	2057	0.3057851
A01	14499047	14501015	A01p26630.2_BraZ1	664.4	+	485	1804	1968	0.9166667
A01	14501749	14503595	A01p26640.2_BraZ1	20979	-	403	1652	1846	0.8949079
A01	14509273	14511026	A01p26650.2_BraZ1	906.686	+	348	1588	1753	0.9058756
A01	14514818	14515001	A01p26660.2_BraZ1	18.3	+	235	183	183	1.0000000
A01	14519469	14522043	A01p26670.2_BraZ1	485	-	882	2442	2574	0.9487180
A01	14523393	14525687	A01p26680.2_BraZ1	688.86	-	251	1242	2294	0.5414124
A01	14563022	14565460	A01p26690.2_BraZ1	1895.43	+	38	852	2438	0.3494668
A01	14571129	14572299	A01p26700.2_BraZ1	9376.5	+	243	825	1170	0.7051282
A01	14572848	14573379	A01p26710.2_BraZ1	53.1	+	167	529	531	0.9962335
A01	14577369	14578573	A01p26720.2_BraZ1	780.522	-	486	1098	1204	0.9119601
A01	14582681	14587213	A01p26730.2_BraZ1	2829	-	3453	3975	4532	0.8770962
A01	14587790	14588048	A01p26740.2_BraZ1	25.8	-	128	258	258	1.0000000
A01	14597583	14599137	A01p26750.2_BraZ1	591.643	-	158	1149	1554	0.7393823
A01	14606616	14607289	A01p26760.2_BraZ1	395.636	-	238	673	673	1.0000000
A01	14616780	14617920	A01p26770.2_BraZ1	5100	-	179	948	1140	0.8315790
A01	14623548	14624175	A01p26780.2_BraZ1	279	+	503	627	627	1.0000000
A01	14624320	14624691	A01p26790.2_BraZ1	282	+	289	371	371	1.0000000
A01	14625362	14629340	A01p26800.2_BraZ1	385	-	578	3596	3978	0.9039719
A01	14630000	14631134	A01p26810.2_BraZ1	729	+	172	1116	1134	0.9841270
A01	14632335	14632612	A01p26820.2_BraZ1	24	-	232	277	277	1.0000000
A01	14633085	14646591	A01p26830.2_BraZ1	736.653	-	3275	10284	13506	0.7614394
A01	14659362	14659767	A01p26840.2_BraZ1	342	+	837	405	405	1.0000000
A01	14660830	14662876	A01p26850.2_BraZ1	474	-	3051	2046	2046	1.0000000
A01	14669645	14670242	A01p26860.2_BraZ1	417	-	587	597	597	1.0000000
A01	14676765	14677648	A01p26870.2_BraZ1	621	+	357	839	883	0.9501699
A01	14687610	14687796	A01p26880.2_BraZ1	18.6	-	548	186	186	1.0000000
A01	14690946	14691821	A01p26890.2_BraZ1	366	-	367	875	875	1.0000000
A01	14696919	14699721	A01p26900.2_BraZ1	363	-	2312	2739	2802	0.9775161
A01	14697937	14701035	A01p26910.2_BraZ1	165	-	2420	2826	3098	0.9122014
A01	14707199	14711440	A01p26920.2_BraZ1	2004.75	-	1247	3616	4241	0.8526291
A01	14712694	14713015	A01p26930.2_BraZ1	32.1	-	577	321	321	1.0000000
A01	14716753	14731775	A01p26940.2_BraZ1	733.667	-	5787	14018	15022	0.9331647
A01	14718277	14724974	A01p26950.2_BraZ1	174	+	1641	5960	6697	0.8899508
A01	14755348	14755545	A01p26960.2_BraZ1	108	-	164	197	197	1.0000000
A01	14757516	14758050	A01p26970.2_BraZ1	339	+	359	534	534	1.0000000
A01	14772197	14774867	A01p26980.2_BraZ1	1612.43	+	236	1748	2670	0.6546816
A01	14792022	14793517	A01p26990.2_BraZ1	1350	+	349	1226	1495	0.8200669
A01	14796437	14806745	A01p27000.2_BraZ1	299.2	-	15131	10307	10308	0.9999030
A01	14797061	14798066	A01p27010.2_BraZ1	279	-	1528	1005	1005	1.0000000
A01	14810751	14811751	A01p27020.2_BraZ1	348.5	-	881	1000	1000	1.0000000
A01	14840365	14841721	A01p27030.2_BraZ1	135.6	+	460	1356	1356	1.0000000
A01	14843564	14845532	A01p27040.2_BraZ1	196.8	+	106	932	1968	0.4735772
A01	14852550	14854596	A01p27050.2_BraZ1	1536	-	242	1089	2046	0.5322581
A01	14860698	14861697	A01p27060.2_BraZ1	99	-	24	255	999	0.2552553
A01	14862250	14863735	A01p27070.2_BraZ1	964.737	-	18	393	1485	0.2646465
A01	14870162	14871671	A01p27080.2_BraZ1	150.9	+	268	1083	1509	0.7176939
A01	14874302	14876023	A01p27090.2_BraZ1	318	+	9636	1721	1721	1.0000000
A01	14880323	14881489	A01p27100.2_BraZ1	1345.5	-	1163	1166	1166	1.0000000
A01	14881684	14882263	A01p27110.2_BraZ1	165	-	941	579	579	1.0000000
A01	14882168	14882900	A01p27120.2_BraZ1	198	-	1301	732	732	1.0000000
A01	14886155	14886434	A01p27130.2_BraZ1	27.9	-	0	0	279	0.0000000
A01	14891309	14894180	A01p27140.2_BraZ1	7311.42	+	1558	2719	2871	0.9470568
A01	14894656	14896769	A01p27150.2_BraZ1	427.5	+	805	2015	2113	0.9536204
A01	14899938	14901512	A01p27160.2_BraZ1	813	+	175	1119	1574	0.7109275
A01	14907424	14908301	A01p27170.2_BraZ1	1100	-	247	615	877	0.7012542
A01	14915839	14917268	A01p27180.2_BraZ1	1353	+	117	487	1429	0.3407978
A01	14917723	14919166	A01p27190.2_BraZ1	9534	+	11	116	1443	0.0803881
A01	14920522	14921380	A01p27200.2_BraZ1	84	-	451	851	858	0.9918415
A01	14923425	14924657	A01p27210.2_BraZ1	2793	+	535	1029	1232	0.8352273
A01	14925355	14925942	A01p27220.2_BraZ1	168	-	128	587	587	1.0000000
A01	14926969	14927355	A01p27230.2_BraZ1	117	-	9	251	386	0.6502591
A01	14945287	14945785	A01p27240.2_BraZ1	435	-	509	498	498	1.0000000
A01	14996823	14998102	A01p27250.2_BraZ1	500.786	-	464	1139	1279	0.8905395
A01	15002690	15004475	A01p27260.2_BraZ1	178.5	-	217	908	1785	0.5086835
A01	15009271	15010087	A01p27270.2_BraZ1	81.6	-	3508	816	816	1.0000000
A01	15025719	15025973	A01p27280.2_BraZ1	23.1	-	105	254	254	1.0000000
A01	15032824	15034093	A01p27290.2_BraZ1	3600	+	621	1269	1269	1.0000000
A01	15040176	15040776	A01p27300.2_BraZ1	60	-	413	600	600	1.0000000
A01	15042090	15043715	A01p27310.2_BraZ1	10872	-	211	651	1625	0.4006154
A01	15059708	15060734	A01p27320.2_BraZ1	589	-	3324	1026	1026	1.0000000
A01	15060708	15074123	A01p27330.2_BraZ1	2139.5	-	11845	12089	13415	0.9011554
A01	15080249	15081247	A01p27340.2_BraZ1	183	+	434	998	998	1.0000000
A01	15081620	15082317	A01p27350.2_BraZ1	1224	-	1444	697	697	1.0000000
A01	15087324	15087828	A01p27360.2_BraZ1	1387	-	104	504	504	1.0000000
A01	15090236	15090518	A01p27370.2_BraZ1	207	+	363	282	282	1.0000000
A01	15091297	15091456	A01p27380.2_BraZ1	15.9	+	232	159	159	1.0000000
A01	15097299	15099571	A01p27390.2_BraZ1	2083.29	+	197	1203	2272	0.5294895
A01	15105679	15106009	A01p27400.2_BraZ1	33	-	112	330	330	1.0000000
A01	15111674	15112033	A01p27410.2_BraZ1	267	-	54	110	359	0.3064067
A01	15114162	15115372	A01p27420.2_BraZ1	438	+	329	1115	1210	0.9214876
A01	15117112	15117376	A01p27430.2_BraZ1	26.4	-	3	75	264	0.2840909
A01	15124439	15124586	A01p27440.2_BraZ1	14.7	+	243	147	147	1.0000000
A01	15134244	15134472	A01p27450.2_BraZ1	16.2	-	15	168	228	0.7368421
A01	15137805	15138923	A01p27460.2_BraZ1	336	+	249	962	1118	0.8604651
A01	15141136	15144402	A01p27470.2_BraZ1	794.077	-	734	1462	3266	0.4476424
A01	15145642	15146872	A01p27480.2_BraZ1	723	+	8	335	1230	0.2723577
A01	15152427	15152556	A01p27490.2_BraZ1	12.9	-	0	0	129	0.0000000
A01	15200103	15200328	A01p27500.2_BraZ1	22.5	+	6	21	225	0.0933333
A01	15200658	15201780	A01p27510.2_BraZ1	780	+	75	1061	1122	0.9456328
A01	15203767	15204463	A01p27520.2_BraZ1	588	-	2	104	696	0.1494253
A01	15209133	15226998	A01p27530.2_BraZ1	429	-	3587	10379	17865	0.5809684
A01	15219015	15220324	A01p27540.2_BraZ1	995.833	-	1	128	1309	0.0977846
A01	15220509	15220889	A01p27550.2_BraZ1	112	-	111	240	380	0.6315789
A01	15242339	15243484	A01p27560.2_BraZ1	390	-	62	820	1145	0.7161572
A01	15245237	15249677	A01p27570.2_BraZ1	1808.12	+	2680	4307	4440	0.9700450
A01	15251806	15254326	A01p27580.2_BraZ1	1522.5	-	1091	2286	2520	0.9071429
A01	15255963	15258471	A01p27590.2_BraZ1	250.8	-	111	943	2508	0.3759968
A01	15277910	15278244	A01p27600.2_BraZ1	135	+	267	334	334	1.0000000
A01	15292317	15292563	A01p27610.2_BraZ1	24.6	-	117	190	246	0.7723577
A01	15300453	15300612	A01p27620.2_BraZ1	15.9	+	8	154	159	0.9685535
A01	15303411	15305131	A01p27630.2_BraZ1	72.9	-	1978	1720	1720	1.0000000
A01	15309598	15309964	A01p27640.2_BraZ1	198	-	532	366	366	1.0000000
A01	15310408	15310923	A01p27650.2_BraZ1	243	-	1108	515	515	1.0000000
A01	15315750	15320709	A01p27660.2_BraZ1	2662.81	+	600	3306	4959	0.6666667
A01	15333017	15335057	A01p27670.2_BraZ1	1046.77	+	400	1837	2040	0.9004902
A01	15343176	15344031	A01p27680.2_BraZ1	408.889	+	647	804	855	0.9403509
A01	15344978	15346138	A01p27690.2_BraZ1	219	-	290	1095	1160	0.9439655
A01	15346546	15347881	A01p27700.2_BraZ1	250.167	+	1064	1335	1335	1.0000000
A01	15348196	15349360	A01p27710.2_BraZ1	528.5	+	2180	1164	1164	1.0000000
A01	15354463	15356479	A01p27720.2_BraZ1	1508.18	-	432	1610	2016	0.7986111
A01	15374595	15376663	A01p27730.2_BraZ1	858	+	371	1004	2068	0.4854932
A01	15376965	15377239	A01p27740.2_BraZ1	108	-	290	274	274	1.0000000
A01	15386099	15386345	A01p27750.2_BraZ1	23.7	+	98	246	246	1.0000000
A01	15398488	15398665	A01p27760.2_BraZ1	17.7	-	2	140	177	0.7909604
A01	15401640	15403350	A01p27770.2_BraZ1	1061.56	+	69	959	1710	0.5608187
A01	15412986	15447093	A01p27780.2_BraZ1	94.3421	+	68749	34103	34107	0.9998827
A01	15419340	15419865	A01p27790.2_BraZ1	33.9	-	1579	525	525	1.0000000
A01	15460996	15464948	A01p27800.2_BraZ1	921.789	+	2592	3952	3952	1.0000000
A01	15465176	15474228	A01p27810.2_BraZ1	306.411	+	7742	9041	9052	0.9987848
A01	15478165	15478432	A01p27820.2_BraZ1	26.7	+	2	151	267	0.5655431
A01	15510666	15510888	A01p27830.2_BraZ1	22.2	-	21	222	222	1.0000000
A01	15510964	15511414	A01p27840.2_BraZ1	45	-	46	450	450	1.0000000
A01	15552509	15553203	A01p27850.2_BraZ1	399	-	463	694	694	1.0000000
A01	15603066	15605745	A01p27860.2_BraZ1	1522.09	+	325	2179	2679	0.8133632
A01	15637933	15639654	A01p27870.2_BraZ1	1626	+	2	121	1721	0.0703080
A01	15640162	15640940	A01p27880.2_BraZ1	454.031	-	92	446	778	0.5732648
A01	15650258	15652865	A01p27890.2_BraZ1	1280.33	+	299	1247	2607	0.4783276
A01	15654626	15656616	A01p27900.2_BraZ1	577.5	-	3725	1990	1990	1.0000000
A01	15655116	15655795	A01p27910.2_BraZ1	324	-	431	679	679	1.0000000
A01	15662492	15664011	A01p27920.2_BraZ1	405	+	83	731	1519	0.4812376
A01	15668962	15669196	A01p27930.2_BraZ1	23.4	+	19	127	234	0.5427350
A01	15669774	15677526	A01p27940.2_BraZ1	768	+	5552	7709	7752	0.9944531
A01	15672007	15672349	A01p27950.2_BraZ1	34.2	-	475	342	342	1.0000000
A01	15673736	15674432	A01p27960.2_BraZ1	69.6	+	968	696	696	1.0000000
A01	15701065	15701518	A01p27970.2_BraZ1	381	+	63	443	453	0.9779249
A01	15711937	15714102	A01p27980.2_BraZ1	1274	-	12217	2165	2165	1.0000000
A01	15714090	15714689	A01p27990.2_BraZ1	264.562	-	3553	599	599	1.0000000
A01	15773438	15775045	A01p28000.2_BraZ1	858.071	+	993	1607	1607	1.0000000
A01	15779126	15779700	A01p28010.2_BraZ1	486	-	1446	574	574	1.0000000
A01	15779319	15780339	A01p28020.2_BraZ1	117	-	2591	1020	1020	1.0000000
A01	15791885	15792035	A01p28030.2_BraZ1	15	-	60	149	150	0.9933333
A01	15792621	15793746	A01p28040.2_BraZ1	717	+	173	984	1125	0.8746667
A01	15809196	15809603	A01p28050.2_BraZ1	303	+	497	407	407	1.0000000
A01	15810059	15812668	A01p28060.2_BraZ1	2454	-	28	949	2609	0.3637409
A01	15813374	15814448	A01p28070.2_BraZ1	526.527	-	567	1055	1074	0.9823091
A01	15824887	15827264	A01p28080.2_BraZ1	1419.72	-	467	1616	2377	0.6798486
A01	15827719	15829664	A01p28090.2_BraZ1	792	-	968	1819	1945	0.9352185
A01	15831544	15833458	A01p28100.2_BraZ1	191.4	+	2570	1914	1914	1.0000000
A01	15836394	15836787	A01p28110.2_BraZ1	39.3	+	708	393	393	1.0000000
A01	15839062	15841547	A01p28120.2_BraZ1	1908	-	438	1709	2485	0.6877264
A01	15846141	15846505	A01p28130.2_BraZ1	207.375	+	112	360	364	0.9890110
A01	15848039	15849226	A01p28140.2_BraZ1	337.5	-	480	1152	1187	0.9705139
A01	15855563	15857784	A01p28150.2_BraZ1	1720.5	+	144	1227	2221	0.5524539
A01	15867457	15874527	A01p28160.2_BraZ1	2773.96	+	767	3725	7070	0.5268741
A01	15876236	15876810	A01p28170.2_BraZ1	432	+	335	574	574	1.0000000
A01	15877533	15883603	A01p28180.2_BraZ1	4357.39	-	201	1889	6070	0.3112026
A01	15897044	15897965	A01p28190.2_BraZ1	336	-	516	921	921	1.0000000
A01	15898363	15898779	A01p28200.2_BraZ1	29.7	-	400	416	416	1.0000000
A01	15921102	15921306	A01p28210.2_BraZ1	20.4	-	239	204	204	1.0000000
A01	15923606	15924522	A01p28220.2_BraZ1	534	+	141	916	916	1.0000000
A01	15946112	15947253	A01p28230.2_BraZ1	37.5	+	585	1141	1141	1.0000000
A01	15947687	15954388	A01p28240.2_BraZ1	2941.47	-	1381	4692	6701	0.7001940
A01	15957497	15958571	A01p28250.2_BraZ1	315	+	20	22	1074	0.0204842
A01	16071007	16071367	A01p28260.2_BraZ1	237	+	408	360	360	1.0000000
A01	16080365	16080755	A01p28270.2_BraZ1	267	+	1237	390	390	1.0000000
A01	16080756	16080909	A01p28280.2_BraZ1	15.3	+	2209	153	153	1.0000000
A01	16089110	16089500	A01p28290.2_BraZ1	267	+	581	390	390	1.0000000
A01	16107412	16109285	A01p28300.2_BraZ1	393	-	4447	1873	1873	1.0000000
A01	16107957	16108347	A01p28310.2_BraZ1	267	+	1878	390	390	1.0000000
A01	16123147	16124688	A01p28320.2_BraZ1	324	-	21585	1541	1541	1.0000000
A01	16123692	16124082	A01p28330.2_BraZ1	267	+	3452	390	390	1.0000000
A01	16136260	16136650	A01p28340.2_BraZ1	267	+	317	390	390	1.0000000
A01	16144867	16145685	A01p28350.2_BraZ1	471	-	2996	818	818	1.0000000
A01	16157041	16157272	A01p28360.2_BraZ1	23.1	-	643	231	231	1.0000000
A01	16168204	16168324	A01p28370.2_BraZ1	12	-	134	120	120	1.0000000
A01	16182639	16183027	A01p28380.2_BraZ1	267	+	384	388	388	1.0000000
A01	16191670	16192060	A01p28390.2_BraZ1	267	+	420	390	390	1.0000000
A01	16210244	16210634	A01p28400.2_BraZ1	267	+	545	390	390	1.0000000
A01	16253585	16253975	A01p28410.2_BraZ1	267	+	793	390	390	1.0000000
A01	16262597	16262986	A01p28420.2_BraZ1	623	+	88	389	389	1.0000000
A01	16281771	16282148	A01p28430.2_BraZ1	219	+	110	377	377	1.0000000
A01	16303788	16304178	A01p28440.2_BraZ1	267	+	75	370	390	0.9487180
A01	16312627	16313017	A01p28450.2_BraZ1	267	+	414	390	390	1.0000000
A01	16354141	16376735	A01p28460.2_BraZ1	1104	+	7332	17263	22594	0.7640524
A01	16357462	16358374	A01p28470.2_BraZ1	339	-	87	870	912	0.9539474
A01	16384604	16421347	A01p28480.2_BraZ1	762	+	14992	30776	36743	0.8376017
A01	16392600	16395052	A01p28490.2_BraZ1	582	+	1701	2452	2452	1.0000000
A01	16402178	16412596	A01p28500.2_BraZ1	408	-	3686	8542	10418	0.8199270
A01	16409715	16412044	A01p28510.2_BraZ1	294	-	1039	1851	2329	0.7947617
A01	16440103	16440264	A01p28520.2_BraZ1	15.3	+	46	161	161	1.0000000
A01	16452074	16461398	A01p28530.2_BraZ1	393	+	3029	7352	9324	0.7885028
A01	16474272	16477619	A01p28540.2_BraZ1	405	+	1715	2164	3347	0.6465492
A01	16474393	16539804	A01p28550.2_BraZ1	474	-	43435	51226	65411	0.7831404
A01	16520482	16521258	A01p28560.2_BraZ1	536.25	-	17	333	776	0.4291237
A01	16556748	16599009	A01p28570.2_BraZ1	576	+	7599	30007	42261	0.7100400
A01	16564497	16565275	A01p28580.2_BraZ1	374.5	-	51	567	778	0.7287918
A01	16565273	16565897	A01p28590.2_BraZ1	144	+	5	76	624	0.1217949
A01	16581844	16582754	A01p28600.2_BraZ1	339	-	2	248	910	0.2725275
A01	16600014	16600791	A01p28610.2_BraZ1	471	-	15	513	777	0.6602316
A01	16717493	16717869	A01p28620.2_BraZ1	219	-	36	375	376	0.9973404
A01	16746363	16746752	A01p28630.2_BraZ1	267	-	1	126	389	0.3239075
A01	16755203	16755591	A01p28640.2_BraZ1	267	-	335	388	388	1.0000000
A01	16770332	16770722	A01p28650.2_BraZ1	267	-	1341	390	390	1.0000000
A01	16787987	16788373	A01p28660.2_BraZ1	616	-	2	173	386	0.4481865
A01	16795879	16805463	A01p28670.2_BraZ1	951	-	7901	8338	9584	0.8699917
A01	16796556	16797334	A01p28680.2_BraZ1	471	+	22	596	778	0.7660668
A01	16805655	16806044	A01p28690.2_BraZ1	623	-	16	213	389	0.5475578
A01	16813391	16813511	A01p28700.2_BraZ1	12	+	4	115	120	0.9583333
A01	16814262	16815039	A01p28710.2_BraZ1	47.1	+	349	387	777	0.4980695
A01	17014143	17014362	A01p28720.2_BraZ1	21.9	-	11	198	219	0.9041096
A01	17215898	17216283	A01p28730.2_BraZ1	285	+	24	76	385	0.1974026
A01	17321864	17322566	A01p28740.2_BraZ1	171	+	1454	702	702	1.0000000
A01	17384702	17385325	A01p28750.2_BraZ1	252	-	158	623	623	1.0000000
A01	17385975	17444151	A01p28760.2_BraZ1	447	-	15330	48934	58176	0.8411372
A01	17416479	17416857	A01p28770.2_BraZ1	201	+	211	299	378	0.7910053
A01	17433293	17433471	A01p28780.2_BraZ1	165	-	0	0	178	0.0000000
A01	17442761	17444614	A01p28790.2_BraZ1	318	+	451	1761	1853	0.9503508
A01	17461271	17461421	A01p28800.2_BraZ1	15	+	57	150	150	1.0000000
A01	17480864	17481847	A01p28810.2_BraZ1	318	+	380	983	983	1.0000000
A01	17503626	17505185	A01p28820.2_BraZ1	1062	-	509	1442	1559	0.9249519
A01	18146916	18147252	A01p28830.2_BraZ1	33.6	+	91	336	336	1.0000000
A01	18203038	18203410	A01p28840.2_BraZ1	37.2	+	20	372	372	1.0000000
A01	18826699	18826903	A01p28850.2_BraZ1	20.4	-	904	204	204	1.0000000
A01	18867818	18868903	A01p28860.2_BraZ1	312.5	-	553	1085	1085	1.0000000
A01	20116512	20116884	A01p28870.2_BraZ1	37.2	-	3	127	372	0.3413979
A01	20122512	20122884	A01p28880.2_BraZ1	37.2	-	42	288	372	0.7741935
A01	20128511	20128883	A01p28890.2_BraZ1	37.2	-	16	372	372	1.0000000
A01	21289763	21289958	A01p28900.2_BraZ1	17.7	-	794	195	195	1.0000000
A01	22630619	22631674	A01p28910.2_BraZ1	67.8	+	2671	1055	1055	1.0000000
A01	22733846	22735424	A01p28920.2_BraZ1	3915.5	+	413	1039	1578	0.6584284
A01	22869449	22869989	A01p28930.2_BraZ1	54	+	106	540	540	1.0000000
A01	22870134	22871070	A01p28940.2_BraZ1	370.6	+	223	936	936	1.0000000
A01	22980539	22982178	A01p28950.2_BraZ1	1317	-	3293	1639	1639	1.0000000
A01	23213661	23214069	A01p28960.2_BraZ1	3360	+	148	408	408	1.0000000
A01	23215026	23217670	A01p28970.2_BraZ1	4432.5	-	602	2644	2644	1.0000000
A01	23245692	23246574	A01p28980.2_BraZ1	531	+	763	882	882	1.0000000
A01	23250392	23251306	A01p28990.2_BraZ1	76.2	-	556	914	914	1.0000000
A01	23251956	23252253	A01p29000.2_BraZ1	243	+	68	297	297	1.0000000
A01	23252705	23253401	A01p29010.2_BraZ1	588	-	414	696	696	1.0000000
A01	23358934	23359162	A01p29020.2_BraZ1	22.8	+	189	228	228	1.0000000
A01	23461524	23462467	A01p29030.2_BraZ1	48.6	+	139	943	943	1.0000000
A01	23486040	23486832	A01p29040.2_BraZ1	489.938	-	59	617	792	0.7790404
A01	23489618	23494803	A01p29050.2_BraZ1	2215.83	-	418	3045	5185	0.5872710
A01	23518948	23519914	A01p29060.2_BraZ1	3168	-	576	966	966	1.0000000
A01	23544360	23544576	A01p29070.2_BraZ1	21.6	+	11	31	216	0.1435185
A01	23611068	23614118	A01p29080.2_BraZ1	1549.23	+	337	1678	3050	0.5501639
A01	23614755	23618882	A01p29090.2_BraZ1	1705.43	-	268	2525	4127	0.6118246
A01	23647679	23649338	A01p29100.2_BraZ1	165.9	+	110	651	1659	0.3924051
A01	23650254	23658990	A01p29110.2_BraZ1	406.875	-	9317	8736	8736	1.0000000
A01	23659835	23660306	A01p29120.2_BraZ1	47.1	+	69	441	471	0.9363058
A01	23665717	23666071	A01p29130.2_BraZ1	35.4	-	135	354	354	1.0000000
A01	23667485	23667854	A01p29140.2_BraZ1	35.4	-	173	369	369	1.0000000
A01	23669141	23671450	A01p29150.2_BraZ1	704.895	-	4210	2309	2309	1.0000000
A01	23673159	23673722	A01p29160.2_BraZ1	803.769	-	749	563	563	1.0000000
A01	23724985	23726565	A01p29170.2_BraZ1	814.917	-	262	953	1580	0.6031646
A01	23734643	23734757	A01p29180.2_BraZ1	11.4	-	27	114	114	1.0000000
A01	23744257	23745803	A01p29190.2_BraZ1	1313	+	914	746	1546	0.4825356
A01	23763533	23765168	A01p29200.2_BraZ1	671.707	+	66	1008	1635	0.6165138
A01	23767202	23770498	A01p29210.2_BraZ1	2295.48	-	293	1960	3296	0.5946602
A01	23800164	23800536	A01p29220.2_BraZ1	37.2	-	211	372	372	1.0000000
A01	23821358	23822081	A01p29230.2_BraZ1	47.7	-	171	723	723	1.0000000
A01	23865282	23865495	A01p29240.2_BraZ1	186	-	32	213	213	1.0000000
A01	23866223	23870182	A01p29250.2_BraZ1	318	+	4664	3959	3959	1.0000000
A01	23883610	23884002	A01p29260.2_BraZ1	207	-	131	392	392	1.0000000
A01	23885241	23894506	A01p29270.2_BraZ1	1089.41	+	10958	9265	9265	1.0000000
A01	23901098	23902229	A01p29280.2_BraZ1	855	+	35	530	1131	0.4686118
A01	23903243	23904011	A01p29290.2_BraZ1	74.1	-	1541	768	768	1.0000000
A01	23905623	23906068	A01p29300.2_BraZ1	231	-	1059	445	445	1.0000000
A01	23906907	23907282	A01p29310.2_BraZ1	37.5	-	873	375	375	1.0000000
A01	23925320	23926384	A01p29320.2_BraZ1	987	-	119	807	1064	0.7584587
A01	23937665	23937897	A01p29330.2_BraZ1	135	+	231	232	232	1.0000000
A01	23942613	23943153	A01p29340.2_BraZ1	54	+	385	540	540	1.0000000
A01	23943335	23956295	A01p29350.2_BraZ1	535.5	+	8077	12951	12960	0.9993055
A01	23946057	23947608	A01p29360.2_BraZ1	705	+	1399	1551	1551	1.0000000
A01	23954212	23954602	A01p29370.2_BraZ1	165	+	147	390	390	1.0000000
A01	23954643	23955153	A01p29380.2_BraZ1	231	+	260	510	510	1.0000000
A01	23956645	23957366	A01p29390.2_BraZ1	3021	+	94	307	721	0.4257975
A01	23957755	23958674	A01p29400.2_BraZ1	39	-	210	902	919	0.9815016
A01	23960592	23961962	A01p29410.2_BraZ1	77.4	-	116	1097	1370	0.8007299
A01	23965900	23967138	A01p29420.2_BraZ1	897	+	235	801	1238	0.6470113
A01	23969560	23971413	A01p29430.2_BraZ1	4972	+	785	1793	1853	0.9676201
A01	23972469	23972652	A01p29440.2_BraZ1	18.3	+	102	183	183	1.0000000
A01	23972733	23973048	A01p29450.2_BraZ1	234	+	59	315	315	1.0000000
A01	24000373	24000644	A01p29460.2_BraZ1	222	+	904	271	271	1.0000000
A01	24073439	24079023	A01p29470.2_BraZ1	2383.33	+	2212	3997	5584	0.7157951
A01	24086824	24087184	A01p29480.2_BraZ1	36	-	378	360	360	1.0000000
A01	24101889	24104305	A01p29490.2_BraZ1	2343	+	216	1139	2416	0.4714404
A01	24117469	24126240	A01p29500.2_BraZ1	68.7	-	1113	2577	8771	0.2938091
A01	24118891	24120446	A01p29510.2_BraZ1	796.8	-	2	154	1555	0.0990354
A01	24126891	24127188	A01p29520.2_BraZ1	243	+	281	297	297	1.0000000
A01	24127665	24128361	A01p29530.2_BraZ1	588	-	424	696	696	1.0000000
A01	24147382	24150289	A01p29540.2_BraZ1	1835.46	-	268	1818	2907	0.6253870
A01	24152721	24153183	A01p29550.2_BraZ1	46.2	-	18	106	462	0.2294372
A01	24164638	24165674	A01p29560.2_BraZ1	832.636	-	7	192	1036	0.1853282
A01	24172023	24172617	A01p29570.2_BraZ1	59.4	-	814	594	594	1.0000000
A01	24177941	24178331	A01p29580.2_BraZ1	39	+	389	390	390	1.0000000
A01	24179793	24181032	A01p29590.2_BraZ1	459.091	+	561	1239	1239	1.0000000
A01	24182057	24182397	A01p29600.2_BraZ1	171	-	222	340	340	1.0000000
A01	24189105	24190128	A01p29610.2_BraZ1	339.2	-	151	692	1023	0.6764418
A01	24191426	24191726	A01p29620.2_BraZ1	30	+	439	300	300	1.0000000
A01	24193382	24194066	A01p29630.2_BraZ1	361.667	-	635	684	684	1.0000000
A01	24195071	24195631	A01p29640.2_BraZ1	465	+	419	560	560	1.0000000
A01	24197998	24199053	A01p29650.2_BraZ1	3548.25	-	413	1055	1055	1.0000000
A01	24214535	24215717	A01p29660.2_BraZ1	411.346	-	570	1182	1182	1.0000000
A01	24226037	24226789	A01p29670.2_BraZ1	550.737	+	92	653	752	0.8683510
A01	24227145	24227874	A01p29680.2_BraZ1	408.692	+	3	116	729	0.1591221
A01	24242685	24243242	A01p29690.2_BraZ1	243	-	124	391	557	0.7019749
A01	24245564	24252409	A01p29700.2_BraZ1	1078.43	+	1812	5625	6845	0.8217677
A01	24253542	24253710	A01p29710.2_BraZ1	16.8	+	184	168	168	1.0000000
A01	24254870	24257140	A01p29720.2_BraZ1	1195.11	-	514	1689	2270	0.7440529
A01	24264058	24264979	A01p29730.2_BraZ1	517.5	-	575	818	921	0.8881651
A01	24274641	24275373	A01p29740.2_BraZ1	43.8	+	698	732	732	1.0000000
A01	24275395	24275892	A01p29750.2_BraZ1	30.9	-	456	497	497	1.0000000
A01	24283896	24284865	A01p29760.2_BraZ1	96.9	+	43	433	969	0.4468524
A01	24298390	24300711	A01p29770.2_BraZ1	1037.57	-	735	1743	2321	0.7509694
A01	24302597	24303981	A01p29780.2_BraZ1	549.25	-	392	1384	1384	1.0000000
A01	24305681	24307394	A01p29790.2_BraZ1	742.114	+	353	1539	1713	0.8984238
A01	24307478	24317190	A01p29800.2_BraZ1	77.7	+	10892	9311	9712	0.9587108
A01	24319551	24322815	A01p29810.2_BraZ1	1420.65	+	1191	3125	3264	0.9574142
A01	24323960	24326315	A01p29820.2_BraZ1	883.768	-	1828	2278	2355	0.9673036
A01	24338348	24340211	A01p29830.2_BraZ1	969.857	+	874	1863	1863	1.0000000
A01	24377683	24378226	A01p29840.2_BraZ1	657	-	729	543	543	1.0000000
A01	24378233	24379293	A01p29850.2_BraZ1	609	-	936	1060	1060	1.0000000
A01	24382500	24383339	A01p29860.2_BraZ1	696	-	618	839	839	1.0000000
A01	24397903	24402143	A01p29870.2_BraZ1	1135.71	+	4631	4240	4240	1.0000000
A01	24403889	24405759	A01p29880.2_BraZ1	609	-	2287	1870	1870	1.0000000
A01	24405759	24406128	A01p29890.2_BraZ1	276	-	734	369	369	1.0000000
A01	24410888	24412348	A01p29900.2_BraZ1	924	+	1216	1460	1460	1.0000000
A01	24413571	24413865	A01p29910.2_BraZ1	29.4	+	281	294	294	1.0000000
A01	24416471	24417826	A01p29920.2_BraZ1	630	+	534	1355	1355	1.0000000
A01	24418601	24418943	A01p29930.2_BraZ1	34.2	-	281	342	342	1.0000000
A01	24422274	24422595	A01p29940.2_BraZ1	30.9	-	127	321	321	1.0000000
A01	24425876	24429009	A01p29950.2_BraZ1	2736	-	1496	3133	3133	1.0000000
A01	24431843	24432111	A01p29960.2_BraZ1	159	-	231	268	268	1.0000000
A01	24437329	24438295	A01p29970.2_BraZ1	891	-	608	966	966	1.0000000
A01	24442640	24443066	A01p29980.2_BraZ1	7080	+	304	426	426	1.0000000
A01	24444102	24444868	A01p29990.2_BraZ1	696	-	174	766	766	1.0000000
A01	24444937	24446873	A01p30000.2_BraZ1	687	-	619	1862	1936	0.9617769
A01	24454346	24457796	A01p30010.2_BraZ1	219.6	+	2604	3355	3450	0.9724638
A01	24458655	24460719	A01p30020.2_BraZ1	828	-	5025	2064	2064	1.0000000
A01	24483234	24483521	A01p30030.2_BraZ1	228	-	234	287	287	1.0000000
A01	24487080	24488410	A01p30040.2_BraZ1	1170.44	+	34	348	1330	0.2616541
A01	24488742	24492783	A01p30050.2_BraZ1	1066.79	-	70	1861	4041	0.4605296
A01	24501099	24504825	A01p30060.2_BraZ1	2751	-	1694	3615	3726	0.9702094
A01	24518781	24519003	A01p30070.2_BraZ1	22.2	+	43	197	222	0.8873874
A01	24524488	24525732	A01p30080.2_BraZ1	915	-	58	785	1244	0.6310290
A01	24526244	24526705	A01p30090.2_BraZ1	258	+	270	461	461	1.0000000
A01	24556280	24558062	A01p30100.2_BraZ1	1131	+	4076	1782	1782	1.0000000
A01	24561083	24565862	A01p30110.2_BraZ1	690	-	19108	4779	4779	1.0000000
A01	24563771	24564929	A01p30120.2_BraZ1	91.2	-	6766	1158	1158	1.0000000
A01	24565366	24574100	A01p30130.2_BraZ1	343.875	-	7435	8734	8734	1.0000000
A01	24589744	24591071	A01p30140.2_BraZ1	632.083	+	6	243	1327	0.1831198
A01	24591409	24594100	A01p30150.2_BraZ1	382.465	-	203	1991	2691	0.7398736
A01	24593835	24611630	A01p30160.2_BraZ1	316.37	-	4063	16556	17795	0.9303737
A01	24614035	24618307	A01p30170.2_BraZ1	2693.07	-	306	2661	4272	0.6228933
A01	24618624	24621673	A01p30180.2_BraZ1	1228.2	+	108	1838	3049	0.6028206
A01	24682499	24682834	A01p30190.2_BraZ1	30	+	0	0	335	0.0000000
A01	24691148	24691508	A01p30200.2_BraZ1	18.3	-	160	360	360	1.0000000
A01	24717994	24718329	A01p30210.2_BraZ1	30	+	0	0	335	0.0000000
A01	24728538	24730017	A01p30220.2_BraZ1	147.9	-	787	1479	1479	1.0000000
A01	24729794	24730469	A01p30230.2_BraZ1	213	-	350	675	675	1.0000000
A01	24737288	24737631	A01p30240.2_BraZ1	18.3	-	501	343	343	1.0000000
A01	24752263	24752687	A01p30250.2_BraZ1	2907	+	1707	424	424	1.0000000
A01	24760892	24761227	A01p30260.2_BraZ1	30	+	0	0	335	0.0000000
A01	24795285	24795620	A01p30270.2_BraZ1	30	+	0	0	335	0.0000000
A01	24805362	24805701	A01p30280.2_BraZ1	33.9	-	192	339	339	1.0000000
A01	24828851	24831009	A01p30290.2_BraZ1	275.438	+	2993	2158	2158	1.0000000
A01	24829136	24831129	A01p30300.2_BraZ1	201	+	3534	1993	1993	1.0000000
A01	24856679	24856961	A01p30310.2_BraZ1	28.2	-	83	282	282	1.0000000
A01	24870553	24870730	A01p30320.2_BraZ1	17.7	+	191	177	177	1.0000000
A01	24871562	24882026	A01p30330.2_BraZ1	342	+	6010	10437	10464	0.9974197
A01	24889040	24889296	A01p30340.2_BraZ1	159	+	81	256	256	1.0000000
A01	24921619	24922582	A01p30350.2_BraZ1	656.25	-	113	727	963	0.7549325
A01	24936972	24948224	A01p30360.2_BraZ1	453.276	-	8243	9968	11252	0.8858870
A01	24941041	24941416	A01p30370.2_BraZ1	282	-	154	375	375	1.0000000
A01	24948157	24949826	A01p30380.2_BraZ1	307.412	-	41	939	1669	0.5626124
A01	24949803	24951371	A01p30390.2_BraZ1	324.776	-	433	1506	1568	0.9604592
A01	24957861	24958722	A01p30400.2_BraZ1	361.029	-	39	735	861	0.8536586
A01	24958701	24959322	A01p30410.2_BraZ1	428.571	-	92	486	621	0.7826087
A01	24959639	24963908	A01p30420.2_BraZ1	2459.77	+	876	2602	4269	0.6095104
A01	24964929	24965181	A01p30430.2_BraZ1	25.2	-	93	252	252	1.0000000
A01	24969695	24983324	A01p30440.2_BraZ1	6181.33	+	9351	13044	13629	0.9570768
A01	24985963	24986446	A01p30450.2_BraZ1	202.667	+	297	483	483	1.0000000
A01	24996450	24996938	A01p30460.2_BraZ1	747.5	-	233	488	488	1.0000000
A01	24999895	25001917	A01p30470.2_BraZ1	42.9	-	1797	2022	2022	1.0000000
A01	25002578	25002809	A01p30480.2_BraZ1	23.1	-	190	231	231	1.0000000
A01	25017275	25018412	A01p30490.2_BraZ1	567	-	4447	1137	1137	1.0000000
A01	25018598	25019581	A01p30500.2_BraZ1	1638	-	1879	983	983	1.0000000
A01	25021477	25022857	A01p30510.2_BraZ1	11086.5	+	285	1111	1380	0.8050725
A01	25027086	25028121	A01p30520.2_BraZ1	300	+	912	1035	1035	1.0000000
A01	25029781	25029976	A01p30530.2_BraZ1	19.5	+	459	195	195	1.0000000
A01	25031266	25033918	A01p30540.2_BraZ1	1922.86	-	536	2369	2652	0.8932881
A01	25040865	25041933	A01p30550.2_BraZ1	106.8	-	745	1068	1068	1.0000000
A01	25045958	25046388	A01p30560.2_BraZ1	381	+	369	430	430	1.0000000
A01	25051092	25053122	A01p30570.2_BraZ1	15552	-	1084	2025	2030	0.9975370
A01	25057561	25058970	A01p30580.2_BraZ1	1317	-	228	1118	1409	0.7934706
A01	25065834	25067961	A01p30590.2_BraZ1	596.7	+	1824	2127	2127	1.0000000
A01	25073761	25076444	A01p30600.2_BraZ1	1517.59	-	1728	2302	2683	0.8579948
A01	25079661	25080041	A01p30610.2_BraZ1	186	-	623	380	380	1.0000000
A01	25080959	25083571	A01p30620.2_BraZ1	1107.22	-	900	2549	2612	0.9758806
A01	25092274	25093694	A01p30630.2_BraZ1	952.391	-	73	976	1420	0.6873239
A01	25119959	25121229	A01p30640.2_BraZ1	126	+	200	1069	1270	0.8417323
A01	25121552	25123137	A01p30650.2_BraZ1	746.46	-	156	1114	1585	0.7028391
A01	25127882	25128293	A01p30660.2_BraZ1	270	-	0	0	411	0.0000000
A01	25130729	25134032	A01p30670.2_BraZ1	291	+	2954	3303	3303	1.0000000
A01	25136108	25140621	A01p30680.2_BraZ1	1619.75	+	1418	4456	4513	0.9873698
A01	25140621	25142067	A01p30690.2_BraZ1	423	+	1068	1446	1446	1.0000000
A01	25140943	25148600	A01p30700.2_BraZ1	329.875	+	3585	5490	7657	0.7169910
A01	25150212	25150635	A01p30710.2_BraZ1	25.8	+	303	423	423	1.0000000
A01	25151783	25155913	A01p30720.2_BraZ1	1824.64	-	2693	3772	4130	0.9133172
A01	25158137	25158629	A01p30730.2_BraZ1	49.2	+	255	492	492	1.0000000
A01	25159449	25163408	A01p30740.2_BraZ1	3423	+	804	1876	3959	0.4738570
A01	25163711	25167200	A01p30750.2_BraZ1	1518.95	-	845	1366	3489	0.3915162
A01	25171564	25174067	A01p30760.2_BraZ1	4329	+	1496	2326	2503	0.9292849
A01	25175368	25176766	A01p30770.2_BraZ1	249.6	-	510	1398	1398	1.0000000
A01	25183293	25183473	A01p30780.2_BraZ1	18	+	163	180	180	1.0000000
A01	25187128	25200109	A01p30790.2_BraZ1	7271.2	+	562	4246	12981	0.3270935
A01	25204409	25215886	A01p30800.2_BraZ1	6971.08	-	664	5330	11477	0.4644071
A01	25219160	25221278	A01p30810.2_BraZ1	207	+	295	1483	2118	0.7001889
A01	25228811	25230676	A01p30820.2_BraZ1	781.452	-	1923	1865	1865	1.0000000
A01	25231333	25232647	A01p30830.2_BraZ1	131.4	-	623	1314	1314	1.0000000
A01	25233009	25233435	A01p30840.2_BraZ1	42.6	-	177	426	426	1.0000000
A01	25233495	25233809	A01p30850.2_BraZ1	255	-	80	183	314	0.5828025
A01	25237340	25238603	A01p30860.2_BraZ1	126.3	-	330	1205	1263	0.9540776
A01	25247584	25248565	A01p30870.2_BraZ1	399	-	7	561	981	0.5718654
A01	25247584	25250333	A01p30880.2_BraZ1	53.2	-	48	1186	2749	0.4314296
A01	25249351	25252098	A01p30890.2_BraZ1	725.4	-	50	879	2747	0.3199854
A01	25252884	25255629	A01p30900.2_BraZ1	824.25	-	137	1613	2745	0.5876138
A01	25253249	25253866	A01p30910.2_BraZ1	39.9	-	2	247	617	0.4003241
A01	25256469	25257393	A01p30920.2_BraZ1	92.4	-	87	621	924	0.6720779
A01	25275458	25276205	A01p30930.2_BraZ1	74.7	-	573	747	747	1.0000000
A01	25290371	25292410	A01p30940.2_BraZ1	1737	-	402	1753	2039	0.8597352
A01	25293519	25293871	A01p30950.2_BraZ1	254.625	-	14	271	352	0.7698864
A01	25295772	25296039	A01p30960.2_BraZ1	26.7	-	0	0	267	0.0000000
A01	25299445	25300231	A01p30970.2_BraZ1	690	+	14	346	786	0.4402035
A01	25301126	25302544	A01p30980.2_BraZ1	931.98	-	973	1418	1418	1.0000000
A01	25307378	25313211	A01p30990.2_BraZ1	890.842	-	2233	5559	5833	0.9530259
A01	25321793	25322385	A01p31000.2_BraZ1	183	+	0	0	592	0.0000000
A01	25323882	25326366	A01p31010.2_BraZ1	867.5	+	456	1573	2484	0.6332528
A01	25324946	25326240	A01p31020.2_BraZ1	325.5	+	387	1215	1294	0.9389490
A01	25326825	25327433	A01p31030.2_BraZ1	108	+	84	454	608	0.7467105
A01	25329908	25333996	A01p31040.2_BraZ1	2079.24	+	3402	4004	4088	0.9794521
A01	25334662	25336783	A01p31050.2_BraZ1	212.1	-	1165	2121	2121	1.0000000
A01	25341529	25343422	A01p31060.2_BraZ1	1167.09	-	1255	1893	1893	1.0000000
A01	25353370	25353760	A01p31070.2_BraZ1	293.7	-	206	388	390	0.9948718
A01	25361126	25363863	A01p31080.2_BraZ1	34.2	-	4332	2735	2737	0.9992692
A01	25366452	25369545	A01p31090.2_BraZ1	2318.29	+	324	2478	3093	0.8011639
A01	25375788	25377857	A01p31100.2_BraZ1	312	-	935	2012	2069	0.9724504
A01	25401233	25404009	A01p31110.2_BraZ1	2599.24	+	450	2536	2776	0.9135447
A01	25409145	25410533	A01p31120.2_BraZ1	5478	+	724	1388	1388	1.0000000
A01	25411280	25467816	A01p31130.2_BraZ1	404	+	81031	45779	56536	0.8097318
A01	25420433	25424855	A01p31140.2_BraZ1	2251.7	+	16951	4422	4422	1.0000000
A01	25464988	25465525	A01p31150.2_BraZ1	190	+	7784	537	537	1.0000000
A01	25465567	25466333	A01p31160.2_BraZ1	520	+	7542	766	766	1.0000000
A01	25468270	25468462	A01p31170.2_BraZ1	19.2	+	312	192	192	1.0000000
A01	25473363	25474515	A01p31180.2_BraZ1	543.481	-	404	995	1152	0.8637153
A01	25476846	25477588	A01p31190.2_BraZ1	257.25	+	136	348	742	0.4690027
A01	25477929	25478522	A01p31200.2_BraZ1	231	+	2	100	593	0.1686341
A01	25488864	25489740	A01p31210.2_BraZ1	87.6	+	46	655	876	0.7477169
A01	25499498	25499750	A01p31220.2_BraZ1	25.2	-	463	252	252	1.0000000
A01	25500456	25500792	A01p31230.2_BraZ1	33.6	+	855	336	336	1.0000000
A01	25500841	25502111	A01p31240.2_BraZ1	414	+	4823	1270	1270	1.0000000
A01	25510834	25511435	A01p31250.2_BraZ1	234	+	18	478	601	0.7953411
A01	25511223	25511609	A01p31260.2_BraZ1	312	-	7	252	386	0.6528497
A01	25515841	25517425	A01p31270.2_BraZ1	684	+	1163	1455	1584	0.9185606
A01	25535036	25537728	A01p31280.2_BraZ1	1544.06	+	312	1290	2692	0.4791976
A01	25552216	25552438	A01p31290.2_BraZ1	22.2	-	221	222	222	1.0000000
A01	25557729	25558026	A01p31300.2_BraZ1	29.7	-	109	297	297	1.0000000
A01	25580677	25581482	A01p31310.2_BraZ1	528	+	2186	805	805	1.0000000
A01	25595264	25601067	A01p31320.2_BraZ1	123	-	258	257	5803	0.0442874
A01	25601338	25604227	A01p31330.2_BraZ1	107.4	-	6972	2639	2889	0.9134648
A01	25607755	25610281	A01p31340.2_BraZ1	1361.05	+	2548	2428	2526	0.9612035
A01	25619387	25626194	A01p31350.2_BraZ1	1006.09	+	3230	6232	6807	0.9155281
A01	25632333	25634255	A01p31360.2_BraZ1	1512	+	226	1735	1922	0.9027055
A01	25643324	25644140	A01p31370.2_BraZ1	696	-	121	624	816	0.7647059
A01	25645226	25645568	A01p31380.2_BraZ1	34.2	+	50	342	342	1.0000000
A01	25646907	25647603	A01p31390.2_BraZ1	69.6	-	99	641	696	0.9209770
A01	25663461	25663605	A01p31400.2_BraZ1	14.4	-	6	48	144	0.3333333
A01	25663715	25665006	A01p31410.2_BraZ1	1219.5	-	214	1219	1291	0.9442293
A01	25667894	25670380	A01p31420.2_BraZ1	2880	+	6102	2478	2486	0.9967820
A01	25670900	25673358	A01p31430.2_BraZ1	1093.59	-	3168	2449	2458	0.9963385
A01	25680350	25680940	A01p31440.2_BraZ1	51	-	1941	590	590	1.0000000
A01	25681751	25684165	A01p31450.2_BraZ1	609.84	+	5980	2414	2414	1.0000000
A01	25684453	25685797	A01p31460.2_BraZ1	621	+	1057	1344	1344	1.0000000
A01	25688314	25694167	A01p31470.2_BraZ1	2691.45	-	5145	5661	5853	0.9671963
A01	25696569	25697907	A01p31480.2_BraZ1	886.312	-	3	65	1338	0.0485800
A01	25705665	25706832	A01p31490.2_BraZ1	261	-	1875	1167	1167	1.0000000
A01	25707095	25707380	A01p31500.2_BraZ1	28.5	+	439	285	285	1.0000000
A01	25707708	25708045	A01p31510.2_BraZ1	29.7	+	731	337	337	1.0000000
A01	25711449	25712844	A01p31520.2_BraZ1	139.5	+	1041	1378	1395	0.9878136
A01	25713040	25714489	A01p31530.2_BraZ1	601.067	-	2010	1449	1449	1.0000000
A01	25716268	25724612	A01p31540.2_BraZ1	3194.7	-	2360	7085	8344	0.8491131
A01	25725297	25725584	A01p31550.2_BraZ1	225	+	3	95	287	0.3310105
A01	25732874	25737727	A01p31560.2_BraZ1	2677.25	+	4637	4624	4853	0.9528127
A01	25737932	25741582	A01p31570.2_BraZ1	1798.73	-	3531	3650	3650	1.0000000
A01	25761676	25763031	A01p31580.2_BraZ1	785.333	-	1313	1280	1355	0.9446495
A01	25772724	25777744	A01p31590.2_BraZ1	1904	-	4670	3843	5020	0.7655379
A01	25783694	25788702	A01p31600.2_BraZ1	276	+	1320	2703	5008	0.5397364
A01	25789314	25789543	A01p31610.2_BraZ1	20.7	+	187	229	229	1.0000000
A01	25792762	25793401	A01p31620.2_BraZ1	477	+	307	639	639	1.0000000
A01	25804086	25820005	A01p31630.2_BraZ1	1014.31	-	3230	11819	15919	0.7424461
A01	25815528	25816053	A01p31640.2_BraZ1	296.903	+	23	434	525	0.8266667
A01	25820210	25820438	A01p31650.2_BraZ1	22.8	-	250	219	228	0.9605263
A01	25820850	25825072	A01p31660.2_BraZ1	1020.7	-	3336	4126	4222	0.9772620
A01	25830359	25830573	A01p31670.2_BraZ1	19.8	-	302	214	214	1.0000000
A01	25831210	25837859	A01p31680.2_BraZ1	2666.1	-	1090	5767	6649	0.8673485
A01	25845348	25847424	A01p31690.2_BraZ1	960.48	+	1533	2076	2076	1.0000000
A01	25851455	25852094	A01p31700.2_BraZ1	63.9	-	338	639	639	1.0000000
A01	25860858	25861772	A01p31710.2_BraZ1	316	+	606	895	914	0.9792122
A01	25875219	25875574	A01p31720.2_BraZ1	168	+	544	355	355	1.0000000
A01	25877179	25877746	A01p31730.2_BraZ1	126	-	342	567	567	1.0000000
A01	25883403	25884752	A01p31740.2_BraZ1	1143	-	107	829	1349	0.6145293
A01	25894000	25897860	A01p31750.2_BraZ1	986.621	-	614	2497	3860	0.6468912
A01	25902523	25903775	A01p31760.2_BraZ1	14331	+	223	1148	1252	0.9169329
A01	25904399	25908204	A01p31770.2_BraZ1	2211.05	-	283	2296	3805	0.6034166
A01	25911811	25913100	A01p31780.2_BraZ1	1086	-	163	1220	1289	0.9464701
A01	25917239	25917918	A01p31790.2_BraZ1	315	+	552	679	679	1.0000000
A01	25926269	25927416	A01p31800.2_BraZ1	1074	-	10	214	1147	0.1865737
A01	25930256	25930627	A01p31810.2_BraZ1	285	-	448	371	371	1.0000000
A01	25939327	25945861	A01p31820.2_BraZ1	3224.44	+	11878	6482	6534	0.9920416
A01	25943352	25943940	A01p31830.2_BraZ1	58.2	+	527	584	588	0.9931973
A01	25946637	25947312	A01p31840.2_BraZ1	41.1	-	742	675	675	1.0000000
A01	25947605	25948316	A01p31850.2_BraZ1	71.1	+	348	711	711	1.0000000
A01	25948961	25949674	A01p31860.2_BraZ1	66.9	-	1595	713	713	1.0000000
A01	25950073	25952889	A01p31870.2_BraZ1	5305.5	-	5108	2816	2816	1.0000000
A01	25952338	25954090	A01p31880.2_BraZ1	3474	-	1564	1752	1752	1.0000000
A01	25959963	25960203	A01p31890.2_BraZ1	24	+	177	240	240	1.0000000
A01	25960935	25964428	A01p31900.2_BraZ1	11755.2	-	873	2511	3493	0.7188663
A01	25965037	25966054	A01p31910.2_BraZ1	101.7	-	472	1017	1017	1.0000000
A01	25990742	25990859	A01p31920.2_BraZ1	11.7	-	177	117	117	1.0000000
A01	26000751	26002501	A01p31930.2_BraZ1	1562.2	+	327	1202	1750	0.6868572
A01	26005352	26010912	A01p31940.2_BraZ1	1168.14	-	3882	5560	5560	1.0000000
A01	26012258	26012410	A01p31950.2_BraZ1	12.3	-	54	152	152	1.0000000
A01	26014226	26014763	A01p31960.2_BraZ1	453	-	465	168	537	0.3128492
A01	26015465	26023016	A01p31970.2_BraZ1	882.45	-	5634	7495	7551	0.9925838
A01	26026734	26027019	A01p31980.2_BraZ1	156	-	942	285	285	1.0000000
A01	26033016	26033662	A01p31990.2_BraZ1	303	+	408	646	646	1.0000000
A01	26037878	26038339	A01p32000.2_BraZ1	363	-	365	461	461	1.0000000
A01	26038501	26038753	A01p32010.2_BraZ1	20.7	+	25	252	252	1.0000000
A01	26048182	26050762	A01p32020.2_BraZ1	1238.28	+	1398	2319	2580	0.8988372
A01	26065443	26068148	A01p32030.2_BraZ1	1500	+	1079	2396	2705	0.8857671
A01	26073638	26074007	A01p32040.2_BraZ1	35.1	+	286	369	369	1.0000000
A01	26074935	26076035	A01p32050.2_BraZ1	825	+	471	1100	1100	1.0000000
A01	26077383	26077821	A01p32060.2_BraZ1	258	+	119	388	438	0.8858448
A01	26093555	26094469	A01p32070.2_BraZ1	30	-	3642	914	914	1.0000000
A01	26096061	26096404	A01p32080.2_BraZ1	18.6	+	343	343	343	1.0000000
A01	26105763	26107797	A01p32090.2_BraZ1	1965	+	262	1292	2034	0.6352016
A01	26110922	26111900	A01p32100.2_BraZ1	864	-	29	469	978	0.4795501
A01	26117693	26118632	A01p32110.2_BraZ1	852	-	9	81	939	0.0862620
A01	26122596	26125045	A01p32120.2_BraZ1	1836.52	-	199	1794	2449	0.7325439
A01	26134584	26136030	A01p32130.2_BraZ1	920.857	+	785	1446	1446	1.0000000
A01	26139641	26139815	A01p32140.2_BraZ1	17.4	-	6	122	174	0.7011494
A01	26143077	26143356	A01p32150.2_BraZ1	297	-	125	223	279	0.7992831
A01	26145987	26146515	A01p32160.2_BraZ1	52.8	+	115	359	528	0.6799242
A01	26146909	26162513	A01p32170.2_BraZ1	1702.92	-	6381	11476	15604	0.7354525
A01	26167701	26169582	A01p32180.2_BraZ1	1091.38	+	1223	1881	1881	1.0000000
A01	26174912	26176908	A01p32190.2_BraZ1	1929	-	357	1529	1996	0.7660320
A01	26178156	26179341	A01p32200.2_BraZ1	745.588	-	1233	1178	1185	0.9940928
A01	26181630	26181996	A01p32210.2_BraZ1	36.6	-	465	366	366	1.0000000
A01	26184627	26186749	A01p32220.2_BraZ1	500	+	1435	2001	2122	0.9429783
A01	26192962	26199077	A01p32230.2_BraZ1	387	+	297	4644	6115	0.7594440
A01	26199575	26202660	A01p32240.2_BraZ1	138.3	+	33	1333	3085	0.4320908
A01	26205641	26206004	A01p32250.2_BraZ1	207	-	2	33	363	0.0909091
A01	26207528	26208794	A01p32260.2_BraZ1	723	-	6	393	1266	0.3104265
A01	26219404	26221898	A01p32270.2_BraZ1	1440.83	+	3082	2057	2494	0.8247795
A01	26228383	26229777	A01p32280.2_BraZ1	99.6	+	85	954	1394	0.6843616
A01	26236840	26237909	A01p32290.2_BraZ1	234.614	-	23	355	1069	0.3320861
A01	26238540	26241259	A01p32300.2_BraZ1	166.8	+	622	1683	2719	0.6189775
A01	26241746	26244328	A01p32310.2_BraZ1	1201.86	-	1217	1903	2582	0.7370256
A01	26258753	26259815	A01p32320.2_BraZ1	429.3	-	6	216	1062	0.2033898
A01	26260528	26262071	A01p32330.2_BraZ1	5926.5	+	1025	1543	1543	1.0000000
A01	26266086	26269536	A01p32340.2_BraZ1	1857.29	-	3040	3431	3450	0.9944928
A01	26283953	26284440	A01p32350.2_BraZ1	321	+	1735	487	487	1.0000000
A01	26286073	26286494	A01p32360.2_BraZ1	198	+	21	303	421	0.7197149
A01	26286993	26287128	A01p32370.2_BraZ1	13.5	+	247	135	135	1.0000000
A01	26289739	26295181	A01p32380.2_BraZ1	2445.73	-	180	2741	5442	0.5036751
A01	26308088	26311668	A01p32390.2_BraZ1	1486.07	+	1235	3359	3580	0.9382682
A01	26312254	26313316	A01p32400.2_BraZ1	106.2	-	326	884	1062	0.8323917
A01	26319856	26322243	A01p32410.2_BraZ1	885.258	-	831	2109	2387	0.8835358
A01	26336705	26337935	A01p32420.2_BraZ1	512.679	-	137	830	1230	0.6747968
A01	26343022	26344321	A01p32430.2_BraZ1	301.467	+	1132	1299	1299	1.0000000
A01	26349520	26353230	A01p32440.2_BraZ1	1590.7	+	865	3349	3710	0.9026954
A01	26354024	26354471	A01p32450.2_BraZ1	44.7	+	59	190	447	0.4250559
A01	26358797	26360097	A01p32460.2_BraZ1	23142	-	788	1300	1300	1.0000000
A01	26370301	26373206	A01p32470.2_BraZ1	1473.46	-	1164	2058	2905	0.7084337
A01	26395092	26396720	A01p32480.2_BraZ1	1053	+	77	780	1628	0.4791155
A01	26400510	26400899	A01p32490.2_BraZ1	291	+	17	121	389	0.3110540
A01	26403856	26410383	A01p32500.2_BraZ1	966	-	4722	6344	6527	0.9719626
A01	26410597	26412514	A01p32510.2_BraZ1	102	+	1885	1917	1917	1.0000000
A01	26416736	26419069	A01p32520.2_BraZ1	782.727	-	1424	2155	2333	0.9237034
A01	26430555	26432264	A01p32530.2_BraZ1	1110	-	309	1399	1709	0.8186074
A01	26437912	26438854	A01p32540.2_BraZ1	253	-	344	942	942	1.0000000
A01	26440011	26444353	A01p32550.2_BraZ1	1138.26	-	1087	4151	4342	0.9560111
A01	26446969	26447847	A01p32560.2_BraZ1	300	-	76	574	878	0.6537585
A01	26453136	26454648	A01p32570.2_BraZ1	724.5	-	210	1239	1512	0.8194444
A01	26457263	26459854	A01p32580.2_BraZ1	2039.67	-	1305	2591	2591	1.0000000
A01	26460623	26462513	A01p32590.2_BraZ1	189	+	492	1412	1890	0.7470899
A01	26463103	26464014	A01p32600.2_BraZ1	321	-	307	908	911	0.9967069
A01	26470088	26470446	A01p32610.2_BraZ1	234	-	11	243	358	0.6787710
A01	26475911	26479275	A01p32620.2_BraZ1	2058.71	-	1094	2563	3364	0.7618906
A01	26485405	26488810	A01p32630.2_BraZ1	1943.1	-	1125	2855	3405	0.8384728
A01	26492282	26492840	A01p32640.2_BraZ1	36	-	268	548	558	0.9820789
A01	26496876	26498820	A01p32650.2_BraZ1	749.7	-	1045	1330	1944	0.6841564
A01	26505057	26506432	A01p32660.2_BraZ1	135.3	-	363	1375	1375	1.0000000
A01	26514485	26516069	A01p32670.2_BraZ1	286	-	1342	1301	1584	0.8213384
A01	26524362	26527987	A01p32680.2_BraZ1	1334.5	-	258	2309	3625	0.6369655
A01	26532118	26536990	A01p32690.2_BraZ1	3248.53	-	860	3520	4872	0.7224959
A01	26544351	26544780	A01p32700.2_BraZ1	42.9	+	34	186	429	0.4335664
A01	26546053	26547137	A01p32710.2_BraZ1	449.717	+	886	1084	1084	1.0000000
A01	26549226	26550718	A01p32720.2_BraZ1	471	+	89	1229	1492	0.8237265
A01	26552375	26553119	A01p32730.2_BraZ1	74.4	+	36	474	744	0.6370968
A01	26553441	26554826	A01p32740.2_BraZ1	475.629	+	1571	1385	1385	1.0000000
A01	26572296	26573920	A01p32750.2_BraZ1	139.92	+	2572	1624	1624	1.0000000
A01	26582322	26582638	A01p32760.2_BraZ1	258	+	93	316	316	1.0000000
A01	26585105	26586760	A01p32770.2_BraZ1	131.25	+	674	1653	1655	0.9987915
A01	26588056	26593194	A01p32780.2_BraZ1	122.96	+	93	1542	5138	0.3001168
A01	26594475	26596115	A01p32790.2_BraZ1	848	+	263	1563	1640	0.9530488
A01	26594475	26601067	A01p32800.2_BraZ1	980.5	+	1865	5770	6592	0.8753034
A01	26598394	26598710	A01p32810.2_BraZ1	1147.5	+	129	316	316	1.0000000
A01	26602324	26603679	A01p32820.2_BraZ1	212.727	+	247	1331	1355	0.9822878
A01	26608280	26612593	A01p32830.2_BraZ1	161	+	2417	3923	4313	0.9095757
A01	26608344	26609665	A01p32840.2_BraZ1	178.875	+	1588	1321	1321	1.0000000
A01	26634562	26635518	A01p32850.2_BraZ1	221.591	+	462	910	956	0.9518828
A01	26650518	26656722	A01p32860.2_BraZ1	2549.51	+	4963	6147	6204	0.9908124
A01	26658058	26660086	A01p32870.2_BraZ1	1434.34	+	1239	2001	2028	0.9866864
A01	26666712	26666832	A01p32880.2_BraZ1	12	+	79	120	120	1.0000000
A01	26668840	26671410	A01p32890.2_BraZ1	1166.99	+	1159	2570	2570	1.0000000
A01	26673291	26675471	A01p32900.2_BraZ1	862.372	+	1927	2154	2180	0.9880734
A01	26678790	26679300	A01p32910.2_BraZ1	51	-	44	388	510	0.7607843
A01	26684361	26685363	A01p32920.2_BraZ1	1386	-	158	948	1002	0.9461078
A01	26691602	26692962	A01p32930.2_BraZ1	204	+	339	1088	1360	0.8000000
A01	26693692	26694440	A01p32940.2_BraZ1	280.35	-	0	0	748	0.0000000
A01	26695057	26695461	A01p32950.2_BraZ1	23.1	+	10	139	404	0.3440594
A01	26700194	26701306	A01p32960.2_BraZ1	6960	-	766	1112	1112	1.0000000
A01	26703768	26703999	A01p32970.2_BraZ1	16.8	+	521	231	231	1.0000000
A01	26708359	26708745	A01p32980.2_BraZ1	32.7	+	293	386	386	1.0000000
A01	26716374	26718792	A01p32990.2_BraZ1	1761	-	449	2087	2418	0.8631100
A01	26727307	26729116	A01p33000.2_BraZ1	1413.36	+	37	228	1809	0.1260365
A01	26736410	26736924	A01p33010.2_BraZ1	183	-	526	514	514	1.0000000
A01	26737055	26737178	A01p33020.2_BraZ1	12.3	+	273	123	123	1.0000000
A01	26739652	26741461	A01p33030.2_BraZ1	1413.36	+	69	751	1809	0.4151465
A01	26758810	26760085	A01p33040.2_BraZ1	7194.75	+	531	1270	1275	0.9960784
A01	26763541	26763658	A01p33050.2_BraZ1	11.7	-	279	117	117	1.0000000
A01	26764092	26767029	A01p33060.2_BraZ1	2084.75	-	662	2722	2937	0.9267961
A01	26770714	26773669	A01p33070.2_BraZ1	3358.33	-	1512	2538	2955	0.8588833
A01	26786584	26786854	A01p33080.2_BraZ1	27	+	264	270	270	1.0000000
A01	26795816	26796623	A01p33090.2_BraZ1	441	+	634	807	807	1.0000000
A01	26800567	26802028	A01p33100.2_BraZ1	711	+	1063	1461	1461	1.0000000
A01	26809488	26810045	A01p33110.2_BraZ1	930	-	57	457	557	0.8204668
A01	26811284	26814284	A01p33120.2_BraZ1	15338.2	-	1776	2925	3000	0.9750000
A01	26816625	26817623	A01p33130.2_BraZ1	822	+	74	649	998	0.6503006
A01	26818208	26821470	A01p33140.2_BraZ1	1669.22	-	1675	3159	3262	0.9684243
A01	26833135	26833246	A01p33150.2_BraZ1	11.1	-	0	0	111	0.0000000
A01	26851987	26852473	A01p33160.2_BraZ1	231	-	354	478	486	0.9835391
A01	26856428	26856656	A01p33170.2_BraZ1	22.8	-	30	135	228	0.5921053
A01	26861627	26861855	A01p33180.2_BraZ1	22.8	+	51	223	228	0.9780702
A01	26867125	26867518	A01p33190.2_BraZ1	38.8636	-	478	393	393	1.0000000
A01	26875898	26876507	A01p33200.2_BraZ1	225	-	413	592	609	0.9720854
A01	26879206	26879602	A01p33210.2_BraZ1	156	-	204	396	396	1.0000000
A01	26882495	26884034	A01p33220.2_BraZ1	1240.91	-	726	1337	1539	0.8687459
A01	26903966	26906193	A01p33230.2_BraZ1	22572	-	368	1263	2227	0.5671307
A01	26915967	26916826	A01p33240.2_BraZ1	1096.88	+	304	859	859	1.0000000
A01	26917284	26917473	A01p33250.2_BraZ1	129	+	105	189	189	1.0000000
A01	26932552	26935454	A01p33260.2_BraZ1	402	+	500	2164	2902	0.7456926
A01	26938159	26953356	A01p33270.2_BraZ1	3303.15	+	7649	14057	15197	0.9249852
A01	26948436	26949084	A01p33280.2_BraZ1	114	-	473	643	648	0.9922839
A01	26963134	26964459	A01p33290.2_BraZ1	933	+	628	1216	1325	0.9177359
A01	26965036	26969694	A01p33300.2_BraZ1	976.872	+	871	3014	4658	0.6470588
A01	26966232	26968240	A01p33310.2_BraZ1	1335	-	479	1183	2008	0.5891435
A01	26974812	26976854	A01p33320.2_BraZ1	1090.98	+	1008	1918	2042	0.9392752
A01	26977466	26979543	A01p33330.2_BraZ1	1783.46	-	985	2020	2077	0.9725566
A01	26982051	26982291	A01p33340.2_BraZ1	20.1	-	572	240	240	1.0000000
A01	26986490	26987535	A01p33350.2_BraZ1	183	+	2378	1045	1045	1.0000000
A01	27001643	27003417	A01p33360.2_BraZ1	1188.22	-	258	1221	1774	0.6882751
A01	27005700	27009111	A01p33370.2_BraZ1	900	+	675	3404	3411	0.9979478
A01	27009434	27009578	A01p33380.2_BraZ1	14.4	-	120	144	144	1.0000000
A01	27016539	27016740	A01p33390.2_BraZ1	20.1	+	1	44	201	0.2189055
A01	27025621	27028410	A01p33400.2_BraZ1	309	+	376	1460	2789	0.5234851
A01	27035487	27036504	A01p33410.2_BraZ1	498.2	-	208	904	1017	0.8888889
A01	27042715	27044592	A01p33420.2_BraZ1	370.696	-	411	1647	1877	0.8774641
A01	27051909	27052284	A01p33430.2_BraZ1	37.5	+	151	375	375	1.0000000
A01	27076717	27077106	A01p33440.2_BraZ1	291	+	13	212	389	0.5449871
A01	27083370	27084079	A01p33450.2_BraZ1	576	-	228	709	709	1.0000000
A01	27089173	27091037	A01p33460.2_BraZ1	1398.86	+	207	1309	1864	0.7022532
A01	27099260	27101108	A01p33470.2_BraZ1	184.8	+	906	1777	1848	0.9615801
A01	27103475	27104332	A01p33480.2_BraZ1	972	+	509	857	857	1.0000000
A01	27104661	27104870	A01p33490.2_BraZ1	132	-	24	177	209	0.8468900
A01	27106030	27109652	A01p33500.2_BraZ1	3336	-	1319	3046	3622	0.8409718
A01	27109952	27110703	A01p33510.2_BraZ1	326.455	+	895	751	751	1.0000000
A01	27111093	27112559	A01p33520.2_BraZ1	971.8	-	377	1322	1466	0.9017735
A01	27113267	27114266	A01p33530.2_BraZ1	99.9	-	1113	999	999	1.0000000
A01	27117162	27123160	A01p33540.2_BraZ1	1517.59	-	22155	5253	5998	0.8757919
A01	27126973	27128046	A01p33550.2_BraZ1	54	+	139	909	1073	0.8471575
A01	27136881	27137553	A01p33560.2_BraZ1	67.2	-	49	393	672	0.5848214
A01	27140776	27144975	A01p33570.2_BraZ1	175	+	26	422	4199	0.1005001
A01	27143486	27144303	A01p33580.2_BraZ1	280.125	-	0	0	817	0.0000000
A01	27145173	27145483	A01p33590.2_BraZ1	102	+	2	57	310	0.1838710
A01	27146440	27146833	A01p33600.2_BraZ1	39.3	+	6	54	393	0.1374046
A01	27150852	27152850	A01p33610.2_BraZ1	883.581	+	1749	1998	1998	1.0000000
A01	27154932	27155153	A01p33620.2_BraZ1	129	-	16	184	221	0.8325792
A01	27156078	27157125	A01p33630.2_BraZ1	104.7	+	90	968	1047	0.9245463
A01	27173947	27174990	A01p33640.2_BraZ1	60.9	+	14	188	1043	0.1802493
A01	27187790	27188459	A01p33650.2_BraZ1	381	+	704	669	669	1.0000000
A01	27190740	27191615	A01p33660.2_BraZ1	222	+	0	0	875	0.0000000
A01	27190831	27191194	A01p33670.2_BraZ1	198	+	0	0	363	0.0000000
A01	27198652	27200022	A01p33680.2_BraZ1	77.4	+	203	1034	1370	0.7547445
A01	27213946	27215485	A01p33690.2_BraZ1	9039	+	433	1443	1539	0.9376218
A01	27227610	27231540	A01p33700.2_BraZ1	1332.55	+	3850	3930	3930	1.0000000
A01	27271186	27271989	A01p33710.2_BraZ1	342	-	579	803	803	1.0000000
A01	27278675	27281590	A01p33720.2_BraZ1	1420.44	+	458	2148	2915	0.7368782
A01	27282498	27282925	A01p33730.2_BraZ1	70	+	226	427	427	1.0000000
A01	27282977	27284241	A01p33740.2_BraZ1	1029	+	173	1072	1264	0.8481013
A01	27290296	27290496	A01p33750.2_BraZ1	16.5	-	394	200	200	1.0000000
A01	27297663	27299180	A01p33760.2_BraZ1	1153.17	-	370	1327	1517	0.8747528
A01	27299966	27301193	A01p33770.2_BraZ1	122.7	-	593	1227	1227	1.0000000
A01	27308485	27311547	A01p33780.2_BraZ1	1102.22	-	2061	3062	3062	1.0000000
A01	27325117	27325252	A01p33790.2_BraZ1	13.5	-	16	135	135	1.0000000
A01	27325781	27326187	A01p33800.2_BraZ1	225	-	456	406	406	1.0000000
A01	27334066	27334486	A01p33810.2_BraZ1	162	-	299	420	420	1.0000000
A01	27342803	27344821	A01p33820.2_BraZ1	1160.54	-	765	1922	2018	0.9524282
A01	27350484	27351750	A01p33830.2_BraZ1	126.6	+	133	958	1266	0.7567140
A01	27359367	27362932	A01p33840.2_BraZ1	1383	+	1888	3418	3565	0.9587658
A01	27363422	27364107	A01p33850.2_BraZ1	369	+	77	550	685	0.8029197
A01	27365496	27365874	A01p33860.2_BraZ1	228	-	48	306	378	0.8095238
A01	27371020	27371753	A01p33870.2_BraZ1	309	+	9	220	733	0.3001364
A01	27371757	27372099	A01p33880.2_BraZ1	264	+	0	0	342	0.0000000
A01	27375684	27381340	A01p33890.2_BraZ1	3153.83	+	863	4200	5656	0.7425743
A01	27389578	27389903	A01p33900.2_BraZ1	267	-	380	325	325	1.0000000
A01	27401821	27403865	A01p33910.2_BraZ1	822	+	990	1920	2044	0.9393346
A01	27411698	27414784	A01p33920.2_BraZ1	1696.39	+	782	2232	3086	0.7232664
A01	27417281	27418731	A01p33930.2_BraZ1	1009.45	-	289	1225	1450	0.8448276
A01	27435063	27436036	A01p33940.2_BraZ1	825	+	21	479	973	0.4922919
A01	27450459	27451935	A01p33950.2_BraZ1	147.6	+	660	1281	1476	0.8678862
A01	27461391	27464283	A01p33960.2_BraZ1	1824	+	1282	2494	2892	0.8623790
A01	27465035	27465469	A01p33970.2_BraZ1	264	-	336	434	434	1.0000000
A01	27478255	27478993	A01p33980.2_BraZ1	73.8	+	73	702	738	0.9512195
A01	27479560	27481804	A01p33990.2_BraZ1	1282.14	-	1086	2139	2244	0.9532086
A01	27489444	27490302	A01p34000.2_BraZ1	85.8	-	118	733	858	0.8543124
A01	27493122	27493293	A01p34010.2_BraZ1	17.1	+	352	171	171	1.0000000
A01	27493804	27494376	A01p34020.2_BraZ1	43.5	-	137	301	572	0.5262238
A01	27498434	27499498	A01p34030.2_BraZ1	103.5	+	666	1055	1064	0.9915413
A01	27505775	27505961	A01p34040.2_BraZ1	18.6	+	164	186	186	1.0000000
A01	27512548	27513135	A01p34050.2_BraZ1	315	-	346	587	587	1.0000000
A01	27518896	27519713	A01p34060.2_BraZ1	340	+	798	817	817	1.0000000
A01	27521351	27521653	A01p34070.2_BraZ1	421.8	+	4	161	302	0.5331126
A01	27522216	27526079	A01p34080.2_BraZ1	1231.45	-	670	3001	3863	0.7768574
A01	27537178	27538550	A01p34090.2_BraZ1	981.696	-	15	413	1372	0.3010204
A01	27539862	27540176	A01p34100.2_BraZ1	141	-	8	248	314	0.7898089
A01	27544601	27546491	A01p34110.2_BraZ1	1063.52	-	185	1184	1890	0.6264550
A01	27555075	27555770	A01p34120.2_BraZ1	34.5	+	168	615	695	0.8848921
A01	27557143	27558056	A01p34130.2_BraZ1	60.9	+	40	712	913	0.7798467
A01	27563367	27563592	A01p34140.2_BraZ1	22.5	-	1	114	225	0.5066667
A01	27574652	27575895	A01p34150.2_BraZ1	937.833	-	796	1243	1243	1.0000000
A01	27578064	27580507	A01p34160.2_BraZ1	1026.48	+	660	2387	2443	0.9770774
A01	27581318	27582203	A01p34170.2_BraZ1	88.5	+	459	871	885	0.9841808
A01	27582765	27583023	A01p34180.2_BraZ1	162	-	104	258	258	1.0000000
A01	27588688	27592569	A01p34190.2_BraZ1	2138.09	+	890	3369	3881	0.8680753
A01	27594650	27595670	A01p34200.2_BraZ1	924	+	1699	1020	1020	1.0000000
A01	27602417	27602642	A01p34210.2_BraZ1	22.5	+	123	225	225	1.0000000
A01	27626331	27626577	A01p34220.2_BraZ1	24.6	-	1354	246	246	1.0000000
A01	27642402	27643724	A01p34230.2_BraZ1	664.125	+	169	609	1322	0.4606656
A01	27649883	27650270	A01p34240.2_BraZ1	38.7	+	76	339	387	0.8759690
A01	27651150	27652344	A01p34250.2_BraZ1	119.4	-	633	1194	1194	1.0000000
A01	27652926	27654587	A01p34260.2_BraZ1	637.714	+	2322	1661	1661	1.0000000
A01	27654587	27656383	A01p34270.2_BraZ1	567	+	1157	1796	1796	1.0000000
A01	27658590	27659973	A01p34280.2_BraZ1	138.3	-	59	525	1383	0.3796096
A01	27687005	27688331	A01p34290.2_BraZ1	927	+	1227	1326	1326	1.0000000
A01	27688757	27690276	A01p34300.2_BraZ1	923.538	-	29	816	1519	0.5371955
A01	27693209	27694128	A01p34310.2_BraZ1	690.182	+	762	919	919	1.0000000
A01	27697012	27698815	A01p34320.2_BraZ1	28576.8	+	228	1135	1803	0.6295063
A01	27699713	27700169	A01p34330.2_BraZ1	45.6	-	15	287	456	0.6293859
A01	27705092	27706632	A01p34340.2_BraZ1	7260	-	43	389	1540	0.2525974
A01	27707256	27707439	A01p34350.2_BraZ1	18.3	-	269	183	183	1.0000000
A01	27712802	27715725	A01p34360.2_BraZ1	44880	-	422	1972	2923	0.6746494
A01	27720252	27723373	A01p34370.2_BraZ1	2557.5	-	362	1585	3121	0.5078501
A01	27729233	27730049	A01p34380.2_BraZ1	81.6	+	323	718	816	0.8799019
A01	27732878	27733281	A01p34390.2_BraZ1	240	-	12	231	403	0.5732010
A01	27733976	27736076	A01p34400.2_BraZ1	840.583	-	377	2077	2100	0.9890476
A01	27740050	27740847	A01p34410.2_BraZ1	480	-	1	45	797	0.0564617
A01	27740955	27741773	A01p34420.2_BraZ1	4473	-	2	228	818	0.2787286
A01	27743218	27743755	A01p34430.2_BraZ1	348	-	310	537	537	1.0000000
A01	27746627	27747818	A01p34440.2_BraZ1	119.1	+	108	604	1191	0.5071369
A01	27751768	27751888	A01p34450.2_BraZ1	12	+	395	120	120	1.0000000
A01	27753019	27754736	A01p34460.2_BraZ1	784.929	+	786	1666	1717	0.9702970
A01	27755233	27764114	A01p34470.2_BraZ1	3872	-	4584	8289	8881	0.9333408
A01	27765979	27768570	A01p34480.2_BraZ1	1507.17	-	723	2585	2591	0.9976843
A01	27770012	27770444	A01p34490.2_BraZ1	351	+	63	366	432	0.8472222
A01	27777864	27785085	A01p34500.2_BraZ1	1756.69	-	1467	5885	7221	0.8149841
A01	27790281	27797267	A01p34510.2_BraZ1	2806.2	-	1670	5452	6986	0.7804180
A01	27819921	27820284	A01p34520.2_BraZ1	36.3	+	243	363	363	1.0000000
A01	27825006	27825144	A01p34530.2_BraZ1	13.2	+	23	72	138	0.5217391
A01	27856763	27857762	A01p34540.2_BraZ1	99.9	-	38	483	999	0.4834835
A01	27875277	27877232	A01p34550.2_BraZ1	306	+	140	859	1955	0.4393862
A01	27893193	27894852	A01p34560.2_BraZ1	708.331	-	1076	1587	1659	0.9566004
A01	27895845	27897390	A01p34570.2_BraZ1	816	-	861	1545	1545	1.0000000
A01	27898253	27899917	A01p34580.2_BraZ1	523.895	-	1475	1664	1664	1.0000000
A01	27904153	27904585	A01p34590.2_BraZ1	43.2	-	40	353	432	0.8171296
A01	27910239	27911737	A01p34600.2_BraZ1	582.353	-	401	1434	1498	0.9572763
A01	27913966	27920149	A01p34610.2_BraZ1	2617.26	-	970	5345	6183	0.8644671
A01	27921842	27922163	A01p34620.2_BraZ1	222	+	277	321	321	1.0000000
A01	27922201	27923755	A01p34630.2_BraZ1	410	+	1523	1554	1554	1.0000000
A01	27922934	27924033	A01p34640.2_BraZ1	255	-	1402	1099	1099	1.0000000
A01	27926877	27928092	A01p34650.2_BraZ1	111.9	+	1168	1215	1215	1.0000000
A01	27928370	27938789	A01p34660.2_BraZ1	1471.25	-	9939	10419	10419	1.0000000
A01	27941748	27943965	A01p34670.2_BraZ1	465.804	-	2086	2217	2217	1.0000000
A01	27950712	27953148	A01p34680.2_BraZ1	1074.4	+	822	2285	2436	0.9380131
A01	27957026	27962910	A01p34690.2_BraZ1	1290.67	+	2171	5500	5884	0.9347383
A01	27960403	27960931	A01p34700.2_BraZ1	52.8	+	426	528	528	1.0000000
A01	27970507	27973745	A01p34710.2_BraZ1	1525.98	-	2333	3238	3238	1.0000000
A01	27976463	27976669	A01p34720.2_BraZ1	18.3	+	107	206	206	1.0000000
A01	27981545	27984263	A01p34730.2_BraZ1	1057.7	-	2293	2587	2718	0.9518028
A01	27997893	28017048	A01p34740.2_BraZ1	1335.6	-	7292	13640	19155	0.7120856
A01	28007232	28009623	A01p34750.2_BraZ1	1452	+	0	0	2391	0.0000000
A01	28018567	28019761	A01p34760.2_BraZ1	119.4	-	10151	1194	1194	1.0000000
A01	28022105	28024496	A01p34770.2_BraZ1	603	-	0	0	2391	0.0000000
A01	28044517	28045153	A01p34780.2_BraZ1	411	-	626	636	636	1.0000000
A01	28060765	28061380	A01p34790.2_BraZ1	42.6	+	156	615	615	1.0000000
A01	28068918	28074559	A01p34800.2_BraZ1	2266.22	+	552	2913	5641	0.5163978
A01	28075575	28076451	A01p34810.2_BraZ1	222.504	-	135	767	876	0.8755708
A01	28079621	28080349	A01p34820.2_BraZ1	549	-	39	281	728	0.3859890
A01	28086097	28086810	A01p34830.2_BraZ1	195	+	0	0	713	0.0000000
A01	28086610	28087433	A01p34840.2_BraZ1	372	+	0	0	823	0.0000000
A01	28103144	28104635	A01p34850.2_BraZ1	149.1	+	45	908	1491	0.6089873
A01	28106906	28109733	A01p34860.2_BraZ1	1258.45	-	178	2052	2827	0.7258578
A01	28111063	28111277	A01p34870.2_BraZ1	15	+	513	214	214	1.0000000
A01	28128509	28128671	A01p34880.2_BraZ1	16.2	+	141	162	162	1.0000000
A01	28129059	28129544	A01p34890.2_BraZ1	396	-	205	485	485	1.0000000
A01	28131356	28132554	A01p34900.2_BraZ1	116.7	+	339	1034	1198	0.8631052
A01	28132791	28134141	A01p34910.2_BraZ1	432.667	-	746	1350	1350	1.0000000
A01	28138954	28139830	A01p34920.2_BraZ1	534	+	234	853	876	0.9737443
A01	28141483	28142548	A01p34930.2_BraZ1	588	-	18	310	1065	0.2910798
A01	28154919	28157313	A01p34940.2_BraZ1	1032.75	-	2207	2281	2394	0.9527987
A01	28157358	28158052	A01p34950.2_BraZ1	213.75	+	384	657	694	0.9466859
A01	28158487	28158763	A01p34960.2_BraZ1	27.6	+	187	276	276	1.0000000
A01	28160260	28162990	A01p34970.2_BraZ1	633.333	+	1026	2705	2730	0.9908425
A01	28163183	28167262	A01p34980.2_BraZ1	2729.35	-	127	1379	4079	0.3380730
A01	28173514	28175845	A01p34990.2_BraZ1	1306.22	-	74	1433	2331	0.6147576
A01	28179779	28180972	A01p35000.2_BraZ1	827.609	-	77	760	1193	0.6370494
A01	28203317	28203950	A01p35010.2_BraZ1	63.3	-	110	522	633	0.8246446
A01	28210409	28210636	A01p35020.2_BraZ1	168	+	299	227	227	1.0000000
A01	28236980	28237397	A01p35030.2_BraZ1	41.7	+	251	400	417	0.9592326
A01	28242857	28243340	A01p35040.2_BraZ1	48.3	-	806	483	483	1.0000000
A01	28253810	28254612	A01p35050.2_BraZ1	1212	-	687	802	802	1.0000000
A01	28255812	28256901	A01p35060.2_BraZ1	2656.5	-	514	1089	1089	1.0000000
A01	28257494	28259389	A01p35070.2_BraZ1	564	-	274	1270	1895	0.6701847
A01	28265868	28266294	A01p35080.2_BraZ1	42.6	-	273	426	426	1.0000000
A01	28267593	28268800	A01p35090.2_BraZ1	863.929	+	494	1207	1207	1.0000000
A01	28269658	28270542	A01p35100.2_BraZ1	468.978	-	191	693	884	0.7839367
A01	28275377	28276807	A01p35110.2_BraZ1	528.462	-	115	1092	1430	0.7636364
A01	28280504	28281103	A01p35120.2_BraZ1	378	+	453	599	599	1.0000000
A01	28281729	28283057	A01p35130.2_BraZ1	603.692	-	55	954	1328	0.7183735
A01	28286710	28289587	A01p35140.2_BraZ1	280.5	+	850	2853	2877	0.9916580
A01	28293036	28295453	A01p35150.2_BraZ1	2340	-	59	1202	2417	0.4973107
A01	28299880	28300087	A01p35160.2_BraZ1	20.7	-	180	207	207	1.0000000
A01	28313824	28314692	A01p35170.2_BraZ1	53.4	-	324	823	868	0.9481567
A01	28319808	28320447	A01p35180.2_BraZ1	61.8	-	286	639	639	1.0000000
A01	28324369	28324735	A01p35190.2_BraZ1	36.6	+	0	0	366	0.0000000
A01	28329070	28329890	A01p35200.2_BraZ1	414.75	+	842	820	820	1.0000000
A01	28331640	28332762	A01p35210.2_BraZ1	112.2	+	63	461	1122	0.4108734
A01	28335163	28336285	A01p35220.2_BraZ1	112.2	-	561	1122	1122	1.0000000
A01	28341574	28342697	A01p35230.2_BraZ1	559.038	-	665	1119	1123	0.9964381
A01	28348244	28350510	A01p35240.2_BraZ1	700.138	+	105	867	2266	0.3826125
A01	28352305	28354218	A01p35250.2_BraZ1	1104.24	+	918	1824	1913	0.9534762
A01	28374113	28376923	A01p35260.2_BraZ1	1400.67	-	2095	2810	2810	1.0000000
A01	28380779	28381266	A01p35270.2_BraZ1	1326	-	653	487	487	1.0000000
A01	28383331	28393257	A01p35280.2_BraZ1	847.167	+	19813	9696	9926	0.9768285
A01	28394146	28395889	A01p35290.2_BraZ1	561.436	+	0	0	1743	0.0000000
A01	28399317	28399656	A01p35300.2_BraZ1	33.9	-	20	243	339	0.7168142
A01	28399656	28400289	A01p35310.2_BraZ1	516	+	28	358	633	0.5655608
A01	28409930	28410553	A01p35320.2_BraZ1	189	-	847	623	623	1.0000000
A01	28429311	28430695	A01p35330.2_BraZ1	5280	+	489	1092	1384	0.7890173
A01	28434999	28435209	A01p35340.2_BraZ1	21	-	221	210	210	1.0000000
A01	28440477	28441008	A01p35350.2_BraZ1	51	+	435	531	531	1.0000000
A01	28441008	28441629	A01p35360.2_BraZ1	351	-	371	621	621	1.0000000
A01	28442901	28444146	A01p35370.2_BraZ1	124.5	-	76	1043	1245	0.8377510
A01	28457293	28458487	A01p35380.2_BraZ1	438	-	629	1181	1194	0.9891122
A01	28467235	28468081	A01p35390.2_BraZ1	84.6	-	191	846	846	1.0000000
A01	28468659	28470909	A01p35400.2_BraZ1	1610.89	-	600	1795	2250	0.7977778
A01	28476822	28478512	A01p35410.2_BraZ1	476.532	+	537	1690	1690	1.0000000
A01	28479514	28479841	A01p35420.2_BraZ1	32.7	-	367	327	327	1.0000000
A01	28484455	28485919	A01p35430.2_BraZ1	1308	-	175	1131	1464	0.7725410
A01	28496415	28498344	A01p35440.2_BraZ1	1374.57	+	414	1650	1929	0.8553655
A01	28512171	28513775	A01p35450.2_BraZ1	481.705	+	158	1256	1604	0.7830424
A01	28522892	28526332	A01p35460.2_BraZ1	336	+	1215	2986	3440	0.8680233
A01	28528772	28529078	A01p35470.2_BraZ1	30.6	-	265	306	306	1.0000000
A01	28540938	28541824	A01p35480.2_BraZ1	252	-	896	886	886	1.0000000
A01	28546395	28549449	A01p35490.2_BraZ1	305.4	+	203	2034	3054	0.6660118
A01	28549589	28550134	A01p35500.2_BraZ1	52.8	-	30	190	545	0.3486238
A01	28552178	28554116	A01p35510.2_BraZ1	713.589	-	642	1574	1938	0.8121775
A01	28557131	28558675	A01p35520.2_BraZ1	343.895	-	975	1544	1544	1.0000000
A01	28559967	28561011	A01p35530.2_BraZ1	229.286	-	523	1044	1044	1.0000000
A01	28568536	28569396	A01p35540.2_BraZ1	192	+	727	857	860	0.9965116
A01	28575109	28577703	A01p35550.2_BraZ1	970.186	+	904	1907	2594	0.7351581
A01	28578460	28579546	A01p35560.2_BraZ1	637.091	-	350	1057	1086	0.9732965
A01	28580415	28581459	A01p35570.2_BraZ1	267	+	1463	1044	1044	1.0000000
A01	28581617	28581896	A01p35580.2_BraZ1	24.9	+	642	279	279	1.0000000
A01	28584357	28585241	A01p35590.2_BraZ1	503.1	+	297	586	884	0.6628959
A01	28592981	28594633	A01p35600.2_BraZ1	405	+	1297	1652	1652	1.0000000
A01	28598759	28599113	A01p35610.2_BraZ1	35.4	+	70	354	354	1.0000000
A01	28601005	28602842	A01p35620.2_BraZ1	1203	-	544	1557	1837	0.8475776
A01	28609451	28618412	A01p35630.2_BraZ1	474	-	5074	7277	8961	0.8120745
A01	28621655	28622072	A01p35640.2_BraZ1	345	-	433	417	417	1.0000000
A01	28626834	28627597	A01p35650.2_BraZ1	501	+	45	733	763	0.9606815
A01	28628003	28628948	A01p35660.2_BraZ1	94.5	-	694	926	945	0.9798942
A01	28644532	28647625	A01p35670.2_BraZ1	1331	-	400	1566	3093	0.5063046
A01	28648926	28649028	A01p35680.2_BraZ1	10.2	-	0	0	102	0.0000000
A01	28670760	28672044	A01p35690.2_BraZ1	128.4	+	134	707	1284	0.5506231
A01	28673236	28673416	A01p35700.2_BraZ1	18	-	338	180	180	1.0000000
A01	28679263	28679851	A01p35710.2_BraZ1	217.8	-	42	550	588	0.9353741
A01	28679681	28680910	A01p35720.2_BraZ1	364.32	-	49	582	1229	0.4735557
A01	28684551	28689828	A01p35730.2_BraZ1	4845.35	+	857	4878	5277	0.9243889
A01	28690099	28691581	A01p35740.2_BraZ1	704.455	-	1232	1392	1482	0.9392713
A01	28692412	28693562	A01p35750.2_BraZ1	61.5	+	535	1119	1150	0.9730435
A01	28696420	28699293	A01p35760.2_BraZ1	1652.61	-	1409	2390	2873	0.8318831
A01	28712221	28712521	A01p35770.2_BraZ1	18	+	683	300	300	1.0000000
A01	28732484	28733213	A01p35780.2_BraZ1	72.9	-	9	154	729	0.2112483
A01	28739194	28741034	A01p35790.2_BraZ1	1183.11	+	411	1459	1840	0.7929348
A01	28742966	28743854	A01p35800.2_BraZ1	88.8	+	121	795	888	0.8952703
A01	28745348	28747330	A01p35810.2_BraZ1	1461	+	836	1982	1982	1.0000000
A01	28749263	28749791	A01p35820.2_BraZ1	52.8	-	34	369	528	0.6988636
A01	28750310	28750619	A01p35830.2_BraZ1	30.9	+	120	309	309	1.0000000
A01	28750864	28751662	A01p35840.2_BraZ1	2170.8	-	546	696	798	0.8721805
A01	28754703	28755318	A01p35850.2_BraZ1	432	-	623	615	615	1.0000000
A01	28761603	28762517	A01p35860.2_BraZ1	789	+	65	804	914	0.8796499
A01	28766612	28767116	A01p35870.2_BraZ1	48.9	+	278	450	504	0.8928571
A01	28767754	28769927	A01p35880.2_BraZ1	1566.15	-	1053	2129	2173	0.9797515
A01	28772466	28773786	A01p35890.2_BraZ1	132	-	538	1210	1320	0.9166667
A01	28781926	28782548	A01p35900.2_BraZ1	390	-	1020	622	622	1.0000000
A01	28783820	28784765	A01p35910.2_BraZ1	94.5	-	471	732	945	0.7746032
A01	28785307	28787131	A01p35920.2_BraZ1	1605	-	275	1746	1824	0.9572368
A01	28790556	28791939	A01p35930.2_BraZ1	726.692	-	1052	1383	1383	1.0000000
A01	28795685	28796287	A01p35940.2_BraZ1	492	+	393	290	602	0.4817276
A01	28796409	28796788	A01p35950.2_BraZ1	195	-	231	379	379	1.0000000
A01	28797880	28798327	A01p35960.2_BraZ1	204	-	2	74	447	0.1655481
A01	28809271	28811800	A01p35970.2_BraZ1	1024.23	+	833	2334	2529	0.9228944
A01	28817801	28822239	A01p35980.2_BraZ1	2157.07	-	1056	3369	4438	0.7591257
A01	28832428	28837915	A01p35990.2_BraZ1	4123.35	-	1512	3515	5487	0.6406051
A01	28844190	28844570	A01p36000.2_BraZ1	31.8	+	4	214	380	0.5631579
A01	28844668	28846663	A01p36010.2_BraZ1	95.1	+	10	609	1995	0.3052632
A01	28846740	28855033	A01p36020.2_BraZ1	151.2	+	275	3094	8293	0.3730857
A01	28853653	28858853	A01p36030.2_BraZ1	177.9	+	10	517	5200	0.0994231
A01	28861244	28861656	A01p36040.2_BraZ1	300	-	0	0	412	0.0000000
A01	28861685	28861853	A01p36050.2_BraZ1	16.8	-	0	0	168	0.0000000
A01	28876834	28882858	A01p36060.2_BraZ1	508.125	+	2187	5281	6024	0.8766600
A01	28880462	28880993	A01p36070.2_BraZ1	453	-	343	531	531	1.0000000
A01	28888854	28889088	A01p36080.2_BraZ1	23.4	-	7	129	234	0.5512820
A01	28891220	28891343	A01p36090.2_BraZ1	12.3	-	158	123	123	1.0000000
A01	28893537	28893759	A01p36100.2_BraZ1	22.2	-	142	222	222	1.0000000
A01	28894354	28896165	A01p36110.2_BraZ1	992.25	-	406	1435	1811	0.7923799
A01	28896600	28899011	A01p36120.2_BraZ1	1479.84	-	370	2133	2411	0.8846952
A01	28901111	28902355	A01p36130.2_BraZ1	539.4	+	665	1244	1244	1.0000000
A01	28904731	28905119	A01p36140.2_BraZ1	270	-	27	367	388	0.9458763
A01	28906015	28906228	A01p36150.2_BraZ1	21.3	-	638	213	213	1.0000000
A01	28913103	28915819	A01p36160.2_BraZ1	1185.68	+	320	2120	2716	0.7805597
A01	28920163	28923132	A01p36170.2_BraZ1	2182.5	-	1470	2421	2969	0.8154261
A01	28924412	28926010	A01p36180.2_BraZ1	673.991	-	1250	1598	1598	1.0000000
A01	28926821	28930143	A01p36190.2_BraZ1	1357.43	-	2199	2977	3322	0.8961469
A01	28935407	28936192	A01p36200.2_BraZ1	1161	+	688	785	785	1.0000000
A01	28937505	28938068	A01p36210.2_BraZ1	328.5	+	823	563	563	1.0000000
A01	28939090	28939498	A01p36220.2_BraZ1	40.8	+	170	408	408	1.0000000
A01	28940223	28940352	A01p36230.2_BraZ1	12.9	-	257	129	129	1.0000000
A01	28952996	28954758	A01p36240.2_BraZ1	1037.18	+	916	1751	1762	0.9937571
A01	28955086	28957870	A01p36250.2_BraZ1	1862.14	-	1135	2695	2784	0.9680316
A01	28962385	28965402	A01p36260.2_BraZ1	2199.75	+	277	2421	3017	0.8024527
A01	28977190	28977454	A01p36270.2_BraZ1	171	+	21	264	264	1.0000000
A01	28982368	28982992	A01p36280.2_BraZ1	62.4	+	8	21	624	0.0336538
A01	28990712	28991210	A01p36290.2_BraZ1	142.56	+	0	0	498	0.0000000
A01	29000062	29001075	A01p36300.2_BraZ1	837	+	106	679	1013	0.6702863
A01	29006147	29006900	A01p36310.2_BraZ1	75.3	+	54	633	753	0.8406374
A01	29011704	29014041	A01p36320.2_BraZ1	793.1	+	771	2181	2337	0.9332477
A01	29019926	29020454	A01p36330.2_BraZ1	52.8	+	483	528	528	1.0000000
A01	29022526	29024568	A01p36340.2_BraZ1	588.281	-	88	1111	2042	0.5440744
A01	29025731	29026643	A01p36350.2_BraZ1	804	-	75	850	912	0.9320176
A01	29054280	29055336	A01p36360.2_BraZ1	813	-	55	174	1056	0.1647727
A01	29060968	29061252	A01p36370.2_BraZ1	177	-	300	284	284	1.0000000
A01	29065984	29066284	A01p36380.2_BraZ1	30	+	0	0	300	0.0000000
A01	29066284	29067479	A01p36390.2_BraZ1	73.5	+	2	241	1195	0.2016736
A01	29067422	29072071	A01p36400.2_BraZ1	142.5	+	62	1391	4649	0.2992041
A01	29073132	29073552	A01p36410.2_BraZ1	261	+	0	0	420	0.0000000
A01	29073387	29075615	A01p36420.2_BraZ1	103.2	+	2	278	2228	0.1247756
A01	29075671	29076612	A01p36430.2_BraZ1	17.4	+	0	0	941	0.0000000
A01	29077740	29079903	A01p36440.2_BraZ1	258	-	61	1453	2163	0.6717522
A01	29080269	29082432	A01p36450.2_BraZ1	560.057	-	0	0	2163	0.0000000
A01	29087575	29087947	A01p36460.2_BraZ1	37.2	+	235	372	372	1.0000000
A01	29089256	29090685	A01p36470.2_BraZ1	1219.05	-	754	1238	1429	0.8663401
A01	29091890	29092479	A01p36480.2_BraZ1	243.667	+	321	589	589	1.0000000
A01	29093226	29095235	A01p36490.2_BraZ1	668.324	+	617	1624	2009	0.8083624
A01	29096232	29101994	A01p36500.2_BraZ1	1002.27	-	2303	5278	5762	0.9160014
A01	29110675	29114449	A01p36510.2_BraZ1	145.2	+	550	2865	3774	0.7591415
A01	29117307	29121809	A01p36520.2_BraZ1	223.5	+	31	1442	4502	0.3203021
A01	29122505	29124421	A01p36530.2_BraZ1	429	-	13	592	1916	0.3089770
A01	29125501	29128170	A01p36540.2_BraZ1	1129.89	-	185	1732	2669	0.6489322
A01	29130611	29130716	A01p36550.2_BraZ1	10.5	-	82	105	105	1.0000000
A01	29131440	29131960	A01p36560.2_BraZ1	232	+	1	96	520	0.1846154
A01	29133918	29135404	A01p36570.2_BraZ1	111.9	+	40	576	1486	0.3876178
A01	29136404	29136671	A01p36580.2_BraZ1	26.7	-	20	203	267	0.7602996
A01	29137064	29138781	A01p36590.2_BraZ1	990	-	301	1138	1717	0.6627839
A01	29146006	29146186	A01p36600.2_BraZ1	18	-	51	180	180	1.0000000
A01	29156647	29157237	A01p36610.2_BraZ1	243	-	1	72	590	0.1220339
A01	29157275	29157719	A01p36620.2_BraZ1	345	-	0	0	444	0.0000000
A01	29162920	29164372	A01p36630.2_BraZ1	145.2	-	30	531	1452	0.3657025
A01	29168846	29169994	A01p36640.2_BraZ1	642	-	103	886	1148	0.7717770
A01	29172153	29173614	A01p36650.2_BraZ1	755.12	-	29	628	1461	0.4298426
A01	29187417	29191493	A01p36660.2_BraZ1	1168.86	-	1253	3418	4076	0.8385672
A01	29196634	29203946	A01p36670.2_BraZ1	1339.14	-	5327	6735	7312	0.9210886
A01	29217763	29218117	A01p36680.2_BraZ1	35.4	+	1	5	354	0.0141243
A01	29218878	29219232	A01p36690.2_BraZ1	35.4	+	0	0	354	0.0000000
A01	29220203	29221053	A01p36700.2_BraZ1	515.667	+	603	826	850	0.9717647
A01	29221959	29222751	A01p36710.2_BraZ1	201	+	526	792	792	1.0000000
A01	29225912	29226089	A01p36720.2_BraZ1	17.7	+	145	177	177	1.0000000
A01	29243026	29245634	A01p36730.2_BraZ1	1083.76	+	235	1592	2608	0.6104295
A01	29247290	29247830	A01p36740.2_BraZ1	1092	+	93	540	540	1.0000000
A01	29249095	29249239	A01p36750.2_BraZ1	14.4	-	190	144	144	1.0000000
A01	29251834	29252221	A01p36760.2_BraZ1	38.7	+	113	387	387	1.0000000
A01	29266667	29267084	A01p36770.2_BraZ1	41.7	+	3	61	417	0.1462830
A01	29272168	29273662	A01p36780.2_BraZ1	149.4	-	12	24	1494	0.0160643
A01	29286298	29286822	A01p36790.2_BraZ1	3480	+	29	399	524	0.7614504
A01	29287487	29287697	A01p36800.2_BraZ1	21	+	21	210	210	1.0000000
A01	29290394	29290583	A01p36810.2_BraZ1	18.9	-	0	0	189	0.0000000
A01	29294815	29295210	A01p36820.2_BraZ1	243	-	364	395	395	1.0000000
A01	29298749	29298884	A01p36830.2_BraZ1	13.5	+	3	36	135	0.2666667
A01	29301519	29302785	A01p36840.2_BraZ1	723	+	44	1021	1266	0.8064771
A01	29304775	29305141	A01p36850.2_BraZ1	36.6	+	7	194	366	0.5300546
A01	29306087	29307023	A01p36860.2_BraZ1	46.5	-	41	891	936	0.9519231
A01	29306891	29310390	A01p36870.2_BraZ1	209.7	-	52	1222	3499	0.3492426
A01	29310225	29310645	A01p36880.2_BraZ1	261	-	0	0	420	0.0000000
A01	29311705	29317326	A01p36890.2_BraZ1	397.8	-	221	3811	5621	0.6779932
A01	29337727	29338285	A01p36900.2_BraZ1	55.8	+	6	205	558	0.3673835
A01	29339978	29340587	A01p36910.2_BraZ1	60.9	-	1	142	609	0.2331691
A01	29345324	29345796	A01p36920.2_BraZ1	381	+	3	113	472	0.2394068
A01	29347598	29348835	A01p36930.2_BraZ1	471	+	48	339	1237	0.2740501
A01	29349108	29349606	A01p36940.2_BraZ1	49.8	+	169	498	498	1.0000000
A01	29354173	29355040	A01p36950.2_BraZ1	384	-	583	867	867	1.0000000
A01	29358389	29362443	A01p36960.2_BraZ1	627.231	-	613	3027	4054	0.7466699
A01	29362626	29363938	A01p36970.2_BraZ1	600	+	1052	1312	1312	1.0000000
A01	29364660	29365269	A01p36980.2_BraZ1	238.091	+	49	304	609	0.4991790
A01	29365616	29368686	A01p36990.2_BraZ1	360	-	1348	3019	3070	0.9833876
A01	29369482	29371644	A01p37000.2_BraZ1	1356.75	+	87	686	2162	0.3172988
A01	29375374	29375587	A01p37010.2_BraZ1	21.3	-	27	76	213	0.3568075
A01	29376384	29377284	A01p37020.2_BraZ1	90	+	59	273	900	0.3033333
A01	29378628	29388983	A01p37030.2_BraZ1	1931.4	+	437	4192	10355	0.4048286
A01	29390321	29393484	A01p37040.2_BraZ1	669	+	2405	3163	3163	1.0000000
A01	29404403	29404712	A01p37050.2_BraZ1	30.9	+	30	253	309	0.8187702
A01	29410840	29412587	A01p37060.2_BraZ1	1074.67	-	79	875	1747	0.5008586
A01	29428846	29429400	A01p37070.2_BraZ1	348	+	38	504	554	0.9097473
A01	29429400	29431789	A01p37080.2_BraZ1	675	+	223	2106	2389	0.8815404
A01	29429978	29430899	A01p37090.2_BraZ1	831	+	71	822	921	0.8925081
A01	29439400	29441073	A01p37100.2_BraZ1	1334.47	-	1907	1673	1673	1.0000000
A01	29442118	29445271	A01p37110.2_BraZ1	1351.43	+	3578	3153	3153	1.0000000
A01	29458494	29460377	A01p37120.2_BraZ1	1535.37	+	103	1388	1883	0.7371216
A01	29475920	29476523	A01p37130.2_BraZ1	60.3	-	266	559	603	0.9270315
A01	29482883	29485299	A01p37140.2_BraZ1	484.061	-	1566	2409	2416	0.9971027
A01	29500797	29500967	A01p37150.2_BraZ1	10.5	-	0	0	170	0.0000000
A01	29510166	29511856	A01p37160.2_BraZ1	698.286	+	81	818	1690	0.4840237
A01	29518257	29520419	A01p37170.2_BraZ1	1380	+	3223	2162	2162	1.0000000
A01	29522518	29527818	A01p37180.2_BraZ1	4183.11	+	6676	5300	5300	1.0000000
A01	29536285	29537281	A01p37190.2_BraZ1	99.6	-	1356	996	996	1.0000000
A01	29540472	29542838	A01p37200.2_BraZ1	578.957	+	450	1967	2366	0.8313609
A01	29543963	29544395	A01p37210.2_BraZ1	216	-	91	382	432	0.8842593
A01	29545256	29546570	A01p37220.2_BraZ1	941.114	-	531	1314	1314	1.0000000
A01	29552670	29554550	A01p37230.2_BraZ1	1147.87	+	128	1123	1880	0.5973404
A01	29555190	29565670	A01p37240.2_BraZ1	427.5	-	4157	8867	10480	0.8460878
A01	29566499	29568683	A01p37250.2_BraZ1	959.31	+	1042	2080	2184	0.9523810
A01	29569151	29570884	A01p37260.2_BraZ1	1114.03	-	677	1719	1733	0.9919215
A01	29570964	29573753	A01p37270.2_BraZ1	1090.37	+	1828	2789	2789	1.0000000
A01	29574442	29576947	A01p37280.2_BraZ1	1271.25	-	1076	2344	2505	0.9357285
A01	29581127	29581473	A01p37290.2_BraZ1	216	+	498	346	346	1.0000000
A01	29598967	29601903	A01p37300.2_BraZ1	1550.95	+	2000	2722	2936	0.9271117
A01	29602323	29604281	A01p37310.2_BraZ1	1387.67	-	1096	1862	1958	0.9509704
A01	29604956	29605307	A01p37320.2_BraZ1	32.1	+	191	351	351	1.0000000
A01	29608468	29609698	A01p37330.2_BraZ1	123	-	269	1158	1230	0.9414634
A01	29616461	29617108	A01p37340.2_BraZ1	492	-	204	613	647	0.9474497
A01	29619667	29620522	A01p37350.2_BraZ1	85.5	-	35	469	855	0.5485380
A01	29630355	29632115	A01p37360.2_BraZ1	927.562	+	840	1725	1760	0.9801136
A01	29632415	29633072	A01p37370.2_BraZ1	477	-	563	657	657	1.0000000
A01	29634251	29641507	A01p37380.2_BraZ1	471	-	3177	4299	7256	0.5924752
A01	29642557	29642989	A01p37390.2_BraZ1	42.6	-	97	420	432	0.9722222
A01	29662431	29664470	A01p37400.2_BraZ1	1074	+	301	1921	2039	0.9421285
A01	29675598	29675793	A01p37410.2_BraZ1	19.5	+	2	78	195	0.4000000
A01	29675856	29678943	A01p37420.2_BraZ1	393.333	-	1272	3032	3087	0.9821833
A01	29679251	29679811	A01p37430.2_BraZ1	35.5	-	863	560	560	1.0000000
A01	29682704	29685379	A01p37440.2_BraZ1	1556.63	-	72	1287	2675	0.4811215
A01	29691128	29691335	A01p37450.2_BraZ1	20.7	-	10	188	207	0.9082125
A01	29713912	29714697	A01p37460.2_BraZ1	59.7	+	904	785	785	1.0000000
A01	29715360	29715558	A01p37470.2_BraZ1	19.8	+	249	198	198	1.0000000
A01	29721698	29722796	A01p37480.2_BraZ1	109.8	-	75	729	1098	0.6639344
A01	29729964	29732018	A01p37490.2_BraZ1	876.563	+	1969	2054	2054	1.0000000
A01	29735411	29737226	A01p37500.2_BraZ1	181.5	+	979	1815	1815	1.0000000
A01	29744802	29744961	A01p37510.2_BraZ1	15.9	+	25	122	159	0.7672956
A01	29746392	29747644	A01p37520.2_BraZ1	1352.4	-	254	1236	1252	0.9872205
A01	29765528	29766107	A01p37530.2_BraZ1	57.9	+	705	579	579	1.0000000
A01	29769101	29769260	A01p37540.2_BraZ1	15.9	+	110	159	159	1.0000000
A01	29770568	29771821	A01p37550.2_BraZ1	1515	-	434	1253	1253	1.0000000
A01	29784245	29786654	A01p37560.2_BraZ1	988.289	+	2443	2409	2409	1.0000000
A01	29786867	29788657	A01p37570.2_BraZ1	1716	-	440	1559	1790	0.8709497
A01	29788934	29796059	A01p37580.2_BraZ1	3395.95	-	3460	6661	7125	0.9348772
A01	29797213	29798230	A01p37590.2_BraZ1	101.7	+	578	1017	1017	1.0000000
A01	29799050	29799554	A01p37600.2_BraZ1	405	-	331	504	504	1.0000000
A01	29802308	29802900	A01p37610.2_BraZ1	297	+	654	592	592	1.0000000
A01	29803198	29805819	A01p37620.2_BraZ1	979.953	+	2161	2477	2621	0.9450591
A01	29822667	29825305	A01p37630.2_BraZ1	1229.52	+	858	2085	2638	0.7903715
A01	29827581	29830159	A01p37640.2_BraZ1	519.75	+	247	1203	2578	0.4666408
A01	29830272	29830568	A01p37650.2_BraZ1	153	+	157	274	296	0.9256757
A01	29841886	29842081	A01p37660.2_BraZ1	19.5	-	75	120	195	0.6153846
A01	29844941	29845580	A01p37670.2_BraZ1	63.9	-	269	639	639	1.0000000
A01	29848720	29851895	A01p37680.2_BraZ1	1970.93	+	998	2848	3175	0.8970079
A01	29852361	29853049	A01p37690.2_BraZ1	640.714	+	215	688	688	1.0000000
A01	29854126	29854758	A01p37700.2_BraZ1	381.091	-	302	632	632	1.0000000
A01	29856884	29858918	A01p37710.2_BraZ1	33	-	223	1558	2034	0.7659784
A01	29862293	29863265	A01p37720.2_BraZ1	240	+	754	939	972	0.9660494
A01	29864124	29865574	A01p37730.2_BraZ1	1169.29	-	190	1201	1450	0.8282759
A01	29885340	29888948	A01p37740.2_BraZ1	332.8	-	1269	2699	3608	0.7480599
A01	29886711	29887234	A01p37750.2_BraZ1	333	+	74	400	523	0.7648184
A01	29890768	29897709	A01p37760.2_BraZ1	442.014	+	3485	6664	6941	0.9600922
A01	29898614	29903031	A01p37770.2_BraZ1	1427.29	-	808	2985	4417	0.6757981
A01	29920190	29920520	A01p37780.2_BraZ1	33	+	158	305	330	0.9242424
A01	29921893	29924063	A01p37790.2_BraZ1	696.273	+	1378	2170	2170	1.0000000
A01	29924142	29927344	A01p37800.2_BraZ1	1485	+	499	2514	3202	0.7851343
A01	29940624	29942826	A01p37810.2_BraZ1	1312.95	+	645	1686	2202	0.7656676
A01	29943750	29947292	A01p37820.2_BraZ1	1344.33	+	1182	2640	3542	0.7453416
A01	29948152	29949190	A01p37830.2_BraZ1	755.526	-	240	950	1038	0.9152216
A01	29949256	29949604	A01p37840.2_BraZ1	279	+	10	62	348	0.1781609
A01	29954606	29955698	A01p37850.2_BraZ1	53.1	-	67	418	1092	0.3827839
A01	29956087	29957270	A01p37860.2_BraZ1	195	+	2160	1183	1183	1.0000000
A01	29959939	29961028	A01p37870.2_BraZ1	53.1	-	37	553	1089	0.5078053
A01	29962611	29963798	A01p37880.2_BraZ1	195	+	587	912	1187	0.7683235
A01	29968921	29970045	A01p37890.2_BraZ1	780	+	8	692	1124	0.6156583
A01	29971496	29971727	A01p37900.2_BraZ1	23.1	+	5	101	231	0.4372294
A01	29973768	29974307	A01p37910.2_BraZ1	387	-	44	539	539	1.0000000
A01	29974308	29974593	A01p37920.2_BraZ1	231	+	7	197	285	0.6912281
A01	29975006	29975702	A01p37930.2_BraZ1	588	-	2	118	696	0.1695402
A01	29989312	29990401	A01p37940.2_BraZ1	53.1	-	150	1089	1089	1.0000000
A01	29994463	29995652	A01p37950.2_BraZ1	195	+	367	958	1189	0.8057191
A01	29998619	29999413	A01p37960.2_BraZ1	35.4	-	13	243	794	0.3060454
A01	30003655	30004744	A01p37970.2_BraZ1	53.1	-	121	794	1089	0.7291093
A01	30004761	30006350	A01p37980.2_BraZ1	17.7	-	1620	1572	1589	0.9893014
A01	30009282	30010079	A01p37990.2_BraZ1	52.8	-	30	797	797	1.0000000
A01	30010487	30011673	A01p38000.2_BraZ1	195	+	381	975	1186	0.8220910
A01	30014329	30015418	A01p38010.2_BraZ1	53.1	-	167	968	1089	0.8888889
A01	30015446	30017007	A01p38020.2_BraZ1	16.5	-	330	1198	1561	0.7674568
A01	30020303	30021392	A01p38030.2_BraZ1	53.1	-	40	694	1089	0.6372819
A01	30021420	30025629	A01p38040.2_BraZ1	16.5	-	674	3500	4209	0.8315514
A01	30028277	30029366	A01p38050.2_BraZ1	53.1	-	337	1089	1089	1.0000000
A01	30029753	30030939	A01p38060.2_BraZ1	195	+	789	1186	1186	1.0000000
A01	30033603	30034685	A01p38070.2_BraZ1	125.375	-	517	581	1082	0.5369686
A01	30035017	30036260	A01p38080.2_BraZ1	234	+	1382	1243	1243	1.0000000
A01	30038665	30039291	A01p38090.2_BraZ1	153.9	+	517	626	626	1.0000000
A01	30039801	30041824	A01p38100.2_BraZ1	1035.95	-	604	2023	2023	1.0000000
A01	30045092	30047847	A01p38110.2_BraZ1	1562.45	-	993	2264	2755	0.8217786
A01	30049526	30050832	A01p38120.2_BraZ1	321	-	66	622	1306	0.4762634
A01	30050832	30051145	A01p38130.2_BraZ1	258	-	67	231	313	0.7380192
A01	30057291	30062336	A01p38140.2_BraZ1	1705.52	+	2134	4842	5045	0.9597622
A01	30062733	30066175	A01p38150.2_BraZ1	66.6	+	1350	3406	3442	0.9895410
A01	30066497	30066641	A01p38160.2_BraZ1	14.4	+	65	144	144	1.0000000
A01	30071259	30071379	A01p38170.2_BraZ1	12	-	158	120	120	1.0000000
A01	30079666	30081630	A01p38180.2_BraZ1	1272	-	1134	1940	1964	0.9877800
A01	30082525	30085089	A01p38190.2_BraZ1	918.487	-	1603	2511	2564	0.9793292
A01	30086838	30087837	A01p38200.2_BraZ1	98.4	-	184	966	999	0.9669670
A01	30091147	30093254	A01p38210.2_BraZ1	1403.59	-	1145	2107	2107	1.0000000
A01	30105799	30107909	A01p38220.2_BraZ1	6656	-	1662	2110	2110	1.0000000
A01	30112447	30112705	A01p38230.2_BraZ1	192	-	0	0	258	0.0000000
A01	30114186	30115261	A01p38240.2_BraZ1	315	+	100	404	1075	0.3758140
A01	30117437	30120781	A01p38250.2_BraZ1	722.5	+	3170	3344	3344	1.0000000
A01	30121161	30121629	A01p38260.2_BraZ1	46.8	+	511	468	468	1.0000000
A01	30129016	30131115	A01p38270.2_BraZ1	1792	+	1968	2099	2099	1.0000000
A01	30146327	30148440	A01p38280.2_BraZ1	1760	+	1395	2113	2113	1.0000000
A01	30149912	30151724	A01p38290.2_BraZ1	1391.6	-	39	566	1812	0.3123620
A01	30157019	30159684	A01p38300.2_BraZ1	971.5	-	1404	2489	2665	0.9339587
A01	30162183	30164073	A01p38310.2_BraZ1	616.05	+	1157	1521	1890	0.8047619
A01	30165323	30168216	A01p38320.2_BraZ1	1590.45	+	1395	2256	2893	0.7798133
A01	30170892	30174654	A01p38330.2_BraZ1	3171.12	-	1034	3288	3762	0.8740032
A01	30175809	30179777	A01p38340.2_BraZ1	1143.12	-	1491	3466	3968	0.8734879
A01	30180312	30183947	A01p38350.2_BraZ1	371.8	+	678	2961	3635	0.8145804
A01	30186938	30189614	A01p38360.2_BraZ1	1988.1	+	1116	2276	2676	0.8505232
A01	30192692	30195573	A01p38370.2_BraZ1	4440	+	2086	2878	2881	0.9989587
A01	30199614	30201708	A01p38380.2_BraZ1	1686	+	146	1246	2094	0.5950334
A01	30203743	30204989	A01p38390.2_BraZ1	626.308	-	273	836	1246	0.6709470
A01	30205780	30208020	A01p38400.2_BraZ1	1185.46	-	1288	2171	2240	0.9691964
A01	30208697	30215031	A01p38410.2_BraZ1	2119.94	+	2637	5813	6334	0.9177455
A01	30215606	30220125	A01p38420.2_BraZ1	2130.43	+	632	2364	4519	0.5231246
A01	30227265	30227574	A01p38430.2_BraZ1	30.9	+	113	309	309	1.0000000
A01	30228877	30229134	A01p38440.2_BraZ1	105	+	383	257	257	1.0000000
A01	30238617	30238926	A01p38450.2_BraZ1	30.9	+	0	0	309	0.0000000
A01	30245475	30245821	A01p38460.2_BraZ1	150	+	141	346	346	1.0000000
A01	30246780	30249785	A01p38470.2_BraZ1	2913	-	904	1845	3005	0.6139767
A01	30251166	30252564	A01p38480.2_BraZ1	139.8	-	185	1158	1398	0.8283262
A01	30254195	30254522	A01p38490.2_BraZ1	32.7	-	2	128	327	0.3914373
A01	30257348	30257750	A01p38500.2_BraZ1	40.2	+	292	402	402	1.0000000
A01	30258287	30259550	A01p38510.2_BraZ1	831	-	292	1040	1263	0.8234363
A01	30268215	30268662	A01p38520.2_BraZ1	44.7	+	70	426	447	0.9530202
A01	30276120	30276342	A01p38530.2_BraZ1	20.1	+	385	222	222	1.0000000
A01	30277069	30277332	A01p38540.2_BraZ1	216	-	258	263	263	1.0000000
A01	30279932	30281985	A01p38550.2_BraZ1	1371	-	991	2033	2053	0.9902582
A01	30284656	30284959	A01p38560.2_BraZ1	30.3	+	178	284	303	0.9372937
A01	30287012	30287951	A01p38570.2_BraZ1	93.9	+	1413	939	939	1.0000000
A01	30288292	30290679	A01p38580.2_BraZ1	855.779	-	2500	2320	2387	0.9719313
A01	30298259	30299051	A01p38590.2_BraZ1	79.2	+	80	743	792	0.9381313
A01	30301109	30303932	A01p38600.2_BraZ1	1537.6	-	1109	2683	2823	0.9504074
A01	30305676	30307811	A01p38610.2_BraZ1	838.385	+	574	1913	2135	0.8960187
A01	30316811	30317467	A01p38620.2_BraZ1	333	+	186	629	656	0.9588414
A01	30322266	30322795	A01p38630.2_BraZ1	40.7143	+	23	329	529	0.6219282
A01	30323304	30328766	A01p38640.2_BraZ1	335.143	+	1232	3120	5462	0.5712193
A01	30333567	30334462	A01p38650.2_BraZ1	1332	+	203	895	895	1.0000000
A01	30334517	30334694	A01p38660.2_BraZ1	17.7	+	23	158	177	0.8926554
A01	30335010	30337601	A01p38670.2_BraZ1	981	+	181	2198	2591	0.8483211
A01	30337916	30338211	A01p38680.2_BraZ1	219	+	6	121	295	0.4101695
A01	30338274	30338586	A01p38690.2_BraZ1	237	+	3	25	312	0.0801282
A01	30348410	30349912	A01p38700.2_BraZ1	1380	-	185	1084	1502	0.7217044
A01	30360273	30361162	A01p38710.2_BraZ1	2910	-	601	889	889	1.0000000
A01	30362435	30365186	A01p38720.2_BraZ1	2000.39	+	1043	2651	2751	0.9636496
A01	30365703	30366024	A01p38730.2_BraZ1	246	+	316	321	321	1.0000000
A01	30367482	30369089	A01p38740.2_BraZ1	751.793	+	252	1373	1607	0.8543870
A01	30378050	30380252	A01p38750.2_BraZ1	1776.26	+	577	1832	2202	0.8319709
A01	30381677	30384833	A01p38760.2_BraZ1	1601.07	-	1844	3155	3156	0.9996831
A01	30386764	30388612	A01p38770.2_BraZ1	1460.45	-	316	1683	1848	0.9107143
A01	30389435	30394109	A01p38780.2_BraZ1	90	-	1422	3370	4674	0.7210099
A01	30401852	30403737	A01p38790.2_BraZ1	1307.81	-	323	1845	1885	0.9787799
A01	30419261	30420515	A01p38800.2_BraZ1	125.4	+	142	1138	1254	0.9074960
A01	30420694	30421441	A01p38810.2_BraZ1	297.5	+	114	349	747	0.4672022
A01	30422561	30423726	A01p38820.2_BraZ1	1080	-	777	1122	1165	0.9630901
A01	30427134	30427597	A01p38830.2_BraZ1	441	-	10	174	463	0.3758099
A01	30428270	30428711	A01p38840.2_BraZ1	44.1	-	372	441	441	1.0000000
A01	30433331	30433773	A01p38850.2_BraZ1	309	-	166	386	442	0.8733032
A01	30449133	30449399	A01p38860.2_BraZ1	186	-	39	165	266	0.6203008
A01	30449527	30449955	A01p38870.2_BraZ1	252	-	91	373	428	0.8714953
A01	30457125	30458668	A01p38880.2_BraZ1	128.4	-	455	1512	1543	0.9799092
A01	30464401	30465366	A01p38890.2_BraZ1	607.75	+	19	574	965	0.5948187
A01	30466371	30467802	A01p38900.2_BraZ1	607.464	+	1687	1431	1431	1.0000000
A01	30468325	30469369	A01p38910.2_BraZ1	104.4	-	575	1044	1044	1.0000000
A01	30472835	30478703	A01p38920.2_BraZ1	2567.68	+	2376	5521	5868	0.9408657
A01	30479571	30479967	A01p38930.2_BraZ1	39.6	+	0	0	396	0.0000000
A01	30481566	30482985	A01p38940.2_BraZ1	9750	+	594	1138	1419	0.8019732
A01	30483685	30486086	A01p38950.2_BraZ1	1196.25	+	400	2012	2401	0.8379841
A01	30486387	30488362	A01p38960.2_BraZ1	847.875	+	573	1877	1975	0.9503797
A01	30489234	30492338	A01p38970.2_BraZ1	1778.39	-	1067	2827	3104	0.9107603
A01	30494910	30497257	A01p38980.2_BraZ1	354.875	-	3347	2272	2347	0.9680443
A01	30499544	30499995	A01p38990.2_BraZ1	246	+	265	451	451	1.0000000
A01	30512277	30513614	A01p39000.2_BraZ1	1432.25	+	339	1336	1337	0.9992521
A01	30516175	30524098	A01p39010.2_BraZ1	4675.19	+	1353	5222	7923	0.6590938
A01	30528342	30528525	A01p39020.2_BraZ1	18.3	+	182	183	183	1.0000000
A01	30532467	30532611	A01p39030.2_BraZ1	14.4	+	1	89	144	0.6180556
A01	30545184	30547707	A01p39040.2_BraZ1	252.3	+	377	2080	2523	0.8244154
A01	30553470	30559009	A01p39050.2_BraZ1	266.667	-	1730	5051	5539	0.9118975
A01	30555433	30555849	A01p39060.2_BraZ1	36.6	+	46	416	416	1.0000000
A01	30557815	30558194	A01p39070.2_BraZ1	35.4	-	199	379	379	1.0000000
A01	30567731	30570378	A01p39080.2_BraZ1	1489.36	+	547	2390	2647	0.9029090
A01	30574188	30575577	A01p39090.2_BraZ1	138.9	-	184	841	1389	0.6054716
A01	30592805	30593176	A01p39100.2_BraZ1	306	+	58	123	371	0.3315364
A01	30607658	30608808	A01p39110.2_BraZ1	363	-	82	1008	1150	0.8765218
A01	30608081	30610387	A01p39120.2_BraZ1	1428	+	142	2123	2306	0.9206418
A01	30611262	30616823	A01p39130.2_BraZ1	1109.34	-	230	1696	5561	0.3049811
A01	30617381	30617962	A01p39140.2_BraZ1	459	-	46	510	581	0.8777969
A01	30620472	30621748	A01p39150.2_BraZ1	712.727	-	183	1127	1276	0.8832288
A01	30634037	30634377	A01p39160.2_BraZ1	225	+	12	187	340	0.5500000
A01	30642449	30643997	A01p39170.2_BraZ1	1248	-	35	924	1548	0.5968992
A01	30647065	30648267	A01p39180.2_BraZ1	11370	+	221	1162	1202	0.9667221
A01	30651659	30652109	A01p39190.2_BraZ1	168	+	97	420	450	0.9333333
A01	30657946	30660923	A01p39200.2_BraZ1	1590	+	904	2134	2977	0.7168290
A01	30667474	30668390	A01p39210.2_BraZ1	172.8	-	684	916	916	1.0000000
A01	30668984	30670551	A01p39220.2_BraZ1	1263	+	470	1552	1567	0.9904276
A01	30693478	30693805	A01p39230.2_BraZ1	32.7	-	623	327	327	1.0000000
A01	30701739	30703219	A01p39240.2_BraZ1	566.786	-	467	1239	1480	0.8371621
A01	30703901	30707089	A01p39250.2_BraZ1	1980.05	+	1714	2871	3188	0.9005646
A01	30707915	30708700	A01p39260.2_BraZ1	888	-	752	785	785	1.0000000
A01	30714055	30715438	A01p39270.2_BraZ1	41580	-	221	1319	1383	0.9537238
A01	30721320	30721995	A01p39280.2_BraZ1	67.5	-	134	669	675	0.9911111
A01	30724753	30725383	A01p39290.2_BraZ1	63	-	168	594	630	0.9428571
A01	30730015	30734673	A01p39300.2_BraZ1	534.708	-	1657	3729	4658	0.8005581
A01	30730634	30730948	A01p39310.2_BraZ1	216	-	62	307	314	0.9777070
A01	30740969	30742895	A01p39320.2_BraZ1	1761	+	327	1790	1926	0.9293873
A01	30744340	30746674	A01p39330.2_BraZ1	1872.72	+	535	1714	2334	0.7343616
A01	30747110	30747550	A01p39340.2_BraZ1	339	-	165	440	440	1.0000000
A01	30747938	30748137	A01p39350.2_BraZ1	147	+	282	199	199	1.0000000
A01	30751391	30751679	A01p39360.2_BraZ1	28.8	-	206	288	288	1.0000000
A01	30762341	30763583	A01p39370.2_BraZ1	124.2	+	645	1242	1242	1.0000000
A01	30769465	30770119	A01p39380.2_BraZ1	65.4	+	108	598	654	0.9143731
A01	30777751	30780928	A01p39390.2_BraZ1	2327.87	+	788	2813	3177	0.8854265
A01	30788977	30789972	A01p39400.2_BraZ1	534	+	165	873	995	0.8773869
A01	30791351	30793503	A01p39410.2_BraZ1	3084.87	+	2236	2127	2152	0.9883829
A01	30793968	30795410	A01p39420.2_BraZ1	761.95	+	806	1399	1442	0.9701803
A01	30797780	30800974	A01p39430.2_BraZ1	1651.12	+	830	2522	3194	0.7896055
A01	30801366	30802009	A01p39440.2_BraZ1	549	-	211	643	643	1.0000000
A01	30809920	30810876	A01p39450.2_BraZ1	654	+	656	955	956	0.9989540
A01	30811181	30811676	A01p39460.2_BraZ1	49.5	+	328	495	495	1.0000000
A01	30813632	30814217	A01p39470.2_BraZ1	58.5	-	13	94	585	0.1606838
A01	30830327	30832347	A01p39480.2_BraZ1	2044.89	-	338	1520	2020	0.7524753
A01	30847060	30849376	A01p39490.2_BraZ1	538.2	-	1921	2316	2316	1.0000000
A01	30852470	30852644	A01p39500.2_BraZ1	17.4	-	38	172	174	0.9885057
A01	30866332	30867832	A01p39510.2_BraZ1	150	+	162	862	1500	0.5746667
A01	30876118	30885346	A01p39520.2_BraZ1	3286.59	-	5770	8773	9228	0.9506935
A01	30886927	30887194	A01p39530.2_BraZ1	26.7	+	91	267	267	1.0000000
A01	30888299	30889539	A01p39540.2_BraZ1	876	+	3	250	1240	0.2016129
A01	30889565	30891218	A01p39550.2_BraZ1	165.3	+	4	51	1653	0.0308530
A01	30891753	30892077	A01p39560.2_BraZ1	32.4	-	132	258	324	0.7962963
A01	30896601	30898638	A01p39570.2_BraZ1	6998.25	+	371	1798	2037	0.8826706
A01	30899585	30903347	A01p39580.2_BraZ1	2154.86	-	1254	3616	3762	0.9611909
A01	30903611	30905775	A01p39590.2_BraZ1	917.333	+	1322	2059	2164	0.9514787
A01	30906925	30907789	A01p39600.2_BraZ1	86.4	+	282	819	864	0.9479167
A01	30908844	30912115	A01p39610.2_BraZ1	2058.87	-	1713	3271	3271	1.0000000
A01	30914006	30914632	A01p39620.2_BraZ1	549	-	365	626	626	1.0000000
A01	30919086	30924517	A01p39630.2_BraZ1	3593.74	-	4717	3911	5431	0.7201252
A01	30928947	30930227	A01p39640.2_BraZ1	1140	+	333	1149	1280	0.8976563
A01	30931402	30931768	A01p39650.2_BraZ1	36.6	-	13	185	366	0.5054645
A01	30933273	30934230	A01p39660.2_BraZ1	95.7	-	744	957	957	1.0000000
A01	30937442	30938582	A01p39670.2_BraZ1	632.812	+	18	135	1140	0.1184211
A01	30940657	30941788	A01p39680.2_BraZ1	174	+	99	809	1131	0.7152962
A01	30942162	30944588	A01p39690.2_BraZ1	13524	-	807	1959	2426	0.8075020
A01	30946976	30947417	A01p39700.2_BraZ1	324	-	367	441	441	1.0000000
A01	30968018	30968468	A01p39710.2_BraZ1	273	+	256	370	450	0.8222222
A01	30974006	30975377	A01p39720.2_BraZ1	735	-	593	1371	1371	1.0000000
A01	30977680	30979273	A01p39730.2_BraZ1	1030.58	+	468	1573	1593	0.9874451
A01	30980175	30981812	A01p39740.2_BraZ1	1620	-	333	1550	1637	0.9468540
A01	30983153	30984677	A01p39750.2_BraZ1	447.75	-	1993	1524	1524	1.0000000
A01	30990258	30990369	A01p39760.2_BraZ1	11.1	-	110	111	111	1.0000000
A01	30993187	30993568	A01p39770.2_BraZ1	38.1	+	21	225	381	0.5905512
A01	30994755	30996037	A01p39780.2_BraZ1	7959	-	131	1033	1282	0.8057722
A01	31001149	31002946	A01p39790.2_BraZ1	17136	-	784	1788	1797	0.9949917
A01	31004984	31005453	A01p39800.2_BraZ1	294	-	71	242	469	0.5159914
A01	31006350	31010472	A01p39810.2_BraZ1	1289.58	-	1292	3712	4122	0.9005337
A01	31012654	31014549	A01p39820.2_BraZ1	10602	-	337	1509	1895	0.7963061
A01	31017924	31018519	A01p39830.2_BraZ1	477	-	109	573	595	0.9630252
A01	31025391	31026529	A01p39840.2_BraZ1	19129.5	+	184	1134	1138	0.9964851
A01	31026650	31027047	A01p39850.2_BraZ1	174	-	193	397	397	1.0000000
A01	31027057	31027617	A01p39860.2_BraZ1	306.789	-	173	560	560	1.0000000
A01	31029185	31031848	A01p39870.2_BraZ1	1364.42	-	457	1836	2663	0.6894480
A01	31035461	31036351	A01p39880.2_BraZ1	80	+	1121	865	890	0.9719101
A01	31040876	31041895	A01p39890.2_BraZ1	457.85	-	275	973	1019	0.9548577
A01	31041855	31043323	A01p39900.2_BraZ1	763.399	-	308	1375	1468	0.9366485
A01	31047017	31047335	A01p39910.2_BraZ1	31.8	+	47	225	318	0.7075472
A01	31047409	31049487	A01p39920.2_BraZ1	10971	+	852	2046	2078	0.9846006
A01	31050418	31051116	A01p39930.2_BraZ1	618	+	183	594	698	0.8510029
A01	31052237	31053320	A01p39940.2_BraZ1	108.3	+	557	1053	1083	0.9722992
A01	31053667	31053832	A01p39950.2_BraZ1	16.5	+	190	165	165	1.0000000
A01	31060539	31061340	A01p39960.2_BraZ1	4792.5	-	134	581	801	0.7253433
A01	31064825	31066540	A01p39970.2_BraZ1	924.194	+	489	1636	1715	0.9539359
A01	31069411	31070901	A01p39980.2_BraZ1	586.032	+	556	1451	1490	0.9738255
A01	31071270	31073198	A01p39990.2_BraZ1	932.657	-	1035	1926	1928	0.9989626
A01	31073620	31076967	A01p40000.2_BraZ1	2291.62	-	1205	3230	3347	0.9650433
A01	31080715	31080847	A01p40010.2_BraZ1	13.2	+	0	0	132	0.0000000
A01	31081412	31084039	A01p40020.2_BraZ1	944	-	280	1580	2627	0.6014465
A01	31089019	31089580	A01p40030.2_BraZ1	56.1	+	77	519	561	0.9251337
A01	31113742	31117608	A01p40040.2_BraZ1	1408.88	+	216	1334	3866	0.3450595
A01	31118950	31124922	A01p40050.2_BraZ1	3048.46	+	1138	4006	5972	0.6707970
A01	31129576	31131795	A01p40060.2_BraZ1	1893	-	322	1852	2219	0.8346102
A01	31132809	31133508	A01p40070.2_BraZ1	618	+	407	699	699	1.0000000
A01	31148723	31150625	A01p40080.2_BraZ1	9970.17	-	693	1871	1902	0.9837013
A01	31156764	31158567	A01p40090.2_BraZ1	1227.62	-	819	1744	1803	0.9672768
A01	31160954	31162202	A01p40100.2_BraZ1	960.25	-	211	1202	1248	0.9631410
A01	31163502	31164624	A01p40110.2_BraZ1	393.421	-	853	1122	1122	1.0000000
A01	31173247	31174329	A01p40120.2_BraZ1	228	-	8	139	1082	0.1284658
A01	31174350	31174964	A01p40130.2_BraZ1	222	-	46	200	614	0.3257329
A01	31176194	31178124	A01p40140.2_BraZ1	1412.57	+	124	1472	1930	0.7626943
A01	31186222	31187359	A01p40150.2_BraZ1	113.7	+	257	856	1137	0.7528584
A01	31190319	31190827	A01p40160.2_BraZ1	186	+	564	508	508	1.0000000
A01	31203698	31207046	A01p40170.2_BraZ1	1885.96	+	2502	2609	3348	0.7792712
A01	31209219	31212645	A01p40180.2_BraZ1	1996.4	-	873	3034	3426	0.8855808
A01	31215425	31215943	A01p40190.2_BraZ1	411	+	576	518	518	1.0000000
A01	31216194	31216818	A01p40200.2_BraZ1	353.917	-	719	624	624	1.0000000
A01	31218276	31222496	A01p40210.2_BraZ1	1530.41	-	1977	3749	4220	0.8883886
A01	31230516	31230829	A01p40220.2_BraZ1	141	+	420	313	313	1.0000000
A01	31231721	31231856	A01p40230.2_BraZ1	13.5	+	104	135	135	1.0000000
A01	31237809	31238895	A01p40240.2_BraZ1	108.3	-	23	372	1086	0.3425414
A01	31241699	31245437	A01p40250.2_BraZ1	1506	-	1104	3631	3738	0.9713750
A01	31245763	31246463	A01p40260.2_BraZ1	506	-	67	430	700	0.6142857
A01	31252065	31252466	A01p40270.2_BraZ1	219	+	122	372	401	0.9276808
A01	31254844	31255451	A01p40280.2_BraZ1	120	+	408	607	607	1.0000000
A01	31259223	31259472	A01p40290.2_BraZ1	24.9	-	292	249	249	1.0000000
A01	31265951	31267153	A01p40300.2_BraZ1	1095	-	1140	1192	1202	0.9916805
A01	31276752	31277993	A01p40310.2_BraZ1	832.5	+	528	1241	1241	1.0000000
A01	31286404	31291617	A01p40320.2_BraZ1	312	-	1902	5036	5213	0.9660464
A01	31293302	31297358	A01p40330.2_BraZ1	2265.71	+	430	1943	4056	0.4790434
A01	31301555	31301996	A01p40340.2_BraZ1	213	+	383	441	441	1.0000000
A01	31304514	31306194	A01p40350.2_BraZ1	188.364	-	948	1680	1680	1.0000000
A01	31312700	31315324	A01p40360.2_BraZ1	697.5	+	2033	2339	2624	0.8913872
A01	31321201	31325926	A01p40370.2_BraZ1	2523.14	+	224	2028	4725	0.4292063
A01	31326621	31327400	A01p40380.2_BraZ1	355.6	+	0	0	779	0.0000000
A01	31328592	31329537	A01p40390.2_BraZ1	729.6	+	3	266	945	0.2814815
A01	31330724	31331669	A01p40400.2_BraZ1	729.6	+	6	296	945	0.3132275
A01	31335220	31336160	A01p40410.2_BraZ1	390	+	0	0	940	0.0000000
A01	31343280	31343823	A01p40420.2_BraZ1	54.3	+	345	543	543	1.0000000
A01	31344397	31347465	A01p40430.2_BraZ1	3222	+	436	1878	3068	0.6121252
A01	31348108	31349968	A01p40440.2_BraZ1	777.978	+	960	1703	1860	0.9155914
A01	31350893	31353004	A01p40450.2_BraZ1	893.829	-	1493	2095	2111	0.9924207
A01	31358504	31360824	A01p40460.2_BraZ1	1287.8	+	416	1962	2320	0.8456897
A01	31361368	31362052	A01p40470.2_BraZ1	351	-	398	684	684	1.0000000
A01	31364152	31364436	A01p40480.2_BraZ1	177	-	143	284	284	1.0000000
A01	31373473	31374038	A01p40490.2_BraZ1	312	+	197	565	565	1.0000000
A01	31375232	31377050	A01p40500.2_BraZ1	1080.4	-	410	1683	1818	0.9257426
A01	31380080	31381271	A01p40510.2_BraZ1	119.1	+	87	532	1191	0.4466835
A01	31383357	31398899	A01p40520.2_BraZ1	1333.24	+	7019	14795	15542	0.9519367
A01	31399712	31400768	A01p40530.2_BraZ1	102.9	-	196	771	1056	0.7301136
A01	31410609	31411065	A01p40540.2_BraZ1	45.6	+	5	108	456	0.2368421
A01	31412320	31413301	A01p40550.2_BraZ1	272.392	-	243	950	981	0.9683996
A01	31418010	31419559	A01p40560.2_BraZ1	1248	+	123	973	1549	0.6281472
A01	31419656	31421447	A01p40570.2_BraZ1	101.25	+	435	1677	1791	0.9363484
A01	31436114	31437551	A01p40580.2_BraZ1	14620.5	+	761	1434	1437	0.9979123
A01	31438477	31439002	A01p40590.2_BraZ1	52.5	+	46	198	525	0.3771428
A01	31439297	31443775	A01p40600.2_BraZ1	459.429	-	547	2274	4478	0.5078160
A01	31439935	31440274	A01p40610.2_BraZ1	237	-	0	0	339	0.0000000
A01	31441310	31441622	A01p40620.2_BraZ1	31.2	+	0	0	312	0.0000000
A01	31450797	31451311	A01p40630.2_BraZ1	38.7	+	204	445	514	0.8657588
A01	31451925	31452527	A01p40640.2_BraZ1	324	-	127	476	602	0.7906977
A01	31454725	31455023	A01p40650.2_BraZ1	138	+	12	235	298	0.7885906
A01	31455324	31455658	A01p40660.2_BraZ1	135	+	21	223	334	0.6676646
A01	31456699	31463658	A01p40670.2_BraZ1	3026.69	-	1675	4495	6959	0.6459261
A01	31473245	31473383	A01p40680.2_BraZ1	13.8	-	19	96	138	0.6956522
A01	31473502	31474097	A01p40690.2_BraZ1	126	-	311	595	595	1.0000000
A01	31481833	31485529	A01p40700.2_BraZ1	1408.81	+	1234	3284	3696	0.8885282
A01	31488012	31489289	A01p40710.2_BraZ1	1027.29	+	420	1252	1277	0.9804229
A01	31490581	31491292	A01p40720.2_BraZ1	519	-	294	686	711	0.9648383
A01	31493275	31493914	A01p40730.2_BraZ1	183	-	310	639	639	1.0000000
A01	31494615	31495297	A01p40740.2_BraZ1	5968.5	+	121	682	682	1.0000000
A01	31496246	31496798	A01p40750.2_BraZ1	55.2	+	51	402	552	0.7282609
A01	31497979	31498831	A01p40760.2_BraZ1	660.3	-	72	824	852	0.9671361
A01	31501711	31502911	A01p40770.2_BraZ1	570.667	-	822	1200	1200	1.0000000
A01	31503925	31504916	A01p40780.2_BraZ1	347.127	+	461	991	991	1.0000000
A01	31509394	31510186	A01p40790.2_BraZ1	195	-	743	792	792	1.0000000
A01	31523007	31523991	A01p40800.2_BraZ1	531	+	89	479	984	0.4867886
A01	31540047	31540572	A01p40810.2_BraZ1	297	-	372	525	525	1.0000000
A01	31543290	31544272	A01p40820.2_BraZ1	531	+	136	900	982	0.9164969
A01	31555082	31555727	A01p40830.2_BraZ1	64.5	-	182	602	645	0.9333333
A01	31558510	31560306	A01p40840.2_BraZ1	1045.12	-	496	1716	1796	0.9554566
A01	31562829	31563169	A01p40850.2_BraZ1	276	-	174	307	340	0.9029412
A01	31570249	31570657	A01p40860.2_BraZ1	40.8	-	69	361	408	0.8848040
A01	31575711	31576356	A01p40870.2_BraZ1	260	+	326	645	645	1.0000000
A01	31581881	31582910	A01p40880.2_BraZ1	885	-	10435	1028	1029	0.9990282
A01	31585764	31589235	A01p40890.2_BraZ1	1904.28	+	1757	3124	3471	0.9000288
A01	31589938	31590933	A01p40900.2_BraZ1	497.29	+	310	995	995	1.0000000
A01	31591651	31593701	A01p40910.2_BraZ1	782.156	-	1571	2050	2050	1.0000000
A01	31593940	31601434	A01p40920.2_BraZ1	306	+	6895	6942	7494	0.9263411
A01	31603980	31605138	A01p40930.2_BraZ1	111.9	+	879	1158	1158	1.0000000
A01	31606112	31607235	A01p40940.2_BraZ1	11092.5	+	326	764	1123	0.6803206
A01	31607670	31608450	A01p40950.2_BraZ1	78	+	339	780	780	1.0000000
A01	31609302	31610192	A01p40960.2_BraZ1	606	+	330	890	890	1.0000000
A01	31611531	31611972	A01p40970.2_BraZ1	44.1	+	323	441	441	1.0000000
A01	31613163	31613615	A01p40980.2_BraZ1	32.4	+	257	363	452	0.8030974
A01	31614234	31615017	A01p40990.2_BraZ1	56.1	-	398	783	783	1.0000000
A01	31615768	31617727	A01p41000.2_BraZ1	195.9	+	1083	1959	1959	1.0000000
A01	31619674	31620288	A01p41010.2_BraZ1	516	+	58	614	614	1.0000000
A01	31623149	31625575	A01p41020.2_BraZ1	2007	+	1052	2403	2426	0.9905193
A01	31626560	31627100	A01p41030.2_BraZ1	99.75	-	92	519	540	0.9611111
A01	31628307	31629052	A01p41040.2_BraZ1	255	+	328	702	745	0.9422819
A01	31630279	31631055	A01p41050.2_BraZ1	372	+	1	65	776	0.0837629
A01	31631639	31631870	A01p41060.2_BraZ1	23.1	-	29	227	231	0.9826840
A01	31644581	31649096	A01p41070.2_BraZ1	2336.02	+	3762	4382	4515	0.9705426
A01	31649432	31650079	A01p41080.2_BraZ1	360	+	64	510	647	0.7882535
A01	31652966	31653959	A01p41090.2_BraZ1	381	+	1017	993	993	1.0000000
A01	31654929	31655360	A01p41100.2_BraZ1	330	-	346	431	431	1.0000000
A01	31658736	31668416	A01p41110.2_BraZ1	2465	-	3488	8877	9680	0.9170455
A01	31671014	31672750	A01p41120.2_BraZ1	990	-	102	898	1736	0.5172811
A01	31677551	31677827	A01p41130.2_BraZ1	27.6	-	38	230	276	0.8333333
A01	31678118	31678223	A01p41140.2_BraZ1	10.5	-	1	33	105	0.3142857
A01	31679924	31680434	A01p41150.2_BraZ1	51	-	30	130	510	0.2549020
A01	31681192	31683061	A01p41160.2_BraZ1	186.9	-	402	1064	1869	0.5692884
A01	31683214	31683328	A01p41170.2_BraZ1	11.4	-	275	114	114	1.0000000
A01	31688799	31689487	A01p41180.2_BraZ1	285	-	673	688	688	1.0000000
A01	31690630	31690891	A01p41190.2_BraZ1	26.1	-	683	261	261	1.0000000
A01	31705955	31706144	A01p41200.2_BraZ1	18.9	-	147	189	189	1.0000000
A01	31706235	31706531	A01p41210.2_BraZ1	1863	-	125	296	296	1.0000000
A01	31708231	31708516	A01p41220.2_BraZ1	28.5	-	0	0	285	0.0000000
A01	31713603	31713810	A01p41230.2_BraZ1	20.7	+	306	207	207	1.0000000
A01	31716772	31717733	A01p41240.2_BraZ1	726	-	318	901	961	0.9375650
A01	31719260	31721062	A01p41250.2_BraZ1	18018	-	1075	1645	1802	0.9128746
A01	31723587	31725211	A01p41260.2_BraZ1	297	-	0	0	1624	0.0000000
A01	31726600	31730543	A01p41270.2_BraZ1	2201.92	-	1426	3921	3943	0.9944205
A01	31732740	31733638	A01p41280.2_BraZ1	198.75	-	1026	898	898	1.0000000
A01	31733705	31734454	A01p41290.2_BraZ1	299.062	-	583	749	749	1.0000000
A01	31735778	31735967	A01p41300.2_BraZ1	18.9	+	18	74	189	0.3915344
A01	31740024	31743009	A01p41310.2_BraZ1	1906.22	+	686	2412	2985	0.8080402
A01	31744957	31745833	A01p41320.2_BraZ1	87.6	-	697	876	876	1.0000000
A01	31748430	31751195	A01p41330.2_BraZ1	819	-	1254	2701	2765	0.9768535
A01	31751996	31757230	A01p41340.2_BraZ1	2473.8	-	1066	4552	5234	0.8696981
A01	31753014	31753470	A01p41350.2_BraZ1	45.6	-	105	456	456	1.0000000
A01	31758084	31759403	A01p41360.2_BraZ1	645.042	-	859	1293	1319	0.9802881
A01	31761656	31762867	A01p41370.2_BraZ1	42.9	+	65	511	1211	0.4219653
A01	31763453	31764971	A01p41380.2_BraZ1	613.125	+	141	856	1518	0.5638999
A01	31767318	31768319	A01p41390.2_BraZ1	2235.6	-	123	842	1001	0.8411589
A01	31771629	31774997	A01p41400.2_BraZ1	1078.93	-	1563	2737	3368	0.8126485
A01	31779301	31779748	A01p41410.2_BraZ1	44.7	-	63	402	447	0.8993289
A01	31784508	31784955	A01p41420.2_BraZ1	44.7	-	3	150	447	0.3355705
A01	31791695	31792745	A01p41430.2_BraZ1	494.929	+	962	1033	1050	0.9838095
A01	31794924	31799570	A01p41440.2_BraZ1	2068.6	+	1501	4540	4646	0.9771847
A01	31799941	31814471	A01p41450.2_BraZ1	474.667	+	2073	5371	14530	0.3696490
A01	31814975	31816943	A01p41460.2_BraZ1	196.8	+	1082	1957	1968	0.9944106
A01	31817357	31819149	A01p41470.2_BraZ1	6808.5	+	690	1726	1792	0.9631696
A01	31821180	31822320	A01p41480.2_BraZ1	408.75	+	414	1098	1140	0.9631579
A01	31827631	31828231	A01p41490.2_BraZ1	60	-	13	53	600	0.0883333
A01	31835720	31837082	A01p41500.2_BraZ1	679.821	+	317	1188	1362	0.8722467
A01	31844648	31845370	A01p41510.2_BraZ1	192	+	1021	722	722	1.0000000
A01	31846726	31846960	A01p41520.2_BraZ1	23.4	+	696	234	234	1.0000000
A01	31851112	31853516	A01p41530.2_BraZ1	1403.3	-	52	992	2404	0.4126456
A01	31854739	31856275	A01p41540.2_BraZ1	1170	+	419	1520	1536	0.9895833
A01	31859956	31860359	A01p41550.2_BraZ1	276	-	102	299	403	0.7419355
A01	31864977	31867062	A01p41560.2_BraZ1	1333.83	+	484	1999	2085	0.9587530
A01	31868119	31872544	A01p41570.2_BraZ1	385	-	5385	4009	4425	0.9059887
A01	31872586	31873500	A01p41580.2_BraZ1	421.8	-	932	914	914	1.0000000
A01	31885894	31887252	A01p41590.2_BraZ1	897	-	153	1136	1358	0.8365243
A01	31889655	31891337	A01p41600.2_BraZ1	1613.27	-	450	1595	1682	0.9482759
A01	31894495	31896242	A01p41610.2_BraZ1	1367.05	-	257	980	1747	0.5609617
A01	31903367	31903925	A01p41620.2_BraZ1	261	-	1389	558	558	1.0000000
A01	31907885	31920388	A01p41630.2_BraZ1	2638.07	-	1639	8219	12503	0.6573622
A01	31927076	31927558	A01p41640.2_BraZ1	321	-	7	150	482	0.3112033
A01	31928157	31929515	A01p41650.2_BraZ1	576.343	+	320	1260	1358	0.9278350
A01	31931489	31932980	A01p41660.2_BraZ1	750	-	228	1226	1491	0.8222669
A01	31937740	31944411	A01p41670.2_BraZ1	1285.91	-	1346	5897	6671	0.8839754
A01	31949958	31952265	A01p41680.2_BraZ1	1481.6	+	873	1895	2307	0.8214131
A01	31956903	31959036	A01p41690.2_BraZ1	484.5	-	1436	1816	2133	0.8513830
A01	31967132	31970373	A01p41700.2_BraZ1	1373.62	+	271	2296	3241	0.7084233
A01	31970619	31971537	A01p41710.2_BraZ1	512.5	-	94	738	918	0.8039216
A01	31971889	31975427	A01p41720.2_BraZ1	1399.33	-	885	3164	3538	0.8942906
A01	31977804	31979254	A01p41730.2_BraZ1	711	+	588	1450	1450	1.0000000
A01	31979373	31980642	A01p41740.2_BraZ1	978	-	77	1161	1269	0.9148936
A01	31986038	31986194	A01p41750.2_BraZ1	15.6	+	22	156	156	1.0000000
A01	31986950	31987641	A01p41760.2_BraZ1	4336.2	+	315	555	691	0.8031838
A01	31987785	31990089	A01p41770.2_BraZ1	1478.25	-	153	1186	2304	0.5147569
A01	31991646	31992081	A01p41780.2_BraZ1	213	+	237	412	435	0.9471264
A01	31991855	31992811	A01p41790.2_BraZ1	58.8	+	452	935	956	0.9780335
A01	31996097	31996257	A01p41800.2_BraZ1	13.2	-	162	160	160	1.0000000
A01	31997865	32000077	A01p41810.2_BraZ1	1361.95	-	459	1475	2212	0.6668174
A01	32000877	32001297	A01p41820.2_BraZ1	153	+	213	420	420	1.0000000
A01	32001728	32004816	A01p41830.2_BraZ1	1582.55	-	1073	2950	3088	0.9553109
A01	32006269	32007193	A01p41840.2_BraZ1	91.5	+	194	924	924	1.0000000
A01	32007962	32008616	A01p41850.2_BraZ1	358.312	+	245	654	654	1.0000000
A01	32043115	32046505	A01p41860.2_BraZ1	1808.57	-	882	2732	3390	0.8058997
A01	32047548	32047841	A01p41870.2_BraZ1	207	-	23	239	293	0.8156996
A01	32048013	32048333	A01p41880.2_BraZ1	246	-	37	126	320	0.3937500
A01	32049278	32049545	A01p41890.2_BraZ1	26.7	+	96	267	267	1.0000000
A01	32049830	32052068	A01p41900.2_BraZ1	921.2	+	1689	2234	2238	0.9982127
A01	32052343	32056134	A01p41910.2_BraZ1	1723.32	-	1329	3109	3791	0.8201002
A01	32062703	32063102	A01p41920.2_BraZ1	39.9	+	261	380	399	0.9523810
A01	32063634	32063985	A01p41930.2_BraZ1	297	+	422	351	351	1.0000000
A01	32067976	32068225	A01p41940.2_BraZ1	24.9	-	21	173	249	0.6947791
A01	32082902	32088620	A01p41950.2_BraZ1	2597.25	+	687	3728	5718	0.6519762
A01	32091398	32094823	A01p41960.2_BraZ1	1224.82	+	617	2247	3425	0.6560584
A01	32099002	32103698	A01p41970.2_BraZ1	1773.84	+	2248	3991	4696	0.8498722
A01	32104686	32105163	A01p41980.2_BraZ1	47.7	+	31	309	477	0.6477987
A01	32106376	32108305	A01p41990.2_BraZ1	192.9	-	1069	1828	1929	0.9476413
A01	32108682	32112109	A01p42000.2_BraZ1	1802.56	+	3245	3427	3427	1.0000000
A01	32112436	32113040	A01p42010.2_BraZ1	423	+	468	604	604	1.0000000
A01	32113281	32114776	A01p42020.2_BraZ1	1020	-	732	1495	1495	1.0000000
A01	32119977	32121245	A01p42030.2_BraZ1	354	+	371	1161	1268	0.9156151
A01	32122604	32124836	A01p42040.2_BraZ1	363	+	645	1962	2232	0.8790323
A01	32125510	32126011	A01p42050.2_BraZ1	50.1	+	98	334	501	0.6666667
A01	32195969	32196218	A01p42060.2_BraZ1	24.9	-	128	249	249	1.0000000
A01	32200151	32200494	A01p42070.2_BraZ1	188.906	-	121	343	343	1.0000000
A01	32222417	32224010	A01p42080.2_BraZ1	870	-	231	1137	1593	0.7137476
A01	32224950	32227079	A01p42090.2_BraZ1	1176	-	47	710	2129	0.3334899
A01	32227741	32230465	A01p42100.2_BraZ1	1022.83	-	1591	2635	2724	0.9673275
A01	32231385	32231888	A01p42110.2_BraZ1	426	-	272	503	503	1.0000000
A01	32233699	32234644	A01p42120.2_BraZ1	738	+	2	21	945	0.0222222
A01	32236684	32240708	A01p42130.2_BraZ1	36585	-	858	2680	4024	0.6660040
A01	32246100	32247362	A01p42140.2_BraZ1	504.214	+	1185	1262	1262	1.0000000
A01	32247994	32249338	A01p42150.2_BraZ1	125.1	+	411	1102	1344	0.8199404
A01	32250346	32250541	A01p42160.2_BraZ1	19.5	+	75	195	195	1.0000000
A01	32250846	32252684	A01p42170.2_BraZ1	931.346	-	1122	1805	1838	0.9820457
A01	32254720	32255374	A01p42180.2_BraZ1	501	-	71	588	654	0.8990825
A01	32260186	32260956	A01p42190.2_BraZ1	681	+	160	629	770	0.8168831
A01	32262553	32263542	A01p42200.2_BraZ1	485.673	+	640	988	989	0.9989889
A01	32263836	32265464	A01p42210.2_BraZ1	685.969	-	1586	1628	1628	1.0000000
A01	32271696	32273550	A01p42220.2_BraZ1	531.08	-	1747	1854	1854	1.0000000
A01	32275896	32278680	A01p42230.2_BraZ1	1392.32	+	749	2719	2784	0.9766523
A01	32284406	32287131	A01p42240.2_BraZ1	1675.26	-	976	2649	2725	0.9721101
A01	32288206	32288806	A01p42250.2_BraZ1	342	-	235	600	600	1.0000000
A01	32289676	32291200	A01p42260.2_BraZ1	97.5	+	304	1413	1524	0.9271653
A01	32295895	32297759	A01p42270.2_BraZ1	3714.5	+	78	651	1864	0.3492489
A01	32299337	32300485	A01p42280.2_BraZ1	6831	-	245	800	1148	0.6968641
A01	32310426	32310743	A01p42290.2_BraZ1	1020	-	70	286	317	0.9022082
A01	32318450	32318657	A01p42300.2_BraZ1	20.7	-	28	198	207	0.9565217
A01	32321812	32322115	A01p42310.2_BraZ1	30.3	+	598	303	303	1.0000000
A01	32326283	32329080	A01p42320.2_BraZ1	1296	+	1750	2687	2797	0.9606721
A01	32333884	32335336	A01p42330.2_BraZ1	1077	-	341	1126	1452	0.7754821
A01	32357970	32359095	A01p42340.2_BraZ1	935.654	-	37	356	1125	0.3164445
A01	32368393	32369455	A01p42350.2_BraZ1	720	-	378	1025	1062	0.9651601
A01	32372069	32373570	A01p42360.2_BraZ1	719.979	+	1172	1501	1501	1.0000000
A01	32373826	32374990	A01p42370.2_BraZ1	762	-	871	1164	1164	1.0000000
A01	32377168	32387043	A01p42380.2_BraZ1	1774.29	-	2701	7284	9875	0.7376202
A01	32388146	32390823	A01p42390.2_BraZ1	1307.17	+	1370	2592	2677	0.9682480
A01	32394364	32396449	A01p42400.2_BraZ1	820.8	-	1347	2085	2085	1.0000000
A01	32396747	32397023	A01p42410.2_BraZ1	204	+	366	276	276	1.0000000
A01	32398691	32401279	A01p42420.2_BraZ1	1579.56	-	1774	2588	2588	1.0000000
A01	32403927	32405944	A01p42430.2_BraZ1	718.2	-	1465	2017	2017	1.0000000
A01	32406568	32407245	A01p42440.2_BraZ1	1318.2	-	739	677	677	1.0000000
A01	32408255	32409086	A01p42450.2_BraZ1	83.1	+	253	647	831	0.7785800
A01	32410895	32414381	A01p42460.2_BraZ1	1704.25	+	507	2913	3486	0.8356282
A01	32414778	32416885	A01p42470.2_BraZ1	1310.48	-	349	1816	2107	0.8618889
A01	32420748	32421183	A01p42480.2_BraZ1	43.5	+	456	435	435	1.0000000
A01	32421491	32422178	A01p42490.2_BraZ1	68.7	-	146	621	687	0.9039301
A01	32438194	32438845	A01p42500.2_BraZ1	65.1	+	283	455	651	0.6989247
A01	32442017	32442683	A01p42510.2_BraZ1	389.4	+	775	666	666	1.0000000
A01	32444600	32445223	A01p42520.2_BraZ1	5044.5	+	303	623	623	1.0000000
A01	32446767	32448931	A01p42530.2_BraZ1	630	-	4276	2164	2164	1.0000000
A01	32447183	32447501	A01p42540.2_BraZ1	31.5	+	319	318	318	1.0000000
A01	32457353	32458273	A01p42550.2_BraZ1	399	-	12	228	920	0.2478261
A01	32464604	32465234	A01p42560.2_BraZ1	63	-	164	630	630	1.0000000
A01	32466655	32467100	A01p42570.2_BraZ1	144	-	666	445	445	1.0000000
A01	32468370	32469178	A01p42580.2_BraZ1	600	-	490	808	808	1.0000000
A01	32472826	32474386	A01p42590.2_BraZ1	915	-	1066	1525	1560	0.9775641
A01	32476997	32478116	A01p42600.2_BraZ1	1005	+	531	1116	1119	0.9973190
A01	32478689	32478911	A01p42610.2_BraZ1	22.2	+	101	222	222	1.0000000
A01	32480265	32481435	A01p42620.2_BraZ1	117	+	560	1170	1170	1.0000000
A01	32482906	32483652	A01p42630.2_BraZ1	657	-	82	687	746	0.9209116
A01	32484488	32485454	A01p42640.2_BraZ1	849.205	+	448	966	966	1.0000000
A01	32486123	32486786	A01p42650.2_BraZ1	66.3	+	92	663	663	1.0000000
A01	32488631	32489690	A01p42660.2_BraZ1	105.9	-	259	998	1059	0.9423985
A01	32495224	32496779	A01p42670.2_BraZ1	761.4	-	1055	1460	1555	0.9389067
A01	32501776	32504509	A01p42680.2_BraZ1	2173.5	+	959	2521	2733	0.9224296
A01	32505296	32505425	A01p42690.2_BraZ1	12.9	-	98	129	129	1.0000000
A01	32507010	32513523	A01p42700.2_BraZ1	276	-	1829	4681	6513	0.7187164
A01	32510030	32511176	A01p42710.2_BraZ1	180	+	163	737	1146	0.6431065
A01	32513526	32515320	A01p42720.2_BraZ1	179.4	-	473	1656	1794	0.9230769
A01	32518330	32518804	A01p42730.2_BraZ1	47.4	+	182	406	474	0.8565401
A01	32518876	32519944	A01p42740.2_BraZ1	106.5	+	522	845	1068	0.7911985
A01	32520503	32521789	A01p42750.2_BraZ1	900	+	1237	1078	1286	0.8382581
A01	32522981	32525027	A01p42760.2_BraZ1	959.719	-	298	1586	2046	0.7751710
A01	32527838	32528621	A01p42770.2_BraZ1	40.2	-	6	328	783	0.4189017
A01	32529802	32535791	A01p42780.2_BraZ1	2602.09	-	4046	5626	5989	0.9393889
A01	32538250	32538391	A01p42790.2_BraZ1	14.1	-	28	141	141	1.0000000
A01	32542964	32544450	A01p42800.2_BraZ1	1010.62	-	840	1486	1486	1.0000000
A01	32547396	32549519	A01p42810.2_BraZ1	2028	+	963	2092	2123	0.9853980
A01	32550129	32552127	A01p42820.2_BraZ1	199.2	-	435	1632	1998	0.8168168
A01	32557729	32559398	A01p42830.2_BraZ1	661.539	+	1128	1600	1669	0.9586579
A01	32559817	32560414	A01p42840.2_BraZ1	3192	-	100	480	597	0.8040201
A01	32561895	32562569	A01p42850.2_BraZ1	40.5	+	590	648	674	0.9614244
A01	32563978	32565916	A01p42860.2_BraZ1	193.8	+	1029	1938	1938	1.0000000
A01	32566340	32568658	A01p42870.2_BraZ1	1739.92	-	573	2083	2318	0.8986195
A01	32572046	32574318	A01p42880.2_BraZ1	1154.25	-	247	1277	2272	0.5620599
A01	32575611	32576576	A01p42890.2_BraZ1	288	+	76	754	965	0.7813472
A01	32578100	32580137	A01p42900.2_BraZ1	1459.63	-	18	647	2037	0.3176239
A01	32580727	32582559	A01p42910.2_BraZ1	1314.92	-	335	1268	1832	0.6921397
A01	32583188	32584021	A01p42920.2_BraZ1	326.667	-	914	833	833	1.0000000
A01	32584488	32584989	A01p42930.2_BraZ1	381	-	574	501	501	1.0000000
A01	32585666	32588601	A01p42940.2_BraZ1	1974.52	+	955	2895	2935	0.9863714
A01	32589362	32589803	A01p42950.2_BraZ1	44.1	-	193	441	441	1.0000000
A01	32598117	32600308	A01p42960.2_BraZ1	393	-	632	1908	2191	0.8708352
A01	32611503	32611899	A01p42970.2_BraZ1	39.6	+	265	396	396	1.0000000
A01	32614624	32619439	A01p42980.2_BraZ1	1669.85	+	2449	4546	4815	0.9441329
A01	32793262	32794052	A01p42990.2_BraZ1	492.375	+	45	382	790	0.4835443
A01	32798169	32800525	A01p43000.2_BraZ1	1509.09	+	1861	2356	2356	1.0000000
A01	32801684	32801852	A01p43010.2_BraZ1	16.8	+	95	168	168	1.0000000
A01	32802397	32804952	A01p43020.2_BraZ1	2121.75	+	894	2524	2555	0.9878669
A01	32807473	32807786	A01p43030.2_BraZ1	222	-	363	313	313	1.0000000
A01	32811445	32811598	A01p43040.2_BraZ1	15.3	-	1451	153	153	1.0000000
A01	32815370	32818135	A01p43050.2_BraZ1	1557.75	+	2119	2765	2765	1.0000000
A01	32821701	32823811	A01p43060.2_BraZ1	657.333	-	933	2006	2110	0.9507109
A01	32840732	32842529	A01p43070.2_BraZ1	179.7	+	217	1562	1797	0.8692265
A01	32857352	32857660	A01p43080.2_BraZ1	231	+	308	308	308	1.0000000
A01	32858226	32862515	A01p43090.2_BraZ1	726	-	1906	3979	4289	0.9277221
A01	32863738	32865641	A01p43100.2_BraZ1	873.62	+	717	1903	1903	1.0000000
A01	32866437	32866719	A01p43110.2_BraZ1	171	-	14	83	282	0.2943262
A01	32867122	32867329	A01p43120.2_BraZ1	20.7	-	192	207	207	1.0000000
A01	32873427	32875096	A01p43130.2_BraZ1	916.875	-	886	1470	1669	0.8807669
A01	32894977	32895130	A01p43140.2_BraZ1	14.7	+	298	153	153	1.0000000
A01	32901838	32905841	A01p43150.2_BraZ1	2105.4	+	2349	4003	4003	1.0000000
A01	32906531	32908565	A01p43160.2_BraZ1	203.4	+	560	1979	2034	0.9729597
A01	32915054	32918005	A01p43170.2_BraZ1	1624.3	+	1794	2951	2951	1.0000000
A01	32922137	32922296	A01p43180.2_BraZ1	15.9	+	0	0	159	0.0000000
A01	32928540	32933259	A01p43190.2_BraZ1	1657.7	+	2179	3620	4719	0.7671117
A01	32938807	32940944	A01p43200.2_BraZ1	2976	+	654	2058	2137	0.9630323
A01	32940911	32941532	A01p43210.2_BraZ1	784	+	223	621	621	1.0000000
A01	32945351	32945882	A01p43220.2_BraZ1	87.3	+	1	72	531	0.1355932
A01	32950063	32950654	A01p43230.2_BraZ1	4758.75	+	370	591	591	1.0000000
A01	32951087	32957335	A01p43240.2_BraZ1	5826.72	-	1098	5301	6248	0.8484315
A01	32960148	32960490	A01p43250.2_BraZ1	285	-	632	342	342	1.0000000
A01	32966386	32967167	A01p43260.2_BraZ1	693	+	21	335	781	0.4289373
A01	32971930	32973639	A01p43270.2_BraZ1	1098	+	1005	1677	1709	0.9812756
A01	32974827	32976229	A01p43280.2_BraZ1	1056.52	-	326	1220	1402	0.8701854
A01	32985153	32989480	A01p43290.2_BraZ1	1908.11	+	1835	4061	4327	0.9385256
A01	32991076	32992387	A01p43300.2_BraZ1	567	+	631	1251	1311	0.9542334
A01	32993413	32994135	A01p43310.2_BraZ1	479.217	-	700	722	722	1.0000000
A01	32995453	32995911	A01p43320.2_BraZ1	306	+	300	458	458	1.0000000
A01	33001620	33002548	A01p43330.2_BraZ1	92.1	+	810	928	928	1.0000000
A01	33003807	33010413	A01p43340.2_BraZ1	1025.07	+	5457	6502	6606	0.9842567
A01	33006878	33007845	A01p43350.2_BraZ1	93.9	+	1124	967	967	1.0000000
A01	33010598	33017499	A01p43360.2_BraZ1	1911.68	-	5165	6821	6901	0.9884075
A01	33018718	33018853	A01p43370.2_BraZ1	13.5	+	259	135	135	1.0000000
A01	33018988	33019948	A01p43380.2_BraZ1	11997	-	848	960	960	1.0000000
A01	33021529	33023757	A01p43390.2_BraZ1	1896.3	+	572	2172	2228	0.9748654
A01	33024319	33026647	A01p43400.2_BraZ1	232.8	+	606	2251	2328	0.9669244
A01	33027918	33028275	A01p43410.2_BraZ1	35.7	+	0	0	357	0.0000000
A01	33030365	33031682	A01p43420.2_BraZ1	744.911	-	255	1128	1317	0.8564920
A01	33033911	33038009	A01p43430.2_BraZ1	1143.43	-	1675	4029	4098	0.9831625
A01	33047483	33049320	A01p43440.2_BraZ1	1049.8	+	386	1671	1837	0.9096352
A01	33050187	33054291	A01p43450.2_BraZ1	2400.75	+	1397	3813	4104	0.9290935
A01	33061692	33062742	A01p43460.2_BraZ1	105	+	186	908	1050	0.8647619
A01	33071371	33071602	A01p43470.2_BraZ1	23.1	-	629	231	231	1.0000000
A01	33071707	33072330	A01p43480.2_BraZ1	240	-	1688	623	623	1.0000000
A01	33072712	33073070	A01p43490.2_BraZ1	53.1429	-	389	358	358	1.0000000
A01	33075951	33082979	A01p43500.2_BraZ1	1078.29	-	2648	4219	7028	0.6003130
A01	33078230	33078713	A01p43510.2_BraZ1	48.3	+	186	154	483	0.3188406
A01	33085390	33086235	A01p43520.2_BraZ1	228	+	39	558	845	0.6603550
A01	33086235	33087546	A01p43530.2_BraZ1	1284	+	632	753	1311	0.5743707
A01	33092822	33095327	A01p43540.2_BraZ1	69.3	-	1839	2478	2505	0.9892216
A01	33093791	33094859	A01p43550.2_BraZ1	729	-	675	1068	1068	1.0000000
A01	33095666	33097983	A01p43560.2_BraZ1	1268.35	+	406	1786	2317	0.7708243
A01	33100561	33102374	A01p43570.2_BraZ1	1139.57	+	466	1754	1813	0.9674572
A01	33103091	33103793	A01p43580.2_BraZ1	330	+	500	702	702	1.0000000
A01	33116567	33117845	A01p43590.2_BraZ1	1074	+	133	965	1278	0.7550861
A01	33120393	33122640	A01p43600.2_BraZ1	224.7	-	790	2247	2247	1.0000000
A01	33128715	33129498	A01p43610.2_BraZ1	78.3	-	11	292	783	0.3729247
A01	33131180	33131423	A01p43620.2_BraZ1	231	-	364	243	243	1.0000000
A01	33132665	33133844	A01p43630.2_BraZ1	117.9	-	901	1113	1179	0.9440203
A01	33141079	33143535	A01p43640.2_BraZ1	1399.05	-	677	2051	2456	0.8350977
A01	33147367	33147558	A01p43650.2_BraZ1	17.4	+	84	191	191	1.0000000
A01	33152889	33159129	A01p43660.2_BraZ1	1489.24	+	561	4033	6240	0.6463141
A01	33153989	33155153	A01p43670.2_BraZ1	334.286	-	34	396	1164	0.3402062
A01	33155153	33155371	A01p43680.2_BraZ1	120	+	0	0	218	0.0000000
A01	33161280	33163071	A01p43690.2_BraZ1	179.1	-	1477	1791	1791	1.0000000
A01	33163890	33168206	A01p43700.2_BraZ1	2371.76	-	1288	4020	4316	0.9314180
A01	33180175	33183061	A01p43710.2_BraZ1	1355.75	+	674	1850	2886	0.6410257
A01	33183178	33183607	A01p43720.2_BraZ1	16.125	+	108	211	429	0.4918415
A01	33184630	33185257	A01p43730.2_BraZ1	62.7	+	70	398	627	0.6347687
A01	33186230	33186857	A01p43740.2_BraZ1	62.7	+	185	597	627	0.9521531
A01	33188608	33189253	A01p43750.2_BraZ1	64.5	+	342	645	645	1.0000000
A01	33191419	33194300	A01p43760.2_BraZ1	1930.52	-	672	2528	2881	0.8774731
A01	33196383	33196554	A01p43770.2_BraZ1	17.1	-	33	107	171	0.6257310
A01	33201135	33203414	A01p43780.2_BraZ1	2196	+	714	2255	2279	0.9894691
A01	33204236	33208843	A01p43790.2_BraZ1	447	-	611	3535	4607	0.7673106
A01	33207512	33208533	A01p43800.2_BraZ1	250	-	209	925	1021	0.9059745
A01	33215054	33219019	A01p43810.2_BraZ1	1955.86	-	1452	3953	3965	0.9969735
A01	33224338	33226618	A01p43820.2_BraZ1	7709.02	-	1140	2201	2280	0.9653509
A01	33228525	33229083	A01p43830.2_BraZ1	55.8	-	134	445	558	0.7974910
A01	33235580	33236135	A01p43840.2_BraZ1	55.5	-	387	555	555	1.0000000
A01	33238064	33238625	A01p43850.2_BraZ1	56.1	-	63	360	561	0.6417112
A01	33241697	33242174	A01p43860.2_BraZ1	258	+	2	19	477	0.0398323
A01	33243027	33245471	A01p43870.2_BraZ1	1727.06	+	369	1019	2444	0.4169394
A01	33247768	33252954	A01p43880.2_BraZ1	530.2	+	3586	5001	5186	0.9643270
A01	33256363	33257800	A01p43890.2_BraZ1	1086	-	253	1274	1437	0.8865693
A01	33259456	33261634	A01p43900.2_BraZ1	827.67	-	428	2138	2178	0.9816345
A01	33286165	33287275	A01p43910.2_BraZ1	654	+	3950	1110	1110	1.0000000
A01	33288168	33289787	A01p43920.2_BraZ1	18375	-	88	928	1619	0.5731933
A01	33301016	33301544	A01p43930.2_BraZ1	330	+	1896	528	528	1.0000000
A01	33301591	33306433	A01p43940.2_BraZ1	445.714	+	8487	4842	4842	1.0000000
A01	33302147	33302456	A01p43950.2_BraZ1	30.9	-	911	309	309	1.0000000
A01	33307568	33307910	A01p43960.2_BraZ1	240	+	527	342	342	1.0000000
A01	33308408	33309009	A01p43970.2_BraZ1	1130.4	-	347	601	601	1.0000000
A01	33309097	33309623	A01p43980.2_BraZ1	327	-	177	484	526	0.9201521
A01	33310334	33310518	A01p43990.2_BraZ1	111	-	119	184	184	1.0000000
A01	33312306	33314169	A01p44000.2_BraZ1	777.333	+	1430	1824	1863	0.9790660
A01	33316928	33318216	A01p44010.2_BraZ1	756	-	198	728	1288	0.5652174
A01	33319703	33325328	A01p44020.2_BraZ1	2637.48	+	1520	4327	5625	0.7692444
A01	33326820	33327009	A01p44030.2_BraZ1	18.9	-	32	156	189	0.8253968
A01	33327045	33329915	A01p44040.2_BraZ1	74.4	+	1688	2593	2870	0.9034843
A01	33332431	33332981	A01p44050.2_BraZ1	453	+	182	550	550	1.0000000
A01	33333015	33333490	A01p44060.2_BraZ1	171	+	490	475	475	1.0000000
A01	33334562	33337499	A01p44070.2_BraZ1	1556.25	+	675	2790	2937	0.9499489
A01	33338415	33339577	A01p44080.2_BraZ1	866.7	-	642	1162	1162	1.0000000
A01	33341113	33341365	A01p44090.2_BraZ1	25.2	+	237	252	252	1.0000000
A01	33342316	33342744	A01p44100.2_BraZ1	48.6	-	139	393	428	0.9182243
A01	33343198	33343375	A01p44110.2_BraZ1	17.7	-	77	147	177	0.8305085
A01	33343503	33343608	A01p44120.2_BraZ1	10.5	-	122	105	105	1.0000000
A01	33345746	33346019	A01p44130.2_BraZ1	27.3	-	354	273	273	1.0000000
A01	33347972	33348346	A01p44140.2_BraZ1	186	-	254	374	374	1.0000000
A01	33696710	33700211	A01p44150.2_BraZ1	225	-	3655	3501	3501	1.0000000
A01	33709743	33711610	A01p44160.2_BraZ1	916.831	+	770	1594	1867	0.8537761
A01	33712664	33712793	A01p44170.2_BraZ1	10.2	+	38	129	129	1.0000000
A01	33713826	33715188	A01p44180.2_BraZ1	372	+	941	1362	1362	1.0000000
A01	33716229	33718570	A01p44190.2_BraZ1	1656	-	430	1519	2341	0.6488680
A01	33721858	33723865	A01p44200.2_BraZ1	1665	+	177	1687	2007	0.8405581
A01	33724735	33726022	A01p44210.2_BraZ1	1200	+	1242	1287	1287	1.0000000
A01	33727847	33729992	A01p44220.2_BraZ1	1126.91	-	1666	2142	2145	0.9986014
A01	33733654	33734134	A01p44230.2_BraZ1	48	+	233	480	480	1.0000000
A01	33737355	33741332	A01p44240.2_BraZ1	1136.89	+	2823	3977	3977	1.0000000
A01	33741821	33743566	A01p44250.2_BraZ1	1074.98	+	827	1467	1745	0.8406877
A01	33746313	33749389	A01p44260.2_BraZ1	2185.62	+	2407	2987	3076	0.9710663
A01	33751659	33753361	A01p44270.2_BraZ1	941.2	-	455	1537	1702	0.9030553
A01	33754744	33757646	A01p44280.2_BraZ1	1012.7	+	2752	2902	2902	1.0000000
A01	33758213	33761258	A01p44290.2_BraZ1	2046	+	2157	3045	3045	1.0000000
A01	33761548	33763121	A01p44300.2_BraZ1	679.429	-	1064	1573	1573	1.0000000
A01	33763593	33766729	A01p44310.2_BraZ1	1129.88	+	1572	3088	3136	0.9846939
A01	33767485	33767899	A01p44320.2_BraZ1	41.4	+	331	414	414	1.0000000
A01	33772098	33774760	A01p44330.2_BraZ1	1063.64	+	1755	2435	2662	0.9147258
A01	33775064	33776259	A01p44340.2_BraZ1	118.5	+	223	1090	1195	0.9121339
A01	33776774	33778166	A01p44350.2_BraZ1	139.2	+	70	355	1392	0.2550287
A01	33781354	33782096	A01p44360.2_BraZ1	564	+	288	742	742	1.0000000
A01	33783607	33784553	A01p44370.2_BraZ1	2352	+	628	946	946	1.0000000
A01	33785516	33796414	A01p44380.2_BraZ1	4733.24	+	2932	9850	10898	0.9038356
A01	33791412	33792035	A01p44390.2_BraZ1	552	+	618	623	623	1.0000000
A01	33796746	33802411	A01p44400.2_BraZ1	2604.83	-	2816	5494	5665	0.9698147
A01	33803448	33808926	A01p44410.2_BraZ1	2431.61	-	2220	5306	5478	0.9686017
A01	33812395	33814262	A01p44420.2_BraZ1	1258.6	+	946	1867	1867	1.0000000
A01	33815024	33817109	A01p44430.2_BraZ1	1992	+	814	2085	2085	1.0000000
A01	33817343	33818591	A01p44440.2_BraZ1	124.8	-	319	1139	1248	0.9126602
A01	33820755	33822513	A01p44450.2_BraZ1	5838	+	499	1354	1758	0.7701934
A01	33823261	33825810	A01p44460.2_BraZ1	4620	+	165	1706	2549	0.6692821
A01	33826699	33833880	A01p44470.2_BraZ1	4477.38	-	1807	6746	7181	0.9394235
A01	33838384	33838651	A01p44480.2_BraZ1	26.7	-	212	267	267	1.0000000
A01	33838919	33839465	A01p44490.2_BraZ1	54.6	+	156	546	546	1.0000000
A01	33840492	33843158	A01p44500.2_BraZ1	1580.62	+	1261	2587	2666	0.9703676
A01	33844028	33845471	A01p44510.2_BraZ1	639.722	-	215	640	1443	0.4435205
A01	33847574	33848816	A01p44520.2_BraZ1	392	-	0	0	1242	0.0000000
A01	33857914	33858294	A01p44530.2_BraZ1	84	+	0	0	380	0.0000000
A01	33858480	33859789	A01p44540.2_BraZ1	488.75	+	0	0	1309	0.0000000
A01	33864520	33865671	A01p44550.2_BraZ1	978	+	118	958	1151	0.8323197
A01	33872300	33873909	A01p44560.2_BraZ1	903	-	254	1055	1609	0.6556867
A01	33888394	33889219	A01p44570.2_BraZ1	51.9	-	64	405	825	0.4909091
A01	33891042	33893756	A01p44580.2_BraZ1	1332.8	-	350	1503	2714	0.5537952
A01	33898851	33899049	A01p44590.2_BraZ1	19.8	-	78	198	198	1.0000000
A01	33905635	33906674	A01p44600.2_BraZ1	753	-	391	1039	1039	1.0000000
A01	33911524	33911938	A01p44610.2_BraZ1	41.4	-	310	414	414	1.0000000
A01	33914120	33919880	A01p44620.2_BraZ1	4385.69	-	1801	5081	5760	0.8821180
A01	33920729	33921523	A01p44630.2_BraZ1	510	-	131	739	794	0.9307305
A01	33924568	33925177	A01p44640.2_BraZ1	60.9	+	194	609	609	1.0000000
A01	33934666	33935068	A01p44650.2_BraZ1	40.2	+	77	402	402	1.0000000
A01	33944527	33946093	A01p44660.2_BraZ1	667.435	+	900	1419	1566	0.9061303
A01	33946380	33946692	A01p44670.2_BraZ1	31.2	+	139	312	312	1.0000000
A01	33946785	33948031	A01p44680.2_BraZ1	256	-	554	1001	1246	0.8033708
A01	33949610	33951765	A01p44690.2_BraZ1	1297.49	+	457	1939	2155	0.8997680
A01	33952255	33953995	A01p44700.2_BraZ1	607.6	-	1950	1740	1740	1.0000000
A01	33955351	33956604	A01p44710.2_BraZ1	616.875	+	20	157	1253	0.1252993
A01	33959178	33965916	A01p44720.2_BraZ1	885	+	2363	5731	6738	0.8505491
A01	33959623	33960091	A01p44730.2_BraZ1	46.8	-	272	468	468	1.0000000
A01	33960192	33960981	A01p44740.2_BraZ1	384	+	656	789	789	1.0000000
A01	33961740	33962161	A01p44750.2_BraZ1	234	+	102	421	421	1.0000000
A01	33962218	33962908	A01p44760.2_BraZ1	261.375	+	395	690	690	1.0000000
A01	34090767	34092112	A01p44770.2_BraZ1	936	+	1	29	1345	0.0215613
A01	34093231	34095374	A01p44780.2_BraZ1	16020	-	109	1129	2143	0.5268316
A01	34101873	34104096	A01p44790.2_BraZ1	1719	+	263	1260	2223	0.5668016
A01	34106539	34113424	A01p44800.2_BraZ1	1655.8	+	4441	6229	6885	0.9047204
A01	34107740	34107924	A01p44810.2_BraZ1	144	+	428	184	184	1.0000000
A01	34117129	34117909	A01p44820.2_BraZ1	78	-	69	510	780	0.6538461
A01	34119569	34122412	A01p44830.2_BraZ1	1765.24	-	889	2535	2843	0.8916637
A01	34123972	34124443	A01p44840.2_BraZ1	47.1	-	91	379	471	0.8046709
A01	34127444	34129003	A01p44850.2_BraZ1	1137.24	+	248	1344	1559	0.8620911
A01	34130534	34131656	A01p44860.2_BraZ1	112.2	+	273	883	1122	0.7869875
A01	34132298	34133463	A01p44870.2_BraZ1	635.243	-	544	1165	1165	1.0000000
A01	34135579	34147406	A01p44880.2_BraZ1	4000.94	+	2542	8291	11827	0.7010231
A01	34149512	34151043	A01p44890.2_BraZ1	147.3	-	145	747	1531	0.4879164
A01	34154986	34157784	A01p44900.2_BraZ1	1782.31	+	1893	2697	2798	0.9639028
A01	34158295	34160112	A01p44910.2_BraZ1	468	+	768	1722	1817	0.9477160
A01	34161011	34161545	A01p44920.2_BraZ1	53.4	-	353	534	534	1.0000000
A01	34163227	34164238	A01p44930.2_BraZ1	783	+	190	913	1011	0.9030663
A01	34165790	34168566	A01p44940.2_BraZ1	853.882	+	986	2455	2776	0.8843660
A01	34168684	34169686	A01p44950.2_BraZ1	12390	+	524	980	1002	0.9780439
A01	34169914	34171677	A01p44960.2_BraZ1	843.9	-	1436	1763	1763	1.0000000
A01	34175627	34175984	A01p44970.2_BraZ1	35.7	+	123	357	357	1.0000000
A01	34279545	34280157	A01p44980.2_BraZ1	61.2	+	71	602	612	0.9836601
A01	34282564	34283254	A01p44990.2_BraZ1	58.2	+	307	672	690	0.9739130
A01	34285171	34285654	A01p45000.2_BraZ1	48.3	-	1070	483	483	1.0000000
A01	34287176	34287659	A01p45010.2_BraZ1	48.3	-	450	483	483	1.0000000
A01	34289244	34289721	A01p45020.2_BraZ1	47.7	-	994	477	477	1.0000000
A01	34290928	34291411	A01p45030.2_BraZ1	48.3	-	153	483	483	1.0000000
A01	34295813	34296524	A01p45040.2_BraZ1	71.1	+	377	695	711	0.9774965
A01	34297243	34298331	A01p45050.2_BraZ1	593.963	-	451	1088	1088	1.0000000
A01	34301636	34301810	A01p45060.2_BraZ1	17.4	+	40	160	174	0.9195402
A01	34303749	34304262	A01p45070.2_BraZ1	51.3	+	70	431	513	0.8401560
A01	34304804	34308295	A01p45080.2_BraZ1	820.244	-	719	3064	3491	0.8776855
A01	34314506	34314749	A01p45090.2_BraZ1	189	-	523	243	243	1.0000000
A01	34316296	34318724	A01p45100.2_BraZ1	243	-	1415	2428	2428	1.0000000
A01	34320301	34320796	A01p45110.2_BraZ1	49.5	-	58	338	495	0.6828283
A01	34322797	34323629	A01p45120.2_BraZ1	466.364	+	429	774	832	0.9302884
A01	34324320	34324473	A01p45130.2_BraZ1	14.4	-	314	153	153	1.0000000
A01	34324808	34325285	A01p45140.2_BraZ1	47.1	-	63	409	477	0.8574423
A01	34329209	34329419	A01p45150.2_BraZ1	21	+	108	210	210	1.0000000
A01	34331541	34336080	A01p45160.2_BraZ1	2849.42	+	1990	4323	4539	0.9524124
A01	34336811	34337822	A01p45170.2_BraZ1	964.8	+	402	1011	1011	1.0000000
A01	34338397	34340317	A01p45180.2_BraZ1	967.024	-	702	1892	1920	0.9854167
A01	34341816	34354103	A01p45190.2_BraZ1	1730.11	+	1336	7375	12287	0.6002279
A01	34349290	34349648	A01p45200.2_BraZ1	222	-	3	86	358	0.2402235
A01	34354561	34357016	A01p45210.2_BraZ1	897.812	+	1759	2207	2455	0.8989817
A01	34369583	34372529	A01p45220.2_BraZ1	1548	+	1654	2942	2946	0.9986422
A01	34373063	34376229	A01p45230.2_BraZ1	911.58	-	2245	3166	3166	1.0000000
A01	34377074	34378487	A01p45240.2_BraZ1	669	+	1188	1401	1413	0.9915074
A01	34380898	34382065	A01p45250.2_BraZ1	978	+	89	590	1167	0.5055698
A01	34383676	34384165	A01p45260.2_BraZ1	48.9	-	738	489	489	1.0000000
A01	34387576	34387843	A01p45270.2_BraZ1	26.7	-	2	111	267	0.4157303
A01	34393308	34395322	A01p45280.2_BraZ1	792.167	+	265	1687	2014	0.8376365
A01	34703073	34704945	A01p45290.2_BraZ1	7371	+	692	1623	1872	0.8669872
A01	34707029	34708170	A01p45300.2_BraZ1	525	+	202	943	1141	0.8264680
A01	34707428	34708058	A01p45310.2_BraZ1	50.4	+	95	518	630	0.8222222
A01	34715487	34716714	A01p45320.2_BraZ1	593.85	+	52	948	1227	0.7726161
A01	34719598	34719910	A01p45330.2_BraZ1	31.2	-	130	312	312	1.0000000
A01	34721035	34721369	A01p45340.2_BraZ1	243	-	63	296	334	0.8862275
A01	34726141	34726366	A01p45350.2_BraZ1	171	+	15	162	225	0.7200000
A01	34726640	34728834	A01p45360.2_BraZ1	1537	-	103	981	2194	0.4471285
A01	34735240	34735828	A01p45370.2_BraZ1	58.8	+	72	407	588	0.6921769
A01	34736142	34741752	A01p45380.2_BraZ1	490.769	-	491	3247	5610	0.5787879
A01	34744363	34749558	A01p45390.2_BraZ1	1404	-	451	2358	5195	0.4538980
A01	34750380	34752960	A01p45400.2_BraZ1	1022.88	-	154	1082	2580	0.4193798
A01	34754070	34766525	A01p45410.2_BraZ1	5606.46	+	1098	7268	12455	0.5835407
A01	34767808	34769361	A01p45420.2_BraZ1	10018.7	+	863	1553	1553	1.0000000
A01	34769790	34770930	A01p45430.2_BraZ1	5929.5	-	162	1061	1140	0.9307017
A01	34777322	34778524	A01p45440.2_BraZ1	561.167	-	482	1202	1202	1.0000000
A01	34779931	34783243	A01p45450.2_BraZ1	1211.78	-	1455	2984	3312	0.9009662
A01	34785061	34794303	A01p45460.2_BraZ1	3244.77	+	4856	8999	9242	0.9737070
A01	34794340	34795939	A01p45470.2_BraZ1	1285.75	+	1126	1547	1599	0.9674796
A01	34799061	34800759	A01p45480.2_BraZ1	1344	+	729	1657	1698	0.9758539
A01	34800984	34804564	A01p45490.2_BraZ1	1334.28	-	981	3065	3580	0.8561453
A01	34806192	34807367	A01p45500.2_BraZ1	360.077	+	906	1175	1175	1.0000000
A01	34808027	34808630	A01p45510.2_BraZ1	60.3	+	233	603	603	1.0000000
A01	34808839	34812595	A01p45520.2_BraZ1	1948.8	-	914	3256	3756	0.8668796
A01	34817126	34818157	A01p45530.2_BraZ1	523.6	+	276	744	1031	0.7216295
A01	34818411	34819280	A01p45540.2_BraZ1	585	-	166	776	869	0.8929805
A01	34821150	34823003	A01p45550.2_BraZ1	577.944	+	516	1823	1853	0.9838101
A01	34823760	34826774	A01p45560.2_BraZ1	1381.5	+	1424	3002	3014	0.9960186
A01	34830405	34832241	A01p45570.2_BraZ1	1392	-	523	1199	1836	0.6530501
A01	34835834	34836557	A01p45580.2_BraZ1	72.3	-	392	723	723	1.0000000
A01	34889449	34891801	A01p45590.2_BraZ1	1420.39	+	754	1442	2352	0.6130952
A01	34897090	34901239	A01p45600.2_BraZ1	882	+	2132	3266	4149	0.7871776
A01	34901994	34902480	A01p45610.2_BraZ1	48.6	-	193	486	486	1.0000000
A01	34903128	34904932	A01p45620.2_BraZ1	789.067	-	472	1686	1804	0.9345898
A01	34910486	34910837	A01p45630.2_BraZ1	35.1	-	9	252	351	0.7179487
A01	34916583	34919486	A01p45640.2_BraZ1	981.287	+	4	151	2903	0.0520152
A01	34922727	34923012	A01p45650.2_BraZ1	30.8824	+	17	282	285	0.9894737
A01	34930444	34930636	A01p45660.2_BraZ1	19.2	+	207	192	192	1.0000000
A01	34934873	34935361	A01p45670.2_BraZ1	186	+	0	0	488	0.0000000
A01	34948880	34950621	A01p45680.2_BraZ1	7552.5	+	1078	1678	1741	0.9638139
A01	34955406	34957659	A01p45690.2_BraZ1	320.87	-	770	2000	2253	0.8877053
A01	34963402	34963525	A01p45700.2_BraZ1	12.3	+	147	123	123	1.0000000
A01	34965000	34968450	A01p45710.2_BraZ1	642.727	+	1039	3215	3450	0.9318841
A01	34971590	34972212	A01p45720.2_BraZ1	240	+	218	622	622	1.0000000
A01	34975749	34978033	A01p45730.2_BraZ1	1258.6	+	863	2182	2284	0.9553415
A01	34978442	34980043	A01p45740.2_BraZ1	1527.41	-	942	1489	1601	0.9300437
A01	34983346	34983829	A01p45750.2_BraZ1	48.3	+	89	475	483	0.9834369
A01	34986961	34988657	A01p45760.2_BraZ1	1509	-	12	484	1696	0.2853774
A01	34989995	34992162	A01p45770.2_BraZ1	1420.71	-	269	1892	2167	0.8730965
A01	34998552	34999793	A01p45780.2_BraZ1	1143	+	280	1176	1241	0.9476229
A01	35180423	35182509	A01p45790.2_BraZ1	3685.2	-	539	1826	2086	0.8753595
A01	35183986	35187158	A01p45800.2_BraZ1	1005	+	1123	2867	3172	0.9038461
A01	35189439	35191635	A01p45810.2_BraZ1	1325.45	+	507	1892	2196	0.8615665
A01	35193049	35194011	A01p45820.2_BraZ1	780	+	230	962	962	1.0000000
A01	35196367	35200255	A01p45830.2_BraZ1	3645	-	157	1676	3888	0.4310700
A01	35201361	35202377	A01p45840.2_BraZ1	372.794	-	68	649	1016	0.6387795
A01	35204586	35206474	A01p45850.2_BraZ1	747.87	+	1728	1888	1888	1.0000000
A01	35207393	35209379	A01p45860.2_BraZ1	658.875	+	907	1767	1986	0.8897281
A01	35211220	35213676	A01p45870.2_BraZ1	12707.5	-	475	1913	2456	0.7789088
A01	35217687	35218769	A01p45880.2_BraZ1	295.833	-	225	782	1082	0.7227357
A01	35220467	35222509	A01p45890.2_BraZ1	1050	+	441	1744	2042	0.8540646
A01	35224569	35232784	A01p45900.2_BraZ1	4730.92	+	962	6071	8215	0.7390140
A01	35234423	35235323	A01p45910.2_BraZ1	90	+	1029	893	900	0.9922222
A01	35237982	35238496	A01p45920.2_BraZ1	249	-	508	514	514	1.0000000
A01	35246571	35249419	A01p45930.2_BraZ1	1344	-	681	2682	2848	0.9417135
A01	35250222	35253630	A01p45940.2_BraZ1	9966	-	523	2778	3408	0.8151408
A01	35259571	35270088	A01p45950.2_BraZ1	279.9	-	1313	8069	10517	0.7672340
A01	35272574	35273621	A01p45960.2_BraZ1	333	-	70	567	1047	0.5415473
A01	35274172	35276820	A01p45970.2_BraZ1	2331	-	122	1206	2648	0.4554381
A01	35281607	35290098	A01p45980.2_BraZ1	2985	-	726	5714	8491	0.6729478
A01	35282758	35284107	A01p45990.2_BraZ1	219.429	-	62	904	1349	0.6701260
A01	35290730	35291494	A01p46000.2_BraZ1	609	+	9	294	764	0.3848168
A01	35291494	35292739	A01p46010.2_BraZ1	1068	+	20	598	1245	0.4803213
A01	35295736	35305939	A01p46020.2_BraZ1	114.27	-	679	4058	10203	0.3977261
A01	35299010	35301521	A01p46030.2_BraZ1	251.1	-	63	874	2511	0.3480685
A01	35304750	35306955	A01p46040.2_BraZ1	974.391	-	117	1567	2205	0.7106576
A01	35307078	35307863	A01p46050.2_BraZ1	144.972	-	256	785	785	1.0000000
A01	35308649	35312093	A01p46060.2_BraZ1	1932.35	-	806	2829	3444	0.8214286
A01	35313682	35314418	A01p46070.2_BraZ1	1218.75	+	2	89	736	0.1209239
A01	35317139	35317295	A01p46080.2_BraZ1	15.6	+	309	156	156	1.0000000
A01	35319996	35320311	A01p46090.2_BraZ1	31.5	-	1	128	315	0.4063492
A01	35372843	35374141	A01p46100.2_BraZ1	405	+	605	917	1298	0.7064715
A01	35382373	35383220	A01p46110.2_BraZ1	357	-	166	705	847	0.8323495
A01	35390682	35390973	A01p46120.2_BraZ1	29.1	+	282	291	291	1.0000000
A01	35392095	35392698	A01p46130.2_BraZ1	392.308	-	524	603	603	1.0000000
A01	35394428	35395665	A01p46140.2_BraZ1	671.942	-	913	1237	1237	1.0000000
A01	35397124	35398297	A01p46150.2_BraZ1	675	+	630	1062	1173	0.9053708
A01	35400628	35401180	A01p46160.2_BraZ1	55.2	+	27	266	552	0.4818841
A01	35404868	35406829	A01p46170.2_BraZ1	1172.36	+	443	1245	1961	0.6348802
A01	35412066	35413140	A01p46180.2_BraZ1	761.75	+	180	785	1074	0.7309124
A01	35413949	35414389	A01p46190.2_BraZ1	219	-	314	427	440	0.9704546
A01	35415350	35417622	A01p46200.2_BraZ1	1521.9	+	646	1378	2272	0.6065141
A01	35417994	35419974	A01p46210.2_BraZ1	1902	-	492	1810	1980	0.9141414
A01	35421397	35422454	A01p46220.2_BraZ1	564.3	-	743	1057	1057	1.0000000
A01	35423920	35425343	A01p46230.2_BraZ1	763.077	+	815	1381	1423	0.9704849
A01	35426921	35427899	A01p46240.2_BraZ1	97.8	-	418	978	978	1.0000000
A01	35428990	35429709	A01p46250.2_BraZ1	685	-	169	719	719	1.0000000
A01	35433820	35437665	A01p46260.2_BraZ1	1525.32	+	3360	3804	3845	0.9893368
A01	35439192	35442646	A01p46270.2_BraZ1	3907.27	+	1050	3046	3454	0.8818761
A01	35443928	35446359	A01p46280.2_BraZ1	1680	-	723	1954	2431	0.8037844
A01	35447355	35447577	A01p46290.2_BraZ1	22.2	-	196	222	222	1.0000000
A01	35448279	35448429	A01p46300.2_BraZ1	15	+	216	150	150	1.0000000
A01	35449592	35452198	A01p46310.2_BraZ1	1719	+	1874	2606	2606	1.0000000
A01	35454624	35454831	A01p46320.2_BraZ1	20.7	+	3	34	207	0.1642512
A01	35458189	35466799	A01p46330.2_BraZ1	5686.5	-	1725	5783	8610	0.6716608
A01	35469063	35473161	A01p46340.2_BraZ1	2525.46	+	1566	4005	4098	0.9773060
A01	35473664	35475775	A01p46350.2_BraZ1	459	-	342	1390	2111	0.6584557
A01	35477036	35478479	A01p46360.2_BraZ1	144.3	+	244	1441	1443	0.9986140
A01	35479057	35480076	A01p46370.2_BraZ1	2242.5	-	727	1019	1019	1.0000000
A01	35484638	35485877	A01p46380.2_BraZ1	123.9	-	648	1235	1239	0.9967716
A01	35488071	35488415	A01p46390.2_BraZ1	270	-	475	344	344	1.0000000
A01	35491757	35494947	A01p46400.2_BraZ1	1622.9	-	224	1778	3190	0.5573668
A01	35497487	35503783	A01p46410.2_BraZ1	131.76	+	3245	6076	6296	0.9650572
A01	35499447	35499938	A01p46420.2_BraZ1	357	+	350	491	491	1.0000000
A01	35501468	35502428	A01p46430.2_BraZ1	621	+	780	960	960	1.0000000
A01	35506809	35507473	A01p46440.2_BraZ1	342	-	991	664	664	1.0000000
A01	35509547	35519384	A01p46450.2_BraZ1	1761	+	10133	6263	9837	0.6366779
A01	35520773	35525177	A01p46460.2_BraZ1	2163.81	-	458	1819	4404	0.4130336
A01	35527746	35532516	A01p46470.2_BraZ1	2361.6	+	3741	4598	4770	0.9639413
A01	35533451	35596007	A01p46480.2_BraZ1	2441.65	-	19002	49270	62556	0.7876143
A01	35602303	35602684	A01p46490.2_BraZ1	38.1	+	11	62	381	0.1627297
A01	35604820	35606137	A01p46500.2_BraZ1	519.353	+	1415	1317	1317	1.0000000
A01	35606840	35609943	A01p46510.2_BraZ1	2347.83	-	1624	3013	3103	0.9709958
A01	35611379	35613673	A01p46520.2_BraZ1	1558.98	-	877	1857	2294	0.8095031
A01	35614749	35616801	A01p46530.2_BraZ1	771.368	-	1268	2052	2052	1.0000000
A01	35618169	35620003	A01p46540.2_BraZ1	1332.63	-	563	1834	1834	1.0000000
A01	35622949	35624104	A01p46550.2_BraZ1	115.5	-	204	742	1155	0.6424242
A01	35627434	35629254	A01p46560.2_BraZ1	642	-	680	1568	1820	0.8615385
A01	35629914	35632285	A01p46570.2_BraZ1	850.397	-	706	1543	2371	0.6507803
A01	35634011	35639004	A01p46580.2_BraZ1	1443	+	3323	4955	4993	0.9923893
A01	35640424	35641684	A01p46590.2_BraZ1	126	+	428	1189	1260	0.9436508
A01	35643400	35655113	A01p46600.2_BraZ1	3588.23	+	2949	9595	11713	0.8191753
A01	35655826	35659055	A01p46610.2_BraZ1	1837.66	-	1923	3040	3229	0.9414679
A01	35660306	35661571	A01p46620.2_BraZ1	696.8	-	657	1261	1265	0.9968380
A01	35662263	35664374	A01p46630.2_BraZ1	1164.97	-	1290	2080	2111	0.9853150
A01	35665941	35667330	A01p46640.2_BraZ1	612.818	-	411	1224	1389	0.8812095
A01	35671559	35676625	A01p46650.2_BraZ1	21984.2	+	1688	4765	5066	0.9405843
A01	35678366	35680132	A01p46660.2_BraZ1	1052.74	+	1435	1766	1766	1.0000000
A01	35692262	35693461	A01p46670.2_BraZ1	456	+	1379	1199	1199	1.0000000
A01	35694764	35694994	A01p46680.2_BraZ1	210	-	25	209	230	0.9086956
A01	35695231	35695736	A01p46690.2_BraZ1	489	-	2	106	505	0.2099010
A01	35697188	35698414	A01p46700.2_BraZ1	456	+	462	1217	1226	0.9926590
A01	35699381	35700963	A01p46710.2_BraZ1	282.889	-	2186	1582	1582	1.0000000
A01	35701568	35701891	A01p46720.2_BraZ1	237	+	438	323	323	1.0000000
A01	35706518	35706832	A01p46730.2_BraZ1	222	+	816	314	314	1.0000000
A01	35712766	35713438	A01p46740.2_BraZ1	434.526	-	46	577	672	0.8586310
A01	35717381	35721383	A01p46750.2_BraZ1	1857.21	+	1487	3806	4002	0.9510245
A01	35721580	35722129	A01p46760.2_BraZ1	291	+	311	549	549	1.0000000
A01	35725543	35731245	A01p46770.2_BraZ1	498	-	496	2234	5702	0.3917924
A01	35743079	35743820	A01p46780.2_BraZ1	74.1	+	131	665	741	0.8974359
A01	35745367	35747955	A01p46790.2_BraZ1	5374.29	+	2694	2588	2588	1.0000000
A01	35748969	35752165	A01p46800.2_BraZ1	1982.5	+	1309	2980	3196	0.9324155
A01	35752510	35753185	A01p46810.2_BraZ1	18.6	+	149	675	675	1.0000000
A01	35759113	35760658	A01p46820.2_BraZ1	225	+	1265	1545	1545	1.0000000
A01	35762435	35765405	A01p46830.2_BraZ1	2316.11	-	646	2908	2970	0.9791246
A01	35766251	35769847	A01p46840.2_BraZ1	780.868	-	1337	2941	3596	0.8178532
A01	35773256	35775419	A01p46850.2_BraZ1	987.955	-	581	1967	2163	0.9093851
A01	35775971	35777364	A01p46860.2_BraZ1	500.328	+	1287	1393	1393	1.0000000
A01	35781008	35782284	A01p46870.2_BraZ1	11812.5	+	857	1276	1276	1.0000000
A01	35782869	35784498	A01p46880.2_BraZ1	783	-	836	1629	1629	1.0000000
A01	35786484	35787421	A01p46890.2_BraZ1	222	+	539	937	937	1.0000000
A01	35788103	35789728	A01p46900.2_BraZ1	1130.61	-	931	1536	1625	0.9452308
A01	35790396	35793125	A01p46910.2_BraZ1	1590.41	+	1687	2729	2729	1.0000000
A01	35794237	35797769	A01p46920.2_BraZ1	1520.7	+	2319	3532	3532	1.0000000
A01	35798534	35803231	A01p46930.2_BraZ1	3312.69	+	1400	3861	4697	0.8220140
A01	35803673	35805977	A01p46940.2_BraZ1	1154.34	-	888	2289	2304	0.9934896
A01	35806158	35807590	A01p46950.2_BraZ1	239.036	+	830	1432	1432	1.0000000
A01	35808264	35809730	A01p46960.2_BraZ1	679.656	-	654	1379	1466	0.9406548
A01	35810371	35812202	A01p46970.2_BraZ1	1221	-	302	1595	1831	0.8711087
A01	35813118	35813459	A01p46980.2_BraZ1	186	+	396	341	341	1.0000000
A01	35815019	35816882	A01p46990.2_BraZ1	783.399	-	1011	1802	1863	0.9672571
A01	35820426	35824048	A01p47000.2_BraZ1	1903.94	+	1572	3319	3622	0.9163446
A01	35826438	35828331	A01p47010.2_BraZ1	189	-	384	1864	1893	0.9846804
A01	35833632	35834213	A01p47020.2_BraZ1	1554	-	276	569	581	0.9793460
A01	35835812	35841820	A01p47030.2_BraZ1	1528.68	+	2205	5580	6008	0.9287617
A01	35842208	35847406	A01p47040.2_BraZ1	1159.79	-	959	4395	5198	0.8455175
A01	35845457	35846456	A01p47050.2_BraZ1	99.9	-	63	864	999	0.8648649
A01	35894493	35895039	A01p47060.2_BraZ1	345	-	596	546	546	1.0000000
A01	35895533	35896523	A01p47070.2_BraZ1	99	+	324	837	990	0.8454546
A01	35901096	35902101	A01p47080.2_BraZ1	100.5	+	23	542	1005	0.5393035
A01	35902784	35904910	A01p47090.2_BraZ1	1230.51	-	548	2077	2126	0.9769520
A01	35905990	35906543	A01p47100.2_BraZ1	52.2	-	918	553	553	1.0000000
A01	35912315	35912702	A01p47110.2_BraZ1	38.7	-	166	387	387	1.0000000
A01	35913988	35917586	A01p47120.2_BraZ1	3061.8	-	1369	3544	3598	0.9849917
A01	35921982	35923055	A01p47130.2_BraZ1	681	+	123	868	1073	0.8089469
A01	35927211	35930330	A01p47140.2_BraZ1	1476.56	+	1908	3046	3119	0.9765950
A01	35933625	35934787	A01p47150.2_BraZ1	657.25	-	682	1112	1162	0.9569708
A01	35939104	35946051	A01p47160.2_BraZ1	1353.97	+	1644	4521	6947	0.6507845
A01	35946493	35949004	A01p47170.2_BraZ1	7566	-	1767	2511	2511	1.0000000
A01	35949057	35950290	A01p47180.2_BraZ1	1088.22	+	850	1233	1233	1.0000000
A01	35950698	35952736	A01p47190.2_BraZ1	967.737	+	1103	1983	2038	0.9730127
A01	35955847	35960091	A01p47200.2_BraZ1	2182.38	+	1555	4109	4244	0.9681904
A01	35960283	35960622	A01p47210.2_BraZ1	33.9	-	76	261	339	0.7699115
A01	35960979	35966156	A01p47220.2_BraZ1	2962.19	+	1073	4720	5177	0.9117249
A01	35968569	35968866	A01p47230.2_BraZ1	29.7	+	72	297	297	1.0000000
A01	35969429	35972181	A01p47240.2_BraZ1	803.571	+	171	528	2752	0.1918605
A01	35975996	35977907	A01p47250.2_BraZ1	1860	+	1014	1897	1911	0.9926740
A01	35978375	35979506	A01p47260.2_BraZ1	831	-	241	1113	1131	0.9840849
A01	35982163	35982574	A01p47270.2_BraZ1	41.1	+	78	411	411	1.0000000
A01	35984389	35985586	A01p47280.2_BraZ1	119.7	-	61	837	1197	0.6992481
A01	35987445	35989275	A01p47290.2_BraZ1	1127.88	-	603	1827	1830	0.9983606
A01	35991659	35993628	A01p47300.2_BraZ1	1517.28	-	1518	1969	1969	1.0000000
A01	35994432	35995247	A01p47310.2_BraZ1	465	-	1246	815	815	1.0000000
A01	35996228	35998805	A01p47320.2_BraZ1	1745.76	-	1183	2525	2577	0.9798215
A01	36075579	36077666	A01p47330.2_BraZ1	6540	+	1473	2021	2087	0.9683757
A01	36078444	36079337	A01p47340.2_BraZ1	956.75	-	334	893	893	1.0000000
A01	36083842	36085990	A01p47350.2_BraZ1	214.8	+	138	1030	2148	0.4795158
A01	36088940	36089211	A01p47360.2_BraZ1	21.9	+	324	271	271	1.0000000
A01	36090315	36093407	A01p47370.2_BraZ1	1722	-	235	1487	3092	0.4809185
A01	36095346	36097484	A01p47380.2_BraZ1	15361.5	+	1368	2138	2138	1.0000000
A01	36099257	36100971	A01p47390.2_BraZ1	1336.5	+	1435	1714	1714	1.0000000
A01	36102597	36104347	A01p47400.2_BraZ1	1068.75	+	584	1750	1750	1.0000000
A01	36104867	36105602	A01p47410.2_BraZ1	133.378	-	791	691	735	0.9401361
A01	36111961	36113044	A01p47420.2_BraZ1	430.892	-	952	1083	1083	1.0000000
A01	36115746	36118624	A01p47430.2_BraZ1	1429.36	+	897	2812	2878	0.9770674
A01	36120083	36121358	A01p47440.2_BraZ1	650.222	+	647	1232	1275	0.9662745
A01	36121690	36122046	A01p47450.2_BraZ1	18.6	+	226	356	356	1.0000000
A01	36126245	36126977	A01p47460.2_BraZ1	537.188	-	422	732	732	1.0000000
A01	36127507	36129661	A01p47470.2_BraZ1	285	-	736	1196	2154	0.5552461
A01	36132854	36133877	A01p47480.2_BraZ1	102.3	-	195	945	1023	0.9237537
A01	36134943	36135229	A01p47490.2_BraZ1	198	+	149	286	286	1.0000000
A01	36136594	36139339	A01p47500.2_BraZ1	1390.24	-	976	2556	2745	0.9311475
A01	36139763	36140736	A01p47510.2_BraZ1	210	-	627	973	973	1.0000000
A01	36141632	36146843	A01p47520.2_BraZ1	1691.9	+	1295	4630	5211	0.8885051
A01	36149612	36151009	A01p47530.2_BraZ1	681	+	779	1326	1397	0.9491768
A01	36154612	36158002	A01p47540.2_BraZ1	1450.32	+	1191	2770	3390	0.8171092
A01	36158749	36160380	A01p47550.2_BraZ1	1098	-	436	1452	1631	0.8902514
A01	36163036	36166450	A01p47560.2_BraZ1	1894	+	1423	3264	3414	0.9560633
A01	36169389	36172155	A01p47570.2_BraZ1	1901.66	-	434	1947	2766	0.7039046
A01	36226204	36228126	A01p47580.2_BraZ1	838.657	-	1007	1838	1922	0.9562955
A01	36229469	36231394	A01p47590.2_BraZ1	1086.55	-	1955	1925	1925	1.0000000
A01	36233138	36233814	A01p47600.2_BraZ1	136.5	+	127	668	676	0.9881657
A01	36236800	36237501	A01p47610.2_BraZ1	360	-	6	114	701	0.1626248
A01	36237995	36238157	A01p47620.2_BraZ1	16.2	+	0	0	162	0.0000000
A01	36240044	36240712	A01p47630.2_BraZ1	214.6	+	210	668	668	1.0000000
A01	36241160	36241337	A01p47640.2_BraZ1	108	-	380	177	177	1.0000000
A01	36242744	36245081	A01p47650.2_BraZ1	1228.5	+	1432	2331	2337	0.9974326
A01	36245762	36247095	A01p47660.2_BraZ1	640.588	-	63	726	1333	0.5446361
A01	36248785	36250331	A01p47670.2_BraZ1	1155.48	+	44	317	1546	0.2050453
A01	36253506	36255052	A01p47680.2_BraZ1	1131.81	+	95	329	1546	0.2128072
A01	36257321	36258881	A01p47690.2_BraZ1	156	+	252	1442	1560	0.9243590
A01	36259805	36261446	A01p47700.2_BraZ1	1111.6	+	205	1393	1641	0.8488727
A01	36262930	36264839	A01p47710.2_BraZ1	1452	-	610	1845	1909	0.9664746
A01	36266329	36266908	A01p47720.2_BraZ1	1101.6	+	159	579	579	1.0000000
A01	36267995	36269483	A01p47730.2_BraZ1	148.8	-	428	1369	1488	0.9200269
A01	36271038	36273178	A01p47740.2_BraZ1	1668	-	394	1847	2140	0.8630841
A01	36274313	36278654	A01p47750.2_BraZ1	2293.42	-	735	2525	4341	0.5816632
A01	36279674	36290440	A01p47760.2_BraZ1	778.235	-	5877	10229	10766	0.9501207
A01	36284052	36285498	A01p47770.2_BraZ1	815.393	-	765	1446	1446	1.0000000
A01	36286451	36287990	A01p47780.2_BraZ1	153.9	-	1126	1539	1539	1.0000000
A01	36290821	36293948	A01p47790.2_BraZ1	1326.89	-	1611	3115	3127	0.9961625
A01	36296125	36300635	A01p47800.2_BraZ1	1954.63	+	3122	4510	4510	1.0000000
A01	36300944	36301589	A01p47810.2_BraZ1	285	-	346	645	645	1.0000000
A01	36301781	36303335	A01p47820.2_BraZ1	17432.5	-	471	1265	1554	0.8140283
A01	36307996	36311876	A01p47830.2_BraZ1	1684.8	+	1255	3024	3880	0.7793815
A01	36312133	36312637	A01p47840.2_BraZ1	325.92	-	539	504	504	1.0000000
A01	36315835	36317917	A01p47850.2_BraZ1	984	+	2491	2082	2082	1.0000000
A01	36318339	36320494	A01p47860.2_BraZ1	1050.43	+	1527	2103	2155	0.9758701
A01	36321744	36323365	A01p47870.2_BraZ1	678.462	-	1712	1621	1621	1.0000000
A01	36323810	36324210	A01p47880.2_BraZ1	408.75	+	438	400	400	1.0000000
A01	36324205	36324883	A01p47890.2_BraZ1	2196.5	+	653	678	678	1.0000000
A01	36428921	36429684	A01p47900.2_BraZ1	243	-	353	749	763	0.9816514
A01	36429647	36429950	A01p47910.2_BraZ1	186	+	104	269	303	0.8877888
A01	36431847	36432355	A01p47920.2_BraZ1	2320.5	+	55	242	508	0.4763780
A01	36433854	36434564	A01p47930.2_BraZ1	600	+	79	663	710	0.9338028
A01	36435712	36438218	A01p47940.2_BraZ1	805.797	-	571	1855	2506	0.7402235
A01	36440680	36442501	A01p47950.2_BraZ1	2217.86	+	296	1384	1821	0.7600220
A01	36446402	36448165	A01p47960.2_BraZ1	866.864	+	781	1581	1763	0.8967669
A01	36451558	36452011	A01p47970.2_BraZ1	216	-	595	453	453	1.0000000
A01	36454692	36457010	A01p47980.2_BraZ1	1365	+	1047	2153	2318	0.9288179
A01	36457871	36459140	A01p47990.2_BraZ1	600	-	22	239	1269	0.1883373
A01	36462468	36466101	A01p48000.2_BraZ1	3810	-	1056	3141	3633	0.8645747
A01	36467173	36467683	A01p48010.2_BraZ1	51	+	54	481	510	0.9431372
A01	36468136	36469330	A01p48020.2_BraZ1	416.308	-	1154	1194	1194	1.0000000
A01	36470429	36472201	A01p48030.2_BraZ1	1221.33	+	1091	1772	1772	1.0000000
A01	36473784	36477986	A01p48040.2_BraZ1	70044.8	+	878	3991	4202	0.9497858
A01	36478907	36481753	A01p48050.2_BraZ1	1510.94	+	1294	2846	2846	1.0000000
A01	36487624	36488920	A01p48060.2_BraZ1	336	-	896	1296	1296	1.0000000
A01	36489567	36492794	A01p48070.2_BraZ1	1300.92	-	1221	2817	3227	0.8729470
A01	36496275	36498103	A01p48080.2_BraZ1	461.538	-	919	1749	1828	0.9567834
A01	36506457	36513106	A01p48090.2_BraZ1	817.952	+	1032	5498	6649	0.8268912
A01	36515949	36517089	A01p48100.2_BraZ1	623.826	+	836	1140	1140	1.0000000
A01	36517688	36519385	A01p48110.2_BraZ1	1282.37	-	689	1687	1697	0.9941072
A01	36520082	36522646	A01p48120.2_BraZ1	2046.38	+	353	2034	2564	0.7932917
A01	36523854	36524583	A01p48130.2_BraZ1	468	+	128	617	729	0.8463649
A01	36652299	36653347	A01p48140.2_BraZ1	342.429	+	1157	1048	1048	1.0000000
A01	36653829	36656189	A01p48150.2_BraZ1	1269.84	-	512	1500	2360	0.6355932
A01	36658390	36659941	A01p48160.2_BraZ1	807	-	119	951	1551	0.6131528
A01	36662037	36666277	A01p48170.2_BraZ1	1605.54	-	1536	3866	4240	0.9117925
A01	36667656	36676393	A01p48180.2_BraZ1	943.95	-	5329	5101	8737	0.5838388
A01	36668440	36669678	A01p48190.2_BraZ1	489.6	+	2	20	1238	0.0161551
A01	36678137	36683707	A01p48200.2_BraZ1	1865.5	-	2681	3488	5570	0.6262118
A01	36687177	36687396	A01p48210.2_BraZ1	21.9	-	15	89	219	0.4063927
A01	36688847	36696911	A01p48220.2_BraZ1	3248.11	+	8164	7930	8064	0.9833829
A01	36697315	36697692	A01p48230.2_BraZ1	24.3	-	0	0	377	0.0000000
A01	36698038	36698967	A01p48240.2_BraZ1	572.813	+	686	929	929	1.0000000
A01	36699248	36699500	A01p48250.2_BraZ1	25.2	+	4	176	252	0.6984127
A01	36701445	36704794	A01p48260.2_BraZ1	1197	+	1847	3284	3349	0.9805912
A01	36705288	36706545	A01p48270.2_BraZ1	1047	-	632	1203	1257	0.9570405
A01	36707830	36709374	A01p48280.2_BraZ1	699.286	+	774	1544	1544	1.0000000
A01	36710753	36712860	A01p48290.2_BraZ1	1686.98	-	958	1662	2107	0.7887992
A01	36718726	36719092	A01p48300.2_BraZ1	36.6	-	130	366	366	1.0000000
A01	36720056	36721079	A01p48310.2_BraZ1	102.3	-	146	945	1023	0.9237537
A01	36722552	36723587	A01p48320.2_BraZ1	193.667	-	91	289	1035	0.2792270
A01	36842020	36842197	A01p48330.2_BraZ1	17.7	-	0	0	177	0.0000000
A01	36878087	36879700	A01p48340.2_BraZ1	959.942	+	1024	1613	1613	1.0000000
A01	36881806	36884030	A01p48350.2_BraZ1	1414.22	-	877	2051	2224	0.9222122
A01	36885899	36888143	A01p48360.2_BraZ1	1000.85	-	1070	1858	2244	0.8279858
A01	36888871	36892185	A01p48370.2_BraZ1	1375	+	1804	3171	3314	0.9568498
A01	36894631	36894790	A01p48380.2_BraZ1	15.9	-	17	159	159	1.0000000
A01	36895858	36897242	A01p48390.2_BraZ1	7581	-	28	523	1384	0.3778902
A01	36910233	36911538	A01p48400.2_BraZ1	5190	-	577	568	1305	0.4352490
A01	36915379	36918457	A01p48410.2_BraZ1	307.8	+	236	2426	3078	0.7881742
A01	36919457	36921379	A01p48420.2_BraZ1	1033.64	-	948	1618	1922	0.8418314
A01	36922242	36923433	A01p48430.2_BraZ1	119.1	-	1043	1139	1191	0.9563392
A01	36928646	36929817	A01p48440.2_BraZ1	561	-	1658	1171	1171	1.0000000
A01	36933719	36936324	A01p48450.2_BraZ1	846.857	+	1964	2605	2605	1.0000000
A01	36936828	36945060	A01p48460.2_BraZ1	2179.38	-	5545	7560	8232	0.9183673
A01	36947589	36948936	A01p48470.2_BraZ1	12834	+	313	899	1347	0.6674091
A01	36951643	36956141	A01p48480.2_BraZ1	1690.67	+	2662	3749	4498	0.8334816
A01	36957269	36957722	A01p48490.2_BraZ1	44.1	-	19	305	453	0.6732892
A01	36959502	36960301	A01p48500.2_BraZ1	793.5	+	264	754	799	0.9436796
A01	36961181	36963999	A01p48510.2_BraZ1	1473.06	-	1221	1586	2818	0.5628105
A01	36965204	36967159	A01p48520.2_BraZ1	721.154	+	2032	1955	1955	1.0000000
A01	36967837	36971083	A01p48530.2_BraZ1	1872.1	-	1934	3123	3246	0.9621072
A01	36981192	36988138	A01p48540.2_BraZ1	1108.21	+	4803	6946	6946	1.0000000
A01	36991953	36993585	A01p48550.2_BraZ1	865.526	+	1000	1632	1632	1.0000000
A01	36998242	37000165	A01p48560.2_BraZ1	879.462	+	903	1920	1923	0.9984399
A01	37000412	37001336	A01p48570.2_BraZ1	590.526	-	719	924	924	1.0000000
A01	37002226	37005982	A01p48580.2_BraZ1	2063.41	-	2221	3694	3756	0.9834931
A01	37013807	37019706	A01p48590.2_BraZ1	1859.14	+	2702	5408	5899	0.9167656
A01	37020063	37021458	A01p48600.2_BraZ1	139.5	-	705	1117	1395	0.8007168
A01	37022960	37024841	A01p48610.2_BraZ1	4444.4	-	1624	1881	1881	1.0000000
A01	37025451	37026620	A01p48620.2_BraZ1	2061	+	309	701	1169	0.5996578
A01	37028486	37029844	A01p48630.2_BraZ1	8712	+	712	1254	1358	0.9234168
A01	37030341	37033962	A01p48640.2_BraZ1	3142.11	-	1477	3540	3621	0.9776305
A01	37036544	37037348	A01p48650.2_BraZ1	80.4	+	25	196	804	0.2437811
A01	37043211	37043367	A01p48660.2_BraZ1	15.6	-	119	156	156	1.0000000
A01	37043947	37044264	A01p48670.2_BraZ1	225	+	56	317	317	1.0000000
A01	37050486	37054186	A01p48680.2_BraZ1	13932	+	2326	3700	3700	1.0000000
A01	37054416	37056105	A01p48690.2_BraZ1	1118.64	-	233	1448	1689	0.8573120
A01	37059250	37060886	A01p48700.2_BraZ1	1446.85	+	647	1636	1636	1.0000000
A01	37176083	37177448	A01p48710.2_BraZ1	918.145	-	44	865	1365	0.6336997
A01	37183577	37185035	A01p48720.2_BraZ1	1074	-	376	1196	1458	0.8203018
A01	37195925	37201120	A01p48730.2_BraZ1	1880	-	1953	4499	5195	0.8660250
A01	37202677	37203235	A01p48740.2_BraZ1	55.8	+	129	404	558	0.7240143
A01	37203911	37207632	A01p48750.2_BraZ1	174	+	7360	3373	3721	0.9064767
A01	37213792	37216862	A01p48760.2_BraZ1	3148.13	+	1251	2765	3070	0.9006515
A01	37221222	37221663	A01p48770.2_BraZ1	44.1	-	173	441	441	1.0000000
A01	37222693	37228293	A01p48780.2_BraZ1	2676.13	-	3602	5565	5600	0.9937500
A01	37229576	37230204	A01p48790.2_BraZ1	150	-	637	628	628	1.0000000
A01	37230936	37232742	A01p48800.2_BraZ1	180.6	-	842	1806	1806	1.0000000
A01	37236173	37240316	A01p48810.2_BraZ1	2523.03	-	1197	4109	4143	0.9917934
A01	37242010	37242394	A01p48820.2_BraZ1	294	+	490	384	384	1.0000000
A01	37242688	37245226	A01p48830.2_BraZ1	1472.75	-	558	2387	2538	0.9405043
A01	37246186	37248738	A01p48840.2_BraZ1	13368	-	606	2177	2552	0.8530564
A01	37261123	37262051	A01p48850.2_BraZ1	90	+	672	928	928	1.0000000
A01	37264189	37264777	A01p48860.2_BraZ1	58.8	-	3	103	588	0.1751701
A01	37266968	37268378	A01p48870.2_BraZ1	1329	+	271	1024	1410	0.7262411
A01	37271511	37272459	A01p48880.2_BraZ1	94.8	+	39	362	948	0.3818565
A01	37283434	37286294	A01p48890.2_BraZ1	24160.5	-	596	2036	2860	0.7118881
A01	37287399	37289362	A01p48900.2_BraZ1	1095.97	-	951	1765	1963	0.8991340
A01	37290716	37292999	A01p48910.2_BraZ1	991.571	+	457	1561	2283	0.6837494
A01	37293253	37295140	A01p48920.2_BraZ1	264	-	1434	1551	1887	0.8219396
A01	37296545	37299519	A01p48930.2_BraZ1	1427.75	+	1698	2653	2974	0.8920646
A01	37301034	37303203	A01p48940.2_BraZ1	216.9	+	420	1501	2169	0.6920240
A01	37350666	37351480	A01p48950.2_BraZ1	1564.39	-	589	814	814	1.0000000
A01	37353386	37353803	A01p48960.2_BraZ1	41.7	-	201	397	417	0.9520383
A01	37355563	37356736	A01p48970.2_BraZ1	117	+	898	1127	1173	0.9607843
A01	37360787	37361951	A01p48980.2_BraZ1	116.4	+	119	757	1164	0.6503437
A01	37362684	37367946	A01p48990.2_BraZ1	1270.98	+	1000	3260	5262	0.6195363
A01	37368971	37370534	A01p49000.2_BraZ1	823.263	-	409	1205	1563	0.7709533
A01	37373554	37375079	A01p49010.2_BraZ1	513.151	-	367	1334	1525	0.8747541
A01	37375698	37378797	A01p49020.2_BraZ1	1346.53	+	910	2834	3099	0.9144886
A01	37380171	37381020	A01p49030.2_BraZ1	84.9	-	243	722	849	0.8504122
A01	37381558	37390421	A01p49040.2_BraZ1	3874.19	-	2502	6646	8863	0.7498590
A01	37392033	37393080	A01p49050.2_BraZ1	104.7	-	437	944	1047	0.9016237
A01	37393884	37394741	A01p49060.2_BraZ1	331.299	-	671	857	857	1.0000000
A01	37395691	37399587	A01p49070.2_BraZ1	1280.07	-	3766	2986	3896	0.7664271
A01	37404201	37404527	A01p49080.2_BraZ1	231	-	121	257	326	0.7883435
A01	37405884	37406985	A01p49090.2_BraZ1	412.25	-	0	0	1101	0.0000000
A01	37407497	37408672	A01p49100.2_BraZ1	1443	+	310	1163	1175	0.9897872
A01	37408635	37409248	A01p49110.2_BraZ1	239.4	+	211	613	613	1.0000000
A01	37415281	37418361	A01p49120.2_BraZ1	1249.69	-	20	49	3080	0.0159091
A01	37514789	37515833	A01p49130.2_BraZ1	104.4	-	116	897	1044	0.8591954
A01	37517445	37518159	A01p49140.2_BraZ1	3173.33	+	15	214	714	0.2997199
A01	37519908	37524678	A01p49150.2_BraZ1	1337.16	+	1605	3795	4770	0.7955975
A01	37527896	37545182	A01p49160.2_BraZ1	1949.9	+	4698	13878	17286	0.8028463
A01	37532930	37533758	A01p49170.2_BraZ1	348	-	575	828	828	1.0000000
A01	37538773	37539445	A01p49180.2_BraZ1	67.2	+	229	593	672	0.8824404
A01	37540959	37541478	A01p49190.2_BraZ1	273	+	129	286	519	0.5510597
A01	37547025	37552909	A01p49200.2_BraZ1	1714.85	+	1658	5212	5884	0.8857920
A01	37553080	37556529	A01p49210.2_BraZ1	1495	-	434	2375	3449	0.6886054
A01	37563276	37565430	A01p49220.2_BraZ1	96.3	-	126	631	2154	0.2929434
A01	37576330	37577218	A01p49230.2_BraZ1	88.8	-	134	855	888	0.9628378
A01	37581153	37582038	A01p49240.2_BraZ1	88.5	-	20	265	885	0.2994350
A01	37584345	37586469	A01p49250.2_BraZ1	1678.88	+	254	1599	2124	0.7528248
A01	37591003	37592167	A01p49260.2_BraZ1	116.4	+	1805	1164	1164	1.0000000
A01	37594833	37596632	A01p49270.2_BraZ1	1093.55	+	884	1661	1799	0.9232907
A01	37597033	37602307	A01p49280.2_BraZ1	2938.61	-	5596	5203	5274	0.9865378
A01	37607024	37610647	A01p49290.2_BraZ1	1511.25	+	682	3024	3623	0.8346674
A01	37613858	37617272	A01p49300.2_BraZ1	1901.88	+	426	2196	3414	0.6432337
A01	37622580	37622961	A01p49310.2_BraZ1	38.1	-	10	176	381	0.4619423
A01	37626139	37629675	A01p49320.2_BraZ1	1890.88	+	1457	3417	3536	0.9663461
A01	37630263	37640004	A01p49330.2_BraZ1	1143.9	-	5102	8128	9741	0.8344113
A01	37647940	37648726	A01p49340.2_BraZ1	531	-	438	778	786	0.9898219
A01	37716283	37716629	A01p49350.2_BraZ1	884	-	221	346	346	1.0000000
A01	37717444	37718669	A01p49360.2_BraZ1	1056	-	85	710	1225	0.5795918
A01	37720746	37721802	A01p49370.2_BraZ1	105.6	+	38	743	1056	0.7035985
A01	37722724	37724557	A01p49380.2_BraZ1	648	+	786	1719	1833	0.9378068
A01	37725067	37727077	A01p49390.2_BraZ1	804.894	-	810	1557	2010	0.7746269
A01	37728263	37729552	A01p49400.2_BraZ1	582.692	-	142	762	1289	0.5911559
A01	37738326	37738860	A01p49410.2_BraZ1	453	+	210	524	534	0.9812734
A01	37741265	37742321	A01p49420.2_BraZ1	624	+	211	856	1056	0.8106061
A01	37745204	37750106	A01p49430.2_BraZ1	3141.11	+	2055	4338	4902	0.8849449
A01	37754940	37757770	A01p49440.2_BraZ1	1523.15	+	900	2305	2830	0.8144876
A01	37758578	37759274	A01p49450.2_BraZ1	69.6	-	993	682	696	0.9798850
A01	37760158	37760731	A01p49460.2_BraZ1	57.3	+	214	573	573	1.0000000
A01	37761415	37763258	A01p49470.2_BraZ1	1143	+	99	1380	1843	0.7487792
A01	37764206	37767460	A01p49480.2_BraZ1	1550.48	-	1706	2933	3254	0.9013522
A01	37770218	37771329	A01p49490.2_BraZ1	362.25	+	484	958	1111	0.8622862
A01	37773681	37773961	A01p49500.2_BraZ1	159	-	23	280	280	1.0000000
A01	37777144	37777525	A01p49510.2_BraZ1	38.1	+	14	148	381	0.3884515
A01	37777694	37778564	A01p49520.2_BraZ1	657	-	208	760	870	0.8735632
A01	37779518	37780009	A01p49530.2_BraZ1	417	+	499	491	491	1.0000000
A01	37780680	37782175	A01p49540.2_BraZ1	5791.5	+	217	1008	1495	0.6742475
A01	37784840	37785106	A01p49550.2_BraZ1	168	+	91	252	266	0.9473684
A01	37786266	37786557	A01p49560.2_BraZ1	165	+	148	291	291	1.0000000
A01	37788757	37790074	A01p49570.2_BraZ1	991.8	+	403	954	1317	0.7243736
A01	37795929	37796199	A01p49580.2_BraZ1	27	-	5	39	270	0.1444445
A01	37800474	37802939	A01p49590.2_BraZ1	2319	+	545	2159	2465	0.8758621
A01	37803958	37806420	A01p49600.2_BraZ1	1183.2	-	362	1948	2462	0.7912266
A01	37809251	37812112	A01p49610.2_BraZ1	1795.5	+	774	2449	2861	0.8559944
A01	37814390	37814987	A01p49620.2_BraZ1	59.7	-	34	469	597	0.7855946
A01	37816990	37821851	A01p49630.2_BraZ1	2328.59	+	2275	4601	4861	0.9465131
A01	37864126	37864511	A01p49640.2_BraZ1	273	-	512	385	385	1.0000000
A01	37867749	37870187	A01p49650.2_BraZ1	1164.77	+	583	1973	2438	0.8092699
A01	37871260	37871735	A01p49660.2_BraZ1	8250	+	311	475	475	1.0000000
A01	37872299	37872800	A01p49670.2_BraZ1	50.1	+	176	501	501	1.0000000
A01	37873394	37876871	A01p49680.2_BraZ1	1822.63	+	1418	3413	3477	0.9815933
A01	37878248	37879260	A01p49690.2_BraZ1	658.875	+	1601	1012	1012	1.0000000
A01	37879720	37880868	A01p49700.2_BraZ1	99.9	-	861	1148	1148	1.0000000
A01	37881893	37883444	A01p49710.2_BraZ1	705.202	-	331	1512	1551	0.9748549
A01	37886296	37887149	A01p49720.2_BraZ1	464.767	+	477	853	853	1.0000000
A01	37887637	37890070	A01p49730.2_BraZ1	12936	-	1772	2433	2433	1.0000000
A01	37893953	37899275	A01p49740.2_BraZ1	3046.19	+	3375	5303	5322	0.9964299
A01	37899914	37901905	A01p49750.2_BraZ1	1019.45	-	766	1905	1991	0.9568056
A01	37908635	37910362	A01p49760.2_BraZ1	1732.5	-	1604	1696	1727	0.9820498
A01	37914482	37916585	A01p49770.2_BraZ1	873.452	+	1644	2103	2103	1.0000000
A01	37919618	37920247	A01p49780.2_BraZ1	375	+	216	577	629	0.9173291
A01	37920951	37921336	A01p49790.2_BraZ1	240	+	258	385	385	1.0000000
A01	37922871	37923250	A01p49800.2_BraZ1	273	+	183	305	379	0.8047494
A01	37924439	37926004	A01p49810.2_BraZ1	77.6471	-	571	1336	1565	0.8536741
A01	37927200	37928310	A01p49820.2_BraZ1	897	+	306	954	1110	0.8594595
A01	37929273	37931918	A01p49830.2_BraZ1	1181.48	-	1351	2283	2645	0.8631380
A01	38049605	38051689	A01p49840.2_BraZ1	813.804	-	402	1823	2084	0.8747601
A01	38051680	38055173	A01p49850.2_BraZ1	741.886	-	873	3303	3493	0.9456055
A01	38057446	38058655	A01p49860.2_BraZ1	242.509	-	93	1055	1209	0.8726220
A01	38062943	38063303	A01p49870.2_BraZ1	36	-	18	294	360	0.8166667
A01	38066691	38067246	A01p49880.2_BraZ1	55.5	-	16	39	555	0.0702703
A01	38068088	38072328	A01p49890.2_BraZ1	1868.62	-	986	3113	4240	0.7341981
A01	38073922	38074640	A01p49900.2_BraZ1	522	+	12072	718	718	1.0000000
A01	38074529	38076529	A01p49910.2_BraZ1	387	+	9357	1998	2000	0.9990000
A01	38080192	38081335	A01p49920.2_BraZ1	993	+	5787	1071	1143	0.9370078
A01	38082969	38083272	A01p49930.2_BraZ1	30.3	-	112	303	303	1.0000000
A01	38087453	38092461	A01p49940.2_BraZ1	2740.87	-	980	3240	5008	0.6469648
A01	38093811	38097966	A01p49950.2_BraZ1	2392.67	+	988	2787	4155	0.6707581
A01	38098494	38100690	A01p49960.2_BraZ1	1447.16	+	591	1735	2196	0.7900729
A01	38102665	38103478	A01p49970.2_BraZ1	1198.12	+	224	775	813	0.9532595
A01	38103624	38103753	A01p49980.2_BraZ1	12.9	+	127	129	129	1.0000000
A01	38105719	38107003	A01p49990.2_BraZ1	128.4	+	40	753	1284	0.5864486
A01	38107285	38109089	A01p50000.2_BraZ1	1045.84	-	68	534	1804	0.2960089
A01	38111150	38112474	A01p50010.2_BraZ1	809.26	+	396	1281	1324	0.9675227
A01	38113871	38115917	A01p50020.2_BraZ1	12903.8	-	879	2033	2046	0.9936461
A01	38122055	38123216	A01p50030.2_BraZ1	116.1	-	86	762	1161	0.6563308
A01	38123900	38127879	A01p50040.2_BraZ1	1265.37	-	2114	3370	3979	0.8469465
A01	38130627	38133069	A01p50050.2_BraZ1	1134	+	831	2181	2442	0.8931204
A01	38133245	38134509	A01p50060.2_BraZ1	921	-	271	1192	1264	0.9430380
A01	38135661	38136716	A01p50070.2_BraZ1	390	-	110	752	1055	0.7127962
A01	38137535	38140289	A01p50080.2_BraZ1	1500.77	-	405	2214	2754	0.8039216
A01	38256295	38256764	A01p50090.2_BraZ1	324	+	0	0	469	0.0000000
A01	38256643	38258427	A01p50100.2_BraZ1	9768	+	2	21	1784	0.0117713
A01	38259540	38260882	A01p50110.2_BraZ1	936	-	0	0	1342	0.0000000
A01	38347444	38348692	A01p50120.2_BraZ1	402.8	-	460	1248	1248	1.0000000
A01	38349348	38349893	A01p50130.2_BraZ1	186	-	165	510	545	0.9357798
A01	38350513	38350777	A01p50140.2_BraZ1	26.4	-	506	264	264	1.0000000
A01	38352616	38357323	A01p50150.2_BraZ1	2966.43	-	3574	4408	4707	0.9364776
A01	38359976	38360714	A01p50160.2_BraZ1	284.071	+	333	622	738	0.8428184
A01	38362498	38364479	A01p50170.2_BraZ1	1784.91	-	434	1803	1981	0.9101464
A01	38366076	38367775	A01p50180.2_BraZ1	1012.5	-	362	1699	1699	1.0000000
A01	38370317	38371293	A01p50190.2_BraZ1	587.039	+	260	973	976	0.9969262
A01	38372866	38375015	A01p50200.2_BraZ1	799.855	+	1164	2120	2149	0.9865053
A01	38375575	38376735	A01p50210.2_BraZ1	501	+	166	955	1160	0.8232759
A01	38379184	38380976	A01p50220.2_BraZ1	735	+	1368	1792	1792	1.0000000
A01	38381435	38384989	A01p50230.2_BraZ1	1274.91	+	943	3055	3554	0.8595948
A01	38387195	38388899	A01p50240.2_BraZ1	1524.25	+	1166	1673	1704	0.9818075
A01	38389271	38391584	A01p50250.2_BraZ1	250.7	-	604	1869	2313	0.8080415
A01	38392470	38393290	A01p50260.2_BraZ1	577.895	+	259	784	820	0.9560975
A01	38394253	38396998	A01p50270.2_BraZ1	1304.41	-	579	1350	2745	0.4918033
A01	38397290	38398602	A01p50280.2_BraZ1	804	+	172	891	1312	0.6791158
A01	38398800	38400588	A01p50290.2_BraZ1	1037.54	-	214	1440	1788	0.8053691
A01	38400840	38402888	A01p50300.2_BraZ1	1512	+	638	2048	2048	1.0000000
A01	38408240	38409945	A01p50310.2_BraZ1	169.5	-	180	1492	1705	0.8750733
A01	38410862	38412428	A01p50320.2_BraZ1	156.6	-	478	1566	1566	1.0000000
A01	38412910	38413341	A01p50330.2_BraZ1	258	-	570	431	431	1.0000000
A01	38415532	38416169	A01p50340.2_BraZ1	224.312	+	1001	637	637	1.0000000
A01	38416814	38417530	A01p50350.2_BraZ1	274.038	+	884	716	716	1.0000000
A01	38418114	38418565	A01p50360.2_BraZ1	229.5	+	659	451	451	1.0000000
A01	38419339	38421797	A01p50370.2_BraZ1	1032.55	-	864	1776	2458	0.7225387
A01	38422952	38424181	A01p50380.2_BraZ1	364.5	-	403	1172	1229	0.9536209
A01	38424880	38425937	A01p50390.2_BraZ1	917.468	-	418	913	1057	0.8637654
A01	38432548	38434425	A01p50400.2_BraZ1	1283.54	+	592	1812	1877	0.9653703
A01	38434697	38439031	A01p50410.2_BraZ1	556.8	-	2331	4176	4334	0.9635441
A01	38437005	38437797	A01p50420.2_BraZ1	1405.62	+	621	792	792	1.0000000
A01	38441000	38441879	A01p50430.2_BraZ1	795	+	237	879	879	1.0000000
A01	38443406	38446279	A01p50440.2_BraZ1	3579.54	-	622	2440	2873	0.8492864
A01	38456974	38459306	A01p50450.2_BraZ1	1078.58	+	657	1711	2332	0.7337050
A01	38459787	38460253	A01p50460.2_BraZ1	201.692	-	0	0	466	0.0000000
A01	38548871	38549374	A01p50470.2_BraZ1	201.692	-	60	485	503	0.9642147
A01	38550111	38551630	A01p50480.2_BraZ1	1332	-	875	1386	1519	0.9124424
A01	38554250	38554433	A01p50490.2_BraZ1	18.3	+	6	160	183	0.8743169
A01	38554740	38556490	A01p50500.2_BraZ1	1411.57	+	628	1310	1750	0.7485715
A01	38557081	38557747	A01p50510.2_BraZ1	66.6	-	185	666	666	1.0000000
A01	38561675	38563310	A01p50520.2_BraZ1	495	-	710	1445	1635	0.8837920
A01	38563717	38564422	A01p50530.2_BraZ1	504	+	566	705	705	1.0000000
A01	38564963	38566831	A01p50540.2_BraZ1	670.442	+	915	1868	1868	1.0000000
A01	38567844	38569221	A01p50550.2_BraZ1	137.7	-	258	1312	1377	0.9527959
A01	38570476	38571442	A01p50560.2_BraZ1	96.6	+	472	875	966	0.9057971
A01	38571877	38573861	A01p50570.2_BraZ1	1461	-	777	1696	1984	0.8548387
A01	38575119	38578490	A01p50580.2_BraZ1	891	-	350	1977	3371	0.5864729
A01	38578804	38581501	A01p50590.2_BraZ1	269.7	+	547	2355	2697	0.8731924
A01	38581922	38584826	A01p50600.2_BraZ1	1357.61	-	271	2258	2904	0.7775482
A01	38587832	38589731	A01p50610.2_BraZ1	697.931	+	1148	1885	1899	0.9926277
A01	38590342	38590568	A01p50620.2_BraZ1	123	-	481	226	226	1.0000000
A01	38595938	38597232	A01p50630.2_BraZ1	929.111	+	1824	1294	1294	1.0000000
A01	38600436	38602482	A01p50640.2_BraZ1	1333	+	413	1763	2046	0.8616813
A01	38603165	38604977	A01p50650.2_BraZ1	1055.16	-	394	1604	1812	0.8852097
A01	38790562	38808434	A01p50660.2_BraZ1	2656	-	5880	11927	17872	0.6673567
A01	38800203	38800525	A01p50670.2_BraZ1	243	+	0	0	322	0.0000000
A01	38809093	38809752	A01p50680.2_BraZ1	296.125	-	676	659	659	1.0000000
A01	38811153	38811621	A01p50690.2_BraZ1	375	-	74	384	468	0.8205128
A01	38820784	38821119	A01p50700.2_BraZ1	234	+	0	0	335	0.0000000
A01	38821535	38824265	A01p50710.2_BraZ1	1474.6	-	272	1836	2730	0.6725275
A01	38824663	38825713	A01p50720.2_BraZ1	414	+	721	1050	1050	1.0000000
A01	38827286	38827983	A01p50730.2_BraZ1	85.5312	+	374	697	697	1.0000000
A01	38828151	38829973	A01p50740.2_BraZ1	1293.91	-	398	1124	1822	0.6169045
A01	38830904	38831764	A01p50750.2_BraZ1	5044.5	+	8	290	860	0.3372093
A01	38832842	38835338	A01p50760.2_BraZ1	1786.15	+	376	2004	2496	0.8028846
A01	38835979	38838395	A01p50770.2_BraZ1	1480.65	-	1366	2416	2416	1.0000000
A01	38840647	38842084	A01p50780.2_BraZ1	760.5	-	500	1371	1437	0.9540710
A01	38843614	38844966	A01p50790.2_BraZ1	276	+	1318	1352	1352	1.0000000
A01	38845355	38848156	A01p50800.2_BraZ1	1606.36	+	517	1791	2801	0.6394145
A01	38848410	38859827	A01p50810.2_BraZ1	1206.07	-	7608	10694	11417	0.9366734
A01	38859870	38864493	A01p50820.2_BraZ1	868.054	-	65	973	4623	0.2104694
A01	38865416	38866683	A01p50830.2_BraZ1	17298	-	126	1048	1267	0.8271508
A01	38869454	38869898	A01p50840.2_BraZ1	146.25	-	32	337	444	0.7590090
A01	38953812	38955817	A01p50850.2_BraZ1	782.727	+	820	1500	2005	0.7481297
A01	38957417	38957972	A01p50860.2_BraZ1	55.5	-	4	169	555	0.3045045
A01	38961939	38962326	A01p50870.2_BraZ1	38.7	-	1	21	387	0.0542636
A01	38962789	38963263	A01p50880.2_BraZ1	47.4	+	2	212	474	0.4472574
A01	38963557	38965777	A01p50890.2_BraZ1	1562.18	-	359	1036	2220	0.4666667
A01	38969015	38970733	A01p50900.2_BraZ1	26790	-	20	347	1718	0.2019790
A01	38972223	38973622	A01p50910.2_BraZ1	707.889	+	819	1399	1399	1.0000000
A01	38974048	38976160	A01p50920.2_BraZ1	1540.69	-	446	1907	2112	0.9029356
A01	38976998	38984491	A01p50930.2_BraZ1	2163.86	-	2944	7104	7493	0.9480849
A01	38986352	38987152	A01p50940.2_BraZ1	38.1	+	266	800	800	1.0000000
A01	38990857	38991962	A01p50950.2_BraZ1	324	-	1217	1105	1105	1.0000000
A01	38992113	38993755	A01p50960.2_BraZ1	124	+	1579	1642	1642	1.0000000
A01	38993590	38994425	A01p50970.2_BraZ1	336	+	863	835	835	1.0000000
A01	38999538	39001844	A01p50980.2_BraZ1	927.153	-	116	865	2306	0.3751084
A01	39005909	39006230	A01p50990.2_BraZ1	32.1	+	21	270	321	0.8411215
A01	39006964	39012772	A01p51000.2_BraZ1	3098.4	+	718	4479	5808	0.7711777
A01	39014501	39014801	A01p51010.2_BraZ1	30	-	177	300	300	1.0000000
A01	39015178	39015349	A01p51020.2_BraZ1	17.1	-	24	125	171	0.7309942
A01	39015384	39015871	A01p51030.2_BraZ1	337.97	-	233	487	487	1.0000000
A01	39016596	39017682	A01p51040.2_BraZ1	108.6	+	285	999	1086	0.9198895
A01	39018352	39019933	A01p51050.2_BraZ1	696.745	-	968	1581	1581	1.0000000
A01	39020370	39020922	A01p51060.2_BraZ1	55.2	-	207	552	552	1.0000000
A01	39021490	39022218	A01p51070.2_BraZ1	325.304	-	409	728	728	1.0000000
A01	39022664	39023567	A01p51080.2_BraZ1	610.5	+	478	871	903	0.9645626
A01	39024782	39033207	A01p51090.2_BraZ1	5190.96	+	213	2742	8425	0.3254599
A01	39033900	39044480	A01p51100.2_BraZ1	1297.12	-	5258	9991	10580	0.9443289
A01	39155157	39158242	A01p51110.2_BraZ1	1520.74	-	2381	3053	3085	0.9896272
A01	39163832	39166862	A01p51120.2_BraZ1	2195.37	+	1797	2996	3030	0.9887789
A01	39173876	39176070	A01p51130.2_BraZ1	516	+	1906	2194	2194	1.0000000
A01	39177205	39178764	A01p51140.2_BraZ1	454.447	-	1053	1559	1559	1.0000000
A01	39179042	39182358	A01p51150.2_BraZ1	1803.58	+	2861	3279	3316	0.9888420
A01	39182523	39184056	A01p51160.2_BraZ1	870.462	-	635	1411	1533	0.9204175
A01	39185075	39186288	A01p51170.2_BraZ1	110.7	-	954	1213	1213	1.0000000
A01	39186621	39189938	A01p51180.2_BraZ1	2016.09	+	2450	3317	3317	1.0000000
A01	39190273	39193298	A01p51190.2_BraZ1	1721.64	+	1202	2992	3025	0.9890909
A01	39194597	39196214	A01p51200.2_BraZ1	1509	+	744	1617	1617	1.0000000
A01	39196997	39198889	A01p51210.2_BraZ1	294.429	+	346	1418	1892	0.7494715
A01	39210121	39211219	A01p51220.2_BraZ1	296.25	-	2	20	1098	0.0182149
A01	39212614	39212998	A01p51230.2_BraZ1	177	+	100	384	384	1.0000000
A01	39213379	39213747	A01p51240.2_BraZ1	219	+	124	319	368	0.8668478
A02	4580	5270	A02p00010.2_BraZ1	312	+	164	532	690	0.7710145
A02	7444	7609	A02p00020.2_BraZ1	16.5	-	0	0	165	0.0000000
A02	9149	13572	A02p00030.2_BraZ1	1156.83	+	1201	3976	4423	0.8989373
A02	20252	21221	A02p00040.2_BraZ1	767.286	+	813	756	969	0.7801858
A02	24705	29238	A02p00050.2_BraZ1	1698.41	+	937	3551	4533	0.7833664
A02	30399	31344	A02p00060.2_BraZ1	306	+	34	490	945	0.5185185
A02	35107	37988	A02p00070.2_BraZ1	2793	+	740	2070	2881	0.7185005
A02	40790	41249	A02p00080.2_BraZ1	45.9	-	108	428	459	0.9324619
A02	43753	44461	A02p00090.2_BraZ1	70.8	-	65	245	708	0.3460452
A02	47262	48524	A02p00100.2_BraZ1	929.5	-	115	1150	1262	0.9112520
A02	72349	73036	A02p00110.2_BraZ1	363	+	726	687	687	1.0000000
A02	82568	83360	A02p00120.2_BraZ1	79.2	-	147	534	792	0.6742424
A02	91133	92429	A02p00130.2_BraZ1	129.6	+	46	879	1296	0.6782407
A02	95118	96402	A02p00140.2_BraZ1	128.4	-	43	412	1284	0.3208723
A02	98380	99303	A02p00150.2_BraZ1	711	-	289	745	923	0.8071506
A02	99763	100093	A02p00160.2_BraZ1	25.5	+	218	330	330	1.0000000
A02	102990	103195	A02p00170.2_BraZ1	11.1	-	5	163	205	0.7951220
A02	112042	112525	A02p00180.2_BraZ1	48.3	-	13	128	483	0.2650104
A02	123976	128137	A02p00190.2_BraZ1	2296.27	+	1637	3908	4161	0.9391973
A02	129848	131957	A02p00200.2_BraZ1	210.9	+	1924	2109	2109	1.0000000
A02	134180	135219	A02p00210.2_BraZ1	867	-	876	996	1039	0.9586141
A02	135890	139743	A02p00220.2_BraZ1	2570.15	-	1815	3420	3853	0.8876200
A02	140296	141811	A02p00230.2_BraZ1	571.629	-	774	1430	1515	0.9438944
A02	142375	144961	A02p00240.2_BraZ1	897.193	+	1211	2518	2586	0.9737046
A02	146295	147232	A02p00250.2_BraZ1	93	+	209	867	937	0.9252935
A02	148257	156465	A02p00260.2_BraZ1	4053.78	+	1339	5576	8208	0.6793372
A02	158055	159710	A02p00270.2_BraZ1	933	+	886	1632	1655	0.9861027
A02	161205	161705	A02p00280.2_BraZ1	342	-	16	73	500	0.1460000
A02	162946	166254	A02p00290.2_BraZ1	1287	-	253	1555	3308	0.4700725
A02	171038	172887	A02p00300.2_BraZ1	1121.67	+	285	1506	1849	0.8144943
A02	178849	180925	A02p00310.2_BraZ1	1860.85	+	1322	1900	2076	0.9152216
A02	182267	182801	A02p00320.2_BraZ1	53.4	-	3	10	534	0.0187266
A02	187787	190107	A02p00330.2_BraZ1	1521	+	49	548	2320	0.2362069
A02	191075	192657	A02p00340.2_BraZ1	153	-	57	833	1582	0.5265487
A02	201369	201931	A02p00350.2_BraZ1	312	-	2	12	562	0.0213523
A02	202553	203738	A02p00360.2_BraZ1	789	-	775	1168	1185	0.9856540
A02	206159	208535	A02p00370.2_BraZ1	1565.19	-	656	2132	2376	0.8973064
A02	210305	210832	A02p00380.2_BraZ1	330	+	85	504	527	0.9563568
A02	212099	212759	A02p00390.2_BraZ1	66	-	779	660	660	1.0000000
A02	215576	217977	A02p00400.2_BraZ1	1743.5	+	870	2301	2401	0.9583507
A02	219056	220139	A02p00410.2_BraZ1	108.3	-	178	872	1083	0.8051708
A02	223586	223901	A02p00420.2_BraZ1	228	+	7	216	315	0.6857143
A02	224843	226069	A02p00430.2_BraZ1	753.75	-	434	1014	1226	0.8270800
A02	228254	231065	A02p00440.2_BraZ1	1357.2	+	88	1098	2811	0.3906083
A02	233013	234217	A02p00450.2_BraZ1	385	-	293	572	1204	0.4750831
A02	238778	242123	A02p00460.2_BraZ1	1579.5	+	791	2780	3345	0.8310912
A02	245876	247731	A02p00470.2_BraZ1	1055.29	+	618	1676	1855	0.9035040
A02	249734	251235	A02p00480.2_BraZ1	149.1	+	1	65	1501	0.0433045
A02	252832	253057	A02p00490.2_BraZ1	22.5	-	138	225	225	1.0000000
A02	259412	260810	A02p00500.2_BraZ1	724.98	+	151	1115	1398	0.7975680
A02	262382	262688	A02p00510.2_BraZ1	18.9	+	1183	306	306	1.0000000
A02	267316	268982	A02p00520.2_BraZ1	786	+	398	1311	1666	0.7869148
A02	271044	272927	A02p00530.2_BraZ1	1167	-	472	1311	1883	0.6962294
A02	274762	282867	A02p00540.2_BraZ1	5217.39	+	731	4851	8105	0.5985194
A02	283499	283900	A02p00550.2_BraZ1	246	-	236	401	401	1.0000000
A02	287245	290396	A02p00560.2_BraZ1	2416.35	+	492	2209	3151	0.7010473
A02	291717	293030	A02p00570.2_BraZ1	492	+	113	989	1313	0.7532369
A02	301714	303147	A02p00580.2_BraZ1	1221	-	567	1386	1433	0.9672017
A02	305375	307499	A02p00590.2_BraZ1	990.375	+	1493	1988	2124	0.9359699
A02	310356	310716	A02p00600.2_BraZ1	36	-	10	116	360	0.3222222
A02	313530	314303	A02p00610.2_BraZ1	2295	+	274	739	773	0.9560155
A02	314762	315188	A02p00620.2_BraZ1	855	+	312	426	426	1.0000000
A02	315324	315621	A02p00630.2_BraZ1	29.7	-	321	297	297	1.0000000
A02	316989	317286	A02p00640.2_BraZ1	29.7	-	198	297	297	1.0000000
A02	318030	319150	A02p00650.2_BraZ1	5049	-	148	771	1120	0.6883929
A02	319828	320579	A02p00660.2_BraZ1	2592	+	369	741	751	0.9866844
A02	321494	323136	A02p00670.2_BraZ1	1083	+	438	1137	1642	0.6924483
A02	327238	328561	A02p00680.2_BraZ1	770	+	168	1091	1323	0.8246410
A02	328861	329002	A02p00690.2_BraZ1	14.1	+	237	141	141	1.0000000
A02	329784	330688	A02p00700.2_BraZ1	482.625	-	920	904	904	1.0000000
A02	331968	336137	A02p00710.2_BraZ1	1187.57	+	2662	4163	4169	0.9985608
A02	336720	338587	A02p00720.2_BraZ1	1064.47	-	976	1782	1867	0.9544724
A02	339281	342056	A02p00730.2_BraZ1	1598.14	-	908	2480	2775	0.8936937
A02	343898	349813	A02p00740.2_BraZ1	4124.38	+	2689	5300	5915	0.8960270
A02	351403	352924	A02p00750.2_BraZ1	1080	-	1991	1521	1521	1.0000000
A02	354197	354589	A02p00760.2_BraZ1	249	+	682	392	392	1.0000000
A02	355814	357247	A02p00770.2_BraZ1	1083	-	871	1390	1433	0.9699930
A02	359181	360564	A02p00780.2_BraZ1	138.3	+	897	1383	1383	1.0000000
A02	360900	361490	A02p00790.2_BraZ1	394.156	-	140	590	590	1.0000000
A02	362486	363101	A02p00800.2_BraZ1	360	-	82	572	615	0.9300813
A02	363863	365603	A02p00810.2_BraZ1	26927.2	-	649	1662	1740	0.9551724
A02	368160	368864	A02p00820.2_BraZ1	368.333	-	314	617	704	0.8764204
A02	369576	372215	A02p00830.2_BraZ1	1017.9	-	864	2517	2639	0.9537703
A02	372584	373253	A02p00840.2_BraZ1	66.9	+	85	530	669	0.7922272
A02	379347	380229	A02p00850.2_BraZ1	88.2	+	130	742	882	0.8412699
A02	382810	383227	A02p00860.2_BraZ1	321	+	2	129	417	0.3093525
A02	387139	387871	A02p00870.2_BraZ1	73.2	-	125	547	732	0.7472678
A02	388828	390611	A02p00880.2_BraZ1	1080	-	449	1291	1783	0.7240606
A02	394884	395854	A02p00890.2_BraZ1	1325	-	264	970	970	1.0000000
A02	396583	396712	A02p00900.2_BraZ1	12.9	-	237	129	129	1.0000000
A02	397455	400258	A02p00910.2_BraZ1	515.9	-	2427	2803	2803	1.0000000
A02	400321	402585	A02p00920.2_BraZ1	1583.27	-	846	2016	2264	0.8904594
A02	405646	410865	A02p00930.2_BraZ1	1109.52	+	1674	4387	5219	0.8405825
A02	411425	411911	A02p00940.2_BraZ1	219	+	715	486	486	1.0000000
A02	412253	412589	A02p00950.2_BraZ1	33.6	-	695	336	336	1.0000000
A02	417360	419022	A02p00960.2_BraZ1	1239	+	2609	1662	1662	1.0000000
A02	430293	434391	A02p00970.2_BraZ1	942.33	+	6149	4098	4098	1.0000000
A02	434696	435515	A02p00980.2_BraZ1	81.9	-	1285	819	819	1.0000000
A02	436497	437604	A02p00990.2_BraZ1	646.895	+	856	1098	1107	0.9918699
A02	443310	445073	A02p01000.2_BraZ1	1118.89	-	95	1438	1763	0.8156551
A02	447170	450251	A02p01010.2_BraZ1	1458	-	4306	3081	3081	1.0000000
A02	451521	454654	A02p01020.2_BraZ1	1500.86	-	1644	2912	3133	0.9294606
A02	455190	455950	A02p01030.2_BraZ1	230.417	+	807	760	760	1.0000000
A02	456966	458588	A02p01040.2_BraZ1	2103.27	+	276	1488	1622	0.9173859
A02	460888	461695	A02p01050.2_BraZ1	80.7	+	427	807	807	1.0000000
A02	471181	472395	A02p01060.2_BraZ1	598.642	-	0	0	1214	0.0000000
A02	473119	474705	A02p01070.2_BraZ1	1324	+	103	541	1586	0.3411097
A02	476137	476384	A02p01080.2_BraZ1	213	+	1	124	247	0.5020243
A02	477060	478658	A02p01090.2_BraZ1	573.333	-	27	243	1598	0.1520651
A02	479530	480154	A02p01100.2_BraZ1	405.15	-	0	0	624	0.0000000
A02	482170	492997	A02p01110.2_BraZ1	2209.13	+	385	3337	10827	0.3082110
A02	496570	497784	A02p01120.2_BraZ1	598.642	-	0	0	1214	0.0000000
A02	498502	498983	A02p01130.2_BraZ1	321	+	265	475	481	0.9875260
A02	500484	500768	A02p01140.2_BraZ1	26.7	+	114	284	284	1.0000000
A02	504042	504329	A02p01150.2_BraZ1	360	-	59	282	287	0.9825784
A02	504641	505265	A02p01160.2_BraZ1	405.15	-	2	19	624	0.0304487
A02	506952	517817	A02p01170.2_BraZ1	2111.22	+	253	1562	10865	0.1437644
A02	530489	533334	A02p01180.2_BraZ1	1773	+	472	2299	2845	0.8080844
A02	538718	543263	A02p01190.2_BraZ1	600	-	3098	4253	4545	0.9357536
A02	540807	541176	A02p01200.2_BraZ1	33.6	-	59	257	369	0.6964769
A02	543888	544245	A02p01210.2_BraZ1	35.7	+	296	357	357	1.0000000
A02	546417	547604	A02p01220.2_BraZ1	396.455	+	298	1112	1187	0.9368155
A02	559100	560579	A02p01230.2_BraZ1	665	+	502	1164	1479	0.7870182
A02	561161	563795	A02p01240.2_BraZ1	263.4	-	456	2183	2634	0.8287776
A02	564348	566021	A02p01250.2_BraZ1	889.688	-	1196	1579	1673	0.9438135
A02	567877	568148	A02p01260.2_BraZ1	55	+	37	271	271	1.0000000
A02	568135	568906	A02p01270.2_BraZ1	177.222	+	19	181	771	0.2347600
A02	570835	571956	A02p01280.2_BraZ1	540	-	295	887	1121	0.7912578
A02	574934	575817	A02p01290.2_BraZ1	22.9412	-	402	869	883	0.9841450
A02	576345	578912	A02p01300.2_BraZ1	1421.53	-	1378	2352	2567	0.9162446
A02	580832	581876	A02p01310.2_BraZ1	104.4	-	277	974	1044	0.9329502
A02	584172	586798	A02p01320.2_BraZ1	1375.66	+	1369	2545	2626	0.9691546
A02	587621	588530	A02p01330.2_BraZ1	496.8	+	944	909	909	1.0000000
A02	588915	591810	A02p01340.2_BraZ1	1542.88	-	1018	2599	2895	0.8977547
A02	592197	596633	A02p01350.2_BraZ1	592.983	+	502	1989	4436	0.4483769
A02	597300	599026	A02p01360.2_BraZ1	1075	-	95	731	1726	0.4235226
A02	603617	606684	A02p01370.2_BraZ1	2421	+	768	1628	3067	0.5308118
A02	607736	608251	A02p01380.2_BraZ1	19.8	+	594	515	515	1.0000000
A02	613433	614862	A02p01390.2_BraZ1	672.442	+	1000	1364	1429	0.9545137
A02	616492	618045	A02p01400.2_BraZ1	1365	+	526	808	1553	0.5202833
A02	618873	630093	A02p01410.2_BraZ1	1490.34	+	3001	8042	11220	0.7167558
A02	632099	632368	A02p01420.2_BraZ1	117	+	275	269	269	1.0000000
A02	633664	642414	A02p01430.2_BraZ1	2425.34	-	7033	8382	8750	0.9579428
A02	642795	644926	A02p01440.2_BraZ1	3112	+	1422	2120	2131	0.9948381
A02	645216	646188	A02p01450.2_BraZ1	97.2	+	117	724	972	0.7448559
A02	647769	648977	A02p01460.2_BraZ1	852.222	+	406	1060	1208	0.8774834
A02	655665	656001	A02p01470.2_BraZ1	33.6	+	107	336	336	1.0000000
A02	663014	664783	A02p01480.2_BraZ1	382.5	+	1848	1701	1769	0.9615602
A02	665240	665792	A02p01490.2_BraZ1	494.062	+	335	552	552	1.0000000
A02	666109	666502	A02p01500.2_BraZ1	39.3	+	2	60	393	0.1526718
A02	669300	670353	A02p01510.2_BraZ1	105.3	+	519	746	1053	0.7084520
A02	671491	671881	A02p01520.2_BraZ1	39	+	28	321	390	0.8230769
A02	672616	674588	A02p01530.2_BraZ1	1477.13	+	582	1658	1972	0.8407708
A02	675001	677213	A02p01540.2_BraZ1	767.5	-	667	2082	2212	0.9412296
A02	677913	678339	A02p01550.2_BraZ1	42.6	-	74	1	426	0.0023474
A02	680303	680583	A02p01560.2_BraZ1	162	-	31	280	280	1.0000000
A02	687655	688045	A02p01570.2_BraZ1	39	-	6	255	390	0.6538461
A02	694933	697599	A02p01580.2_BraZ1	2074.22	+	985	2513	2666	0.9426107
A02	699310	700699	A02p01590.2_BraZ1	138.9	-	243	1191	1389	0.8574514
A02	702800	707778	A02p01600.2_BraZ1	2293.57	-	1927	4196	4978	0.8429088
A02	708741	710523	A02p01610.2_BraZ1	178.2	-	869	1782	1782	1.0000000
A02	713959	715534	A02p01620.2_BraZ1	667.444	+	1052	1575	1575	1.0000000
A02	717672	718249	A02p01630.2_BraZ1	381	+	898	577	577	1.0000000
A02	718752	720778	A02p01640.2_BraZ1	1822.8	-	293	1927	2026	0.9511352
A02	721631	725047	A02p01650.2_BraZ1	751.872	-	2886	3267	3416	0.9563817
A02	726106	726881	A02p01660.2_BraZ1	642	-	356	775	775	1.0000000
A02	732269	734686	A02p01670.2_BraZ1	519	+	729	1831	2417	0.7575507
A02	735468	736432	A02p01680.2_BraZ1	1440	+	786	964	964	1.0000000
A02	744812	746670	A02p01690.2_BraZ1	807	+	983	1795	1858	0.9660926
A02	746727	748569	A02p01700.2_BraZ1	1104	+	158	1153	1842	0.6259500
A02	749009	750937	A02p01710.2_BraZ1	1902	-	233	1202	1928	0.6234440
A02	750478	751239	A02p01720.2_BraZ1	213	-	338	651	761	0.8554534
A02	752191	754356	A02p01730.2_BraZ1	1301.23	-	628	1913	2165	0.8836028
A02	756013	759093	A02p01740.2_BraZ1	1284.42	+	1812	3042	3080	0.9876623
A02	759876	760534	A02p01750.2_BraZ1	459.692	+	108	652	658	0.9908814
A02	761509	762207	A02p01760.2_BraZ1	4335	-	893	698	698	1.0000000
A02	766230	766892	A02p01770.2_BraZ1	2469.6	+	982	662	662	1.0000000
A02	770726	772753	A02p01780.2_BraZ1	1103.94	+	445	1742	2027	0.8593981
A02	776194	781831	A02p01790.2_BraZ1	1288.17	+	3303	4270	5637	0.7574951
A02	782601	787122	A02p01800.2_BraZ1	2870.95	-	407	3315	4521	0.7332448
A02	787626	789278	A02p01810.2_BraZ1	1014	+	135	1436	1652	0.8692494
A02	789712	789912	A02p01820.2_BraZ1	174	+	169	120	200	0.6000000
A02	790383	792436	A02p01830.2_BraZ1	1272.38	-	1560	1861	2053	0.9064783
A02	793675	795835	A02p01840.2_BraZ1	7182	-	1854	1665	2160	0.7708333
A02	798584	799902	A02p01850.2_BraZ1	744	+	651	1318	1318	1.0000000
A02	800549	801534	A02p01860.2_BraZ1	451.44	-	406	893	985	0.9065990
A02	803262	805105	A02p01870.2_BraZ1	633.75	-	77	1041	1843	0.5648400
A02	809732	810433	A02p01880.2_BraZ1	242.5	-	712	680	701	0.9700428
A02	815687	817897	A02p01890.2_BraZ1	1625.23	+	92	1377	2210	0.6230769
A02	819804	820785	A02p01900.2_BraZ1	98.1	+	693	981	981	1.0000000
A02	822191	822785	A02p01910.2_BraZ1	59.4	+	814	594	594	1.0000000
A02	824001	827265	A02p01920.2_BraZ1	1503.73	+	2148	3237	3264	0.9917279
A02	828062	828626	A02p01930.2_BraZ1	56.4	+	563	564	564	1.0000000
A02	828989	830181	A02p01940.2_BraZ1	479.446	-	465	1024	1192	0.8590604
A02	830944	844172	A02p01950.2_BraZ1	4502.25	+	4471	11598	13228	0.8767765
A02	846870	853216	A02p01960.2_BraZ1	2972.7	+	1717	5236	6346	0.8250867
A02	853840	855758	A02p01970.2_BraZ1	1264.21	+	173	1511	1918	0.7877998
A02	856128	857298	A02p01980.2_BraZ1	1008.19	-	122	866	1170	0.7401710
A02	864150	866867	A02p01990.2_BraZ1	1099.89	+	753	2290	2717	0.8428414
A02	871911	875132	A02p02000.2_BraZ1	1354.33	-	1258	2858	3221	0.8873021
A02	879475	879634	A02p02010.2_BraZ1	15.9	+	52	159	159	1.0000000
A02	879790	880415	A02p02020.2_BraZ1	336	+	194	614	625	0.9824000
A02	880511	880730	A02p02030.2_BraZ1	183	+	111	172	219	0.7853881
A02	885059	885730	A02p02040.2_BraZ1	579	+	109	470	671	0.7004471
A02	886730	888738	A02p02050.2_BraZ1	864.464	+	179	1253	2008	0.6240040
A02	889280	889718	A02p02060.2_BraZ1	43.8	-	113	238	438	0.5433790
A02	892331	893131	A02p02070.2_BraZ1	3870	+	433	773	800	0.9662500
A02	894208	904641	A02p02080.2_BraZ1	2138.43	-	1759	8376	10433	0.8028371
A02	897104	898286	A02p02090.2_BraZ1	388.167	-	97	800	1182	0.6768190
A02	905161	906627	A02p02100.2_BraZ1	616	+	748	1379	1466	0.9406548
A02	907064	908637	A02p02110.2_BraZ1	578.16	-	1458	1573	1573	1.0000000
A02	909923	917557	A02p02120.2_BraZ1	2810.67	+	2859	6345	7634	0.8311501
A02	918264	919764	A02p02130.2_BraZ1	863.545	-	1094	1500	1500	1.0000000
A02	924585	925090	A02p02140.2_BraZ1	261	-	497	505	505	1.0000000
A02	925859	927757	A02p02150.2_BraZ1	1040	-	1240	1898	1898	1.0000000
A02	928704	931832	A02p02160.2_BraZ1	1466.68	-	1437	3122	3128	0.9980819
A02	932189	932941	A02p02170.2_BraZ1	432.833	+	790	752	752	1.0000000
A02	933291	935393	A02p02180.2_BraZ1	1329	-	1016	2081	2102	0.9900095
A02	948480	949560	A02p02190.2_BraZ1	408	+	539	879	1080	0.8138889
A02	952337	952787	A02p02200.2_BraZ1	45	-	824	450	450	1.0000000
A02	955047	958275	A02p02210.2_BraZ1	621	-	775	2853	3228	0.8838290
A02	961560	963605	A02p02220.2_BraZ1	634.63	+	2167	2045	2045	1.0000000
A02	964957	965431	A02p02230.2_BraZ1	46.8	+	229	474	474	1.0000000
A02	968028	968941	A02p02240.2_BraZ1	462	-	975	913	913	1.0000000
A02	969629	970226	A02p02250.2_BraZ1	59.4	-	124	557	597	0.9329983
A02	970960	971515	A02p02260.2_BraZ1	37.5	-	934	555	555	1.0000000
A02	974027	974786	A02p02270.2_BraZ1	75.9	+	19	482	759	0.6350461
A02	976118	984413	A02p02280.2_BraZ1	1662.47	-	3465	7994	8295	0.9637131
A02	985624	987011	A02p02290.2_BraZ1	1005.53	-	926	1387	1387	1.0000000
A02	988217	996512	A02p02300.2_BraZ1	3239.13	-	2484	7168	8295	0.8641350
A02	997492	999435	A02p02310.2_BraZ1	887.857	+	754	1943	1943	1.0000000
A02	999994	1000609	A02p02320.2_BraZ1	61.5	-	45	399	615	0.6487805
A02	1002452	1002992	A02p02330.2_BraZ1	54	+	234	482	540	0.8925926
A02	1005000	1011483	A02p02340.2_BraZ1	2714.52	-	1993	5317	6483	0.8201450
A02	1012816	1015396	A02p02350.2_BraZ1	2511	+	480	2284	2580	0.8852713
A02	1017103	1019338	A02p02360.2_BraZ1	1432.66	+	698	2217	2235	0.9919463
A02	1019880	1021735	A02p02370.2_BraZ1	1176	-	680	1855	1855	1.0000000
A02	1022766	1023318	A02p02380.2_BraZ1	519	-	95	552	552	1.0000000
A02	1031312	1033716	A02p02390.2_BraZ1	836.903	+	609	2150	2404	0.8943428
A02	1034939	1035115	A02p02400.2_BraZ1	102	+	49	176	176	1.0000000
A02	1035021	1036704	A02p02410.2_BraZ1	168.3	+	1191	1683	1683	1.0000000
A02	1037169	1038401	A02p02420.2_BraZ1	6825	-	1355	1232	1232	1.0000000
A02	1038893	1040694	A02p02430.2_BraZ1	1521	-	1187	1801	1801	1.0000000
A02	1041582	1041804	A02p02440.2_BraZ1	22.2	+	127	180	222	0.8108108
A02	1042464	1044570	A02p02450.2_BraZ1	10257	-	1083	2036	2106	0.9667616
A02	1045998	1047716	A02p02460.2_BraZ1	949.857	+	535	1633	1718	0.9505239
A02	1048998	1049757	A02p02470.2_BraZ1	75.9	+	188	622	759	0.8194993
A02	1050492	1051599	A02p02480.2_BraZ1	110.7	-	422	1107	1107	1.0000000
A02	1058068	1059476	A02p02490.2_BraZ1	665.833	-	941	1337	1408	0.9495739
A02	1060179	1061499	A02p02500.2_BraZ1	132	-	107	927	1320	0.7022727
A02	1064476	1065971	A02p02510.2_BraZ1	24115	+	1040	1486	1495	0.9939799
A02	1067042	1068556	A02p02520.2_BraZ1	728.889	+	283	1315	1514	0.8685601
A02	1074946	1075966	A02p02530.2_BraZ1	74.7	-	80	681	1020	0.6676471
A02	1083177	1084665	A02p02540.2_BraZ1	1110	-	908	1481	1488	0.9952957
A02	1094834	1101656	A02p02550.2_BraZ1	1926.91	+	2113	5784	6822	0.8478452
A02	1102592	1104121	A02p02560.2_BraZ1	1366.67	-	191	1206	1529	0.7887508
A02	1111137	1112021	A02p02570.2_BraZ1	179.2	+	496	676	884	0.7647059
A02	1115139	1117691	A02p02580.2_BraZ1	1031.8	+	2865	2436	2552	0.9545454
A02	1118312	1118501	A02p02590.2_BraZ1	18.9	-	215	189	189	1.0000000
A02	1120848	1126042	A02p02600.2_BraZ1	2738.06	-	3055	5052	5194	0.9726608
A02	1128487	1132868	A02p02610.2_BraZ1	2764.6	+	1235	3782	4381	0.8632732
A02	1135597	1137137	A02p02620.2_BraZ1	797.143	-	109	599	1540	0.3889610
A02	1137931	1139681	A02p02630.2_BraZ1	1055.6	+	267	1393	1750	0.7960000
A02	1141129	1142650	A02p02640.2_BraZ1	325.8	+	68	1092	1521	0.7179487
A02	1144683	1147136	A02p02650.2_BraZ1	1157.72	+	590	2330	2453	0.9498573
A02	1149370	1151407	A02p02660.2_BraZ1	1065.89	+	342	1667	2037	0.8183603
A02	1152970	1153983	A02p02670.2_BraZ1	618	-	86	683	1013	0.6742349
A02	1154712	1155417	A02p02680.2_BraZ1	108	+	463	585	705	0.8297873
A02	1158445	1165916	A02p02690.2_BraZ1	14971.5	-	2221	6433	7471	0.8610628
A02	1168774	1169757	A02p02700.2_BraZ1	486	-	1081	923	983	0.9389623
A02	1171188	1172293	A02p02710.2_BraZ1	450	-	772	925	1105	0.8371041
A02	1174063	1174612	A02p02720.2_BraZ1	54.9	+	451	549	549	1.0000000
A02	1175916	1182440	A02p02730.2_BraZ1	2114.17	+	4852	6524	6524	1.0000000
A02	1185934	1191795	A02p02740.2_BraZ1	2781.84	+	3303	5710	5861	0.9742365
A02	1192358	1194078	A02p02750.2_BraZ1	1341	+	931	1679	1720	0.9761628
A02	1197545	1198763	A02p02760.2_BraZ1	870.395	+	448	1145	1218	0.9400657
A02	1202421	1209697	A02p02770.2_BraZ1	4046.25	-	4450	6957	7276	0.9561572
A02	1211364	1213892	A02p02780.2_BraZ1	1383	-	316	1773	2528	0.7013449
A02	1217688	1219271	A02p02790.2_BraZ1	11600	+	1200	1558	1583	0.9842072
A02	1219723	1221920	A02p02800.2_BraZ1	732.6	-	628	2042	2197	0.9294493
A02	1222656	1225628	A02p02810.2_BraZ1	2030	-	740	2464	2972	0.8290713
A02	1228102	1235887	A02p02820.2_BraZ1	505	+	4459	5885	7785	0.7559409
A02	1238766	1243640	A02p02830.2_BraZ1	3763.64	+	249	2720	4874	0.5580632
A02	1244212	1245594	A02p02840.2_BraZ1	718.667	-	1068	1382	1382	1.0000000
A02	1245914	1246888	A02p02850.2_BraZ1	320.944	+	894	974	974	1.0000000
A02	1247637	1248209	A02p02860.2_BraZ1	165	-	633	572	572	1.0000000
A02	1248618	1248999	A02p02870.2_BraZ1	38.1	+	209	381	381	1.0000000
A02	1254240	1257409	A02p02880.2_BraZ1	666	-	2778	2770	3169	0.8740928
A02	1260954	1262983	A02p02890.2_BraZ1	973.378	-	1115	1961	2029	0.9664860
A02	1263884	1265510	A02p02900.2_BraZ1	448.5	-	2091	1626	1626	1.0000000
A02	1266451	1268395	A02p02910.2_BraZ1	594.205	+	1621	1944	1944	1.0000000
A02	1269472	1271392	A02p02920.2_BraZ1	1090.61	+	1381	1920	1920	1.0000000
A02	1271645	1273642	A02p02930.2_BraZ1	1012.03	-	166	1770	1997	0.8863295
A02	1276481	1278354	A02p02940.2_BraZ1	971.833	+	1026	1864	1873	0.9951949
A02	1278660	1279796	A02p02950.2_BraZ1	81	-	1224	1136	1136	1.0000000
A02	1280488	1280871	A02p02960.2_BraZ1	240	-	243	383	383	1.0000000
A02	1282359	1282736	A02p02970.2_BraZ1	218.182	-	39	281	377	0.7453581
A02	1283731	1284982	A02p02980.2_BraZ1	453	+	450	951	1251	0.7601919
A02	1286260	1286953	A02p02990.2_BraZ1	69.3	+	104	673	693	0.9711400
A02	1288029	1290276	A02p03000.2_BraZ1	985.812	-	1092	2037	2247	0.9065421
A02	1291436	1293691	A02p03010.2_BraZ1	1081.52	-	799	2050	2255	0.9090909
A02	1295519	1295729	A02p03020.2_BraZ1	21	+	80	210	210	1.0000000
A02	1298737	1300407	A02p03030.2_BraZ1	713.417	-	1219	1594	1670	0.9544910
A02	1300931	1303223	A02p03040.2_BraZ1	1088.31	-	1182	2292	2292	1.0000000
A02	1304192	1306403	A02p03050.2_BraZ1	835.852	+	2057	2211	2211	1.0000000
A02	1307309	1309840	A02p03060.2_BraZ1	1678.44	+	839	2290	2531	0.9047807
A02	1310924	1311407	A02p03070.2_BraZ1	48.3	+	161	483	483	1.0000000
A02	1311905	1312822	A02p03080.2_BraZ1	846	-	227	750	917	0.8178844
A02	1314410	1314617	A02p03090.2_BraZ1	20.7	-	86	207	207	1.0000000
A02	1317068	1321982	A02p03100.2_BraZ1	312	+	1686	4750	4914	0.9666260
A02	1322122	1325228	A02p03110.2_BraZ1	1642.5	+	590	2771	3106	0.8921443
A02	1325557	1330080	A02p03120.2_BraZ1	422.124	-	3965	4381	4523	0.9686049
A02	1332315	1335353	A02p03130.2_BraZ1	1842.86	+	2064	3013	3038	0.9917709
A02	1335791	1338187	A02p03140.2_BraZ1	1686.95	-	350	1938	2396	0.8088481
A02	1340019	1342389	A02p03150.2_BraZ1	1534.73	+	903	2307	2370	0.9734177
A02	1342896	1345643	A02p03160.2_BraZ1	1137.41	-	2262	2741	2747	0.9978158
A02	1346603	1348028	A02p03170.2_BraZ1	142.5	-	380	1349	1425	0.9466667
A02	1349713	1350201	A02p03180.2_BraZ1	31.8	+	109	402	488	0.8237705
A02	1351422	1352476	A02p03190.2_BraZ1	844.412	-	281	1054	1054	1.0000000
A02	1355768	1356421	A02p03200.2_BraZ1	216	-	465	653	653	1.0000000
A02	1357284	1359013	A02p03210.2_BraZ1	985.5	+	397	1607	1729	0.9294390
A02	1359315	1360226	A02p03220.2_BraZ1	315.692	-	606	911	911	1.0000000
A02	1361300	1361639	A02p03230.2_BraZ1	33.9	+	163	339	339	1.0000000
A02	1362458	1363977	A02p03240.2_BraZ1	1155.56	-	509	1519	1519	1.0000000
A02	1365821	1366920	A02p03250.2_BraZ1	519	-	526	1063	1099	0.9672430
A02	1368800	1369103	A02p03260.2_BraZ1	17.1	+	86	190	303	0.6270627
A02	1372249	1372669	A02p03270.2_BraZ1	363	+	201	420	420	1.0000000
A02	1376371	1376924	A02p03280.2_BraZ1	468	+	339	553	553	1.0000000
A02	1378709	1379885	A02p03290.2_BraZ1	991.059	+	613	1176	1176	1.0000000
A02	1384038	1384926	A02p03300.2_BraZ1	88.8	+	556	888	888	1.0000000
A02	1389036	1389949	A02p03310.2_BraZ1	90.9	+	333	913	913	1.0000000
A02	1391151	1391499	A02p03320.2_BraZ1	34.8	+	326	348	348	1.0000000
A02	1391851	1393431	A02p03330.2_BraZ1	8505	+	281	1423	1580	0.9006329
A02	1393838	1394183	A02p03340.2_BraZ1	34.5	-	380	345	345	1.0000000
A02	1533175	1533731	A02p03350.2_BraZ1	258	-	494	556	556	1.0000000
A02	1534366	1537120	A02p03360.2_BraZ1	798.188	-	1314	2754	2754	1.0000000
A02	1537970	1540297	A02p03370.2_BraZ1	1219.07	+	645	2119	2327	0.9106146
A02	1543369	1545332	A02p03380.2_BraZ1	944	+	1707	1963	1963	1.0000000
A02	1545797	1549142	A02p03390.2_BraZ1	1944.94	+	2348	3328	3345	0.9949178
A02	1555371	1563599	A02p03400.2_BraZ1	884.759	+	2588	5340	8228	0.6490034
A02	1556305	1557802	A02p03410.2_BraZ1	149.7	-	29	638	1497	0.4261857
A02	1564066	1564692	A02p03420.2_BraZ1	225	+	72	563	626	0.8993610
A02	1564626	1564909	A02p03430.2_BraZ1	120	+	32	239	283	0.8445230
A02	1565757	1568641	A02p03440.2_BraZ1	782	+	704	2057	2884	0.7132455
A02	1569038	1570385	A02p03450.2_BraZ1	1611	-	445	1344	1347	0.9977728
A02	1570842	1571204	A02p03460.2_BraZ1	243	-	903	362	362	1.0000000
A02	1571156	1572309	A02p03470.2_BraZ1	270	+	2392	1153	1153	1.0000000
A02	1574400	1576358	A02p03480.2_BraZ1	907.443	-	1153	1958	1958	1.0000000
A02	1576979	1580759	A02p03490.2_BraZ1	5166	-	3190	3780	3780	1.0000000
A02	1581793	1584136	A02p03500.2_BraZ1	1031.73	-	1427	2341	2343	0.9991464
A02	1587524	1588169	A02p03510.2_BraZ1	64.5	-	480	645	645	1.0000000
A02	1596959	1598996	A02p03520.2_BraZ1	950.4	-	797	1978	2037	0.9710358
A02	1601045	1601315	A02p03530.2_BraZ1	27	+	47	232	270	0.8592592
A02	1603897	1605584	A02p03540.2_BraZ1	1281	-	163	1068	1687	0.6330765
A02	1609158	1610541	A02p03550.2_BraZ1	94122	+	299	1345	1383	0.9725235
A02	1612057	1614469	A02p03560.2_BraZ1	938.4	-	185	1057	2412	0.4382255
A02	1617223	1620766	A02p03570.2_BraZ1	1809.5	+	2182	3543	3543	1.0000000
A02	1621531	1624790	A02p03580.2_BraZ1	1534.74	-	1395	3124	3259	0.9585763
A02	1625410	1626011	A02p03590.2_BraZ1	268.103	-	460	601	601	1.0000000
A02	1626010	1628501	A02p03600.2_BraZ1	650	-	1560	2491	2491	1.0000000
A02	1630686	1631157	A02p03610.2_BraZ1	47.1	+	500	471	471	1.0000000
A02	1631673	1632844	A02p03620.2_BraZ1	418.345	+	1590	1171	1171	1.0000000
A02	1633800	1634415	A02p03630.2_BraZ1	61.5	+	86	541	615	0.8796748
A02	1635259	1636726	A02p03640.2_BraZ1	342	+	545	1110	1467	0.7566462
A02	1638138	1638739	A02p03650.2_BraZ1	243	+	125	427	601	0.7104825
A02	1639924	1645976	A02p03660.2_BraZ1	1418.17	+	4101	6033	6052	0.9968606
A02	1646632	1648495	A02p03670.2_BraZ1	1089	-	847	1694	1863	0.9092861
A02	1654445	1655819	A02p03680.2_BraZ1	513.882	+	1808	1374	1374	1.0000000
A02	1656404	1662588	A02p03690.2_BraZ1	2740.57	-	4678	6055	6184	0.9791397
A02	1664280	1665648	A02p03700.2_BraZ1	136.8	+	269	1186	1368	0.8669590
A02	1666173	1667032	A02p03710.2_BraZ1	501	-	198	789	859	0.9185099
A02	1669684	1672961	A02p03720.2_BraZ1	517.333	-	2956	3211	3277	0.9798597
A02	1675103	1676705	A02p03730.2_BraZ1	1083.64	-	494	1557	1602	0.9719101
A02	1678732	1680111	A02p03740.2_BraZ1	660.8	+	543	1187	1379	0.8607687
A02	1680845	1683755	A02p03750.2_BraZ1	1401.38	-	432	2474	2910	0.8501718
A02	1688194	1691839	A02p03760.2_BraZ1	1556.89	+	915	3381	3645	0.9275720
A02	1694351	1696586	A02p03770.2_BraZ1	13736.2	+	950	1814	2235	0.8116331
A02	1704853	1706023	A02p03780.2_BraZ1	971.75	+	446	1147	1170	0.9803419
A02	1707277	1710434	A02p03790.2_BraZ1	1696.91	-	779	2534	3157	0.8026608
A02	1714913	1715357	A02p03800.2_BraZ1	351	-	253	444	444	1.0000000
A02	1716877	1717910	A02p03810.2_BraZ1	11965.8	-	451	1021	1033	0.9883834
A02	1718725	1719139	A02p03820.2_BraZ1	41.1	-	43	341	414	0.8236715
A02	1720018	1722271	A02p03830.2_BraZ1	1221.19	-	1555	2147	2253	0.9529516
A02	1723937	1726227	A02p03840.2_BraZ1	538.2	-	1881	2094	2290	0.9144105
A02	1728136	1728556	A02p03850.2_BraZ1	42	-	24	327	420	0.7785714
A02	1731041	1731279	A02p03860.2_BraZ1	216	-	141	238	238	1.0000000
A02	1731676	1732400	A02p03870.2_BraZ1	360	-	787	724	724	1.0000000
A02	1733497	1735216	A02p03880.2_BraZ1	924	+	685	1719	1719	1.0000000
A02	1745242	1748873	A02p03890.2_BraZ1	1653.55	+	648	3514	3631	0.9677775
A02	1749263	1751186	A02p03900.2_BraZ1	1640.25	-	936	1859	1923	0.9667187
A02	1753148	1754828	A02p03910.2_BraZ1	116.7	-	257	1339	1680	0.7970238
A02	1754828	1755106	A02p03920.2_BraZ1	198	-	273	278	278	1.0000000
A02	1756251	1760029	A02p03930.2_BraZ1	1940.82	+	2957	3778	3778	1.0000000
A02	1763600	1764915	A02p03940.2_BraZ1	735	+	710	1150	1315	0.8745247
A02	1765918	1770055	A02p03950.2_BraZ1	1605.59	+	3464	4034	4137	0.9751027
A02	1770557	1772074	A02p03960.2_BraZ1	533.143	-	1379	1517	1517	1.0000000
A02	1773763	1774795	A02p03970.2_BraZ1	103.2	+	1334	1032	1032	1.0000000
A02	1775008	1777923	A02p03980.2_BraZ1	1563.84	-	1441	2431	2915	0.8339623
A02	1783217	1787058	A02p03990.2_BraZ1	2096.42	+	1477	3434	3841	0.8940380
A02	1787289	1789153	A02p04000.2_BraZ1	279.643	-	1138	1735	1864	0.9307940
A02	1790209	1791589	A02p04010.2_BraZ1	138	+	130	968	1380	0.7014493
A02	1791958	1793905	A02p04020.2_BraZ1	638.179	-	641	1744	1947	0.8957371
A02	1797573	1799145	A02p04030.2_BraZ1	8943.75	-	1482	1572	1572	1.0000000
A02	1799820	1802078	A02p04040.2_BraZ1	1314.5	-	1000	2070	2258	0.9167405
A02	1813178	1815540	A02p04050.2_BraZ1	540.404	+	1179	2273	2362	0.9623201
A02	1815803	1818889	A02p04060.2_BraZ1	473.25	-	2326	2850	3086	0.9235256
A02	1819344	1820212	A02p04070.2_BraZ1	786	+	171	849	868	0.9781106
A02	1820425	1830892	A02p04080.2_BraZ1	1583.97	-	4641	7951	10467	0.7596255
A02	1824836	1826336	A02p04090.2_BraZ1	648	-	214	521	1500	0.3473333
A02	1828421	1829934	A02p04100.2_BraZ1	752.143	-	713	1445	1513	0.9550562
A02	1831003	1831474	A02p04110.2_BraZ1	303	-	600	471	471	1.0000000
A02	1832762	1836672	A02p04120.2_BraZ1	1005.53	-	2366	3792	3910	0.9698210
A02	1837180	1837530	A02p04130.2_BraZ1	258	+	696	350	350	1.0000000
A02	1837919	1838525	A02p04140.2_BraZ1	3989.12	-	120	479	606	0.7904291
A02	1840076	1840523	A02p04150.2_BraZ1	44.7	+	255	447	447	1.0000000
A02	1841815	1842841	A02p04160.2_BraZ1	102.6	-	128	612	1026	0.5964912
A02	1845055	1845969	A02p04170.2_BraZ1	36.3	+	394	766	914	0.8380744
A02	1849834	1852212	A02p04180.2_BraZ1	945.6	+	341	1404	2378	0.5904121
A02	1855076	1855514	A02p04190.2_BraZ1	43.8	-	635	438	438	1.0000000
A02	1859367	1860517	A02p04200.2_BraZ1	672	+	941	1114	1150	0.9686956
A02	1865781	1868895	A02p04210.2_BraZ1	1650.61	+	1468	3114	3114	1.0000000
A02	1869792	1872248	A02p04220.2_BraZ1	1326.1	+	1517	2365	2456	0.9629479
A02	1873535	1874641	A02p04230.2_BraZ1	480	-	218	925	1106	0.8363472
A02	1879092	1881895	A02p04240.2_BraZ1	1141.33	-	1501	2803	2803	1.0000000
A02	1882521	1885568	A02p04250.2_BraZ1	1046.99	+	1418	2677	3047	0.8785691
A02	1885917	1889746	A02p04260.2_BraZ1	2432.7	-	1811	3495	3829	0.9127710
A02	1890498	1894255	A02p04270.2_BraZ1	784.539	-	904	2071	3757	0.5512377
A02	1892810	1894016	A02p04280.2_BraZ1	933	-	2	119	1206	0.0986733
A02	1895322	1898538	A02p04290.2_BraZ1	1571.29	+	2954	3015	3216	0.9375000
A02	1898940	1899835	A02p04300.2_BraZ1	4814	-	226	748	895	0.8357542
A02	1903350	1905430	A02p04310.2_BraZ1	1236	-	1093	1621	2080	0.7793269
A02	1911337	1913091	A02p04320.2_BraZ1	2296	+	426	778	1754	0.4435576
A02	1913520	1915143	A02p04330.2_BraZ1	1380	-	78	1046	1623	0.6444855
A02	1917445	1918514	A02p04340.2_BraZ1	306.667	+	492	1069	1069	1.0000000
A02	1919006	1919252	A02p04350.2_BraZ1	24.6	+	665	246	246	1.0000000
A02	1925523	1927700	A02p04360.2_BraZ1	1174.4	+	2219	2145	2177	0.9853009
A02	1929179	1929776	A02p04370.2_BraZ1	489	-	951	597	597	1.0000000
A02	1930695	1931551	A02p04380.2_BraZ1	687	-	1164	856	856	1.0000000
A02	1933886	1934249	A02p04390.2_BraZ1	36.3	-	435	363	363	1.0000000
A02	1945948	1949287	A02p04400.2_BraZ1	2612.39	+	3438	3339	3339	1.0000000
A02	1949840	1952182	A02p04410.2_BraZ1	1597.5	-	685	2130	2342	0.9094791
A02	1955335	1956289	A02p04420.2_BraZ1	92.7	-	266	954	954	1.0000000
A02	1957389	1961599	A02p04430.2_BraZ1	2574	-	3017	4210	4210	1.0000000
A02	1962488	1964694	A02p04440.2_BraZ1	1561.61	+	1547	1986	2206	0.9002720
A02	1968760	1969465	A02p04450.2_BraZ1	70.5	-	421	705	705	1.0000000
A02	1973707	1974844	A02p04460.2_BraZ1	531.692	-	149	992	1137	0.8724714
A02	1975453	1975757	A02p04470.2_BraZ1	24.6	-	142	303	304	0.9967105
A02	1976104	1976520	A02p04480.2_BraZ1	954.462	+	128	416	416	1.0000000
A02	1977583	1979917	A02p04490.2_BraZ1	725.625	+	1258	2214	2334	0.9485861
A02	1981501	1985121	A02p04500.2_BraZ1	1618.51	+	1380	3382	3620	0.9342542
A02	1985946	1988991	A02p04510.2_BraZ1	1546.46	+	1474	3034	3045	0.9963875
A02	1989481	1991143	A02p04520.2_BraZ1	166.2	-	910	1662	1662	1.0000000
A02	1995185	1995380	A02p04530.2_BraZ1	19.5	+	189	195	195	1.0000000
A02	1996756	1997901	A02p04540.2_BraZ1	655.941	+	672	1145	1145	1.0000000
A02	1998383	1999630	A02p04550.2_BraZ1	660	-	3364	1247	1247	1.0000000
A02	2002149	2002545	A02p04560.2_BraZ1	39.6	-	101	396	396	1.0000000
A02	2005206	2008219	A02p04570.2_BraZ1	973.459	+	379	2410	3013	0.7998672
A02	2008888	2012611	A02p04580.2_BraZ1	1227.62	-	915	2812	3723	0.7553049
A02	2018563	2019103	A02p04590.2_BraZ1	52.5	-	81	353	540	0.6537037
A02	2020032	2020545	A02p04600.2_BraZ1	50.7	-	45	155	513	0.3021443
A02	2021428	2025981	A02p04610.2_BraZ1	2235.89	-	737	4002	4553	0.8789809
A02	2028158	2031224	A02p04620.2_BraZ1	4016.25	+	1087	2782	3066	0.9073712
A02	2032195	2035268	A02p04630.2_BraZ1	2140.31	+	242	2212	3073	0.7198178
A02	2035933	2039952	A02p04640.2_BraZ1	12232.5	-	5355	4019	4019	1.0000000
A02	2042653	2044062	A02p04650.2_BraZ1	607.885	+	756	1392	1409	0.9879347
A02	2046545	2050098	A02p04660.2_BraZ1	1232.24	-	2172	3372	3553	0.9490572
A02	2054944	2055118	A02p04670.2_BraZ1	17.4	+	176	174	174	1.0000000
A02	2059118	2062369	A02p04680.2_BraZ1	1562.73	-	2844	3251	3251	1.0000000
A02	2063897	2066453	A02p04690.2_BraZ1	1722.6	-	289	1991	2556	0.7789515
A02	2068161	2069652	A02p04700.2_BraZ1	1341	-	766	1491	1491	1.0000000
A02	2073246	2073899	A02p04710.2_BraZ1	46.5	-	589	653	653	1.0000000
A02	2076156	2077191	A02p04720.2_BraZ1	103.5	+	478	1035	1035	1.0000000
A02	2086110	2091618	A02p04730.2_BraZ1	1640.33	-	1983	5481	5508	0.9950981
A02	2091737	2092294	A02p04740.2_BraZ1	225	-	46	557	557	1.0000000
A02	2093486	2095067	A02p04750.2_BraZ1	158.1	-	947	1581	1581	1.0000000
A02	2096736	2099121	A02p04760.2_BraZ1	1069.34	+	464	2246	2385	0.9417191
A02	2100028	2100405	A02p04770.2_BraZ1	306	-	197	377	377	1.0000000
A02	2101475	2105108	A02p04780.2_BraZ1	1228.92	+	1245	2791	3633	0.7682356
A02	2106110	2108350	A02p04790.2_BraZ1	1516.7	+	443	2015	2240	0.8995536
A02	2113293	2114881	A02p04800.2_BraZ1	274.167	-	848	1470	1588	0.9256927
A02	2119351	2119624	A02p04810.2_BraZ1	27.3	+	608	273	273	1.0000000
A02	2121815	2124001	A02p04820.2_BraZ1	1071	-	1187	2186	2186	1.0000000
A02	2125016	2128683	A02p04830.2_BraZ1	1495.38	-	1445	3484	3667	0.9500955
A02	2135540	2138199	A02p04840.2_BraZ1	128.4	-	495	2087	2659	0.7848815
A02	2142661	2143342	A02p04850.2_BraZ1	67.5	-	58	602	681	0.8839941
A02	2149465	2149776	A02p04860.2_BraZ1	276	-	0	0	311	0.0000000
A02	2156072	2157314	A02p04870.2_BraZ1	569.25	-	0	0	1242	0.0000000
A02	2157341	2158243	A02p04880.2_BraZ1	591	-	0	0	902	0.0000000
A02	2160748	2165118	A02p04890.2_BraZ1	2596.16	+	905	3615	4370	0.8272311
A02	2165711	2166626	A02p04900.2_BraZ1	487.35	-	476	915	915	1.0000000
A02	2167615	2174002	A02p04910.2_BraZ1	4614	+	1612	5625	6387	0.8806952
A02	2175761	2178438	A02p04920.2_BraZ1	1060.36	-	765	2317	2677	0.8655211
A02	2188549	2189666	A02p04930.2_BraZ1	651.75	-	1074	1063	1117	0.9516562
A02	2192346	2195752	A02p04940.2_BraZ1	1543.5	+	1134	3310	3406	0.9718145
A02	2198580	2200580	A02p04950.2_BraZ1	840	-	1431	1865	2000	0.9325000
A02	2203800	2205768	A02p04960.2_BraZ1	1446	-	903	1942	1968	0.9867886
A02	2207551	2209286	A02p04970.2_BraZ1	1218.24	-	1074	1704	1735	0.9821326
A02	2212203	2213322	A02p04980.2_BraZ1	111.9	+	463	1022	1119	0.9133155
A02	2218174	2222292	A02p04990.2_BraZ1	2559.03	+	2373	3990	4118	0.9689170
A02	2222813	2223293	A02p05000.2_BraZ1	255	-	285	480	480	1.0000000
A02	2224047	2233755	A02p05010.2_BraZ1	594	-	3657	9248	9708	0.9526164
A02	2235451	2241303	A02p05020.2_BraZ1	3326.28	+	638	4271	5852	0.7298359
A02	2241968	2247068	A02p05030.2_BraZ1	1604.84	-	3556	5026	5100	0.9854902
A02	2248460	2252323	A02p05040.2_BraZ1	2003.82	+	1219	3242	3863	0.8392441
A02	2253433	2254151	A02p05050.2_BraZ1	582	+	235	690	718	0.9610028
A02	2256138	2258177	A02p05060.2_BraZ1	756.8	+	1522	2039	2039	1.0000000
A02	2258668	2259825	A02p05070.2_BraZ1	813	-	525	1157	1157	1.0000000
A02	2261466	2263805	A02p05080.2_BraZ1	1248.38	+	1055	2256	2339	0.9645147
A02	2265807	2267567	A02p05090.2_BraZ1	811.477	-	260	1265	1760	0.7187500
A02	2284485	2285399	A02p05100.2_BraZ1	760.909	+	71	563	914	0.6159738
A02	2298524	2299685	A02p05110.2_BraZ1	394.875	-	798	1087	1161	0.9362618
A02	2300245	2301614	A02p05120.2_BraZ1	7371	+	305	1119	1369	0.8173850
A02	2304455	2305786	A02p05130.2_BraZ1	488.929	+	376	1165	1331	0.8752818
A02	2313748	2320098	A02p05140.2_BraZ1	1387.93	+	3719	6260	6350	0.9858268
A02	2321722	2324851	A02p05150.2_BraZ1	1443	+	1219	3027	3129	0.9674017
A02	2325076	2326967	A02p05160.2_BraZ1	1299	-	658	1829	1891	0.9672131
A02	2331466	2333873	A02p05170.2_BraZ1	946.776	+	439	2195	2407	0.9119235
A02	2335322	2337309	A02p05180.2_BraZ1	750	+	1098	1968	1987	0.9904379
A02	2341619	2344740	A02p05190.2_BraZ1	1303.37	+	1544	2991	3121	0.9583467
A02	2345831	2347620	A02p05200.2_BraZ1	196.625	+	1106	1789	1789	1.0000000
A02	2347899	2348382	A02p05210.2_BraZ1	48.3	+	463	483	483	1.0000000
A02	2349272	2353300	A02p05220.2_BraZ1	3296.52	+	639	2853	4028	0.7082919
A02	2353478	2355659	A02p05230.2_BraZ1	1635.38	-	797	2113	2181	0.9688216
A02	2356444	2358296	A02p05240.2_BraZ1	647.727	-	2396	1852	1852	1.0000000
A02	2358702	2360883	A02p05250.2_BraZ1	1160.02	-	1285	2168	2181	0.9940394
A02	2361565	2362915	A02p05260.2_BraZ1	326.7	+	235	1116	1350	0.8266667
A02	2365812	2367581	A02p05270.2_BraZ1	1414.29	-	1696	1769	1769	1.0000000
A02	2368765	2370622	A02p05280.2_BraZ1	357.254	-	1435	1857	1857	1.0000000
A02	2370662	2381866	A02p05290.2_BraZ1	1878.06	-	4353	10328	11204	0.9218137
A02	2374252	2375975	A02p05300.2_BraZ1	1018.76	+	625	1479	1723	0.8583865
A02	2376240	2377206	A02p05310.2_BraZ1	471	+	805	966	966	1.0000000
A02	2382919	2384303	A02p05320.2_BraZ1	2466.47	+	409	1359	1384	0.9819364
A02	2384692	2386612	A02p05330.2_BraZ1	888.835	+	2220	1920	1920	1.0000000
A02	2387141	2387807	A02p05340.2_BraZ1	66.6	+	239	666	666	1.0000000
A02	2387911	2390540	A02p05350.2_BraZ1	1588.23	-	1706	2576	2629	0.9798402
A02	2392188	2396172	A02p05360.2_BraZ1	1732.42	-	1492	3861	3984	0.9691265
A02	2397212	2399443	A02p05370.2_BraZ1	11142.9	+	1634	2223	2231	0.9964142
A02	2401545	2404915	A02p05380.2_BraZ1	14941.7	-	478	2911	3370	0.8637982
A02	2407166	2409339	A02p05390.2_BraZ1	1843.57	+	1232	2019	2173	0.9291303
A02	2409802	2410950	A02p05400.2_BraZ1	888	-	168	937	1148	0.8162021
A02	2416820	2417891	A02p05410.2_BraZ1	849	-	498	944	1071	0.8814192
A02	2420377	2423927	A02p05420.2_BraZ1	2277.72	+	2557	3550	3550	1.0000000
A02	2424912	2437372	A02p05430.2_BraZ1	2508.29	+	2673	7627	12460	0.6121188
A02	2437672	2439304	A02p05440.2_BraZ1	1152.67	-	271	1257	1632	0.7702206
A02	2441484	2445906	A02p05450.2_BraZ1	1149.91	+	1597	3999	4422	0.9043419
A02	2448102	2448302	A02p05460.2_BraZ1	18.3	+	93	200	200	1.0000000
A02	2449012	2451260	A02p05470.2_BraZ1	747.333	-	1418	2218	2248	0.9866548
A02	2452269	2453537	A02p05480.2_BraZ1	796.5	+	826	1266	1268	0.9984227
A02	2453646	2455706	A02p05490.2_BraZ1	2590.33	-	1516	1793	2060	0.8703883
A02	2457788	2463772	A02p05500.2_BraZ1	1241.22	+	4792	5984	5984	1.0000000
A02	2463861	2464818	A02p05510.2_BraZ1	31.0962	+	1083	957	957	1.0000000
A02	2465272	2465655	A02p05520.2_BraZ1	144.237	+	297	366	383	0.9556136
A02	2468310	2470642	A02p05530.2_BraZ1	1448.53	+	550	1192	2332	0.5111492
A02	2471801	2473643	A02p05540.2_BraZ1	184.2	+	625	1496	1842	0.8121607
A02	2475885	2478635	A02p05550.2_BraZ1	1277.14	-	1874	2686	2750	0.9767272
A02	2482066	2484248	A02p05560.2_BraZ1	749.211	+	2196	2182	2182	1.0000000
A02	2485577	2486452	A02p05570.2_BraZ1	390	-	293	806	875	0.9211429
A02	2488463	2489693	A02p05580.2_BraZ1	123	-	487	1149	1230	0.9341463
A02	2490141	2493245	A02p05590.2_BraZ1	850.043	-	765	2214	3104	0.7132732
A02	2498461	2499913	A02p05600.2_BraZ1	1185	+	543	1452	1452	1.0000000
A02	2500117	2502768	A02p05610.2_BraZ1	1351.3	-	208	1820	2651	0.6865334
A02	2503593	2506801	A02p05620.2_BraZ1	1174.35	-	2280	3148	3208	0.9812968
A02	2507673	2509208	A02p05630.2_BraZ1	507	+	1640	1535	1535	1.0000000
A02	2510069	2511203	A02p05640.2_BraZ1	489.375	+	844	1089	1134	0.9603174
A02	2512157	2513784	A02p05650.2_BraZ1	1007.54	-	903	1627	1627	1.0000000
A02	2519495	2519959	A02p05660.2_BraZ1	41.4	+	122	411	464	0.8857759
A02	2521247	2521789	A02p05670.2_BraZ1	228	-	629	542	542	1.0000000
A02	2522845	2525123	A02p05680.2_BraZ1	889.647	-	898	2252	2278	0.9885865
A02	2528848	2530759	A02p05690.2_BraZ1	1085.33	+	1480	1911	1911	1.0000000
A02	2533449	2533671	A02p05700.2_BraZ1	22.2	+	152	222	222	1.0000000
A02	2534263	2534791	A02p05710.2_BraZ1	315	-	759	528	528	1.0000000
A02	2535064	2540640	A02p05720.2_BraZ1	2127.9	+	4652	5576	5576	1.0000000
A02	2541416	2541915	A02p05730.2_BraZ1	3391.5	-	621	499	499	1.0000000
A02	2543260	2543509	A02p05740.2_BraZ1	23.4	-	85	249	249	1.0000000
A02	2546348	2546898	A02p05750.2_BraZ1	4161	-	184	515	550	0.9363636
A02	2549123	2549871	A02p05760.2_BraZ1	1207.5	+	125	223	748	0.2981283
A02	2550430	2552068	A02p05770.2_BraZ1	2214	-	762	1580	1638	0.9645910
A02	2553752	2556837	A02p05780.2_BraZ1	12004.5	-	579	1934	3085	0.6269044
A02	2560003	2563045	A02p05790.2_BraZ1	1233.24	+	722	2311	3042	0.7596976
A02	2563866	2566256	A02p05800.2_BraZ1	1310.52	-	262	1751	2390	0.7326360
A02	2572226	2573668	A02p05810.2_BraZ1	802.088	-	341	1313	1442	0.9105409
A02	2576534	2578111	A02p05820.2_BraZ1	1167	+	890	1428	1577	0.9055168
A02	2582814	2584036	A02p05830.2_BraZ1	258	+	257	1148	1222	0.9394435
A02	2584053	2584322	A02p05840.2_BraZ1	22.5	-	15	259	269	0.9628253
A02	2585067	2589020	A02p05850.2_BraZ1	779.025	+	1220	2746	3953	0.6946623
A02	2588607	2588876	A02p05860.2_BraZ1	243	+	7	123	269	0.4572491
A02	2589379	2589679	A02p05870.2_BraZ1	30	+	61	254	300	0.8466667
A02	2591641	2597672	A02p05880.2_BraZ1	1759.6	-	6829	5906	6031	0.9792737
A02	2599243	2601257	A02p05890.2_BraZ1	866.857	-	1305	2014	2014	1.0000000
A02	2603317	2605385	A02p05900.2_BraZ1	1462.69	-	1829	2068	2068	1.0000000
A02	2606256	2607814	A02p05910.2_BraZ1	1488	-	543	1366	1558	0.8767651
A02	2609021	2609246	A02p05920.2_BraZ1	22.5	+	226	225	225	1.0000000
A02	2610981	2611215	A02p05930.2_BraZ1	23.4	+	0	0	234	0.0000000
A02	2612223	2615346	A02p05940.2_BraZ1	1778.67	+	1017	2196	3123	0.7031700
A02	2616419	2619282	A02p05950.2_BraZ1	1519.96	-	1310	2377	2863	0.8302480
A02	2621039	2621329	A02p05960.2_BraZ1	15	+	483	290	290	1.0000000
A02	2622939	2626249	A02p05970.2_BraZ1	919.875	-	4474	3068	3310	0.9268882
A02	2633990	2637394	A02p05980.2_BraZ1	1168.5	-	1425	2693	3404	0.7911281
A02	2640399	2641366	A02p05990.2_BraZ1	368.243	+	1109	967	967	1.0000000
A02	2641829	2646012	A02p06000.2_BraZ1	1879.91	-	2775	3561	4183	0.8513029
A02	2649015	2649693	A02p06010.2_BraZ1	64.8	+	677	678	678	1.0000000
A02	2653480	2655899	A02p06020.2_BraZ1	713.839	+	934	2259	2419	0.9338570
A02	2659137	2660290	A02p06030.2_BraZ1	537.3	-	556	1049	1153	0.9098005
A02	2663010	2663193	A02p06040.2_BraZ1	144	-	377	183	183	1.0000000
A02	2663861	2663972	A02p06050.2_BraZ1	11.1	+	257	111	111	1.0000000
A02	2664068	2666292	A02p06060.2_BraZ1	1094.21	+	1363	2224	2224	1.0000000
A02	2669313	2670828	A02p06070.2_BraZ1	1018.94	+	279	1345	1515	0.8877888
A02	2671265	2674048	A02p06080.2_BraZ1	1920	-	1933	2516	2783	0.9040604
A02	2677327	2683895	A02p06090.2_BraZ1	3037.54	+	1036	4536	6568	0.6906212
A02	2686654	2687686	A02p06100.2_BraZ1	513	+	790	1002	1032	0.9709302
A02	2687801	2688525	A02p06110.2_BraZ1	60.6	-	182	608	724	0.8397790
A02	2688407	2688945	A02p06120.2_BraZ1	420	-	97	248	538	0.4609666
A02	2689322	2692170	A02p06130.2_BraZ1	1245.71	-	1546	2784	2848	0.9775281
A02	2692628	2693918	A02p06140.2_BraZ1	129	+	5196	1290	1290	1.0000000
A02	2696153	2700283	A02p06150.2_BraZ1	3125.33	-	2158	3779	4130	0.9150121
A02	2701892	2704107	A02p06160.2_BraZ1	978.735	+	398	1877	2215	0.8474041
A02	2704975	2707069	A02p06170.2_BraZ1	980.571	+	274	1610	2094	0.7688634
A02	2707986	2713108	A02p06180.2_BraZ1	15037.5	+	2047	4708	5122	0.9191722
A02	2713811	2715875	A02p06190.2_BraZ1	1803	+	1243	2064	2064	1.0000000
A02	2716279	2722355	A02p06200.2_BraZ1	3651.72	-	5073	5963	6076	0.9814022
A02	2724256	2726010	A02p06210.2_BraZ1	1324.47	-	539	1641	1754	0.9355758
A02	2727385	2731841	A02p06220.2_BraZ1	1532.67	-	2190	3632	4456	0.8150808
A02	2734956	2736784	A02p06230.2_BraZ1	1325.5	+	691	1768	1828	0.9671773
A02	2743190	2744090	A02p06240.2_BraZ1	261	-	0	0	900	0.0000000
A02	2749395	2751579	A02p06250.2_BraZ1	1442.16	+	1879	2184	2184	1.0000000
A02	2752115	2752442	A02p06260.2_BraZ1	32.7	+	231	327	327	1.0000000
A02	2757900	2758035	A02p06270.2_BraZ1	13.5	-	0	0	135	0.0000000
A02	2761400	2765355	A02p06280.2_BraZ1	933	-	491	2528	3955	0.6391909
A02	2771468	2772415	A02p06290.2_BraZ1	282	-	183	878	947	0.9271383
A02	2776602	2778154	A02p06300.2_BraZ1	910.25	+	940	1257	1552	0.8099227
A02	2779007	2779379	A02p06310.2_BraZ1	36.3	-	34	287	372	0.7715054
A02	2780846	2781765	A02p06320.2_BraZ1	59.4	-	260	871	919	0.9477693
A02	2782844	2783674	A02p06330.2_BraZ1	47.1	-	792	830	830	1.0000000
A02	2788735	2789596	A02p06340.2_BraZ1	86.1	-	673	861	861	1.0000000
A02	2791136	2792160	A02p06350.2_BraZ1	279.286	+	288	943	1024	0.9208984
A02	2795320	2797976	A02p06360.2_BraZ1	1396.44	+	2066	2459	2656	0.9258283
A02	2798747	2802212	A02p06370.2_BraZ1	346.5	+	1962	3427	3465	0.9890332
A02	2804684	2806556	A02p06380.2_BraZ1	792	+	1473	1808	1872	0.9658120
A02	2808366	2813252	A02p06390.2_BraZ1	3117	-	1379	3709	4886	0.7591076
A02	2814210	2815443	A02p06400.2_BraZ1	123.3	+	486	1210	1233	0.9813463
A02	2816260	2820107	A02p06410.2_BraZ1	2575.42	-	2760	3847	3847	1.0000000
A02	2821438	2824441	A02p06420.2_BraZ1	1640.9	-	1980	2778	3003	0.9250749
A02	2825628	2828335	A02p06430.2_BraZ1	939.857	-	881	2555	2707	0.9438493
A02	2831579	2833940	A02p06440.2_BraZ1	1207.58	+	1283	2361	2361	1.0000000
A02	2834820	2844103	A02p06450.2_BraZ1	5135.67	-	2111	5265	9283	0.5671658
A02	2846483	2847720	A02p06460.2_BraZ1	762	+	852	1195	1237	0.9660469
A02	2853928	2857044	A02p06470.2_BraZ1	2607.61	-	1149	2713	3116	0.8706675
A02	2864840	2865935	A02p06480.2_BraZ1	109.5	-	131	1095	1095	1.0000000
A02	2872737	2873296	A02p06490.2_BraZ1	241.875	+	135	505	559	0.9033989
A02	2874403	2876517	A02p06500.2_BraZ1	1004.85	+	856	1937	2114	0.9162725
A02	2880667	2882363	A02p06510.2_BraZ1	736.763	+	634	1620	1696	0.9551887
A02	2885183	2887025	A02p06520.2_BraZ1	1055.6	+	714	1842	1842	1.0000000
A02	2887772	2888926	A02p06530.2_BraZ1	1388	+	141	688	1154	0.5961872
A02	2890254	2898693	A02p06540.2_BraZ1	4029.51	-	1128	6046	8439	0.7164356
A02	2899050	2899352	A02p06550.2_BraZ1	28.2581	-	71	259	302	0.8576159
A02	2900644	2905683	A02p06560.2_BraZ1	2441.26	-	2837	4899	5039	0.9722167
A02	2907175	2908594	A02p06570.2_BraZ1	1166.62	-	331	1399	1419	0.9859056
A02	2910117	2911319	A02p06580.2_BraZ1	549	+	964	1178	1202	0.9800333
A02	2911445	2911925	A02p06590.2_BraZ1	48	-	219	457	480	0.9520833
A02	2912380	2913513	A02p06600.2_BraZ1	1014	-	732	1133	1133	1.0000000
A02	2914910	2915315	A02p06610.2_BraZ1	123	+	391	405	405	1.0000000
A02	2915644	2916790	A02p06620.2_BraZ1	114.6	+	1271	1146	1146	1.0000000
A02	2926714	2927281	A02p06630.2_BraZ1	56.7	+	124	567	567	1.0000000
A02	2929906	2930860	A02p06640.2_BraZ1	95.4	-	382	946	954	0.9916143
A02	2931991	2935234	A02p06650.2_BraZ1	969.734	-	1906	3155	3243	0.9728646
A02	2936026	2937975	A02p06660.2_BraZ1	886.364	-	978	1478	1949	0.7583376
A02	2938779	2941490	A02p06670.2_BraZ1	1929	-	983	2481	2711	0.9151605
A02	2942166	2942370	A02p06680.2_BraZ1	20.4	-	46	204	204	1.0000000
A02	2943237	2943629	A02p06690.2_BraZ1	300	+	0	0	392	0.0000000
A02	2948412	2950204	A02p06700.2_BraZ1	725.333	+	662	1628	1792	0.9084821
A02	2951085	2955377	A02p06710.2_BraZ1	1710	+	1515	3883	4292	0.9047064
A02	2956581	2957078	A02p06720.2_BraZ1	198	+	362	489	497	0.9839034
A02	2958027	2958948	A02p06730.2_BraZ1	339	+	1002	921	921	1.0000000
A02	2959070	2959901	A02p06740.2_BraZ1	83.1	+	719	831	831	1.0000000
A02	2960938	2961091	A02p06750.2_BraZ1	15.3	-	373	153	153	1.0000000
A02	2966311	2969277	A02p06760.2_BraZ1	914.727	+	2326	2892	2966	0.9750506
A02	2969496	2971196	A02p06770.2_BraZ1	412.5	+	351	1451	1700	0.8535294
A02	2971549	2972488	A02p06780.2_BraZ1	225	-	87	361	939	0.3844515
A02	2973520	2975211	A02p06790.2_BraZ1	1215	-	1037	1624	1691	0.9603785
A02	2976155	2976893	A02p06800.2_BraZ1	326	-	679	738	738	1.0000000
A02	2977627	2980941	A02p06810.2_BraZ1	876.303	+	1595	3113	3314	0.9393482
A02	2981290	2981927	A02p06820.2_BraZ1	368.571	-	351	637	637	1.0000000
A02	2982793	2988656	A02p06830.2_BraZ1	2501.46	+	1615	5164	5863	0.8807778
A02	2989037	2995014	A02p06840.2_BraZ1	3165.23	-	1639	4757	5977	0.7958843
A02	2995512	2997346	A02p06850.2_BraZ1	717	-	1363	1834	1834	1.0000000
A02	2999138	3003692	A02p06860.2_BraZ1	2783.67	+	1976	4527	4554	0.9940711
A02	3003928	3004302	A02p06870.2_BraZ1	32.7	+	477	374	374	1.0000000
A02	3005841	3009328	A02p06880.2_BraZ1	1363.09	+	2130	3487	3487	1.0000000
A02	3009870	3010832	A02p06890.2_BraZ1	870	-	784	962	962	1.0000000
A02	3011943	3012816	A02p06900.2_BraZ1	786	-	746	873	873	1.0000000
A02	3018766	3020430	A02p06910.2_BraZ1	153.9	-	601	1626	1664	0.9771634
A02	3022128	3023929	A02p06920.2_BraZ1	782.525	-	1395	1801	1801	1.0000000
A02	3025209	3026294	A02p06930.2_BraZ1	600	-	902	1085	1085	1.0000000
A02	3027082	3030165	A02p06940.2_BraZ1	1944	-	2002	3048	3083	0.9886474
A02	3032463	3032857	A02p06950.2_BraZ1	258	-	430	394	394	1.0000000
A02	3034636	3037282	A02p06960.2_BraZ1	1077	-	721	2584	2646	0.9765684
A02	3039496	3039808	A02p06970.2_BraZ1	31.2	+	448	312	312	1.0000000
A02	3041223	3041852	A02p06980.2_BraZ1	356.129	+	469	557	629	0.8855326
A02	3042158	3043353	A02p06990.2_BraZ1	603.487	-	497	1121	1195	0.9380753
A02	3044323	3044998	A02p07000.2_BraZ1	484.083	-	988	675	675	1.0000000
A02	3046864	3047191	A02p07010.2_BraZ1	32.7	+	629	327	327	1.0000000
A02	3048408	3049398	A02p07020.2_BraZ1	753.375	+	383	960	990	0.9696970
A02	3050089	3053852	A02p07030.2_BraZ1	1133.33	-	1731	3481	3763	0.9250598
A02	3059848	3060459	A02p07040.2_BraZ1	111	+	137	419	611	0.6857610
A02	3062406	3064755	A02p07050.2_BraZ1	973.636	-	1040	2264	2349	0.9638144
A02	3070549	3072670	A02p07060.2_BraZ1	16578	+	193	1763	2121	0.8312117
A02	3083069	3085296	A02p07070.2_BraZ1	1774.55	-	220	2053	2227	0.9218680
A02	3086603	3088649	A02p07080.2_BraZ1	1218.46	+	744	2007	2046	0.9809384
A02	3099423	3115099	A02p07090.2_BraZ1	3847.77	+	7448	14205	15676	0.9061623
A02	3111704	3112514	A02p07100.2_BraZ1	81	+	89	609	810	0.7518519
A02	3117463	3119832	A02p07110.2_BraZ1	546.783	+	1135	2252	2369	0.9506121
A02	3121703	3123724	A02p07120.2_BraZ1	1267.74	-	181	1384	2021	0.6848095
A02	3127858	3132509	A02p07130.2_BraZ1	2510.35	-	1204	4102	4651	0.8819609
A02	3137218	3138063	A02p07140.2_BraZ1	652.545	+	784	845	845	1.0000000
A02	3140487	3140834	A02p07150.2_BraZ1	249	+	331	347	347	1.0000000
A02	3140999	3143844	A02p07160.2_BraZ1	1002.61	-	1216	2454	2845	0.8625659
A02	3144270	3145727	A02p07170.2_BraZ1	13290	+	1103	1457	1457	1.0000000
A02	3146091	3148048	A02p07180.2_BraZ1	523.98	-	1150	1957	1957	1.0000000
A02	3146355	3150386	A02p07190.2_BraZ1	436.6	+	2254	3917	4031	0.9717192
A02	3151219	3154028	A02p07200.2_BraZ1	1728	+	1056	2695	2809	0.9594162
A02	3154657	3157167	A02p07210.2_BraZ1	1399.23	+	1274	2316	2510	0.9227092
A02	3158927	3163603	A02p07220.2_BraZ1	3423	+	918	3653	4676	0.7812233
A02	3164650	3165463	A02p07230.2_BraZ1	81.3	+	108	422	813	0.5190652
A02	3166342	3169109	A02p07240.2_BraZ1	1729	+	464	2425	2767	0.8764004
A02	3169530	3170824	A02p07250.2_BraZ1	972	-	414	1260	1294	0.9737249
A02	3171770	3174588	A02p07260.2_BraZ1	831.115	-	975	2062	2818	0.7317246
A02	3174800	3175731	A02p07270.2_BraZ1	147	-	323	722	931	0.7755102
A02	3177503	3184961	A02p07280.2_BraZ1	3081.85	+	2445	5640	7458	0.7562349
A02	3185280	3186839	A02p07290.2_BraZ1	1377	-	352	1388	1559	0.8903143
A02	3188351	3189272	A02p07300.2_BraZ1	243	+	569	918	921	0.9967427
A02	3189473	3192146	A02p07310.2_BraZ1	778.603	-	680	2632	2673	0.9846614
A02	3195696	3196209	A02p07320.2_BraZ1	312	-	72	513	513	1.0000000
A02	3197836	3201198	A02p07330.2_BraZ1	1543.76	-	1296	3180	3362	0.9458656
A02	3201957	3203439	A02p07340.2_BraZ1	900.414	+	389	1215	1482	0.8198380
A02	3204557	3206357	A02p07350.2_BraZ1	957.333	-	605	1608	1800	0.8933333
A02	3207311	3209665	A02p07360.2_BraZ1	738	+	2996	2354	2354	1.0000000
A02	3210678	3212574	A02p07370.2_BraZ1	1248.39	-	994	1886	1896	0.9947258
A02	3213988	3216946	A02p07380.2_BraZ1	999.6	+	1894	2774	2958	0.9377958
A02	3217595	3219660	A02p07390.2_BraZ1	1182.76	-	321	1436	2065	0.6953995
A02	3220132	3221114	A02p07400.2_BraZ1	150	+	90	801	982	0.8156823
A02	3220765	3221047	A02p07410.2_BraZ1	120	+	21	237	282	0.8404256
A02	3223411	3223810	A02p07420.2_BraZ1	285	+	32	188	399	0.4711779
A02	3225240	3227081	A02p07430.2_BraZ1	1015.65	+	486	1812	1841	0.9842477
A02	3227600	3229472	A02p07440.2_BraZ1	1272	+	343	1575	1872	0.8413461
A02	3229832	3230142	A02p07450.2_BraZ1	222	-	54	301	310	0.9709678
A02	3232387	3232822	A02p07460.2_BraZ1	43.5	+	74	435	435	1.0000000
A02	3233037	3235332	A02p07470.2_BraZ1	961.714	-	999	2295	2295	1.0000000
A02	3236022	3237999	A02p07480.2_BraZ1	1065.27	-	939	1932	1977	0.9772382
A02	3240233	3244475	A02p07490.2_BraZ1	1904.74	-	272	1794	4242	0.4229137
A02	3247839	3250350	A02p07500.2_BraZ1	1394.03	+	234	1917	2511	0.7634408
A02	3251265	3251763	A02p07510.2_BraZ1	49.8	-	20	219	498	0.4397590
A02	3254250	3254802	A02p07520.2_BraZ1	55.2	+	83	521	552	0.9438406
A02	3256653	3259232	A02p07530.2_BraZ1	1254.9	-	883	2504	2579	0.9709190
A02	3260416	3266183	A02p07540.2_BraZ1	70.2	-	1240	2937	5767	0.5092769
A02	3270450	3275406	A02p07550.2_BraZ1	2346.65	-	596	3334	4956	0.6727200
A02	3276898	3279969	A02p07560.2_BraZ1	1570.11	-	1387	2824	3071	0.9195701
A02	3287228	3290392	A02p07570.2_BraZ1	1182.88	+	2894	3164	3164	1.0000000
A02	3292039	3293561	A02p07580.2_BraZ1	450	+	904	1503	1522	0.9875164
A02	3294794	3296203	A02p07590.2_BraZ1	918	-	1470	1409	1409	1.0000000
A02	3297975	3298215	A02p07600.2_BraZ1	24	+	117	229	240	0.9541667
A02	3299089	3302109	A02p07610.2_BraZ1	1066.87	-	2800	3020	3020	1.0000000
A02	3302719	3306372	A02p07620.2_BraZ1	1829.09	+	2668	3515	3653	0.9622228
A02	3307054	3307751	A02p07630.2_BraZ1	1440	+	59	389	697	0.5581062
A02	3308972	3318859	A02p07640.2_BraZ1	18.6	-	4721	5900	9887	0.5967432
A02	3309158	3311202	A02p07650.2_BraZ1	712.5	+	0	0	2044	0.0000000
A02	3311839	3313234	A02p07660.2_BraZ1	4080	+	450	654	1395	0.4688172
A02	3321457	3322543	A02p07670.2_BraZ1	108.6	+	955	1086	1086	1.0000000
A02	3323544	3324826	A02p07680.2_BraZ1	8482.5	+	347	1266	1282	0.9875195
A02	3327865	3328951	A02p07690.2_BraZ1	108.6	+	172	1013	1086	0.9327809
A02	3329402	3331396	A02p07700.2_BraZ1	564.3	+	365	1758	1994	0.8816450
A02	3332332	3333591	A02p07710.2_BraZ1	444	+	1555	1259	1259	1.0000000
A02	3341500	3341974	A02p07720.2_BraZ1	47.4	-	200	474	474	1.0000000
A02	3343186	3344013	A02p07730.2_BraZ1	333.321	+	1045	827	827	1.0000000
A02	3344378	3346700	A02p07740.2_BraZ1	966.429	-	1098	2177	2322	0.9375538
A02	3347415	3349062	A02p07750.2_BraZ1	1075	+	2126	1647	1647	1.0000000
A02	3349286	3353906	A02p07760.2_BraZ1	3045.6	-	6094	4620	4620	1.0000000
A02	3355154	3356807	A02p07770.2_BraZ1	644.64	-	1866	1653	1653	1.0000000
A02	3358637	3361260	A02p07780.2_BraZ1	1384.44	-	608	1928	2623	0.7350362
A02	3369766	3371057	A02p07790.2_BraZ1	983.625	-	274	1232	1291	0.9542990
A02	3374485	3376448	A02p07800.2_BraZ1	1473	-	340	1590	1963	0.8099847
A02	3379294	3381317	A02p07810.2_BraZ1	748.71	-	1273	1885	2023	0.9317845
A02	3388834	3390592	A02p07820.2_BraZ1	96.3	+	83	988	1758	0.5620023
A02	3393081	3394196	A02p07830.2_BraZ1	7868	-	3	68	1115	0.0609865
A02	3399812	3401461	A02p07840.2_BraZ1	5254.5	-	31	618	1649	0.3747726
A02	3406861	3407230	A02p07850.2_BraZ1	913	+	17	284	369	0.7696477
A02	3407378	3409034	A02p07860.2_BraZ1	165.6	+	439	1154	1656	0.6968599
A02	3410006	3410355	A02p07870.2_BraZ1	312	+	65	292	349	0.8366762
A02	3411332	3412515	A02p07880.2_BraZ1	118.2	+	1765	1183	1183	1.0000000
A02	3414459	3416196	A02p07890.2_BraZ1	173.7	-	60	925	1737	0.5325273
A02	3421213	3421534	A02p07900.2_BraZ1	32.1	+	97	321	321	1.0000000
A02	3425223	3428574	A02p07910.2_BraZ1	2161.49	+	580	3036	3351	0.9059982
A02	3429301	3439710	A02p07920.2_BraZ1	3432.95	-	5902	9478	10409	0.9105582
A02	3441398	3446347	A02p07930.2_BraZ1	551.727	-	1066	2849	4949	0.5756719
A02	3448058	3449953	A02p07940.2_BraZ1	2083.2	-	1248	1663	1895	0.8775725
A02	3451331	3451640	A02p07950.2_BraZ1	30.9	+	2	37	309	0.1197411
A02	3455598	3455907	A02p07960.2_BraZ1	30.9	+	67	309	309	1.0000000
A02	3458549	3460956	A02p07970.2_BraZ1	1203.05	+	238	1675	2407	0.6958870
A02	3461211	3462686	A02p07980.2_BraZ1	940.5	-	196	817	1475	0.5538983
A02	3464210	3464510	A02p07990.2_BraZ1	30	-	45	300	300	1.0000000
A02	3465742	3466024	A02p08000.2_BraZ1	28.2	-	5	154	282	0.5460993
A02	3466850	3467084	A02p08010.2_BraZ1	186	+	50	220	234	0.9401709
A02	3471173	3471470	A02p08020.2_BraZ1	258	-	173	297	297	1.0000000
A02	3472327	3474944	A02p08030.2_BraZ1	462	+	588	2414	2617	0.9224303
A02	3474647	3477387	A02p08040.2_BraZ1	279	+	764	1596	2740	0.5824817
A02	3475946	3478640	A02p08050.2_BraZ1	276	-	1592	2452	2694	0.9101707
A02	3479582	3479873	A02p08060.2_BraZ1	29.1	+	117	291	291	1.0000000
A02	3480753	3482065	A02p08070.2_BraZ1	646.579	-	807	1309	1312	0.9977134
A02	3484154	3485608	A02p08080.2_BraZ1	819	+	671	1429	1454	0.9828060
A02	3485998	3486327	A02p08090.2_BraZ1	240	-	120	251	329	0.7629179
A02	3487064	3488030	A02p08100.2_BraZ1	58.8	-	606	966	966	1.0000000
A02	3489821	3494436	A02p08110.2_BraZ1	1715.48	-	1717	4615	4615	1.0000000
A02	3494489	3495545	A02p08120.2_BraZ1	907.5	-	237	732	1056	0.6931818
A02	3500479	3500677	A02p08130.2_BraZ1	19.8	+	29	198	198	1.0000000
A02	3502098	3503499	A02p08140.2_BraZ1	942.068	-	52	375	1401	0.2676660
A02	3526355	3527200	A02p08150.2_BraZ1	2249.4	+	107	758	845	0.8970414
A02	3528357	3533042	A02p08160.2_BraZ1	8932.5	-	389	2298	4685	0.4905016
A02	3534797	3539217	A02p08170.2_BraZ1	13965	-	946	3635	4420	0.8223982
A02	3539232	3544390	A02p08180.2_BraZ1	1516.5	-	1238	4103	5158	0.7954634
A02	3547768	3548332	A02p08190.2_BraZ1	56.4	+	242	564	564	1.0000000
A02	3549953	3554544	A02p08200.2_BraZ1	9720	-	587	2395	4591	0.5216728
A02	3556325	3561522	A02p08210.2_BraZ1	4190.06	-	547	4202	5197	0.8085434
A02	3562648	3566596	A02p08220.2_BraZ1	1616.3	-	2112	3735	3948	0.9460486
A02	3566875	3567103	A02p08230.2_BraZ1	195	-	276	228	228	1.0000000
A02	3569588	3571081	A02p08240.2_BraZ1	1126.91	-	269	1412	1493	0.9457468
A02	3573648	3574515	A02p08250.2_BraZ1	86.7	-	105	867	867	1.0000000
A02	3577632	3580808	A02p08260.2_BraZ1	1076.65	+	201	1415	3176	0.4455290
A02	3581498	3582716	A02p08270.2_BraZ1	121.8	+	33	866	1218	0.7110016
A02	3582770	3584291	A02p08280.2_BraZ1	152.1	-	296	1467	1521	0.9644970
A02	3586621	3589026	A02p08290.2_BraZ1	1487.97	-	920	2378	2405	0.9887734
A02	3590520	3592343	A02p08300.2_BraZ1	1440	+	186	1582	1823	0.8678004
A02	3595194	3596517	A02p08310.2_BraZ1	132.3	+	100	1071	1323	0.8095238
A02	3597382	3599357	A02p08320.2_BraZ1	423.36	+	769	1920	1975	0.9721519
A02	3602761	3604878	A02p08330.2_BraZ1	1097.5	+	1362	2055	2117	0.9707133
A02	3609406	3610405	A02p08340.2_BraZ1	99.9	-	169	561	999	0.5615616
A02	3621903	3625056	A02p08350.2_BraZ1	1966.2	-	2242	2988	3153	0.9476689
A02	3625287	3628169	A02p08360.2_BraZ1	1365.8	+	963	2755	2882	0.9559334
A02	3630122	3630431	A02p08370.2_BraZ1	30.9	-	71	309	309	1.0000000
A02	3636707	3639203	A02p08380.2_BraZ1	231	-	2092	2422	2496	0.9703526
A02	3639408	3644511	A02p08390.2_BraZ1	1122.98	+	1712	4885	5103	0.9572800
A02	3645321	3647194	A02p08400.2_BraZ1	619.189	+	938	1873	1873	1.0000000
A02	3648070	3648241	A02p08410.2_BraZ1	17.1	-	36	169	171	0.9883041
A02	3652312	3654044	A02p08420.2_BraZ1	1005.38	-	1446	1732	1732	1.0000000
A02	3655006	3655183	A02p08430.2_BraZ1	17.7	-	15	150	177	0.8474576
A02	3655795	3659727	A02p08440.2_BraZ1	523.279	+	1463	3580	3932	0.9104781
A02	3662016	3666306	A02p08450.2_BraZ1	2133.72	+	1606	3706	4290	0.8638695
A02	3666724	3668621	A02p08460.2_BraZ1	949.324	+	1867	1897	1897	1.0000000
A02	3669205	3670655	A02p08470.2_BraZ1	844.833	-	421	1341	1450	0.9248276
A02	3671036	3673946	A02p08480.2_BraZ1	1450.8	-	865	2813	2910	0.9666666
A02	3676071	3677136	A02p08490.2_BraZ1	106.5	-	77	656	1065	0.6159624
A02	3683991	3693395	A02p08500.2_BraZ1	160.846	+	3163	9157	9404	0.9737346
A02	3697898	3698903	A02p08510.2_BraZ1	100.5	-	286	943	1005	0.9383085
A02	3705539	3706286	A02p08520.2_BraZ1	336	+	676	747	747	1.0000000
A02	3716426	3718495	A02p08530.2_BraZ1	1839	+	266	1777	2069	0.8588690
A02	3738986	3739373	A02p08540.2_BraZ1	38.7	+	679	387	387	1.0000000
A02	3739404	3739703	A02p08550.2_BraZ1	28.5	+	662	299	299	1.0000000
A02	3743528	3748711	A02p08560.2_BraZ1	717	-	6598	5183	5183	1.0000000
A02	3745374	3746946	A02p08570.2_BraZ1	1170	-	2719	1572	1572	1.0000000
A02	3750837	3752354	A02p08580.2_BraZ1	1710	-	1167	1507	1517	0.9934080
A02	3758450	3762378	A02p08590.2_BraZ1	1462.5	+	1437	3572	3928	0.9093686
A02	3759890	3760251	A02p08600.2_BraZ1	365.4	-	227	350	361	0.9695291
A02	3763227	3765029	A02p08610.2_BraZ1	867.564	-	715	1560	1802	0.8657048
A02	3765194	3766719	A02p08620.2_BraZ1	1155	+	110	794	1525	0.5206558
A02	3767214	3770822	A02p08630.2_BraZ1	5049	+	964	3186	3608	0.8830377
A02	3771703	3771886	A02p08640.2_BraZ1	18.3	+	221	183	183	1.0000000
A02	3772873	3773519	A02p08650.2_BraZ1	576	+	511	646	646	1.0000000
A02	3774785	3776867	A02p08660.2_BraZ1	1390.98	+	1075	2082	2082	1.0000000
A02	3777030	3779888	A02p08670.2_BraZ1	1506.87	-	1133	2796	2858	0.9783065
A02	3780824	3781560	A02p08680.2_BraZ1	341.143	+	478	736	736	1.0000000
A02	3782130	3783166	A02p08690.2_BraZ1	314.286	+	385	990	1036	0.9555985
A02	3795525	3796383	A02p08700.2_BraZ1	85.8	-	73	523	858	0.6095571
A02	3797304	3797421	A02p08710.2_BraZ1	11.7	-	173	117	117	1.0000000
A02	3801539	3802235	A02p08720.2_BraZ1	13.6957	+	582	696	696	1.0000000
A02	3802339	3805715	A02p08730.2_BraZ1	1582.15	+	889	2795	3376	0.8279029
A02	3993735	3994743	A02p08740.2_BraZ1	100.8	+	185	666	1008	0.6607143
A02	3995553	3995928	A02p08750.2_BraZ1	240	+	366	375	375	1.0000000
A02	3996535	3996943	A02p08760.2_BraZ1	40.8	+	532	408	408	1.0000000
A02	3997707	4001199	A02p08770.2_BraZ1	756	-	2801	3492	3492	1.0000000
A02	4003420	4005486	A02p08780.2_BraZ1	1528.94	-	1903	2066	2066	1.0000000
A02	4005964	4007851	A02p08790.2_BraZ1	696.351	-	1769	1828	1887	0.9687334
A02	4008623	4011946	A02p08800.2_BraZ1	1271.43	-	3763	3097	3323	0.9319892
A02	4022323	4027866	A02p08810.2_BraZ1	2508.47	+	6483	5543	5543	1.0000000
A02	4029657	4033267	A02p08820.2_BraZ1	2981.37	+	3716	3610	3610	1.0000000
A02	4035655	4036067	A02p08830.2_BraZ1	285	-	451	412	412	1.0000000
A02	4038396	4041161	A02p08840.2_BraZ1	1471.87	-	1148	2553	2765	0.9233273
A02	4046695	4051321	A02p08850.2_BraZ1	1899.53	-	3004	4435	4626	0.9587116
A02	4054314	4056753	A02p08860.2_BraZ1	1528.27	-	1096	2439	2439	1.0000000
A02	4057391	4059937	A02p08870.2_BraZ1	1312.5	+	2074	2546	2546	1.0000000
A02	4060086	4061400	A02p08880.2_BraZ1	540	-	985	1314	1314	1.0000000
A02	4061600	4062539	A02p08890.2_BraZ1	93.9	-	556	939	939	1.0000000
A02	4065343	4068823	A02p08900.2_BraZ1	1854.94	+	3893	3480	3480	1.0000000
A02	4069145	4070880	A02p08910.2_BraZ1	925.714	-	1453	1735	1735	1.0000000
A02	4077070	4079287	A02p08920.2_BraZ1	1355.37	+	1127	2217	2217	1.0000000
A02	4080342	4083546	A02p08930.2_BraZ1	1174.79	+	1345	2784	3204	0.8689138
A02	4087616	4090455	A02p08940.2_BraZ1	1495.27	+	287	2010	2839	0.7079958
A02	4091334	4091763	A02p08950.2_BraZ1	42.9	+	125	377	429	0.8787879
A02	4092491	4094492	A02p08960.2_BraZ1	1752	-	125	1318	2001	0.6586707
A02	4095871	4096321	A02p08970.2_BraZ1	45	-	99	450	450	1.0000000
A02	4097321	4104500	A02p08980.2_BraZ1	1725.9	-	3968	5947	7179	0.8283883
A02	4110215	4110576	A02p08990.2_BraZ1	34.2	-	425	361	361	1.0000000
A02	4113745	4114216	A02p09000.2_BraZ1	47.1	-	631	471	471	1.0000000
A02	4116169	4116790	A02p09010.2_BraZ1	62.1	-	825	621	621	1.0000000
A02	4117832	4119549	A02p09020.2_BraZ1	717.75	+	1115	1717	1717	1.0000000
A02	4121485	4122870	A02p09030.2_BraZ1	297.231	+	1426	1385	1385	1.0000000
A02	4127291	4128818	A02p09040.2_BraZ1	152.7	+	2248	1527	1527	1.0000000
A02	4129664	4132551	A02p09050.2_BraZ1	443.368	-	2445	2887	2887	1.0000000
A02	4135192	4139914	A02p09060.2_BraZ1	967.579	+	1883	4279	4722	0.9061838
A02	4141110	4143104	A02p09070.2_BraZ1	900	-	1141	1979	1994	0.9924774
A02	4147288	4148949	A02p09080.2_BraZ1	35741.7	-	108	1211	1661	0.7290789
A02	4152995	4154662	A02p09090.2_BraZ1	53612.6	+	6	257	1667	0.1541692
A02	4154976	4155747	A02p09100.2_BraZ1	75.9	-	111	523	771	0.6783398
A02	4156167	4156551	A02p09110.2_BraZ1	38.4	+	122	384	384	1.0000000
A02	4157930	4163508	A02p09120.2_BraZ1	3175.99	-	1546	5441	5578	0.9754393
A02	4165980	4169816	A02p09130.2_BraZ1	1982.04	-	2146	3836	3836	1.0000000
A02	4171739	4175404	A02p09140.2_BraZ1	2053.2	-	3220	3665	3665	1.0000000
A02	4177238	4178498	A02p09150.2_BraZ1	126	+	416	1096	1260	0.8698413
A02	4179158	4180067	A02p09160.2_BraZ1	90.9	-	249	573	909	0.6303630
A02	4182263	4184092	A02p09170.2_BraZ1	916.667	-	883	1698	1829	0.9283761
A02	4185229	4186821	A02p09180.2_BraZ1	838.158	-	382	1397	1592	0.8775126
A02	4191717	4192905	A02p09190.2_BraZ1	117.6	-	1149	1188	1188	1.0000000
A02	4194661	4195631	A02p09200.2_BraZ1	497.94	-	758	970	970	1.0000000
A02	4196647	4199361	A02p09210.2_BraZ1	1764	-	2942	2714	2714	1.0000000
A02	4206727	4208827	A02p09220.2_BraZ1	850.5	+	2140	2100	2100	1.0000000
A02	4210505	4211708	A02p09230.2_BraZ1	120.3	+	92	886	1203	0.7364921
A02	4213661	4214624	A02p09240.2_BraZ1	96.3	-	512	963	963	1.0000000
A02	4215537	4219979	A02p09250.2_BraZ1	1549.07	+	2547	4274	4442	0.9621792
A02	4220654	4221755	A02p09260.2_BraZ1	1017	-	1037	1101	1101	1.0000000
A02	4223183	4226638	A02p09270.2_BraZ1	1243.37	-	3332	3140	3455	0.9088278
A02	4227035	4227290	A02p09280.2_BraZ1	25.5	-	377	255	255	1.0000000
A02	4230069	4233875	A02p09290.2_BraZ1	1719.38	+	1544	3383	3806	0.8888597
A02	4234309	4235873	A02p09300.2_BraZ1	1163.66	+	1332	1564	1564	1.0000000
A02	4236239	4236917	A02p09310.2_BraZ1	309.383	-	777	678	678	1.0000000
A02	4238292	4240241	A02p09320.2_BraZ1	633	-	473	1535	1949	0.7875834
A02	4242360	4243378	A02p09330.2_BraZ1	10233.5	+	1097	1018	1018	1.0000000
A02	4243944	4245366	A02p09340.2_BraZ1	606	+	1491	1379	1422	0.9697609
A02	4247621	4248593	A02p09350.2_BraZ1	777	+	122	746	972	0.7674897
A02	4248958	4249681	A02p09360.2_BraZ1	43.2632	+	265	723	723	1.0000000
A02	4251971	4253055	A02p09370.2_BraZ1	831.938	+	37	544	1084	0.5018450
A02	4257456	4257951	A02p09380.2_BraZ1	49.5	+	35	291	495	0.5878788
A02	4262455	4263346	A02p09390.2_BraZ1	705	+	36	586	891	0.6576880
A02	4265027	4267337	A02p09400.2_BraZ1	486.245	+	22	530	2310	0.2294372
A02	4269502	4272447	A02p09410.2_BraZ1	2085.65	+	262	1874	2945	0.6363328
A02	4272552	4273778	A02p09420.2_BraZ1	962.325	-	146	733	1226	0.5978793
A02	4276916	4282241	A02p09430.2_BraZ1	2810.28	-	2455	5077	5325	0.9534273
A02	4285313	4292579	A02p09440.2_BraZ1	645	-	1657	5104	7266	0.7024497
A02	4294845	4295877	A02p09450.2_BraZ1	103.2	+	478	877	1032	0.8498062
A02	4296812	4301217	A02p09460.2_BraZ1	1706.55	+	2609	3646	4405	0.8276958
A02	4302283	4302776	A02p09470.2_BraZ1	46.2	-	327	493	493	1.0000000
A02	4303522	4307620	A02p09480.2_BraZ1	1307.82	-	4765	4098	4098	1.0000000
A02	4311363	4311579	A02p09490.2_BraZ1	21.6	+	269	216	216	1.0000000
A02	4311888	4314205	A02p09500.2_BraZ1	1365.12	+	1556	2207	2317	0.9525248
A02	4317218	4318678	A02p09510.2_BraZ1	633.536	+	355	1307	1460	0.8952055
A02	4319233	4329126	A02p09520.2_BraZ1	3298.4	-	4492	9497	9893	0.9599717
A02	4329378	4330962	A02p09530.2_BraZ1	386.925	+	992	1125	1584	0.7102273
A02	4331224	4332903	A02p09540.2_BraZ1	698.063	-	1577	1679	1679	1.0000000
A02	4336279	4338544	A02p09550.2_BraZ1	884.5	-	2340	2265	2265	1.0000000
A02	4340112	4345235	A02p09560.2_BraZ1	947.368	+	3818	5087	5123	0.9929729
A02	4346234	4347997	A02p09570.2_BraZ1	1077	+	477	1517	1763	0.8604651
A02	4348340	4349245	A02p09580.2_BraZ1	344.348	-	341	583	905	0.6441989
A02	4351118	4354414	A02p09590.2_BraZ1	3207	+	1142	2825	3296	0.8570995
A02	4354817	4355453	A02p09600.2_BraZ1	63.6	-	29	571	636	0.8977987
A02	4357827	4358469	A02p09610.2_BraZ1	64.2	-	218	388	642	0.6043614
A02	4359473	4359896	A02p09620.2_BraZ1	25.8	+	651	423	423	1.0000000
A02	4361336	4361531	A02p09630.2_BraZ1	19.5	-	56	195	195	1.0000000
A02	4361629	4362290	A02p09640.2_BraZ1	63.9	-	86	347	661	0.5249622
A02	4366626	4369218	A02p09650.2_BraZ1	547.8	-	705	2480	2592	0.9567901
A02	4370887	4372015	A02p09660.2_BraZ1	654	+	548	1127	1128	0.9991135
A02	4378824	4382955	A02p09670.2_BraZ1	4452	-	4483	4131	4131	1.0000000
A02	4388592	4390729	A02p09680.2_BraZ1	986.294	+	639	1822	2137	0.8525971
A02	4391954	4394299	A02p09690.2_BraZ1	1920	+	892	2251	2345	0.9599147
A02	4396077	4396992	A02p09700.2_BraZ1	753	-	366	530	915	0.5792350
A02	4405175	4405533	A02p09710.2_BraZ1	231	-	274	358	358	1.0000000
A02	4412392	4413934	A02p09720.2_BraZ1	5219.7	+	483	1486	1542	0.9636835
A02	4414627	4419349	A02p09730.2_BraZ1	3143.15	-	2786	4361	4722	0.9235494
A02	4431440	4432170	A02p09740.2_BraZ1	3984	+	55	221	730	0.3027397
A02	4434542	4434923	A02p09750.2_BraZ1	38.1	-	7	123	381	0.3228346
A02	4439135	4444266	A02p09760.2_BraZ1	1954.88	-	5744	5098	5131	0.9935685
A02	4448081	4448559	A02p09770.2_BraZ1	267	+	321	478	478	1.0000000
A02	4449241	4451546	A02p09780.2_BraZ1	1222.08	-	2059	2294	2305	0.9952278
A02	4452640	4454263	A02p09790.2_BraZ1	1491	-	432	1596	1623	0.9833642
A02	4455382	4456184	A02p09800.2_BraZ1	510	-	323	802	802	1.0000000
A02	4458468	4461286	A02p09810.2_BraZ1	1434.54	-	1452	2818	2818	1.0000000
A02	4461799	4463140	A02p09820.2_BraZ1	7076.25	+	1846	1341	1341	1.0000000
A02	4463776	4465771	A02p09830.2_BraZ1	621.563	-	7197	1995	1995	1.0000000
A02	4467033	4471483	A02p09840.2_BraZ1	2008.47	+	1861	3951	4450	0.8878652
A02	4471950	4472468	A02p09850.2_BraZ1	1989	+	749	518	518	1.0000000
A02	4472664	4476096	A02p09860.2_BraZ1	1768.93	-	1923	3077	3432	0.8965617
A02	4482386	4489452	A02p09870.2_BraZ1	3334.55	+	2743	4142	7066	0.5861874
A02	4489970	4490728	A02p09880.2_BraZ1	672	+	173	747	758	0.9854881
A02	4491444	4493762	A02p09890.2_BraZ1	859.222	+	1655	2307	2318	0.9952545
A02	4495460	4495880	A02p09900.2_BraZ1	42	-	906	420	420	1.0000000
A02	4497255	4498355	A02p09910.2_BraZ1	6328	+	446	1097	1100	0.9972727
A02	4498772	4504041	A02p09920.2_BraZ1	2493.44	-	1752	4482	5269	0.8506358
A02	4506074	4508339	A02p09930.2_BraZ1	628.571	+	2069	2265	2265	1.0000000
A02	4514553	4516858	A02p09940.2_BraZ1	1795.4	+	583	2102	2305	0.9119306
A02	4518972	4523348	A02p09950.2_BraZ1	1983.47	+	1702	3671	4376	0.8388939
A02	4531550	4533089	A02p09960.2_BraZ1	153.9	+	108	1065	1539	0.6920078
A02	4533873	4534785	A02p09970.2_BraZ1	91.2	+	65	564	912	0.6184211
A02	4536934	4537816	A02p09980.2_BraZ1	88.2	+	159	426	882	0.4829932
A02	4540465	4542196	A02p09990.2_BraZ1	858.6	-	325	1407	1731	0.8128250
A02	4543170	4544663	A02p10000.2_BraZ1	451.35	-	1293	1493	1493	1.0000000
A02	4545715	4547081	A02p10010.2_BraZ1	171	+	336	605	1366	0.4428990
A02	4547530	4549059	A02p10020.2_BraZ1	395.438	+	27	445	1529	0.2910399
A02	4549706	4551613	A02p10030.2_BraZ1	516	-	38	798	1907	0.4184583
A02	4552949	4558271	A02p10040.2_BraZ1	2239.47	+	1264	4508	5322	0.8470500
A02	4559597	4563430	A02p10050.2_BraZ1	1568.26	-	1600	3447	3833	0.8992956
A02	4571303	4573134	A02p10060.2_BraZ1	633.043	+	1177	1722	1831	0.9404697
A02	4573652	4574344	A02p10070.2_BraZ1	47.4	-	208	628	692	0.9075145
A02	4575384	4578667	A02p10080.2_BraZ1	1314.67	+	961	3037	3283	0.9250686
A02	4579893	4580382	A02p10090.2_BraZ1	192	+	951	489	489	1.0000000
A02	4588609	4591719	A02p10100.2_BraZ1	1326.08	+	1169	2422	3110	0.7787781
A02	4598829	4599665	A02p10110.2_BraZ1	750	-	514	836	836	1.0000000
A02	4601648	4602929	A02p10120.2_BraZ1	128.1	-	1552	1281	1281	1.0000000
A02	4610917	4614009	A02p10130.2_BraZ1	870.957	-	2625	3035	3092	0.9815654
A02	4623831	4625267	A02p10140.2_BraZ1	885	-	554	1404	1436	0.9777158
A02	4640336	4642065	A02p10150.2_BraZ1	209.692	+	579	1518	1729	0.8779641
A02	4643217	4645091	A02p10160.2_BraZ1	1055.92	+	1089	1823	1874	0.9727855
A02	4645848	4659490	A02p10170.2_BraZ1	2330.91	-	7633	13026	13642	0.9548453
A02	4653740	4655709	A02p10180.2_BraZ1	26330.4	-	783	1842	1969	0.9355003
A02	4660567	4661908	A02p10190.2_BraZ1	134.1	-	489	1293	1341	0.9642058
A02	4675407	4675749	A02p10200.2_BraZ1	31.2	-	150	263	342	0.7690058
A02	4675786	4678237	A02p10210.2_BraZ1	245.1	-	1209	2451	2451	1.0000000
A02	4680293	4681503	A02p10220.2_BraZ1	84.6	+	3	136	1210	0.1123967
A02	4683158	4685389	A02p10230.2_BraZ1	13043.2	+	1565	1701	2231	0.7624384
A02	4686341	4688171	A02p10240.2_BraZ1	994.625	-	1927	1830	1830	1.0000000
A02	4689424	4691236	A02p10250.2_BraZ1	181.2	-	393	1712	1812	0.9448124
A02	4692528	4693854	A02p10260.2_BraZ1	926.345	-	643	1326	1326	1.0000000
A02	4694805	4695624	A02p10270.2_BraZ1	630	+	366	755	819	0.9218559
A02	4696337	4696895	A02p10280.2_BraZ1	48.9	+	329	492	558	0.8817204
A02	4697672	4698485	A02p10290.2_BraZ1	81.3	-	148	809	813	0.9950799
A02	4701845	4702241	A02p10300.2_BraZ1	39.6	-	39	254	396	0.6414142
A02	4703737	4704457	A02p10310.2_BraZ1	1798.5	-	712	720	720	1.0000000
A02	4705790	4707479	A02p10320.2_BraZ1	963.2	-	1719	1657	1689	0.9810539
A02	4712242	4713247	A02p10330.2_BraZ1	100.5	-	211	608	1005	0.6049751
A02	4716265	4718047	A02p10340.2_BraZ1	984.5	+	231	1352	1782	0.7586981
A02	4718671	4720262	A02p10350.2_BraZ1	262.689	-	479	1540	1591	0.9679447
A02	4719735	4721327	A02p10360.2_BraZ1	353.874	-	538	1592	1592	1.0000000
A02	4722458	4725017	A02p10370.2_BraZ1	1193.62	-	1332	2559	2559	1.0000000
A02	4725890	4726991	A02p10380.2_BraZ1	654.316	-	747	1101	1101	1.0000000
A02	4730214	4731646	A02p10390.2_BraZ1	689.368	-	232	1110	1432	0.7751397
A02	4737437	4738055	A02p10400.2_BraZ1	61.8	-	32	324	618	0.5242718
A02	4744240	4746045	A02p10410.2_BraZ1	1329	-	1094	1713	1805	0.9490305
A02	4748771	4751383	A02p10420.2_BraZ1	1060.94	+	1748	2432	2612	0.9310873
A02	4755469	4756350	A02p10430.2_BraZ1	519	+	54	421	881	0.4778661
A02	4757053	4761364	A02p10440.2_BraZ1	1600.77	-	2281	3837	4311	0.8900487
A02	4769349	4772848	A02p10450.2_BraZ1	1455.52	+	1829	3404	3499	0.9728494
A02	4773737	4774031	A02p10460.2_BraZ1	210	-	319	160	294	0.5442177
A02	4775557	4775869	A02p10470.2_BraZ1	31.2	+	251	252	312	0.8076923
A02	4779048	4780253	A02p10480.2_BraZ1	880.833	-	515	787	1205	0.6531121
A02	4782684	4783280	A02p10490.2_BraZ1	300	+	242	566	596	0.9496644
A02	4784140	4785413	A02p10500.2_BraZ1	863.025	-	171	851	1273	0.6684996
A02	4793277	4793709	A02p10510.2_BraZ1	138.353	+	20	216	432	0.5000000
A02	4793892	4796516	A02p10520.2_BraZ1	1712.82	+	1018	2624	2624	1.0000000
A02	4796717	4798950	A02p10530.2_BraZ1	1274.77	-	1386	2231	2233	0.9991043
A02	4803412	4804711	A02p10540.2_BraZ1	129.9	+	145	1159	1299	0.8922248
A02	4814184	4814756	A02p10550.2_BraZ1	530	+	53	488	572	0.8531469
A02	4816081	4818333	A02p10560.2_BraZ1	1182.5	-	1279	2233	2252	0.9915631
A02	4818274	4818844	A02p10570.2_BraZ1	274.5	-	135	570	570	1.0000000
A02	4826964	4829989	A02p10580.2_BraZ1	733.943	+	499	2804	3025	0.9269422
A02	4830644	4832446	A02p10590.2_BraZ1	371.143	+	215	1754	1802	0.9733629
A02	4838216	4839950	A02p10600.2_BraZ1	927	+	484	1688	1734	0.9734718
A02	4840875	4841241	A02p10610.2_BraZ1	36.6	+	527	366	366	1.0000000
A02	4841303	4843974	A02p10620.2_BraZ1	1149.5	+	2174	2469	2671	0.9243729
A02	4844630	4846220	A02p10630.2_BraZ1	142.5	-	1256	1590	1590	1.0000000
A02	4848152	4849751	A02p10640.2_BraZ1	141.9	-	469	1567	1599	0.9799875
A02	4850839	4855323	A02p10650.2_BraZ1	1544.1	-	936	3645	4484	0.8128903
A02	4860190	4860442	A02p10660.2_BraZ1	25.2	-	106	252	252	1.0000000
A02	4860652	4860859	A02p10670.2_BraZ1	20.7	-	235	207	207	1.0000000
A02	4872630	4878413	A02p10680.2_BraZ1	4292.18	+	1877	5429	5783	0.9387861
A02	4887979	4889205	A02p10690.2_BraZ1	247.5	-	1090	1058	1226	0.8629690
A02	4894666	4895857	A02p10700.2_BraZ1	119.1	-	228	1017	1191	0.8539043
A02	4896492	4897699	A02p10710.2_BraZ1	86.4	-	36	701	1207	0.5807788
A02	4898685	4902642	A02p10720.2_BraZ1	2455.31	-	1294	3858	3957	0.9749811
A02	4905511	4907512	A02p10730.2_BraZ1	1086	+	1222	1839	2001	0.9190405
A02	4908120	4910504	A02p10740.2_BraZ1	1357	-	1056	2384	2384	1.0000000
A02	4910893	4912816	A02p10750.2_BraZ1	1581	-	1612	1923	1923	1.0000000
A02	4913952	4916162	A02p10760.2_BraZ1	1167.49	-	734	2116	2210	0.9574661
A02	4923034	4923187	A02p10770.2_BraZ1	15.3	-	56	125	153	0.8169935
A02	4923274	4926094	A02p10780.2_BraZ1	1291.19	-	322	1794	2820	0.6361702
A02	4930295	4934286	A02p10790.2_BraZ1	1066.91	-	887	3847	3991	0.9639188
A02	4940514	4947992	A02p10800.2_BraZ1	1155.52	-	717	3702	7478	0.4950522
A02	4952232	4952841	A02p10810.2_BraZ1	60	-	71	379	609	0.6223317
A02	4953800	4954092	A02p10820.2_BraZ1	222	+	362	292	292	1.0000000
A02	4954674	4955787	A02p10830.2_BraZ1	111.3	-	210	1012	1113	0.9092543
A02	4959197	4960319	A02p10840.2_BraZ1	112.2	-	37	507	1122	0.4518717
A02	4963611	4966398	A02p10850.2_BraZ1	2333.86	+	206	1920	2787	0.6889128
A02	4967473	4968821	A02p10860.2_BraZ1	637.389	+	396	1158	1348	0.8590505
A02	4969523	4970383	A02p10870.2_BraZ1	594	-	11	179	860	0.2081395
A02	4973123	4975535	A02p10880.2_BraZ1	1432.66	+	827	1684	2412	0.6981758
A02	4979213	4980538	A02p10890.2_BraZ1	1020.94	+	36	528	1325	0.3984906
A02	4983712	4984856	A02p10900.2_BraZ1	811.952	+	270	1040	1144	0.9090909
A02	4998796	5002188	A02p10910.2_BraZ1	2020.05	-	1572	3082	3392	0.9086085
A02	5006926	5008778	A02p10920.2_BraZ1	1041	-	1198	1852	1852	1.0000000
A02	5010001	5012127	A02p10930.2_BraZ1	1086.67	-	1313	2126	2126	1.0000000
A02	5018676	5022332	A02p10940.2_BraZ1	2088	+	1329	3617	3656	0.9893326
A02	5026368	5028072	A02p10950.2_BraZ1	1347	+	984	1670	1704	0.9800469
A02	5037575	5041837	A02p10960.2_BraZ1	2772	+	1401	3859	4262	0.9054434
A02	5042016	5046097	A02p10970.2_BraZ1	2282.93	-	1916	4033	4081	0.9882382
A02	5065194	5065695	A02p10980.2_BraZ1	50.1	-	192	501	501	1.0000000
A02	5070674	5071597	A02p10990.2_BraZ1	672	-	892	923	923	1.0000000
A02	5081207	5081832	A02p11000.2_BraZ1	531	+	30	196	625	0.3136000
A02	5088808	5090281	A02p11010.2_BraZ1	895	+	150	1083	1473	0.7352342
A02	5092387	5095716	A02p11020.2_BraZ1	1601.43	+	1785	3287	3329	0.9873836
A02	5096081	5098272	A02p11030.2_BraZ1	1134.68	-	1133	2180	2191	0.9949794
A02	5103250	5103691	A02p11040.2_BraZ1	44.1	+	0	0	441	0.0000000
A02	5111382	5111613	A02p11050.2_BraZ1	23.1	+	0	0	231	0.0000000
A02	5116485	5118567	A02p11060.2_BraZ1	1033.25	-	1190	2082	2082	1.0000000
A02	5119008	5127066	A02p11070.2_BraZ1	222.133	+	1304	4512	8058	0.5599405
A02	5120049	5120454	A02p11080.2_BraZ1	40.5	-	1	7	405	0.0172840
A02	5130372	5130777	A02p11090.2_BraZ1	40.5	-	1	16	405	0.0395062
A02	5138209	5138650	A02p11100.2_BraZ1	44.1	-	82	437	441	0.9909297
A02	5139912	5141017	A02p11110.2_BraZ1	4855.5	-	111	710	1105	0.6425340
A02	5146287	5146936	A02p11120.2_BraZ1	309.519	+	146	623	649	0.9599383
A02	5147536	5149636	A02p11130.2_BraZ1	4855.5	-	451	1456	2100	0.6933333
A02	5154534	5154875	A02p11140.2_BraZ1	258	+	29	140	341	0.4105572
A02	5155492	5155992	A02p11150.2_BraZ1	306	-	136	486	500	0.9720000
A02	5156467	5157607	A02p11160.2_BraZ1	2750	-	120	689	1140	0.6043860
A02	5164170	5165253	A02p11170.2_BraZ1	846	-	40	670	1083	0.6186519
A02	5170940	5171246	A02p11180.2_BraZ1	30.6	-	279	306	306	1.0000000
A02	5174460	5179973	A02p11190.2_BraZ1	2296.59	-	1859	5191	5513	0.9415926
A02	5182817	5183207	A02p11200.2_BraZ1	297	+	35	248	390	0.6358975
A02	5184754	5186191	A02p11210.2_BraZ1	2574	-	393	1246	1437	0.8670842
A02	5190413	5190814	A02p11220.2_BraZ1	303	+	402	401	401	1.0000000
A02	5191426	5192884	A02p11230.2_BraZ1	74250	-	345	1458	1458	1.0000000
A02	5193977	5195825	A02p11240.2_BraZ1	1170	-	757	1734	1848	0.9383117
A02	5196718	5198795	A02p11250.2_BraZ1	1038.54	-	814	1747	2077	0.8411170
A02	5209888	5210191	A02p11260.2_BraZ1	30.3	-	216	303	303	1.0000000
A02	5212364	5212848	A02p11270.2_BraZ1	48	+	249	470	484	0.9710744
A02	5217240	5218098	A02p11280.2_BraZ1	85.8	+	41	701	858	0.8170163
A02	5221804	5223673	A02p11290.2_BraZ1	1116	+	421	1626	1869	0.8699840
A02	5225347	5226311	A02p11300.2_BraZ1	777	-	15	176	964	0.1825726
A02	5236489	5237629	A02p11310.2_BraZ1	922.5	+	590	1140	1140	1.0000000
A02	5239650	5241654	A02p11320.2_BraZ1	1240.68	-	871	1986	2004	0.9910179
A02	5250133	5250865	A02p11330.2_BraZ1	338.625	+	738	732	732	1.0000000
A02	5251469	5253238	A02p11340.2_BraZ1	1234.8	+	216	1655	1769	0.9355568
A02	5253645	5256480	A02p11350.2_BraZ1	816.48	+	2129	2835	2835	1.0000000
A02	5259108	5260602	A02p11360.2_BraZ1	149.4	+	424	1406	1494	0.9410977
A02	5260807	5268945	A02p11370.2_BraZ1	3707.2	-	1240	6503	8138	0.7990907
A02	5269389	5269935	A02p11380.2_BraZ1	54.6	+	504	546	546	1.0000000
A02	5271061	5273107	A02p11390.2_BraZ1	1703.65	-	341	1942	2046	0.9491691
A02	5276718	5281857	A02p11400.2_BraZ1	2313.07	-	1028	4054	5139	0.7888694
A02	5299465	5301386	A02p11410.2_BraZ1	726	+	337	1651	1921	0.8594482
A02	5302744	5305212	A02p11420.2_BraZ1	1733.14	-	946	2130	2468	0.8630470
A02	5305584	5305936	A02p11430.2_BraZ1	264	-	368	352	352	1.0000000
A02	5307155	5310694	A02p11440.2_BraZ1	2007	-	1084	2097	3539	0.5925403
A02	5312066	5312495	A02p11450.2_BraZ1	42.9	-	77	429	429	1.0000000
A02	5313348	5316329	A02p11460.2_BraZ1	1546.29	-	1407	2926	2981	0.9815498
A02	5322917	5323450	A02p11470.2_BraZ1	10504.5	+	178	533	533	1.0000000
A02	5324150	5324961	A02p11480.2_BraZ1	295.909	-	652	811	811	1.0000000
A02	5325600	5326155	A02p11490.2_BraZ1	17390.2	+	444	555	555	1.0000000
A02	5326666	5327035	A02p11500.2_BraZ1	270	-	160	348	369	0.9430894
A02	5327359	5330756	A02p11510.2_BraZ1	5215.93	+	1937	3397	3397	1.0000000
A02	5331041	5332531	A02p11520.2_BraZ1	984.667	-	812	1490	1490	1.0000000
A02	5333719	5334193	A02p11530.2_BraZ1	47.4	-	93	463	474	0.9767932
A02	5342348	5342831	A02p11540.2_BraZ1	48.3	-	113	468	483	0.9689441
A02	5345074	5348144	A02p11550.2_BraZ1	2106.93	+	799	2643	3070	0.8609120
A02	5349578	5350430	A02p11560.2_BraZ1	469.636	+	784	852	852	1.0000000
A02	5352184	5354035	A02p11570.2_BraZ1	13376	-	596	1764	1851	0.9529984
A02	5366110	5366467	A02p11580.2_BraZ1	35.7	-	362	357	357	1.0000000
A02	5376947	5381482	A02p11590.2_BraZ1	822.797	+	2902	4287	4535	0.9453142
A02	5385399	5386189	A02p11600.2_BraZ1	699	+	176	757	790	0.9582279
A02	5386706	5398058	A02p11610.2_BraZ1	893.091	+	4180	10834	11352	0.9543692
A02	5387034	5395330	A02p11620.2_BraZ1	1327.98	-	2676	7860	8296	0.9474446
A02	5403390	5405256	A02p11630.2_BraZ1	186.6	+	425	1806	1866	0.9678457
A02	5407464	5407923	A02p11640.2_BraZ1	45.9	-	107	431	459	0.9389978
A02	5408685	5411981	A02p11650.2_BraZ1	1662.54	-	1564	3296	3296	1.0000000
A02	5413595	5413907	A02p11660.2_BraZ1	31.2	-	157	312	312	1.0000000
A02	5417110	5420898	A02p11670.2_BraZ1	1940.57	-	3427	3788	3788	1.0000000
A02	5421452	5425496	A02p11680.2_BraZ1	2340.6	-	731	3326	4044	0.8224530
A02	5427687	5433049	A02p11690.2_BraZ1	2285.4	-	2649	4035	5362	0.7525177
A02	5440359	5452574	A02p11700.2_BraZ1	3745.41	-	6273	11089	12215	0.9078183
A02	5453848	5454178	A02p11710.2_BraZ1	168	+	229	330	330	1.0000000
A02	5454815	5455862	A02p11720.2_BraZ1	104.7	-	517	754	1047	0.7201528
A02	5459000	5459721	A02p11730.2_BraZ1	354	-	293	687	721	0.9528432
A02	5460669	5462288	A02p11740.2_BraZ1	611.04	-	1413	1619	1619	1.0000000
A02	5463228	5465150	A02p11750.2_BraZ1	1425	+	500	1708	1922	0.8886576
A02	5467215	5468034	A02p11760.2_BraZ1	81.6	+	83	622	819	0.7594628
A02	5468765	5470255	A02p11770.2_BraZ1	1170	+	169	1301	1490	0.8731543
A02	5475194	5481548	A02p11780.2_BraZ1	1071	+	965	2973	6354	0.4678942
A02	5482707	5483130	A02p11790.2_BraZ1	42.3	-	197	423	423	1.0000000
A02	5486742	5488146	A02p11800.2_BraZ1	769.167	+	872	1386	1404	0.9871795
A02	5489416	5490222	A02p11810.2_BraZ1	8349	-	426	806	806	1.0000000
A02	5491230	5492445	A02p11820.2_BraZ1	470.156	+	779	823	1215	0.6773663
A02	5494211	5494586	A02p11830.2_BraZ1	37.5	-	332	375	375	1.0000000
A02	5495398	5497062	A02p11840.2_BraZ1	60385.5	-	425	1577	1664	0.9477164
A02	5506645	5507479	A02p11850.2_BraZ1	83.4	-	52	451	834	0.5407674
A02	5515756	5516805	A02p11860.2_BraZ1	759	+	127	692	1049	0.6596759
A02	5525317	5525650	A02p11870.2_BraZ1	33.3	-	164	267	333	0.8018018
A02	5530852	5531188	A02p11880.2_BraZ1	33.6	+	39	222	336	0.6607143
A02	5533960	5534968	A02p11890.2_BraZ1	397.575	+	203	889	1008	0.8819444
A02	5537295	5539307	A02p11900.2_BraZ1	846.34	+	1447	1952	2012	0.9701789
A02	5541316	5542197	A02p11910.2_BraZ1	75.3	+	239	880	881	0.9988649
A02	5543871	5544752	A02p11920.2_BraZ1	80.1	+	224	779	881	0.8842224
A02	5546844	5547725	A02p11930.2_BraZ1	80.1	+	142	792	881	0.8989784
A02	5551997	5552588	A02p11940.2_BraZ1	59.1	-	14	169	591	0.2859560
A02	5561313	5563309	A02p11950.2_BraZ1	585	+	100	973	1996	0.4874749
A02	5564561	5567867	A02p11960.2_BraZ1	590.772	-	707	3067	3306	0.9277072
A02	5568981	5576381	A02p11970.2_BraZ1	453	-	4652	6017	7400	0.8131081
A02	5577665	5580739	A02p11980.2_BraZ1	1515	+	677	2192	3074	0.7130774
A02	5578542	5579324	A02p11990.2_BraZ1	222	+	288	699	782	0.8938619
A02	5581161	5581867	A02p12000.2_BraZ1	417	-	431	706	706	1.0000000
A02	5588702	5591878	A02p12010.2_BraZ1	1488.91	-	725	2653	3176	0.8353274
A02	5597190	5598736	A02p12020.2_BraZ1	6540	+	757	1546	1546	1.0000000
A02	5600287	5602115	A02p12030.2_BraZ1	1173.75	+	1121	1828	1828	1.0000000
A02	5604208	5604638	A02p12040.2_BraZ1	170.625	+	350	430	430	1.0000000
A02	5607002	5608676	A02p12050.2_BraZ1	398	+	1538	1674	1674	1.0000000
A02	5608323	5609325	A02p12060.2_BraZ1	218.4	+	452	980	1002	0.9780439
A02	5613472	5615560	A02p12070.2_BraZ1	208.8	-	528	1424	2088	0.6819924
A02	5621826	5622711	A02p12080.2_BraZ1	88.5	-	837	885	885	1.0000000
A02	5631147	5632889	A02p12090.2_BraZ1	1659	+	830	1742	1742	1.0000000
A02	5636631	5637896	A02p12100.2_BraZ1	453.973	+	381	899	1265	0.7106720
A02	5637956	5638915	A02p12110.2_BraZ1	428.28	+	317	907	959	0.9457769
A02	5639582	5640443	A02p12120.2_BraZ1	448.875	-	339	861	861	1.0000000
A02	5641408	5643322	A02p12130.2_BraZ1	811.607	+	1097	1809	1914	0.9451411
A02	5644596	5646276	A02p12140.2_BraZ1	1533	+	249	1566	1680	0.9321429
A02	5647078	5647596	A02p12150.2_BraZ1	51.3	-	194	510	518	0.9845560
A02	5652006	5655450	A02p12160.2_BraZ1	20817	+	580	3293	3444	0.9561557
A02	5656098	5657644	A02p12170.2_BraZ1	1241.71	-	181	958	1546	0.6196637
A02	5658928	5685144	A02p12180.2_BraZ1	821.4	-	7915	22211	26216	0.8472307
A02	5666306	5666807	A02p12190.2_BraZ1	50.1	-	113	389	501	0.7764471
A02	5687304	5688582	A02p12200.2_BraZ1	729.474	+	183	768	1278	0.6009390
A02	5690506	5694473	A02p12210.2_BraZ1	1253.5	+	782	3079	3967	0.7761533
A02	5694786	5696347	A02p12220.2_BraZ1	921	-	349	1367	1561	0.8757207
A02	5697271	5700044	A02p12230.2_BraZ1	1508.33	+	1404	2773	2773	1.0000000
A02	5701172	5707762	A02p12240.2_BraZ1	690	-	2908	5650	6590	0.8573596
A02	5721670	5724593	A02p12250.2_BraZ1	1428.98	+	600	2496	2923	0.8539172
A02	5724913	5726071	A02p12260.2_BraZ1	433.2	-	995	1158	1158	1.0000000
A02	5727129	5730135	A02p12270.2_BraZ1	1375.94	+	887	2716	3006	0.9035263
A02	5731899	5732961	A02p12280.2_BraZ1	106.2	+	97	766	1062	0.7212806
A02	5733826	5739300	A02p12290.2_BraZ1	402	+	6115	5474	5474	1.0000000
A02	5740467	5742910	A02p12300.2_BraZ1	1607.93	+	746	1905	2443	0.7797790
A02	5744648	5747083	A02p12310.2_BraZ1	2355.75	-	1548	2318	2435	0.9519507
A02	5748719	5755835	A02p12320.2_BraZ1	585.75	+	1610	4850	7116	0.6815627
A02	5757342	5758098	A02p12330.2_BraZ1	75.6	-	70	634	756	0.8386244
A02	5765198	5765744	A02p12340.2_BraZ1	54.6	+	0	0	546	0.0000000
A02	5767305	5769481	A02p12350.2_BraZ1	1113.86	+	2422	2176	2176	1.0000000
A02	5772229	5775074	A02p12360.2_BraZ1	2556	+	180	1076	2845	0.3782074
A02	5776528	5778385	A02p12370.2_BraZ1	185.7	+	403	1779	1857	0.9579968
A02	5779159	5780136	A02p12380.2_BraZ1	732.343	-	355	977	977	1.0000000
A02	5786188	5787697	A02p12390.2_BraZ1	981	+	506	1455	1509	0.9642147
A02	5791224	5792556	A02p12400.2_BraZ1	133.2	+	947	1332	1332	1.0000000
A02	5793707	5794634	A02p12410.2_BraZ1	92.7	+	504	927	927	1.0000000
A02	5794789	5798549	A02p12420.2_BraZ1	1235.4	-	1285	3016	3760	0.8021277
A02	5798797	5798992	A02p12430.2_BraZ1	147	-	337	195	195	1.0000000
A02	5799684	5801895	A02p12440.2_BraZ1	1245.77	+	1699	2211	2211	1.0000000
A02	5802245	5804097	A02p12450.2_BraZ1	1245.6	-	583	1559	1852	0.8417926
A02	5808647	5809649	A02p12460.2_BraZ1	792	+	245	970	1002	0.9680639
A02	5809860	5812146	A02p12470.2_BraZ1	1956	-	274	1627	2286	0.7117235
A02	5813671	5815706	A02p12480.2_BraZ1	1157.14	-	390	1891	2035	0.9292383
A02	5818076	5820294	A02p12490.2_BraZ1	1153.7	-	12661	2218	2218	1.0000000
A02	5824670	5826134	A02p12500.2_BraZ1	802.5	+	521	1331	1464	0.9091530
A02	5826755	5828819	A02p12510.2_BraZ1	679.5	-	1608	2064	2064	1.0000000
A02	5830925	5833671	A02p12520.2_BraZ1	1218.8	-	936	1829	2746	0.6660597
A02	5835544	5836737	A02p12530.2_BraZ1	561.927	-	554	1084	1193	0.9086337
A02	5837568	5840422	A02p12540.2_BraZ1	2033.1	+	475	1967	2854	0.6892081
A02	5841422	5847275	A02p12550.2_BraZ1	3995.47	-	1218	5307	5853	0.9067145
A02	5849450	5855508	A02p12560.2_BraZ1	1473.07	-	2454	4268	6058	0.7045230
A02	5865630	5866740	A02p12570.2_BraZ1	111	-	350	967	1110	0.8711712
A02	5868287	5872863	A02p12580.2_BraZ1	2535.75	-	2011	4479	4576	0.9788024
A02	5873797	5874166	A02p12590.2_BraZ1	36.9	+	226	369	369	1.0000000
A02	5885710	5887880	A02p12600.2_BraZ1	1437	+	1325	2131	2170	0.9820276
A02	5889534	5892120	A02p12610.2_BraZ1	1718.84	+	370	1474	2586	0.5699922
A02	5896321	5898277	A02p12620.2_BraZ1	562.5	+	233	898	1956	0.4591002
A02	5899211	5900297	A02p12630.2_BraZ1	477	+	486	1020	1086	0.9392265
A02	5901478	5902152	A02p12640.2_BraZ1	387.75	+	117	449	674	0.6661721
A02	5902532	5904032	A02p12650.2_BraZ1	594.146	-	1120	1327	1500	0.8846667
A02	5905063	5907953	A02p12660.2_BraZ1	1615.52	+	188	1921	2890	0.6647059
A02	5908140	5908966	A02p12670.2_BraZ1	204	-	287	777	826	0.9406779
A02	5911187	5927012	A02p12680.2_BraZ1	1249.24	+	3005	12228	15825	0.7727014
A02	5912955	5914011	A02p12690.2_BraZ1	105.6	-	169	1019	1056	0.9649621
A02	5927637	5929941	A02p12700.2_BraZ1	1440.75	-	1505	2304	2304	1.0000000
A02	5935207	5938580	A02p12710.2_BraZ1	2201.5	+	1920	3221	3373	0.9549363
A02	5938990	5942299	A02p12720.2_BraZ1	1501.5	+	2112	3253	3309	0.9830765
A02	5942878	5945810	A02p12730.2_BraZ1	1828.82	-	837	2890	2932	0.9856753
A02	5946576	5948259	A02p12740.2_BraZ1	1001.25	-	454	1378	1683	0.8187760
A02	5949721	5950922	A02p12750.2_BraZ1	572.762	+	708	1186	1201	0.9875104
A02	5951256	5951426	A02p12760.2_BraZ1	13.5	+	158	170	170	1.0000000
A02	5951779	5952052	A02p12770.2_BraZ1	25.8	-	407	273	273	1.0000000
A02	5952432	5954715	A02p12780.2_BraZ1	962.5	-	1302	2283	2283	1.0000000
A02	5955802	5959281	A02p12790.2_BraZ1	2118.61	-	790	3048	3479	0.8761138
A02	5960004	5960833	A02p12800.2_BraZ1	930.6	-	341	640	829	0.7720145
A02	5961719	5962970	A02p12810.2_BraZ1	2560	+	1069	1240	1251	0.9912071
A02	5963226	5963731	A02p12820.2_BraZ1	426	-	545	505	505	1.0000000
A02	5965616	5967126	A02p12830.2_BraZ1	942	+	496	1227	1510	0.8125828
A02	5968088	5971524	A02p12840.2_BraZ1	1630.42	-	1236	3301	3436	0.9607101
A02	5980733	5982777	A02p12850.2_BraZ1	1113.25	+	309	1526	2044	0.7465754
A02	5983228	5983745	A02p12860.2_BraZ1	207	-	816	517	517	1.0000000
A02	5985819	5988081	A02p12870.2_BraZ1	1485	+	558	1940	2262	0.8576481
A02	5991756	5992622	A02p12880.2_BraZ1	639	+	365	866	866	1.0000000
A02	5995178	5997239	A02p12890.2_BraZ1	742.5	+	1285	1672	2061	0.8112566
A02	5997392	5998858	A02p12900.2_BraZ1	831.429	+	625	1466	1466	1.0000000
A02	6001139	6001761	A02p12910.2_BraZ1	410.294	+	493	622	622	1.0000000
A02	6002970	6006009	A02p12920.2_BraZ1	27816.8	-	968	2943	3039	0.9684107
A02	6025001	6025385	A02p12930.2_BraZ1	38.4	-	29	109	384	0.2838542
A02	6028114	6029416	A02p12940.2_BraZ1	321.48	+	549	1302	1302	1.0000000
A02	6029952	6030602	A02p12950.2_BraZ1	153	+	964	650	650	1.0000000
A02	6031424	6032018	A02p12960.2_BraZ1	59.4	+	510	594	594	1.0000000
A02	6056299	6057461	A02p12970.2_BraZ1	1029	-	301	1120	1162	0.9638554
A02	6061218	6062099	A02p12980.2_BraZ1	369	-	829	881	881	1.0000000
A02	6062107	6063355	A02p12990.2_BraZ1	486.692	-	1542	1248	1248	1.0000000
A02	6064564	6065619	A02p13000.2_BraZ1	960	-	638	988	1055	0.9364929
A02	6068788	6070445	A02p13010.2_BraZ1	999	-	441	1359	1657	0.8201569
A02	6079292	6079571	A02p13020.2_BraZ1	189	-	36	224	279	0.8028674
A02	6081515	6083897	A02p13030.2_BraZ1	1386.89	+	541	2334	2382	0.9798489
A02	6087738	6090411	A02p13040.2_BraZ1	1796.9	+	1756	2380	2673	0.8903853
A02	6092183	6093579	A02p13050.2_BraZ1	981.75	+	3693	1396	1396	1.0000000
A02	6098210	6098772	A02p13060.2_BraZ1	55.8	-	645	562	562	1.0000000
A02	6098768	6099491	A02p13070.2_BraZ1	496.125	-	597	723	723	1.0000000
A02	6101308	6102694	A02p13080.2_BraZ1	565.25	+	753	1386	1386	1.0000000
A02	6102759	6103787	A02p13090.2_BraZ1	852	-	179	368	1028	0.3579766
A02	6111885	6112817	A02p13100.2_BraZ1	852	+	324	567	932	0.6083691
A02	6113557	6120324	A02p13110.2_BraZ1	832.929	+	739	4034	6767	0.5961283
A02	6120995	6122476	A02p13120.2_BraZ1	45.6	+	252	727	1481	0.4908845
A02	6125260	6125701	A02p13130.2_BraZ1	351	+	144	441	441	1.0000000
A02	6126878	6127620	A02p13140.2_BraZ1	540	+	57	360	742	0.4851752
A02	6134742	6135195	A02p13150.2_BraZ1	45.3	-	40	388	453	0.8565121
A02	6153592	6153985	A02p13160.2_BraZ1	39.3	+	35	127	393	0.3231552
A02	6157642	6157805	A02p13170.2_BraZ1	138	+	222	163	163	1.0000000
A02	6159807	6160758	A02p13180.2_BraZ1	528	-	672	951	951	1.0000000
A02	6169802	6170296	A02p13190.2_BraZ1	282	+	956	494	494	1.0000000
A02	6178067	6179163	A02p13200.2_BraZ1	642	+	390	994	1096	0.9069343
A02	6193260	6194028	A02p13210.2_BraZ1	324	+	554	768	768	1.0000000
A02	6194122	6197039	A02p13220.2_BraZ1	1625.14	+	1761	2917	2917	1.0000000
A02	6208907	6211478	A02p13230.2_BraZ1	1232.22	+	1628	2440	2571	0.9490471
A02	6212306	6212975	A02p13240.2_BraZ1	66.9	-	556	669	669	1.0000000
A02	6216223	6221085	A02p13250.2_BraZ1	2663.5	+	1216	4216	4862	0.8671328
A02	6221787	6222879	A02p13260.2_BraZ1	573	+	387	1056	1092	0.9670330
A02	6223365	6224544	A02p13270.2_BraZ1	693	-	377	935	1179	0.7930449
A02	6241914	6243881	A02p13280.2_BraZ1	673.239	-	1458	1967	1967	1.0000000
A02	6244831	6249408	A02p13290.2_BraZ1	2590.86	-	1280	3778	4577	0.8254315
A02	6249973	6252219	A02p13300.2_BraZ1	550.585	+	1943	2246	2246	1.0000000
A02	6252822	6253358	A02p13310.2_BraZ1	363	+	540	485	536	0.9048507
A02	6253759	6256726	A02p13320.2_BraZ1	1353	-	2571	2967	2967	1.0000000
A02	6260388	6261423	A02p13330.2_BraZ1	324	-	960	1035	1035	1.0000000
A02	6265174	6266957	A02p13340.2_BraZ1	1455.54	-	189	889	1783	0.4985979
A02	6285824	6289441	A02p13350.2_BraZ1	1377.69	-	2311	3519	3617	0.9729057
A02	6291221	6293496	A02p13360.2_BraZ1	1179	-	1280	2165	2275	0.9516484
A02	6300226	6301586	A02p13370.2_BraZ1	219	+	1434	1261	1360	0.9272059
A02	6300535	6300924	A02p13380.2_BraZ1	195	+	956	389	389	1.0000000
A02	6302123	6310296	A02p13390.2_BraZ1	703.95	-	997	4112	8173	0.5031200
A02	6311076	6318180	A02p13400.2_BraZ1	2405.81	-	3185	6404	7104	0.9014640
A02	6365089	6367280	A02p13410.2_BraZ1	832	+	1960	2191	2191	1.0000000
A02	6382268	6382681	A02p13420.2_BraZ1	34.5	-	11	314	413	0.7602906
A02	6384935	6392334	A02p13430.2_BraZ1	3189.4	+	2727	6663	7399	0.9005271
A02	6394213	6397663	A02p13440.2_BraZ1	1661.37	-	693	2662	3450	0.7715942
A02	6400749	6402348	A02p13450.2_BraZ1	159.9	-	601	1514	1599	0.9468418
A02	6411659	6414541	A02p13460.2_BraZ1	1219.39	-	1542	2855	2882	0.9906315
A02	6415762	6418135	A02p13470.2_BraZ1	237.3	-	648	2140	2373	0.9018121
A02	6418335	6418808	A02p13480.2_BraZ1	258	+	400	473	473	1.0000000
A02	6425081	6425459	A02p13490.2_BraZ1	37.8	-	270	378	378	1.0000000
A02	6441887	6444146	A02p13500.2_BraZ1	373.043	+	1064	2259	2259	1.0000000
A02	6451693	6452833	A02p13510.2_BraZ1	114	+	109	938	1140	0.8228070
A02	6462420	6463276	A02p13520.2_BraZ1	312	-	561	856	856	1.0000000
A02	6476622	6479706	A02p13530.2_BraZ1	1572.52	+	555	2172	3084	0.7042801
A02	6492116	6495182	A02p13540.2_BraZ1	1479.11	+	1377	2478	3066	0.8082192
A02	6505993	6507320	A02p13550.2_BraZ1	405.446	-	722	1262	1327	0.9510173
A02	6507539	6510145	A02p13560.2_BraZ1	1906.09	+	1322	2502	2606	0.9600921
A02	6513217	6513690	A02p13570.2_BraZ1	381	-	2	151	473	0.3192389
A02	6522069	6525762	A02p13580.2_BraZ1	633.353	+	2694	3671	3693	0.9940428
A02	6525741	6526335	A02p13590.2_BraZ1	57.3	+	104	594	594	1.0000000
A02	6527212	6531700	A02p13600.2_BraZ1	2137.79	-	742	3788	4488	0.8440285
A02	6554235	6555851	A02p13610.2_BraZ1	1185	+	295	1370	1616	0.8477723
A02	6560839	6562206	A02p13620.2_BraZ1	5112	-	124	952	1367	0.6964155
A02	6566412	6567481	A02p13630.2_BraZ1	232	-	1244	1069	1069	1.0000000
A02	6567517	6570196	A02p13640.2_BraZ1	586.5	-	2260	2663	2679	0.9940276
A02	6571250	6574026	A02p13650.2_BraZ1	1721.2	-	2962	2776	2776	1.0000000
A02	6577798	6578604	A02p13660.2_BraZ1	360	+	169	806	806	1.0000000
A02	6582090	6584232	A02p13670.2_BraZ1	851.371	+	2030	2142	2142	1.0000000
A02	6586015	6588606	A02p13680.2_BraZ1	1390.14	-	1270	2591	2591	1.0000000
A02	6593116	6594667	A02p13690.2_BraZ1	155.1	-	851	1551	1551	1.0000000
A02	6600212	6601611	A02p13700.2_BraZ1	886.364	-	1116	1399	1399	1.0000000
A02	6605227	6605942	A02p13710.2_BraZ1	525	+	456	715	715	1.0000000
A02	6606080	6606266	A02p13720.2_BraZ1	18.6	-	261	186	186	1.0000000
A02	6608863	6609046	A02p13730.2_BraZ1	18.3	-	69	183	183	1.0000000
A02	6613615	6615638	A02p13740.2_BraZ1	1141.43	-	1300	2023	2023	1.0000000
A02	6626481	6629328	A02p13750.2_BraZ1	1341.31	-	921	2847	2847	1.0000000
A02	6637464	6640570	A02p13760.2_BraZ1	1558.09	-	1416	2872	3106	0.9246619
A02	6643087	6645227	A02p13770.2_BraZ1	1123.62	-	726	1961	2140	0.9163551
A02	6650778	6651246	A02p13780.2_BraZ1	46.8	+	672	468	468	1.0000000
A02	6652490	6653817	A02p13790.2_BraZ1	1245	+	585	1191	1327	0.8975132
A02	6655117	6656395	A02p13800.2_BraZ1	127.8	+	1065	1278	1278	1.0000000
A02	6658680	6662245	A02p13810.2_BraZ1	2310	+	809	3138	3565	0.8802244
A02	6662641	6663749	A02p13820.2_BraZ1	687	-	288	1021	1108	0.9214801
A02	6667974	6669348	A02p13830.2_BraZ1	1152.87	+	671	1374	1374	1.0000000
A02	6674892	6679160	A02p13840.2_BraZ1	641.348	+	2083	3830	4268	0.8973758
A02	6684037	6684427	A02p13850.2_BraZ1	39	+	1	30	390	0.0769231
A02	6689757	6691185	A02p13860.2_BraZ1	1200	+	141	1045	1428	0.7317927
A02	6694771	6694876	A02p13870.2_BraZ1	10.5	-	100	105	105	1.0000000
A02	6705068	6706545	A02p13880.2_BraZ1	13392	-	684	1414	1477	0.9573460
A02	6715887	6716166	A02p13890.2_BraZ1	520	+	470	279	279	1.0000000
A02	6718947	6719368	A02p13900.2_BraZ1	285	-	585	421	421	1.0000000
A02	6720135	6720246	A02p13910.2_BraZ1	11.1	-	90	111	111	1.0000000
A02	6722116	6722647	A02p13920.2_BraZ1	50.1	+	22	284	531	0.5348399
A02	6726691	6727065	A02p13930.2_BraZ1	261	-	597	374	374	1.0000000
A02	6731878	6732052	A02p13940.2_BraZ1	17.4	+	0	0	174	0.0000000
A02	6733498	6734427	A02p13950.2_BraZ1	180.6	-	0	0	929	0.0000000
A02	6734734	6736077	A02p13960.2_BraZ1	430.95	-	7	113	1343	0.0841400
A02	6737394	6740602	A02p13970.2_BraZ1	477.75	+	3347	3208	3208	1.0000000
A02	6750471	6753627	A02p13980.2_BraZ1	17815.5	+	1832	2931	3156	0.9287072
A02	6755667	6756945	A02p13990.2_BraZ1	127.8	-	640	1278	1278	1.0000000
A02	6760369	6762484	A02p14000.2_BraZ1	1284.48	-	269	1803	2115	0.8524823
A02	6763876	6767234	A02p14010.2_BraZ1	1285.96	+	1154	2652	3358	0.7897558
A02	6767625	6768560	A02p14020.2_BraZ1	213.281	-	252	924	935	0.9882353
A02	6770673	6771657	A02p14030.2_BraZ1	613.813	-	1030	984	984	1.0000000
A02	6773426	6775079	A02p14040.2_BraZ1	8478.75	-	279	1427	1653	0.8632789
A02	6776988	6777384	A02p14050.2_BraZ1	39.6	-	888	396	396	1.0000000
A02	6781234	6782197	A02p14060.2_BraZ1	96.3	+	11	174	963	0.1806854
A02	6786494	6786964	A02p14070.2_BraZ1	38.7	-	5	228	470	0.4851064
A02	6787289	6788253	A02p14080.2_BraZ1	504	-	162	636	964	0.6597511
A02	6788669	6789283	A02p14090.2_BraZ1	331.364	-	42	504	614	0.8208469
A02	6790724	6791627	A02p14100.2_BraZ1	666	-	66	408	903	0.4518272
A02	6796597	6797302	A02p14110.2_BraZ1	70.5	+	0	0	705	0.0000000
A02	6797998	6800247	A02p14120.2_BraZ1	72139.5	+	282	1527	2249	0.6789684
A02	6800759	6802083	A02p14130.2_BraZ1	631.364	-	1161	1282	1324	0.9682779
A02	6804085	6805286	A02p14140.2_BraZ1	618.106	+	602	1201	1201	1.0000000
A02	6805725	6808802	A02p14150.2_BraZ1	1640.78	-	1942	3049	3077	0.9909002
A02	6811385	6813517	A02p14160.2_BraZ1	1243.2	+	91	1360	2132	0.6378987
A02	6817682	6821122	A02p14170.2_BraZ1	907.2	+	2287	3387	3440	0.9845930
A02	6822371	6824594	A02p14180.2_BraZ1	19341.8	-	84	1360	2223	0.6117859
A02	6825283	6825415	A02p14190.2_BraZ1	13.2	+	39	132	132	1.0000000
A02	6828264	6830269	A02p14200.2_BraZ1	1485	+	684	1794	2005	0.8947631
A02	6830478	6832157	A02p14210.2_BraZ1	435	-	1471	1679	1679	1.0000000
A02	6833875	6833992	A02p14220.2_BraZ1	11.7	-	18	117	117	1.0000000
A02	6837833	6838166	A02p14230.2_BraZ1	30.3	-	388	333	333	1.0000000
A02	6842130	6842622	A02p14240.2_BraZ1	49.2	+	588	492	492	1.0000000
A02	6848595	6850531	A02p14250.2_BraZ1	2418.75	+	815	1936	1936	1.0000000
A02	6851377	6852814	A02p14260.2_BraZ1	1134.9	-	245	912	1437	0.6346555
A02	6853850	6854486	A02p14270.2_BraZ1	63.6	+	57	554	636	0.8710692
A02	6854759	6857306	A02p14280.2_BraZ1	1513.78	-	1189	2401	2547	0.9426777
A02	6859760	6860795	A02p14290.2_BraZ1	103.5	-	391	1035	1035	1.0000000
A02	6863525	6865463	A02p14300.2_BraZ1	193.8	+	379	1847	1938	0.9530444
A02	6866928	6870362	A02p14310.2_BraZ1	2311.62	-	450	2406	3434	0.7006407
A02	6873678	6875335	A02p14320.2_BraZ1	971.429	-	1388	1657	1657	1.0000000
A02	6875942	6876239	A02p14330.2_BraZ1	29.7	-	345	297	297	1.0000000
A02	6878080	6878269	A02p14340.2_BraZ1	18.9	-	156	189	189	1.0000000
A02	6878821	6880689	A02p14350.2_BraZ1	1137	-	551	1670	1868	0.8940043
A02	6882504	6884087	A02p14360.2_BraZ1	963.769	+	545	1576	1583	0.9955780
A02	6884682	6885927	A02p14370.2_BraZ1	124.5	+	375	1115	1245	0.8955823
A02	6893435	6894445	A02p14380.2_BraZ1	933	+	281	993	1010	0.9831683
A02	6895478	6898599	A02p14390.2_BraZ1	2412.46	+	1984	2933	3121	0.9397629
A02	6899068	6901123	A02p14400.2_BraZ1	533.857	+	710	1951	2055	0.9493917
A02	6905900	6906239	A02p14410.2_BraZ1	33.9	-	14	83	339	0.2448378
A02	6908857	6909534	A02p14420.2_BraZ1	303	-	295	677	677	1.0000000
A02	6910978	6911413	A02p14430.2_BraZ1	363	-	47	380	435	0.8735632
A02	6913229	6920763	A02p14440.2_BraZ1	4048.83	+	1762	4761	7534	0.6319352
A02	6921834	6922866	A02p14450.2_BraZ1	103.2	+	127	937	1032	0.9079458
A02	6923965	6924815	A02p14460.2_BraZ1	585	+	83	316	850	0.3717647
A02	6925660	6926674	A02p14470.2_BraZ1	101.4	+	438	885	1014	0.8727810
A02	6928040	6929057	A02p14480.2_BraZ1	101.7	+	182	985	1017	0.9685349
A02	6929982	6932188	A02p14490.2_BraZ1	708	+	412	1847	2206	0.8372620
A02	6934274	6948370	A02p14500.2_BraZ1	2880.04	+	3188	8970	14096	0.6363508
A02	6949207	6950036	A02p14510.2_BraZ1	213	+	735	829	829	1.0000000
A02	6950499	6952211	A02p14520.2_BraZ1	1278	+	1094	1712	1712	1.0000000
A02	6953244	6961164	A02p14530.2_BraZ1	2940.3	-	3934	7713	7920	0.9738637
A02	6965756	6967385	A02p14540.2_BraZ1	482.771	+	625	1624	1629	0.9969307
A02	6970107	6970667	A02p14550.2_BraZ1	210	+	5	101	560	0.1803571
A02	6971112	6975498	A02p14560.2_BraZ1	149.4	-	1001	4150	4386	0.9461924
A02	6977377	6981120	A02p14570.2_BraZ1	377.455	+	2021	3737	3743	0.9983970
A02	6981410	6982513	A02p14580.2_BraZ1	1080	+	300	1048	1103	0.9501360
A02	6983070	6983506	A02p14590.2_BraZ1	330	-	410	436	436	1.0000000
A02	6992436	6992856	A02p14600.2_BraZ1	342	-	103	412	420	0.9809524
A02	6994482	6997036	A02p14610.2_BraZ1	1317.33	+	1106	2419	2554	0.9471418
A02	6997439	6997720	A02p14620.2_BraZ1	23.4	-	223	281	281	1.0000000
A02	6999169	7005230	A02p14630.2_BraZ1	1385.45	-	1947	4564	6061	0.7530110
A02	7009522	7013420	A02p14640.2_BraZ1	1421.37	+	1547	3366	3898	0.8635197
A02	7017179	7021316	A02p14650.2_BraZ1	1362	+	2803	4107	4137	0.9927484
A02	7021689	7024551	A02p14660.2_BraZ1	1340.94	-	584	1730	2862	0.6044724
A02	7027787	7029269	A02p14670.2_BraZ1	323.684	-	743	1482	1482	1.0000000
A02	7030945	7033565	A02p14680.2_BraZ1	1095.39	-	219	1806	2620	0.6893130
A02	7037048	7037748	A02p14690.2_BraZ1	327	+	562	700	700	1.0000000
A02	7039083	7040892	A02p14700.2_BraZ1	1236	+	1578	1809	1809	1.0000000
A02	7041878	7042583	A02p14710.2_BraZ1	70.5	-	456	705	705	1.0000000
A02	7043452	7045394	A02p14720.2_BraZ1	668.25	+	1176	1726	1942	0.8887745
A02	7046739	7049558	A02p14730.2_BraZ1	1561.55	-	686	2454	2819	0.8705215
A02	7050595	7052259	A02p14740.2_BraZ1	921.815	-	819	1644	1664	0.9879808
A02	7052614	7052829	A02p14750.2_BraZ1	14.4	-	225	215	215	1.0000000
A02	7052992	7056796	A02p14760.2_BraZ1	1685.06	-	1033	3680	3804	0.9674028
A02	7064053	7064593	A02p14770.2_BraZ1	246	+	749	540	540	1.0000000
A02	7073861	7076597	A02p14780.2_BraZ1	273.6	-	69	1132	2736	0.4137427
A02	7138715	7140838	A02p14790.2_BraZ1	11331.4	-	624	2044	2123	0.9627885
A02	7141701	7143254	A02p14800.2_BraZ1	441.562	+	6	149	1553	0.0959433
A02	7151894	7152123	A02p14810.2_BraZ1	17.1	-	65	216	229	0.9432315
A02	7157495	7159451	A02p14820.2_BraZ1	545.143	-	543	1415	1956	0.7234151
A02	7164597	7165761	A02p14830.2_BraZ1	444.333	+	1595	1164	1164	1.0000000
A02	7171539	7174005	A02p14840.2_BraZ1	1247.85	+	1727	2382	2466	0.9659367
A02	7175126	7176949	A02p14850.2_BraZ1	1041.1	-	743	1698	1823	0.9314317
A02	7181298	7182200	A02p14860.2_BraZ1	528	+	0	0	902	0.0000000
A02	7185933	7188494	A02p14870.2_BraZ1	2008.57	+	1020	2472	2561	0.9652479
A02	7190632	7191151	A02p14880.2_BraZ1	365.125	-	102	519	519	1.0000000
A02	7192404	7194445	A02p14890.2_BraZ1	1467.73	+	549	1901	2041	0.9314062
A02	7194914	7196678	A02p14900.2_BraZ1	694.026	-	1198	1697	1764	0.9620181
A02	7198398	7199253	A02p14910.2_BraZ1	138	+	1599	855	855	1.0000000
A02	7204843	7209161	A02p14920.2_BraZ1	2023.4	-	1248	4251	4318	0.9844835
A02	7213664	7213870	A02p14930.2_BraZ1	11.1	-	321	206	206	1.0000000
A02	7216131	7217075	A02p14940.2_BraZ1	555	-	215	705	944	0.7468221
A02	7220423	7220528	A02p14950.2_BraZ1	10.5	+	19	84	105	0.8000000
A02	7226915	7228750	A02p14960.2_BraZ1	1422	+	1081	1827	1835	0.9956403
A02	7230483	7231982	A02p14970.2_BraZ1	5252	-	927	1499	1499	1.0000000
A02	7233168	7233489	A02p14980.2_BraZ1	32.1	-	352	321	321	1.0000000
A02	7234446	7235580	A02p14990.2_BraZ1	113.4	+	76	855	1134	0.7539682
A02	7243046	7243420	A02p15000.2_BraZ1	291	+	405	374	374	1.0000000
A02	7244338	7245433	A02p15010.2_BraZ1	109.5	-	276	997	1095	0.9105023
A02	7248647	7249175	A02p15020.2_BraZ1	52.8	+	487	528	528	1.0000000
A02	7252554	7253652	A02p15030.2_BraZ1	109.8	-	183	872	1098	0.7941712
A02	7254711	7256684	A02p15040.2_BraZ1	868.943	-	1286	1973	1973	1.0000000
A02	7275787	7276517	A02p15050.2_BraZ1	360	+	29	381	730	0.5219178
A02	7282728	7284934	A02p15060.2_BraZ1	1839	+	131	1237	2206	0.5607435
A02	7301374	7301551	A02p15070.2_BraZ1	17.7	-	277	177	177	1.0000000
A02	7305997	7307259	A02p15080.2_BraZ1	742.241	-	663	1231	1262	0.9754358
A02	7311363	7311759	A02p15090.2_BraZ1	39.6	-	55	346	396	0.8737374
A02	7320861	7321570	A02p15100.2_BraZ1	606	+	124	529	709	0.7461213
A02	7327403	7328102	A02p15110.2_BraZ1	69.9	-	401	699	699	1.0000000
A02	7330206	7337224	A02p15120.2_BraZ1	3604.5	+	2104	5733	7018	0.8168994
A02	7339255	7340417	A02p15130.2_BraZ1	882	-	111	1101	1162	0.9475043
A02	7347449	7355269	A02p15140.2_BraZ1	58008.5	-	642	5702	7820	0.7291560
A02	7358883	7360688	A02p15150.2_BraZ1	649.552	-	488	1694	1805	0.9385042
A02	7363227	7364963	A02p15160.2_BraZ1	1155	+	1162	1736	1736	1.0000000
A02	7366290	7368527	A02p15170.2_BraZ1	1062.38	+	1199	2237	2237	1.0000000
A02	7371810	7372898	A02p15180.2_BraZ1	484.5	+	16	456	1088	0.4191177
A02	7379055	7380286	A02p15190.2_BraZ1	982.312	-	182	712	1231	0.5783916
A02	7383652	7385311	A02p15200.2_BraZ1	165.9	-	212	1498	1659	0.9029536
A02	7387620	7391095	A02p15210.2_BraZ1	1281.11	+	1738	3381	3475	0.9729496
A02	7393086	7394127	A02p15220.2_BraZ1	1006.07	+	556	1041	1041	1.0000000
A02	7394498	7397319	A02p15230.2_BraZ1	860.338	-	3026	2821	2821	1.0000000
A02	7410416	7411788	A02p15240.2_BraZ1	735	+	515	1372	1372	1.0000000
A02	7416064	7417043	A02p15250.2_BraZ1	771	-	390	956	979	0.9765067
A02	7423203	7424307	A02p15260.2_BraZ1	110.4	+	698	1104	1104	1.0000000
A02	7428666	7429357	A02p15270.2_BraZ1	561	+	463	691	691	1.0000000
A02	7431529	7432636	A02p15280.2_BraZ1	110.7	-	513	852	1107	0.7696477
A02	7435802	7440357	A02p15290.2_BraZ1	1918.66	+	865	3653	4555	0.8019758
A02	7441160	7441457	A02p15300.2_BraZ1	25.5	-	887	297	297	1.0000000
A02	7444358	7445884	A02p15310.2_BraZ1	843	+	777	1526	1526	1.0000000
A02	7448379	7449504	A02p15320.2_BraZ1	112.5	+	174	881	1125	0.7831111
A02	7455617	7456784	A02p15330.2_BraZ1	431.682	-	0	0	1167	0.0000000
A02	7457788	7459650	A02p15340.2_BraZ1	972.875	-	812	1715	1862	0.9210526
A02	7462655	7462847	A02p15350.2_BraZ1	19.2	-	11	153	192	0.7968750
A02	7473463	7474702	A02p15360.2_BraZ1	123.9	+	84	892	1239	0.7199354
A02	7475036	7475564	A02p15370.2_BraZ1	247.5	+	843	528	528	1.0000000
A02	7477136	7479395	A02p15380.2_BraZ1	1033.94	-	1424	2012	2259	0.8906596
A02	7483553	7484953	A02p15390.2_BraZ1	734.25	-	458	1400	1400	1.0000000
A02	7489243	7491550	A02p15400.2_BraZ1	1047.14	+	24	787	2307	0.3411357
A02	7494177	7497471	A02p15410.2_BraZ1	1231.96	+	1448	3120	3294	0.9471767
A02	7497942	7501766	A02p15420.2_BraZ1	2252.06	+	1571	3655	3824	0.9558054
A02	7501907	7504028	A02p15430.2_BraZ1	934.312	-	1215	2121	2121	1.0000000
A02	7510222	7511785	A02p15440.2_BraZ1	827.273	+	196	463	1563	0.2962252
A02	7514859	7516196	A02p15450.2_BraZ1	921	+	694	1337	1337	1.0000000
A02	7517544	7518900	A02p15460.2_BraZ1	135.6	+	170	1089	1356	0.8030974
A02	7521065	7521536	A02p15470.2_BraZ1	47.1	-	101	394	471	0.8365180
A02	7524434	7526648	A02p15480.2_BraZ1	1139.68	-	326	1428	2214	0.6449865
A02	7539188	7539401	A02p15490.2_BraZ1	21.3	-	349	213	213	1.0000000
A02	7550264	7552021	A02p15500.2_BraZ1	1076.4	+	275	1504	1757	0.8560045
A02	7555271	7561099	A02p15510.2_BraZ1	559.457	+	3190	5561	5828	0.9541867
A02	7562257	7563942	A02p15520.2_BraZ1	1499.4	+	404	1575	1685	0.9347181
A02	7564220	7566057	A02p15530.2_BraZ1	877.886	-	842	1800	1837	0.9798585
A02	7566164	7567141	A02p15540.2_BraZ1	548.261	+	946	977	977	1.0000000
A02	7569573	7587779	A02p15550.2_BraZ1	1899	+	3323	11384	18206	0.6252884
A02	7576504	7577925	A02p15560.2_BraZ1	331.2	-	161	1275	1421	0.8972555
A02	7596408	7598169	A02p15570.2_BraZ1	960.758	+	168	938	1761	0.5326519
A02	7599091	7601908	A02p15580.2_BraZ1	281.7	-	826	2817	2817	1.0000000
A02	7609997	7610844	A02p15590.2_BraZ1	198	+	2	236	847	0.2786305
A02	7618022	7618468	A02p15600.2_BraZ1	222	+	21	321	446	0.7197309
A02	7621681	7622807	A02p15610.2_BraZ1	1026	+	197	1024	1126	0.9094139
A02	7624027	7626817	A02p15620.2_BraZ1	1425.88	+	1916	2725	2790	0.9767025
A02	7630068	7631231	A02p15630.2_BraZ1	252	+	0	0	1163	0.0000000
A02	7633738	7634464	A02p15640.2_BraZ1	72.6	-	214	718	726	0.9889807
A02	7637339	7637710	A02p15650.2_BraZ1	204	-	67	371	371	1.0000000
A02	7644575	7645070	A02p15660.2_BraZ1	49.5	-	68	437	495	0.8828283
A02	7657211	7660098	A02p15670.2_BraZ1	1293.77	-	63	387	2887	0.1340492
A02	7664411	7665721	A02p15680.2_BraZ1	1200	-	0	0	1310	0.0000000
A02	7674059	7675197	A02p15690.2_BraZ1	1071	-	0	0	1138	0.0000000
A02	7677495	7678511	A02p15700.2_BraZ1	549	+	0	0	1016	0.0000000
A02	7679197	7680504	A02p15710.2_BraZ1	949.385	-	0	0	1307	0.0000000
A02	7687684	7690569	A02p15720.2_BraZ1	1287.94	-	0	0	2885	0.0000000
A02	7694880	7696190	A02p15730.2_BraZ1	1200	-	0	0	1310	0.0000000
A02	7704527	7705821	A02p15740.2_BraZ1	1025.89	-	0	0	1294	0.0000000
A02	7707976	7708993	A02p15750.2_BraZ1	669	+	0	0	1017	0.0000000
A02	7709680	7710987	A02p15760.2_BraZ1	949.385	-	0	0	1307	0.0000000
A02	7721855	7722497	A02p15770.2_BraZ1	64.2	+	69	333	642	0.5186916
A02	7723470	7723893	A02p15780.2_BraZ1	527.333	-	178	375	423	0.8865248
A02	7724490	7725623	A02p15790.2_BraZ1	2966.5	-	265	923	1133	0.8146514
A02	7730530	7730995	A02p15800.2_BraZ1	222	-	280	465	465	1.0000000
A02	7732489	7734103	A02p15810.2_BraZ1	6396.38	+	1054	1562	1614	0.9677819
A02	7737507	7738786	A02p15820.2_BraZ1	315	+	370	1168	1279	0.9132134
A02	7742709	7743096	A02p15830.2_BraZ1	38.7	-	22	246	387	0.6356589
A02	7750371	7752334	A02p15840.2_BraZ1	447	-	1779	1963	1963	1.0000000
A02	7759440	7761363	A02p15850.2_BraZ1	1249.7	+	828	1872	1923	0.9734789
A02	7762245	7762966	A02p15860.2_BraZ1	390	-	19	299	721	0.4147018
A02	7765451	7767734	A02p15870.2_BraZ1	721.895	+	2049	2283	2283	1.0000000
A02	7768085	7770995	A02p15880.2_BraZ1	2139.64	-	457	2158	2910	0.7415808
A02	7780105	7781878	A02p15890.2_BraZ1	357	+	964	1479	1773	0.8341793
A02	7785838	7788036	A02p15900.2_BraZ1	1640.05	+	887	2114	2198	0.9617835
A02	7788050	7788439	A02p15910.2_BraZ1	240	+	46	299	389	0.7686375
A02	7791362	7792103	A02p15920.2_BraZ1	1378.12	-	92	387	741	0.5222672
A02	7797879	7799723	A02p15930.2_BraZ1	929.911	-	1243	1811	1844	0.9821041
A02	7804093	7804327	A02p15940.2_BraZ1	23.4	-	281	234	234	1.0000000
A02	7804364	7804553	A02p15950.2_BraZ1	18.9	-	194	189	189	1.0000000
A02	7805683	7806691	A02p15960.2_BraZ1	279	-	433	1008	1008	1.0000000
A02	7835239	7837862	A02p15970.2_BraZ1	1121.06	+	426	2129	2623	0.8116660
A02	7839374	7839664	A02p15980.2_BraZ1	21.6	-	69	281	290	0.9689655
A02	7843622	7846461	A02p15990.2_BraZ1	1218.56	-	2500	2839	2839	1.0000000
A02	7856625	7858558	A02p16000.2_BraZ1	1761	+	459	1836	1933	0.9498189
A02	7862333	7862622	A02p16010.2_BraZ1	162	-	312	289	289	1.0000000
A02	7864255	7867369	A02p16020.2_BraZ1	1111.4	+	3392	3114	3114	1.0000000
A02	7870710	7871622	A02p16030.2_BraZ1	1159.2	-	739	912	912	1.0000000
A02	7873793	7874800	A02p16040.2_BraZ1	44.7	+	421	1007	1007	1.0000000
A02	7904164	7905220	A02p16050.2_BraZ1	105.6	+	28	902	1056	0.8541667
A02	7919038	7920049	A02p16060.2_BraZ1	522	+	647	992	1011	0.9812067
A02	7920834	7921118	A02p16070.2_BraZ1	192	-	143	284	284	1.0000000
A02	7924577	7926606	A02p16080.2_BraZ1	435.682	-	1644	1892	2029	0.9324790
A02	7943741	7947084	A02p16090.2_BraZ1	1117.61	+	99	1748	3343	0.5228837
A02	7957856	7959213	A02p16100.2_BraZ1	324	-	50	1006	1357	0.7413412
A02	7968967	7970424	A02p16110.2_BraZ1	637	+	577	1393	1457	0.9560741
A02	7974468	7975254	A02p16120.2_BraZ1	387	+	765	786	786	1.0000000
A02	7975515	7979763	A02p16130.2_BraZ1	1838.67	+	2327	3511	4248	0.8265066
A02	7980660	7981475	A02p16140.2_BraZ1	567	-	329	815	815	1.0000000
A02	7982695	7983886	A02p16150.2_BraZ1	119.1	+	280	927	1191	0.7783375
A02	7989473	7992016	A02p16160.2_BraZ1	1922.4	+	864	2496	2543	0.9815179
A02	7992192	7994299	A02p16170.2_BraZ1	1084.68	-	1551	2107	2107	1.0000000
A02	7999625	8002681	A02p16180.2_BraZ1	1149	-	1654	2924	3056	0.9568063
A02	8003947	8004088	A02p16190.2_BraZ1	14.1	-	2	32	141	0.2269503
A02	8009786	8012138	A02p16200.2_BraZ1	970.109	-	1099	2015	2352	0.8567177
A02	8012407	8014671	A02p16210.2_BraZ1	1419.13	-	1447	2190	2264	0.9673145
A02	8015118	8016803	A02p16220.2_BraZ1	484.319	-	641	1669	1685	0.9905044
A02	8017887	8022355	A02p16230.2_BraZ1	920.455	-	2768	4108	4468	0.9194270
A02	8023331	8026316	A02p16240.2_BraZ1	1740.11	-	883	2796	2985	0.9366834
A02	8029778	8033804	A02p16250.2_BraZ1	1744.71	-	1130	3313	4026	0.8229011
A02	8040228	8041065	A02p16260.2_BraZ1	689.85	+	80	499	837	0.5961768
A02	8052422	8053082	A02p16270.2_BraZ1	66	-	459	660	660	1.0000000
A02	8055194	8057547	A02p16280.2_BraZ1	9297.75	+	1271	2353	2353	1.0000000
A02	8060183	8061064	A02p16290.2_BraZ1	759	-	375	881	881	1.0000000
A02	8063021	8063789	A02p16300.2_BraZ1	76.8	-	327	768	768	1.0000000
A02	8070780	8071890	A02p16310.2_BraZ1	590.162	+	256	1010	1110	0.9099099
A02	8072609	8076492	A02p16320.2_BraZ1	627	-	6809	2225	3883	0.5730106
A02	8077883	8080004	A02p16330.2_BraZ1	627	-	4897	2121	2121	1.0000000
A02	8081399	8083525	A02p16340.2_BraZ1	627	-	402	1767	2126	0.8311383
A02	8084920	8087071	A02p16350.2_BraZ1	627	-	17	1130	2151	0.5253370
A02	8088463	8088829	A02p16360.2_BraZ1	36.6	-	29	366	366	1.0000000
A02	8090223	8092357	A02p16370.2_BraZ1	627	-	11484	2131	2134	0.9985942
A02	8093586	8096599	A02p16380.2_BraZ1	2624.14	+	1343	3013	3013	1.0000000
A02	8097219	8099899	A02p16390.2_BraZ1	1644.07	-	107	817	2680	0.3048508
A02	8107063	8109747	A02p16400.2_BraZ1	1644.07	+	71	928	2684	0.3457526
A02	8113240	8123160	A02p16410.2_BraZ1	786	+	6064	9397	9920	0.9472782
A02	8125049	8126048	A02p16420.2_BraZ1	99.9	+	356	944	999	0.9449449
A02	8127250	8128003	A02p16430.2_BraZ1	75.3	+	271	753	753	1.0000000
A02	8139305	8141075	A02p16440.2_BraZ1	177	+	121	1121	1770	0.6333333
A02	8143013	8143331	A02p16450.2_BraZ1	31.8	-	12	21	318	0.0660377
A02	8144672	8146112	A02p16460.2_BraZ1	8500	-	1086	1440	1440	1.0000000
A02	8147816	8149044	A02p16470.2_BraZ1	1011.48	-	121	468	1228	0.3811075
A02	8162455	8165078	A02p16480.2_BraZ1	1080.76	-	1495	2584	2623	0.9851315
A02	8166181	8170358	A02p16490.2_BraZ1	2304.63	-	2274	3893	4177	0.9320086
A02	8173153	8173587	A02p16500.2_BraZ1	345	+	502	434	434	1.0000000
A02	8175581	8175860	A02p16510.2_BraZ1	27	-	32	279	279	1.0000000
A02	8182121	8182631	A02p16520.2_BraZ1	51	-	14	159	510	0.3117647
A02	8189233	8189741	A02p16530.2_BraZ1	300	-	699	508	508	1.0000000
A02	8193655	8194143	A02p16540.2_BraZ1	342	-	64	390	488	0.7991803
A02	8199211	8201672	A02p16550.2_BraZ1	390.326	-	132	558	2461	0.2267371
A02	8205974	8206379	A02p16560.2_BraZ1	40.5	+	44	188	405	0.4641975
A02	8210971	8211321	A02p16570.2_BraZ1	249	+	127	350	350	1.0000000
A02	8211941	8213860	A02p16580.2_BraZ1	155.1	-	520	1400	1919	0.7295467
A02	8218754	8219379	A02p16590.2_BraZ1	369	+	178	586	625	0.9376000
A02	8219955	8221053	A02p16600.2_BraZ1	4387.5	+	23	505	1098	0.4599271
A02	8225031	8225886	A02p16610.2_BraZ1	638.25	+	44	730	855	0.8538012
A02	8226170	8230002	A02p16620.2_BraZ1	2042.84	-	370	2771	3832	0.7231211
A02	8231694	8232279	A02p16630.2_BraZ1	258	+	582	585	585	1.0000000
A02	8232384	8233131	A02p16640.2_BraZ1	74.7	+	329	747	747	1.0000000
A02	8234454	8234769	A02p16650.2_BraZ1	31.5	+	93	214	315	0.6793651
A02	8239788	8240160	A02p16660.2_BraZ1	258	+	77	335	372	0.9005376
A02	8240574	8241433	A02p16670.2_BraZ1	381.207	-	294	821	859	0.9557625
A02	8242400	8244509	A02p16680.2_BraZ1	11810.4	+	1372	2109	2109	1.0000000
A02	8244873	8247744	A02p16690.2_BraZ1	1514.68	-	1958	2813	2871	0.9797980
A02	8251624	8253349	A02p16700.2_BraZ1	172.5	-	462	1565	1725	0.9072464
A02	8258978	8260677	A02p16710.2_BraZ1	687.464	-	199	1156	1699	0.6804003
A02	8265283	8268560	A02p16720.2_BraZ1	1345.79	+	569	2239	3277	0.6832469
A02	8270672	8271825	A02p16730.2_BraZ1	568.807	-	386	1153	1153	1.0000000
A02	8274597	8275314	A02p16740.2_BraZ1	71.7	+	65	437	717	0.6094840
A02	8276367	8276496	A02p16750.2_BraZ1	12.9	-	192	129	129	1.0000000
A02	8278009	8281388	A02p16760.2_BraZ1	1887.27	-	943	2982	3379	0.8825096
A02	8283474	8286686	A02p16770.2_BraZ1	1903.79	-	1429	3120	3212	0.9713574
A02	8288117	8288723	A02p16780.2_BraZ1	522	+	2	2	606	0.0033003
A02	8291238	8291954	A02p16790.2_BraZ1	460.833	+	0	0	716	0.0000000
A02	8293097	8297071	A02p16800.2_BraZ1	1462.64	-	358	2506	3974	0.6305989
A02	8322240	8327169	A02p16810.2_BraZ1	422.938	+	2555	4811	4929	0.9760600
A02	8328819	8332019	A02p16820.2_BraZ1	1804.05	-	669	2792	3200	0.8725000
A02	8334064	8342388	A02p16830.2_BraZ1	193.5	-	3489	7922	8324	0.9517059
A02	8345970	8348973	A02p16840.2_BraZ1	1907.1	-	1159	2935	3003	0.9773560
A02	8354990	8356338	A02p16850.2_BraZ1	5586	+	560	1348	1348	1.0000000
A02	8357273	8358308	A02p16860.2_BraZ1	702	+	291	948	1035	0.9159420
A02	8360141	8362617	A02p16870.2_BraZ1	676.2	+	999	2410	2476	0.9733441
A02	8364500	8366463	A02p16880.2_BraZ1	626.167	+	108	1149	1963	0.5853286
A02	8368538	8369641	A02p16890.2_BraZ1	385.826	-	332	1027	1103	0.9310970
A02	8373988	8375426	A02p16900.2_BraZ1	931.52	+	241	1335	1438	0.9283727
A02	8381458	8381641	A02p16910.2_BraZ1	18.3	-	117	183	183	1.0000000
A02	8397172	8398699	A02p16920.2_BraZ1	152.7	-	76	1069	1527	0.7000655
A02	8411191	8412886	A02p16930.2_BraZ1	1055.86	-	499	1695	1695	1.0000000
A02	8417915	8420586	A02p16940.2_BraZ1	562.6	-	192	1736	2671	0.6499438
A02	8422105	8422783	A02p16950.2_BraZ1	67.8	+	75	600	678	0.8849558
A02	8423954	8424651	A02p16960.2_BraZ1	232.65	-	254	653	697	0.9368723
A02	8426745	8429447	A02p16970.2_BraZ1	1650.94	+	517	1930	2702	0.7142857
A02	8430008	8432143	A02p16980.2_BraZ1	1764.2	-	265	1136	2135	0.5320843
A02	8439271	8440978	A02p16990.2_BraZ1	170.7	+	115	1228	1707	0.7193907
A02	8441463	8446163	A02p17000.2_BraZ1	894	+	1815	4284	4700	0.9114894
A02	8447405	8447721	A02p17010.2_BraZ1	207	+	632	316	316	1.0000000
A02	8452564	8453718	A02p17020.2_BraZ1	969	+	81	547	1154	0.4740035
A02	8469797	8471197	A02p17030.2_BraZ1	1134	+	71	782	1400	0.5585715
A02	8473299	8477026	A02p17040.2_BraZ1	1012.5	+	1232	2808	3727	0.7534210
A02	8479382	8483016	A02p17050.2_BraZ1	2877	-	48	968	3634	0.2663731
A02	8500962	8502295	A02p17060.2_BraZ1	554.114	-	116	593	1333	0.4448612
A02	8504499	8505947	A02p17070.2_BraZ1	513	+	323	1303	1448	0.8998619
A02	8506911	8508765	A02p17080.2_BraZ1	1377.75	+	286	1312	1854	0.7076591
A02	8509007	8509973	A02p17090.2_BraZ1	96.6	-	143	797	966	0.8250518
A02	8512912	8514371	A02p17100.2_BraZ1	1392	-	83	1079	1459	0.7395476
A02	8522652	8531056	A02p17110.2_BraZ1	3972.26	-	1768	5472	8404	0.6511185
A02	8532419	8532894	A02p17120.2_BraZ1	1089	+	793	475	475	1.0000000
A02	8533452	8534226	A02p17130.2_BraZ1	255	+	507	774	774	1.0000000
A02	8534283	8537033	A02p17140.2_BraZ1	357.5	+	1338	2707	2750	0.9843636
A02	8537910	8539798	A02p17150.2_BraZ1	1078.96	+	376	1806	1888	0.9565678
A02	8545246	8547602	A02p17160.2_BraZ1	1257	+	1165	2133	2356	0.9053481
A02	8552513	8554145	A02p17170.2_BraZ1	1104	-	82	213	1632	0.1305147
A02	8557753	8559373	A02p17180.2_BraZ1	4260	-	25	653	1620	0.4030864
A02	8571792	8573420	A02p17190.2_BraZ1	2288.57	-	3	81	1628	0.0497543
A02	8575758	8577735	A02p17200.2_BraZ1	203	-	18	271	1977	0.1370764
A02	8583025	8584660	A02p17210.2_BraZ1	5874	-	2	37	1635	0.0226300
A02	8598458	8599114	A02p17220.2_BraZ1	377.799	-	106	564	656	0.8597561
A02	8606452	8607466	A02p17230.2_BraZ1	101.4	+	6	20	1014	0.0197239
A02	8629057	8629684	A02p17240.2_BraZ1	61.5	-	133	591	627	0.9425837
A02	8635357	8637310	A02p17250.2_BraZ1	6528	+	362	1498	1953	0.7670251
A02	8637685	8646671	A02p17260.2_BraZ1	1259.68	-	4593	6788	8986	0.7553973
A02	8652182	8654185	A02p17270.2_BraZ1	1029.68	-	429	1689	2003	0.8432351
A02	8654814	8654946	A02p17280.2_BraZ1	13.2	-	73	132	132	1.0000000
A02	8660743	8661031	A02p17290.2_BraZ1	28.8	-	210	288	288	1.0000000
A02	8665587	8665779	A02p17300.2_BraZ1	19.2	+	369	192	192	1.0000000
A02	8667928	8670760	A02p17310.2_BraZ1	780.839	+	907	2455	2832	0.8668785
A02	8670667	8676765	A02p17320.2_BraZ1	1188.63	+	2371	5277	6098	0.8653657
A02	8682486	8684868	A02p17330.2_BraZ1	1300.75	+	1218	2340	2382	0.9823678
A02	8694339	8696225	A02p17340.2_BraZ1	969	+	537	1599	1886	0.8478261
A02	8701862	8705014	A02p17350.2_BraZ1	2000.52	+	900	2950	3152	0.9359137
A02	8709485	8710598	A02p17360.2_BraZ1	5633	+	660	1113	1113	1.0000000
A02	8711820	8716479	A02p17370.2_BraZ1	1756.58	-	15804	4622	4659	0.9920584
A02	8720699	8721239	A02p17380.2_BraZ1	234	+	13	120	540	0.2222222
A02	8724889	8725477	A02p17390.2_BraZ1	300	+	558	562	588	0.9557823
A02	8728477	8728597	A02p17400.2_BraZ1	12	-	181	115	120	0.9583333
A02	8730705	8733124	A02p17410.2_BraZ1	1068.57	+	1357	2325	2419	0.9611410
A02	8733502	8735630	A02p17420.2_BraZ1	951.786	-	1745	2126	2128	0.9990602
A02	8741763	8743241	A02p17430.2_BraZ1	635.478	-	384	1436	1478	0.9715832
A02	8744680	8745163	A02p17440.2_BraZ1	279	-	205	481	483	0.9958592
A02	8749814	8753475	A02p17450.2_BraZ1	2574.29	+	896	2556	3661	0.6981699
A02	8753865	8754966	A02p17460.2_BraZ1	395.379	-	420	1001	1101	0.9091735
A02	8755676	8757356	A02p17470.2_BraZ1	1596	-	1163	1679	1680	0.9994048
A02	8758121	8759923	A02p17480.2_BraZ1	163.2	+	667	1632	1802	0.9056604
A02	8760688	8762305	A02p17490.2_BraZ1	1245	-	386	1571	1617	0.9715523
A02	8764584	8767272	A02p17500.2_BraZ1	1091.17	-	1420	2688	2688	1.0000000
A02	8769846	8772412	A02p17510.2_BraZ1	1023.78	-	1382	2566	2566	1.0000000
A02	8774465	8775754	A02p17520.2_BraZ1	812.114	-	549	1280	1289	0.9930179
A02	8778780	8780825	A02p17530.2_BraZ1	855.771	+	1132	2045	2045	1.0000000
A02	8786609	8787173	A02p17540.2_BraZ1	53.7	-	152	506	564	0.8971631
A02	8788974	8789310	A02p17550.2_BraZ1	33.6	-	429	336	336	1.0000000
A02	8790562	8792237	A02p17560.2_BraZ1	1050	+	224	1551	1675	0.9259701
A02	8806065	8818215	A02p17570.2_BraZ1	1582.17	+	8902	11586	12150	0.9535803
A02	8811496	8813779	A02p17580.2_BraZ1	270	-	2916	2283	2283	1.0000000
A02	8822877	8824737	A02p17590.2_BraZ1	162	+	592	1509	1860	0.8112903
A02	8830199	8833271	A02p17600.2_BraZ1	3020.62	-	945	2996	3072	0.9752604
A02	8833869	8836298	A02p17610.2_BraZ1	257.812	-	1277	2429	2429	1.0000000
A02	8841151	8841757	A02p17620.2_BraZ1	60.6	+	163	540	606	0.8910891
A02	8843517	8844123	A02p17630.2_BraZ1	420	-	323	598	606	0.9867987
A02	8845471	8845768	A02p17640.2_BraZ1	210	+	87	297	297	1.0000000
A02	8850514	8851646	A02p17650.2_BraZ1	1075.75	+	166	934	1132	0.8250883
A02	8856567	8856900	A02p17660.2_BraZ1	225	-	12	57	333	0.1711712
A02	8861198	8863071	A02p17670.2_BraZ1	1587	+	449	1839	1873	0.9818473
A02	8863709	8864815	A02p17680.2_BraZ1	693	+	229	1046	1106	0.9457505
A02	8866151	8868796	A02p17690.2_BraZ1	1581.25	+	346	1994	2645	0.7538753
A02	8870191	8872698	A02p17700.2_BraZ1	2535	-	423	2326	2507	0.9278021
A02	8872698	8872960	A02p17710.2_BraZ1	153	-	18	194	262	0.7404580
A02	8881119	8881299	A02p17720.2_BraZ1	18	+	224	180	180	1.0000000
A02	8881393	8881669	A02p17730.2_BraZ1	27.6	+	340	276	276	1.0000000
A02	8882426	8883613	A02p17740.2_BraZ1	735	-	1250	1163	1187	0.9797810
A02	8888473	8892923	A02p17750.2_BraZ1	2257.2	+	1529	3765	4450	0.8460674
A02	8893291	8894308	A02p17760.2_BraZ1	101.7	-	286	898	1017	0.8829892
A02	8896213	8897348	A02p17770.2_BraZ1	849	+	433	1105	1135	0.9735683
A02	8902214	8905254	A02p17780.2_BraZ1	2091.25	+	584	2722	3040	0.8953947
A02	8907503	8910639	A02p17790.2_BraZ1	1983.16	+	4282	3136	3136	1.0000000
A02	8912550	8915218	A02p17800.2_BraZ1	1397.81	+	802	2652	2668	0.9940030
A02	8917090	8923119	A02p17810.2_BraZ1	3122.36	-	1690	4315	6029	0.7157074
A02	8925255	8927300	A02p17820.2_BraZ1	1039.14	-	299	1390	2045	0.6797066
A02	8930002	8930746	A02p17830.2_BraZ1	74.4	-	310	744	744	1.0000000
A02	8932390	8937073	A02p17840.2_BraZ1	1282.28	-	345	2003	4683	0.4277173
A02	8942317	8943322	A02p17850.2_BraZ1	313.5	+	76	410	1005	0.4079602
A02	8943733	8946081	A02p17860.2_BraZ1	4022.25	+	691	2183	2348	0.9297274
A02	8944016	8944392	A02p17870.2_BraZ1	273	+	387	336	376	0.8936170
A02	8949846	8953631	A02p17880.2_BraZ1	4186	+	823	3025	3785	0.7992074
A02	8954540	8956429	A02p17890.2_BraZ1	827.7	-	625	1679	1889	0.8888301
A02	8959846	8962618	A02p17900.2_BraZ1	926.71	-	894	2765	2772	0.9974747
A02	8964519	8967994	A02p17910.2_BraZ1	2456.31	-	396	2149	3475	0.6184173
A02	8969966	8973146	A02p17920.2_BraZ1	1511.77	+	755	2923	3180	0.9191824
A02	8974228	8976070	A02p17930.2_BraZ1	589.235	-	396	1769	1842	0.9603692
A02	8977192	8978302	A02p17940.2_BraZ1	111	-	1046	1110	1110	1.0000000
A02	8983942	8985040	A02p17950.2_BraZ1	109.8	+	1505	1098	1098	1.0000000
A02	8985378	8986644	A02p17960.2_BraZ1	571.286	+	310	1233	1266	0.9739336
A02	8988028	8989522	A02p17970.2_BraZ1	813.361	+	193	1261	1494	0.8440428
A02	8990082	8994171	A02p17980.2_BraZ1	2574.19	-	2608	4089	4089	1.0000000
A02	8995195	8996894	A02p17990.2_BraZ1	901.959	+	670	1637	1699	0.9635080
A02	8997488	9001928	A02p18000.2_BraZ1	2795	-	1111	3463	4440	0.7799550
A02	9002445	9003094	A02p18010.2_BraZ1	59.1	+	0	0	649	0.0000000
A02	9011725	9014383	A02p18020.2_BraZ1	1059.2	+	693	2311	2658	0.8694507
A02	9014742	9016381	A02p18030.2_BraZ1	867	+	250	1320	1639	0.8053691
A02	9017226	9020373	A02p18040.2_BraZ1	901.461	+	1712	3147	3147	1.0000000
A02	9021795	9023580	A02p18050.2_BraZ1	563.893	+	653	1677	1785	0.9394958
A02	9027820	9028103	A02p18060.2_BraZ1	201	-	27	283	283	1.0000000
A02	9033640	9033835	A02p18070.2_BraZ1	19.5	-	33	195	195	1.0000000
A02	9041609	9042244	A02p18080.2_BraZ1	396	-	256	608	635	0.9574803
A02	9050251	9050777	A02p18090.2_BraZ1	348	+	8	19	526	0.0361217
A02	9054103	9056317	A02p18100.2_BraZ1	221.4	+	135	1540	2214	0.6955736
A02	9058358	9060202	A02p18110.2_BraZ1	833.207	+	459	1769	1844	0.9593276
A02	9060755	9061398	A02p18120.2_BraZ1	579	-	202	643	643	1.0000000
A02	9064313	9064688	A02p18130.2_BraZ1	282	-	2379	375	375	1.0000000
A02	9065893	9071028	A02p18140.2_BraZ1	1619.33	-	1402	3535	5135	0.6884128
A02	9069108	9069687	A02p18150.2_BraZ1	273	+	62	13	579	0.0224525
A02	9074609	9081528	A02p18160.2_BraZ1	3300.63	-	1321	4323	6919	0.6248013
A02	9087836	9090559	A02p18170.2_BraZ1	1356	+	647	2388	2723	0.8769739
A02	9106989	9109793	A02p18180.2_BraZ1	520.667	+	873	2190	2804	0.7810271
A02	9121226	9123877	A02p18190.2_BraZ1	801	-	1462	2627	2651	0.9909468
A02	9128455	9130288	A02p18200.2_BraZ1	995.772	-	583	1636	1833	0.8925259
A02	9134908	9138804	A02p18210.2_BraZ1	1737.1	-	842	2162	3896	0.5549281
A02	9143033	9144800	A02p18220.2_BraZ1	297.391	-	1002	1301	1767	0.7362761
A02	9155080	9155689	A02p18230.2_BraZ1	60.9	+	23	143	609	0.2348112
A02	9168414	9169864	A02p18240.2_BraZ1	417	-	987	1450	1450	1.0000000
A02	9176923	9182020	A02p18250.2_BraZ1	925.738	-	1431	4007	5097	0.7861487
A02	9194228	9195155	A02p18260.2_BraZ1	273	-	645	927	927	1.0000000
A02	9198075	9199066	A02p18270.2_BraZ1	747	-	170	828	991	0.8355197
A02	9200677	9204238	A02p18280.2_BraZ1	319.114	-	2685	3561	3561	1.0000000
A02	9208311	9208904	A02p18290.2_BraZ1	348	-	577	593	593	1.0000000
A02	9209273	9209531	A02p18300.2_BraZ1	25.8	+	71	258	258	1.0000000
A02	9210721	9211479	A02p18310.2_BraZ1	442.294	+	389	758	758	1.0000000
A02	9213346	9215884	A02p18320.2_BraZ1	253.8	+	811	2111	2538	0.8317573
A02	9219386	9222092	A02p18330.2_BraZ1	1406.44	+	1079	1916	2706	0.7080562
A02	9223963	9225994	A02p18340.2_BraZ1	1384.09	-	54	567	2031	0.2791728
A02	9232176	9233777	A02p18350.2_BraZ1	531.882	-	105	828	1601	0.5171767
A02	9240862	9244217	A02p18360.2_BraZ1	1598.19	-	222	1728	3355	0.5150521
A02	9247992	9250892	A02p18370.2_BraZ1	1084.84	+	790	2772	2900	0.9558620
A02	9252173	9253073	A02p18380.2_BraZ1	651.293	-	259	723	900	0.8033333
A02	9255251	9256363	A02p18390.2_BraZ1	628.448	-	475	1112	1112	1.0000000
A02	9259521	9260157	A02p18400.2_BraZ1	573	-	235	636	636	1.0000000
A02	9262425	9264563	A02p18410.2_BraZ1	479.88	-	814	1555	2138	0.7273152
A02	9267647	9268047	A02p18420.2_BraZ1	201	-	473	400	400	1.0000000
A02	9268844	9269571	A02p18430.2_BraZ1	189	-	1061	727	727	1.0000000
A02	9270213	9271053	A02p18440.2_BraZ1	84	-	124	538	840	0.6404762
A02	9275442	9275730	A02p18450.2_BraZ1	28.8	-	71	280	288	0.9722222
A02	9296439	9297726	A02p18460.2_BraZ1	128.7	+	356	923	1287	0.7171717
A02	9298298	9300727	A02p18470.2_BraZ1	2072.87	-	296	1397	2429	0.5751338
A02	9303635	9304103	A02p18480.2_BraZ1	309	+	112	451	468	0.9636752
A02	9306114	9306882	A02p18490.2_BraZ1	76.8	-	5	44	768	0.0572917
A02	9311222	9311474	A02p18500.2_BraZ1	12.9	-	38	169	252	0.6706349
A02	9313809	9316992	A02p18510.2_BraZ1	722.114	-	2004	3181	3183	0.9993716
A02	9322219	9324200	A02p18520.2_BraZ1	977.5	-	183	1325	1981	0.6688541
A02	9341654	9342251	A02p18530.2_BraZ1	59.7	+	89	251	597	0.4204355
A02	9365117	9367491	A02p18540.2_BraZ1	856.8	+	322	2115	2374	0.8909014
A02	9373238	9375546	A02p18550.2_BraZ1	1220.32	-	522	2292	2308	0.9930676
A02	9378524	9386347	A02p18560.2_BraZ1	1624.31	-	1481	5884	7823	0.7521411
A02	9387845	9390482	A02p18570.2_BraZ1	169.8	+	348	2064	2637	0.7827076
A02	9392267	9393887	A02p18580.2_BraZ1	162	+	230	1283	1620	0.7919753
A02	9396268	9396928	A02p18590.2_BraZ1	192	+	173	464	660	0.7030303
A02	9397699	9397906	A02p18600.2_BraZ1	20.7	-	110	191	207	0.9227053
A02	9403903	9405427	A02p18610.2_BraZ1	152.4	+	6	164	1524	0.1076116
A02	9413923	9415653	A02p18620.2_BraZ1	75	+	388	1233	1730	0.7127168
A02	9435824	9437201	A02p18630.2_BraZ1	866.25	+	31	825	1377	0.5991285
A02	9459691	9460810	A02p18640.2_BraZ1	75	+	707	1119	1119	1.0000000
A02	9463872	9464239	A02p18650.2_BraZ1	300	-	205	367	367	1.0000000
A02	9464150	9465435	A02p18660.2_BraZ1	398.769	-	595	1285	1285	1.0000000
A02	9469085	9470255	A02p18670.2_BraZ1	171	-	970	1170	1170	1.0000000
A02	9470322	9473443	A02p18680.2_BraZ1	198	-	1292	2706	3121	0.8670298
A02	9471930	9473205	A02p18690.2_BraZ1	8520	-	141	862	1275	0.6760784
A02	9478418	9479832	A02p18700.2_BraZ1	751.2	+	61	930	1414	0.6577086
A02	9480561	9481988	A02p18710.2_BraZ1	1056	+	14	135	1427	0.0946041
A02	9485305	9486474	A02p18720.2_BraZ1	566.375	+	546	830	1169	0.7100086
A02	9492818	9493117	A02p18730.2_BraZ1	23.7	-	428	299	299	1.0000000
A02	9500073	9501326	A02p18740.2_BraZ1	597	+	870	1226	1253	0.9784517
A02	9507169	9507508	A02p18750.2_BraZ1	33.9	+	55	225	339	0.6637168
A02	9508422	9509898	A02p18760.2_BraZ1	135	-	640	1415	1476	0.9586721
A02	9510273	9511373	A02p18770.2_BraZ1	489	-	253	1014	1100	0.9218182
A02	9513175	9513472	A02p18780.2_BraZ1	29.7	+	20	245	297	0.8249158
A02	9521298	9524274	A02p18790.2_BraZ1	1302	+	222	1289	2976	0.4331317
A02	9527492	9528107	A02p18800.2_BraZ1	42.9	+	267	509	615	0.8276423
A02	9530692	9536234	A02p18810.2_BraZ1	5608.37	+	4468	5318	5542	0.9595814
A02	9560976	9561618	A02p18820.2_BraZ1	298.5	+	29	399	642	0.6214953
A02	9561573	9562482	A02p18830.2_BraZ1	735	+	0	0	909	0.0000000
A02	9570489	9570759	A02p18840.2_BraZ1	27	+	7	186	270	0.6888889
A02	9571003	9571441	A02p18850.2_BraZ1	336	+	18	420	438	0.9589041
A02	9571840	9580390	A02p18860.2_BraZ1	2420.86	-	3219	6480	8550	0.7578948
A02	9582193	9589925	A02p18870.2_BraZ1	248.7	-	1648	5581	7732	0.7218055
A02	9590486	9591383	A02p18880.2_BraZ1	315.857	+	235	526	897	0.5863991
A02	9592511	9603316	A02p18890.2_BraZ1	2682.35	+	3894	8876	10805	0.8214715
A02	9604723	9605428	A02p18900.2_BraZ1	591	+	360	705	705	1.0000000
A02	9605577	9608230	A02p18910.2_BraZ1	1586.89	-	1068	2653	2653	1.0000000
A02	9637998	9648076	A02p18920.2_BraZ1	2336	-	9882	8797	10078	0.8728914
A02	9653281	9655069	A02p18930.2_BraZ1	288	+	1072	1779	1788	0.9949664
A02	9662559	9664546	A02p18940.2_BraZ1	653.309	+	694	1810	1987	0.9109210
A02	9670960	9673569	A02p18950.2_BraZ1	1228.2	+	612	2108	2609	0.8079724
A02	9677244	9678067	A02p18960.2_BraZ1	4845.75	-	5	342	823	0.4155529
A02	9680365	9681189	A02p18970.2_BraZ1	4845.75	-	0	0	824	0.0000000
A02	9682914	9684284	A02p18980.2_BraZ1	655.5	-	361	1370	1370	1.0000000
A02	9686905	9687982	A02p18990.2_BraZ1	164.769	+	943	1077	1077	1.0000000
A02	9692603	9693426	A02p19000.2_BraZ1	473.538	-	71	599	823	0.7278250
A02	9694583	9695020	A02p19010.2_BraZ1	327	-	78	437	437	1.0000000
A02	9706761	9707882	A02p19020.2_BraZ1	744	+	38	672	1121	0.5994648
A02	9712411	9714297	A02p19030.2_BraZ1	231	-	1380	1886	1886	1.0000000
A02	9725268	9729095	A02p19040.2_BraZ1	1480	-	1251	2621	3827	0.6848707
A02	9735664	9758458	A02p19050.2_BraZ1	1612.8	-	8783	17585	22794	0.7714750
A02	9767319	9767880	A02p19060.2_BraZ1	56.1	+	3	73	561	0.1301248
A02	9777155	9782281	A02p19070.2_BraZ1	920.833	-	250	2982	5126	0.5817401
A02	9784503	9788246	A02p19080.2_BraZ1	1399.2	+	1591	3258	3743	0.8704248
A02	9789585	9791584	A02p19090.2_BraZ1	1032.77	+	777	1792	1999	0.8964482
A02	9799166	9799427	A02p19100.2_BraZ1	26.1	-	261	261	261	1.0000000
A02	9802529	9803738	A02p19110.2_BraZ1	120.9	+	267	1190	1209	0.9842845
A02	9804777	9805833	A02p19120.2_BraZ1	105.6	-	1866	1020	1056	0.9659091
A02	9807518	9808715	A02p19130.2_BraZ1	119.7	+	175	808	1197	0.6750209
A02	9811698	9814498	A02p19140.2_BraZ1	1316.25	+	1229	2373	2800	0.8475000
A02	9817940	9821843	A02p19150.2_BraZ1	2768.22	+	1194	3087	3903	0.7909300
A02	9822532	9826828	A02p19160.2_BraZ1	2394.14	-	2557	4067	4296	0.9466946
A02	9828721	9829825	A02p19170.2_BraZ1	426	-	1149	1104	1104	1.0000000
A02	9834508	9835549	A02p19180.2_BraZ1	104.1	-	191	951	1041	0.9135447
A02	9839936	9842664	A02p19190.2_BraZ1	1239.81	-	705	1712	2728	0.6275660
A02	9858524	9860656	A02p19200.2_BraZ1	1779	-	134	1540	2132	0.7223265
A02	9864020	9868263	A02p19210.2_BraZ1	3002.88	-	1072	3455	4243	0.8142824
A02	9871974	9875368	A02p19220.2_BraZ1	1234.52	-	824	2981	3394	0.8783147
A02	9879011	9879899	A02p19230.2_BraZ1	86.7	+	76	271	888	0.3051802
A02	9880052	9880169	A02p19240.2_BraZ1	11.7	+	0	0	117	0.0000000
A02	9899815	9900478	A02p19250.2_BraZ1	573	+	120	497	663	0.7496229
A02	9921998	9923581	A02p19260.2_BraZ1	1134	+	197	1169	1583	0.7384713
A02	9925761	9926037	A02p19270.2_BraZ1	27.6	+	40	261	276	0.9456522
A02	9926850	9927636	A02p19280.2_BraZ1	708	-	286	732	786	0.9312977
A02	9929430	9929595	A02p19290.2_BraZ1	16.5	+	257	165	165	1.0000000
A02	9934425	9940196	A02p19300.2_BraZ1	828.571	-	3250	5101	5771	0.8839023
A02	9940785	9942288	A02p19310.2_BraZ1	1320	-	491	1503	1503	1.0000000
A02	9943443	9944705	A02p19320.2_BraZ1	399.62	+	446	1237	1262	0.9801902
A02	9948517	9950611	A02p19330.2_BraZ1	573.846	+	445	1593	2094	0.7607450
A02	9951955	9952303	A02p19340.2_BraZ1	34.8	+	61	303	348	0.8706896
A02	9953840	9954539	A02p19350.2_BraZ1	69.9	+	891	699	699	1.0000000
A02	9957040	9957718	A02p19360.2_BraZ1	540	+	863	678	678	1.0000000
A02	9959918	9962512	A02p19370.2_BraZ1	717.161	-	382	2262	2594	0.8720123
A02	9964076	9967461	A02p19380.2_BraZ1	2390.68	+	608	2985	3385	0.8818316
A02	9968320	9970697	A02p19390.2_BraZ1	786.667	-	1282	1998	2377	0.8405553
A02	9971183	9971760	A02p19400.2_BraZ1	105	+	281	577	577	1.0000000
A02	9973873	9978363	A02p19410.2_BraZ1	2400.31	+	1070	4092	4490	0.9113586
A02	9982103	9982995	A02p19420.2_BraZ1	864	-	0	0	892	0.0000000
A02	9983241	9983574	A02p19430.2_BraZ1	33.3	-	24	54	333	0.1621622
A02	9985064	9994055	A02p19440.2_BraZ1	2429.05	+	1290	5703	8991	0.6343009
A02	9996068	9998846	A02p19450.2_BraZ1	1287.6	-	132	1129	2778	0.4064075
A02	10002800	10004101	A02p19460.2_BraZ1	1035.45	-	137	551	1301	0.4235204
A02	10013509	10014373	A02p19470.2_BraZ1	470.662	-	89	763	864	0.8831019
A02	10015310	10015601	A02p19480.2_BraZ1	192	+	154	291	291	1.0000000
A02	10015512	10016588	A02p19490.2_BraZ1	354	-	266	917	1076	0.8522305
A02	10017204	10017801	A02p19500.2_BraZ1	312	+	608	597	597	1.0000000
A02	10019337	10022845	A02p19510.2_BraZ1	1891.39	-	752	2794	3508	0.7964652
A02	10024818	10025191	A02p19520.2_BraZ1	222	-	0	0	373	0.0000000
A02	10028023	10030245	A02p19530.2_BraZ1	1272.96	-	70	909	2222	0.4090909
A02	10032562	10032838	A02p19540.2_BraZ1	237	-	408	276	276	1.0000000
A02	10034972	10035582	A02p19550.2_BraZ1	575.4	+	558	493	610	0.8081967
A02	10036987	10037113	A02p19560.2_BraZ1	12.6	+	0	0	126	0.0000000
A02	10041711	10043312	A02p19570.2_BraZ1	975.484	+	377	1204	1601	0.7520300
A02	10044396	10044999	A02p19580.2_BraZ1	60.3	-	51	490	603	0.8126037
A02	10049453	10052806	A02p19590.2_BraZ1	896.727	+	4	201	3353	0.0599463
A02	10055924	10058067	A02p19600.2_BraZ1	1022.4	+	55	1093	2143	0.5100327
A02	10058674	10058977	A02p19610.2_BraZ1	30.3	+	121	303	303	1.0000000
A02	10062711	10062942	A02p19620.2_BraZ1	23.1	+	125	231	231	1.0000000
A02	10065825	10067318	A02p19630.2_BraZ1	1199.58	+	27	848	1493	0.5679839
A02	10073038	10073513	A02p19640.2_BraZ1	192	-	426	475	475	1.0000000
A02	10079918	10080254	A02p19650.2_BraZ1	246	+	31	214	336	0.6369048
A02	10083572	10084004	A02p19660.2_BraZ1	43.2	+	33	330	432	0.7638889
A02	10083890	10084271	A02p19670.2_BraZ1	192	+	55	325	381	0.8530183
A02	10086534	10092049	A02p19680.2_BraZ1	450	-	3635	5042	5515	0.9142339
A02	10094169	10096512	A02p19690.2_BraZ1	354	-	1448	1659	2343	0.7080666
A02	10097690	10098506	A02p19700.2_BraZ1	81.6	+	46	378	816	0.4632353
A02	10102239	10103628	A02p19710.2_BraZ1	1277.1	+	451	1389	1389	1.0000000
A02	10103867	10112511	A02p19720.2_BraZ1	870.4	-	4990	7585	8644	0.8774873
A02	10110831	10111152	A02p19730.2_BraZ1	32.1	+	89	244	321	0.7601246
A02	10115175	10117594	A02p19740.2_BraZ1	978.937	+	1170	2233	2419	0.9231087
A02	10118252	10118678	A02p19750.2_BraZ1	42.6	-	272	426	426	1.0000000
A02	10124221	10124403	A02p19760.2_BraZ1	123	-	114	182	182	1.0000000
A02	10124461	10125553	A02p19770.2_BraZ1	109.2	-	255	974	1092	0.8919414
A02	10128759	10129059	A02p19780.2_BraZ1	30	-	1350	300	300	1.0000000
A02	10139283	10140256	A02p19790.2_BraZ1	6898.5	-	46	616	973	0.6330935
A02	10144973	10145174	A02p19800.2_BraZ1	20.1	+	207	201	201	1.0000000
A02	10146536	10147230	A02p19810.2_BraZ1	411	-	298	649	694	0.9351585
A02	10155255	10156509	A02p19820.2_BraZ1	429	-	480	1078	1254	0.8596491
A02	10159102	10159274	A02p19830.2_BraZ1	108	-	127	172	172	1.0000000
A02	10159637	10159961	A02p19840.2_BraZ1	32.4	+	136	324	324	1.0000000
A02	10160224	10160509	A02p19850.2_BraZ1	28.5	+	22	208	285	0.7298245
A02	10161272	10176305	A02p19860.2_BraZ1	881.763	+	5970	12129	15033	0.8068250
A02	10163739	10165981	A02p19870.2_BraZ1	856.275	+	1485	2199	2242	0.9808207
A02	10176807	10177201	A02p19880.2_BraZ1	594	+	160	355	394	0.9010152
A02	10178126	10179389	A02p19890.2_BraZ1	126.3	+	1020	1237	1263	0.9794141
A02	10184131	10186750	A02p19900.2_BraZ1	1086	+	268	2089	2619	0.7976327
A02	10190510	10192091	A02p19910.2_BraZ1	993.92	-	1215	1561	1581	0.9873498
A02	10193015	10193607	A02p19920.2_BraZ1	381	+	281	303	592	0.5118243
A02	10193921	10195440	A02p19930.2_BraZ1	907.773	-	332	1430	1519	0.9414088
A02	10198244	10198586	A02p19940.2_BraZ1	255	-	177	342	342	1.0000000
A02	10201779	10202115	A02p19950.2_BraZ1	1303.5	-	342	336	336	1.0000000
A02	10203739	10204642	A02p19960.2_BraZ1	260.471	-	757	903	903	1.0000000
A02	10206889	10207984	A02p19970.2_BraZ1	109.5	+	101	1032	1095	0.9424658
A02	10211667	10212094	A02p19980.2_BraZ1	102	-	30	228	427	0.5339578
A02	10215607	10226187	A02p19990.2_BraZ1	2260.66	+	6044	9541	10580	0.9017959
A02	10229187	10232153	A02p20000.2_BraZ1	1872.2	+	1152	2925	2966	0.9861767
A02	10237679	10242978	A02p20010.2_BraZ1	1299.54	+	5304	5299	5299	1.0000000
A02	10243985	10245812	A02p20020.2_BraZ1	20625	+	426	1580	1827	0.8648057
A02	10255492	10258128	A02p20030.2_BraZ1	887.019	+	813	2365	2636	0.8971927
A02	10259425	10260178	A02p20040.2_BraZ1	75.3	+	36	522	753	0.6932271
A02	10263317	10263770	A02p20050.2_BraZ1	45.3	-	10	91	453	0.2008830
A02	10268852	10269939	A02p20060.2_BraZ1	597.609	+	81	730	1087	0.6715732
A02	10274322	10274619	A02p20070.2_BraZ1	29.7	+	40	297	297	1.0000000
A02	10275217	10276185	A02p20080.2_BraZ1	496.696	-	154	859	968	0.8873967
A02	10284500	10285457	A02p20090.2_BraZ1	492.315	+	370	957	957	1.0000000
A02	10288578	10289310	A02p20100.2_BraZ1	519.167	+	2	62	732	0.0846995
A02	10289304	10289628	A02p20110.2_BraZ1	31.8	+	10	53	324	0.1635803
A02	10296656	10297475	A02p20120.2_BraZ1	79.2	+	33	362	819	0.4420024
A02	10303120	10304921	A02p20130.2_BraZ1	476.667	-	1223	1743	1801	0.9677957
A02	10308916	10309417	A02p20140.2_BraZ1	50.1	+	515	501	501	1.0000000
A02	10318303	10318870	A02p20150.2_BraZ1	495	+	10	211	567	0.3721340
A02	10319700	10324550	A02p20160.2_BraZ1	964.6	-	612	3702	4850	0.7632990
A02	10333091	10333456	A02p20170.2_BraZ1	294	-	137	331	365	0.9068493
A02	10338152	10339938	A02p20180.2_BraZ1	827.106	-	632	1786	1786	1.0000000
A02	10345656	10347937	A02p20190.2_BraZ1	1233	+	449	1699	2281	0.7448487
A02	10349368	10352696	A02p20200.2_BraZ1	2007	-	953	2843	3328	0.8542668
A02	10355513	10356686	A02p20210.2_BraZ1	891	+	182	747	1173	0.6368287
A02	10356689	10357097	A02p20220.2_BraZ1	25.5	+	33	177	408	0.4338235
A02	10359344	10361495	A02p20230.2_BraZ1	1242.5	-	916	2136	2151	0.9930265
A02	10366184	10366628	A02p20240.2_BraZ1	44.4	-	51	335	444	0.7545045
A02	10373416	10374367	A02p20250.2_BraZ1	95.1	+	62	694	951	0.7297581
A02	10383853	10384261	A02p20260.2_BraZ1	40.8	-	31	262	408	0.6421568
A02	10395004	10396051	A02p20270.2_BraZ1	104.7	-	14	324	1047	0.3094556
A02	10407196	10407899	A02p20280.2_BraZ1	354	-	454	703	703	1.0000000
A02	10414140	10414419	A02p20290.2_BraZ1	27.9	+	382	279	279	1.0000000
A02	10415468	10416739	A02p20300.2_BraZ1	1049.64	-	277	968	1271	0.7616050
A02	10423611	10423867	A02p20310.2_BraZ1	19.8	+	443	256	256	1.0000000
A02	10424286	10429727	A02p20320.2_BraZ1	330	+	4222	4773	5441	0.8772284
A02	10432289	10435047	A02p20330.2_BraZ1	890.741	+	985	1988	2758	0.7208122
A02	10437298	10442697	A02p20340.2_BraZ1	318.9	+	1172	4999	5399	0.9259122
A02	10443506	10444375	A02p20350.2_BraZ1	56.4	+	584	869	869	1.0000000
A02	10445196	10446097	A02p20360.2_BraZ1	483	+	281	781	901	0.8668147
A02	10462140	10462518	A02p20370.2_BraZ1	37.8	+	19	237	378	0.6269841
A02	10469039	10469719	A02p20380.2_BraZ1	396	-	1999	680	680	1.0000000
A02	10473077	10474496	A02p20390.2_BraZ1	1206	-	65	339	1419	0.2389006
A02	10479779	10480406	A02p20400.2_BraZ1	62.7	-	315	627	627	1.0000000
A02	10481007	10482068	A02p20410.2_BraZ1	411	+	93	319	1061	0.3006597
A02	10486433	10487384	A02p20420.2_BraZ1	95.1	-	106	713	951	0.7497371
A02	10487497	10487838	A02p20430.2_BraZ1	249	-	59	297	341	0.8709677
A02	10494953	10498719	A02p20440.2_BraZ1	2938.67	-	224	2622	3766	0.6962294
A02	10500235	10500826	A02p20450.2_BraZ1	59.1	-	0	0	591	0.0000000
A02	10525905	10529680	A02p20460.2_BraZ1	1769.68	+	246	2089	3775	0.5533775
A02	10539951	10540493	A02p20470.2_BraZ1	36.9	+	155	540	542	0.9963099
A02	10540641	10541217	A02p20480.2_BraZ1	504	-	28	144	576	0.2500000
A02	10542562	10542948	A02p20490.2_BraZ1	22.5	-	82	386	386	1.0000000
A02	10563284	10564089	A02p20500.2_BraZ1	594	+	737	805	805	1.0000000
A02	10564655	10565826	A02p20510.2_BraZ1	474	-	590	1170	1171	0.9991460
A02	10570119	10571530	A02p20520.2_BraZ1	1060.87	+	164	1385	1411	0.9815733
A02	10574811	10579024	A02p20530.2_BraZ1	3864	+	558	2012	4213	0.4775694
A02	10579581	10580380	A02p20540.2_BraZ1	504.706	-	225	710	799	0.8886108
A02	10581152	10584765	A02p20550.2_BraZ1	1708.88	-	469	2209	3613	0.6114033
A02	10601310	10601833	A02p20560.2_BraZ1	438	+	165	450	523	0.8604206
A02	10603011	10603233	A02p20570.2_BraZ1	22.2	-	3	81	222	0.3648649
A02	10605125	10605812	A02p20580.2_BraZ1	363	-	1052	687	687	1.0000000
A02	10606305	10609975	A02p20590.2_BraZ1	2525.21	-	2170	3172	3670	0.8643052
A02	10635166	10636269	A02p20600.2_BraZ1	999	-	858	1050	1103	0.9519492
A02	10639071	10639422	A02p20610.2_BraZ1	35.1	+	533	351	351	1.0000000
A02	10644358	10644634	A02p20620.2_BraZ1	27.6	-	399	276	276	1.0000000
A02	10647647	10650087	A02p20630.2_BraZ1	672.6	+	1276	2385	2440	0.9774590
A02	10653125	10656964	A02p20640.2_BraZ1	506.333	+	2385	3820	3839	0.9950508
A02	10664584	10665637	A02p20650.2_BraZ1	105.3	+	17	323	1053	0.3067426
A02	10674286	10675853	A02p20660.2_BraZ1	977.143	-	72	1253	1567	0.7996171
A02	10690656	10691265	A02p20670.2_BraZ1	456	+	30	387	609	0.6354680
A02	10694087	10694543	A02p20680.2_BraZ1	45.6	+	3	177	456	0.3881579
A02	10695217	10695394	A02p20690.2_BraZ1	17.4	-	21	138	177	0.7796610
A02	10696129	10697640	A02p20700.2_BraZ1	683.346	-	132	1046	1511	0.6922568
A02	10708765	10709128	A02p20710.2_BraZ1	36.3	+	80	354	363	0.9752066
A02	10712727	10722149	A02p20720.2_BraZ1	4618.12	+	8989	9422	9422	1.0000000
A02	10722606	10722966	A02p20730.2_BraZ1	182	-	48	360	360	1.0000000
A02	10723844	10724187	A02p20740.2_BraZ1	246	-	61	209	343	0.6093295
A02	10724440	10726839	A02p20750.2_BraZ1	3506.22	-	832	2131	2399	0.8882868
A02	10728051	10728225	A02p20760.2_BraZ1	16.8	+	195	174	174	1.0000000
A02	10732093	10732348	A02p20770.2_BraZ1	25.5	+	772	255	255	1.0000000
A02	10737341	10739277	A02p20780.2_BraZ1	1353.76	+	1180	1917	1936	0.9901860
A02	10740702	10741339	A02p20790.2_BraZ1	658.8	-	765	637	637	1.0000000
A02	10743540	10743997	A02p20800.2_BraZ1	1190	-	89	442	457	0.9671773
A02	10745156	10747013	A02p20810.2_BraZ1	185.7	+	407	1817	1857	0.9784599
A02	10748289	10749833	A02p20820.2_BraZ1	921	+	541	1544	1544	1.0000000
A02	10750268	10752055	A02p20830.2_BraZ1	931.5	-	882	1597	1787	0.8936766
A02	10770870	10772594	A02p20840.2_BraZ1	1280.28	+	352	1526	1724	0.8851508
A02	10774549	10774834	A02p20850.2_BraZ1	28.5	+	55	235	285	0.8245614
A02	10778144	10779247	A02p20860.2_BraZ1	3401	-	106	879	1103	0.7969175
A02	10783111	10786861	A02p20870.2_BraZ1	2452.31	-	765	2894	3750	0.7717333
A02	10788664	10792681	A02p20880.2_BraZ1	706.967	-	797	2062	4017	0.5133184
A02	10799883	10800849	A02p20890.2_BraZ1	96.6	+	380	857	966	0.8871636
A02	10802740	10803223	A02p20900.2_BraZ1	48.3	+	55	249	483	0.5155280
A02	10814883	10815935	A02p20910.2_BraZ1	906	+	291	961	1052	0.9134981
A02	10817382	10817733	A02p20920.2_BraZ1	35.1	+	20	291	351	0.8290598
A02	10822849	10823515	A02p20930.2_BraZ1	267	+	13	50	666	0.0750751
A02	10824316	10825437	A02p20940.2_BraZ1	561	+	8	105	1121	0.0936664
A02	10826480	10826777	A02p20950.2_BraZ1	29.7	+	263	297	297	1.0000000
A02	10833711	10838703	A02p20960.2_BraZ1	456	-	11701	4785	4992	0.9585336
A02	10835088	10835925	A02p20970.2_BraZ1	441.692	+	3154	837	837	1.0000000
A02	10840026	10840536	A02p20980.2_BraZ1	1976	-	32	460	510	0.9019608
A02	10844075	10845510	A02p20990.2_BraZ1	93	-	747	1392	1435	0.9700348
A02	10845825	10851232	A02p21000.2_BraZ1	2047.91	-	459	3098	5407	0.5729610
A02	10851948	10852594	A02p21010.2_BraZ1	159.75	-	88	617	646	0.9551083
A02	10853710	10855746	A02p21020.2_BraZ1	1287.47	-	344	1618	2036	0.7946955
A02	10866189	10868167	A02p21030.2_BraZ1	1206.73	+	639	1898	1978	0.9595551
A02	10869640	10874119	A02p21040.2_BraZ1	1635.91	+	2092	3397	4479	0.7584282
A02	10876048	10877596	A02p21050.2_BraZ1	154.8	-	176	1485	1548	0.9593023
A02	10878564	10878801	A02p21060.2_BraZ1	12	-	244	237	237	1.0000000
A02	10879325	10881305	A02p21070.2_BraZ1	198	-	509	1721	1980	0.8691919
A02	10883152	10884120	A02p21080.2_BraZ1	685.962	-	309	901	968	0.9307851
A02	10888360	10890202	A02p21090.2_BraZ1	900	-	164	1414	1842	0.7676439
A02	10900344	10901062	A02p21100.2_BraZ1	132.88	+	363	718	718	1.0000000
A02	10902351	10905443	A02p21110.2_BraZ1	1360.8	+	1581	2849	3092	0.9214101
A02	10906227	10906973	A02p21120.2_BraZ1	489	-	298	721	746	0.9664879
A02	10908611	10910343	A02p21130.2_BraZ1	651.786	-	1141	1732	1732	1.0000000
A02	10910885	10912250	A02p21140.2_BraZ1	669	+	348	1340	1365	0.9816850
A02	10912439	10914710	A02p21150.2_BraZ1	825.111	+	465	1609	2271	0.7084985
A02	10915381	10923438	A02p21160.2_BraZ1	492	+	487	1531	8057	0.1900211
A02	10929981	10933305	A02p21170.2_BraZ1	1362.62	+	1587	3252	3324	0.9783394
A02	10936984	10940256	A02p21180.2_BraZ1	1809.37	-	849	2741	3272	0.8377140
A02	10942173	10943038	A02p21190.2_BraZ1	444	-	0	0	865	0.0000000
A02	10943433	10943998	A02p21200.2_BraZ1	444	-	2	63	565	0.1115044
A02	10944045	10946217	A02p21210.2_BraZ1	321	-	506	1097	2172	0.5050644
A02	10946620	10947478	A02p21220.2_BraZ1	420	-	6	152	858	0.1771562
A02	10953019	10953277	A02p21230.2_BraZ1	165	-	163	258	258	1.0000000
A02	10953801	10954842	A02p21240.2_BraZ1	618.098	+	131	810	1041	0.7780980
A02	10982145	10983184	A02p21250.2_BraZ1	24864	+	82	792	1039	0.7622714
A02	10984758	10985755	A02p21260.2_BraZ1	3465	-	1098	997	997	1.0000000
A02	10986949	10990492	A02p21270.2_BraZ1	745.938	+	2764	3534	3543	0.9974598
A02	10990989	10993303	A02p21280.2_BraZ1	420	-	1239	2271	2314	0.9814175
A02	10994964	10995333	A02p21290.2_BraZ1	655.2	-	163	369	369	1.0000000
A02	10999160	11001075	A02p21300.2_BraZ1	982.468	+	941	1884	1915	0.9838120
A02	11015471	11018193	A02p21310.2_BraZ1	938.348	+	515	2427	2722	0.8916238
A02	11017053	11017971	A02p21320.2_BraZ1	91.8	+	192	918	918	1.0000000
A02	11027183	11027540	A02p21330.2_BraZ1	35.7	+	6	196	357	0.5490196
A02	11033185	11033953	A02p21340.2_BraZ1	76.8	+	163	379	768	0.4934896
A02	11040370	11042870	A02p21350.2_BraZ1	1695.52	+	1319	2437	2500	0.9748000
A02	11043828	11044680	A02p21360.2_BraZ1	358.111	+	319	687	852	0.8063380
A02	11045895	11047451	A02p21370.2_BraZ1	780	-	708	1371	1556	0.8811054
A02	11052849	11054200	A02p21380.2_BraZ1	815	-	1721	1351	1351	1.0000000
A02	11055539	11058175	A02p21390.2_BraZ1	1010	-	3124	2553	2636	0.9685129
A02	11064866	11067216	A02p21400.2_BraZ1	97.5	-	685	1912	2350	0.8136171
A02	11077775	11078741	A02p21410.2_BraZ1	96.6	+	10	457	966	0.4730849
A02	11082590	11088912	A02p21420.2_BraZ1	2707.64	+	497	3017	6322	0.4772224
A02	11091119	11092090	A02p21430.2_BraZ1	66.6	+	139	971	971	1.0000000
A02	11095610	11095944	A02p21440.2_BraZ1	240	+	205	334	334	1.0000000
A02	11096935	11097946	A02p21450.2_BraZ1	531	+	1035	1011	1011	1.0000000
A02	11109288	11109816	A02p21460.2_BraZ1	52.8	-	113	436	528	0.8257576
A02	11131390	11131561	A02p21470.2_BraZ1	17.1	+	0	0	171	0.0000000
A02	11133046	11133494	A02p21480.2_BraZ1	405	-	338	448	448	1.0000000
A02	11141526	11143196	A02p21490.2_BraZ1	836.55	+	250	1152	1670	0.6898203
A02	11150789	11159561	A02p21500.2_BraZ1	589.5	-	4406	6990	8772	0.7968536
A02	11154258	11154890	A02p21510.2_BraZ1	351	-	13	187	632	0.2958861
A02	11162898	11174983	A02p21520.2_BraZ1	1954.84	-	1969	6537	12085	0.5409185
A02	11177706	11177932	A02p21530.2_BraZ1	18.9	-	2	226	226	1.0000000
A02	11179630	11180842	A02p21540.2_BraZ1	680.804	-	94	955	1212	0.7879538
A02	11183022	11183578	A02p21550.2_BraZ1	138	+	14	318	556	0.5719424
A02	11189660	11190555	A02p21560.2_BraZ1	349.977	-	91	746	895	0.8335196
A02	11200031	11206842	A02p21570.2_BraZ1	1447.29	+	2151	5612	6811	0.8239613
A02	11208109	11209191	A02p21580.2_BraZ1	828	-	23	265	1082	0.2449168
A02	11209914	11211495	A02p21590.2_BraZ1	1182	-	78	1030	1581	0.6514864
A02	11215305	11216076	A02p21600.2_BraZ1	6210	-	19	637	771	0.8261998
A02	11220985	11222187	A02p21610.2_BraZ1	693	-	34	413	1202	0.3435940
A02	11230935	11231577	A02p21620.2_BraZ1	333.5	-	2	182	642	0.2834891
A02	11231818	11232211	A02p21630.2_BraZ1	757.5	-	0	0	393	0.0000000
A02	11236738	11240736	A02p21640.2_BraZ1	549	+	578	2976	3998	0.7443722
A02	11245082	11248039	A02p21650.2_BraZ1	50.7	-	1070	2059	2957	0.6963139
A02	11246571	11247033	A02p21660.2_BraZ1	46.2	-	2	169	462	0.3658009
A02	11257749	11258528	A02p21670.2_BraZ1	705	-	21	369	779	0.4736842
A02	11271639	11272614	A02p21680.2_BraZ1	345.176	+	31	559	975	0.5733333
A02	11283342	11284325	A02p21690.2_BraZ1	498.588	+	26	587	983	0.5971516
A02	11292906	11293254	A02p21700.2_BraZ1	34.8	+	65	348	348	1.0000000
A02	11294436	11295130	A02p21710.2_BraZ1	552	-	268	694	694	1.0000000
A02	11296482	11302202	A02p21720.2_BraZ1	2470.5	+	2238	5085	5720	0.8889860
A02	11303379	11303976	A02p21730.2_BraZ1	59.7	+	35	380	597	0.6365159
A02	11306079	11308118	A02p21740.2_BraZ1	1461.06	+	461	1925	2039	0.9440902
A02	11309213	11309410	A02p21750.2_BraZ1	138	+	217	197	197	1.0000000
A02	11309293	11309596	A02p21760.2_BraZ1	216	+	441	303	303	1.0000000
A02	11313443	11315718	A02p21770.2_BraZ1	1600.38	+	1779	2254	2275	0.9907692
A02	11322864	11325137	A02p21780.2_BraZ1	929.682	+	441	2049	2273	0.9014518
A02	11330252	11330961	A02p21790.2_BraZ1	1353.75	+	664	709	709	1.0000000
A02	11335133	11336464	A02p21800.2_BraZ1	444	-	919	1331	1331	1.0000000
A02	11336593	11337504	A02p21810.2_BraZ1	492	+	357	911	911	1.0000000
A02	11339758	11341816	A02p21820.2_BraZ1	883.6	-	665	1782	2058	0.8658892
A02	11352155	11352488	A02p21830.2_BraZ1	33.3	+	4	21	333	0.0630631
A02	11354566	11357320	A02p21840.2_BraZ1	2445	-	245	1700	2754	0.6172839
A02	11364578	11382620	A02p21850.2_BraZ1	618.6	-	6007	12708	18042	0.7043565
A02	11383728	11387768	A02p21860.2_BraZ1	2286.6	-	924	3661	4040	0.9061881
A02	11395721	11397348	A02p21870.2_BraZ1	1269	+	547	1493	1627	0.9176399
A02	11397472	11398017	A02p21880.2_BraZ1	276	-	198	342	545	0.6275229
A02	11399105	11399578	A02p21890.2_BraZ1	318	-	30	379	473	0.8012685
A02	11401593	11405500	A02p21900.2_BraZ1	728.844	-	1921	3782	3907	0.9680061
A02	11407894	11408665	A02p21910.2_BraZ1	77.1	-	75	771	771	1.0000000
A02	11418326	11421746	A02p21920.2_BraZ1	1640.09	+	793	3195	3420	0.9342105
A02	11423102	11426117	A02p21930.2_BraZ1	1876.84	+	1381	2983	3015	0.9893864
A02	11426461	11426935	A02p21940.2_BraZ1	45	-	103	393	474	0.8291139
A02	11433175	11434558	A02p21950.2_BraZ1	138.3	-	1411	1383	1383	1.0000000
A02	11451449	11453322	A02p21960.2_BraZ1	910.286	+	1575	1873	1873	1.0000000
A02	11467931	11473174	A02p21970.2_BraZ1	962.609	+	2315	4990	5243	0.9517452
A02	11475645	11478255	A02p21980.2_BraZ1	1120.26	-	540	2266	2610	0.8681992
A02	11482437	11482938	A02p21990.2_BraZ1	50.1	+	37	190	501	0.3792415
A02	11493690	11496030	A02p22000.2_BraZ1	892.277	+	813	2199	2340	0.9397436
A02	11505586	11505752	A02p22010.2_BraZ1	144	-	368	166	166	1.0000000
A02	11517996	11520508	A02p22020.2_BraZ1	998.586	+	426	2399	2512	0.9550159
A02	11521071	11522048	A02p22030.2_BraZ1	571.733	-	337	757	977	0.7748209
A02	11523647	11523836	A02p22040.2_BraZ1	18.9	+	232	189	189	1.0000000
A02	11524764	11528137	A02p22050.2_BraZ1	1690	+	2614	3373	3373	1.0000000
A02	11529609	11532246	A02p22060.2_BraZ1	474	+	1262	2317	2637	0.8786500
A02	11533823	11535729	A02p22070.2_BraZ1	398.75	-	43	594	1906	0.3116474
A02	11536487	11537031	A02p22080.2_BraZ1	474	-	0	0	544	0.0000000
A02	11538317	11538918	A02p22090.2_BraZ1	518.4	+	217	601	601	1.0000000
A02	11543880	11544321	A02p22100.2_BraZ1	44.1	-	223	441	441	1.0000000
A02	11544897	11548913	A02p22110.2_BraZ1	1737.47	+	1770	3906	4016	0.9726096
A02	11549707	11551252	A02p22120.2_BraZ1	865.298	+	1398	1545	1545	1.0000000
A02	11553290	11554520	A02p22130.2_BraZ1	528.545	+	1358	1200	1230	0.9756098
A02	11561206	11561908	A02p22140.2_BraZ1	504	+	445	702	702	1.0000000
A02	11563910	11565580	A02p22150.2_BraZ1	474.7	+	680	1647	1670	0.9862276
A02	11568364	11569466	A02p22160.2_BraZ1	303	+	1502	1102	1102	1.0000000
A02	11568633	11569123	A02p22170.2_BraZ1	252	+	886	490	490	1.0000000
A02	11573717	11574907	A02p22180.2_BraZ1	942	+	182	890	1190	0.7478992
A02	11578515	11580581	A02p22190.2_BraZ1	607.5	+	385	1543	2066	0.7468538
A02	11601970	11602977	A02p22200.2_BraZ1	615	+	1259	1007	1007	1.0000000
A02	11605234	11606979	A02p22210.2_BraZ1	1374.64	-	679	1429	1745	0.8189112
A02	11609548	11610049	A02p22220.2_BraZ1	399	-	0	0	501	0.0000000
A02	11625141	11626049	A02p22230.2_BraZ1	559.261	+	115	315	908	0.3469163
A02	11626312	11629152	A02p22240.2_BraZ1	1412.07	-	1005	2544	2840	0.8957747
A02	11633001	11633481	A02p22250.2_BraZ1	203.657	-	118	423	480	0.8812500
A02	11633555	11633708	A02p22260.2_BraZ1	15.3	-	43	153	153	1.0000000
A02	11635735	11636057	A02p22270.2_BraZ1	21.3	+	179	322	322	1.0000000
A02	11639909	11640150	A02p22280.2_BraZ1	331.2	+	0	0	241	0.0000000
A02	11640193	11641864	A02p22290.2_BraZ1	1225.5	+	264	1444	1671	0.8641532
A02	11640274	11646081	A02p22300.2_BraZ1	370	+	1896	5657	5807	0.9741691
A02	11647215	11648062	A02p22310.2_BraZ1	498	+	62	653	847	0.7709563
A02	11652031	11652916	A02p22320.2_BraZ1	6670	-	99	681	885	0.7694916
A02	11654806	11655784	A02p22330.2_BraZ1	519.444	-	29	132	978	0.1349693
A02	11658511	11658724	A02p22340.2_BraZ1	21.3	+	0	0	213	0.0000000
A02	11660629	11661046	A02p22350.2_BraZ1	41.7	+	365	417	417	1.0000000
A02	11674146	11674846	A02p22360.2_BraZ1	285	-	792	700	700	1.0000000
A02	11677020	11677904	A02p22370.2_BraZ1	495	-	6	123	884	0.1391403
A02	11684575	11686054	A02p22380.2_BraZ1	1960.31	+	1295	1479	1479	1.0000000
A02	11689188	11689589	A02p22390.2_BraZ1	309	+	231	401	401	1.0000000
A02	11690419	11691049	A02p22400.2_BraZ1	360	+	930	630	630	1.0000000
A02	11691950	11692214	A02p22410.2_BraZ1	26.4	+	326	264	264	1.0000000
A02	11694859	11695734	A02p22420.2_BraZ1	2277	-	133	769	875	0.8788571
A02	11697247	11697960	A02p22430.2_BraZ1	2451	-	43	341	713	0.4782609
A02	11699873	11700407	A02p22440.2_BraZ1	53.4	-	184	494	534	0.9250937
A02	11701627	11701900	A02p22450.2_BraZ1	27.3	-	341	273	273	1.0000000
A02	11710964	11719919	A02p22460.2_BraZ1	587.1	+	1411	5635	8955	0.6292574
A02	11724701	11725751	A02p22470.2_BraZ1	481.359	-	493	887	1050	0.8447619
A02	11752394	11757785	A02p22480.2_BraZ1	4448.67	+	1057	4410	5391	0.8180301
A02	11759076	11759790	A02p22490.2_BraZ1	2892.75	-	52	392	714	0.5490196
A02	11760367	11762168	A02p22500.2_BraZ1	210	-	793	1780	1801	0.9883398
A02	11763217	11764277	A02p22510.2_BraZ1	623.833	-	607	1051	1060	0.9915094
A02	11769630	11771507	A02p22520.2_BraZ1	414.75	-	0	0	1877	0.0000000
A02	11774563	11776084	A02p22530.2_BraZ1	152.1	-	405	1279	1521	0.8408942
A02	11776888	11778361	A02p22540.2_BraZ1	1188	-	683	1473	1473	1.0000000
A02	11779573	11779957	A02p22550.2_BraZ1	38.4	-	109	375	384	0.9765625
A02	11780250	11780403	A02p22560.2_BraZ1	15.3	+	179	153	153	1.0000000
A02	11781672	11782452	A02p22570.2_BraZ1	78	+	13	389	780	0.4987179
A02	11784509	11785851	A02p22580.2_BraZ1	1004.52	-	166	630	1342	0.4694486
A02	11786783	11787287	A02p22590.2_BraZ1	50.4	+	424	504	504	1.0000000
A02	11789439	11791804	A02p22600.2_BraZ1	1168.41	+	2035	2365	2365	1.0000000
A02	11800106	11800857	A02p22610.2_BraZ1	463.773	+	360	746	751	0.9933422
A02	11802494	11803844	A02p22620.2_BraZ1	135	-	283	1215	1350	0.9000000
A02	11804251	11805181	A02p22630.2_BraZ1	91.2	+	1326	930	930	1.0000000
A02	11806328	11806697	A02p22640.2_BraZ1	228	+	4	20	369	0.0542005
A02	11807243	11807384	A02p22650.2_BraZ1	14.1	+	150	141	141	1.0000000
A02	11812446	11813709	A02p22660.2_BraZ1	717	-	1518	1263	1263	1.0000000
A02	11825931	11828946	A02p22670.2_BraZ1	1704.06	+	1201	3013	3015	0.9993367
A02	11829448	11830838	A02p22680.2_BraZ1	515.847	-	409	1325	1390	0.9532374
A02	11830762	11832611	A02p22690.2_BraZ1	483.12	-	469	1711	1849	0.9253651
A02	11849819	11853892	A02p22700.2_BraZ1	631.391	+	3344	4073	4073	1.0000000
A02	11862643	11865525	A02p22710.2_BraZ1	1879.35	-	793	2823	2882	0.9795281
A02	11867114	11867558	A02p22720.2_BraZ1	44.4	-	24	287	444	0.6463964
A02	11877462	11878026	A02p22730.2_BraZ1	54.9	-	29	277	564	0.4911348
A02	11886968	11889374	A02p22740.2_BraZ1	321.75	+	657	2077	2406	0.8632585
A02	11889828	11890405	A02p22750.2_BraZ1	49.5	-	543	577	577	1.0000000
A02	11891168	11895633	A02p22760.2_BraZ1	2571.79	+	2760	4408	4465	0.9872341
A02	11896811	11899244	A02p22770.2_BraZ1	240.6	-	3575	2433	2433	1.0000000
A02	11910669	11910939	A02p22780.2_BraZ1	27	-	623	270	270	1.0000000
A02	11923622	11925591	A02p22790.2_BraZ1	1322.73	+	925	1810	1969	0.9192483
A02	11930986	11932867	A02p22800.2_BraZ1	1290.67	+	471	1762	1881	0.9367357
A02	11934634	11938044	A02p22810.2_BraZ1	902	-	1705	3349	3410	0.9821115
A02	11939020	11939435	A02p22820.2_BraZ1	128.625	+	52	281	415	0.6771084
A02	11941562	11944053	A02p22830.2_BraZ1	1233.17	+	1157	2491	2491	1.0000000
A02	11944305	11945206	A02p22840.2_BraZ1	761.25	+	277	841	901	0.9334073
A02	11945607	11946228	A02p22850.2_BraZ1	62.1	-	456	621	621	1.0000000
A02	11948519	11950793	A02p22860.2_BraZ1	216	+	2654	2274	2274	1.0000000
A02	11950848	11951624	A02p22870.2_BraZ1	219	+	1352	776	776	1.0000000
A02	11952415	11954282	A02p22880.2_BraZ1	1470	-	1286	1867	1867	1.0000000
A02	11957958	11958481	A02p22890.2_BraZ1	321	+	316	523	523	1.0000000
A02	11960066	11963812	A02p22900.2_BraZ1	1273.09	+	2344	3719	3746	0.9927923
A02	11964611	11966546	A02p22910.2_BraZ1	18084	-	213	1391	1935	0.7188631
A02	12005573	12005708	A02p22920.2_BraZ1	13.5	-	310	135	135	1.0000000
A02	12007305	12007500	A02p22930.2_BraZ1	19.5	-	575	195	195	1.0000000
A02	12011897	12013626	A02p22940.2_BraZ1	1512.35	+	17	658	1729	0.3805668
A02	12018757	12019406	A02p22950.2_BraZ1	1612	-	261	549	649	0.8459168
A02	12025519	12030769	A02p22960.2_BraZ1	402	+	3738	5235	5250	0.9971429
A02	12032342	12033002	A02p22970.2_BraZ1	66	+	6	20	660	0.0303030
A02	12034152	12036073	A02p22980.2_BraZ1	923.555	+	1493	1921	1921	1.0000000
A02	12037054	12045103	A02p22990.2_BraZ1	1223.48	+	2452	5938	8049	0.7377314
A02	12038738	12040108	A02p23000.2_BraZ1	1783.33	-	2	160	1370	0.1167883
A02	12053686	12053902	A02p23010.2_BraZ1	21.6	-	201	216	216	1.0000000
A02	12067082	12068833	A02p23020.2_BraZ1	956.667	+	194	1147	1751	0.6550543
A02	12070029	12071139	A02p23030.2_BraZ1	316.575	+	493	1097	1110	0.9882883
A02	12071619	12072448	A02p23040.2_BraZ1	381	-	794	829	829	1.0000000
A02	12074831	12079999	A02p23050.2_BraZ1	1836.52	-	2888	4585	5168	0.8871904
A02	12090426	12091062	A02p23060.2_BraZ1	63.6	+	670	636	636	1.0000000
A02	12111900	12113025	A02p23070.2_BraZ1	112.5	+	215	866	1125	0.7697778
A02	12113588	12114174	A02p23080.2_BraZ1	291	-	295	586	586	1.0000000
A02	12115078	12117000	A02p23090.2_BraZ1	1698	-	775	1912	1922	0.9947971
A02	12117330	12119233	A02p23100.2_BraZ1	1052.89	+	1148	1785	1903	0.9379926
A02	12119564	12119893	A02p23110.2_BraZ1	246	+	173	279	329	0.8480243
A02	12120831	12122332	A02p23120.2_BraZ1	1389	+	281	1285	1501	0.8560959
A02	12127389	12127851	A02p23130.2_BraZ1	46.2	+	642	462	462	1.0000000
A02	12128957	12131614	A02p23140.2_BraZ1	1359.31	-	760	2334	2657	0.8784343
A02	12141125	12143041	A02p23150.2_BraZ1	1534.89	+	540	1638	1916	0.8549061
A02	12144340	12146657	A02p23160.2_BraZ1	1377.12	-	257	1440	2317	0.6214933
A02	12158975	12164334	A02p23170.2_BraZ1	2397	+	1287	3885	5359	0.7249487
A02	12171271	12173230	A02p23180.2_BraZ1	1613.7	+	422	1909	1959	0.9744768
A02	12184333	12186292	A02p23190.2_BraZ1	1464.84	-	762	1804	1959	0.9208780
A02	12188591	12192725	A02p23200.2_BraZ1	1251.3	+	991	3328	4134	0.8050314
A02	12193398	12193807	A02p23210.2_BraZ1	324	-	118	409	409	1.0000000
A02	12195854	12198204	A02p23220.2_BraZ1	141	-	44	503	2350	0.2140426
A02	12200086	12200319	A02p23230.2_BraZ1	14.4	+	216	233	233	1.0000000
A02	12201292	12202399	A02p23240.2_BraZ1	897	-	1628	1107	1107	1.0000000
A02	12216796	12218008	A02p23250.2_BraZ1	121.2	-	1308	1212	1212	1.0000000
A02	12224760	12226924	A02p23260.2_BraZ1	9319.5	+	782	2076	2164	0.9593346
A02	12236804	12237905	A02p23270.2_BraZ1	110.1	-	59	829	1101	0.7529519
A02	12244166	12245702	A02p23280.2_BraZ1	540	+	140	1125	1536	0.7324219
A02	12246833	12248197	A02p23290.2_BraZ1	379.421	-	795	1364	1364	1.0000000
A02	12248832	12250473	A02p23300.2_BraZ1	198	+	1078	1615	1641	0.9841560
A02	12253406	12253811	A02p23310.2_BraZ1	40.5	+	185	405	405	1.0000000
A02	12258626	12259692	A02p23320.2_BraZ1	64.5	+	38	602	1066	0.5647280
A02	12265087	12270251	A02p23330.2_BraZ1	2505.23	+	1954	4525	5164	0.8762587
A02	12273428	12274134	A02p23340.2_BraZ1	68.1	+	418	706	706	1.0000000
A02	12277125	12277527	A02p23350.2_BraZ1	288	+	712	402	402	1.0000000
A02	12279080	12280734	A02p23360.2_BraZ1	282	-	1756	1654	1654	1.0000000
A02	12288025	12288658	A02p23370.2_BraZ1	63.3	+	899	633	633	1.0000000
A02	12288852	12289659	A02p23380.2_BraZ1	80.7	+	24	572	807	0.7087980
A02	12291169	12291615	A02p23390.2_BraZ1	246	-	4	21	446	0.0470852
A02	12295652	12295808	A02p23400.2_BraZ1	15.6	+	137	156	156	1.0000000
A02	12300588	12301242	A02p23410.2_BraZ1	65.4	+	49	574	654	0.8776758
A02	12305907	12309141	A02p23420.2_BraZ1	323.4	-	527	2229	3234	0.6892393
A02	12309671	12309884	A02p23430.2_BraZ1	18.3	+	2	137	213	0.6431925
A02	12316392	12317325	A02p23440.2_BraZ1	93.3	+	383	917	933	0.9828510
A02	12318232	12318620	A02p23450.2_BraZ1	240	+	15	320	388	0.8247423
A02	12320499	12322487	A02p23460.2_BraZ1	1045.84	+	588	1716	1988	0.8631791
A02	12325317	12326974	A02p23470.2_BraZ1	22943.2	-	523	1657	1657	1.0000000
A02	12327551	12333485	A02p23480.2_BraZ1	3104.18	+	1003	3351	5934	0.5647118
A02	12336320	12336674	A02p23490.2_BraZ1	35.4	-	5	264	354	0.7457627
A02	12342718	12344001	A02p23500.2_BraZ1	60.3	+	1218	1283	1283	1.0000000
A02	12348156	12349532	A02p23510.2_BraZ1	795.905	-	659	1372	1376	0.9970930
A02	12350010	12350255	A02p23520.2_BraZ1	13.8	-	608	245	245	1.0000000
A02	12355567	12357631	A02p23530.2_BraZ1	1878	+	255	1659	2064	0.8037791
A02	12361670	12362927	A02p23540.2_BraZ1	874.957	-	523	1257	1257	1.0000000
A02	12382675	12383176	A02p23550.2_BraZ1	50.1	+	41	349	501	0.6966068
A02	12391225	12394862	A02p23560.2_BraZ1	2760	+	297	1250	3637	0.3436899
A02	12396268	12398426	A02p23570.2_BraZ1	1451.76	-	206	1096	2158	0.5078776
A02	12413692	12413863	A02p23580.2_BraZ1	17.1	-	224	171	171	1.0000000
A02	12417472	12420756	A02p23590.2_BraZ1	1311.82	+	110	1649	3284	0.5021315
A02	12431124	12431913	A02p23600.2_BraZ1	4935	-	74	770	789	0.9759189
A02	12437141	12437534	A02p23610.2_BraZ1	39.3	+	53	389	393	0.9898219
A02	12438474	12439528	A02p23620.2_BraZ1	147.643	-	430	1054	1054	1.0000000
A02	12447637	12451878	A02p23630.2_BraZ1	3361.38	+	740	3761	4241	0.8868191
A02	12454097	12458007	A02p23640.2_BraZ1	1347.5	+	2148	3852	3910	0.9851663
A02	12458812	12459196	A02p23650.2_BraZ1	38.4	-	6	140	384	0.3645833
A02	12459891	12461831	A02p23660.2_BraZ1	1759.56	-	808	1605	1940	0.8273196
A02	12468169	12468394	A02p23670.2_BraZ1	22.5	-	1	41	225	0.1822222
A02	12468847	12469219	A02p23680.2_BraZ1	300	-	174	372	372	1.0000000
A02	12469894	12470461	A02p23690.2_BraZ1	56.7	+	95	567	567	1.0000000
A02	12471342	12474406	A02p23700.2_BraZ1	1348	-	513	1836	3064	0.5992167
A02	12475564	12476206	A02p23710.2_BraZ1	63.9	+	469	642	642	1.0000000
A02	12487306	12489295	A02p23720.2_BraZ1	1551	-	278	1710	1989	0.8597285
A02	12496764	12498066	A02p23730.2_BraZ1	963	-	168	812	1302	0.6236559
A02	12512085	12513246	A02p23740.2_BraZ1	678.5	-	652	994	1161	0.8561585
A02	12514852	12516957	A02p23750.2_BraZ1	1139.01	-	950	1953	2105	0.9277910
A02	12520002	12520566	A02p23760.2_BraZ1	621	-	415	564	564	1.0000000
A02	12520416	12523605	A02p23770.2_BraZ1	528	-	1035	1840	3189	0.5769834
A02	12524895	12526429	A02p23780.2_BraZ1	840.583	-	645	1404	1534	0.9152542
A02	12535459	12538134	A02p23790.2_BraZ1	2627.7	+	1639	2561	2675	0.9573832
A02	12550845	12553903	A02p23800.2_BraZ1	22015	+	1124	2789	3058	0.9120340
A02	12554361	12554910	A02p23810.2_BraZ1	54.9	-	343	549	549	1.0000000
A02	12556484	12556766	A02p23820.2_BraZ1	207	-	195	282	282	1.0000000
A02	12557820	12558438	A02p23830.2_BraZ1	61.8	+	64	328	618	0.5307443
A02	12564297	12565570	A02p23840.2_BraZ1	853.522	-	142	834	1273	0.6551453
A02	12576665	12578069	A02p23850.2_BraZ1	612	+	600	1296	1404	0.9230769
A02	12578340	12580060	A02p23860.2_BraZ1	855	-	33	552	1720	0.3209302
A02	12580504	12582341	A02p23870.2_BraZ1	2475	-	664	1755	1837	0.9553620
A02	12583001	12585064	A02p23880.2_BraZ1	855.692	+	1417	1997	2063	0.9680077
A02	12589867	12590323	A02p23890.2_BraZ1	336	-	483	456	456	1.0000000
A02	12592272	12593433	A02p23900.2_BraZ1	867	+	425	1161	1161	1.0000000
A02	12593628	12596337	A02p23910.2_BraZ1	1199.66	-	775	2661	2709	0.9822813
A02	12596730	12598169	A02p23920.2_BraZ1	687.75	-	2437	1439	1439	1.0000000
A02	12599194	12599829	A02p23930.2_BraZ1	62.7	+	625	635	635	1.0000000
A02	12603234	12603474	A02p23940.2_BraZ1	24	-	5	138	240	0.5750000
A02	12606845	12610635	A02p23950.2_BraZ1	1730.17	-	1007	3674	3790	0.9693931
A02	12611687	12612410	A02p23960.2_BraZ1	429	+	464	576	723	0.7966805
A02	12612786	12613735	A02p23970.2_BraZ1	723.981	+	242	909	949	0.9578504
A02	12613955	12616846	A02p23980.2_BraZ1	2208	-	1151	2819	2891	0.9750951
A02	12618307	12620393	A02p23990.2_BraZ1	820.954	-	1378	1989	2086	0.9534995
A02	12633415	12639156	A02p24000.2_BraZ1	441	+	2598	5109	5741	0.8899146
A02	12634377	12634881	A02p24010.2_BraZ1	48.9	-	319	504	504	1.0000000
A02	12636604	12637608	A02p24020.2_BraZ1	465	-	31	469	1004	0.4671315
A02	12640998	12642083	A02p24030.2_BraZ1	494.679	+	20	529	1085	0.4875576
A02	12644421	12645039	A02p24040.2_BraZ1	61.8	+	293	601	618	0.9724919
A02	12653445	12654077	A02p24050.2_BraZ1	393	+	470	632	632	1.0000000
A02	12662337	12664387	A02p24060.2_BraZ1	1707	+	613	1627	2050	0.7936586
A02	12673263	12674365	A02p24070.2_BraZ1	288	-	658	1102	1102	1.0000000
A02	12674839	12676798	A02p24080.2_BraZ1	1617	+	217	1450	1959	0.7401736
A02	12677049	12678501	A02p24090.2_BraZ1	508.345	-	436	1452	1452	1.0000000
A02	12679070	12679664	A02p24100.2_BraZ1	59.4	-	47	343	594	0.5774411
A02	12680107	12680731	A02p24110.2_BraZ1	62.4	-	133	369	624	0.5913461
A02	12682602	12683518	A02p24120.2_BraZ1	651	-	217	856	916	0.9344978
A02	12684703	12685455	A02p24130.2_BraZ1	190.667	-	50	668	752	0.8882979
A02	12694104	12694612	A02p24140.2_BraZ1	429	-	51	92	508	0.1811024
A02	12697103	12699096	A02p24150.2_BraZ1	5386.5	+	2445	1993	1993	1.0000000
A02	12707714	12707861	A02p24160.2_BraZ1	14.7	+	229	145	147	0.9863946
A02	12709012	12710391	A02p24170.2_BraZ1	1299	+	247	1009	1379	0.7316896
A02	12712794	12713933	A02p24180.2_BraZ1	609.632	+	522	1139	1139	1.0000000
A02	12717110	12718293	A02p24190.2_BraZ1	450	+	458	1068	1183	0.9027895
A02	12720323	12723046	A02p24200.2_BraZ1	2349	+	790	2324	2723	0.8534704
A02	12725638	12727822	A02p24210.2_BraZ1	936.96	+	986	2071	2184	0.9482601
A02	12732393	12733314	A02p24220.2_BraZ1	92.1	-	244	849	921	0.9218241
A02	12739867	12740499	A02p24230.2_BraZ1	270.667	-	15	289	632	0.4572785
A02	12742146	12742814	A02p24240.2_BraZ1	6520.5	-	76	565	668	0.8458084
A02	12743920	12744620	A02p24250.2_BraZ1	447	-	138	405	700	0.5785714
A02	12745669	12746164	A02p24260.2_BraZ1	49.5	+	343	495	495	1.0000000
A02	12750310	12757769	A02p24270.2_BraZ1	252	+	3723	7374	7459	0.9886044
A02	12760466	12761270	A02p24280.2_BraZ1	546	+	47	494	804	0.6144279
A02	12772109	12774968	A02p24290.2_BraZ1	1577.37	+	1570	2859	2859	1.0000000
A02	12782114	12782638	A02p24300.2_BraZ1	304.5	-	2	21	524	0.0400763
A02	12782650	12783813	A02p24310.2_BraZ1	612.75	-	21	182	1163	0.1564918
A02	12803875	12805629	A02p24320.2_BraZ1	859.95	-	1322	1754	1754	1.0000000
A02	12809028	12809362	A02p24330.2_BraZ1	216	-	134	329	334	0.9850299
A02	12809554	12812531	A02p24340.2_BraZ1	1814.28	-	309	2280	2977	0.7658717
A02	12819205	12819367	A02p24350.2_BraZ1	16.2	-	12	83	162	0.5123457
A02	12823374	12824520	A02p24360.2_BraZ1	114.6	-	145	1046	1146	0.9127400
A02	12828191	12829391	A02p24370.2_BraZ1	117.6	-	117	850	1200	0.7083333
A02	12830585	12832589	A02p24380.2_BraZ1	1722	-	1039	1906	2004	0.9510978
A02	12839475	12840254	A02p24390.2_BraZ1	7900.5	+	609	779	779	1.0000000
A02	12840874	12841171	A02p24400.2_BraZ1	29.7	+	41	180	297	0.6060606
A02	12844057	12845346	A02p24410.2_BraZ1	796.514	+	707	1235	1289	0.9581071
A02	12846561	12846754	A02p24420.2_BraZ1	174	+	195	193	193	1.0000000
A02	12851218	12852373	A02p24430.2_BraZ1	93	-	646	1155	1155	1.0000000
A02	12854864	12855784	A02p24440.2_BraZ1	865.857	+	191	621	920	0.6750000
A02	12855975	12856706	A02p24450.2_BraZ1	810	-	321	712	731	0.9740082
A02	12857536	12859581	A02p24460.2_BraZ1	1866	-	364	1457	2045	0.7124695
A02	12860228	12864781	A02p24470.2_BraZ1	1692.1	-	2685	4489	4553	0.9859433
A02	12874494	12875769	A02p24480.2_BraZ1	127.5	+	261	823	1275	0.6454902
A02	12878726	12879533	A02p24490.2_BraZ1	80.7	+	2	165	807	0.2044610
A02	12880475	12880986	A02p24500.2_BraZ1	270	-	26	371	511	0.7260274
A02	12881226	12881526	A02p24510.2_BraZ1	30	+	15	162	300	0.5400000
A02	12881746	12882300	A02p24520.2_BraZ1	462	+	289	554	554	1.0000000
A02	12886925	12887511	A02p24530.2_BraZ1	153	+	158	375	586	0.6399317
A02	12887659	12887817	A02p24540.2_BraZ1	13.2	+	25	158	158	1.0000000
A02	12898619	12899883	A02p24550.2_BraZ1	952.5	-	609	1258	1264	0.9952531
A02	12911575	12912860	A02p24560.2_BraZ1	1212	+	163	779	1285	0.6062257
A02	12914090	12916717	A02p24570.2_BraZ1	8802	-	377	1793	2627	0.6825276
A02	12918493	12920135	A02p24580.2_BraZ1	984	-	25	357	1642	0.2174178
A02	12922948	12924962	A02p24590.2_BraZ1	4515.75	-	754	1571	2014	0.7800397
A02	12925976	12926588	A02p24600.2_BraZ1	61.2	-	27	439	612	0.7173203
A02	12930922	12931674	A02p24610.2_BraZ1	138	+	2107	752	752	1.0000000
A02	12939284	12945301	A02p24620.2_BraZ1	1043.08	-	2523	4598	6017	0.7641682
A02	12941935	12942256	A02p24630.2_BraZ1	32.1	+	305	321	321	1.0000000
A02	12948098	12949430	A02p24640.2_BraZ1	672.75	-	931	1309	1332	0.9827327
A02	12950776	12951884	A02p24650.2_BraZ1	5176.12	-	423	1108	1108	1.0000000
A02	12953298	12953648	A02p24660.2_BraZ1	34.5	-	308	350	350	1.0000000
A02	12959886	12961816	A02p24670.2_BraZ1	952.105	+	1444	1930	1930	1.0000000
A02	12973603	12974758	A02p24680.2_BraZ1	115.5	-	96	1112	1155	0.9627706
A02	12989049	12990973	A02p24690.2_BraZ1	19987.5	-	6	173	1924	0.0899168
A02	13002009	13003933	A02p24700.2_BraZ1	19987.5	-	17	323	1924	0.1678794
A02	13009138	13011361	A02p24710.2_BraZ1	940.686	+	646	2005	2223	0.9019343
A02	13014680	13018427	A02p24720.2_BraZ1	2735.06	+	869	3138	3747	0.8374700
A02	13018863	13022594	A02p24730.2_BraZ1	1624.35	-	5644	3731	3731	1.0000000
A02	13023124	13024000	A02p24740.2_BraZ1	87.6	+	1	116	876	0.1324201
A02	13028965	13038204	A02p24750.2_BraZ1	10474.6	-	7305	9182	9239	0.9938305
A02	13039302	13041969	A02p24760.2_BraZ1	16380	-	1134	2552	2667	0.9568804
A02	13042306	13042737	A02p24770.2_BraZ1	201	-	548	431	431	1.0000000
A02	13043925	13046516	A02p24780.2_BraZ1	2367	-	985	2464	2591	0.9509842
A02	13048691	13049643	A02p24790.2_BraZ1	2402.4	-	656	952	952	1.0000000
A02	13050425	13051921	A02p24800.2_BraZ1	799.239	+	957	1441	1496	0.9632353
A02	13056950	13058974	A02p24810.2_BraZ1	1851	+	1095	1927	2024	0.9520751
A02	13061524	13062257	A02p24820.2_BraZ1	335.523	-	387	581	733	0.7926330
A02	13065898	13066279	A02p24830.2_BraZ1	243	-	68	351	381	0.9212598
A02	13067602	13068976	A02p24840.2_BraZ1	137.4	+	317	1309	1374	0.9526929
A02	13072451	13073221	A02p24850.2_BraZ1	384	+	354	768	770	0.9974026
A02	13081175	13082117	A02p24860.2_BraZ1	2256	-	159	802	942	0.8513801
A02	13086777	13088156	A02p24870.2_BraZ1	741	+	32	650	1379	0.4713561
A02	13106894	13108455	A02p24880.2_BraZ1	1066.36	-	25	444	1561	0.2844331
A02	13110976	13112862	A02p24890.2_BraZ1	1384.32	+	231	1556	1886	0.8250265
A02	13112991	13113991	A02p24900.2_BraZ1	802.429	-	405	982	1000	0.9820000
A02	13121771	13122141	A02p24910.2_BraZ1	282	-	248	370	370	1.0000000
A02	13139958	13141958	A02p24920.2_BraZ1	3150	-	61	755	2000	0.3775000
A02	13144126	13144682	A02p24930.2_BraZ1	247.5	-	22	250	556	0.4496403
A02	13144909	13145071	A02p24940.2_BraZ1	16.2	-	4	80	162	0.4938272
A02	13146709	13159847	A02p24950.2_BraZ1	1152	+	16885	13138	13138	1.0000000
A02	13160295	13161397	A02p24960.2_BraZ1	537.779	-	827	1102	1102	1.0000000
A02	13162723	13163494	A02p24970.2_BraZ1	699	-	194	635	771	0.8236057
A02	13164007	13165942	A02p24980.2_BraZ1	193.5	-	812	1904	1935	0.9839793
A02	13166899	13169011	A02p24990.2_BraZ1	14960	+	1340	2060	2112	0.9753788
A02	13170600	13171054	A02p25000.2_BraZ1	369	+	66	144	454	0.3171806
A02	13193823	13195298	A02p25010.2_BraZ1	996.818	+	95	1062	1475	0.7200000
A02	13212356	13212875	A02p25020.2_BraZ1	306	+	4	138	519	0.2658960
A02	13213667	13215858	A02p25030.2_BraZ1	1203.16	-	909	1985	2191	0.9059790
A02	13217121	13218543	A02p25040.2_BraZ1	749.714	+	168	1173	1422	0.8248945
A02	13224870	13229177	A02p25050.2_BraZ1	1599.57	+	1801	4131	4307	0.9591363
A02	13229925	13231372	A02p25060.2_BraZ1	585	+	608	866	1447	0.5984796
A02	13238380	13242330	A02p25070.2_BraZ1	1663.79	+	188	1544	3950	0.3908861
A02	13242691	13243970	A02p25080.2_BraZ1	766.8	-	91	1173	1279	0.9171228
A02	13245205	13246207	A02p25090.2_BraZ1	66.3	-	206	1002	1002	1.0000000
A02	13256009	13256781	A02p25100.2_BraZ1	605.318	+	888	772	772	1.0000000
A02	13257452	13260328	A02p25110.2_BraZ1	1052.68	-	2113	2830	2876	0.9840056
A02	13264856	13265492	A02p25120.2_BraZ1	495	+	0	0	636	0.0000000
A02	13271941	13272289	A02p25130.2_BraZ1	267	+	68	240	348	0.6896552
A02	13272489	13273861	A02p25140.2_BraZ1	270.938	-	9	73	1372	0.0532070
A02	13276763	13277963	A02p25150.2_BraZ1	715.141	-	625	1200	1200	1.0000000
A02	13282900	13285615	A02p25160.2_BraZ1	1355.11	-	639	2330	2715	0.8581952
A02	13286652	13288116	A02p25170.2_BraZ1	726	-	1442	1464	1464	1.0000000
A02	13287499	13289806	A02p25180.2_BraZ1	270	-	1648	2101	2307	0.9107065
A02	13290539	13292785	A02p25190.2_BraZ1	9405	+	324	1827	2246	0.8134461
A02	13293735	13294569	A02p25200.2_BraZ1	83.4	+	223	834	834	1.0000000
A02	13296161	13297977	A02p25210.2_BraZ1	568.816	-	423	1538	1816	0.8469163
A02	13300644	13301588	A02p25220.2_BraZ1	486	+	1143	944	944	1.0000000
A02	13302322	13302791	A02p25230.2_BraZ1	400	-	356	469	469	1.0000000
A02	13304002	13306315	A02p25240.2_BraZ1	1174.91	+	14	243	2313	0.1050584
A02	13307876	13308218	A02p25250.2_BraZ1	34.2	-	16	55	342	0.1608187
A02	13308313	13310802	A02p25260.2_BraZ1	496	+	142	1309	2489	0.5259140
A02	13311625	13312864	A02p25270.2_BraZ1	10930.5	+	81	567	1239	0.4576271
A02	13329821	13330731	A02p25280.2_BraZ1	240	-	168	906	910	0.9956044
A02	13338248	13338374	A02p25290.2_BraZ1	12.6	+	111	126	126	1.0000000
A02	13339683	13340612	A02p25300.2_BraZ1	4864.5	-	1004	929	929	1.0000000
A02	13340871	13342762	A02p25310.2_BraZ1	426	+	889	1868	1891	0.9878371
A02	13351038	13354061	A02p25320.2_BraZ1	1520.81	-	1895	2772	3023	0.9169699
A02	13358111	13358234	A02p25330.2_BraZ1	10.8	-	65	123	123	1.0000000
A02	13371916	13372801	A02p25340.2_BraZ1	88.5	+	373	760	885	0.8587571
A02	13377309	13377615	A02p25350.2_BraZ1	30.6	-	94	306	306	1.0000000
A02	13380725	13382165	A02p25360.2_BraZ1	906.621	+	299	693	1440	0.4812500
A02	13382452	13383310	A02p25370.2_BraZ1	631.563	-	95	637	858	0.7424242
A02	13385674	13386232	A02p25380.2_BraZ1	55.8	+	0	0	558	0.0000000
A02	13386627	13386942	A02p25390.2_BraZ1	237	-	106	307	315	0.9746032
A02	13389169	13389955	A02p25400.2_BraZ1	78.6	+	149	604	786	0.7684478
A02	13391663	13391937	A02p25410.2_BraZ1	189	+	219	274	274	1.0000000
A02	13393763	13395397	A02p25420.2_BraZ1	847.344	-	225	1485	1634	0.9088127
A02	13409478	13410615	A02p25430.2_BraZ1	113.7	+	1	128	1137	0.1125770
A02	13412387	13413254	A02p25440.2_BraZ1	396	+	280	629	867	0.7254902
A02	13413711	13417841	A02p25450.2_BraZ1	249	-	5	78	4130	0.0188862
A02	13417810	13418232	A02p25460.2_BraZ1	291	-	0	0	422	0.0000000
A02	13419293	13422910	A02p25470.2_BraZ1	76.2	-	40	1003	3617	0.2773016
A02	13420361	13424885	A02p25480.2_BraZ1	149.4	-	8	576	4524	0.1273210
A02	13425081	13425381	A02p25490.2_BraZ1	30	-	0	0	300	0.0000000
A02	13435409	13435892	A02p25500.2_BraZ1	48.3	+	86	483	483	1.0000000
A02	13442661	13442871	A02p25510.2_BraZ1	21	+	15	150	210	0.7142857
A02	13448898	13449474	A02p25520.2_BraZ1	45.3	+	314	576	576	1.0000000
A02	13451379	13452601	A02p25530.2_BraZ1	952.5	+	618	847	1222	0.6931260
A02	13453181	13454819	A02p25540.2_BraZ1	1411.34	-	118	1464	1638	0.8937729
A02	13460378	13476271	A02p25550.2_BraZ1	1845.72	+	2338	11911	15893	0.7494494
A02	13468919	13469369	A02p25560.2_BraZ1	141	+	1	10	450	0.0222222
A02	13477672	13478494	A02p25570.2_BraZ1	82.2	+	14	368	822	0.4476885
A02	13478659	13478814	A02p25580.2_BraZ1	12.6	+	238	155	155	1.0000000
A02	13487949	13489785	A02p25590.2_BraZ1	1530	+	220	1081	1836	0.5887800
A02	13498431	13499049	A02p25600.2_BraZ1	59.7	+	918	618	618	1.0000000
A02	13500288	13502107	A02p25610.2_BraZ1	753.906	-	2383	1819	1819	1.0000000
A02	13505920	13506532	A02p25620.2_BraZ1	61.2	+	71	309	612	0.5049019
A02	13523725	13524041	A02p25630.2_BraZ1	20.7	-	163	316	316	1.0000000
A02	13525201	13526255	A02p25640.2_BraZ1	759.273	-	174	560	1054	0.5313093
A02	13530100	13531461	A02p25650.2_BraZ1	1029	-	62	718	1361	0.5275533
A02	13561368	13562595	A02p25660.2_BraZ1	3836.25	+	600	1214	1227	0.9894050
A02	13569542	13570070	A02p25670.2_BraZ1	52.8	-	209	511	528	0.9678030
A02	13573674	13574376	A02p25680.2_BraZ1	1047.75	+	77	667	702	0.9501424
A02	13587990	13588317	A02p25690.2_BraZ1	32.7	+	1	29	327	0.0886850
A02	13589740	13590380	A02p25700.2_BraZ1	390	-	467	640	640	1.0000000
A02	13594354	13595620	A02p25710.2_BraZ1	632	-	596	1243	1266	0.9818326
A02	13609157	13609613	A02p25720.2_BraZ1	45.6	-	64	387	456	0.8486842
A02	13620525	13620753	A02p25730.2_BraZ1	22.8	-	302	228	228	1.0000000
A02	13622468	13623145	A02p25740.2_BraZ1	419.112	+	457	677	677	1.0000000
A02	13624406	13626074	A02p25750.2_BraZ1	166.8	-	620	1149	1668	0.6888489
A02	13631954	13637257	A02p25760.2_BraZ1	2866.3	+	2455	5183	5303	0.9773713
A02	13637780	13638971	A02p25770.2_BraZ1	514.655	-	232	1148	1191	0.9638959
A02	13640097	13643274	A02p25780.2_BraZ1	1522.44	-	1240	2803	3177	0.8822789
A02	13644791	13645896	A02p25790.2_BraZ1	870	+	392	1105	1105	1.0000000
A02	13646289	13646981	A02p25800.2_BraZ1	500.187	-	492	692	692	1.0000000
A02	13647359	13648802	A02p25810.2_BraZ1	331.429	+	1352	1443	1443	1.0000000
A02	13661119	13663236	A02p25820.2_BraZ1	1341	+	368	1498	2117	0.7076051
A02	13663898	13664144	A02p25830.2_BraZ1	24.6	+	6	102	246	0.4146341
A02	13668003	13668986	A02p25840.2_BraZ1	603	-	612	971	983	0.9877925
A02	13669786	13672495	A02p25850.2_BraZ1	1563.05	-	681	2560	2709	0.9449981
A02	13676827	13677292	A02p25860.2_BraZ1	318	-	166	451	465	0.9698925
A02	13684176	13687068	A02p25870.2_BraZ1	1574.18	-	633	2465	2892	0.8523513
A02	13688385	13690107	A02p25880.2_BraZ1	96.6	+	250	1654	1722	0.9605110
A02	13691670	13692048	A02p25890.2_BraZ1	37.8	+	40	296	378	0.7830688
A02	13694826	13695161	A02p25900.2_BraZ1	243	+	52	287	335	0.8567164
A02	13698464	13698798	A02p25910.2_BraZ1	140.062	+	100	304	334	0.9101796
A02	13709013	13709365	A02p25920.2_BraZ1	243	+	114	317	352	0.9005682
A02	13710037	13713232	A02p25930.2_BraZ1	1920	-	1381	3184	3195	0.9965571
A02	13718292	13719574	A02p25940.2_BraZ1	7753.36	+	289	1277	1282	0.9960998
A02	13719963	13724647	A02p25950.2_BraZ1	169	-	805	2631	4684	0.5616994
A02	13721322	13724763	A02p25960.2_BraZ1	358.05	-	805	2022	3441	0.5876199
A02	13726831	13727491	A02p25970.2_BraZ1	249	+	26	239	660	0.3621212
A02	13728499	13730236	A02p25980.2_BraZ1	917.481	+	31	463	1737	0.2665515
A02	13731618	13733234	A02p25990.2_BraZ1	1032	+	21	212	1616	0.1311881
A02	13738798	13741793	A02p26000.2_BraZ1	1427.44	+	27	415	2995	0.1385643
A02	13745934	13746636	A02p26010.2_BraZ1	483	+	74	676	702	0.9629630
A02	13749018	13750668	A02p26020.2_BraZ1	165	+	193	1558	1650	0.9442424
A02	13751971	13752468	A02p26030.2_BraZ1	423.75	-	257	497	497	1.0000000
A02	13753519	13757678	A02p26040.2_BraZ1	1348.54	-	1088	3598	4159	0.8651118
A02	13758496	13763802	A02p26050.2_BraZ1	150	-	1167	5059	5306	0.9534490
A02	13765311	13766094	A02p26060.2_BraZ1	78.3	+	68	553	783	0.7062580
A02	13767351	13767672	A02p26070.2_BraZ1	32.1	-	424	321	321	1.0000000
A02	13772321	13772896	A02p26080.2_BraZ1	159	+	36	322	575	0.5600000
A02	13772935	13773465	A02p26090.2_BraZ1	1963.5	+	43	433	530	0.8169811
A02	13781832	13785129	A02p26100.2_BraZ1	2247.37	+	1189	2972	3297	0.9014255
A02	13785883	13790570	A02p26110.2_BraZ1	1332.82	-	1827	4129	4687	0.8809473
A02	13797500	13798033	A02p26120.2_BraZ1	405	+	16	152	533	0.2851782
A02	13799334	13800059	A02p26130.2_BraZ1	10237.5	-	34	445	725	0.6137931
A02	13809871	13810532	A02p26140.2_BraZ1	327	+	219	648	661	0.9803329
A02	13811404	13811810	A02p26150.2_BraZ1	176.9	+	293	238	406	0.5862069
A02	13815377	13815836	A02p26160.2_BraZ1	1186.5	-	172	456	459	0.9934641
A02	13816834	13816948	A02p26170.2_BraZ1	11.4	-	16	105	114	0.9210526
A02	13823381	13823570	A02p26180.2_BraZ1	18.9	+	0	0	189	0.0000000
A02	13827319	13829088	A02p26190.2_BraZ1	1629.45	-	113	1229	1769	0.6947428
A02	13830156	13831451	A02p26200.2_BraZ1	715	+	1	37	1295	0.0285714
A02	13831945	13833586	A02p26210.2_BraZ1	4200.38	-	11	45	1641	0.0274223
A02	13840471	13844318	A02p26220.2_BraZ1	875.584	-	123	1190	3847	0.3093320
A02	13845177	13846944	A02p26230.2_BraZ1	1531.29	-	21	639	1767	0.3616299
A02	13849506	13850108	A02p26240.2_BraZ1	1014.75	+	0	0	602	0.0000000
A02	13850598	13852269	A02p26250.2_BraZ1	3578.4	-	6	345	1671	0.2064632
A02	13855803	13859264	A02p26260.2_BraZ1	366.857	-	0	0	3461	0.0000000
A02	13859004	13859597	A02p26270.2_BraZ1	23.4	-	4	20	593	0.0337268
A02	13861063	13862634	A02p26280.2_BraZ1	8564.38	-	207	1405	1571	0.8943348
A02	13867165	13867764	A02p26290.2_BraZ1	1220	+	0	0	599	0.0000000
A02	13868265	13869903	A02p26300.2_BraZ1	9477	-	2	19	1638	0.0115995
A02	13872860	13873692	A02p26310.2_BraZ1	745.5	-	2	79	832	0.0949519
A02	13876365	13877863	A02p26320.2_BraZ1	906.75	-	227	915	1498	0.6108144
A02	13894193	13897753	A02p26330.2_BraZ1	2040	+	1672	3266	3560	0.9174157
A02	13900094	13903375	A02p26340.2_BraZ1	1055.31	-	102	1433	3281	0.4367571
A02	13918970	13920210	A02p26350.2_BraZ1	303	+	1099	1237	1240	0.9975806
A02	13930702	13931263	A02p26360.2_BraZ1	56.1	+	82	497	561	0.8859180
A02	13934633	13934762	A02p26370.2_BraZ1	12.9	-	31	129	129	1.0000000
A02	13936940	13938828	A02p26380.2_BraZ1	985.929	-	165	1073	1888	0.5683263
A02	13946510	13949164	A02p26390.2_BraZ1	15390	-	162	1345	2654	0.5067822
A02	13950829	13951248	A02p26400.2_BraZ1	261	+	186	401	419	0.9570405
A02	13956141	13958690	A02p26410.2_BraZ1	1662.86	+	511	1930	2549	0.7571597
A02	13969252	13970122	A02p26420.2_BraZ1	87	+	21	342	870	0.3931035
A02	13973807	13975212	A02p26430.2_BraZ1	480	-	413	1400	1405	0.9964413
A02	13981022	13981268	A02p26440.2_BraZ1	24.6	+	136	224	246	0.9105691
A02	13985942	13987990	A02p26450.2_BraZ1	1003.37	+	112	908	2048	0.4433594
A02	13989083	13990733	A02p26460.2_BraZ1	889.536	+	359	1203	1650	0.7290909
A02	13993587	13997205	A02p26470.2_BraZ1	2728.69	+	1198	3447	3618	0.9527363
A02	14004228	14004870	A02p26480.2_BraZ1	64.2	+	95	598	642	0.9314642
A02	14013375	14013873	A02p26490.2_BraZ1	432	-	81	496	498	0.9959840
A02	14015466	14015976	A02p26500.2_BraZ1	51	-	89	462	510	0.9058824
A02	14017819	14019258	A02p26510.2_BraZ1	1128	-	613	1380	1439	0.9589993
A02	14022944	14024575	A02p26520.2_BraZ1	1038.46	+	140	1450	1631	0.8890252
A02	14025708	14027033	A02p26530.2_BraZ1	819.543	+	119	1028	1325	0.7758490
A02	14027607	14028075	A02p26540.2_BraZ1	46.8	+	149	468	468	1.0000000
A02	14029261	14030070	A02p26550.2_BraZ1	723	+	98	564	809	0.6971570
A02	14030520	14040965	A02p26560.2_BraZ1	4272	+	5262	8767	10445	0.8393490
A02	14045938	14046523	A02p26570.2_BraZ1	58.5	+	141	441	585	0.7538462
A02	14048942	14050388	A02p26580.2_BraZ1	103.8	-	218	959	1446	0.6632088
A02	14051113	14055931	A02p26590.2_BraZ1	3331.82	-	567	3231	4818	0.6706102
A02	14065213	14069742	A02p26600.2_BraZ1	726	+	1200	4292	4529	0.9476706
A02	14070037	14070782	A02p26610.2_BraZ1	291.226	-	224	708	745	0.9503356
A02	14081223	14083530	A02p26620.2_BraZ1	1677	+	438	1943	2307	0.8422194
A02	14086914	14087151	A02p26630.2_BraZ1	23.7	-	9	177	237	0.7468355
A02	14096586	14098259	A02p26640.2_BraZ1	1244.57	+	264	1004	1673	0.6001195
A02	14099068	14099197	A02p26650.2_BraZ1	12.9	-	14	129	129	1.0000000
A02	14111944	14112758	A02p26660.2_BraZ1	204	-	508	814	814	1.0000000
A02	14117387	14119621	A02p26670.2_BraZ1	2280	-	150	528	2234	0.2363474
A02	14124464	14125031	A02p26680.2_BraZ1	35.1	+	556	567	567	1.0000000
A02	14137166	14138477	A02p26690.2_BraZ1	975.526	-	798	1311	1311	1.0000000
A02	14142592	14145662	A02p26700.2_BraZ1	1334.32	+	298	2349	3070	0.7651466
A02	14146049	14147516	A02p26710.2_BraZ1	146.7	-	873	1467	1467	1.0000000
A02	14149104	14152506	A02p26720.2_BraZ1	1167.83	+	1060	1895	3402	0.5570253
A02	14153164	14155170	A02p26730.2_BraZ1	1659	-	375	1229	2006	0.6126620
A02	14161825	14163777	A02p26740.2_BraZ1	1662	+	378	1225	1952	0.6275615
A02	14164159	14185660	A02p26750.2_BraZ1	1410.71	-	10263	19151	21501	0.8907028
A02	14182251	14183224	A02p26760.2_BraZ1	1528	+	1541	973	973	1.0000000
A02	14186333	14190571	A02p26770.2_BraZ1	1749.53	+	1276	3712	4238	0.8758848
A02	14192981	14194196	A02p26780.2_BraZ1	971.143	-	277	1094	1215	0.9004115
A02	14197734	14198034	A02p26790.2_BraZ1	30	-	200	300	300	1.0000000
A02	14200321	14201788	A02p26800.2_BraZ1	146.7	-	151	919	1467	0.6264485
A02	14202926	14203644	A02p26810.2_BraZ1	61.5	+	110	706	718	0.9832869
A02	14204328	14210070	A02p26820.2_BraZ1	549.25	-	158	1415	5742	0.2464298
A02	14210684	14212675	A02p26830.2_BraZ1	1078.29	+	883	1520	1991	0.7634355
A02	14214372	14216246	A02p26840.2_BraZ1	8320.33	+	743	1654	1874	0.8826041
A02	14217800	14218744	A02p26850.2_BraZ1	725	+	442	939	944	0.9947034
A02	14219385	14221390	A02p26860.2_BraZ1	901.163	-	400	1695	2005	0.8453865
A02	14224195	14225452	A02p26870.2_BraZ1	652.929	-	41	247	1257	0.1964996
A02	14225679	14226164	A02p26880.2_BraZ1	264	-	0	0	485	0.0000000
A02	14252846	14254772	A02p26890.2_BraZ1	1497.79	+	14	327	1926	0.1697819
A02	14256764	14258581	A02p26900.2_BraZ1	1813.5	-	52	1359	1817	0.7479361
A02	14258590	14258839	A02p26910.2_BraZ1	24.9	-	55	249	249	1.0000000
A02	14264577	14273641	A02p26920.2_BraZ1	3379.43	+	7189	5158	9064	0.5690644
A02	14279144	14282430	A02p26930.2_BraZ1	1109.2	-	88	637	3286	0.1938527
A02	14291528	14292420	A02p26940.2_BraZ1	396.889	-	76	477	892	0.5347534
A02	14299993	14304883	A02p26950.2_BraZ1	356.449	+	86	1487	4890	0.3040900
A02	14318343	14319146	A02p26960.2_BraZ1	420	+	524	790	803	0.9838107
A02	14321645	14322048	A02p26970.2_BraZ1	237	+	73	403	403	1.0000000
A02	14322542	14322677	A02p26980.2_BraZ1	13.5	+	24	135	135	1.0000000
A02	14324152	14324525	A02p26990.2_BraZ1	105	+	197	372	373	0.9973190
A02	14324709	14325043	A02p27000.2_BraZ1	135	+	86	334	334	1.0000000
A02	14326562	14328111	A02p27010.2_BraZ1	792.5	-	1715	1285	1549	0.8295675
A02	14360950	14361280	A02p27020.2_BraZ1	33	-	299	330	330	1.0000000
A02	14380119	14382886	A02p27030.2_BraZ1	1533	-	151	1260	2767	0.4553668
A02	14385419	14386354	A02p27040.2_BraZ1	366	+	218	890	935	0.9518716
A02	14387330	14387841	A02p27050.2_BraZ1	393	+	375	511	511	1.0000000
A02	14388625	14397081	A02p27060.2_BraZ1	1746.64	+	3998	8225	8456	0.9726821
A02	14400691	14400955	A02p27070.2_BraZ1	26.4	-	24	262	264	0.9924242
A02	14401139	14401806	A02p27080.2_BraZ1	408	+	1	17	667	0.0254873
A02	14402352	14404373	A02p27090.2_BraZ1	888	-	4	20	2021	0.0098961
A02	14405237	14405387	A02p27100.2_BraZ1	15	-	70	150	150	1.0000000
A02	14407250	14407735	A02p27110.2_BraZ1	37.7143	+	0	0	485	0.0000000
A02	14407891	14409138	A02p27120.2_BraZ1	641.25	+	137	234	1247	0.1876504
A02	14410089	14413561	A02p27130.2_BraZ1	1485.8	-	298	1760	3472	0.5069125
A02	14413594	14421092	A02p27140.2_BraZ1	874.5	-	1144	5064	7498	0.6753801
A02	14414894	14415236	A02p27150.2_BraZ1	34.2	+	114	342	342	1.0000000
A02	14423113	14425236	A02p27160.2_BraZ1	1247.85	+	409	1981	2123	0.9331135
A02	14429950	14431522	A02p27170.2_BraZ1	1272.96	-	138	1130	1572	0.7188295
A02	14435525	14439137	A02p27180.2_BraZ1	2290.64	-	389	1133	3612	0.3136766
A02	14440289	14440590	A02p27190.2_BraZ1	16.5	-	257	301	301	1.0000000
A02	14440841	14443059	A02p27200.2_BraZ1	538.2	+	7409	2218	2218	1.0000000
A02	14448430	14451523	A02p27210.2_BraZ1	3896	+	620	2812	3093	0.9091497
A02	14457222	14459697	A02p27220.2_BraZ1	1407.18	-	147	1147	2475	0.4634343
A02	14462041	14468171	A02p27230.2_BraZ1	3900	+	3125	5895	6130	0.9616640
A02	14469056	14470430	A02p27240.2_BraZ1	1838.57	-	2	13	1374	0.0094614
A02	14471945	14472248	A02p27250.2_BraZ1	30.3	-	18	270	303	0.8910891
A02	14473805	14474253	A02p27260.2_BraZ1	604.5	-	18	287	448	0.6406250
A02	14477444	14477756	A02p27270.2_BraZ1	249	-	2	64	312	0.2051282
A02	14477999	14479373	A02p27280.2_BraZ1	2145	-	4	46	1374	0.0334789
A02	14483295	14483532	A02p27290.2_BraZ1	23.7	+	0	0	237	0.0000000
A02	14484089	14484447	A02p27300.2_BraZ1	32.7	+	0	0	358	0.0000000
A02	14484592	14485255	A02p27310.2_BraZ1	555	-	32	492	663	0.7420815
A02	14489835	14490162	A02p27320.2_BraZ1	32.7	-	73	209	327	0.6391437
A02	14490627	14490930	A02p27330.2_BraZ1	555	+	169	191	303	0.6303630
A02	14491672	14493277	A02p27340.2_BraZ1	777	+	469	1068	1605	0.6654205
A02	14501078	14504259	A02p27350.2_BraZ1	1926.81	+	195	1283	3181	0.4033323
A02	14512592	14513740	A02p27360.2_BraZ1	8370	-	395	1116	1148	0.9721254
A02	14520311	14524008	A02p27370.2_BraZ1	2478.08	-	1027	2636	3697	0.7130105
A02	14534119	14535027	A02p27380.2_BraZ1	564.353	+	224	857	908	0.9438326
A02	14535382	14536165	A02p27390.2_BraZ1	78.3	-	30	411	783	0.5249042
A02	14536604	14536999	A02p27400.2_BraZ1	28.2	+	87	395	395	1.0000000
A02	14542513	14543804	A02p27410.2_BraZ1	1041	-	265	1131	1291	0.8760651
A02	14544176	14545939	A02p27420.2_BraZ1	455.7	+	151	829	1763	0.4702212
A02	14550170	14556573	A02p27430.2_BraZ1	3713.14	+	1515	5011	6403	0.7826019
A02	14562190	14562427	A02p27440.2_BraZ1	23.7	+	257	237	237	1.0000000
A02	14565465	14566059	A02p27450.2_BraZ1	310	-	1395	594	594	1.0000000
A02	14570144	14572003	A02p27460.2_BraZ1	342	-	4034	1859	1859	1.0000000
A02	14580471	14583564	A02p27470.2_BraZ1	1695.16	+	116	1284	3093	0.4151309
A02	14588043	14588271	A02p27480.2_BraZ1	16.2	-	7	208	228	0.9122807
A02	14588538	14588812	A02p27490.2_BraZ1	234	-	0	0	274	0.0000000
A02	14595391	14595961	A02p27500.2_BraZ1	492	+	70	495	570	0.8684211
A02	14600871	14601469	A02p27510.2_BraZ1	273	+	562	598	598	1.0000000
A02	14602244	14602406	A02p27520.2_BraZ1	16.2	+	238	162	162	1.0000000
A02	14603794	14605647	A02p27530.2_BraZ1	950.833	+	734	1722	1853	0.9293038
A02	14609744	14609959	A02p27540.2_BraZ1	18	+	313	215	215	1.0000000
A02	14631313	14632249	A02p27550.2_BraZ1	93.6	+	62	685	936	0.7318376
A02	14648103	14650408	A02p27560.2_BraZ1	1045.8	+	61	1256	2305	0.5449024
A02	14655300	14655763	A02p27570.2_BraZ1	257.538	+	764	463	463	1.0000000
A02	14680396	14681332	A02p27580.2_BraZ1	93.6	+	118	898	936	0.9594017
A02	14690537	14691485	A02p27590.2_BraZ1	94.8	+	30	497	948	0.5242616
A02	14692526	14694119	A02p27600.2_BraZ1	1482.92	+	714	1593	1593	1.0000000
A02	14694231	14695805	A02p27610.2_BraZ1	986.026	-	930	1574	1574	1.0000000
A02	14697439	14699022	A02p27620.2_BraZ1	823.841	+	235	1413	1583	0.8926089
A02	14701551	14703997	A02p27630.2_BraZ1	1555.53	+	359	1691	2446	0.6913328
A02	14713304	14714060	A02p27640.2_BraZ1	65.7	+	59	439	756	0.5806878
A02	14716203	14716514	A02p27650.2_BraZ1	225	+	34	311	311	1.0000000
A02	14716990	14717185	A02p27660.2_BraZ1	19.5	+	242	195	195	1.0000000
A02	14718408	14723645	A02p27670.2_BraZ1	1672.35	-	937	4571	5237	0.8728279
A02	14733447	14735812	A02p27680.2_BraZ1	1425	-	690	2179	2365	0.9213530
A02	14738780	14740208	A02p27690.2_BraZ1	663.081	+	387	1297	1428	0.9082633
A02	14741041	14741893	A02p27700.2_BraZ1	85.2	-	1506	852	852	1.0000000
A02	14749233	14749578	A02p27710.2_BraZ1	34.5	-	224	345	345	1.0000000
A02	14754952	14756662	A02p27720.2_BraZ1	3324	-	386	1558	1710	0.9111111
A02	14755659	14756028	A02p27730.2_BraZ1	321	-	162	369	369	1.0000000
A02	14761451	14762396	A02p27740.2_BraZ1	94.5	-	78	916	945	0.9693122
A02	14774519	14775523	A02p27750.2_BraZ1	397.364	-	975	1004	1004	1.0000000
A02	14783475	14784005	A02p27760.2_BraZ1	192	+	419	530	530	1.0000000
A02	14784988	14785208	A02p27770.2_BraZ1	19.2	+	132	220	220	1.0000000
A02	14788515	14788830	A02p27780.2_BraZ1	31.5	+	4	89	315	0.2825397
A02	14790552	14792655	A02p27790.2_BraZ1	915.291	+	1519	2103	2103	1.0000000
A02	14812393	14813083	A02p27800.2_BraZ1	135	-	176	464	690	0.6724638
A02	14815560	14817300	A02p27810.2_BraZ1	916.403	-	649	1703	1740	0.9787356
A02	14824542	14825311	A02p27820.2_BraZ1	273	-	313	703	769	0.9141743
A02	14833277	14836295	A02p27830.2_BraZ1	1206.2	+	512	1883	3018	0.6239231
A02	14842253	14846747	A02p27840.2_BraZ1	590.143	-	910	2912	4494	0.6479751
A02	14848218	14857484	A02p27850.2_BraZ1	2225.98	-	4754	9078	9266	0.9797108
A02	14859395	14859849	A02p27860.2_BraZ1	43.5	+	125	454	454	1.0000000
A02	14860933	14864287	A02p27870.2_BraZ1	231	-	606	926	3354	0.2760883
A02	14868330	14870668	A02p27880.2_BraZ1	894	-	1329	2338	2338	1.0000000
A02	14871326	14872446	A02p27890.2_BraZ1	348.6	+	4	179	1120	0.1598214
A02	14877917	14880524	A02p27900.2_BraZ1	920.817	+	401	1976	2607	0.7579594
A02	14882960	14884235	A02p27910.2_BraZ1	907.286	+	243	1209	1275	0.9482353
A02	14884506	14885567	A02p27920.2_BraZ1	3090	-	1200	1061	1061	1.0000000
A02	14887056	14887389	A02p27930.2_BraZ1	234	+	595	333	333	1.0000000
A02	14887790	14889217	A02p27940.2_BraZ1	729	+	1107	949	1427	0.6650316
A02	14893824	14894223	A02p27950.2_BraZ1	39.9	-	122	378	399	0.9473684
A02	14899615	14899909	A02p27960.2_BraZ1	29.4	+	277	294	294	1.0000000
A02	14906532	14908537	A02p27970.2_BraZ1	958.333	+	1462	2005	2005	1.0000000
A02	14909380	14910778	A02p27980.2_BraZ1	934.25	+	1110	1398	1398	1.0000000
A02	14912046	14913824	A02p27990.2_BraZ1	879	+	764	1580	1778	0.8886389
A02	14914265	14914508	A02p28000.2_BraZ1	24.3	-	620	243	243	1.0000000
A02	14915227	14915714	A02p28010.2_BraZ1	822	-	521	487	487	1.0000000
A02	14916733	14918768	A02p28020.2_BraZ1	1338	-	597	2019	2035	0.9921376
A02	14926324	14926897	A02p28030.2_BraZ1	57.3	-	4	203	573	0.3542757
A02	14930172	14931562	A02p28040.2_BraZ1	522.976	+	683	1359	1390	0.9776978
A02	14932065	14933722	A02p28050.2_BraZ1	1231.8	-	118	1132	1657	0.6831623
A02	14942501	14946483	A02p28060.2_BraZ1	1804.18	+	1004	3661	3982	0.9193872
A02	14948062	14952149	A02p28070.2_BraZ1	2371.41	+	884	3758	4087	0.9195008
A02	14953053	14957081	A02p28080.2_BraZ1	1833.22	-	821	2381	4028	0.5911122
A02	14958733	14959069	A02p28090.2_BraZ1	33.6	-	243	336	336	1.0000000
A02	14959875	14966549	A02p28100.2_BraZ1	4543.79	-	886	3533	6674	0.5293677
A02	14970309	14970471	A02p28110.2_BraZ1	16.2	+	21	162	162	1.0000000
A02	14977272	14979793	A02p28120.2_BraZ1	1147.48	-	958	2358	2521	0.9353431
A02	14981719	14982508	A02p28130.2_BraZ1	403.1	+	163	727	789	0.9214195
A02	14982766	14985245	A02p28140.2_BraZ1	1167.16	-	1013	2157	2479	0.8701089
A02	14987767	14988739	A02p28150.2_BraZ1	97.2	+	134	705	972	0.7253087
A02	14993206	14993590	A02p28160.2_BraZ1	294	-	5	277	384	0.7213542
A02	14994624	14997280	A02p28170.2_BraZ1	622.286	+	1561	2656	2656	1.0000000
A02	14999177	14999686	A02p28180.2_BraZ1	342	+	145	509	509	1.0000000
A02	15000643	15003168	A02p28190.2_BraZ1	393.429	+	1113	2525	2525	1.0000000
A02	15010382	15010972	A02p28200.2_BraZ1	243	-	0	0	590	0.0000000
A02	15011010	15011454	A02p28210.2_BraZ1	345	-	0	0	444	0.0000000
A02	15014181	15015186	A02p28220.2_BraZ1	328.8	-	716	1005	1005	1.0000000
A02	15015677	15015993	A02p28230.2_BraZ1	210	-	474	316	316	1.0000000
A02	15018278	15018716	A02p28240.2_BraZ1	43.8	-	115	334	438	0.7625571
A02	15023640	15024208	A02p28250.2_BraZ1	372	+	100	472	568	0.8309859
A02	15028896	15029334	A02p28260.2_BraZ1	43.8	-	49	292	438	0.6666667
A02	15029901	15036815	A02p28270.2_BraZ1	222	+	4184	6914	6914	1.0000000
A02	15035511	15041214	A02p28280.2_BraZ1	844.444	-	3555	5703	5703	1.0000000
A02	15044173	15044626	A02p28290.2_BraZ1	45.3	-	105	453	453	1.0000000
A02	15052041	15057396	A02p28300.2_BraZ1	450	+	1562	2005	5355	0.3744164
A02	15055852	15056326	A02p28310.2_BraZ1	303	-	65	399	474	0.8417721
A02	15063637	15064087	A02p28320.2_BraZ1	45	-	2	19	450	0.0422222
A02	15065047	15066284	A02p28330.2_BraZ1	201.536	+	602	1222	1237	0.9878739
A02	15070525	15075798	A02p28340.2_BraZ1	3827.77	+	537	4486	5273	0.8507491
A02	15076303	15078249	A02p28350.2_BraZ1	712.08	-	667	1857	1946	0.9542652
A02	15079435	15080571	A02p28360.2_BraZ1	370.667	+	741	1136	1136	1.0000000
A02	15080634	15081031	A02p28370.2_BraZ1	35.6471	-	113	397	397	1.0000000
A02	15082182	15090773	A02p28380.2_BraZ1	966	-	6193	8591	8591	1.0000000
A02	15092990	15095301	A02p28390.2_BraZ1	1702.8	-	401	1820	2311	0.7875379
A02	15098184	15098933	A02p28400.2_BraZ1	397.5	+	197	702	749	0.9372497
A02	15102059	15104206	A02p28410.2_BraZ1	1183.73	+	602	1865	2147	0.8686540
A02	15106555	15108540	A02p28420.2_BraZ1	276.375	-	1208	1863	1985	0.9385390
A02	15109612	15109900	A02p28430.2_BraZ1	28.8	+	110	287	288	0.9965278
A02	15112262	15114068	A02p28440.2_BraZ1	1287	+	439	1434	1806	0.7940199
A02	15115173	15116835	A02p28450.2_BraZ1	304.333	-	513	1406	1662	0.8459687
A02	15118851	15120411	A02p28460.2_BraZ1	156	-	30	890	1560	0.5705128
A02	15133093	15136310	A02p28470.2_BraZ1	2274.91	+	180	1772	3217	0.5508237
A02	15136550	15138086	A02p28480.2_BraZ1	153.6	-	177	690	1536	0.4492188
A02	15146570	15148126	A02p28490.2_BraZ1	1012.61	-	33	475	1556	0.3052699
A02	15152269	15154462	A02p28500.2_BraZ1	836.182	-	229	1775	2193	0.8093935
A02	15153528	15157920	A02p28510.2_BraZ1	6056.31	-	321	3414	4392	0.7773224
A02	15161419	15161728	A02p28520.2_BraZ1	30.9	-	0	0	309	0.0000000
A02	15162571	15163773	A02p28530.2_BraZ1	1125	-	61	687	1202	0.5715474
A02	15167076	15169581	A02p28540.2_BraZ1	759.373	+	1239	2410	2505	0.9620758
A02	15173844	15174666	A02p28550.2_BraZ1	372	-	0	0	822	0.0000000
A02	15176686	15176827	A02p28560.2_BraZ1	14.1	-	133	141	141	1.0000000
A02	15178702	15181274	A02p28570.2_BraZ1	1114.43	-	890	2555	2572	0.9933904
A02	15182152	15184634	A02p28580.2_BraZ1	2370	-	607	1793	2482	0.7224013
A02	15188251	15188842	A02p28590.2_BraZ1	1209	+	33	359	591	0.6074450
A02	15189161	15195501	A02p28600.2_BraZ1	133.2	+	1242	5743	6340	0.9058360
A02	15194568	15203496	A02p28610.2_BraZ1	140.4	+	6219	8481	8928	0.9499328
A02	15197963	15199328	A02p28620.2_BraZ1	9720	-	1166	1365	1365	1.0000000
A02	15199607	15200018	A02p28630.2_BraZ1	318	+	521	411	411	1.0000000
A02	15201655	15202479	A02p28640.2_BraZ1	627	+	125	783	824	0.9502427
A02	15212772	15213091	A02p28650.2_BraZ1	306	-	13	168	319	0.5266458
A02	15213773	15216043	A02p28660.2_BraZ1	864.574	-	741	2095	2270	0.9229075
A02	15229596	15230911	A02p28670.2_BraZ1	514	-	883	1315	1315	1.0000000
A02	15234380	15236193	A02p28680.2_BraZ1	1050	-	1819	1813	1813	1.0000000
A02	15238620	15238834	A02p28690.2_BraZ1	19.8	+	68	168	214	0.7850468
A02	15240837	15242018	A02p28700.2_BraZ1	645.067	+	780	1181	1181	1.0000000
A02	15242375	15244792	A02p28710.2_BraZ1	2088.33	-	398	1712	2417	0.7083161
A02	15245095	15246336	A02p28720.2_BraZ1	469.091	-	438	1241	1241	1.0000000
A02	15247639	15255716	A02p28730.2_BraZ1	3502.33	-	2137	6916	8077	0.8562585
A02	15259526	15261179	A02p28740.2_BraZ1	5762.5	-	516	1583	1653	0.9576527
A02	15261138	15261898	A02p28750.2_BraZ1	702	-	435	760	760	1.0000000
A02	15264292	15267555	A02p28760.2_BraZ1	2206.62	+	588	2666	3263	0.8170395
A02	15268916	15269539	A02p28770.2_BraZ1	456	+	17	207	623	0.3322632
A02	15276846	15278334	A02p28780.2_BraZ1	1332	+	430	1470	1488	0.9879032
A02	15281459	15283245	A02p28790.2_BraZ1	1635	+	475	1521	1786	0.8516237
A02	15284190	15286275	A02p28800.2_BraZ1	208.5	-	65	986	2085	0.4729017
A02	15301107	15301868	A02p28810.2_BraZ1	495	+	389	650	761	0.8541393
A02	15302537	15306031	A02p28820.2_BraZ1	824.5	-	672	2362	3494	0.6760160
A02	15306590	15306764	A02p28830.2_BraZ1	17.4	-	219	174	174	1.0000000
A02	15330161	15331719	A02p28840.2_BraZ1	96	-	1170	1359	1558	0.8722721
A02	15330929	15331831	A02p28850.2_BraZ1	293.25	-	985	902	902	1.0000000
A02	15337064	15339922	A02p28860.2_BraZ1	1359.15	+	385	2079	2858	0.7274318
A02	15340299	15342081	A02p28870.2_BraZ1	1055.31	-	278	1605	1782	0.9006734
A02	15343642	15344467	A02p28880.2_BraZ1	82.5	-	81	760	825	0.9212121
A02	15344597	15347814	A02p28890.2_BraZ1	357	+	1330	2951	3217	0.9173143
A02	15350265	15351263	A02p28900.2_BraZ1	498.929	+	209	903	998	0.9048096
A02	15356514	15357611	A02p28910.2_BraZ1	7350	+	103	796	1097	0.7256153
A02	15364113	15365660	A02p28920.2_BraZ1	878.817	+	81	665	1547	0.4298643
A02	15369007	15370461	A02p28930.2_BraZ1	744.48	-	100	1109	1454	0.7627235
A02	15375591	15376275	A02p28940.2_BraZ1	68.4	+	8	165	684	0.2412281
A02	15381714	15391415	A02p28950.2_BraZ1	1232.75	-	2129	8415	9701	0.8674363
A02	15391621	15394096	A02p28960.2_BraZ1	1030.99	+	582	2433	2475	0.9830303
A02	15394535	15395327	A02p28970.2_BraZ1	585	+	573	731	792	0.9229798
A02	15403392	15404289	A02p28980.2_BraZ1	747	+	405	897	897	1.0000000
A02	15404925	15405950	A02p28990.2_BraZ1	323.172	-	402	970	1025	0.9463415
A02	15406480	15408331	A02p29000.2_BraZ1	945.236	-	388	1821	1851	0.9837925
A02	15409386	15410990	A02p29010.2_BraZ1	1067.43	-	176	1497	1604	0.9332918
A02	15412608	15420055	A02p29020.2_BraZ1	580.65	+	3311	7232	7447	0.9711293
A02	15420941	15423079	A02p29030.2_BraZ1	1304.91	+	467	1982	2138	0.9270346
A02	15431072	15436306	A02p29040.2_BraZ1	678.6	+	6350	5234	5234	1.0000000
A02	15449952	15450925	A02p29050.2_BraZ1	3735	+	554	973	973	1.0000000
A02	15452787	15456088	A02p29060.2_BraZ1	1341	+	1856	3282	3301	0.9942442
A02	15454989	15455487	A02p29070.2_BraZ1	38.1	+	490	498	498	1.0000000
A02	15459787	15469729	A02p29080.2_BraZ1	675	+	4312	6080	9942	0.6115470
A02	15462362	15462734	A02p29090.2_BraZ1	37.2	+	32	362	372	0.9731183
A02	15479579	15480509	A02p29100.2_BraZ1	792.632	+	48	340	930	0.3655914
A02	15483063	15483858	A02p29110.2_BraZ1	79.5	-	140	590	795	0.7421384
A02	15496820	15497889	A02p29120.2_BraZ1	240	-	986	1069	1069	1.0000000
A02	15499283	15504077	A02p29130.2_BraZ1	2173.27	-	747	2911	4794	0.6072174
A02	15504404	15506499	A02p29140.2_BraZ1	1133.79	-	624	2049	2095	0.9780430
A02	15507665	15509817	A02p29150.2_BraZ1	1097.25	-	534	1933	2152	0.8982342
A02	15514816	15515108	A02p29160.2_BraZ1	1095	-	275	292	292	1.0000000
A02	15519833	15522054	A02p29170.2_BraZ1	1191.27	-	144	1122	2221	0.5051779
A02	15523453	15524346	A02p29180.2_BraZ1	546	-	645	893	893	1.0000000
A02	15534983	15535127	A02p29190.2_BraZ1	14.1	-	281	144	144	1.0000000
A02	15536698	15539308	A02p29200.2_BraZ1	1501.92	+	468	2015	2610	0.7720307
A02	15539736	15541185	A02p29210.2_BraZ1	144.9	-	131	1106	1449	0.7632850
A02	15545436	15547670	A02p29220.2_BraZ1	1352.45	+	158	1301	2234	0.5823635
A02	15549464	15549599	A02p29230.2_BraZ1	13.5	+	121	135	135	1.0000000
A02	15551033	15553115	A02p29240.2_BraZ1	1614.88	+	116	1252	2082	0.6013449
A02	15553850	15555552	A02p29250.2_BraZ1	507	+	126	1164	1702	0.6839013
A02	15557462	15559029	A02p29260.2_BraZ1	991.115	+	815	1538	1567	0.9814933
A02	15559490	15565876	A02p29270.2_BraZ1	2610.78	+	638	5668	6386	0.8875666
A02	15565888	15566206	A02p29280.2_BraZ1	31.8	+	228	318	318	1.0000000
A02	15566448	15567916	A02p29290.2_BraZ1	1155	-	294	1420	1468	0.9673024
A02	15568921	15571402	A02p29300.2_BraZ1	1249.09	-	781	2412	2481	0.9721887
A02	15578017	15581039	A02p29310.2_BraZ1	1253.14	-	912	2984	3022	0.9874256
A02	15584620	15585982	A02p29320.2_BraZ1	204	+	127	871	1362	0.6395007
A02	15586712	15587460	A02p29330.2_BraZ1	280.35	-	5	209	748	0.2794118
A02	15588076	15588481	A02p29340.2_BraZ1	40.5	+	105	161	405	0.3975309
A02	15589563	15591486	A02p29350.2_BraZ1	1156	+	392	1849	1923	0.9615185
A02	15593020	15595438	A02p29360.2_BraZ1	1526.89	+	583	2204	2418	0.9114971
A02	15606565	15608154	A02p29370.2_BraZ1	1077	+	100	893	1589	0.5619887
A02	15608867	15610114	A02p29380.2_BraZ1	1056	+	177	1047	1247	0.8396150
A02	15610244	15611395	A02p29390.2_BraZ1	955.565	-	409	1126	1151	0.9782798
A02	15611726	15613349	A02p29400.2_BraZ1	1032	-	280	1593	1623	0.9815157
A02	15616267	15618544	A02p29410.2_BraZ1	1746.9	+	448	1822	2277	0.8001757
A02	15619930	15624388	A02p29420.2_BraZ1	2689.93	-	3455	4449	4458	0.9979811
A02	15625040	15625647	A02p29430.2_BraZ1	166.552	-	501	576	607	0.9489291
A02	15626545	15626840	A02p29440.2_BraZ1	201	+	121	295	295	1.0000000
A02	15635309	15636089	A02p29450.2_BraZ1	78	-	1136	780	780	1.0000000
A02	15638388	15638982	A02p29460.2_BraZ1	378	-	152	594	594	1.0000000
A02	15642208	15643222	A02p29470.2_BraZ1	510.889	-	451	1012	1014	0.9980276
A02	15643856	15645295	A02p29480.2_BraZ1	564.73	-	461	1408	1439	0.9784573
A02	15654688	15656069	A02p29490.2_BraZ1	441	+	1302	1376	1381	0.9963794
A02	15656536	15656746	A02p29500.2_BraZ1	21	+	94	210	210	1.0000000
A02	15657216	15658061	A02p29510.2_BraZ1	555.341	-	200	714	845	0.8449704
A02	15658554	15658905	A02p29520.2_BraZ1	35.1	-	57	340	351	0.9686610
A02	15659118	15660297	A02p29530.2_BraZ1	117.9	-	180	798	1179	0.6768448
A02	15660869	15662665	A02p29540.2_BraZ1	1139.73	-	158	1464	1796	0.8151448
A02	15666256	15666656	A02p29550.2_BraZ1	309	+	71	400	400	1.0000000
A02	15678034	15678301	A02p29560.2_BraZ1	26.7	-	677	267	267	1.0000000
A02	15680761	15682070	A02p29570.2_BraZ1	936.196	+	203	964	1309	0.7364400
A02	15683214	15684026	A02p29580.2_BraZ1	633	-	49	533	812	0.6564040
A02	15688067	15688964	A02p29590.2_BraZ1	52.8	+	170	816	897	0.9096990
A02	15709657	15711096	A02p29600.2_BraZ1	1302	+	352	1439	1439	1.0000000
A02	15711593	15713177	A02p29610.2_BraZ1	1010.32	-	960	1486	1584	0.9381313
A02	15715939	15716281	A02p29620.2_BraZ1	34.2	-	111	342	342	1.0000000
A02	15718516	15719404	A02p29630.2_BraZ1	88.8	+	154	838	888	0.9436937
A02	15719731	15720015	A02p29640.2_BraZ1	270	-	46	284	284	1.0000000
A02	15720246	15726895	A02p29650.2_BraZ1	316.8	-	1319	5568	6649	0.8374192
A02	15727814	15729737	A02p29660.2_BraZ1	938.048	-	271	1764	1923	0.9173167
A02	15732849	15736434	A02p29670.2_BraZ1	3273	-	379	2299	3585	0.6412831
A02	15741228	15756853	A02p29680.2_BraZ1	7091.6	+	1259	8994	15625	0.5756160
A02	15763364	15763655	A02p29690.2_BraZ1	29.1	+	196	291	291	1.0000000
A02	15772864	15774998	A02p29700.2_BraZ1	1039.14	+	183	1478	2134	0.6925961
A02	15785380	15786268	A02p29710.2_BraZ1	381	+	553	888	888	1.0000000
A02	15788347	15788920	A02p29720.2_BraZ1	2656.5	+	187	573	573	1.0000000
A02	15789367	15791116	A02p29730.2_BraZ1	1117.5	-	311	1214	1749	0.6941109
A02	15792136	15793660	A02p29740.2_BraZ1	152.4	-	130	1233	1524	0.8090551
A02	15800947	15801256	A02p29750.2_BraZ1	30.9	+	147	293	309	0.9482201
A02	15801731	15804537	A02p29760.2_BraZ1	1492.11	-	849	2673	2806	0.9526016
A02	15806384	15808651	A02p29770.2_BraZ1	1209.61	-	271	2092	2267	0.9228055
A02	15818572	15819424	A02p29780.2_BraZ1	429	-	15	115	852	0.1349765
A02	15823915	15826602	A02p29790.2_BraZ1	675	+	1163	2481	2687	0.9233346
A02	15837358	15837949	A02p29800.2_BraZ1	59.1	+	272	591	591	1.0000000
A02	15843481	15850605	A02p29810.2_BraZ1	3251.12	-	1662	6068	7124	0.8517687
A02	15852925	15854726	A02p29820.2_BraZ1	1448.64	+	104	949	1801	0.5269295
A02	15855908	15857321	A02p29830.2_BraZ1	141.3	+	53	304	1413	0.2151451
A02	15866596	15866977	A02p29840.2_BraZ1	38.1	+	45	291	381	0.7637795
A02	15877961	15879827	A02p29850.2_BraZ1	57	+	32	851	1866	0.4560557
A02	15880427	15881766	A02p29860.2_BraZ1	1149.5	-	248	1172	1339	0.8752801
A02	15885901	15889027	A02p29870.2_BraZ1	1089.8	+	626	2631	3126	0.8416507
A02	15890891	15891422	A02p29880.2_BraZ1	53.1	-	18	334	531	0.6290019
A02	15891946	15893817	A02p29890.2_BraZ1	1195.9	-	560	1724	1871	0.9214324
A02	15907868	15909284	A02p29900.2_BraZ1	937.5	-	585	1416	1416	1.0000000
A02	15914888	15917255	A02p29910.2_BraZ1	1009.2	+	1110	2349	2367	0.9923955
A02	15919137	15922315	A02p29920.2_BraZ1	28386	+	129	1816	3178	0.5714286
A02	15928547	15932083	A02p29930.2_BraZ1	1932.85	+	743	1938	3536	0.5480769
A02	15944990	15946314	A02p29940.2_BraZ1	964.171	+	199	1044	1324	0.7885196
A02	15946859	15947246	A02p29950.2_BraZ1	38.7	+	274	387	387	1.0000000
A02	15953361	15955961	A02p29960.2_BraZ1	383.167	+	2485	2600	2600	1.0000000
A02	15955951	15957917	A02p29970.2_BraZ1	690.1	+	1942	1966	1966	1.0000000
A02	15974061	15975486	A02p29980.2_BraZ1	142.5	+	33	98	1425	0.0687719
A02	15976789	15977245	A02p29990.2_BraZ1	255	+	53	456	456	1.0000000
A02	15977302	15977957	A02p30000.2_BraZ1	1199	+	471	655	655	1.0000000
A02	15983817	15989707	A02p30010.2_BraZ1	232.2	-	13450	5525	5890	0.9380305
A02	15993262	15994090	A02p30020.2_BraZ1	82.8	+	50	709	828	0.8562802
A02	15998040	15999465	A02p30030.2_BraZ1	142.5	+	12	36	1425	0.0252632
A02	16008056	16008971	A02p30040.2_BraZ1	759	+	43	615	915	0.6721311
A02	16009596	16016121	A02p30050.2_BraZ1	762	+	3743	6425	6525	0.9846743
A02	16021485	16022152	A02p30060.2_BraZ1	2398.5	+	188	508	667	0.7616192
A02	16023223	16024672	A02p30070.2_BraZ1	144.9	-	43	314	1449	0.2167012
A02	16033675	16036264	A02p30080.2_BraZ1	1801.06	-	582	2147	2589	0.8292777
A02	16037061	16037208	A02p30090.2_BraZ1	14.7	-	189	147	147	1.0000000
A02	16037657	16037789	A02p30100.2_BraZ1	13.2	-	142	132	132	1.0000000
A02	16044155	16046095	A02p30110.2_BraZ1	1418.63	+	320	1707	1940	0.8798969
A02	16046379	16047494	A02p30120.2_BraZ1	603	-	462	1017	1115	0.9121076
A02	16047382	16049920	A02p30130.2_BraZ1	253.8	+	1517	2538	2538	1.0000000
A02	16056382	16057558	A02p30140.2_BraZ1	203.4	-	578	1176	1176	1.0000000
A02	16064019	16064714	A02p30150.2_BraZ1	216	+	1268	695	695	1.0000000
A02	16070543	16078272	A02p30160.2_BraZ1	852.048	+	2624	7258	7729	0.9390607
A02	16091440	16093045	A02p30170.2_BraZ1	693.286	-	101	1418	1605	0.8834891
A02	16095293	16098588	A02p30180.2_BraZ1	825.36	+	1458	3095	3295	0.9393020
A02	16122966	16123269	A02p30190.2_BraZ1	30.3	-	347	303	303	1.0000000
A02	16128510	16130231	A02p30200.2_BraZ1	1059.3	+	145	1158	1721	0.6728646
A02	16155279	16155873	A02p30210.2_BraZ1	59.4	-	939	594	594	1.0000000
A02	16156001	16156578	A02p30220.2_BraZ1	342	-	473	577	577	1.0000000
A02	16169226	16170341	A02p30230.2_BraZ1	985.5	-	3223	1115	1115	1.0000000
A02	16179942	16180446	A02p30240.2_BraZ1	73.5	-	210	438	504	0.8690476
A02	16181103	16182439	A02p30250.2_BraZ1	600.415	+	216	1129	1336	0.8450599
A02	16203149	16203788	A02p30260.2_BraZ1	63.9	-	266	638	639	0.9984351
A02	16206747	16208025	A02p30270.2_BraZ1	1074	+	49	386	1278	0.3020344
A02	16218772	16221289	A02p30280.2_BraZ1	1296.71	-	555	2021	2517	0.8029400
A02	16228794	16233504	A02p30290.2_BraZ1	599.625	-	2794	4535	4710	0.9628450
A02	16235910	16238086	A02p30300.2_BraZ1	1530	+	611	2094	2176	0.9623162
A02	16249108	16252501	A02p30310.2_BraZ1	1534.5	+	413	2696	3393	0.7945771
A02	16255615	16256668	A02p30320.2_BraZ1	105.3	-	62	694	1053	0.6590693
A02	16268406	16270813	A02p30330.2_BraZ1	1405.66	-	783	1877	2407	0.7798089
A02	16296181	16297066	A02p30340.2_BraZ1	342	-	155	885	885	1.0000000
A02	16329466	16334043	A02p30350.2_BraZ1	195	-	673	3418	4577	0.7467774
A02	16330173	16331279	A02p30360.2_BraZ1	237	+	63	862	1106	0.7793851
A02	16331819	16333216	A02p30370.2_BraZ1	59.4	+	497	1389	1397	0.9942734
A02	16337167	16338262	A02p30380.2_BraZ1	228	+	0	0	1095	0.0000000
A02	16339176	16340910	A02p30390.2_BraZ1	1005.6	-	131	457	1734	0.2635525
A02	16343683	16344238	A02p30400.2_BraZ1	55.5	+	7	257	555	0.4630631
A02	16347890	16348542	A02p30410.2_BraZ1	393	+	622	652	652	1.0000000
A02	16351840	16356620	A02p30420.2_BraZ1	2466.52	+	536	1921	4780	0.4018829
A02	16357081	16359509	A02p30430.2_BraZ1	498	-	987	1824	2428	0.7512356
A02	16381949	16382107	A02p30440.2_BraZ1	13.2	+	12	51	158	0.3227848
A02	16383738	16386293	A02p30450.2_BraZ1	1421.85	-	112	1474	2555	0.5769081
A02	16398476	16400864	A02p30460.2_BraZ1	238.8	+	68	919	2388	0.3848409
A02	16401653	16402157	A02p30470.2_BraZ1	50.4	+	103	424	504	0.8412699
A02	16407034	16407418	A02p30480.2_BraZ1	291	-	49	368	384	0.9583333
A02	16415984	16419189	A02p30490.2_BraZ1	1687.5	+	635	2852	3205	0.8898596
A02	16420394	16424091	A02p30500.2_BraZ1	1831.92	+	558	2630	3697	0.7113876
A02	16424668	16426684	A02p30510.2_BraZ1	201.6	-	599	1771	2016	0.8784722
A02	16430532	16430763	A02p30520.2_BraZ1	23.1	-	1	10	231	0.0432900
A02	16432001	16433082	A02p30530.2_BraZ1	774	-	532	1081	1081	1.0000000
A02	16435789	16438263	A02p30540.2_BraZ1	738.462	+	1385	2474	2474	1.0000000
A02	16439362	16440497	A02p30550.2_BraZ1	243.633	-	947	1135	1135	1.0000000
A02	16441516	16445706	A02p30560.2_BraZ1	2429.61	-	402	3163	4190	0.7548926
A02	16448035	16454198	A02p30570.2_BraZ1	2656.96	-	1218	5051	6163	0.8195684
A02	16455402	16456267	A02p30580.2_BraZ1	48.9	-	3027	865	865	1.0000000
A02	16458779	16459950	A02p30590.2_BraZ1	514.667	-	855	1171	1171	1.0000000
A02	16460834	16464014	A02p30600.2_BraZ1	1107	-	1755	3180	3180	1.0000000
A02	16479211	16479397	A02p30610.2_BraZ1	18.6	-	342	186	186	1.0000000
A02	16483873	16486690	A02p30620.2_BraZ1	6412	+	335	2042	2817	0.7248846
A02	16491020	16492845	A02p30630.2_BraZ1	1425	+	173	1321	1825	0.7238356
A02	16495223	16495691	A02p30640.2_BraZ1	46.8	+	8	219	468	0.4679487
A02	16527052	16527877	A02p30650.2_BraZ1	615.25	-	73	737	825	0.8933333
A02	16528736	16537871	A02p30660.2_BraZ1	1530.67	-	7531	8851	9135	0.9689108
A02	16534151	16534934	A02p30670.2_BraZ1	513	-	670	783	783	1.0000000
A02	16543170	16543878	A02p30680.2_BraZ1	228	+	786	708	708	1.0000000
A02	16544898	16549366	A02p30690.2_BraZ1	2679.13	-	462	1758	4468	0.3934646
A02	16551030	16552818	A02p30700.2_BraZ1	630	-	626	1722	1788	0.9630873
A02	16558769	16560050	A02p30710.2_BraZ1	666	-	1743	1281	1281	1.0000000
A02	16561578	16561698	A02p30720.2_BraZ1	12	-	135	120	120	1.0000000
A02	16562615	16565185	A02p30730.2_BraZ1	1430.14	+	299	1536	2570	0.5976654
A02	16569762	16570546	A02p30740.2_BraZ1	297	+	119	677	784	0.8635204
A02	16586743	16589174	A02p30750.2_BraZ1	1184.63	-	379	1653	2431	0.6799671
A02	16596336	16597459	A02p30760.2_BraZ1	724.364	+	86	421	1123	0.3748887
A02	16597639	16597750	A02p30770.2_BraZ1	11.1	-	85	111	111	1.0000000
A02	16598654	16599322	A02p30780.2_BraZ1	564	-	554	668	668	1.0000000
A02	16601076	16601514	A02p30790.2_BraZ1	43.8	-	1375	438	438	1.0000000
A02	16604335	16605282	A02p30800.2_BraZ1	2159	-	428	947	947	1.0000000
A02	16608289	16609317	A02p30810.2_BraZ1	501	+	72	850	1028	0.8268483
A02	16609613	16611719	A02p30820.2_BraZ1	1162.79	-	408	1840	2106	0.8736942
A02	16614624	16615718	A02p30830.2_BraZ1	981	+	251	954	1094	0.8720292
A02	16617301	16617745	A02p30840.2_BraZ1	195	+	151	444	444	1.0000000
A02	16619750	16621363	A02p30850.2_BraZ1	1545	+	340	1177	1613	0.7296962
A02	16625140	16626504	A02p30860.2_BraZ1	534.13	+	20	256	1364	0.1876833
A02	16630376	16631829	A02p30870.2_BraZ1	808.889	-	120	881	1453	0.6063317
A02	16639341	16641505	A02p30880.2_BraZ1	1175.11	+	735	1732	2164	0.8003697
A02	16649067	16658868	A02p30890.2_BraZ1	1424.83	-	6413	8455	9801	0.8626671
A02	16676090	16676788	A02p30900.2_BraZ1	582	+	3	97	698	0.1389685
A02	16685913	16686045	A02p30910.2_BraZ1	13.2	-	179	132	132	1.0000000
A02	16688326	16690921	A02p30920.2_BraZ1	8910	-	286	1349	2595	0.5198458
A02	16702453	16707343	A02p30930.2_BraZ1	2190.75	-	552	3564	4890	0.7288343
A02	16713165	16717068	A02p30940.2_BraZ1	1817.93	-	125	1366	3903	0.3499872
A02	16722732	16723048	A02p30950.2_BraZ1	21	+	160	246	316	0.7784810
A02	16724572	16727206	A02p30960.2_BraZ1	1350.59	-	53	585	2634	0.2220957
A02	16729786	16729927	A02p30970.2_BraZ1	14.1	-	6	141	141	1.0000000
A02	16730578	16731774	A02p30980.2_BraZ1	534.36	-	106	781	1196	0.6530100
A02	16732447	16733607	A02p30990.2_BraZ1	338.696	+	351	1156	1160	0.9965518
A02	16742162	16742953	A02p31000.2_BraZ1	588	+	324	791	791	1.0000000
A02	16743173	16743864	A02p31010.2_BraZ1	180.6	-	2	253	691	0.3661360
A02	16748372	16748581	A02p31020.2_BraZ1	159	+	271	209	209	1.0000000
A02	16748843	16749798	A02p31030.2_BraZ1	588.75	+	1373	908	955	0.9507853
A02	16750788	16752424	A02p31040.2_BraZ1	1485	-	585	948	1636	0.5794621
A02	16762055	16762367	A02p31050.2_BraZ1	141	-	9	209	312	0.6698718
A02	16774604	16775020	A02p31060.2_BraZ1	201	+	263	416	416	1.0000000
A02	16776430	16778379	A02p31070.2_BraZ1	1329	-	24	358	1949	0.1836839
A02	16792522	16792896	A02p31080.2_BraZ1	282	-	746	374	374	1.0000000
A02	16797457	16804536	A02p31090.2_BraZ1	902.5	+	2208	5342	7079	0.7546263
A02	16807323	16807618	A02p31100.2_BraZ1	177	-	198	283	295	0.9593220
A02	16808736	16809625	A02p31110.2_BraZ1	444.063	-	825	889	889	1.0000000
A02	16814756	16815158	A02p31120.2_BraZ1	330	+	292	402	402	1.0000000
A02	16819044	16819840	A02p31130.2_BraZ1	302.857	-	77	434	796	0.5452262
A02	16820507	16821039	A02p31140.2_BraZ1	42	-	9	274	532	0.5150376
A02	16832627	16834834	A02p31150.2_BraZ1	1353	-	1901	2177	2207	0.9864069
A02	16843444	16844122	A02p31160.2_BraZ1	1776	+	6	278	678	0.4100295
A02	16843763	16844329	A02p31170.2_BraZ1	339	+	6	45	566	0.0795053
A02	16844584	16853048	A02p31180.2_BraZ1	1204.5	-	4934	5426	8464	0.6410680
A02	16861371	16863892	A02p31190.2_BraZ1	1485.71	+	57	753	2521	0.2986910
A02	16869082	16869378	A02p31200.2_BraZ1	17.4	-	0	0	296	0.0000000
A02	16876511	16896064	A02p31210.2_BraZ1	1198.55	+	34471	16318	19553	0.8345522
A02	16893612	16893957	A02p31220.2_BraZ1	1032	-	176	339	345	0.9826087
A02	16896639	16896939	A02p31230.2_BraZ1	30	-	51	300	300	1.0000000
A02	16899649	16900667	A02p31240.2_BraZ1	933	-	1624	1018	1018	1.0000000
A02	16900789	16903420	A02p31250.2_BraZ1	483	-	6230	2631	2631	1.0000000
A02	16900984	16901335	A02p31260.2_BraZ1	35.1	-	708	351	351	1.0000000
A02	16917873	16918374	A02p31270.2_BraZ1	396	-	96	469	501	0.9361277
A02	16918774	16919115	A02p31280.2_BraZ1	23.7	-	87	339	341	0.9941349
A02	16921951	16925567	A02p31290.2_BraZ1	601.309	+	1019	2634	3616	0.7284292
A02	16937750	16939488	A02p31300.2_BraZ1	589.031	-	1831	1738	1738	1.0000000
A02	16941958	16944454	A02p31310.2_BraZ1	1883.4	-	30	701	2496	0.2808494
A02	16945993	16946398	A02p31320.2_BraZ1	315	+	181	405	405	1.0000000
A02	16947310	16947502	A02p31330.2_BraZ1	19.2	+	197	192	192	1.0000000
A02	16949151	16949627	A02p31340.2_BraZ1	38.1	+	91	472	476	0.9915966
A02	16956425	16959732	A02p31350.2_BraZ1	1764.55	-	2377	3307	3307	1.0000000
A02	16961557	16961891	A02p31360.2_BraZ1	135	+	13	334	334	1.0000000
A02	16998422	17005141	A02p31370.2_BraZ1	2834	-	1140	4496	6719	0.6691472
A02	17014218	17015528	A02p31380.2_BraZ1	333	-	223	1018	1310	0.7770993
A02	17023581	17024010	A02p31390.2_BraZ1	44.25	+	330	412	429	0.9603730
A02	17024062	17025104	A02p31400.2_BraZ1	174	+	951	1028	1042	0.9865643
A02	17025144	17025558	A02p31410.2_BraZ1	41.4	-	76	414	414	1.0000000
A02	17073223	17080154	A02p31420.2_BraZ1	580	+	833	3186	6931	0.4596739
A02	17099583	17100459	A02p31430.2_BraZ1	87.6	+	28	613	876	0.6997717
A02	17115385	17115717	A02p31440.2_BraZ1	27.3	-	77	332	332	1.0000000
A02	17116269	17116605	A02p31450.2_BraZ1	177	+	184	336	336	1.0000000
A02	17117469	17118487	A02p31460.2_BraZ1	1176	+	43	694	1018	0.6817289
A02	17119658	17120103	A02p31470.2_BraZ1	34.2	-	20	22	445	0.0494382
A02	17121358	17122045	A02p31480.2_BraZ1	648	+	11	136	687	0.1979621
A02	17121692	17122924	A02p31490.2_BraZ1	792	+	72	879	1232	0.7134740
A02	17123835	17124606	A02p31500.2_BraZ1	17221.5	-	95	640	771	0.8300908
A02	17128166	17128562	A02p31510.2_BraZ1	39.6	+	590	396	396	1.0000000
A02	17130809	17131082	A02p31520.2_BraZ1	27.3	+	11	209	273	0.7655678
A02	17131453	17142466	A02p31530.2_BraZ1	929.727	-	1069	4929	11013	0.4475620
A02	17147886	17149551	A02p31540.2_BraZ1	1317.27	-	28	771	1665	0.4630631
A02	17150328	17150511	A02p31550.2_BraZ1	18.3	+	41	183	183	1.0000000
A02	17159502	17159622	A02p31560.2_BraZ1	12	-	302	120	120	1.0000000
A02	17159745	17160612	A02p31570.2_BraZ1	426	-	945	867	867	1.0000000
A02	17161806	17165045	A02p31580.2_BraZ1	265.5	-	24	216	3239	0.0666872
A02	17176237	17179472	A02p31590.2_BraZ1	590	-	42	611	3235	0.1888717
A02	17237585	17237807	A02p31600.2_BraZ1	22.2	-	653	222	222	1.0000000
A02	17247205	17247574	A02p31610.2_BraZ1	36.9	+	116	369	369	1.0000000
A02	17247721	17249072	A02p31620.2_BraZ1	378	+	170	1129	1351	0.8356773
A02	17249276	17250214	A02p31630.2_BraZ1	252	+	140	698	938	0.7441365
A02	17255461	17256538	A02p31640.2_BraZ1	261.3	-	528	1059	1077	0.9832869
A02	17256538	17257089	A02p31650.2_BraZ1	195	+	406	551	551	1.0000000
A02	17257448	17257874	A02p31660.2_BraZ1	42	-	147	377	426	0.8849765
A02	17263517	17266469	A02p31670.2_BraZ1	1688.32	+	245	1268	2952	0.4295393
A02	17275948	17277161	A02p31680.2_BraZ1	107.4	-	110	809	1213	0.6669415
A02	17283002	17284184	A02p31690.2_BraZ1	118.2	-	781	1182	1182	1.0000000
A02	17285069	17286389	A02p31700.2_BraZ1	618	-	1603	1320	1320	1.0000000
A02	17286901	17287410	A02p31710.2_BraZ1	44.7	-	322	509	509	1.0000000
A02	17287701	17288214	A02p31720.2_BraZ1	51.3	-	285	513	513	1.0000000
A02	17293386	17294251	A02p31730.2_BraZ1	216	+	420	865	865	1.0000000
A02	17294548	17296847	A02p31740.2_BraZ1	1662	+	212	1413	2299	0.6146150
A02	17299452	17300024	A02p31750.2_BraZ1	55.8	-	522	572	572	1.0000000
A02	17307704	17308325	A02p31760.2_BraZ1	62.1	-	32	497	621	0.8003221
A02	17310159	17312106	A02p31770.2_BraZ1	894	-	754	1665	1947	0.8551618
A02	17319548	17328255	A02p31780.2_BraZ1	604.89	+	5486	8348	8707	0.9587688
A02	17336950	17337945	A02p31790.2_BraZ1	825	-	100	519	995	0.5216081
A02	17339573	17339726	A02p31800.2_BraZ1	15.3	-	1	90	153	0.5882353
A02	17343372	17345087	A02p31810.2_BraZ1	1551	+	64	656	1715	0.3825073
A02	17345996	17348713	A02p31820.2_BraZ1	1048.91	+	911	1901	2717	0.6996688
A02	17356629	17357209	A02p31830.2_BraZ1	237	+	1212	580	580	1.0000000
A02	17357625	17362822	A02p31840.2_BraZ1	2212.92	-	917	1392	5197	0.2678468
A02	17368526	17368945	A02p31850.2_BraZ1	4009.5	+	19	372	419	0.8878282
A02	17371813	17371959	A02p31860.2_BraZ1	13.5	+	203	146	146	1.0000000
A02	17373154	17373367	A02p31870.2_BraZ1	21.3	-	34	124	213	0.5821596
A02	17377119	17379222	A02p31880.2_BraZ1	1230.67	+	53	1120	2103	0.5325725
A02	17379032	17379905	A02p31890.2_BraZ1	695.333	+	24	584	873	0.6689576
A02	17384633	17385623	A02p31900.2_BraZ1	549	+	136	707	990	0.7141414
A02	17396188	17397478	A02p31910.2_BraZ1	129	+	53	605	1290	0.4689922
A02	17406740	17408560	A02p31920.2_BraZ1	993.886	-	163	1261	1820	0.6928571
A02	17444262	17444406	A02p31930.2_BraZ1	14.4	-	123	144	144	1.0000000
A02	17444972	17446162	A02p31940.2_BraZ1	735	+	32	380	1190	0.3193277
A02	17447814	17449760	A02p31950.2_BraZ1	604	+	1724	1930	1946	0.9917780
A02	17450967	17451827	A02p31960.2_BraZ1	317.333	+	42	631	860	0.7337210
A02	17453296	17454070	A02p31970.2_BraZ1	585	+	16	193	774	0.2493540
A02	17462200	17464398	A02p31980.2_BraZ1	432	-	1719	1672	2198	0.7606915
A02	17475590	17476792	A02p31990.2_BraZ1	450	+	446	1202	1202	1.0000000
A02	17480966	17482128	A02p32000.2_BraZ1	42.6	+	140	996	1162	0.8571429
A02	17482579	17483060	A02p32010.2_BraZ1	23.7	-	267	481	481	1.0000000
A02	17482943	17483750	A02p32020.2_BraZ1	55.5	-	369	773	807	0.9578686
A02	17483738	17487675	A02p32030.2_BraZ1	241.8	-	5043	3926	3937	0.9972060
A02	17488168	17489641	A02p32040.2_BraZ1	99.9	-	1512	1465	1473	0.9945689
A02	17489608	17492329	A02p32050.2_BraZ1	153	-	3899	2502	2721	0.9195149
A02	17492336	17494482	A02p32060.2_BraZ1	106.8	-	601	2094	2146	0.9757689
A02	17497258	17497616	A02p32070.2_BraZ1	79.0909	-	25	338	358	0.9441341
A02	17497670	17499288	A02p32080.2_BraZ1	859.545	-	35	491	1618	0.3034611
A02	17510656	17514091	A02p32090.2_BraZ1	1382.87	-	63	1105	3435	0.3216885
A02	17537279	17537548	A02p32100.2_BraZ1	192	+	387	269	269	1.0000000
A02	17540214	17540733	A02p32110.2_BraZ1	51.9	-	78	473	519	0.9113680
A02	17545652	17546071	A02p32120.2_BraZ1	294	-	866	419	419	1.0000000
A02	17560112	17561562	A02p32130.2_BraZ1	936.562	-	166	1071	1450	0.7386207
A02	17570701	17570967	A02p32140.2_BraZ1	98	-	296	266	266	1.0000000
A02	17574136	17575483	A02p32150.2_BraZ1	885	+	3759	1347	1347	1.0000000
A02	17586252	17589089	A02p32160.2_BraZ1	1335.6	+	163	1680	2837	0.5921748
A02	17601775	17605970	A02p32170.2_BraZ1	2648.14	+	243	2072	4195	0.4939213
A02	17606317	17608496	A02p32180.2_BraZ1	883.14	-	516	2054	2179	0.9426342
A02	17610580	17610709	A02p32190.2_BraZ1	12.9	+	2009	129	129	1.0000000
A02	17613737	17616279	A02p32200.2_BraZ1	1344.79	-	648	2051	2542	0.8068450
A02	17634961	17637976	A02p32210.2_BraZ1	862.714	-	647	2677	3015	0.8878939
A02	17642451	17642799	A02p32220.2_BraZ1	34.8	+	67	317	348	0.9109195
A02	17643213	17645767	A02p32230.2_BraZ1	1126.13	-	1501	2405	2554	0.9416602
A02	17650481	17652570	A02p32240.2_BraZ1	402.857	+	427	1362	2089	0.6519866
A02	17653076	17676593	A02p32250.2_BraZ1	1471.56	+	9539	16201	23517	0.6889059
A02	17654494	17654944	A02p32260.2_BraZ1	45	-	14	267	450	0.5933333
A02	17664267	17664717	A02p32270.2_BraZ1	45	-	6	265	450	0.5888889
A02	17676957	17677407	A02p32280.2_BraZ1	45	-	0	0	450	0.0000000
A02	17684491	17687380	A02p32290.2_BraZ1	1815.69	+	15	634	2889	0.2194531
A02	17687467	17687578	A02p32300.2_BraZ1	11.1	+	4	111	111	1.0000000
A02	17697424	17697670	A02p32310.2_BraZ1	24.6	+	288	246	246	1.0000000
A02	17698856	17699965	A02p32320.2_BraZ1	204	-	1177	1109	1109	1.0000000
A02	17704577	17705035	A02p32330.2_BraZ1	408	+	147	458	458	1.0000000
A02	17713986	17715349	A02p32340.2_BraZ1	420	+	4906	1363	1363	1.0000000
A02	17716888	17717605	A02p32350.2_BraZ1	366	-	2337	717	717	1.0000000
A02	17719192	17719378	A02p32360.2_BraZ1	18.6	-	797	186	186	1.0000000
A02	17721716	17722313	A02p32370.2_BraZ1	357	-	282	472	597	0.7906198
A02	17724292	17726392	A02p32380.2_BraZ1	795	+	703	1648	2100	0.7847619
A02	17727674	17728206	A02p32390.2_BraZ1	219	+	288	532	532	1.0000000
A02	17734229	17734813	A02p32400.2_BraZ1	339	+	291	584	584	1.0000000
A02	17735098	17735539	A02p32410.2_BraZ1	378	-	255	441	441	1.0000000
A02	17737846	17738068	A02p32420.2_BraZ1	186	+	180	222	222	1.0000000
A02	17746883	17748052	A02p32430.2_BraZ1	1665	-	1049	1169	1169	1.0000000
A02	17748501	17749093	A02p32440.2_BraZ1	222	-	206	592	592	1.0000000
A02	17748994	17749399	A02p32450.2_BraZ1	297	+	257	405	405	1.0000000
A02	17751174	17752395	A02p32460.2_BraZ1	666	-	679	1221	1221	1.0000000
A02	17762061	17763409	A02p32470.2_BraZ1	826.554	+	305	1277	1348	0.9473294
A02	17766012	17767762	A02p32480.2_BraZ1	1452	-	1360	1750	1750	1.0000000
A02	17769203	17771649	A02p32490.2_BraZ1	1485.33	+	1207	2117	2446	0.8654947
A02	17775052	17775344	A02p32500.2_BraZ1	165	-	4	59	292	0.2020548
A02	17776558	17777026	A02p32510.2_BraZ1	237	-	102	468	468	1.0000000
A02	17781217	17783127	A02p32520.2_BraZ1	521.4	+	352	1348	1910	0.7057592
A02	17788207	17790351	A02p32530.2_BraZ1	2004	+	263	1428	2144	0.6660448
A02	17790794	17792829	A02p32540.2_BraZ1	1307.7	-	490	1602	2035	0.7872236
A02	17799715	17803894	A02p32550.2_BraZ1	2763.32	+	345	2623	4179	0.6276621
A02	17808208	17811533	A02p32560.2_BraZ1	1068.57	+	2474	3325	3325	1.0000000
A02	17831469	17834170	A02p32570.2_BraZ1	1083.65	-	821	2208	2701	0.8174750
A02	17843444	17843813	A02p32580.2_BraZ1	36.9	-	97	369	369	1.0000000
A02	17846732	17848436	A02p32590.2_BraZ1	170.4	-	169	1610	1704	0.9448357
A02	17849563	17858949	A02p32600.2_BraZ1	446.727	+	2941	9123	9386	0.9719796
A02	17864494	17868547	A02p32610.2_BraZ1	1533.64	+	990	2295	4053	0.5662472
A02	17878930	17879494	A02p32620.2_BraZ1	56.4	-	9	118	564	0.2092199
A02	17890271	17890603	A02p32630.2_BraZ1	234	-	226	332	332	1.0000000
A02	17895528	17896248	A02p32640.2_BraZ1	150	+	308	657	720	0.9125000
A02	17896812	17899809	A02p32650.2_BraZ1	1962.01	-	125	934	2997	0.3116450
A02	17904807	17906273	A02p32660.2_BraZ1	724.5	-	243	1466	1466	1.0000000
A02	17909573	17910638	A02p32670.2_BraZ1	605.931	-	410	1065	1065	1.0000000
A02	17912421	17913404	A02p32680.2_BraZ1	85.5	+	164	825	983	0.8392676
A02	17913787	17914596	A02p32690.2_BraZ1	3434.25	-	295	769	809	0.9505562
A02	17918128	17919341	A02p32700.2_BraZ1	996	-	27	593	1213	0.4888706
A02	17929672	17933476	A02p32710.2_BraZ1	1938.17	-	1200	3331	3804	0.8756572
A02	17947894	17948728	A02p32720.2_BraZ1	399	+	1539	834	834	1.0000000
A02	17953072	17953426	A02p32730.2_BraZ1	35.4	+	2	174	354	0.4915254
A02	17956769	17957246	A02p32740.2_BraZ1	247	-	145	407	477	0.8532495
A02	17974461	17975043	A02p32750.2_BraZ1	507	+	555	582	582	1.0000000
A02	17976869	17978408	A02p32760.2_BraZ1	691.724	+	1033	1457	1539	0.9467186
A02	17983188	17983566	A02p32770.2_BraZ1	37.8	-	12	233	378	0.6164021
A02	17988286	17989367	A02p32780.2_BraZ1	351	+	988	1081	1081	1.0000000
A02	17989723	17989951	A02p32790.2_BraZ1	22.8	-	53	151	228	0.6622807
A02	18006409	18006858	A02p32800.2_BraZ1	37.5	+	532	449	449	1.0000000
A02	18009939	18012132	A02p32810.2_BraZ1	2961.38	+	795	2193	2193	1.0000000
A02	18014646	18025545	A02p32820.2_BraZ1	1556.22	+	8500	10764	10899	0.9876136
A02	18031919	18032171	A02p32830.2_BraZ1	25.2	-	326	252	252	1.0000000
A02	18038465	18041787	A02p32840.2_BraZ1	1743.05	+	327	2769	3322	0.8335340
A02	18042625	18042751	A02p32850.2_BraZ1	12.6	+	112	126	126	1.0000000
A02	18049985	18053134	A02p32860.2_BraZ1	1741.71	+	460	1448	3149	0.4598285
A02	18058424	18061504	A02p32870.2_BraZ1	1504.17	-	490	2794	3080	0.9071429
A02	18071930	18072818	A02p32880.2_BraZ1	577.866	+	148	702	888	0.7905405
A02	18074041	18076268	A02p32890.2_BraZ1	1761.75	+	102	905	2227	0.4063763
A02	18084838	18085100	A02p32900.2_BraZ1	17.7	+	306	262	262	1.0000000
A02	18087427	18090149	A02p32910.2_BraZ1	884.314	+	1047	2341	2722	0.8600294
A02	18093727	18094120	A02p32920.2_BraZ1	39.3	+	1323	393	393	1.0000000
A02	18109090	18109514	A02p32930.2_BraZ1	279	+	538	424	424	1.0000000
A02	18111913	18113060	A02p32940.2_BraZ1	3817	+	497	851	1147	0.7419355
A02	18157163	18159994	A02p32950.2_BraZ1	915.437	+	708	2243	2831	0.7922996
A02	18162546	18162821	A02p32960.2_BraZ1	243	-	497	275	275	1.0000000
A02	18164365	18170410	A02p32970.2_BraZ1	281.6	+	2366	5497	6045	0.9093466
A02	18186098	18186337	A02p32980.2_BraZ1	180	-	26	228	239	0.9539749
A02	18193732	18195896	A02p32990.2_BraZ1	847.636	+	1095	1996	2164	0.9223660
A02	18195976	18196668	A02p33000.2_BraZ1	273	+	193	692	692	1.0000000
A02	18233773	18234202	A02p33010.2_BraZ1	42.9	+	240	429	429	1.0000000
A02	18239718	18241087	A02p33020.2_BraZ1	749.762	+	436	1369	1369	1.0000000
A02	18242370	18242937	A02p33030.2_BraZ1	389.932	-	105	567	567	1.0000000
A02	18262433	18263287	A02p33040.2_BraZ1	35.7	+	2461	854	854	1.0000000
A02	18286978	18289995	A02p33050.2_BraZ1	1489.36	-	953	1818	3017	0.6025854
A02	18340234	18340658	A02p33060.2_BraZ1	189	+	726	424	424	1.0000000
A02	18391518	18391701	A02p33070.2_BraZ1	18.3	-	315	183	183	1.0000000
A02	18410326	18412448	A02p33080.2_BraZ1	6330	-	545	1694	2122	0.7983035
A02	18434085	18434471	A02p33090.2_BraZ1	24.3	-	279	386	386	1.0000000
A02	18434759	18435084	A02p33100.2_BraZ1	20.1	-	230	325	325	1.0000000
A02	18435244	18435865	A02p33110.2_BraZ1	129	-	351	621	621	1.0000000
A02	18435965	18436313	A02p33120.2_BraZ1	34.8	-	290	348	348	1.0000000
A02	18438432	18438786	A02p33130.2_BraZ1	35.4	-	66	335	354	0.9463277
A02	18439655	18440863	A02p33140.2_BraZ1	493.615	-	94	744	1208	0.6158940
A02	18446612	18450855	A02p33150.2_BraZ1	2955.69	-	117	2224	4243	0.5241575
A02	18500995	18502323	A02p33160.2_BraZ1	706.75	-	2212	1328	1328	1.0000000
A02	18506366	18507518	A02p33170.2_BraZ1	903	+	617	1142	1152	0.9913194
A02	18507836	18509798	A02p33180.2_BraZ1	1248.72	-	198	1111	1962	0.5662589
A02	18512286	18516817	A02p33190.2_BraZ1	2508.41	-	760	2856	4531	0.6303244
A02	18529175	18539807	A02p33200.2_BraZ1	1070.26	+	4115	10158	10632	0.9554176
A02	18531297	18531766	A02p33210.2_BraZ1	402	-	13	235	469	0.5010661
A02	18531706	18532180	A02p33220.2_BraZ1	41.4	-	26	361	474	0.7616034
A02	18537059	18538157	A02p33230.2_BraZ1	819	+	116	1098	1098	1.0000000
A02	18540779	18541212	A02p33240.2_BraZ1	276	-	488	433	433	1.0000000
A02	18564896	18565394	A02p33250.2_BraZ1	381	-	1511	498	498	1.0000000
A02	18569110	18572009	A02p33260.2_BraZ1	690	-	498	2319	2899	0.7999310
A02	18569999	18570831	A02p33270.2_BraZ1	771	-	165	813	832	0.9771634
A02	18577361	18578049	A02p33280.2_BraZ1	1030	+	51	652	688	0.9476744
A02	18578318	18580943	A02p33290.2_BraZ1	552	-	874	2549	2625	0.9710476
A02	18581845	18582351	A02p33300.2_BraZ1	183	+	99	506	506	1.0000000
A02	18583784	18586409	A02p33310.2_BraZ1	322.833	-	1121	2625	2625	1.0000000
A02	18587843	18592528	A02p33320.2_BraZ1	805.942	+	1559	4416	4685	0.9425827
A02	18597133	18597484	A02p33330.2_BraZ1	35.1	+	725	351	351	1.0000000
A02	18603048	18604900	A02p33340.2_BraZ1	637.538	-	2044	1852	1852	1.0000000
A02	18607935	18609876	A02p33350.2_BraZ1	194.1	+	1515	1821	1941	0.9381762
A02	18621320	18621464	A02p33360.2_BraZ1	14.4	-	152	144	144	1.0000000
A02	18621817	18621976	A02p33370.2_BraZ1	15.9	+	631	159	159	1.0000000
A02	18665521	18666131	A02p33380.2_BraZ1	498	-	204	610	610	1.0000000
A02	18665747	18667754	A02p33390.2_BraZ1	452.667	-	695	2007	2007	1.0000000
A02	18685006	18685226	A02p33400.2_BraZ1	18.6	+	53	220	220	1.0000000
A02	18711588	18712383	A02p33410.2_BraZ1	531	+	625	795	795	1.0000000
A02	18720591	18721351	A02p33420.2_BraZ1	37.8	-	992	760	760	1.0000000
A02	18720972	18721692	A02p33430.2_BraZ1	21.6	-	1009	720	720	1.0000000
A02	18724016	18725512	A02p33440.2_BraZ1	624	+	1602	1496	1496	1.0000000
A02	18756495	18805387	A02p33450.2_BraZ1	912	-	14331	42566	48892	0.8706128
A02	18839840	18840856	A02p33460.2_BraZ1	1012.5	-	630	1016	1016	1.0000000
A02	18927528	18928116	A02p33470.2_BraZ1	474	-	211	588	588	1.0000000
A02	18980658	18981410	A02p33480.2_BraZ1	489	+	910	752	752	1.0000000
A02	18981754	18983765	A02p33490.2_BraZ1	1073.13	-	2208	2011	2011	1.0000000
A02	18988084	18988624	A02p33500.2_BraZ1	301.333	+	419	540	540	1.0000000
A02	18990182	18991048	A02p33510.2_BraZ1	111	+	1175	866	866	1.0000000
A02	19022782	19023581	A02p33520.2_BraZ1	528	+	101	552	799	0.6908635
A02	19023629	19024518	A02p33530.2_BraZ1	533.571	-	134	889	889	1.0000000
A02	19025011	19025634	A02p33540.2_BraZ1	267	-	25	386	623	0.6195827
A02	19030751	19031374	A02p33550.2_BraZ1	267	+	53	365	623	0.5858748
A02	19050240	19054621	A02p33560.2_BraZ1	1292.67	-	1044	3952	4381	0.9020771
A02	19075953	19076822	A02p33570.2_BraZ1	59.4	+	666	869	869	1.0000000
A02	19081741	19098528	A02p33580.2_BraZ1	1553.61	-	3935	16237	16787	0.9672366
A02	19099470	19100188	A02p33590.2_BraZ1	480	+	369	718	718	1.0000000
A02	19100670	19102213	A02p33600.2_BraZ1	648	+	724	1543	1543	1.0000000
A02	19150075	19150713	A02p33610.2_BraZ1	323.85	-	621	638	638	1.0000000
A02	19201092	19203379	A02p33620.2_BraZ1	2187	-	14	235	2287	0.1027547
A02	19204467	19207511	A02p33630.2_BraZ1	967.1	+	1493	3044	3044	1.0000000
A02	19204549	19204902	A02p33640.2_BraZ1	204	+	139	353	353	1.0000000
A02	20155382	20156519	A02p33650.2_BraZ1	849	+	514	1137	1137	1.0000000
A02	20170762	20172613	A02p33660.2_BraZ1	728.226	+	8	244	1851	0.1318206
A02	20183461	20183707	A02p33670.2_BraZ1	24.6	-	137	246	246	1.0000000
A02	20207835	20208381	A02p33680.2_BraZ1	54.6	-	489	546	546	1.0000000
A02	20246861	20263235	A02p33690.2_BraZ1	1207.54	-	8603	15800	16374	0.9649444
A02	20288943	20290017	A02p33700.2_BraZ1	990	-	438	1074	1074	1.0000000
A02	20352770	20353268	A02p33710.2_BraZ1	49.8	+	10	159	498	0.3192771
A02	20355825	20355959	A02p33720.2_BraZ1	10.8	+	263	134	134	1.0000000
A02	20411236	20412348	A02p33730.2_BraZ1	579	-	347	1112	1112	1.0000000
A02	20434554	20434845	A02p33740.2_BraZ1	29.1	-	146	291	291	1.0000000
A02	20474639	20479792	A02p33750.2_BraZ1	1207.3	-	1280	4018	5153	0.7797400
A02	20498204	20498657	A02p33760.2_BraZ1	396	+	696	453	453	1.0000000
A02	20502583	20503992	A02p33770.2_BraZ1	942	-	230	967	1409	0.6863024
A02	20519289	20523033	A02p33780.2_BraZ1	1884	+	2876	3724	3744	0.9946581
A02	20529511	20530747	A02p33790.2_BraZ1	261.8	-	2481	1236	1236	1.0000000
A02	20532923	20533685	A02p33800.2_BraZ1	162	+	165	533	762	0.6994750
A02	20538197	20538532	A02p33810.2_BraZ1	21.3	-	530	335	335	1.0000000
A02	20547602	20548191	A02p33820.2_BraZ1	270	+	345	589	589	1.0000000
A02	20554825	20555115	A02p33830.2_BraZ1	198	-	388	290	290	1.0000000
A02	20555884	20556250	A02p33840.2_BraZ1	36.6	-	539	366	366	1.0000000
A02	20581127	20581794	A02p33850.2_BraZ1	207	-	611	667	667	1.0000000
A02	20587945	20589686	A02p33860.2_BraZ1	16594.7	+	358	1567	1741	0.9000574
A02	20592792	20594399	A02p33870.2_BraZ1	10538	+	84	933	1607	0.5805849
A02	20598240	20599821	A02p33880.2_BraZ1	154.2	+	32	308	1581	0.1948134
A02	20601902	20602512	A02p33890.2_BraZ1	325	-	473	610	610	1.0000000
A02	20604567	20604946	A02p33900.2_BraZ1	657	-	810	379	379	1.0000000
A02	20605534	20609720	A02p33910.2_BraZ1	2801.5	-	426	2514	4186	0.6005734
A02	20613456	20614529	A02p33920.2_BraZ1	657	-	367	992	1073	0.9245107
A02	20650111	20650783	A02p33930.2_BraZ1	531	+	1738	672	672	1.0000000
A02	20650783	20652190	A02p33940.2_BraZ1	929.143	+	1774	1407	1407	1.0000000
A02	20651842	20653399	A02p33950.2_BraZ1	2427.43	+	2532	1557	1557	1.0000000
A02	20653264	20655123	A02p33960.2_BraZ1	492	+	989	1859	1859	1.0000000
A02	20659175	20659996	A02p33970.2_BraZ1	37.5	-	961	821	821	1.0000000
A02	20661918	20663658	A02p33980.2_BraZ1	316.75	+	713	1740	1740	1.0000000
A02	20668058	20668253	A02p33990.2_BraZ1	19.5	-	207	195	195	1.0000000
A02	20670426	20671551	A02p34000.2_BraZ1	54	+	1874	1125	1125	1.0000000
A02	20683351	20688163	A02p34010.2_BraZ1	1110	+	8645	4812	4812	1.0000000
A02	20686875	20687328	A02p34020.2_BraZ1	411	+	607	453	453	1.0000000
A02	20690743	20695300	A02p34030.2_BraZ1	417	-	8292	4557	4557	1.0000000
A02	20693374	20694529	A02p34040.2_BraZ1	1312.5	-	2641	1155	1155	1.0000000
A02	20694934	20695675	A02p34050.2_BraZ1	37.5	-	1124	741	741	1.0000000
A02	20709085	20710307	A02p34060.2_BraZ1	849	+	122	837	1222	0.6849427
A02	20710752	20711090	A02p34070.2_BraZ1	174	+	3221	338	338	1.0000000
A02	20710978	20711178	A02p34080.2_BraZ1	123	+	4169	200	200	1.0000000
A02	20715380	20716428	A02p34090.2_BraZ1	36.6	-	653	1048	1048	1.0000000
A02	20716070	20717216	A02p34100.2_BraZ1	67.5	-	663	1146	1146	1.0000000
A02	20717995	20719030	A02p34110.2_BraZ1	972	-	531	1035	1035	1.0000000
A02	20723751	20725536	A02p34120.2_BraZ1	1226.5	+	108	947	1785	0.5305322
A02	20727408	20727936	A02p34130.2_BraZ1	456	+	1	53	528	0.1003788
A02	20728909	20733884	A02p34140.2_BraZ1	2222.22	-	38	1127	4975	0.2265327
A02	20735863	20736193	A02p34150.2_BraZ1	28.2	-	382	330	330	1.0000000
A02	20736447	20736816	A02p34160.2_BraZ1	36.9	+	345	369	369	1.0000000
A02	20738625	20739775	A02p34170.2_BraZ1	2496	+	801	1150	1150	1.0000000
A02	20739365	20740955	A02p34180.2_BraZ1	429	+	1061	1590	1590	1.0000000
A02	20743888	20745339	A02p34190.2_BraZ1	465	+	555	1451	1451	1.0000000
A02	20744451	20744917	A02p34200.2_BraZ1	147	+	195	466	466	1.0000000
A02	20797227	20798977	A02p34210.2_BraZ1	771.873	-	34	644	1750	0.3680000
A02	20806446	20807461	A02p34220.2_BraZ1	453.6	+	96	818	1015	0.8059113
A02	20809414	20810033	A02p34230.2_BraZ1	378	-	9	245	619	0.3957997
A02	20813218	20814227	A02p34240.2_BraZ1	822	+	1243	1009	1009	1.0000000
A02	20841714	20841924	A02p34250.2_BraZ1	21	+	252	210	210	1.0000000
A02	20842573	20842992	A02p34260.2_BraZ1	174	-	284	419	419	1.0000000
A02	20858492	20858777	A02p34270.2_BraZ1	28.5	+	367	285	285	1.0000000
A02	20860311	20860671	A02p34280.2_BraZ1	114	-	343	360	360	1.0000000
A02	20860922	20861432	A02p34290.2_BraZ1	357	-	600	510	510	1.0000000
A02	20905152	20907841	A02p34300.2_BraZ1	789	+	3102	2689	2689	1.0000000
A02	20909973	20913018	A02p34310.2_BraZ1	702.778	+	2709	3045	3045	1.0000000
A02	20913760	20917043	A02p34320.2_BraZ1	1402.22	+	3933	3283	3283	1.0000000
A02	20926829	20927849	A02p34330.2_BraZ1	384	-	1119	1020	1020	1.0000000
A02	20937968	20939426	A02p34340.2_BraZ1	410	+	949	1458	1458	1.0000000
A02	20939925	20940163	A02p34350.2_BraZ1	12.3	+	319	238	238	1.0000000
A02	20954356	20954629	A02p34360.2_BraZ1	27.3	+	252	273	273	1.0000000
A02	20955261	20956851	A02p34370.2_BraZ1	159	-	37	293	1590	0.1842767
A02	20963108	20964090	A02p34380.2_BraZ1	285.75	-	1668	982	982	1.0000000
A02	20967614	20968177	A02p34390.2_BraZ1	498	+	683	563	563	1.0000000
A02	20974394	20974967	A02p34400.2_BraZ1	57.3	-	22	507	573	0.8848168
A02	20981361	20981594	A02p34410.2_BraZ1	12.9	-	16	96	233	0.4120172
A02	20991397	20992541	A02p34420.2_BraZ1	5801.7	+	52	764	1144	0.6678322
A02	20995441	20996050	A02p34430.2_BraZ1	60.9	+	519	609	609	1.0000000
A02	21004062	21006078	A02p34440.2_BraZ1	201.6	-	28	368	2016	0.1825397
A02	21008839	21009387	A02p34450.2_BraZ1	462	+	202	548	548	1.0000000
A02	21033704	21034841	A02p34460.2_BraZ1	113.7	+	451	1056	1137	0.9287599
A02	21036127	21037334	A02p34470.2_BraZ1	312.75	+	1096	1207	1207	1.0000000
A02	21037660	21042544	A02p34480.2_BraZ1	3636	-	5353	4884	4884	1.0000000
A02	21043043	21048701	A02p34490.2_BraZ1	369.6	-	6238	5658	5658	1.0000000
A02	21075711	21076015	A02p34500.2_BraZ1	228	+	208	304	304	1.0000000
A02	21077343	21077883	A02p34510.2_BraZ1	54	+	256	540	540	1.0000000
A02	21085441	21087646	A02p34520.2_BraZ1	1338	-	3866	2205	2205	1.0000000
A02	21093989	21094139	A02p34530.2_BraZ1	15	+	114	150	150	1.0000000
A02	21097847	21097988	A02p34540.2_BraZ1	14.1	+	183	141	141	1.0000000
A02	21107402	21108018	A02p34550.2_BraZ1	1072.5	-	538	616	616	1.0000000
A02	21124960	21125481	A02p34560.2_BraZ1	183	+	2316	521	521	1.0000000
A02	21128505	21128619	A02p34570.2_BraZ1	11.4	+	35	114	114	1.0000000
A02	21129209	21129588	A02p34580.2_BraZ1	291	-	1	137	379	0.3614776
A02	21130477	21130720	A02p34590.2_BraZ1	24.3	+	356	243	243	1.0000000
A02	21132092	21133118	A02p34600.2_BraZ1	102.6	-	34	342	1026	0.3333333
A02	21170237	21171665	A02p34610.2_BraZ1	11152	-	734	1428	1428	1.0000000
A02	21177966	21179874	A02p34620.2_BraZ1	487.667	+	3642	1908	1908	1.0000000
A02	21187602	21189601	A02p34630.2_BraZ1	1350	+	639	1831	1999	0.9159580
A02	21208157	21209090	A02p34640.2_BraZ1	632.273	-	34	453	933	0.4855306
A02	21211760	21214492	A02p34650.2_BraZ1	1178.25	-	288	1730	2732	0.6332358
A02	21219335	21219752	A02p34660.2_BraZ1	41.7	-	87	294	417	0.7050360
A02	21252091	21253516	A02p34670.2_BraZ1	873	-	648	1175	1425	0.8245614
A02	21260107	21260364	A02p34680.2_BraZ1	20.4	+	269	257	257	1.0000000
A02	21261077	21263086	A02p34690.2_BraZ1	1109.33	-	570	1688	2009	0.8402190
A02	21268155	21304556	A02p34700.2_BraZ1	1417.85	-	30913	35794	36401	0.9833246
A02	21296808	21298002	A02p34710.2_BraZ1	738	-	3330	1194	1194	1.0000000
A02	21305417	21305720	A02p34720.2_BraZ1	30.3	-	53	303	303	1.0000000
A02	21311665	21311923	A02p34730.2_BraZ1	25.8	+	12	147	258	0.5697674
A02	21382409	21383259	A02p34740.2_BraZ1	47.7	-	1820	850	850	1.0000000
A02	21383154	21384993	A02p34750.2_BraZ1	645	-	2624	1839	1839	1.0000000
A02	21396188	21396695	A02p34760.2_BraZ1	50.7	-	1059	507	507	1.0000000
A02	21397381	21397967	A02p34770.2_BraZ1	285	-	426	586	586	1.0000000
A02	21403114	21403592	A02p34780.2_BraZ1	39	+	78	353	478	0.7384937
A02	21404258	21405759	A02p34790.2_BraZ1	1092	+	266	1279	1501	0.8520986
A02	21464134	21468006	A02p34800.2_BraZ1	1792.59	+	795	2643	3872	0.6825930
A02	21482054	21482724	A02p34810.2_BraZ1	490.385	+	450	670	670	1.0000000
A02	21496894	21506565	A02p34820.2_BraZ1	1904.76	+	7885	9462	9671	0.9783890
A02	21516197	21516631	A02p34830.2_BraZ1	357	+	400	434	434	1.0000000
A02	21521185	21526733	A02p34840.2_BraZ1	2464.11	+	1171	4547	5548	0.8195746
A02	21528599	21528854	A02p34850.2_BraZ1	23.7	+	426	255	255	1.0000000
A02	21530951	21532853	A02p34860.2_BraZ1	44.4	+	2401	1902	1902	1.0000000
A02	21536190	21558723	A02p34870.2_BraZ1	1335	-	17473	21996	22533	0.9761683
A02	21548347	21549288	A02p34880.2_BraZ1	896	+	793	941	941	1.0000000
A02	21562733	21567737	A02p34890.2_BraZ1	2469.82	-	1500	4372	5004	0.8737010
A02	21589500	21589980	A02p34900.2_BraZ1	864.6	-	113	480	480	1.0000000
A02	21590236	21590879	A02p34910.2_BraZ1	498	+	140	537	643	0.8351477
A02	21599677	21602437	A02p34920.2_BraZ1	1264.38	-	654	2631	2760	0.9532609
A02	21603488	21605279	A02p34930.2_BraZ1	552	-	1261	1791	1791	1.0000000
A02	21606341	21607078	A02p34940.2_BraZ1	498	-	1	150	737	0.2035278
A02	21607156	21607895	A02p34950.2_BraZ1	582	-	0	0	739	0.0000000
A02	21608928	21610562	A02p34960.2_BraZ1	63423	-	1278	1634	1634	1.0000000
A02	21623587	21625249	A02p34970.2_BraZ1	68121	-	0	0	1662	0.0000000
A02	21645376	21647038	A02p34980.2_BraZ1	35496	+	16	189	1662	0.1137184
A02	21662823	21663719	A02p34990.2_BraZ1	661.304	-	213	698	896	0.7790179
A02	21675199	21677119	A02p35000.2_BraZ1	1608	-	42	379	1920	0.1973958
A02	21690835	21693586	A02p35010.2_BraZ1	1503.94	+	865	2300	2751	0.8360596
A02	21695241	21695578	A02p35020.2_BraZ1	210	+	18	154	337	0.4569733
A02	21696029	21696227	A02p35030.2_BraZ1	19.8	-	42	190	198	0.9595960
A02	21699341	21702940	A02p35040.2_BraZ1	1534.6	-	1117	3015	3599	0.8377327
A02	21704773	21706509	A02p35050.2_BraZ1	936.234	-	617	1728	1736	0.9953917
A02	21711594	21711954	A02p35060.2_BraZ1	36	+	174	360	360	1.0000000
A02	21721256	21721418	A02p35070.2_BraZ1	16.2	-	177	162	162	1.0000000
A02	21730534	21731732	A02p35080.2_BraZ1	785.333	-	279	1092	1198	0.9115192
A02	21736660	21741412	A02p35090.2_BraZ1	2334.26	-	624	3440	4752	0.7239057
A02	21755958	21756309	A02p35100.2_BraZ1	34.5	-	870	351	351	1.0000000
A02	21757002	21758126	A02p35110.2_BraZ1	569.889	-	25	368	1124	0.3274021
A02	21762359	21763011	A02p35120.2_BraZ1	319	-	271	652	652	1.0000000
A02	21764971	21765292	A02p35130.2_BraZ1	32.1	+	12	254	321	0.7912772
A02	21775237	21775883	A02p35140.2_BraZ1	372	+	93	407	646	0.6300309
A02	21780434	21780716	A02p35150.2_BraZ1	19.8	+	25	182	282	0.6453901
A02	21804772	21805344	A02p35160.2_BraZ1	122	+	276	478	572	0.8356643
A02	21826899	21829477	A02p35170.2_BraZ1	1581	+	43	647	2578	0.2509697
A02	21832861	21833818	A02p35180.2_BraZ1	846	-	17	120	957	0.1253919
A02	21841157	21842786	A02p35190.2_BraZ1	518.457	-	44	490	1629	0.3007980
A02	21847556	21848257	A02p35200.2_BraZ1	189	-	380	701	701	1.0000000
A02	21860241	21860982	A02p35210.2_BraZ1	420	+	19	372	741	0.5020243
A02	21864129	21864501	A02p35220.2_BraZ1	37.2	-	4	156	372	0.4193548
A02	21867392	21867849	A02p35230.2_BraZ1	369	+	639	457	457	1.0000000
A02	21868101	21874456	A02p35240.2_BraZ1	451.786	+	2633	3726	6355	0.5863100
A02	21869087	21869438	A02p35250.2_BraZ1	711	+	127	299	351	0.8518519
A02	21876414	21878321	A02p35260.2_BraZ1	7084	+	204	932	1907	0.4887258
A02	21895179	21905213	A02p35270.2_BraZ1	1426.07	-	620	4765	10034	0.4748854
A02	21910917	21911254	A02p35280.2_BraZ1	159	+	0	0	337	0.0000000
A02	21912622	21913095	A02p35290.2_BraZ1	342	+	0	0	473	0.0000000
A02	21925755	21926037	A02p35300.2_BraZ1	28.2	-	13	117	282	0.4148936
A02	21931025	21932515	A02p35310.2_BraZ1	1239.12	-	41	675	1490	0.4530201
A02	21948161	21950063	A02p35320.2_BraZ1	17130	-	132	1020	1902	0.5362776
A02	21958476	21961756	A02p35330.2_BraZ1	1893.83	+	580	2910	3280	0.8871951
A02	21966325	21966630	A02p35340.2_BraZ1	26.1	-	112	305	305	1.0000000
A02	21968674	21971737	A02p35350.2_BraZ1	1261	+	564	2423	3063	0.7910545
A02	21973206	21973587	A02p35360.2_BraZ1	38.1	-	125	381	381	1.0000000
A02	21973832	21977220	A02p35370.2_BraZ1	687.479	-	109	1273	3388	0.3757379
A02	21977244	21977863	A02p35380.2_BraZ1	156.176	-	149	159	619	0.2568659
A02	21992259	21993801	A02p35390.2_BraZ1	727.154	+	144	753	1542	0.4883268
A02	21995268	21996459	A02p35400.2_BraZ1	378.3	+	83	645	1191	0.5415617
A02	22011104	22013724	A02p35410.2_BraZ1	974.094	+	205	1803	2620	0.6881679
A02	22025788	22026023	A02p35420.2_BraZ1	12	+	154	235	235	1.0000000
A02	22027726	22029830	A02p35430.2_BraZ1	19355	-	365	1944	2104	0.9239544
A02	22032186	22032640	A02p35440.2_BraZ1	171	-	268	454	454	1.0000000
A02	22036510	22043577	A02p35450.2_BraZ1	402	+	929	4073	7067	0.5763407
A02	22054349	22054541	A02p35460.2_BraZ1	19.2	+	310	192	192	1.0000000
A02	22063766	22065100	A02p35470.2_BraZ1	2220	-	998	1248	1334	0.9355322
A02	22068790	22071416	A02p35480.2_BraZ1	1078	+	1002	2211	2626	0.8419650
A02	22078210	22078792	A02p35490.2_BraZ1	58.2	+	5	101	582	0.1735395
A02	22084125	22084497	A02p35500.2_BraZ1	37.2	-	1	38	372	0.1021505
A02	22085923	22088186	A02p35510.2_BraZ1	7079.4	-	647	1742	2263	0.7697746
A02	22093033	22094516	A02p35520.2_BraZ1	624	+	308	1316	1483	0.8873904
A02	22100684	22101220	A02p35530.2_BraZ1	279	-	0	0	536	0.0000000
A02	22101195	22101384	A02p35540.2_BraZ1	150	-	0	0	189	0.0000000
A02	22102330	22102753	A02p35550.2_BraZ1	42.3	-	0	0	423	0.0000000
A02	22107451	22109128	A02p35560.2_BraZ1	906.3	+	300	1479	1677	0.8819320
A02	22115238	22115935	A02p35570.2_BraZ1	357.469	-	48	387	697	0.5552368
A02	22116642	22117266	A02p35580.2_BraZ1	595	+	966	624	624	1.0000000
A02	22119220	22120426	A02p35590.2_BraZ1	762	-	328	1006	1206	0.8341625
A02	22134455	22136042	A02p35600.2_BraZ1	158.7	+	251	1556	1587	0.9804663
A02	22137796	22138438	A02p35610.2_BraZ1	540	+	356	642	642	1.0000000
A02	22138554	22138879	A02p35620.2_BraZ1	29.4	-	367	325	325	1.0000000
A02	22139895	22141368	A02p35630.2_BraZ1	63697.5	-	119	1320	1473	0.8961303
A02	22170039	22171834	A02p35640.2_BraZ1	1107	+	266	1361	1795	0.7582173
A02	22174099	22174626	A02p35650.2_BraZ1	186	+	14	268	527	0.5085389
A02	22182743	22183599	A02p35660.2_BraZ1	516	-	79	577	856	0.6740654
A02	22183599	22193177	A02p35670.2_BraZ1	872.727	-	5994	8560	9578	0.8937148
A02	22190641	22191127	A02p35680.2_BraZ1	48.6	+	1013	486	486	1.0000000
A02	22207285	22207864	A02p35690.2_BraZ1	54.9	+	45	186	579	0.3212435
A02	22208842	22210881	A02p35700.2_BraZ1	330.6	+	2355	2039	2039	1.0000000
A02	22213312	22213621	A02p35710.2_BraZ1	28.5	-	228	309	309	1.0000000
A02	22219946	22220297	A02p35720.2_BraZ1	35.1	-	235	351	351	1.0000000
A02	22221013	22224158	A02p35730.2_BraZ1	583.432	-	1393	2464	3145	0.7834658
A02	22230780	22233665	A02p35740.2_BraZ1	2592	-	2876	2694	2885	0.9337955
A02	22258617	22261416	A02p35750.2_BraZ1	1348.5	+	3306	2799	2799	1.0000000
A02	22264669	22264855	A02p35760.2_BraZ1	18.6	-	639	186	186	1.0000000
A02	22270917	22273253	A02p35770.2_BraZ1	634.917	-	1258	2275	2336	0.9738870
A02	22273451	22273820	A02p35780.2_BraZ1	47.04	+	337	369	369	1.0000000
A02	22273986	22279924	A02p35790.2_BraZ1	310.333	+	2775	5865	5938	0.9877063
A02	22280443	22281442	A02p35800.2_BraZ1	99.9	+	14	228	999	0.2282282
A02	22287776	22288188	A02p35810.2_BraZ1	342	+	2241	412	412	1.0000000
A02	22291351	22305634	A02p35820.2_BraZ1	2482.09	-	4530	10808	14283	0.7567038
A02	22307879	22311684	A02p35830.2_BraZ1	3732	-	596	2990	3805	0.7858081
A02	22316374	22317189	A02p35840.2_BraZ1	6180	+	80	611	815	0.7496933
A02	22317617	22318568	A02p35850.2_BraZ1	95.1	-	8	103	951	0.1083070
A02	22321673	22323874	A02p35860.2_BraZ1	288	-	7874	2201	2201	1.0000000
A02	22339202	22339644	A02p35870.2_BraZ1	258	+	566	442	442	1.0000000
A02	22341657	22342878	A02p35880.2_BraZ1	3120	-	302	995	1221	0.8149058
A02	22346046	22347073	A02p35890.2_BraZ1	261	-	123	765	1027	0.7448880
A02	22360455	22361406	A02p35900.2_BraZ1	95.1	-	0	0	951	0.0000000
A02	22367834	22368159	A02p35910.2_BraZ1	216	-	580	325	325	1.0000000
A02	22377922	22390059	A02p35920.2_BraZ1	180	+	11752	11774	12137	0.9700915
A02	22391041	22393307	A02p35930.2_BraZ1	1648.38	+	5343	2266	2266	1.0000000
A02	22394651	22395324	A02p35940.2_BraZ1	315	+	4113	673	673	1.0000000
A02	22396556	22397029	A02p35950.2_BraZ1	41.1	+	4489	473	473	1.0000000
A02	22399652	22400295	A02p35960.2_BraZ1	59.7	-	4645	643	643	1.0000000
A02	22401164	22405597	A02p35970.2_BraZ1	1057.09	+	26664	4433	4433	1.0000000
A02	22405469	22408653	A02p35980.2_BraZ1	863.791	+	15493	3184	3184	1.0000000
A02	22424779	22428424	A02p35990.2_BraZ1	1376	+	404	2617	3645	0.7179698
A02	22432835	22433460	A02p36000.2_BraZ1	444.5	-	540	625	625	1.0000000
A02	22434576	22437673	A02p36010.2_BraZ1	10020	+	83	548	3097	0.1769454
A02	22453708	22454167	A02p36020.2_BraZ1	360	-	5	130	459	0.2832244
A02	22460253	22461522	A02p36030.2_BraZ1	597.882	-	307	1194	1269	0.9408984
A02	22463076	22463625	A02p36040.2_BraZ1	54.9	-	281	542	549	0.9872496
A02	22464698	22465003	A02p36050.2_BraZ1	228	-	45	305	305	1.0000000
A02	22486886	22488193	A02p36060.2_BraZ1	896.5	+	183	1057	1307	0.8087223
A02	22489015	22490041	A02p36070.2_BraZ1	507.5	-	17	388	1026	0.3781676
A02	22491183	22494327	A02p36080.2_BraZ1	3009	-	1060	2833	3144	0.9010814
A02	22496436	22497284	A02p36090.2_BraZ1	1002.67	-	11	268	848	0.3160377
A02	22507568	22508255	A02p36100.2_BraZ1	399	-	408	687	687	1.0000000
A02	22508306	22508624	A02p36110.2_BraZ1	192	-	200	318	318	1.0000000
A02	22514923	22515802	A02p36120.2_BraZ1	390	-	156	729	879	0.8293515
A02	22523779	22525956	A02p36130.2_BraZ1	501	+	2372	2177	2177	1.0000000
A02	22546665	22547636	A02p36140.2_BraZ1	891	+	87	625	971	0.6436663
A02	22556321	22557526	A02p36150.2_BraZ1	411.667	+	682	1205	1205	1.0000000
A02	22560735	22562373	A02p36160.2_BraZ1	806.727	-	1085	1510	1638	0.9218559
A02	22579957	22581534	A02p36170.2_BraZ1	1506	+	763	1577	1577	1.0000000
A02	22582335	22584721	A02p36180.2_BraZ1	1534.5	-	873	2243	2386	0.9400671
A02	22587144	22588160	A02p36190.2_BraZ1	279	+	1606	1016	1016	1.0000000
A02	22592841	22628792	A02p36200.2_BraZ1	11492.7	+	15380	25888	35951	0.7200912
A02	22599255	22604802	A02p36210.2_BraZ1	13794	-	2876	3632	5547	0.6547683
A02	22630265	22630430	A02p36220.2_BraZ1	16.5	-	535	165	165	1.0000000
A02	22646380	22648803	A02p36230.2_BraZ1	552	+	1985	2423	2423	1.0000000
A02	22648787	22650468	A02p36240.2_BraZ1	370.5	+	372	1560	1681	0.9280190
A02	22663829	22674880	A02p36250.2_BraZ1	28908.8	-	11234	11051	11051	1.0000000
A02	22689146	22689514	A02p36260.2_BraZ1	213	-	15	279	368	0.7581522
A02	22689719	22690820	A02p36270.2_BraZ1	501.75	-	982	1101	1101	1.0000000
A02	22690820	22691033	A02p36280.2_BraZ1	21.3	+	571	213	213	1.0000000
A02	22695689	22707457	A02p36290.2_BraZ1	12746.8	+	5540	10660	11768	0.9058464
A02	22708692	22711689	A02p36300.2_BraZ1	4680	-	1290	2531	2997	0.8445112
A02	22712868	22716049	A02p36310.2_BraZ1	9421.5	-	639	2433	3181	0.7648538
A02	22734535	22737244	A02p36320.2_BraZ1	1096.81	+	99	1523	2709	0.5622001
A02	22752115	22755201	A02p36330.2_BraZ1	1946.08	+	718	2753	3086	0.8920933
A02	22756336	22757015	A02p36340.2_BraZ1	600	-	17	43	679	0.0633284
A02	22757693	22759997	A02p36350.2_BraZ1	1486.37	-	609	2135	2304	0.9266493
A02	22769564	22771446	A02p36360.2_BraZ1	1390.39	-	47	905	1882	0.4808714
A02	22772940	22774665	A02p36370.2_BraZ1	430	+	1575	1725	1725	1.0000000
A02	22775088	22776498	A02p36380.2_BraZ1	102.3	-	1264	1410	1410	1.0000000
A02	22778263	22778419	A02p36390.2_BraZ1	15.6	+	76	156	156	1.0000000
A02	22778492	22779193	A02p36400.2_BraZ1	53.7	+	401	701	701	1.0000000
A02	22791102	22791546	A02p36410.2_BraZ1	44.4	-	436	444	444	1.0000000
A02	22819609	22825513	A02p36420.2_BraZ1	1826.77	+	1017	2821	5904	0.4778117
A02	22829637	22829898	A02p36430.2_BraZ1	26.1	+	47	204	261	0.7816092
A02	22832418	22834913	A02p36440.2_BraZ1	2412	+	601	1777	2495	0.7122244
A02	22835286	22836458	A02p36450.2_BraZ1	1038	-	364	1137	1172	0.9701365
A02	22840744	22841175	A02p36460.2_BraZ1	351	-	404	431	431	1.0000000
A02	22843002	22843754	A02p36470.2_BraZ1	351	-	1180	752	752	1.0000000
A02	22858265	22858844	A02p36480.2_BraZ1	57.9	+	1072	579	579	1.0000000
A02	22861304	22862119	A02p36490.2_BraZ1	40.8	+	655	815	815	1.0000000
A02	22865061	22868679	A02p36500.2_BraZ1	808.286	+	1629	3375	3618	0.9328358
A02	22871323	22871851	A02p36510.2_BraZ1	52.8	-	104	457	528	0.8655303
A02	22873647	22874928	A02p36520.2_BraZ1	350	+	461	1242	1281	0.9695550
A02	22876316	22876720	A02p36530.2_BraZ1	324	-	196	404	404	1.0000000
A02	22884076	22890069	A02p36540.2_BraZ1	3236.53	-	752	3387	5993	0.5651594
A02	22895238	22896357	A02p36550.2_BraZ1	111.9	+	536	590	1119	0.5272565
A02	22896862	22899058	A02p36560.2_BraZ1	219.6	-	342	1643	2196	0.7481785
A02	22912073	22915806	A02p36570.2_BraZ1	2830.09	+	2532	3207	3733	0.8590946
A02	22926686	22928993	A02p36580.2_BraZ1	1013.57	-	961	2097	2307	0.9089727
A02	22935089	22935974	A02p36590.2_BraZ1	408	+	570	885	885	1.0000000
A02	22952472	22952799	A02p36600.2_BraZ1	32.7	+	252	327	327	1.0000000
A02	22962392	22963209	A02p36610.2_BraZ1	369	-	594	817	817	1.0000000
A02	22966860	22967735	A02p36620.2_BraZ1	651	+	225	856	875	0.9782857
A02	22979778	22980509	A02p36630.2_BraZ1	375	-	24	339	731	0.4637483
A02	22981047	22981217	A02p36640.2_BraZ1	12	+	245	170	170	1.0000000
A02	22991889	22992692	A02p36650.2_BraZ1	231	-	198	800	803	0.9962640
A02	22993317	22993822	A02p36660.2_BraZ1	351	-	10	135	505	0.2673267
A02	23000076	23000587	A02p36670.2_BraZ1	351	-	26	343	511	0.6712329
A02	23010686	23017412	A02p36680.2_BraZ1	5213.6	-	5159	6633	6726	0.9861730
A02	23018138	23018807	A02p36690.2_BraZ1	66.9	+	149	669	669	1.0000000
A02	23020706	23022110	A02p36700.2_BraZ1	130.8	-	104	648	1404	0.4615385
A02	23024172	23024456	A02p36710.2_BraZ1	207	+	425	284	284	1.0000000
A02	23032754	23035931	A02p36720.2_BraZ1	1951.91	-	80	820	3177	0.2581051
A02	23042358	23043756	A02p36730.2_BraZ1	1314	-	129	779	1398	0.5572246
A02	23064665	23065325	A02p36740.2_BraZ1	66	-	310	568	660	0.8606061
A02	23078750	23080033	A02p36750.2_BraZ1	525	-	85	880	1283	0.6858925
A02	23095367	23097411	A02p36760.2_BraZ1	1041	+	75	919	2044	0.4496086
A02	23104926	23108077	A02p36770.2_BraZ1	1970.26	+	1709	3134	3151	0.9946049
A02	23113347	23114805	A02p36780.2_BraZ1	1207.28	+	268	1165	1458	0.7990398
A02	23114892	23115780	A02p36790.2_BraZ1	602.571	-	560	835	888	0.9403153
A02	23134346	23137528	A02p36800.2_BraZ1	1012.98	+	755	2579	3182	0.8104966
A02	23155866	23160094	A02p36810.2_BraZ1	1101.14	-	1734	3847	4228	0.9098865
A02	23170773	23173464	A02p36820.2_BraZ1	266.036	-	2248	2691	2691	1.0000000
A02	23180275	23180592	A02p36830.2_BraZ1	246	+	762	317	317	1.0000000
A02	23193660	23195867	A02p36840.2_BraZ1	562.714	+	1046	1828	2207	0.8282737
A02	23199315	23199570	A02p36850.2_BraZ1	117	-	293	255	255	1.0000000
A02	23202490	23203219	A02p36860.2_BraZ1	1725	+	998	729	729	1.0000000
A02	23221017	23221194	A02p36870.2_BraZ1	17.7	+	32	177	177	1.0000000
A02	23235998	23237737	A02p36880.2_BraZ1	563.515	+	2562	1739	1739	1.0000000
A02	23246658	23246928	A02p36890.2_BraZ1	27	-	669	270	270	1.0000000
A02	23250341	23251833	A02p36900.2_BraZ1	941.114	+	246	985	1492	0.6601877
A02	23262888	23264463	A02p36910.2_BraZ1	157.5	+	318	1492	1575	0.9473016
A02	23271529	23272924	A02p36920.2_BraZ1	501.213	-	965	1390	1395	0.9964158
A02	23282827	23283481	A02p36930.2_BraZ1	378	+	239	654	654	1.0000000
A02	23283656	23286850	A02p36940.2_BraZ1	1758	-	1193	2739	3194	0.8575454
A02	23293315	23293755	A02p36950.2_BraZ1	24.3	-	534	440	440	1.0000000
A02	23297112	23300292	A02p36960.2_BraZ1	1023.75	-	2174	3180	3180	1.0000000
A02	23301257	23301452	A02p36970.2_BraZ1	19.5	+	245	195	195	1.0000000
A02	23304140	23304436	A02p36980.2_BraZ1	945	-	268	296	296	1.0000000
A02	23310583	23313626	A02p36990.2_BraZ1	5533	-	2204	3043	3043	1.0000000
A02	23321167	23322051	A02p37000.2_BraZ1	741	+	234	713	884	0.8065611
A02	23349830	23350288	A02p37010.2_BraZ1	65.6	-	585	458	458	1.0000000
A02	23350288	23351266	A02p37020.2_BraZ1	280	-	982	978	978	1.0000000
A02	23354012	23354670	A02p37030.2_BraZ1	387	-	267	658	658	1.0000000
A02	23355178	23355529	A02p37040.2_BraZ1	24.6	-	106	351	351	1.0000000
A02	23359920	23363759	A02p37050.2_BraZ1	1007.22	+	1146	3096	3839	0.8064600
A02	23377378	23377501	A02p37060.2_BraZ1	12.3	-	89	123	123	1.0000000
A02	23404577	23405867	A02p37070.2_BraZ1	129	+	2264	1290	1290	1.0000000
A02	23411388	23411628	A02p37080.2_BraZ1	24	-	33	126	240	0.5250000
A02	23420051	23421167	A02p37090.2_BraZ1	111.6	-	234	1078	1116	0.9659498
A02	23431309	23432968	A02p37100.2_BraZ1	853.125	-	67	503	1659	0.3031947
A02	23432994	23433564	A02p37110.2_BraZ1	156.75	-	38	387	570	0.6789474
A02	23446136	23451046	A02p37120.2_BraZ1	2249.21	-	914	3004	4910	0.6118127
A02	23456788	23459823	A02p37130.2_BraZ1	1309.24	+	1757	3026	3035	0.9970346
A02	23462235	23462797	A02p37140.2_BraZ1	306	+	741	562	562	1.0000000
A02	23465753	23466179	A02p37150.2_BraZ1	42.6	-	540	426	426	1.0000000
A02	23467616	23471115	A02p37160.2_BraZ1	2144.02	-	2187	3499	3499	1.0000000
A02	23485149	23487601	A02p37170.2_BraZ1	1238.15	-	1041	2404	2452	0.9804242
A02	23490368	23490865	A02p37180.2_BraZ1	192	-	674	410	497	0.8249497
A02	23503033	23503361	A02p37190.2_BraZ1	252	+	7	163	328	0.4969512
A02	23507670	23508008	A02p37200.2_BraZ1	294	-	307	338	338	1.0000000
A02	23519915	23520265	A02p37210.2_BraZ1	34.5	+	3	220	350	0.6285715
A02	23526974	23530624	A02p37220.2_BraZ1	1759.8	+	403	2536	3650	0.6947945
A02	23530979	23542879	A02p37230.2_BraZ1	450	+	1996	6334	11900	0.5322689
A02	23532605	23534153	A02p37240.2_BraZ1	1065	+	89	1063	1548	0.6866925
A02	23536025	23539231	A02p37250.2_BraZ1	95	-	76	961	3206	0.2997505
A02	23536292	23540599	A02p37260.2_BraZ1	2370	+	86	1126	4307	0.2614349
A02	23536411	23537334	A02p37270.2_BraZ1	675	+	2	278	923	0.3011918
A02	23542247	23542530	A02p37280.2_BraZ1	174	-	153	283	283	1.0000000
A02	23556006	23558344	A02p37290.2_BraZ1	954	-	975	2005	2338	0.8575706
A02	23562568	23562796	A02p37300.2_BraZ1	21.9	-	0	0	228	0.0000000
A02	23562929	23565492	A02p37310.2_BraZ1	1811.73	+	44	430	2563	0.1677721
A02	23566035	23566625	A02p37320.2_BraZ1	45.1636	+	41	453	590	0.7677966
A02	23568362	23568787	A02p37330.2_BraZ1	23.4	-	73	425	425	1.0000000
A02	23568931	23569465	A02p37340.2_BraZ1	53.4	-	1429	534	534	1.0000000
A02	23578849	23580731	A02p37350.2_BraZ1	648.207	-	1961	1882	1882	1.0000000
A02	23581878	23584789	A02p37360.2_BraZ1	270	+	2815	2911	2911	1.0000000
A02	23591973	23596330	A02p37370.2_BraZ1	6953.57	+	1386	4194	4357	0.9625890
A02	23600049	23600609	A02p37380.2_BraZ1	210	-	0	0	560	0.0000000
A02	23601540	23603768	A02p37390.2_BraZ1	1017.5	+	1870	2142	2228	0.9614003
A02	23606896	23613855	A02p37400.2_BraZ1	6441.43	+	6202	6448	6959	0.9265699
A02	23616208	23616610	A02p37410.2_BraZ1	228	-	463	402	402	1.0000000
A02	23620284	23624510	A02p37420.2_BraZ1	3298.64	+	1339	3652	4226	0.8641742
A02	23631562	23635801	A02p37430.2_BraZ1	490.286	+	2482	3427	4239	0.8084454
A02	23639072	23643349	A02p37440.2_BraZ1	3565.62	+	1085	3029	4277	0.7082067
A02	23644019	23645032	A02p37450.2_BraZ1	466.476	+	1060	968	1013	0.9555775
A02	23653518	23656298	A02p37460.2_BraZ1	457.158	+	949	2670	2780	0.9604316
A02	23658789	23658921	A02p37470.2_BraZ1	13.2	-	8	132	132	1.0000000
A02	23659697	23660248	A02p37480.2_BraZ1	186	-	503	551	551	1.0000000
A02	23662627	23664247	A02p37490.2_BraZ1	918	-	1660	1082	1620	0.6679012
A02	23665743	23666495	A02p37500.2_BraZ1	668.5	-	18	107	752	0.1422872
A02	23667769	23668284	A02p37510.2_BraZ1	243	-	379	515	515	1.0000000
A02	23669122	23671410	A02p37520.2_BraZ1	1502.13	-	758	1880	2288	0.8216783
A02	23672841	23672961	A02p37530.2_BraZ1	12	-	189	120	120	1.0000000
A02	23677632	23677773	A02p37540.2_BraZ1	14.1	-	15	73	141	0.5177305
A02	23683133	23684263	A02p37550.2_BraZ1	917.778	+	108	518	1130	0.4584071
A02	23685347	23686473	A02p37560.2_BraZ1	168.188	+	203	1106	1126	0.9822380
A02	23690033	23691424	A02p37570.2_BraZ1	588.06	+	20	611	1391	0.4392523
A02	23698808	23702498	A02p37580.2_BraZ1	1501.28	-	1785	2723	3690	0.7379404
A02	23710011	23710218	A02p37590.2_BraZ1	20.7	+	10	173	207	0.8357488
A02	23718876	23720078	A02p37600.2_BraZ1	444	-	500	1202	1202	1.0000000
A02	23723170	23723698	A02p37610.2_BraZ1	52.8	+	389	528	528	1.0000000
A02	23724285	23725514	A02p37620.2_BraZ1	604.333	-	525	1229	1229	1.0000000
A02	23725941	23728345	A02p37630.2_BraZ1	1269.5	+	927	2345	2404	0.9754575
A02	23734967	23736365	A02p37640.2_BraZ1	139.8	+	1093	1398	1398	1.0000000
A02	23740528	23742044	A02p37650.2_BraZ1	810	+	759	1516	1516	1.0000000
A02	23742914	23744168	A02p37660.2_BraZ1	602	-	1066	1254	1254	1.0000000
A02	23745715	23747212	A02p37670.2_BraZ1	738	+	700	1495	1497	0.9986640
A02	23752162	23753989	A02p37680.2_BraZ1	852.088	-	14	284	1827	0.1554461
A02	23762279	23763547	A02p37690.2_BraZ1	659.333	+	801	1268	1268	1.0000000
A02	23770006	23771725	A02p37700.2_BraZ1	171.9	-	169	1196	1719	0.6957533
A02	23772258	23772668	A02p37710.2_BraZ1	264	+	0	0	410	0.0000000
A02	23783778	23786758	A02p37720.2_BraZ1	2044.77	-	884	2859	2980	0.9593959
A02	23787685	23788250	A02p37730.2_BraZ1	213	+	528	565	565	1.0000000
A02	23799684	23800092	A02p37740.2_BraZ1	40.8	+	105	363	408	0.8897059
A02	23800432	23800534	A02p37750.2_BraZ1	10.2	-	233	102	102	1.0000000
A02	23803789	23804702	A02p37760.2_BraZ1	783	+	148	802	913	0.8784228
A02	23807675	23808744	A02p37770.2_BraZ1	565.926	-	265	879	1069	0.8222638
A02	23809901	23810881	A02p37780.2_BraZ1	903	-	113	747	980	0.7622449
A02	23811598	23812841	A02p37790.2_BraZ1	284.062	+	780	1075	1243	0.8648431
A02	23816695	23818519	A02p37800.2_BraZ1	775.091	+	276	1451	1824	0.7955044
A02	23822052	23825978	A02p37810.2_BraZ1	3267.6	+	717	2917	3926	0.7429954
A02	23839489	23862958	A02p37820.2_BraZ1	1974.61	+	13766	23091	23469	0.9838936
A02	23863426	23863657	A02p37830.2_BraZ1	23.1	-	184	231	231	1.0000000
A02	23869531	23869825	A02p37840.2_BraZ1	29.4	-	4	163	294	0.5544218
A02	23874923	23875237	A02p37850.2_BraZ1	144	+	228	259	314	0.8248408
A02	23875735	23875870	A02p37860.2_BraZ1	13.5	+	50	135	135	1.0000000
A02	23883074	23900937	A02p37870.2_BraZ1	13720.7	-	5298	12794	17863	0.7162291
A02	23913913	23914709	A02p37880.2_BraZ1	507	+	381	796	796	1.0000000
A02	23915511	23927163	A02p37890.2_BraZ1	6835.5	-	6293	8666	11652	0.7437350
A02	23942432	23943761	A02p37900.2_BraZ1	648.771	-	334	880	1329	0.6621520
A02	23945879	23947501	A02p37910.2_BraZ1	787.786	-	1317	1586	1622	0.9778052
A02	23957533	23958154	A02p37920.2_BraZ1	62.1	-	22	43	621	0.0692432
A02	23963962	23964667	A02p37930.2_BraZ1	70.5	+	2	16	705	0.0226950
A02	23977976	23983496	A02p37940.2_BraZ1	959.811	-	624	4203	5520	0.7614130
A02	23985768	23985951	A02p37950.2_BraZ1	18.3	-	178	183	183	1.0000000
A02	23986567	23989836	A02p37960.2_BraZ1	2009.26	+	1362	3162	3269	0.9672683
A02	23991680	23991894	A02p37970.2_BraZ1	10.8	-	437	214	214	1.0000000
A02	23993221	23993564	A02p37980.2_BraZ1	195	+	87	343	343	1.0000000
A02	23997982	23998231	A02p37990.2_BraZ1	24.9	+	204	249	249	1.0000000
A02	23999989	24000344	A02p38000.2_BraZ1	276	+	248	355	355	1.0000000
A02	24000813	24001350	A02p38010.2_BraZ1	53.7	-	22	334	537	0.6219739
A02	24007885	24008928	A02p38020.2_BraZ1	993	-	76	466	1043	0.4467881
A02	24008928	24009681	A02p38030.2_BraZ1	75.3	-	33	423	753	0.5617530
A02	24021702	24022247	A02p38040.2_BraZ1	486	+	279	525	545	0.9633027
A02	24027854	24028705	A02p38050.2_BraZ1	687	+	544	851	851	1.0000000
A02	24034865	24035680	A02p38060.2_BraZ1	655.875	+	128	772	815	0.9472393
A02	24038024	24039217	A02p38070.2_BraZ1	4272	-	386	1071	1193	0.8977368
A02	24044272	24044800	A02p38080.2_BraZ1	52.8	-	46	528	528	1.0000000
A02	24068565	24069509	A02p38090.2_BraZ1	1482	+	261	787	944	0.8336864
A02	24076053	24076792	A02p38100.2_BraZ1	462	+	30	479	739	0.6481732
A02	24081793	24083233	A02p38110.2_BraZ1	1019.67	+	356	1346	1440	0.9347222
A02	24084350	24087496	A02p38120.2_BraZ1	534	-	492	2125	3146	0.6754609
A02	24088219	24088348	A02p38130.2_BraZ1	12.9	-	0	0	129	0.0000000
A02	24089623	24090151	A02p38140.2_BraZ1	52.8	-	1	129	528	0.2443182
A02	24092297	24092825	A02p38150.2_BraZ1	52.8	-	55	528	528	1.0000000
A02	24093542	24093671	A02p38160.2_BraZ1	12.9	-	3	129	129	1.0000000
A02	24094963	24095486	A02p38170.2_BraZ1	510	-	64	523	523	1.0000000
A02	24108522	24109098	A02p38180.2_BraZ1	57.6	-	88	253	576	0.4392361
A02	24114899	24116508	A02p38190.2_BraZ1	216	+	1129	1609	1609	1.0000000
A02	24115317	24116429	A02p38200.2_BraZ1	110.7	+	710	1112	1112	1.0000000
A02	24141284	24141656	A02p38210.2_BraZ1	37.2	-	0	0	372	0.0000000
A02	24143459	24145669	A02p38220.2_BraZ1	720	-	2711	1900	2210	0.8597285
A02	24146227	24147223	A02p38230.2_BraZ1	99.6	-	109	443	996	0.4447791
A02	24152089	24159078	A02p38240.2_BraZ1	3061.02	+	2103	6230	6989	0.8914008
A02	24161877	24163176	A02p38250.2_BraZ1	9648	+	822	1251	1299	0.9630485
A02	24180521	24181672	A02p38260.2_BraZ1	729.444	+	277	1052	1151	0.9139878
A02	24189144	24189597	A02p38270.2_BraZ1	336	-	611	453	453	1.0000000
A02	24192812	24195617	A02p38280.2_BraZ1	2023.54	-	441	1944	2805	0.6930481
A02	24212680	24213079	A02p38290.2_BraZ1	285	-	437	399	399	1.0000000
A02	24214916	24215444	A02p38300.2_BraZ1	52.8	+	674	528	528	1.0000000
A02	24263744	24264417	A02p38310.2_BraZ1	549	+	449	673	673	1.0000000
A02	24265193	24266790	A02p38320.2_BraZ1	1070.91	-	1193	1597	1597	1.0000000
A02	24267361	24267683	A02p38330.2_BraZ1	222	-	54	322	322	1.0000000
A02	24279188	24279519	A02p38340.2_BraZ1	231	-	56	267	331	0.8066465
A02	24283688	24364885	A02p38350.2_BraZ1	1121.52	-	44210	73051	81197	0.8996761
A02	24286127	24287362	A02p38360.2_BraZ1	596.531	-	258	995	1235	0.8056680
A02	24326602	24333145	A02p38370.2_BraZ1	1603.8	+	5121	6490	6543	0.9918997
A02	24340751	24342464	A02p38380.2_BraZ1	628.898	-	698	1607	1713	0.9381202
A02	24348858	24349188	A02p38390.2_BraZ1	231	+	34	248	330	0.7515152
A02	24353677	24354269	A02p38400.2_BraZ1	423	+	454	592	592	1.0000000
A02	24361262	24363195	A02p38410.2_BraZ1	1049.91	+	1300	1933	1933	1.0000000
A02	24367078	24368433	A02p38420.2_BraZ1	633.463	+	744	1355	1355	1.0000000
A02	24368758	24368869	A02p38430.2_BraZ1	11.1	+	142	111	111	1.0000000
A02	24372863	24375705	A02p38440.2_BraZ1	1224.89	+	1432	2697	2842	0.9489796
A02	24376806	24377928	A02p38450.2_BraZ1	112.2	+	165	908	1122	0.8092692
A02	24381868	24382621	A02p38460.2_BraZ1	75.3	+	242	611	753	0.8114210
A02	24384817	24387480	A02p38470.2_BraZ1	549.164	-	1350	2641	2663	0.9917386
A02	24392413	24393699	A02p38480.2_BraZ1	586.01	+	596	1286	1286	1.0000000
A02	24394127	24396067	A02p38490.2_BraZ1	994.583	-	394	1879	1940	0.9685567
A02	24399306	24399999	A02p38500.2_BraZ1	69.3	-	14	204	693	0.2943723
A02	24410051	24411847	A02p38510.2_BraZ1	675.091	-	454	1718	1796	0.9565701
A02	24416520	24417230	A02p38520.2_BraZ1	180	+	435	710	710	1.0000000
A02	24421185	24421579	A02p38530.2_BraZ1	252	+	49	128	394	0.3248731
A02	24423129	24424687	A02p38540.2_BraZ1	620.1	-	298	1127	1558	0.7233633
A02	24432252	24433542	A02p38550.2_BraZ1	165	+	0	0	1290	0.0000000
A02	24432420	24432736	A02p38560.2_BraZ1	150	+	0	0	316	0.0000000
A02	24442955	24443138	A02p38570.2_BraZ1	18.3	+	0	0	183	0.0000000
A02	24443991	24444545	A02p38580.2_BraZ1	339	+	0	0	554	0.0000000
A02	24447537	24447795	A02p38590.2_BraZ1	192	+	0	0	258	0.0000000
A02	24449675	24451640	A02p38600.2_BraZ1	318	+	451	1122	1965	0.5709924
A02	24453377	24454456	A02p38610.2_BraZ1	690	-	916	1079	1079	1.0000000
A02	24464044	24464511	A02p38620.2_BraZ1	672	+	1	20	467	0.0428266
A02	24464567	24464891	A02p38630.2_BraZ1	32.4	+	2	51	324	0.1574074
A02	24466203	24477723	A02p38640.2_BraZ1	686.7	+	500	2911	11520	0.2526910
A02	24478951	24479925	A02p38650.2_BraZ1	182.864	+	17	127	974	0.1303901
A02	24488309	24489574	A02p38660.2_BraZ1	552	+	22	325	1265	0.2569170
A02	24490991	24503038	A02p38670.2_BraZ1	341	+	955	6914	12047	0.5739188
A02	24509177	24509768	A02p38680.2_BraZ1	150	-	149	591	591	1.0000000
A02	24509301	24509768	A02p38690.2_BraZ1	36.3	-	131	467	467	1.0000000
A02	24510252	24528817	A02p38700.2_BraZ1	237	+	7891	10269	18565	0.5531376
A02	24516619	24548237	A02p38710.2_BraZ1	580	+	13208	21733	31618	0.6873617
A02	24530412	24533142	A02p38720.2_BraZ1	396	+	721	1486	2730	0.5443224
A02	24549468	24550457	A02p38730.2_BraZ1	429	+	2	20	989	0.0202224
A02	24554889	24556033	A02p38740.2_BraZ1	552	+	7	276	1144	0.2412587
A02	24557537	24558747	A02p38750.2_BraZ1	1055.55	+	57	846	1210	0.6991736
A02	24571253	24572286	A02p38760.2_BraZ1	639	-	600	1019	1033	0.9864472
A02	24572793	24574059	A02p38770.2_BraZ1	71.7	+	240	985	1266	0.7780411
A02	24594976	24596305	A02p38780.2_BraZ1	984	+	469	1071	1329	0.8058691
A02	24597381	24599248	A02p38790.2_BraZ1	697.829	+	940	1801	1867	0.9646491
A02	24599523	24601616	A02p38800.2_BraZ1	1125	-	651	1891	2093	0.9034878
A02	24607689	24608814	A02p38810.2_BraZ1	112.5	+	884	1125	1125	1.0000000
A02	24623002	24626653	A02p38820.2_BraZ1	753	-	646	2381	3651	0.6521501
A02	24628924	24629312	A02p38830.2_BraZ1	315	+	289	388	388	1.0000000
A02	24630601	24632365	A02p38840.2_BraZ1	176.4	-	1732	1764	1764	1.0000000
A02	24632726	24634295	A02p38850.2_BraZ1	1017.39	+	288	1423	1569	0.9069471
A02	24635271	24636898	A02p38860.2_BraZ1	1039.5	-	139	1131	1627	0.6951444
A02	24640326	24641567	A02p38870.2_BraZ1	915.75	+	562	1187	1241	0.9564867
A02	24642025	24642777	A02p38880.2_BraZ1	666	-	74	632	752	0.8404256
A02	24645671	24647179	A02p38890.2_BraZ1	1213.21	+	286	1192	1508	0.7904509
A02	24647587	24654151	A02p38900.2_BraZ1	1353.09	-	4626	6496	6564	0.9896405
A02	24655264	24657940	A02p38910.2_BraZ1	9112	-	881	1988	2676	0.7428998
A02	24660946	24666431	A02p38920.2_BraZ1	885.712	-	2574	5336	5485	0.9728350
A02	24663322	24663856	A02p38930.2_BraZ1	53.4	-	132	451	534	0.8445693
A02	24671006	24671480	A02p38940.2_BraZ1	378	+	281	474	474	1.0000000
A02	24671697	24672462	A02p38950.2_BraZ1	309	-	870	765	765	1.0000000
A02	24672044	24672336	A02p38960.2_BraZ1	147	-	450	292	292	1.0000000
A02	24672757	24673318	A02p38970.2_BraZ1	56.1	+	625	561	561	1.0000000
A02	24673569	24675298	A02p38980.2_BraZ1	984.949	-	1297	1729	1729	1.0000000
A02	24676007	24677637	A02p38990.2_BraZ1	1164	+	309	1319	1630	0.8092024
A02	24677969	24679865	A02p39000.2_BraZ1	615	+	1035	1896	1896	1.0000000
A02	24682191	24693674	A02p39010.2_BraZ1	4537.02	+	3594	10275	11483	0.8948010
A02	24694084	24694940	A02p39020.2_BraZ1	381	+	125	290	856	0.3387851
A02	24697068	24698978	A02p39030.2_BraZ1	853.096	-	440	1542	1910	0.8073298
A02	24706433	24708624	A02p39040.2_BraZ1	765.313	+	405	1486	2191	0.6782291
A02	24715902	24716331	A02p39050.2_BraZ1	407.4	+	0	0	429	0.0000000
A02	24716826	24717084	A02p39060.2_BraZ1	171	+	0	0	258	0.0000000
A02	24720013	24720145	A02p39070.2_BraZ1	13.2	-	16	132	132	1.0000000
A02	24722779	24723427	A02p39080.2_BraZ1	279	+	903	648	648	1.0000000
A02	24724662	24726574	A02p39090.2_BraZ1	1118.56	+	365	1731	1912	0.9053347
A02	24729082	24730276	A02p39100.2_BraZ1	627	-	395	1080	1194	0.9045226
A02	24730708	24730861	A02p39110.2_BraZ1	14.7	-	523	153	153	1.0000000
A02	24733944	24734088	A02p39120.2_BraZ1	14.4	+	19	130	144	0.9027778
A02	24736006	24738044	A02p39130.2_BraZ1	721.558	+	577	1729	2038	0.8483807
A02	24738376	24739676	A02p39140.2_BraZ1	414.615	+	183	1104	1300	0.8492308
A02	24741474	24744856	A02p39150.2_BraZ1	2103.75	+	511	2575	3382	0.7613838
A02	24746094	24747384	A02p39160.2_BraZ1	165	+	0	0	1290	0.0000000
A02	24755293	24757345	A02p39170.2_BraZ1	812.734	-	1179	2050	2052	0.9990253
A02	24757502	24759013	A02p39180.2_BraZ1	679.889	+	1181	1511	1511	1.0000000
A02	24759755	24760907	A02p39190.2_BraZ1	795	+	327	1089	1152	0.9453125
A02	24761420	24766813	A02p39200.2_BraZ1	783	-	2016	4856	5393	0.9004265
A02	24767637	24768682	A02p39210.2_BraZ1	373.5	+	52	780	1045	0.7464115
A02	24767800	24768400	A02p39220.2_BraZ1	288	+	37	468	600	0.7800000
A02	24773525	24774337	A02p39230.2_BraZ1	341	+	230	677	812	0.8337439
A02	24775523	24778252	A02p39240.2_BraZ1	135.3	-	177	2293	2729	0.8402345
A02	24777654	24780417	A02p39250.2_BraZ1	142.8	-	286	2228	2763	0.8063699
A02	24780916	24786680	A02p39260.2_BraZ1	264.6	-	1280	5150	5764	0.8934767
A02	24788456	24789177	A02p39270.2_BraZ1	70.8	+	176	721	721	1.0000000
A02	24791650	24793150	A02p39280.2_BraZ1	12006	-	567	1500	1500	1.0000000
A02	24793256	24795226	A02p39290.2_BraZ1	210.955	+	737	1884	1970	0.9563452
A02	24804710	24806299	A02p39300.2_BraZ1	1170	-	494	1459	1589	0.9181876
A02	24816339	24817418	A02p39310.2_BraZ1	535.5	-	66	465	1079	0.4309546
A02	24817877	24818492	A02p39320.2_BraZ1	61.5	+	406	615	615	1.0000000
A02	24825183	24827463	A02p39330.2_BraZ1	1160.56	-	628	1810	2280	0.7938597
A02	24853364	24867787	A02p39340.2_BraZ1	816	+	3414	9467	14423	0.6563821
A02	24872738	24873878	A02p39350.2_BraZ1	494	+	468	1134	1140	0.9947369
A02	24879070	24880085	A02p39360.2_BraZ1	1397.33	+	74	565	1015	0.5566502
A02	24881288	24882204	A02p39370.2_BraZ1	119	+	100	866	916	0.9454148
A02	24886725	24886830	A02p39380.2_BraZ1	10.5	+	68	105	105	1.0000000
A02	24887225	24887976	A02p39390.2_BraZ1	330.412	+	64	632	751	0.8415446
A02	24893000	24894121	A02p39400.2_BraZ1	506.625	-	290	1107	1121	0.9875112
A02	24904955	24906262	A02p39410.2_BraZ1	708.497	-	332	1252	1307	0.9579189
A02	24911455	24911894	A02p39420.2_BraZ1	1716	-	123	439	439	1.0000000
A02	24916517	24918286	A02p39430.2_BraZ1	515.053	-	632	1768	1769	0.9994347
A02	24921926	24923900	A02p39440.2_BraZ1	1017.09	-	1079	1943	1974	0.9842958
A02	24930928	24933527	A02p39450.2_BraZ1	1182.53	+	1703	2541	2599	0.9776837
A02	24933906	24934923	A02p39460.2_BraZ1	757.44	-	354	978	1017	0.9616519
A02	24937240	24938044	A02p39470.2_BraZ1	80.4	-	322	804	804	1.0000000
A02	24939438	24939684	A02p39480.2_BraZ1	24.6	+	208	246	246	1.0000000
A02	24941169	24941628	A02p39490.2_BraZ1	45.9	-	125	459	459	1.0000000
A02	24944188	24947338	A02p39500.2_BraZ1	2147.07	-	1068	3002	3150	0.9530159
A02	24963020	24963969	A02p39510.2_BraZ1	72	+	308	949	949	1.0000000
A02	24964519	24966352	A02p39520.2_BraZ1	1070.05	-	1415	1833	1833	1.0000000
A02	24967736	24967982	A02p39530.2_BraZ1	24.6	+	29	216	246	0.8780488
A02	24976174	24976999	A02p39540.2_BraZ1	450	+	718	825	825	1.0000000
A02	25003662	25006319	A02p39550.2_BraZ1	1352.25	-	1226	2564	2657	0.9649981
A02	25018245	25018389	A02p39560.2_BraZ1	10.2	+	261	144	144	1.0000000
A02	25020245	25020803	A02p39570.2_BraZ1	55.8	-	530	558	558	1.0000000
A02	25023894	25025577	A02p39580.2_BraZ1	415.8	-	667	1615	1683	0.9595960
A02	25028761	25030566	A02p39590.2_BraZ1	1963.5	-	1061	1805	1805	1.0000000
A02	25034335	25036825	A02p39600.2_BraZ1	574.038	-	917	2434	2490	0.9775100
A02	25052995	25055498	A02p39610.2_BraZ1	1412.67	-	821	2275	2503	0.9089093
A02	25070513	25076042	A02p39620.2_BraZ1	2596.4	+	1935	3991	5529	0.7218304
A02	25076521	25078681	A02p39630.2_BraZ1	1115.62	-	739	2146	2160	0.9935185
A02	25085926	25088728	A02p39640.2_BraZ1	1629.41	+	1940	2684	2802	0.9578872
A02	25090669	25091729	A02p39650.2_BraZ1	696.15	-	346	998	1060	0.9415094
A02	25095043	25096089	A02p39660.2_BraZ1	954	-	252	993	1046	0.9493308
A02	25096234	25099028	A02p39670.2_BraZ1	2902.5	-	1401	2785	2794	0.9967788
A02	25099849	25102333	A02p39680.2_BraZ1	1396.8	-	1447	2484	2484	1.0000000
A02	25103852	25105821	A02p39690.2_BraZ1	838.893	+	785	1969	1969	1.0000000
A02	25109348	25109805	A02p39700.2_BraZ1	984	-	43	258	457	0.5645514
A02	25111321	25111648	A02p39710.2_BraZ1	32.7	-	70	321	327	0.9816514
A02	25111860	25112064	A02p39720.2_BraZ1	20.4	+	73	204	204	1.0000000
A02	25119276	25119468	A02p39730.2_BraZ1	19.2	+	59	176	192	0.9166667
A02	25126519	25127434	A02p39740.2_BraZ1	105	+	443	915	915	1.0000000
A02	25127659	25134887	A02p39750.2_BraZ1	1228.5	+	553	3254	7228	0.4501937
A02	25132594	25133390	A02p39760.2_BraZ1	1326.38	+	0	0	796	0.0000000
A02	25148286	25149792	A02p39770.2_BraZ1	954.167	-	664	1458	1506	0.9681275
A02	25150731	25151028	A02p39780.2_BraZ1	18.3	-	284	297	297	1.0000000
A02	25152491	25153981	A02p39790.2_BraZ1	1878.5	-	766	1454	1490	0.9758389
A02	25172188	25173026	A02p39800.2_BraZ1	407.5	+	675	838	838	1.0000000
A02	25182183	25183147	A02p39810.2_BraZ1	1976	+	113	753	964	0.7811204
A02	25186297	25188231	A02p39820.2_BraZ1	609.047	-	138	1127	1934	0.5827301
A02	25195333	25195563	A02p39830.2_BraZ1	204	+	144	230	230	1.0000000
A02	25198257	25199076	A02p39840.2_BraZ1	543	-	8	207	819	0.2527473
A02	25205569	25206429	A02p39850.2_BraZ1	222	-	0	0	860	0.0000000
A02	25208862	25209530	A02p39860.2_BraZ1	501	+	100	592	668	0.8862275
A02	25210515	25212083	A02p39870.2_BraZ1	1238.4	-	95	1263	1568	0.8054847
A02	25223079	25226088	A02p39880.2_BraZ1	1548.21	+	1551	2982	3009	0.9910269
A02	25226579	25226864	A02p39890.2_BraZ1	28.5	+	42	285	285	1.0000000
A02	25227701	25228235	A02p39900.2_BraZ1	53.4	+	233	534	534	1.0000000
A02	25241577	25241778	A02p39910.2_BraZ1	20.1	+	122	201	201	1.0000000
A02	25244036	25246395	A02p39920.2_BraZ1	90.9	+	1618	2359	2359	1.0000000
A02	25258072	25258277	A02p39930.2_BraZ1	486	-	197	205	205	1.0000000
A02	25258330	25259581	A02p39940.2_BraZ1	630	-	99	610	1251	0.4876099
A02	25263989	25265073	A02p39950.2_BraZ1	876.316	+	549	1056	1084	0.9741697
A02	25265428	25267753	A02p39960.2_BraZ1	149.4	-	478	1856	2325	0.7982796
A02	25269813	25270185	A02p39970.2_BraZ1	37.2	-	24	305	372	0.8198925
A02	25271930	25273014	A02p39980.2_BraZ1	474	+	563	1025	1084	0.9455720
A02	25273785	25273911	A02p39990.2_BraZ1	12.6	-	341	126	126	1.0000000
A02	25278761	25279735	A02p40000.2_BraZ1	505.08	-	20	188	974	0.1930185
A02	25283321	25283423	A02p40010.2_BraZ1	10.2	-	56	102	102	1.0000000
A02	25291295	25291465	A02p40020.2_BraZ1	11.1	+	246	170	170	1.0000000
A02	25291506	25291750	A02p40030.2_BraZ1	13.8	-	142	241	244	0.9877049
A02	25294835	25299381	A02p40040.2_BraZ1	2039.21	-	553	1792	4546	0.3941927
A02	25306666	25307608	A02p40050.2_BraZ1	94.2	+	281	942	942	1.0000000
A02	25308566	25312912	A02p40060.2_BraZ1	1324.12	-	1877	3664	4346	0.8430741
A02	25313345	25316343	A02p40070.2_BraZ1	1649.08	+	438	1890	2998	0.6304203
A02	25317565	25318989	A02p40080.2_BraZ1	471.336	+	144	1057	1424	0.7422753
A02	25322641	25324614	A02p40090.2_BraZ1	1216.83	+	602	1762	1973	0.8930563
A02	25325950	25328281	A02p40100.2_BraZ1	753	-	455	1472	2331	0.6314886
A02	25341582	25341892	A02p40110.2_BraZ1	189	-	79	297	310	0.9580645
A02	25343654	25344054	A02p40120.2_BraZ1	336	+	245	400	400	1.0000000
A02	25348310	25352531	A02p40130.2_BraZ1	1104	+	1322	3926	4221	0.9301113
A02	25357887	25359317	A02p40140.2_BraZ1	640.375	-	295	757	1430	0.5293706
A02	25376440	25379376	A02p40150.2_BraZ1	2778	-	642	2394	2936	0.8153951
A02	25395625	25395972	A02p40160.2_BraZ1	309	+	510	347	347	1.0000000
A02	25403738	25404239	A02p40170.2_BraZ1	50.1	+	607	501	501	1.0000000
A02	25411707	25412884	A02p40180.2_BraZ1	621	-	613	1177	1177	1.0000000
A02	25418543	25419679	A02p40190.2_BraZ1	282	-	81	590	1136	0.5193662
A02	25435286	25437038	A02p40200.2_BraZ1	768.2	+	305	1752	1752	1.0000000
A02	25437596	25438787	A02p40210.2_BraZ1	442.4	+	483	1191	1191	1.0000000
A02	25441947	25443005	A02p40220.2_BraZ1	327.111	+	2713	1058	1058	1.0000000
A02	25453817	25454929	A02p40230.2_BraZ1	519	-	675	1103	1112	0.9919065
A02	25454248	25454530	A02p40240.2_BraZ1	222	-	193	282	282	1.0000000
A02	25454892	25455897	A02p40250.2_BraZ1	99.9	-	146	645	1005	0.6417910
A02	25456033	25456507	A02p40260.2_BraZ1	324	-	167	474	474	1.0000000
A02	25464292	25480025	A02p40270.2_BraZ1	932.4	-	5950	12414	15733	0.7890421
A02	25470164	25472388	A02p40280.2_BraZ1	714.273	+	677	2026	2224	0.9109712
A02	25484203	25485032	A02p40290.2_BraZ1	324	-	642	829	829	1.0000000
A02	25487758	25488172	A02p40300.2_BraZ1	318	-	197	414	414	1.0000000
A02	25493613	25494493	A02p40310.2_BraZ1	1781.25	-	5725	880	880	1.0000000
A02	25498369	25501195	A02p40320.2_BraZ1	1259.25	+	995	2551	2826	0.9026893
A02	25510441	25511161	A02p40330.2_BraZ1	414	-	840	720	720	1.0000000
A02	25511648	25517039	A02p40340.2_BraZ1	965.25	+	3588	5087	5391	0.9436097
A02	25524126	25526636	A02p40350.2_BraZ1	1317	+	775	2153	2510	0.8577690
A02	25545941	25548310	A02p40360.2_BraZ1	419.333	-	2684	2369	2369	1.0000000
A02	25551513	25553095	A02p40370.2_BraZ1	694.435	-	648	1485	1582	0.9386852
A02	25559610	25562033	A02p40380.2_BraZ1	1460.83	-	266	1653	2423	0.6822121
A02	25565750	25568049	A02p40390.2_BraZ1	8032.5	+	836	1638	2299	0.7124837
A02	25570896	25571901	A02p40400.2_BraZ1	588	+	1628	1005	1005	1.0000000
A02	25572708	25572864	A02p40410.2_BraZ1	15.6	+	31	147	156	0.9423077
A02	25590391	25592420	A02p40420.2_BraZ1	742.975	+	212	1710	2029	0.8427797
A02	25604249	25608449	A02p40430.2_BraZ1	1687.03	+	1744	2993	4200	0.7126191
A02	25608668	25609025	A02p40440.2_BraZ1	35.7	+	12	234	357	0.6554622
A02	25632111	25633944	A02p40450.2_BraZ1	53.7	-	427	1667	1833	0.9094381
A02	25637999	25640776	A02p40460.2_BraZ1	1429.7	-	101	761	2777	0.2740367
A02	25658841	25659369	A02p40470.2_BraZ1	1794	+	10	254	528	0.4810606
A02	25661106	25661373	A02p40480.2_BraZ1	26.7	-	249	267	267	1.0000000
A02	25661654	25661994	A02p40490.2_BraZ1	237	-	130	340	340	1.0000000
A02	25664900	25665434	A02p40500.2_BraZ1	219	+	664	534	534	1.0000000
A02	25675190	25676039	A02p40510.2_BraZ1	315	+	712	833	849	0.9811543
A02	25682180	25684330	A02p40520.2_BraZ1	1849.98	-	319	1228	2150	0.5711628
A02	25685190	25687157	A02p40530.2_BraZ1	928.68	-	315	1873	1967	0.9522115
A02	25692257	25694238	A02p40540.2_BraZ1	895.418	+	1790	1981	1981	1.0000000
A02	25696729	25699561	A02p40550.2_BraZ1	283.2	-	373	2170	2832	0.7662429
A02	25704102	25705246	A02p40560.2_BraZ1	977.083	-	194	1144	1144	1.0000000
A02	25712233	25713753	A02p40570.2_BraZ1	813.75	-	410	1301	1520	0.8559210
A02	25718960	25722659	A02p40580.2_BraZ1	2532.99	+	1298	2959	3699	0.7999460
A02	25725025	25727982	A02p40590.2_BraZ1	890.913	-	432	1972	2957	0.6668921
A02	25729536	25730581	A02p40600.2_BraZ1	2098.64	-	1138	1045	1045	1.0000000
A02	25731147	25739979	A02p40610.2_BraZ1	1421.18	-	4758	8196	8832	0.9279891
A02	25739979	25740190	A02p40620.2_BraZ1	132	-	20	211	211	1.0000000
A02	25746044	25747064	A02p40630.2_BraZ1	102	-	1706	1020	1020	1.0000000
A02	25748801	25750153	A02p40640.2_BraZ1	821.171	-	790	1230	1352	0.9097633
A02	25751329	25752544	A02p40650.2_BraZ1	937.2	+	559	1203	1215	0.9901235
A02	25758081	25760474	A02p40660.2_BraZ1	767.533	+	1545	2345	2393	0.9799415
A02	25763363	25764900	A02p40670.2_BraZ1	966	-	1145	1463	1537	0.9518543
A02	25775642	25775936	A02p40680.2_BraZ1	29.4	-	144	294	294	1.0000000
A02	25776689	25777076	A02p40690.2_BraZ1	38.7	+	43	348	387	0.8992248
A02	25785342	25785665	A02p40700.2_BraZ1	29.1	-	142	323	323	1.0000000
A02	25786388	25788392	A02p40710.2_BraZ1	297	+	1925	2004	2004	1.0000000
A02	25793012	25794878	A02p40720.2_BraZ1	475.125	-	168	795	1866	0.4260450
A02	25798459	25798661	A02p40730.2_BraZ1	17.4	+	1186	202	202	1.0000000
A02	25806479	25809051	A02p40740.2_BraZ1	1083.15	+	1084	1760	2572	0.6842924
A02	25813713	25813926	A02p40750.2_BraZ1	21.3	+	31	187	213	0.8779343
A02	25819011	25820099	A02p40760.2_BraZ1	381	+	628	956	1088	0.8786765
A02	25831113	25832028	A02p40770.2_BraZ1	573	+	919	915	915	1.0000000
A02	25834372	25834773	A02p40780.2_BraZ1	21.9	-	412	401	401	1.0000000
A02	25836046	25837521	A02p40790.2_BraZ1	291	-	968	1238	1475	0.8393220
A02	25843205	25847034	A02p40800.2_BraZ1	768	-	2404	3829	3829	1.0000000
A02	25855025	25858976	A02p40810.2_BraZ1	2568.05	+	1921	3813	3951	0.9650722
A02	25861218	25861443	A02p40820.2_BraZ1	22.5	+	15	197	225	0.8755556
A02	25868388	25868685	A02p40830.2_BraZ1	243	+	39	297	297	1.0000000
A02	25869121	25869817	A02p40840.2_BraZ1	588	-	73	696	696	1.0000000
A02	25875328	25877259	A02p40850.2_BraZ1	893.766	-	234	1558	1931	0.8068358
A02	25877538	25877757	A02p40860.2_BraZ1	21.9	+	11	152	219	0.6940639
A02	25885338	25885487	A02p40870.2_BraZ1	10.5	+	116	149	149	1.0000000
A02	25888952	25889569	A02p40880.2_BraZ1	55.8	-	405	617	617	1.0000000
A02	25889988	25890330	A02p40890.2_BraZ1	138	-	366	342	342	1.0000000
A02	25892926	25893838	A02p40900.2_BraZ1	91.2	+	291	869	912	0.9528509
A02	25895231	25900750	A02p40910.2_BraZ1	414	+	2735	4960	5519	0.8987135
A02	25903068	25903991	A02p40920.2_BraZ1	447	-	281	923	923	1.0000000
A02	25904401	25905559	A02p40930.2_BraZ1	115.2	+	320	1050	1158	0.9067358
A02	25915120	25922036	A02p40940.2_BraZ1	3500.21	+	270	3104	6916	0.4488143
A02	25930945	25932777	A02p40950.2_BraZ1	704	-	819	1649	1832	0.9001092
A02	25936090	25938319	A02p40960.2_BraZ1	2781	+	486	2170	2229	0.9735307
A02	25950673	25950928	A02p40970.2_BraZ1	25.5	+	2	228	255	0.8941177
A02	25953156	25953909	A02p40980.2_BraZ1	75.3	-	336	753	753	1.0000000
A02	25955375	25957483	A02p40990.2_BraZ1	1332.36	+	65	1083	2108	0.5137571
A02	25959241	25960084	A02p41000.2_BraZ1	432.362	+	250	843	843	1.0000000
A02	25961384	25961510	A02p41010.2_BraZ1	12.6	-	7	56	126	0.4444444
A02	25964445	25966572	A02p41020.2_BraZ1	1470.66	+	475	2119	2127	0.9962388
A02	25967288	25969430	A02p41030.2_BraZ1	1229.11	-	481	2002	2142	0.9346405
A02	25974522	25976549	A02p41040.2_BraZ1	970.457	+	884	1921	2027	0.9477060
A02	25977881	25980168	A02p41050.2_BraZ1	1375.7	-	1005	2196	2287	0.9602099
A02	25988907	25989189	A02p41060.2_BraZ1	28.2	+	402	282	282	1.0000000
A02	26001064	26002167	A02p41070.2_BraZ1	390	-	644	999	1103	0.9057117
A02	26003006	26006514	A02p41080.2_BraZ1	1568.71	-	1925	2910	3508	0.8295325
A02	26011811	26013146	A02p41090.2_BraZ1	133.5	+	394	1326	1335	0.9932584
A02	26014536	26016487	A02p41100.2_BraZ1	911.795	+	1299	1951	1951	1.0000000
A02	26017506	26019895	A02p41110.2_BraZ1	1204	-	1430	2389	2389	1.0000000
A02	26022911	26024162	A02p41120.2_BraZ1	125.1	-	157	1122	1251	0.8968825
A02	26028240	26030064	A02p41130.2_BraZ1	182.4	+	953	1824	1824	1.0000000
A02	26031408	26032257	A02p41140.2_BraZ1	441	+	92	227	849	0.2673734
A02	26034442	26035465	A02p41150.2_BraZ1	660	+	234	849	1023	0.8299120
A02	26041820	26042843	A02p41160.2_BraZ1	755.893	-	300	1023	1023	1.0000000
A02	26060633	26062853	A02p41170.2_BraZ1	1018.24	+	1722	2220	2220	1.0000000
A02	26064051	26065316	A02p41180.2_BraZ1	537	+	791	1265	1265	1.0000000
A02	26065316	26067866	A02p41190.2_BraZ1	256.143	+	1670	2481	2550	0.9729412
A02	26068111	26068455	A02p41200.2_BraZ1	61.9286	+	195	344	344	1.0000000
A02	26068900	26072385	A02p41210.2_BraZ1	2382.43	-	1386	3212	3485	0.9216643
A02	26086970	26087120	A02p41220.2_BraZ1	15	+	51	150	150	1.0000000
A02	26087284	26093911	A02p41230.2_BraZ1	3227.26	-	3422	6619	6627	0.9987928
A02	26095303	26097487	A02p41240.2_BraZ1	218.4	+	135	1528	2184	0.6996337
A02	26101987	26102420	A02p41250.2_BraZ1	230.029	-	0	0	433	0.0000000
A02	26102464	26103853	A02p41260.2_BraZ1	211.103	-	7	353	1389	0.2541397
A02	26104673	26104995	A02p41270.2_BraZ1	273	-	92	309	322	0.9596273
A02	26108324	26109424	A02p41280.2_BraZ1	9222.5	+	1288	1100	1100	1.0000000
A02	26113024	26114038	A02p41290.2_BraZ1	101.4	+	392	967	1014	0.9536489
A02	26122344	26125804	A02p41300.2_BraZ1	1084.83	-	1851	3301	3460	0.9540462
A02	26139886	26140716	A02p41310.2_BraZ1	63.6	-	456	787	830	0.9481928
A02	26141513	26141672	A02p41320.2_BraZ1	15.9	-	214	159	159	1.0000000
A02	26144953	26146900	A02p41330.2_BraZ1	1621.8	-	1697	1947	1947	1.0000000
A02	26149337	26149520	A02p41340.2_BraZ1	18.3	-	69	183	183	1.0000000
A02	26153248	26154425	A02p41350.2_BraZ1	519.75	-	173	817	1177	0.6941376
A02	26154738	26155273	A02p41360.2_BraZ1	444	+	584	535	535	1.0000000
A02	26155380	26155944	A02p41370.2_BraZ1	363	-	349	564	564	1.0000000
A02	26156381	26156885	A02p41380.2_BraZ1	50.4	-	153	457	504	0.9067460
A02	26157907	26159839	A02p41390.2_BraZ1	193.2	+	1046	1804	1932	0.9337474
A02	26171079	26173599	A02p41400.2_BraZ1	1626.24	+	851	2426	2520	0.9626984
A02	26181288	26183335	A02p41410.2_BraZ1	1269	+	294	1005	2047	0.4909624
A02	26193406	26194978	A02p41420.2_BraZ1	10087.8	+	144	1365	1572	0.8683206
A02	26197364	26198445	A02p41430.2_BraZ1	888	+	282	672	1081	0.6216466
A02	26203695	26203869	A02p41440.2_BraZ1	17.4	+	520	174	174	1.0000000
A02	26207239	26207655	A02p41450.2_BraZ1	3465	+	286	416	416	1.0000000
A02	26207930	26208692	A02p41460.2_BraZ1	681	-	451	753	762	0.9881890
A02	26226779	26227546	A02p41470.2_BraZ1	279	+	10	65	767	0.0847458
A02	26239723	26241821	A02p41480.2_BraZ1	766.5	+	114	993	2098	0.4733079
A02	26246701	26247124	A02p41490.2_BraZ1	144	+	212	423	423	1.0000000
A02	26247405	26247739	A02p41500.2_BraZ1	135	+	40	334	334	1.0000000
A02	26251120	26252728	A02p41510.2_BraZ1	1314.41	-	519	1392	1608	0.8656716
A02	26257192	26258124	A02p41520.2_BraZ1	579	-	28	387	932	0.4152361
A02	26262916	26263960	A02p41530.2_BraZ1	104.4	-	531	946	1044	0.9061303
A02	26265262	26279752	A02p41540.2_BraZ1	717	-	5750	14452	14490	0.9973775
A02	26280513	26281715	A02p41550.2_BraZ1	3393	+	244	941	1202	0.7828619
A02	26282949	26294884	A02p41560.2_BraZ1	987	-	10340	11915	11935	0.9983243
A02	26300653	26301634	A02p41570.2_BraZ1	98.1	-	453	981	981	1.0000000
A02	26302958	26303258	A02p41580.2_BraZ1	30	+	158	300	300	1.0000000
A02	26306295	26314248	A02p41590.2_BraZ1	984.982	+	5227	6929	7953	0.8712435
A02	26315247	26316186	A02p41600.2_BraZ1	93.9	-	0	0	939	0.0000000
A02	26318186	26318303	A02p41610.2_BraZ1	11.7	-	210	117	117	1.0000000
A02	26321053	26321839	A02p41620.2_BraZ1	336	+	89	593	786	0.7544529
A02	26323549	26323900	A02p41630.2_BraZ1	35.1	+	44	120	351	0.3418804
A02	26324363	26325313	A02p41640.2_BraZ1	532.5	+	166	563	950	0.5926316
A02	26325707	26326104	A02p41650.2_BraZ1	16.8	+	520	397	397	1.0000000
A02	26326063	26326759	A02p41660.2_BraZ1	244.083	+	1756	696	696	1.0000000
A02	26327644	26327824	A02p41670.2_BraZ1	18	-	270	180	180	1.0000000
A02	26331167	26332421	A02p41680.2_BraZ1	125.4	-	247	1090	1254	0.8692185
A02	26334875	26335191	A02p41690.2_BraZ1	15.9	+	95	316	316	1.0000000
A02	26338842	26340914	A02p41700.2_BraZ1	1077.62	+	303	1873	2072	0.9039575
A02	26346437	26350395	A02p41710.2_BraZ1	676.597	+	8080	3112	3958	0.7862557
A02	26351425	26352201	A02p41720.2_BraZ1	474	-	549	776	776	1.0000000
A02	26352897	26354613	A02p41730.2_BraZ1	315	-	1419	1716	1716	1.0000000
A02	26361471	26366085	A02p41740.2_BraZ1	4623.49	+	5531	4614	4614	1.0000000
A02	26366076	26366623	A02p41750.2_BraZ1	1032.61	+	210	547	547	1.0000000
A02	26367333	26367760	A02p41760.2_BraZ1	345	+	30	235	427	0.5503513
A02	26370673	26371462	A02p41770.2_BraZ1	485	-	1548	789	789	1.0000000
A02	26390840	26391209	A02p41780.2_BraZ1	270	+	2	59	369	0.1598916
A02	26394493	26395144	A02p41790.2_BraZ1	210	+	1819	651	651	1.0000000
A02	26397120	26397494	A02p41800.2_BraZ1	273	+	17	114	374	0.3048128
A02	26398681	26399094	A02p41810.2_BraZ1	300	+	1029	413	413	1.0000000
A02	26406197	26406646	A02p41820.2_BraZ1	339	+	286	449	449	1.0000000
A02	26424239	26424779	A02p41830.2_BraZ1	54	+	7	175	540	0.3240741
A02	26434889	26436608	A02p41840.2_BraZ1	684.774	+	1151	1680	1719	0.9773124
A02	26442429	26443239	A02p41850.2_BraZ1	81	+	509	795	810	0.9814815
A02	26443775	26447990	A02p41860.2_BraZ1	457.6	-	3834	4215	4215	1.0000000
A02	26448409	26449965	A02p41870.2_BraZ1	746.429	-	877	1114	1556	0.7159383
A02	26450720	26454879	A02p41880.2_BraZ1	376.25	-	363	3437	4159	0.8264006
A02	26451403	26451907	A02p41890.2_BraZ1	50.4	+	7	231	504	0.4583333
A02	26456192	26456897	A02p41900.2_BraZ1	69	+	98	705	705	1.0000000
A02	26465898	26468452	A02p41910.2_BraZ1	976.454	+	1911	2492	2554	0.9757243
A02	26474641	26475793	A02p41920.2_BraZ1	115.2	+	315	1090	1152	0.9461806
A02	26477341	26478226	A02p41930.2_BraZ1	366.75	-	941	885	885	1.0000000
A02	26480856	26481360	A02p41940.2_BraZ1	50.4	+	2	62	504	0.1230159
A02	26483742	26488837	A02p41950.2_BraZ1	3544.32	-	1409	3921	5095	0.7695780
A02	26494753	26497764	A02p41960.2_BraZ1	1889.4	-	501	2143	3011	0.7117237
A02	26523756	26524575	A02p41970.2_BraZ1	79.8	+	622	819	819	1.0000000
A02	26526030	26526237	A02p41980.2_BraZ1	20.7	+	45	144	207	0.6956522
A02	26529466	26530066	A02p41990.2_BraZ1	60	+	0	0	600	0.0000000
A02	26535154	26535496	A02p42000.2_BraZ1	34.2	+	167	220	342	0.6432748
A02	26536801	26537718	A02p42010.2_BraZ1	303	-	136	807	917	0.8800436
A02	26544344	26545025	A02p42020.2_BraZ1	336	+	754	681	681	1.0000000
A02	26551981	26553648	A02p42030.2_BraZ1	331.143	+	878	1433	1667	0.8596281
A02	26566450	26567361	A02p42040.2_BraZ1	210	+	429	554	911	0.6081229
A02	26567301	26570536	A02p42050.2_BraZ1	1387.17	+	18	324	3235	0.1001546
A02	26572852	26573751	A02p42060.2_BraZ1	425.85	-	224	732	899	0.8142381
A02	26575052	26575337	A02p42070.2_BraZ1	201	+	22	216	285	0.7578948
A02	26578379	26579462	A02p42080.2_BraZ1	47.6842	-	683	1015	1083	0.9372115
A02	26581191	26582553	A02p42090.2_BraZ1	136.2	+	570	1362	1362	1.0000000
A02	26597541	26598956	A02p42100.2_BraZ1	10080	+	256	998	1415	0.7053003
A02	26609694	26610408	A02p42110.2_BraZ1	249	-	982	714	714	1.0000000
A02	26614673	26615266	A02p42120.2_BraZ1	315	+	548	593	593	1.0000000
A02	26623077	26623449	A02p42130.2_BraZ1	30.3	-	310	372	372	1.0000000
A02	26623449	26624337	A02p42140.2_BraZ1	639	-	767	888	888	1.0000000
A02	26624544	26625584	A02p42150.2_BraZ1	98.1	+	345	884	1040	0.8500000
A02	26626570	26629464	A02p42160.2_BraZ1	12954	-	1773	2888	2894	0.9979268
A02	26631941	26632443	A02p42170.2_BraZ1	312	-	321	502	502	1.0000000
A02	26637491	26637675	A02p42180.2_BraZ1	88.8	-	2	62	184	0.3369565
A02	26637675	26639634	A02p42190.2_BraZ1	570	-	745	1579	1959	0.8060235
A02	26641457	26641864	A02p42200.2_BraZ1	202.5	-	8	318	407	0.7813268
A02	26650120	26650585	A02p42210.2_BraZ1	46.5	-	373	465	465	1.0000000
A02	26651326	26651677	A02p42220.2_BraZ1	35.1	-	78	343	351	0.9772080
A02	26666556	26667526	A02p42230.2_BraZ1	900	+	748	970	970	1.0000000
A02	26672517	26672799	A02p42240.2_BraZ1	28.2	-	72	181	282	0.6418440
A02	26675361	26676003	A02p42250.2_BraZ1	913.5	-	1280	642	642	1.0000000
A02	26693426	26693921	A02p42260.2_BraZ1	68.7273	+	608	495	495	1.0000000
A02	26694198	26702056	A02p42270.2_BraZ1	1393.91	+	3172	6964	7858	0.8862306
A02	26701433	26703345	A02p42280.2_BraZ1	120	-	1334	1912	1912	1.0000000
A02	26703933	26705888	A02p42290.2_BraZ1	390.083	-	926	1860	1955	0.9514067
A02	26707658	26709773	A02p42300.2_BraZ1	211.5	-	565	2024	2115	0.9569740
A02	26710447	26710670	A02p42310.2_BraZ1	132	+	242	223	223	1.0000000
A02	26710644	26712318	A02p42320.2_BraZ1	1219.19	-	974	1645	1674	0.9826762
A02	26713081	26714352	A02p42330.2_BraZ1	1182	-	497	1210	1271	0.9520063
A02	26720085	26721282	A02p42340.2_BraZ1	324	+	9	149	1197	0.1244779
A02	26727829	26732638	A02p42350.2_BraZ1	3239.71	+	2260	4649	4809	0.9667290
A02	26733939	26736376	A02p42360.2_BraZ1	1539.49	+	1451	2437	2437	1.0000000
A02	26741128	26743474	A02p42370.2_BraZ1	1468.85	+	605	2141	2346	0.9126172
A02	26747777	26747961	A02p42380.2_BraZ1	168	-	0	0	184	0.0000000
A02	26748735	26749092	A02p42390.2_BraZ1	35.7	+	68	245	357	0.6862745
A02	26754639	26757450	A02p42400.2_BraZ1	1779.2	+	496	2362	2811	0.8402703
A02	26769421	26771483	A02p42410.2_BraZ1	327	-	388	1815	2062	0.8802134
A02	26770479	26771076	A02p42420.2_BraZ1	59.7	-	98	597	597	1.0000000
A02	26773719	26774252	A02p42430.2_BraZ1	249.6	+	224	493	533	0.9249531
A02	26794549	26795947	A02p42440.2_BraZ1	1140	-	245	1004	1398	0.7181688
A02	26810949	26811273	A02p42450.2_BraZ1	150	+	0	0	324	0.0000000
A02	26824428	26824736	A02p42460.2_BraZ1	17.7	+	243	308	308	1.0000000
A02	26827544	26829271	A02p42470.2_BraZ1	1503	+	536	1613	1727	0.9339896
A02	26836361	26838387	A02p42480.2_BraZ1	1506	-	630	1476	2026	0.7285291
A02	26839850	26841737	A02p42490.2_BraZ1	649.286	-	441	1652	1887	0.8754637
A02	26842392	26843978	A02p42500.2_BraZ1	1077.86	-	155	1003	1586	0.6324086
A02	26857840	26859737	A02p42510.2_BraZ1	342.24	-	336	1144	1897	0.6030574
A02	26863903	26866003	A02p42520.2_BraZ1	16221.8	-	254	1162	2100	0.5533333
A02	26868047	26868716	A02p42530.2_BraZ1	976	+	474	614	669	0.9177877
A02	26872209	26873218	A02p42540.2_BraZ1	393.231	-	9	237	1009	0.2348860
A02	26874877	26875773	A02p42550.2_BraZ1	318	+	786	896	896	1.0000000
A02	26878029	26879706	A02p42560.2_BraZ1	25024.5	-	541	1362	1677	0.8121646
A02	26961174	26963474	A02p42570.2_BraZ1	321	-	17	247	2300	0.1073913
A02	26964287	26968820	A02p42580.2_BraZ1	3651.56	+	575	2531	4533	0.5583499
A02	26969229	26969685	A02p42590.2_BraZ1	45.6	-	25	233	456	0.5109649
A02	26980502	26982803	A02p42600.2_BraZ1	321	-	2	111	2301	0.0482399
A02	26983616	26986954	A02p42610.2_BraZ1	1709.05	+	168	2022	3338	0.6057519
A02	26987364	26987820	A02p42620.2_BraZ1	45.6	-	0	0	456	0.0000000
A02	27016271	27018144	A02p42630.2_BraZ1	923.897	+	1342	1799	1873	0.9604912
A02	27018679	27019747	A02p42640.2_BraZ1	106.8	-	281	964	1068	0.9026217
A02	27021060	27021375	A02p42650.2_BraZ1	31.5	-	230	315	315	1.0000000
A02	27021860	27025624	A02p42660.2_BraZ1	1711.73	+	2199	3760	3764	0.9989373
A02	27027529	27029247	A02p42670.2_BraZ1	1210.25	-	555	1718	1718	1.0000000
A02	27029664	27030545	A02p42680.2_BraZ1	732	+	104	764	881	0.8671964
A02	27031268	27032882	A02p42690.2_BraZ1	936	+	717	1561	1614	0.9671623
A02	27033230	27034903	A02p42700.2_BraZ1	1357.36	-	786	1587	1673	0.9485953
A02	27036980	27037620	A02p42710.2_BraZ1	540	-	468	640	640	1.0000000
A02	27052425	27052599	A02p42720.2_BraZ1	17.4	+	86	174	174	1.0000000
A02	27059152	27059467	A02p42730.2_BraZ1	228	+	121	315	315	1.0000000
A02	27061278	27062547	A02p42740.2_BraZ1	762	-	513	1170	1269	0.9219858
A02	27072090	27073109	A02p42750.2_BraZ1	147	+	1343	1019	1019	1.0000000
A02	27073573	27074053	A02p42760.2_BraZ1	366	+	312	480	480	1.0000000
A02	27074822	27076435	A02p42770.2_BraZ1	1125.33	+	1225	1568	1613	0.9721017
A02	27076946	27079085	A02p42780.2_BraZ1	1154.4	-	1863	2097	2139	0.9803647
A02	27080557	27081534	A02p42790.2_BraZ1	542.857	-	242	908	977	0.9293756
A02	27087519	27089283	A02p42800.2_BraZ1	1085.28	+	840	1764	1764	1.0000000
A02	27092045	27093084	A02p42810.2_BraZ1	820.167	+	1522	1039	1039	1.0000000
A02	27094026	27097499	A02p42820.2_BraZ1	1963.33	+	843	3151	3473	0.9072848
A02	27097882	27098467	A02p42830.2_BraZ1	430.5	+	414	585	585	1.0000000
A02	27103761	27105734	A02p42840.2_BraZ1	895.655	-	995	1973	1973	1.0000000
A02	27107677	27107965	A02p42850.2_BraZ1	28.8	-	255	288	288	1.0000000
A02	27108068	27115614	A02p42860.2_BraZ1	873.813	+	2880	5460	7546	0.7235622
A02	27119804	27124995	A02p42870.2_BraZ1	408	+	651	2958	5191	0.5698324
A02	27129054	27136556	A02p42880.2_BraZ1	1300.5	+	8775	6045	7502	0.8057851
A02	27139511	27141216	A02p42890.2_BraZ1	1179	+	604	1491	1705	0.8744868
A02	27145067	27146967	A02p42900.2_BraZ1	849.464	-	937	1746	1900	0.9189473
A02	27151546	27151735	A02p42910.2_BraZ1	18.9	+	407	189	189	1.0000000
A02	27159104	27161486	A02p42920.2_BraZ1	1728	+	615	2140	2382	0.8984047
A02	27162918	27164451	A02p42930.2_BraZ1	549.125	-	416	1402	1533	0.9145467
A02	27174120	27178324	A02p42940.2_BraZ1	1879.01	+	223	2988	4204	0.7107517
A02	27181460	27186481	A02p42950.2_BraZ1	2003.48	+	3797	4833	5021	0.9625573
A02	27192375	27192534	A02p42960.2_BraZ1	12.9	+	165	159	159	1.0000000
A02	27196277	27212526	A02p42970.2_BraZ1	1997.53	+	8453	14855	16249	0.9142101
A02	27206273	27207170	A02p42980.2_BraZ1	396	-	20	330	897	0.3678930
A02	27212629	27215128	A02p42990.2_BraZ1	1667.66	-	1176	2488	2499	0.9955983
A02	27217610	27219995	A02p43000.2_BraZ1	1661.78	-	1257	2289	2385	0.9597484
A02	27230926	27232198	A02p43010.2_BraZ1	1095.29	-	515	1272	1272	1.0000000
A02	27233369	27236166	A02p43020.2_BraZ1	1271.98	-	1297	2568	2797	0.9181266
A02	27241506	27242487	A02p43030.2_BraZ1	700	+	0	0	981	0.0000000
A02	27248724	27250716	A02p43040.2_BraZ1	1381.64	-	1256	1885	1992	0.9462851
A02	27259538	27260136	A02p43050.2_BraZ1	263.077	+	808	598	598	1.0000000
A02	27268955	27271050	A02p43060.2_BraZ1	1207.51	+	797	1853	2095	0.8844869
A02	27272406	27272619	A02p43070.2_BraZ1	21.3	+	247	213	213	1.0000000
A02	27278477	27279642	A02p43080.2_BraZ1	609	+	466	1107	1165	0.9502146
A02	27281777	27282286	A02p43090.2_BraZ1	2520	-	3	144	509	0.2829077
A02	27284675	27285308	A02p43100.2_BraZ1	61.2	+	29	378	633	0.5971564
A02	27287435	27287938	A02p43110.2_BraZ1	2691	-	27	267	503	0.5308151
A02	27289742	27290759	A02p43120.2_BraZ1	612	+	88	584	1017	0.5742379
A02	27292550	27294796	A02p43130.2_BraZ1	603	-	1737	2231	2246	0.9933215
A02	27299349	27299757	A02p43140.2_BraZ1	40.8	-	248	408	408	1.0000000
A02	27321281	27322884	A02p43150.2_BraZ1	927.36	+	624	1603	1603	1.0000000
A02	27323834	27324044	A02p43160.2_BraZ1	21	+	14	175	210	0.8333333
A02	27324445	27328623	A02p43170.2_BraZ1	219	-	2210	4083	4178	0.9772618
A02	27333111	27334110	A02p43180.2_BraZ1	99.9	-	131	928	999	0.9289289
A02	27339568	27339865	A02p43190.2_BraZ1	29.7	+	365	297	297	1.0000000
A02	27340052	27341369	A02p43200.2_BraZ1	512.727	-	763	1317	1317	1.0000000
A02	27343883	27345017	A02p43210.2_BraZ1	760.821	+	765	1134	1134	1.0000000
A02	27346093	27347031	A02p43220.2_BraZ1	291	+	3640	938	938	1.0000000
A02	27347291	27347402	A02p43230.2_BraZ1	11.1	-	36	111	111	1.0000000
A02	27351194	27354385	A02p43240.2_BraZ1	1444	-	735	2523	3191	0.7906612
A02	27354624	27354957	A02p43250.2_BraZ1	33.3	-	78	333	333	1.0000000
A02	27356247	27357483	A02p43260.2_BraZ1	123.6	-	220	1100	1236	0.8899676
A02	27368776	27369562	A02p43270.2_BraZ1	555	+	312	757	786	0.9631043
A02	27373459	27374282	A02p43280.2_BraZ1	77.1	-	2	78	823	0.0947752
A02	27385395	27388479	A02p43290.2_BraZ1	2018.17	+	592	2840	3084	0.9208820
A02	27390058	27393499	A02p43300.2_BraZ1	1441.85	-	2363	3426	3441	0.9956408
A02	27395391	27395986	A02p43310.2_BraZ1	312.136	-	65	476	595	0.8000000
A02	27397173	27398933	A02p43320.2_BraZ1	704	-	1017	1584	1760	0.9000000
A02	27414644	27416483	A02p43330.2_BraZ1	807.211	-	1409	1839	1839	1.0000000
A02	27419345	27419543	A02p43340.2_BraZ1	174	+	143	198	198	1.0000000
A02	27421921	27422758	A02p43350.2_BraZ1	83.4	+	580	837	837	1.0000000
A02	27435970	27443676	A02p43360.2_BraZ1	477	-	1823	4446	7706	0.5769530
A02	27444931	27445191	A02p43370.2_BraZ1	102	+	58	260	260	1.0000000
A02	27447680	27448713	A02p43380.2_BraZ1	269.5	-	255	1033	1033	1.0000000
A02	27450632	27451385	A02p43390.2_BraZ1	75.3	+	311	753	753	1.0000000
A02	27456247	27457958	A02p43400.2_BraZ1	960.75	+	483	949	1711	0.5546464
A02	27459028	27461219	A02p43410.2_BraZ1	1365	+	818	2029	2191	0.9260612
A02	27461264	27461453	A02p43420.2_BraZ1	18.9	+	45	189	189	1.0000000
A02	27462100	27466410	A02p43430.2_BraZ1	2511.37	-	1979	4155	4310	0.9640371
A02	27469403	27474899	A02p43440.2_BraZ1	2840.03	+	2943	5187	5496	0.9437773
A02	27475395	27475590	A02p43450.2_BraZ1	19.5	-	168	195	195	1.0000000
A02	27481575	27481815	A02p43460.2_BraZ1	24	-	15	140	240	0.5833333
A02	27486297	27487196	A02p43470.2_BraZ1	164.571	-	337	864	899	0.9610679
A02	27487943	27489710	A02p43480.2_BraZ1	1539	-	557	1767	1767	1.0000000
A02	27490489	27491843	A02p43490.2_BraZ1	370.909	+	1078	1354	1354	1.0000000
A02	27493896	27495352	A02p43500.2_BraZ1	806.4	+	1012	1456	1456	1.0000000
A02	27496315	27498417	A02p43510.2_BraZ1	846	-	1725	2102	2102	1.0000000
A02	27499237	27502317	A02p43520.2_BraZ1	1656.85	-	1274	2939	3080	0.9542208
A02	27505934	27506267	A02p43530.2_BraZ1	225	-	69	292	333	0.8768769
A02	27509209	27511828	A02p43540.2_BraZ1	1138.54	+	749	1324	2619	0.5055364
A02	27513005	27513389	A02p43550.2_BraZ1	38.4	-	133	243	384	0.6328125
A02	27514275	27517825	A02p43560.2_BraZ1	1154.6	+	2442	3534	3550	0.9954929
A02	27519330	27521383	A02p43570.2_BraZ1	787.206	+	1259	2053	2053	1.0000000
A02	27522409	27527001	A02p43580.2_BraZ1	1361.65	-	2303	4193	4592	0.9131098
A02	27528166	27528988	A02p43590.2_BraZ1	297	+	742	822	822	1.0000000
A02	27532283	27542925	A02p43600.2_BraZ1	129.684	-	7257	10480	10642	0.9847773
A02	27544743	27550557	A02p43610.2_BraZ1	2493.6	-	5223	5803	5814	0.9981080
A02	27553220	27556476	A02p43620.2_BraZ1	1568.7	+	2249	3256	3256	1.0000000
A02	27559736	27562256	A02p43630.2_BraZ1	1089.63	-	2085	2477	2520	0.9829365
A02	27562210	27565490	A02p43640.2_BraZ1	425.092	-	3145	3280	3280	1.0000000
A02	27572756	27573155	A02p43650.2_BraZ1	39.9	+	3	216	399	0.5413534
A02	27577135	27577445	A02p43660.2_BraZ1	222	-	218	310	310	1.0000000
A02	27578482	27579445	A02p43670.2_BraZ1	567	+	1014	963	963	1.0000000
A02	27581811	27582695	A02p43680.2_BraZ1	801	+	418	884	884	1.0000000
A02	27583356	27586881	A02p43690.2_BraZ1	2521.69	-	1039	3429	3525	0.9727660
A02	27589527	27591099	A02p43700.2_BraZ1	157.2	+	261	1324	1572	0.8422392
A02	27591337	27598155	A02p43710.2_BraZ1	2450.46	-	2181	5720	6818	0.8389557
A02	27598380	27600461	A02p43720.2_BraZ1	996.825	-	1985	2081	2081	1.0000000
A02	27600468	27600752	A02p43730.2_BraZ1	213	-	402	284	284	1.0000000
A02	27601162	27603332	A02p43740.2_BraZ1	1206.91	-	1534	1950	2170	0.8986175
A02	27607666	27610728	A02p43750.2_BraZ1	1252.05	+	1035	2430	3062	0.7935989
A02	27612894	27613896	A02p43760.2_BraZ1	585	+	1148	1002	1002	1.0000000
A02	27620213	27620978	A02p43770.2_BraZ1	76.5	+	140	752	765	0.9830065
A02	27622466	27627136	A02p43780.2_BraZ1	1374.83	-	3765	4371	4670	0.9359743
A02	27628566	27637267	A02p43790.2_BraZ1	1130	-	3829	8194	8701	0.9417309
A02	27638091	27639806	A02p43800.2_BraZ1	1044.27	+	213	1515	1715	0.8833819
A02	27649106	27653102	A02p43810.2_BraZ1	1080.31	+	1514	3834	3996	0.9594595
A02	27655451	27657213	A02p43820.2_BraZ1	653.657	-	391	1553	1762	0.8813848
A02	27663518	27666756	A02p43830.2_BraZ1	820.114	+	97	1103	3238	0.3406424
A02	27668715	27669242	A02p43840.2_BraZ1	333	-	0	0	527	0.0000000
A02	27669276	27669930	A02p43850.2_BraZ1	1462	-	0	0	654	0.0000000
A02	27671384	27673906	A02p43860.2_BraZ1	959.203	+	754	1986	2522	0.7874703
A02	27674149	27674493	A02p43870.2_BraZ1	25.5	+	279	344	344	1.0000000
A02	27675295	27676858	A02p43880.2_BraZ1	1213.77	-	152	816	1563	0.5220729
A02	27684267	27693285	A02p43890.2_BraZ1	192	+	5444	8873	9018	0.9839211
A02	27694630	27695348	A02p43900.2_BraZ1	216	+	0	0	718	0.0000000
A02	27698695	27698982	A02p43910.2_BraZ1	180	-	0	0	287	0.0000000
A02	27702834	27705241	A02p43920.2_BraZ1	1506	-	0	0	2407	0.0000000
A02	27720093	27721074	A02p43930.2_BraZ1	98.1	+	553	981	981	1.0000000
A02	27726071	27727031	A02p43940.2_BraZ1	96	+	195	879	960	0.9156250
A02	27733139	27734440	A02p43950.2_BraZ1	459.938	+	655	1127	1301	0.8662567
A02	27734750	27735590	A02p43960.2_BraZ1	588	-	44	198	840	0.2357143
A02	27737499	27738762	A02p43970.2_BraZ1	126.3	-	1	58	1263	0.0459224
A02	27743770	27744777	A02p43980.2_BraZ1	972	-	26	198	1007	0.1966236
A02	27746698	27747961	A02p43990.2_BraZ1	126.3	-	6	167	1263	0.1322249
A02	27751034	27752550	A02p44000.2_BraZ1	318	+	194	1139	1516	0.7513193
A02	27755845	27757108	A02p44010.2_BraZ1	126.3	-	28	452	1263	0.3578781
A02	27759017	27764274	A02p44020.2_BraZ1	3672.75	-	2517	4572	5257	0.8696976
A02	27769501	27770061	A02p44030.2_BraZ1	381	+	0	0	560	0.0000000
A02	27790264	27790885	A02p44040.2_BraZ1	62.1	-	663	621	621	1.0000000
A02	27795007	27796810	A02p44050.2_BraZ1	180.3	+	785	1745	1803	0.9678314
A02	27798657	27799029	A02p44060.2_BraZ1	37.2	-	82	334	372	0.8978494
A02	27801193	27801708	A02p44070.2_BraZ1	291	-	446	515	515	1.0000000
A02	27802411	27802756	A02p44080.2_BraZ1	34.5	+	150	345	345	1.0000000
A02	27804407	27805763	A02p44090.2_BraZ1	135.6	+	256	1272	1356	0.9380531
A02	27809286	27810837	A02p44100.2_BraZ1	155.1	+	166	1261	1551	0.8130239
A02	27814250	27816309	A02p44110.2_BraZ1	1223.42	+	984	2059	2059	1.0000000
A02	27817457	27820065	A02p44120.2_BraZ1	877.744	+	964	2287	2608	0.8769172
A02	27822496	27825858	A02p44130.2_BraZ1	1921.19	+	928	3284	3362	0.9767995
A02	27826119	27828017	A02p44140.2_BraZ1	1503	-	505	1871	1898	0.9857745
A02	27828491	27830765	A02p44150.2_BraZ1	1572.57	-	254	1606	2274	0.7062445
A02	27831863	27834292	A02p44160.2_BraZ1	270	-	1395	2429	2429	1.0000000
A02	27834614	27843399	A02p44170.2_BraZ1	6692.82	+	13321	8142	8785	0.9268070
A02	27846067	27849354	A02p44180.2_BraZ1	13065	-	160	2163	3287	0.6580468
A02	27861371	27863839	A02p44190.2_BraZ1	1974.79	-	1309	2447	2468	0.9914911
A02	27867622	27868582	A02p44200.2_BraZ1	786	-	434	848	960	0.8833333
A02	27870456	27871470	A02p44210.2_BraZ1	101.4	+	223	957	1014	0.9437870
A02	27874137	27874672	A02p44220.2_BraZ1	2929.5	-	200	431	535	0.8056075
A02	27880195	27881083	A02p44230.2_BraZ1	74.7	-	333	842	888	0.9481982
A02	27884176	27884617	A02p44240.2_BraZ1	44.1	-	348	441	441	1.0000000
A02	27888093	27891514	A02p44250.2_BraZ1	1832.07	+	1273	3403	3421	0.9947384
A02	27895914	27897304	A02p44260.2_BraZ1	886.673	+	254	1314	1390	0.9453238
A02	27900091	27900640	A02p44270.2_BraZ1	1116	-	785	549	549	1.0000000
A02	27900338	27908528	A02p44280.2_BraZ1	345.67	-	6240	8189	8190	0.9998779
A02	27911056	27911882	A02p44290.2_BraZ1	507	-	728	826	826	1.0000000
A02	27916796	27918139	A02p44300.2_BraZ1	464.625	-	1031	1310	1343	0.9754282
A02	27919131	27919748	A02p44310.2_BraZ1	80.4844	-	446	617	617	1.0000000
A02	27922767	27923398	A02p44320.2_BraZ1	233.763	-	604	631	631	1.0000000
A02	27925082	27925730	A02p44330.2_BraZ1	305.053	-	754	641	648	0.9891976
A02	27927460	27931800	A02p44340.2_BraZ1	686.438	-	3126	3615	4340	0.8329493
A02	27931812	27932546	A02p44350.2_BraZ1	86	-	771	734	734	1.0000000
A02	27934432	27934993	A02p44360.2_BraZ1	56.1	+	314	561	561	1.0000000
A02	27936533	27936836	A02p44370.2_BraZ1	30.3	-	368	303	303	1.0000000
A02	27936836	27937587	A02p44380.2_BraZ1	2255	-	628	751	751	1.0000000
A02	27938558	27940055	A02p44390.2_BraZ1	768	-	253	690	1497	0.4609219
A02	27942875	27943139	A02p44400.2_BraZ1	26.4	-	33	247	264	0.9356061
A02	27948551	27952501	A02p44410.2_BraZ1	2011.04	-	891	3427	3950	0.8675950
A02	27952891	27954262	A02p44420.2_BraZ1	641.125	+	480	1358	1371	0.9905179
A02	27954746	27955991	A02p44430.2_BraZ1	972	-	687	1245	1245	1.0000000
A02	27957866	27959488	A02p44440.2_BraZ1	954	+	386	1444	1622	0.8902590
A02	27960950	27963837	A02p44450.2_BraZ1	318	-	449	2602	2887	0.9012816
A02	27966471	27966777	A02p44460.2_BraZ1	30.6	-	54	306	306	1.0000000
A02	27976246	27977970	A02p44470.2_BraZ1	1281	-	240	1146	1724	0.6647332
A02	27981470	27981773	A02p44480.2_BraZ1	30.3	-	287	303	303	1.0000000
A02	27983101	27984068	A02p44490.2_BraZ1	176.786	-	353	967	967	1.0000000
A02	27984545	27985357	A02p44500.2_BraZ1	371.857	+	240	766	812	0.9433498
A02	27987657	27989698	A02p44510.2_BraZ1	558	-	816	1904	2041	0.9328761
A02	27988600	27988909	A02p44520.2_BraZ1	30.9	-	200	309	309	1.0000000
A02	27991731	27994627	A02p44530.2_BraZ1	1272.86	-	636	2719	2896	0.9388812
A02	27995753	27996941	A02p44540.2_BraZ1	363	-	1117	1188	1188	1.0000000
A02	27998458	27998569	A02p44550.2_BraZ1	11.1	+	267	111	111	1.0000000
A02	27999852	28000062	A02p44560.2_BraZ1	18.3	-	17	199	210	0.9476190
A02	28003027	28003486	A02p44570.2_BraZ1	45.9	-	146	415	459	0.9041395
A02	28003916	28004552	A02p44580.2_BraZ1	477.321	+	446	636	636	1.0000000
A02	28006346	28007362	A02p44590.2_BraZ1	924	+	166	666	1016	0.6555118
A02	28011408	28012161	A02p44600.2_BraZ1	75.3	+	811	753	753	1.0000000
A02	28012774	28014715	A02p44610.2_BraZ1	1280.51	-	1235	1941	1941	1.0000000
A02	28014954	28015513	A02p44620.2_BraZ1	330	+	609	559	559	1.0000000
A02	28015716	28016761	A02p44630.2_BraZ1	534	-	1591	1045	1045	1.0000000
A02	28017415	28018000	A02p44640.2_BraZ1	432	+	885	585	585	1.0000000
A02	28018450	28020078	A02p44650.2_BraZ1	16285.5	+	1028	1628	1628	1.0000000
A02	28021391	28025907	A02p44660.2_BraZ1	2488.96	+	3149	4500	4516	0.9964570
A02	28029100	28030003	A02p44670.2_BraZ1	741	+	618	716	903	0.7929125
A02	28032169	28032794	A02p44680.2_BraZ1	256.5	-	417	625	625	1.0000000
A02	28033163	28033994	A02p44690.2_BraZ1	378	-	1321	831	831	1.0000000
A02	28036973	28037336	A02p44700.2_BraZ1	36.3	+	315	363	363	1.0000000
A02	28038440	28038587	A02p44710.2_BraZ1	14.7	+	107	147	147	1.0000000
A02	28047363	28048472	A02p44720.2_BraZ1	990	-	370	1109	1109	1.0000000
A02	28056604	28057062	A02p44730.2_BraZ1	381	+	1316	458	458	1.0000000
A02	28057616	28062752	A02p44740.2_BraZ1	2437.73	-	10345	5136	5136	1.0000000
A02	28058723	28059371	A02p44750.2_BraZ1	64.8	-	1464	648	648	1.0000000
A02	28064108	28068717	A02p44760.2_BraZ1	1467.57	+	3063	4557	4609	0.9887177
A02	28069071	28071012	A02p44770.2_BraZ1	194.1	-	231	1706	1941	0.8789284
A02	28076727	28077604	A02p44780.2_BraZ1	765	-	50	662	877	0.7548460
A02	28080195	28081064	A02p44790.2_BraZ1	435.556	-	180	777	869	0.8941312
A02	28084153	28085488	A02p44800.2_BraZ1	133.5	-	194	916	1335	0.6861423
A02	28086232	28093942	A02p44810.2_BraZ1	236.25	-	3169	7448	7710	0.9660181
A02	28096008	28097264	A02p44820.2_BraZ1	354	+	261	1256	1256	1.0000000
A02	28102444	28104713	A02p44830.2_BraZ1	11907	+	821	2001	2269	0.8818863
A02	28105073	28105421	A02p44840.2_BraZ1	34.8	+	32	143	348	0.4109195
A02	28105902	28106203	A02p44850.2_BraZ1	23.4	+	189	301	301	1.0000000
A02	28112832	28115115	A02p44860.2_BraZ1	2097	+	74	1586	2283	0.6946999
A02	28117398	28117595	A02p44870.2_BraZ1	13.2	+	41	197	197	1.0000000
A02	28117941	28118782	A02p44880.2_BraZ1	972	-	211	792	841	0.9417360
A02	28119117	28119445	A02p44890.2_BraZ1	25.5	+	87	276	328	0.8414634
A02	28122047	28122921	A02p44900.2_BraZ1	466.078	+	670	874	874	1.0000000
A02	28134255	28134599	A02p44910.2_BraZ1	19.5	-	0	0	344	0.0000000
A02	28138948	28139293	A02p44920.2_BraZ1	19.5	-	3	223	345	0.6463768
A02	28143641	28143986	A02p44930.2_BraZ1	19.5	-	0	0	345	0.0000000
A02	28148328	28148674	A02p44940.2_BraZ1	19.5	-	1	128	346	0.3699422
A02	28153117	28153460	A02p44950.2_BraZ1	19.5	-	0	0	343	0.0000000
A02	28157897	28158242	A02p44960.2_BraZ1	19.5	-	0	0	345	0.0000000
A02	28162651	28162997	A02p44970.2_BraZ1	19.5	-	15	170	346	0.4913295
A02	28167453	28167797	A02p44980.2_BraZ1	19.5	-	0	0	344	0.0000000
A02	28172233	28172578	A02p44990.2_BraZ1	19.5	-	0	0	345	0.0000000
A02	28177018	28177363	A02p45000.2_BraZ1	19.5	-	4	222	345	0.6434783
A02	28182523	28182868	A02p45010.2_BraZ1	19.5	-	105	345	345	1.0000000
A02	28190103	28190329	A02p45020.2_BraZ1	120	+	24	175	226	0.7743363
A02	28190387	28196171	A02p45030.2_BraZ1	5137.44	-	1191	3838	5784	0.6635546
A02	28195701	28196771	A02p45040.2_BraZ1	360	-	118	771	1070	0.7205607
A02	28197824	28198548	A02p45050.2_BraZ1	5685.75	+	34	628	724	0.8674033
A02	28200720	28202322	A02p45060.2_BraZ1	1182.5	+	1262	1433	1602	0.8945069
A02	28205695	28206358	A02p45070.2_BraZ1	66.3	+	47	330	663	0.4977376
A02	28209708	28213264	A02p45080.2_BraZ1	2017.21	+	372	2191	3556	0.6161417
A02	28228586	28229371	A02p45090.2_BraZ1	1350	+	40	699	785	0.8904459
A02	28232299	28233319	A02p45100.2_BraZ1	780	-	19	530	1020	0.5196078
A02	28240019	28242672	A02p45110.2_BraZ1	1246.67	+	59	585	2653	0.2205051
A02	28246978	28248406	A02p45120.2_BraZ1	142.8	+	6	19	1428	0.0133053
A02	28252284	28252953	A02p45130.2_BraZ1	66.9	-	1213	669	669	1.0000000
A02	28253853	28255423	A02p45140.2_BraZ1	1310	-	1028	1570	1570	1.0000000
A02	28259644	28264087	A02p45150.2_BraZ1	2230.98	-	900	3769	4443	0.8483007
A02	28286627	28286828	A02p45160.2_BraZ1	20.1	-	139	201	201	1.0000000
A02	28294459	28297132	A02p45170.2_BraZ1	1326.31	+	625	2547	2673	0.9528620
A02	28301543	28301925	A02p45180.2_BraZ1	300	-	256	382	382	1.0000000
A02	28305898	28309635	A02p45190.2_BraZ1	7353	+	1579	3542	3737	0.9478191
A02	28322922	28323711	A02p45200.2_BraZ1	485	-	43	757	789	0.9594423
A02	28329910	28339202	A02p45210.2_BraZ1	1510.91	+	6065	8560	9292	0.9212226
A02	28336317	28336785	A02p45220.2_BraZ1	46.5	-	567	468	468	1.0000000
A02	28341204	28341722	A02p45230.2_BraZ1	450	+	663	518	518	1.0000000
A02	28342580	28344022	A02p45240.2_BraZ1	821.5	-	1780	1442	1442	1.0000000
A02	28344117	28345824	A02p45250.2_BraZ1	1527	-	1888	1707	1707	1.0000000
A02	28362236	28364798	A02p45260.2_BraZ1	1026.48	+	478	2237	2562	0.8731460
A02	28365723	28366925	A02p45270.2_BraZ1	432.286	-	494	1202	1202	1.0000000
A02	28369881	28370076	A02p45280.2_BraZ1	19.5	+	483	195	195	1.0000000
A02	28372948	28374896	A02p45290.2_BraZ1	933.699	+	322	1540	1948	0.7905544
A02	28375241	28377449	A02p45300.2_BraZ1	1331.14	-	770	2155	2208	0.9759964
A02	28387696	28387798	A02p45310.2_BraZ1	10.2	-	0	0	102	0.0000000
A02	28397897	28398413	A02p45320.2_BraZ1	51.6	+	18	205	516	0.3972868
A02	28406923	28407328	A02p45330.2_BraZ1	40.5	-	57	359	405	0.8864198
A02	28417423	28417768	A02p45340.2_BraZ1	34.5	+	8	60	345	0.1739130
A02	28418677	28418881	A02p45350.2_BraZ1	20.4	+	139	204	204	1.0000000
A02	28422704	28425050	A02p45360.2_BraZ1	1406.27	-	569	1808	2346	0.7706735
A02	28436015	28438165	A02p45370.2_BraZ1	1226.59	+	786	2150	2150	1.0000000
A02	28442326	28448407	A02p45380.2_BraZ1	2938.26	+	3192	5756	6081	0.9465548
A02	28448904	28449593	A02p45390.2_BraZ1	525	-	182	655	689	0.9506531
A02	28456688	28462749	A02p45400.2_BraZ1	1354.96	+	5116	5088	6061	0.8394654
A02	28464193	28464755	A02p45410.2_BraZ1	1230	-	369	562	562	1.0000000
A02	28466200	28467515	A02p45420.2_BraZ1	302.121	+	1070	1315	1315	1.0000000
A02	28478011	28482460	A02p45430.2_BraZ1	2483.76	+	313	2654	4449	0.5965385
A02	28483011	28483566	A02p45440.2_BraZ1	55.5	-	125	551	555	0.9927928
A02	28486221	28491050	A02p45450.2_BraZ1	461.437	-	2433	4731	4829	0.9797059
A02	28491493	28494984	A02p45460.2_BraZ1	1680	-	2097	3268	3491	0.9361215
A02	28496836	28502221	A02p45470.2_BraZ1	3258.93	-	1729	5183	5385	0.9624884
A02	28507136	28508587	A02p45480.2_BraZ1	10348	-	2	115	1451	0.0792557
A02	28523518	28524971	A02p45490.2_BraZ1	10348	-	0	0	1453	0.0000000
A02	28533931	28535384	A02p45500.2_BraZ1	7429.33	-	14	138	1453	0.0949759
A02	28544768	28546450	A02p45510.2_BraZ1	9462	-	321	1607	1682	0.9554102
A02	28550985	28551281	A02p45520.2_BraZ1	27.3	-	38	256	296	0.8648649
A02	28559079	28559550	A02p45530.2_BraZ1	47.1	-	2	52	471	0.1104034
A02	28569377	28570429	A02p45540.2_BraZ1	969	-	140	925	1052	0.8792776
A02	28572572	28572872	A02p45550.2_BraZ1	30	+	120	300	300	1.0000000
A02	28586003	28586309	A02p45560.2_BraZ1	30.6	+	181	306	306	1.0000000
A02	28588300	28588606	A02p45570.2_BraZ1	30.6	+	58	226	306	0.7385621
A02	28592577	28592886	A02p45580.2_BraZ1	30.9	+	156	309	309	1.0000000
A02	28594881	28597468	A02p45590.2_BraZ1	1123.81	-	1862	2579	2587	0.9969076
A02	28598553	28600057	A02p45600.2_BraZ1	105.6	-	682	1447	1504	0.9621010
A02	28600073	28600694	A02p45610.2_BraZ1	222	-	258	621	621	1.0000000
A02	28606539	28607508	A02p45620.2_BraZ1	96.9	-	20	611	969	0.6305469
A02	28612085	28612424	A02p45630.2_BraZ1	33.9	-	460	339	339	1.0000000
A02	28613180	28613342	A02p45640.2_BraZ1	16.2	+	277	162	162	1.0000000
A02	28613505	28613913	A02p45650.2_BraZ1	40.8	+	221	408	408	1.0000000
A02	28614787	28625168	A02p45660.2_BraZ1	672	+	2289	8401	10381	0.8092669
A02	28630446	28630857	A02p45670.2_BraZ1	41.1	+	161	386	411	0.9391727
A02	28633217	28633801	A02p45680.2_BraZ1	540	-	622	584	584	1.0000000
A02	28636167	28639248	A02p45690.2_BraZ1	308.1	+	23	371	3081	0.1204154
A02	28643841	28646056	A02p45700.2_BraZ1	1872	-	396	1244	2215	0.5616253
A02	28647648	28649943	A02p45710.2_BraZ1	1517.73	+	506	1980	2295	0.8627451
A02	28650728	28668584	A02p45720.2_BraZ1	3206.51	+	5288	12723	17856	0.7125336
A02	28655897	28656895	A02p45730.2_BraZ1	5791.5	-	36	229	998	0.2294589
A02	28670856	28672632	A02p45740.2_BraZ1	907.74	+	655	1712	1776	0.9639640
A02	28672052	28674341	A02p45750.2_BraZ1	312.624	+	1301	2266	2289	0.9899520
A02	28677722	28678949	A02p45760.2_BraZ1	122.7	+	6	242	1227	0.1972290
A02	28679190	28679686	A02p45770.2_BraZ1	402	+	61	456	496	0.9193549
A02	28682608	28683654	A02p45780.2_BraZ1	1536	+	527	1044	1046	0.9980879
A02	28683982	28686595	A02p45790.2_BraZ1	1685.83	-	612	2337	2613	0.8943743
A02	28688871	28689494	A02p45800.2_BraZ1	519	+	296	566	623	0.9085072
A02	28692021	28692720	A02p45810.2_BraZ1	459	+	308	699	699	1.0000000
A02	28693398	28693713	A02p45820.2_BraZ1	31.5	-	663	315	315	1.0000000
A02	28698375	28699051	A02p45830.2_BraZ1	501	+	163	654	676	0.9674556
A02	28704836	28705262	A02p45840.2_BraZ1	42.6	+	188	347	426	0.8145540
A02	28708359	28717167	A02p45850.2_BraZ1	4148.37	+	2761	8084	8808	0.9178020
A02	28719220	28721461	A02p45860.2_BraZ1	1257	+	857	2116	2241	0.9442213
A02	28724888	28726055	A02p45870.2_BraZ1	473.673	-	1555	1167	1167	1.0000000
A02	28728631	28729835	A02p45880.2_BraZ1	412.5	-	1034	1204	1204	1.0000000
A02	28730416	28733988	A02p45890.2_BraZ1	2006.74	-	915	2912	3572	0.8152295
A02	28733962	28735231	A02p45900.2_BraZ1	660.706	-	270	1169	1269	0.9211978
A02	28738687	28740035	A02p45910.2_BraZ1	4579.2	-	501	1348	1348	1.0000000
A02	28750429	28751752	A02p45920.2_BraZ1	1239	+	230	994	1323	0.7513227
A02	28754552	28754882	A02p45930.2_BraZ1	33	+	392	330	330	1.0000000
A02	28755617	28757084	A02p45940.2_BraZ1	523.875	-	838	1277	1467	0.8704840
A02	28761108	28762996	A02p45950.2_BraZ1	607.2	-	1284	1870	1888	0.9904661
A02	28763855	28764565	A02p45960.2_BraZ1	55.8	-	712	710	710	1.0000000
A02	28765642	28766518	A02p45970.2_BraZ1	660	+	600	868	876	0.9908676
A02	28767215	28769144	A02p45980.2_BraZ1	627.9	+	1135	1921	1929	0.9958528
A02	28769664	28771445	A02p45990.2_BraZ1	589.636	-	1903	1781	1781	1.0000000
A02	28773621	28774885	A02p46000.2_BraZ1	690	+	1601	1264	1264	1.0000000
A02	28775534	28777387	A02p46010.2_BraZ1	5616	-	477	1553	1853	0.8381004
A02	28784809	28786706	A02p46020.2_BraZ1	1350.51	-	293	1755	1897	0.9251450
A02	28788350	28788776	A02p46030.2_BraZ1	42.6	-	645	426	426	1.0000000
A02	28789192	28791134	A02p46040.2_BraZ1	824.692	-	812	1524	1942	0.7847580
A02	28803699	28803852	A02p46050.2_BraZ1	15.3	+	228	153	153	1.0000000
A02	28807066	28807943	A02p46060.2_BraZ1	243.659	+	641	877	877	1.0000000
A02	28808144	28810379	A02p46070.2_BraZ1	1213.13	-	659	2170	2235	0.9709172
A02	28812665	28813163	A02p46080.2_BraZ1	49.8	+	332	498	498	1.0000000
A02	28816014	28819720	A02p46090.2_BraZ1	15833.2	+	1129	3030	3706	0.8175931
A02	28825413	28826980	A02p46100.2_BraZ1	868.065	-	330	1170	1567	0.7466496
A02	28830167	28834757	A02p46110.2_BraZ1	350	+	3948	4590	4590	1.0000000
A02	28830813	28831444	A02p46120.2_BraZ1	135	+	598	631	631	1.0000000
A02	28832206	28832595	A02p46130.2_BraZ1	225	-	309	389	389	1.0000000
A02	28837855	28841496	A02p46140.2_BraZ1	1713.57	+	2455	3641	3641	1.0000000
A02	28842268	28845394	A02p46150.2_BraZ1	1442.57	+	2973	2975	3126	0.9516954
A02	28845836	28852969	A02p46160.2_BraZ1	2535.94	-	2442	6178	7133	0.8661152
A02	28853872	28854406	A02p46170.2_BraZ1	50.4	+	33	448	534	0.8389513
A02	28855142	28856516	A02p46180.2_BraZ1	137.4	-	321	1162	1374	0.8457060
A02	28859731	28861269	A02p46190.2_BraZ1	641.55	+	70	603	1538	0.3920676
A02	28864409	28865474	A02p46200.2_BraZ1	106.5	-	812	1065	1065	1.0000000
A02	28868553	28869041	A02p46210.2_BraZ1	258	+	161	488	488	1.0000000
A02	28870300	28876307	A02p46220.2_BraZ1	3220.38	+	1616	4996	6007	0.8316963
A02	28882174	28882765	A02p46230.2_BraZ1	522	-	167	591	591	1.0000000
A02	28883638	28885932	A02p46240.2_BraZ1	8565	-	330	1798	2294	0.7837838
A02	28889881	28891011	A02p46250.2_BraZ1	6237	+	1014	1130	1130	1.0000000
A02	28891792	28892108	A02p46260.2_BraZ1	258	-	204	316	316	1.0000000
A02	28893809	28896195	A02p46270.2_BraZ1	1026.81	+	1352	2386	2386	1.0000000
A02	28897431	28899199	A02p46280.2_BraZ1	1105.23	+	1292	1659	1768	0.9383484
A02	28908622	28911589	A02p46290.2_BraZ1	1230.97	+	1079	2388	2967	0.8048534
A02	28915882	28916441	A02p46300.2_BraZ1	50.1	-	171	521	559	0.9320214
A02	28919241	28919825	A02p46310.2_BraZ1	352.5	-	271	584	584	1.0000000
A02	28921061	28923229	A02p46320.2_BraZ1	1599	-	724	2027	2168	0.9349631
A02	28923877	28925387	A02p46330.2_BraZ1	738.818	-	844	1510	1510	1.0000000
A02	28927190	28936057	A02p46340.2_BraZ1	2744.8	-	3554	8236	8867	0.9288372
A02	28942586	28948089	A02p46350.2_BraZ1	806.942	+	2603	4123	5503	0.7492277
A02	28948124	28948373	A02p46360.2_BraZ1	24.9	-	136	249	249	1.0000000
A02	28949141	28951339	A02p46370.2_BraZ1	872.308	+	1293	2100	2198	0.9554140
A02	28951610	28951772	A02p46380.2_BraZ1	16.2	-	252	162	162	1.0000000
A02	28954735	28962972	A02p46390.2_BraZ1	5020.08	-	1177	6630	8237	0.8049047
A02	28969274	28972504	A02p46400.2_BraZ1	1533.38	+	3079	3129	3230	0.9687306
A02	28975197	28975867	A02p46410.2_BraZ1	445.2	+	622	670	670	1.0000000
A02	28984634	28985078	A02p46420.2_BraZ1	44.4	+	0	0	444	0.0000000
A02	28986238	28990375	A02p46430.2_BraZ1	1034.55	-	1477	3033	4137	0.7331399
A02	28992303	28992752	A02p46440.2_BraZ1	42.3	-	141	449	449	1.0000000
A02	29007886	29009413	A02p46450.2_BraZ1	472.5	+	1224	1527	1527	1.0000000
A02	29009386	29010447	A02p46460.2_BraZ1	542.455	-	352	1046	1061	0.9858624
A02	29011590	29012504	A02p46470.2_BraZ1	450	-	4991	914	914	1.0000000
A02	29013283	29013427	A02p46480.2_BraZ1	14.4	-	161	144	144	1.0000000
A02	29014176	29015467	A02p46490.2_BraZ1	420	+	1281	1291	1291	1.0000000
A02	29043641	29052984	A02p46500.2_BraZ1	1221.87	+	1031	4207	9343	0.4502836
A02	29064170	29064628	A02p46510.2_BraZ1	35.1	-	489	458	458	1.0000000
A02	29067959	29068475	A02p46520.2_BraZ1	51.6	+	89	516	516	1.0000000
A02	29069157	29070249	A02p46530.2_BraZ1	109.2	-	172	1083	1092	0.9917582
A02	29074002	29075881	A02p46540.2_BraZ1	957	-	364	1645	1879	0.8754657
A02	29083215	29085107	A02p46550.2_BraZ1	616.62	-	1542	1892	1892	1.0000000
A02	29086915	29093605	A02p46560.2_BraZ1	1355.47	+	2525	6538	6690	0.9772795
A02	29096260	29098058	A02p46570.2_BraZ1	865.565	+	914	1676	1798	0.9321468
A02	29098958	29099898	A02p46580.2_BraZ1	34.8	+	264	672	940	0.7148936
A02	29100282	29103604	A02p46590.2_BraZ1	6306.6	-	1461	3267	3322	0.9834437
A02	29106001	29106745	A02p46600.2_BraZ1	207	-	673	744	744	1.0000000
A02	29107425	29110365	A02p46610.2_BraZ1	2565	+	455	2701	2940	0.9187075
A02	29113566	29114720	A02p46620.2_BraZ1	1014	+	371	1116	1154	0.9670711
A02	29122106	29123867	A02p46630.2_BraZ1	618	+	1747	1761	1761	1.0000000
A02	29125780	29126333	A02p46640.2_BraZ1	534	-	624	553	553	1.0000000
A02	29133439	29133835	A02p46650.2_BraZ1	39.6	-	699	396	396	1.0000000
A02	29138000	29138228	A02p46660.2_BraZ1	22.8	-	23	215	228	0.9429824
A02	29138444	29140346	A02p46670.2_BraZ1	508.75	+	167	942	1902	0.4952681
A02	29140964	29143137	A02p46680.2_BraZ1	927.886	+	1500	2122	2173	0.9765301
A02	29144241	29146966	A02p46690.2_BraZ1	4128	+	1664	2704	2725	0.9922936
A02	29154375	29154951	A02p46700.2_BraZ1	57.6	+	24	271	576	0.4704861
A02	29159508	29162436	A02p46710.2_BraZ1	1694.09	-	340	1936	2928	0.6612022
A02	29164003	29165446	A02p46720.2_BraZ1	1311	-	225	1193	1443	0.8267498
A02	29170292	29172590	A02p46730.2_BraZ1	1824	+	253	1574	2298	0.6849434
A02	29176195	29179821	A02p46740.2_BraZ1	1256.75	+	1637	3518	3626	0.9702151
A02	29181061	29185096	A02p46750.2_BraZ1	1542.27	+	2288	3878	4035	0.9610904
A02	29185633	29186362	A02p46760.2_BraZ1	546	+	354	729	729	1.0000000
A02	29186494	29197814	A02p46770.2_BraZ1	4539.23	-	4944	10427	11320	0.9211131
A02	29201115	29201446	A02p46780.2_BraZ1	252	+	0	0	331	0.0000000
A02	29205779	29208270	A02p46790.2_BraZ1	1405.09	+	1052	2473	2491	0.9927740
A02	29211125	29211926	A02p46800.2_BraZ1	79.8	+	328	801	801	1.0000000
A02	29217220	29220374	A02p46810.2_BraZ1	1445.76	+	1926	3092	3154	0.9803424
A02	29222756	29225429	A02p46820.2_BraZ1	267.3	+	1400	2558	2673	0.9569772
A02	29229345	29232042	A02p46830.2_BraZ1	2628	+	1594	2020	2697	0.7489803
A02	29256855	29277401	A02p46840.2_BraZ1	1216.99	+	7094	19743	20546	0.9609170
A02	29278030	29279636	A02p46850.2_BraZ1	828	-	1477	1606	1606	1.0000000
A02	29287856	29295010	A02p46860.2_BraZ1	1293.41	+	4970	7154	7154	1.0000000
A02	29308829	29309139	A02p46870.2_BraZ1	207	-	294	310	310	1.0000000
A02	29309648	29314754	A02p46880.2_BraZ1	1330.64	+	1624	4198	5106	0.8221700
A02	29334918	29336064	A02p46890.2_BraZ1	114.6	+	119	834	1146	0.7277487
A02	29341063	29344911	A02p46900.2_BraZ1	791.667	+	3260	3848	3848	1.0000000
A02	29346037	29347683	A02p46910.2_BraZ1	13176	-	931	1646	1646	1.0000000
A02	29348439	29350656	A02p46920.2_BraZ1	1356	+	1094	2067	2217	0.9323410
A02	29352053	29356690	A02p46930.2_BraZ1	1881.45	+	2974	4532	4637	0.9773561
A02	29357448	29360830	A02p46940.2_BraZ1	1792.86	-	2743	3382	3382	1.0000000
A02	29367214	29376465	A02p46950.2_BraZ1	2855.36	+	6321	9041	9251	0.9772997
A02	29377515	29381963	A02p46960.2_BraZ1	1811.9	+	2235	3947	4448	0.8873651
A02	29382508	29382649	A02p46970.2_BraZ1	14.1	+	317	141	141	1.0000000
A02	29383540	29384100	A02p46980.2_BraZ1	474	-	265	560	560	1.0000000
A02	29390961	29393474	A02p46990.2_BraZ1	934.615	-	1753	2513	2513	1.0000000
A02	29393943	29395179	A02p47000.2_BraZ1	1049.59	+	1107	1236	1236	1.0000000
A02	29396104	29396572	A02p47010.2_BraZ1	237.143	-	206	468	468	1.0000000
A02	29397762	29400196	A02p47020.2_BraZ1	1169.9	+	1310	2434	2434	1.0000000
A02	29406888	29409762	A02p47030.2_BraZ1	1030.46	+	1907	2869	2874	0.9982603
A02	29412956	29413389	A02p47040.2_BraZ1	393	+	352	402	433	0.9284065
A02	29420241	29420586	A02p47050.2_BraZ1	34.5	+	271	345	345	1.0000000
A02	29423232	29424694	A02p47060.2_BraZ1	751.304	-	1148	1462	1462	1.0000000
A02	29425001	29426085	A02p47070.2_BraZ1	493.099	+	523	1084	1084	1.0000000
A02	29429611	29430433	A02p47080.2_BraZ1	82.2	+	130	629	822	0.7652068
A02	29435144	29435588	A02p47090.2_BraZ1	44.4	+	18	212	444	0.4774775
A02	29439002	29441103	A02p47100.2_BraZ1	1077.64	-	140	1256	2101	0.5978106
A02	29441131	29445466	A02p47110.2_BraZ1	394	-	1879	4161	4335	0.9598616
A02	29446697	29450121	A02p47120.2_BraZ1	12490.5	-	1364	3305	3424	0.9652453
A02	29454576	29454786	A02p47130.2_BraZ1	21	+	168	210	210	1.0000000
A02	29459083	29465636	A02p47140.2_BraZ1	3096.23	+	1638	5358	6553	0.8176408
A02	29467749	29467941	A02p47150.2_BraZ1	19.2	-	129	192	192	1.0000000
A02	29471652	29473366	A02p47160.2_BraZ1	63.6	-	1510	1714	1714	1.0000000
A02	29474230	29474751	A02p47170.2_BraZ1	375	-	597	521	521	1.0000000
A02	29476181	29483118	A02p47180.2_BraZ1	1536.8	-	1089	4786	6937	0.6899236
A02	29490390	29492880	A02p47190.2_BraZ1	1916.36	+	1868	2445	2490	0.9819277
A02	29494533	29500352	A02p47200.2_BraZ1	2382.47	-	2906	5596	5819	0.9616773
A02	29502791	29503568	A02p47210.2_BraZ1	7392	-	11	190	777	0.2445302
A02	29506896	29510291	A02p47220.2_BraZ1	1709.19	-	1037	3162	3395	0.9313697
A02	29512030	29512486	A02p47230.2_BraZ1	45.6	-	3	66	456	0.1447368
A02	29513093	29513560	A02p47240.2_BraZ1	207	-	174	467	467	1.0000000
A02	29515744	29519745	A02p47250.2_BraZ1	2370.69	+	2615	4001	4001	1.0000000
A02	29523875	29524136	A02p47260.2_BraZ1	26.1	+	89	261	261	1.0000000
A02	29529110	29529761	A02p47270.2_BraZ1	65.1	-	152	626	651	0.9615976
A02	29532989	29533412	A02p47280.2_BraZ1	3616	+	136	404	423	0.9550827
A02	29533837	29534236	A02p47290.2_BraZ1	141	-	18	255	399	0.6390978
A02	29535228	29536422	A02p47300.2_BraZ1	615	-	1112	1194	1194	1.0000000
A02	29538220	29539339	A02p47310.2_BraZ1	111.9	-	22	673	1119	0.6014298
A02	29540623	29540969	A02p47320.2_BraZ1	171	-	18	147	346	0.4248555
A02	29541328	29544067	A02p47330.2_BraZ1	1130.91	-	940	2186	2739	0.7981015
A02	29547642	29548896	A02p47340.2_BraZ1	1164	-	40	604	1254	0.4816587
A02	29553467	29553813	A02p47350.2_BraZ1	171	-	25	235	346	0.6791908
A02	29561797	29565121	A02p47360.2_BraZ1	1165.28	-	813	2697	3324	0.8113719
A02	29571404	29572661	A02p47370.2_BraZ1	1167	-	192	1245	1257	0.9904535
A02	29574326	29574672	A02p47380.2_BraZ1	283.5	-	477	159	346	0.4595376
A02	29575039	29577771	A02p47390.2_BraZ1	1071.68	-	3592	2699	2732	0.9879209
A02	29580038	29580512	A02p47400.2_BraZ1	47.4	-	92	324	474	0.6835443
A02	29583236	29583782	A02p47410.2_BraZ1	54.6	-	75	428	546	0.7838828
A02	29585556	29586087	A02p47420.2_BraZ1	53.1	-	50	286	531	0.5386064
A02	29589106	29592272	A02p47430.2_BraZ1	2034.89	-	871	2714	3166	0.8572331
A02	29593730	29594742	A02p47440.2_BraZ1	507	-	325	920	1012	0.9090909
A02	29595988	29596373	A02p47450.2_BraZ1	237	+	0	0	385	0.0000000
A02	29601322	29604635	A02p47460.2_BraZ1	1414.32	+	2159	3313	3313	1.0000000
A02	29606118	29607733	A02p47470.2_BraZ1	775.5	-	846	1603	1615	0.9925697
A02	29610910	29616739	A02p47480.2_BraZ1	791.2	+	2569	5805	5829	0.9958826
A02	29618357	29631402	A02p47490.2_BraZ1	579.545	+	4682	9016	13045	0.6911460
A02	29633644	29634783	A02p47500.2_BraZ1	567	-	202	936	1139	0.8217735
A02	29637227	29644429	A02p47510.2_BraZ1	3187.58	+	2704	6467	7202	0.8979450
A02	29647447	29648705	A02p47520.2_BraZ1	601.864	+	278	1213	1258	0.9642289
A02	29650769	29651676	A02p47530.2_BraZ1	174	-	370	907	907	1.0000000
A02	29652579	29652843	A02p47540.2_BraZ1	26.4	+	31	264	264	1.0000000
A02	29655608	29655872	A02p47550.2_BraZ1	26.4	+	100	264	264	1.0000000
A02	29656387	29660112	A02p47560.2_BraZ1	1991.83	-	1483	3725	3725	1.0000000
A02	29661739	29663871	A02p47570.2_BraZ1	1202.79	+	1255	2030	2132	0.9521576
A02	29664838	29667360	A02p47580.2_BraZ1	1701	+	420	1912	2522	0.7581285
A02	29668307	29668655	A02p47590.2_BraZ1	34.8	+	258	348	348	1.0000000
A02	29673620	29674277	A02p47600.2_BraZ1	348	+	0	0	657	0.0000000
A02	29674959	29676433	A02p47610.2_BraZ1	912	+	0	0	1474	0.0000000
A02	29677876	29679446	A02p47620.2_BraZ1	1200	-	2	19	1570	0.0121019
A02	29680987	29683020	A02p47630.2_BraZ1	270	-	100	264	2033	0.1298573
A02	29683191	29690043	A02p47640.2_BraZ1	2177.1	-	1	44	6852	0.0064215
A02	29692540	29696874	A02p47650.2_BraZ1	2037.63	+	766	3891	4334	0.8977849
A02	29697055	29697886	A02p47660.2_BraZ1	657	-	420	781	831	0.9398316
A02	29698806	29699305	A02p47670.2_BraZ1	417	+	177	499	499	1.0000000
A02	29699574	29699910	A02p47680.2_BraZ1	162	-	275	336	336	1.0000000
A02	29699932	29701002	A02p47690.2_BraZ1	546	-	1162	1070	1070	1.0000000
A02	29706304	29707510	A02p47700.2_BraZ1	1011	-	125	848	1206	0.7031509
A02	29720469	29721651	A02p47710.2_BraZ1	118.2	+	348	1182	1182	1.0000000
A02	29731186	29732269	A02p47720.2_BraZ1	108.3	+	789	1083	1083	1.0000000
A02	29737265	29739987	A02p47730.2_BraZ1	1144.56	+	512	2404	2722	0.8831741
A02	29740366	29740712	A02p47740.2_BraZ1	171	+	79	320	346	0.9248555
A02	29743701	29746530	A02p47750.2_BraZ1	939.462	+	3022	2829	2829	1.0000000
A02	29747193	29749195	A02p47760.2_BraZ1	1172.36	+	1842	2002	2002	1.0000000
A02	29750719	29752807	A02p47770.2_BraZ1	618	+	647	1788	2088	0.8563218
A02	29753524	29754217	A02p47780.2_BraZ1	324.5	+	509	693	693	1.0000000
A02	29754812	29758360	A02p47790.2_BraZ1	3015	-	1158	3487	3548	0.9828072
A02	29763774	29795202	A02p47800.2_BraZ1	1175.32	+	14312	26785	31428	0.8522655
A02	29765357	29765634	A02p47810.2_BraZ1	186	-	32	218	277	0.7870036
A02	29775291	29777780	A02p47820.2_BraZ1	1469.57	-	289	1758	2489	0.7063078
A02	29780602	29781279	A02p47830.2_BraZ1	1029	-	169	646	677	0.9542097
A02	29781626	29782221	A02p47840.2_BraZ1	222	-	162	572	595	0.9613445
A02	29791832	29792135	A02p47850.2_BraZ1	30.3	-	348	303	303	1.0000000
A02	29799246	29801114	A02p47860.2_BraZ1	920.067	+	190	1372	1868	0.7344754
A02	29802738	29805961	A02p47870.2_BraZ1	1543.64	+	2719	3223	3223	1.0000000
A02	29807026	29809107	A02p47880.2_BraZ1	450.058	+	1665	2069	2081	0.9942335
A02	29821903	29823802	A02p47890.2_BraZ1	790.214	+	894	1840	1899	0.9689310
A02	29842715	29845084	A02p47900.2_BraZ1	1299.22	+	943	2005	2369	0.8463486
A02	29854546	29856675	A02p47910.2_BraZ1	1183.4	+	471	1749	2129	0.8215125
A02	29858211	29860061	A02p47920.2_BraZ1	854.973	-	341	1116	1850	0.6032432
A02	29863383	29864630	A02p47930.2_BraZ1	277.977	+	1218	1247	1247	1.0000000
A02	29865356	29866745	A02p47940.2_BraZ1	1002	+	235	1054	1389	0.7588193
A02	29868007	29869995	A02p47950.2_BraZ1	1458	+	570	1893	1988	0.9522133
A02	29870676	29871846	A02p47960.2_BraZ1	117	-	162	969	1170	0.8282051
A02	29874842	29876055	A02p47970.2_BraZ1	289.957	-	339	975	1213	0.8037922
A02	29879392	29880654	A02p47980.2_BraZ1	592	+	449	1250	1262	0.9904913
A02	29881502	29883696	A02p47990.2_BraZ1	1260.82	-	373	1862	2194	0.8486782
A02	29886064	29886910	A02p48000.2_BraZ1	342.24	-	324	846	846	1.0000000
A02	29898390	29899431	A02p48010.2_BraZ1	104.1	-	260	789	1041	0.7579251
A02	29900509	29900888	A02p48020.2_BraZ1	204	-	33	259	379	0.6833773
A02	29901044	29901203	A02p48030.2_BraZ1	15.9	-	0	0	159	0.0000000
A02	29901890	29905712	A02p48040.2_BraZ1	2204.46	+	806	2891	3822	0.7564102
A02	29906962	29909248	A02p48050.2_BraZ1	498	+	773	2100	2286	0.9186352
A02	29909990	29911076	A02p48060.2_BraZ1	615	-	221	1064	1086	0.9797422
A02	29911994	29914097	A02p48070.2_BraZ1	1008	-	816	1617	2103	0.7689016
A02	29914329	29914482	A02p48080.2_BraZ1	15.3	+	193	153	153	1.0000000
A02	29919123	29919447	A02p48090.2_BraZ1	243	+	0	0	324	0.0000000
A02	29925757	29926973	A02p48100.2_BraZ1	735	-	909	1216	1216	1.0000000
A02	29933845	29935804	A02p48110.2_BraZ1	1023.31	+	763	1892	1959	0.9657989
A02	29936181	29941170	A02p48120.2_BraZ1	2037.05	+	1021	3994	4989	0.8005612
A02	29941507	29943588	A02p48130.2_BraZ1	1276.72	-	603	1871	2081	0.8990870
A02	29946966	29947344	A02p48140.2_BraZ1	37.8	+	181	378	378	1.0000000
A02	29948445	29950525	A02p48150.2_BraZ1	1087.8	-	1224	2080	2080	1.0000000
A02	29968501	29969155	A02p48160.2_BraZ1	528	+	206	620	654	0.9480122
A02	29978351	29979915	A02p48170.2_BraZ1	1491	+	289	1348	1564	0.8618926
A02	29980621	29981335	A02p48180.2_BraZ1	219	+	92	668	714	0.9355742
A02	29985118	29986668	A02p48190.2_BraZ1	2683.8	+	263	1311	1550	0.8458065
A02	29986937	29987781	A02p48200.2_BraZ1	651	-	79	615	844	0.7286730
A02	29992032	29992779	A02p48210.2_BraZ1	74.7	-	13	352	747	0.4712182
A02	29993293	29993485	A02p48220.2_BraZ1	19.2	-	34	95	192	0.4947917
A02	29995533	30000058	A02p48230.2_BraZ1	1912.07	-	1456	4133	4525	0.9133702
A02	30000765	30002336	A02p48240.2_BraZ1	1491	-	236	1156	1571	0.7358370
A02	30003763	30004183	A02p48250.2_BraZ1	42	+	530	420	420	1.0000000
A02	30007513	30007981	A02p48260.2_BraZ1	46.8	-	37	163	468	0.3482906
A02	30011971	30014100	A02p48270.2_BraZ1	1210.78	-	755	2100	2129	0.9863786
A02	30017171	30018281	A02p48280.2_BraZ1	5655	+	847	1110	1110	1.0000000
A02	30020746	30029535	A02p48290.2_BraZ1	2406.4	+	3225	8501	8789	0.9672318
A02	30029535	30029823	A02p48300.2_BraZ1	117	+	478	288	288	1.0000000
A02	30033726	30033885	A02p48310.2_BraZ1	15.9	-	426	159	159	1.0000000
A02	30045922	30046684	A02p48320.2_BraZ1	1575	+	293	762	762	1.0000000
A02	30048852	30050581	A02p48330.2_BraZ1	948.125	+	763	1625	1729	0.9398496
A02	30055244	30055655	A02p48340.2_BraZ1	276	-	705	411	411	1.0000000
A02	30056064	30056342	A02p48350.2_BraZ1	16.2	-	263	278	278	1.0000000
A02	30066991	30068618	A02p48360.2_BraZ1	472.731	+	1105	1622	1627	0.9969268
A02	30071494	30072214	A02p48370.2_BraZ1	3240	+	338	708	720	0.9833333
A02	30074872	30077036	A02p48380.2_BraZ1	741	-	2016	2164	2164	1.0000000
A02	30083864	30089843	A02p48390.2_BraZ1	2836.6	+	3440	5810	5979	0.9717344
A02	30092376	30093569	A02p48400.2_BraZ1	870	-	223	1030	1193	0.8633696
A02	30100079	30102831	A02p48410.2_BraZ1	1507.41	+	1403	2109	2752	0.7663518
A02	30106447	30106883	A02p48420.2_BraZ1	405	+	74	301	436	0.6903670
A02	30108665	30109752	A02p48430.2_BraZ1	741	+	16	372	1087	0.3422263
A02	30118823	30120072	A02p48440.2_BraZ1	862.023	+	1129	1249	1249	1.0000000
A02	30122158	30128658	A02p48450.2_BraZ1	2137.01	+	4399	6200	6500	0.9538462
A02	30130142	30133683	A02p48460.2_BraZ1	1386	+	862	3119	3541	0.8808246
A02	30136706	30137417	A02p48470.2_BraZ1	240	+	107	644	711	0.9057665
A02	30142800	30144205	A02p48480.2_BraZ1	1317	-	182	1387	1405	0.9871886
A02	30144348	30145936	A02p48490.2_BraZ1	242.76	-	1855	1588	1588	1.0000000
A02	30146285	30146732	A02p48500.2_BraZ1	44.7	-	82	366	447	0.8187919
A02	30158149	30159015	A02p48510.2_BraZ1	405	+	3	247	866	0.2852194
A02	30159687	30164942	A02p48520.2_BraZ1	28.5	-	293	3163	5255	0.6019030
A02	30164942	30168980	A02p48530.2_BraZ1	264	-	97	2608	4038	0.6458643
A02	30169800	30170942	A02p48540.2_BraZ1	76.2	-	6	486	1142	0.4255692
A02	30170869	30173215	A02p48550.2_BraZ1	155.1	-	58	1141	2346	0.4863598
A02	30173967	30175925	A02p48560.2_BraZ1	149.1	-	134	1122	1958	0.5730337
A02	30176496	30178067	A02p48570.2_BraZ1	738	+	11	327	1571	0.2081477
A02	30191265	30191917	A02p48580.2_BraZ1	249	+	163	652	652	1.0000000
A02	30194673	30196323	A02p48590.2_BraZ1	671.087	+	882	1649	1650	0.9993939
A02	30205396	30205609	A02p48600.2_BraZ1	21.3	+	61	213	213	1.0000000
A02	30207510	30215941	A02p48610.2_BraZ1	1026	-	6236	8285	8431	0.9826829
A02	30225334	30226725	A02p48620.2_BraZ1	180	+	1068	1375	1391	0.9884975
A02	30230775	30231246	A02p48630.2_BraZ1	47.1	+	92	430	471	0.9129512
A02	30231717	30240602	A02p48640.2_BraZ1	802.286	-	1238	3600	8885	0.4051773
A02	30239968	30240836	A02p48650.2_BraZ1	150	-	124	637	868	0.7338710
A02	30245177	30248483	A02p48660.2_BraZ1	1373.14	+	20	278	3306	0.0840895
A02	30250314	30250880	A02p48670.2_BraZ1	255	+	21	530	566	0.9363958
A02	30252618	30252981	A02p48680.2_BraZ1	36.3	-	28	233	363	0.6418733
A02	30270644	30271417	A02p48690.2_BraZ1	309	+	265	666	773	0.8615783
A02	30272545	30273873	A02p48700.2_BraZ1	922.821	+	320	1075	1328	0.8094879
A02	30283218	30285256	A02p48710.2_BraZ1	1413.12	+	1675	2038	2038	1.0000000
A02	30285482	30289284	A02p48720.2_BraZ1	1477.97	-	2540	3679	3802	0.9676486
A02	30300300	30301099	A02p48730.2_BraZ1	306	-	241	773	799	0.9674593
A02	30302944	30303070	A02p48740.2_BraZ1	12.6	+	49	77	126	0.6111111
A02	30303278	30306186	A02p48750.2_BraZ1	2712	+	1191	2768	2908	0.9518570
A02	30306729	30307039	A02p48760.2_BraZ1	16.2	-	330	219	310	0.7064516
A02	30310805	30313989	A02p48770.2_BraZ1	4338	+	85	1093	3184	0.3432789
A02	30318010	30321664	A02p48780.2_BraZ1	21560	+	1493	3356	3654	0.9184455
A02	30322429	30322600	A02p48790.2_BraZ1	15.9	-	325	171	171	1.0000000
A02	30326652	30326949	A02p48800.2_BraZ1	26.7	-	45	190	297	0.6397306
A02	30327025	30327569	A02p48810.2_BraZ1	378	-	134	515	544	0.9466912
A02	30331517	30334823	A02p48820.2_BraZ1	36130.5	+	10	313	3306	0.0946763
A02	30338740	30342431	A02p48830.2_BraZ1	326.4	+	1562	2925	3691	0.7924682
A02	30345690	30348841	A02p48840.2_BraZ1	274.8	+	1306	3022	3151	0.9590606
A02	30349765	30351570	A02p48850.2_BraZ1	378	-	819	1681	1805	0.9313020
A02	30354281	30355009	A02p48860.2_BraZ1	1069.2	+	602	602	728	0.8269231
A02	30355500	30356479	A02p48870.2_BraZ1	717	-	504	894	979	0.9131767
A02	30357820	30360903	A02p48880.2_BraZ1	1482.12	-	486	2141	3083	0.6944535
A02	30361182	30362858	A02p48890.2_BraZ1	839.426	+	489	1665	1676	0.9934368
A02	30363312	30366013	A02p48900.2_BraZ1	112.696	+	4179	2701	2701	1.0000000
A02	30366839	30369618	A02p48910.2_BraZ1	92.7	-	4781	2779	2779	1.0000000
A02	30370990	30372307	A02p48920.2_BraZ1	921	-	757	1063	1317	0.8071374
A02	30373479	30374007	A02p48930.2_BraZ1	52.8	-	301	528	528	1.0000000
A02	30384282	30390015	A02p48940.2_BraZ1	158.1	-	4407	5733	5733	1.0000000
A02	30388258	30388499	A02p48950.2_BraZ1	174	-	374	241	241	1.0000000
A02	30400519	30402019	A02p48960.2_BraZ1	541.125	+	154	1054	1500	0.7026666
A02	30407175	30408736	A02p48970.2_BraZ1	12093.8	-	670	1427	1561	0.9141576
A02	30410891	30411516	A02p48980.2_BraZ1	246	-	111	442	625	0.7072000
A02	30423240	30426558	A02p48990.2_BraZ1	1550.71	+	2470	3318	3318	1.0000000
A02	30431262	30436484	A02p49000.2_BraZ1	1118.59	+	6898	5110	5222	0.9785523
A02	30458145	30461298	A02p49010.2_BraZ1	1415.45	+	636	2677	3153	0.8490326
A02	30463626	30466337	A02p49020.2_BraZ1	1923	+	515	2188	2711	0.8070822
A02	30470130	30473675	A02p49030.2_BraZ1	1925.82	+	1085	2002	3545	0.5647390
A02	30478714	30481785	A02p49040.2_BraZ1	1419	+	806	2764	3071	0.9000326
A02	30482299	30485750	A02p49050.2_BraZ1	1128.63	-	1023	1612	3451	0.4671110
A02	30487853	30488129	A02p49060.2_BraZ1	27.6	+	251	276	276	1.0000000
A02	30489479	30493005	A02p49070.2_BraZ1	1178.21	+	1289	3277	3526	0.9293817
A02	30496440	30497137	A02p49080.2_BraZ1	506.529	+	787	697	697	1.0000000
A02	30507179	30507485	A02p49090.2_BraZ1	30.6	+	195	306	306	1.0000000
A02	30509873	30511238	A02p49100.2_BraZ1	954	+	525	1139	1365	0.8344322
A02	30513583	30523784	A02p49110.2_BraZ1	4074.95	+	3091	9554	10201	0.9365748
A02	30525369	30525504	A02p49120.2_BraZ1	13.5	+	84	135	135	1.0000000
A02	30526141	30529329	A02p49130.2_BraZ1	695.072	+	323	2005	3188	0.6289210
A02	30531274	30537490	A02p49140.2_BraZ1	1111.26	+	4040	6012	6216	0.9671814
A02	30537787	30539929	A02p49150.2_BraZ1	899.646	-	2250	2142	2142	1.0000000
A02	30540685	30543429	A02p49160.2_BraZ1	715.091	-	1635	2667	2744	0.9719388
A02	30545642	30548007	A02p49170.2_BraZ1	1124.55	+	1016	2288	2365	0.9674419
A02	30548859	30550871	A02p49180.2_BraZ1	2667.5	+	2016	1982	2012	0.9850895
A02	30558517	30562269	A02p49190.2_BraZ1	2125.75	+	605	2444	3752	0.6513859
A02	30562978	30563446	A02p49200.2_BraZ1	46.8	+	193	468	468	1.0000000
A02	30570554	30572249	A02p49210.2_BraZ1	648	+	1520	1695	1695	1.0000000
A02	30572646	30573351	A02p49220.2_BraZ1	70.5	+	73	532	705	0.7546099
A02	30575271	30576817	A02p49230.2_BraZ1	762	+	585	1408	1546	0.9107374
A02	30578444	30580355	A02p49240.2_BraZ1	771	+	2186	1911	1911	1.0000000
A02	30580975	30582905	A02p49250.2_BraZ1	11742	-	369	1799	1930	0.9321244
A02	30586113	30586944	A02p49260.2_BraZ1	83.1	-	186	808	831	0.9723225
A02	30588273	30590523	A02p49270.2_BraZ1	725.2	-	1649	2250	2250	1.0000000
A02	30593966	30594563	A02p49280.2_BraZ1	59.7	+	251	597	597	1.0000000
A02	30596333	30600102	A02p49290.2_BraZ1	1328.25	-	842	2902	3769	0.7699655
A02	30604743	30607188	A02p49300.2_BraZ1	1662	+	1804	2445	2445	1.0000000
A02	30613453	30614391	A02p49310.2_BraZ1	2250	+	964	938	938	1.0000000
A02	30616674	30622289	A02p49320.2_BraZ1	3762.5	-	1265	3755	5615	0.6687444
A02	30626490	30626865	A02p49330.2_BraZ1	267	+	832	375	375	1.0000000
A02	30635700	30636030	A02p49340.2_BraZ1	33	+	783	330	330	1.0000000
A02	30639209	30640306	A02p49350.2_BraZ1	246.857	+	1578	1097	1097	1.0000000
A02	30641278	30642541	A02p49360.2_BraZ1	828	-	714	1226	1263	0.9707047
A02	30643581	30644068	A02p49370.2_BraZ1	120.214	-	530	487	487	1.0000000
A02	30644228	30650392	A02p49380.2_BraZ1	574	-	5428	5915	6164	0.9596041
A02	30650520	30650788	A02p49390.2_BraZ1	15	-	289	268	268	1.0000000
A02	30654772	30658732	A02p49400.2_BraZ1	1374.59	-	2364	3533	3960	0.8921717
A02	30664267	30677754	A02p49410.2_BraZ1	1246.95	-	5176	11129	13487	0.8251650
A02	30683273	30683803	A02p49420.2_BraZ1	30.9	+	4	224	530	0.4226415
A02	30694654	30695515	A02p49430.2_BraZ1	86.1	+	136	674	861	0.7828107
A02	30698834	30700300	A02p49440.2_BraZ1	455	-	843	1350	1466	0.9208731
A02	30711098	30712719	A02p49450.2_BraZ1	2430	-	1845	1597	1621	0.9851943
A02	30716100	30719939	A02p49460.2_BraZ1	10660.5	+	3483	3541	3839	0.9223756
A02	30723399	30724687	A02p49470.2_BraZ1	869.344	+	278	1210	1288	0.9394410
A02	30728719	30730342	A02p49480.2_BraZ1	665	-	886	1581	1623	0.9741220
A02	30739302	30742697	A02p49490.2_BraZ1	630.043	-	3888	3345	3395	0.9852725
A02	30751517	30752621	A02p49500.2_BraZ1	110.4	-	1366	1104	1104	1.0000000
A02	30754125	30755312	A02p49510.2_BraZ1	78.9	-	814	1187	1187	1.0000000
A02	30756173	30763223	A02p49520.2_BraZ1	3608.11	-	2124	6416	7050	0.9100709
A02	30766007	30767081	A02p49530.2_BraZ1	11325	-	61	706	1074	0.6573557
A02	30771443	30773800	A02p49540.2_BraZ1	1182.86	+	684	2118	2357	0.8985999
A02	30774269	30776799	A02p49550.2_BraZ1	1341.36	-	699	2344	2530	0.9264822
A02	30778414	30780718	A02p49560.2_BraZ1	1630.97	-	1883	2304	2304	1.0000000
A02	30781244	30783189	A02p49570.2_BraZ1	1174.02	-	519	1710	1945	0.8791774
A02	30787298	30787937	A02p49580.2_BraZ1	276	-	440	519	639	0.8122066
A02	30792791	30794996	A02p49590.2_BraZ1	337.55	-	313	2108	2205	0.9560091
A02	30799129	30801591	A02p49600.2_BraZ1	148.5	-	538	2071	2462	0.8411860
A02	30801715	30805097	A02p49610.2_BraZ1	739.35	-	2192	3316	3382	0.9804849
A02	30805846	30818453	A02p49620.2_BraZ1	5509.97	+	4848	9216	12607	0.7310225
A02	30821839	30822177	A02p49630.2_BraZ1	138	+	24	332	338	0.9822485
A02	30823285	30824122	A02p49640.2_BraZ1	741	+	1248	837	837	1.0000000
A02	30828376	30828622	A02p49650.2_BraZ1	24.6	+	62	246	246	1.0000000
A02	30834102	30836857	A02p49660.2_BraZ1	1348.27	+	695	2565	2755	0.9310345
A02	30838222	30839864	A02p49670.2_BraZ1	885	+	613	1618	1642	0.9853837
A02	30840625	30842765	A02p49680.2_BraZ1	1287	-	1458	2140	2140	1.0000000
A02	30844143	30844407	A02p49690.2_BraZ1	26.4	-	91	223	264	0.8446970
A02	30845027	30846457	A02p49700.2_BraZ1	218.75	+	1264	1430	1430	1.0000000
A02	30848244	30849399	A02p49710.2_BraZ1	115.5	+	728	1155	1155	1.0000000
A02	30851146	30852398	A02p49720.2_BraZ1	468	+	1198	1252	1252	1.0000000
A02	30856873	30857086	A02p49730.2_BraZ1	21.3	-	450	213	213	1.0000000
A02	30860435	30861283	A02p49740.2_BraZ1	453	+	101	644	848	0.7594340
A02	30861553	30862712	A02p49750.2_BraZ1	894.205	-	280	946	1159	0.8162209
A02	30863936	30864608	A02p49760.2_BraZ1	67.2	+	11	370	672	0.5505952
A02	30866002	30875103	A02p49770.2_BraZ1	2139.36	-	648	3072	9101	0.3375453
A02	30877417	30877564	A02p49780.2_BraZ1	14.7	+	390	147	147	1.0000000
A02	30882445	30886047	A02p49790.2_BraZ1	2356.78	-	732	2934	3602	0.8145475
A02	30892306	30894135	A02p49800.2_BraZ1	917.206	-	1141	1708	1829	0.9338436
A02	30897550	30898300	A02p49810.2_BraZ1	75	-	276	683	750	0.9106666
A02	30898994	30901905	A02p49820.2_BraZ1	625.17	-	353	2187	2911	0.7512882
A02	30906121	30908179	A02p49830.2_BraZ1	667.8	-	8281	2058	2058	1.0000000
A02	30912930	30914140	A02p49840.2_BraZ1	955.773	+	373	1210	1210	1.0000000
A02	30915173	30915773	A02p49850.2_BraZ1	60	-	82	463	600	0.7716666
A02	30927365	30934715	A02p49860.2_BraZ1	1107.6	+	2044	3423	7350	0.4657143
A02	30938454	30939096	A02p49870.2_BraZ1	258.111	+	562	636	642	0.9906542
A02	30944194	30951653	A02p49880.2_BraZ1	2982.47	+	2185	6965	7459	0.9337713
A02	30952464	30955156	A02p49890.2_BraZ1	1689.59	-	1411	2525	2692	0.9379643
A02	30956341	30958578	A02p49900.2_BraZ1	143.4	-	1232	2231	2237	0.9973179
A02	30968657	30971216	A02p49910.2_BraZ1	8112	+	483	2101	2559	0.8210238
A02	30971501	30977052	A02p49920.2_BraZ1	2219.6	-	2048	5128	5551	0.9237975
A02	30978056	30980532	A02p49930.2_BraZ1	833.184	-	3201	2476	2476	1.0000000
A02	30983579	30992539	A02p49940.2_BraZ1	1123	-	3287	8683	8960	0.9690848
A02	30991320	30993776	A02p49950.2_BraZ1	339	-	762	2206	2456	0.8982084
A02	30993828	30996694	A02p49960.2_BraZ1	1904.58	-	760	2553	2866	0.8907886
A02	30997744	30998119	A02p49970.2_BraZ1	37.2	+	194	375	375	1.0000000
A02	30998122	31002709	A02p49980.2_BraZ1	2220.2	+	998	4074	4587	0.8881622
A02	31003657	31009095	A02p49990.2_BraZ1	2249.35	+	1563	5206	5438	0.9573373
A02	31009689	31011876	A02p50000.2_BraZ1	1297.29	-	430	1677	2187	0.7668039
A02	31011808	31013577	A02p50010.2_BraZ1	587.52	-	99	1469	1769	0.8304127
A02	31019082	31019277	A02p50020.2_BraZ1	19.5	+	314	195	195	1.0000000
A02	31019396	31023295	A02p50030.2_BraZ1	1558.53	+	2584	3527	3899	0.9045909
A02	31024352	31029593	A02p50040.2_BraZ1	2032.82	+	1415	4480	5241	0.8547987
A02	31037203	31038510	A02p50050.2_BraZ1	384	-	925	829	1307	0.6342770
A02	31041829	31048643	A02p50060.2_BraZ1	2347.22	+	4110	6489	6814	0.9523041
A02	31049638	31052016	A02p50070.2_BraZ1	15617.1	+	456	2106	2378	0.8856182
A02	31055246	31056144	A02p50080.2_BraZ1	798	+	644	851	898	0.9476615
A02	31056960	31059637	A02p50090.2_BraZ1	1039.93	-	2693	2677	2677	1.0000000
A02	31060723	31063961	A02p50100.2_BraZ1	1817.77	-	1326	3218	3238	0.9938233
A02	31065966	31068694	A02p50110.2_BraZ1	929.111	+	541	1886	2728	0.6913490
A02	31069635	31076471	A02p50120.2_BraZ1	2120.77	-	3326	5353	6836	0.7830603
A02	31078941	31080162	A02p50130.2_BraZ1	528	-	196	1068	1221	0.8746929
A02	31084594	31085211	A02p50140.2_BraZ1	219	+	46	451	617	0.7309563
A02	31085321	31085899	A02p50150.2_BraZ1	210	+	25	246	578	0.4256055
A02	31096204	31098465	A02p50160.2_BraZ1	960.15	-	1051	2068	2261	0.9146395
A02	31101352	31102462	A02p50170.2_BraZ1	726	-	369	1019	1110	0.9180180
A02	31108792	31110584	A02p50180.2_BraZ1	456.75	+	858	1649	1792	0.9202009
A02	31110325	31110464	A02p50190.2_BraZ1	126	+	213	139	139	1.0000000
A02	31121469	31121766	A02p50200.2_BraZ1	150	+	0	0	297	0.0000000
A02	31126098	31126281	A02p50210.2_BraZ1	18.3	+	1	79	183	0.4316940
A02	31130639	31131835	A02p50220.2_BraZ1	632.8	+	447	1059	1196	0.8854515
A02	31131835	31132111	A02p50230.2_BraZ1	225	+	152	276	276	1.0000000
A02	31133291	31133682	A02p50240.2_BraZ1	267	+	186	391	391	1.0000000
A02	31139183	31141958	A02p50250.2_BraZ1	514.138	+	1079	2635	2775	0.9495496
A02	31145401	31146576	A02p50260.2_BraZ1	328.707	+	1629	1152	1175	0.9804255
A02	31147383	31147928	A02p50270.2_BraZ1	450	-	773	545	545	1.0000000
A02	31150655	31151787	A02p50280.2_BraZ1	96.9	-	796	1130	1132	0.9982332
A02	31152851	31158379	A02p50290.2_BraZ1	923.067	-	2092	5512	5528	0.9971057
A02	31187109	31188710	A02p50300.2_BraZ1	873	-	752	1585	1601	0.9900063
A02	31191197	31194947	A02p50310.2_BraZ1	1489.35	-	1962	3750	3750	1.0000000
A02	31195826	31197639	A02p50320.2_BraZ1	589	-	1677	1813	1813	1.0000000
A02	31198712	31204326	A02p50330.2_BraZ1	410.4	-	2342	4366	5614	0.7776986
A02	31206561	31208534	A02p50340.2_BraZ1	1115.45	+	597	1904	1973	0.9650279
A02	31209401	31211080	A02p50350.2_BraZ1	1287	+	486	1674	1679	0.9970220
A02	31215804	31216737	A02p50360.2_BraZ1	735	+	81	481	933	0.5155413
A02	31218273	31219996	A02p50370.2_BraZ1	655	+	1229	1723	1723	1.0000000
A02	31220752	31232149	A02p50380.2_BraZ1	1712.84	+	1977	6699	11397	0.5877863
A02	31232318	31232895	A02p50390.2_BraZ1	537	+	89	549	577	0.9514731
A02	31235859	31236543	A02p50400.2_BraZ1	68.4	+	72	576	684	0.8421053
A02	31243921	31245162	A02p50410.2_BraZ1	1101	+	1172	1241	1241	1.0000000
A02	31256128	31256272	A02p50420.2_BraZ1	14.4	-	442	144	144	1.0000000
A02	31257674	31258040	A02p50430.2_BraZ1	261	+	218	366	366	1.0000000
A02	31262122	31263792	A02p50440.2_BraZ1	894.393	+	519	1425	1670	0.8532934
A02	31268123	31269671	A02p50450.2_BraZ1	879	-	1016	1443	1548	0.9321706
A02	31272078	31273325	A02p50460.2_BraZ1	579	-	582	1222	1247	0.9799519
A02	31274558	31276201	A02p50470.2_BraZ1	825.943	+	1208	1572	1643	0.9567864
A02	31279620	31280978	A02p50480.2_BraZ1	1081.14	-	474	1322	1358	0.9734904
A02	31293221	31295374	A02p50490.2_BraZ1	678.194	+	1041	1889	2153	0.8773804
A02	31296263	31297484	A02p50500.2_BraZ1	495	+	716	1220	1221	0.9991810
A02	31298336	31300275	A02p50510.2_BraZ1	762.268	+	525	1759	1939	0.9071686
A02	31300441	31304810	A02p50520.2_BraZ1	408	-	372	1337	4369	0.3060197
A02	31301478	31304019	A02p50530.2_BraZ1	254.1	-	44	70	2541	0.0275482
A02	31306667	31307078	A02p50540.2_BraZ1	41.1	-	0	0	411	0.0000000
A02	31308074	31309542	A02p50550.2_BraZ1	945.778	+	357	1196	1468	0.8147139
A02	31310770	31313010	A02p50560.2_BraZ1	343.2	-	247	1171	2240	0.5227678
A02	31313962	31314902	A02p50570.2_BraZ1	524.526	+	323	862	940	0.9170213
A02	31315929	31316235	A02p50580.2_BraZ1	30.6	-	298	306	306	1.0000000
A02	31317918	31318251	A02p50590.2_BraZ1	192	+	528	333	333	1.0000000
A02	31319740	31320476	A02p50600.2_BraZ1	1218.75	+	2	8	736	0.0108696
A02	31325236	31326895	A02p50610.2_BraZ1	165.9	+	229	1102	1659	0.6642556
A02	31333462	31338149	A02p50620.2_BraZ1	2505.03	+	1763	4446	4687	0.9485812
A02	31338568	31340939	A02p50630.2_BraZ1	1685.75	-	67	507	2371	0.2138338
A02	31353756	31353960	A02p50640.2_BraZ1	20.4	-	403	204	204	1.0000000
A02	31366657	31368757	A02p50650.2_BraZ1	849	-	9444	1770	2100	0.8428571
A02	31370509	31371221	A02p50660.2_BraZ1	2001	+	78	442	712	0.6207865
A02	31371830	31372984	A02p50670.2_BraZ1	591.583	-	455	1083	1154	0.9384749
A02	31375785	31377786	A02p50680.2_BraZ1	25	-	594	1813	2001	0.9060470
A02	31376354	31377786	A02p50690.2_BraZ1	554.3	-	225	1244	1432	0.8687151
A02	31382468	31385884	A02p50700.2_BraZ1	425.25	+	3191	3410	3416	0.9982436
A02	31385884	31386429	A02p50710.2_BraZ1	317.25	+	808	545	545	1.0000000
A02	31388691	31390310	A02p50720.2_BraZ1	567	+	946	1308	1619	0.8079061
A02	31395507	31395777	A02p50730.2_BraZ1	27	-	839	270	270	1.0000000
A02	31404609	31407655	A02p50740.2_BraZ1	1406.14	+	1674	2911	3046	0.9556796
A02	31408773	31409795	A02p50750.2_BraZ1	840	+	1067	1016	1022	0.9941292
A02	31412465	31413068	A02p50760.2_BraZ1	8184	-	2167	603	603	1.0000000
A02	31418732	31420681	A02p50770.2_BraZ1	1267.57	-	1664	1949	1949	1.0000000
A02	31424034	31426355	A02p50780.2_BraZ1	1343.25	-	813	1942	2321	0.8367083
A02	31429652	31431166	A02p50790.2_BraZ1	1017	-	212	1137	1514	0.7509907
A02	31436305	31437735	A02p50800.2_BraZ1	480	-	2053	1430	1430	1.0000000
A02	31438843	31440944	A02p50810.2_BraZ1	721.633	+	2609	2101	2101	1.0000000
A02	31441597	31444333	A02p50820.2_BraZ1	2646	-	3487	2736	2736	1.0000000
A02	31453595	31455617	A02p50830.2_BraZ1	1937.77	-	705	1858	2022	0.9188922
A02	31456519	31458870	A02p50840.2_BraZ1	1303.27	-	850	2045	2351	0.8698426
A02	31460203	31460901	A02p50850.2_BraZ1	511.875	-	440	655	698	0.9383954
A02	31463048	31463552	A02p50860.2_BraZ1	273.529	+	165	504	504	1.0000000
A02	31466018	31466575	A02p50870.2_BraZ1	489	-	130	557	557	1.0000000
A02	31472192	31473052	A02p50880.2_BraZ1	558	-	154	765	860	0.8895349
A02	31474243	31475818	A02p50890.2_BraZ1	157.5	-	1103	1466	1575	0.9307936
A02	31479681	31484712	A02p50900.2_BraZ1	1670.62	-	2147	4851	5031	0.9642218
A02	31485402	31485858	A02p50910.2_BraZ1	45.6	+	159	399	456	0.8750000
A02	31489221	31489554	A02p50920.2_BraZ1	33.3	+	2	56	333	0.1681682
A02	31490791	31491154	A02p50930.2_BraZ1	36.3	+	740	363	363	1.0000000
A02	31492800	31493965	A02p50940.2_BraZ1	1092	+	1022	1165	1165	1.0000000
A02	31494176	31494657	A02p50950.2_BraZ1	174	-	883	481	481	1.0000000
A02	31498060	31500645	A02p50960.2_BraZ1	1401.29	-	710	2182	2585	0.8441006
A02	31505535	31508224	A02p50970.2_BraZ1	1109.75	+	1361	2648	2689	0.9847527
A02	31514500	31515993	A02p50980.2_BraZ1	190.125	+	837	1105	1493	0.7401206
A02	31515792	31517164	A02p50990.2_BraZ1	233.357	+	151	928	1372	0.6763849
A02	31518614	31520072	A02p51000.2_BraZ1	5580	-	1078	1452	1458	0.9958848
A02	31524828	31526702	A02p51010.2_BraZ1	914.34	-	2344	1874	1874	1.0000000
A02	31530076	31530866	A02p51020.2_BraZ1	269.5	-	671	790	790	1.0000000
A02	31532810	31535230	A02p51030.2_BraZ1	972	+	699	2334	2420	0.9644628
A02	31536593	31537017	A02p51040.2_BraZ1	222	+	183	424	424	1.0000000
A02	31537497	31539691	A02p51050.2_BraZ1	556.562	-	1599	2034	2194	0.9270738
A02	31540731	31541907	A02p51060.2_BraZ1	366.485	+	499	997	1176	0.8477891
A02	31542725	31543910	A02p51070.2_BraZ1	594	-	1334	1185	1185	1.0000000
A02	31544045	31545896	A02p51080.2_BraZ1	1335	-	784	1739	1851	0.9394922
A02	31546853	31547501	A02p51090.2_BraZ1	417	+	165	648	648	1.0000000
A02	31550448	31551723	A02p51100.2_BraZ1	945	+	361	1001	1275	0.7850980
A02	31552976	31554142	A02p51110.2_BraZ1	771.444	-	294	1000	1166	0.8576329
A02	31555067	31555764	A02p51120.2_BraZ1	249	-	55	426	697	0.6111908
A02	31563521	31568863	A02p51130.2_BraZ1	1845.17	+	903	4588	5342	0.8588544
A02	31581837	31583792	A02p51140.2_BraZ1	1355.32	+	334	1452	1955	0.7427110
A02	31585420	31588742	A02p51150.2_BraZ1	1090.51	-	1387	3049	3322	0.9178206
A02	31592240	31605053	A02p51160.2_BraZ1	4294.5	-	576	5870	12813	0.4581285
A02	31607195	31612733	A02p51170.2_BraZ1	1792.27	+	3648	5135	5538	0.9272301
A02	31614788	31617935	A02p51180.2_BraZ1	1789.82	+	1616	2904	3147	0.9227836
A02	31618325	31620158	A02p51190.2_BraZ1	966	-	1782	1761	1833	0.9607201
A02	31620502	31625232	A02p51200.2_BraZ1	438	+	6692	4730	4730	1.0000000
A02	31626329	31627169	A02p51210.2_BraZ1	36	-	5	404	840	0.4809524
A02	31629182	31632575	A02p51220.2_BraZ1	1638.4	-	1585	3393	3393	1.0000000
A02	31634043	31634840	A02p51230.2_BraZ1	870.75	-	3	40	797	0.0501882
A02	31637343	31640305	A02p51240.2_BraZ1	2211	+	756	2830	2962	0.9554355
A02	31640664	31641348	A02p51250.2_BraZ1	516.167	-	97	642	684	0.9385965
A02	31642796	31649086	A02p51260.2_BraZ1	3007.5	-	3027	5298	6290	0.8422893
A02	31650421	31651517	A02p51270.2_BraZ1	540	-	243	986	1096	0.8996350
A02	31654722	31658249	A02p51280.2_BraZ1	913.588	-	574	2555	3527	0.7244117
A02	31658381	31659923	A02p51290.2_BraZ1	1305	-	398	1542	1542	1.0000000
A02	31671994	31673670	A02p51300.2_BraZ1	847.333	-	728	1355	1676	0.8084726
A02	31686880	31687572	A02p51310.2_BraZ1	315.886	-	1523	692	692	1.0000000
A02	31689894	31691343	A02p51320.2_BraZ1	1110	+	379	1212	1449	0.8364389
A02	31692378	31694444	A02p51330.2_BraZ1	2001	-	757	1922	2066	0.9303001
A02	31697004	31697269	A02p51340.2_BraZ1	21.9	+	0	0	265	0.0000000
A02	31701265	31703243	A02p51350.2_BraZ1	1098.52	+	322	1894	1978	0.9575329
A02	31712865	31713780	A02p51360.2_BraZ1	91.5	+	24	524	915	0.5726776
A02	31731549	31734890	A02p51370.2_BraZ1	1552.8	-	1618	3330	3341	0.9967076
A02	31737639	31738639	A02p51380.2_BraZ1	2512.5	+	27	735	1000	0.7350000
A02	31743235	31743628	A02p51390.2_BraZ1	39.3	+	207	393	393	1.0000000
A02	31744714	31753212	A02p51400.2_BraZ1	1053	+	9479	8498	8498	1.0000000
A02	31748464	31752833	A02p51410.2_BraZ1	774.28	-	4214	4369	4369	1.0000000
A02	31753923	31756107	A02p51420.2_BraZ1	216.9	-	839	2184	2184	1.0000000
A02	31757666	31758380	A02p51430.2_BraZ1	71.4	-	551	714	714	1.0000000
A02	31758635	31758877	A02p51440.2_BraZ1	162	-	443	242	242	1.0000000
A02	31762107	31763229	A02p51450.2_BraZ1	112.2	-	1322	1122	1122	1.0000000
A02	31763978	31768075	A02p51460.2_BraZ1	2135.25	-	1633	3952	4097	0.9646083
A02	31771980	31773411	A02p51470.2_BraZ1	143.1	-	588	928	1431	0.6484976
A02	31775184	31779622	A02p51480.2_BraZ1	1578.3	+	1501	4055	4438	0.9136999
A02	31781129	31782676	A02p51490.2_BraZ1	1242	+	74	830	1547	0.5365223
A02	31790296	31791738	A02p51500.2_BraZ1	558	+	234	891	1442	0.6178918
A02	31793767	31795465	A02p51510.2_BraZ1	169.8	-	201	1624	1698	0.9564193
A02	31800084	31802440	A02p51520.2_BraZ1	984.5	-	270	1627	2356	0.6905773
A02	31803483	31806894	A02p51530.2_BraZ1	2410.03	-	415	2689	3411	0.7883319
A02	31815205	31816823	A02p51540.2_BraZ1	276	-	660	1319	1618	0.8152040
A02	31817347	31819090	A02p51550.2_BraZ1	174.3	-	1459	1743	1743	1.0000000
A02	31819647	31820486	A02p51560.2_BraZ1	623.1	+	513	823	839	0.9809297
A02	31827271	31828918	A02p51570.2_BraZ1	13138.5	+	846	1572	1647	0.9544626
A02	31830152	31833001	A02p51580.2_BraZ1	2070	+	1306	2623	2849	0.9206739
A02	31833583	31834959	A02p51590.2_BraZ1	564	-	637	1376	1376	1.0000000
A02	31835551	31835995	A02p51600.2_BraZ1	309	+	210	444	444	1.0000000
A02	31844667	31849989	A02p51610.2_BraZ1	3047.91	+	1160	4721	5322	0.8870725
A02	31851051	31851311	A02p51620.2_BraZ1	14.7	+	56	260	260	1.0000000
A02	31854610	31855927	A02p51630.2_BraZ1	237	+	562	1317	1317	1.0000000
A02	31855007	31855362	A02p51640.2_BraZ1	300	-	113	355	355	1.0000000
A02	31866637	31867042	A02p51650.2_BraZ1	237	-	208	405	405	1.0000000
A02	31871039	31873351	A02p51660.2_BraZ1	1458	+	1815	1576	2312	0.6816609
A02	31876094	31877268	A02p51670.2_BraZ1	2524.5	+	359	1169	1174	0.9957411
A02	31881075	31882188	A02p51680.2_BraZ1	1044	-	273	670	1113	0.6019766
A02	31883724	31886738	A02p51690.2_BraZ1	60.3	-	2107	3011	3014	0.9990047
A02	31887738	31888159	A02p51700.2_BraZ1	300	+	1	151	421	0.3586698
A02	31892377	31895344	A02p51710.2_BraZ1	1935	-	1221	2657	2967	0.8955173
A02	31897314	31898578	A02p51720.2_BraZ1	3024	+	450	1162	1264	0.9193038
A02	31899982	31900208	A02p51730.2_BraZ1	171	-	85	226	226	1.0000000
A02	31902839	31904862	A02p51740.2_BraZ1	1321.88	-	256	1523	2023	0.7528423
A02	31915875	31916598	A02p51750.2_BraZ1	342	+	163	694	723	0.9598894
A02	31919456	31919744	A02p51760.2_BraZ1	231	+	20	268	288	0.9305556
A02	31920679	31921312	A02p51770.2_BraZ1	507	-	266	630	633	0.9952607
A02	31922474	31925074	A02p51780.2_BraZ1	1407.53	+	1302	2555	2600	0.9826923
A02	31927691	31929376	A02p51790.2_BraZ1	896.966	+	127	1164	1685	0.6908012
A02	31933188	31933664	A02p51800.2_BraZ1	348	-	8	93	476	0.1953782
A02	31936571	31950505	A02p51810.2_BraZ1	644.435	+	1112	6112	13934	0.4386393
A02	31951835	31952113	A02p51820.2_BraZ1	186	-	53	278	278	1.0000000
A02	31952536	31961980	A02p51830.2_BraZ1	476	+	13598	8746	9444	0.9260907
A02	31969573	31972191	A02p51840.2_BraZ1	1340.61	+	478	1576	2618	0.6019862
A02	31977934	31978771	A02p51850.2_BraZ1	83.7	+	939	837	837	1.0000000
A02	31980307	31982632	A02p51860.2_BraZ1	1084.58	-	263	1746	2325	0.7509677
A02	31999382	31999989	A02p51870.2_BraZ1	4536	+	0	0	607	0.0000000
A02	32000748	32002245	A02p51880.2_BraZ1	880.957	-	190	675	1497	0.4509018
A02	32007377	32008355	A02p51890.2_BraZ1	97.8	+	85	659	978	0.6738241
A02	32011987	32013631	A02p51900.2_BraZ1	164.4	-	642	1614	1644	0.9817518
A02	32014689	32015729	A02p51910.2_BraZ1	861	-	448	1040	1040	1.0000000
A02	32016069	32016288	A02p51920.2_BraZ1	21.9	-	87	219	219	1.0000000
A02	32018019	32018326	A02p51930.2_BraZ1	29.1	+	19	267	307	0.8697069
A02	32023843	32025671	A02p51940.2_BraZ1	1114.29	+	118	1292	1828	0.7067834
A02	32026556	32027344	A02p51950.2_BraZ1	573.75	+	507	788	788	1.0000000
A02	32028027	32029083	A02p51960.2_BraZ1	647.667	-	428	979	1056	0.9270833
A02	32029419	32030939	A02p51970.2_BraZ1	539.6	-	438	1459	1520	0.9598684
A02	32035169	32036654	A02p51980.2_BraZ1	148.5	-	1465	1485	1485	1.0000000
A02	32038644	32042802	A02p51990.2_BraZ1	2050.71	+	2328	4158	4158	1.0000000
A02	32049485	32049935	A02p52000.2_BraZ1	45	-	317	450	450	1.0000000
A02	32055656	32057375	A02p52010.2_BraZ1	2073.33	-	748	1524	1719	0.8865619
A02	32062667	32064052	A02p52020.2_BraZ1	5502	-	1402	1385	1385	1.0000000
A02	32065128	32066124	A02p52030.2_BraZ1	99.6	+	400	996	996	1.0000000
A02	32069228	32069978	A02p52040.2_BraZ1	75	-	227	750	750	1.0000000
A02	32074140	32074544	A02p52050.2_BraZ1	381	-	261	404	404	1.0000000
A02	32075254	32076329	A02p52060.2_BraZ1	882	+	832	992	1075	0.9227907
A02	32077629	32079024	A02p52070.2_BraZ1	696.6	+	1138	1395	1395	1.0000000
A02	32082370	32083192	A02p52080.2_BraZ1	82.2	+	440	822	822	1.0000000
A02	32088855	32090726	A02p52090.2_BraZ1	857.143	-	578	1855	1871	0.9914484
A02	32094866	32097589	A02p52100.2_BraZ1	1370.42	+	521	2199	2723	0.8075652
A02	32101830	32102490	A02p52110.2_BraZ1	1800	+	243	660	660	1.0000000
A02	32103090	32103502	A02p52120.2_BraZ1	1269	-	208	412	412	1.0000000
A02	32104796	32105870	A02p52130.2_BraZ1	107.4	+	272	710	1074	0.6610801
A02	32106624	32106834	A02p52140.2_BraZ1	21	-	93	210	210	1.0000000
A02	32110193	32112560	A02p52150.2_BraZ1	1267.07	-	640	1948	2367	0.8229827
A02	32117986	32118901	A02p52160.2_BraZ1	91.5	-	21	490	915	0.5355191
A02	32134884	32137501	A02p52170.2_BraZ1	798.592	+	1343	2304	2617	0.8803974
A02	32144354	32145165	A02p52180.2_BraZ1	417	-	233	811	811	1.0000000
A02	32157916	32159136	A02p52190.2_BraZ1	1113.75	+	574	1220	1220	1.0000000
A02	32165962	32168244	A02p52200.2_BraZ1	2127	+	117	1508	2282	0.6608238
A02	32175147	32178240	A02p52210.2_BraZ1	1986.11	+	376	2477	3093	0.8008406
A02	32185359	32186694	A02p52220.2_BraZ1	1116	+	113	730	1335	0.5468165
A02	32191635	32191803	A02p52230.2_BraZ1	16.8	+	85	168	168	1.0000000
A02	32228249	32229883	A02p52240.2_BraZ1	1413	-	107	1281	1634	0.7839657
A02	32236643	32237258	A02p52250.2_BraZ1	61.5	-	122	440	615	0.7154471
A02	32251986	32252307	A02p52260.2_BraZ1	234	+	133	317	321	0.9875389
A02	32254297	32254782	A02p52270.2_BraZ1	46.8	+	80	398	485	0.8206186
A02	32256651	32257359	A02p52280.2_BraZ1	5265	+	15	328	708	0.4632768
A02	32260066	32260517	A02p52290.2_BraZ1	252	+	31	343	451	0.7605321
A02	32266410	32267221	A02p52300.2_BraZ1	2673.75	-	697	811	811	1.0000000
A02	32268121	32270543	A02p52310.2_BraZ1	1417.14	+	470	1647	2422	0.6800165
A02	32270974	32271169	A02p52320.2_BraZ1	19.5	-	29	195	195	1.0000000
A02	32272236	32273831	A02p52330.2_BraZ1	1146	-	772	1381	1595	0.8658307
A02	32274711	32274912	A02p52340.2_BraZ1	20.1	+	87	201	201	1.0000000
A02	32277488	32278680	A02p52350.2_BraZ1	1322.45	+	347	1136	1192	0.9530202
A02	32280879	32281587	A02p52360.2_BraZ1	70.8	+	38	465	708	0.6567796
A02	32285125	32285919	A02p52370.2_BraZ1	726	+	275	794	794	1.0000000
A02	32289020	32296477	A02p52380.2_BraZ1	845.143	-	8650	6877	7457	0.9222207
A02	32296594	32296836	A02p52390.2_BraZ1	117	+	435	242	242	1.0000000
A02	32297181	32297361	A02p52400.2_BraZ1	18	-	234	180	180	1.0000000
A02	32304649	32305267	A02p52410.2_BraZ1	61.8	+	1086	618	618	1.0000000
A02	32305120	32306298	A02p52420.2_BraZ1	882	+	1789	1178	1178	1.0000000
A02	32310466	32311084	A02p52430.2_BraZ1	522	+	4	252	618	0.4077670
A02	32311945	32314544	A02p52440.2_BraZ1	2187.46	-	63	668	2599	0.2570219
A02	32322440	32323398	A02p52450.2_BraZ1	910	+	3	79	958	0.0824635
A02	32327771	32327978	A02p52460.2_BraZ1	20.7	-	67	207	207	1.0000000
A02	32329309	32330877	A02p52470.2_BraZ1	465.263	+	1393	1568	1568	1.0000000
A02	32331336	32331615	A02p52480.2_BraZ1	27.9	+	432	279	279	1.0000000
A02	32340953	32341184	A02p52490.2_BraZ1	23.1	-	28	165	231	0.7142857
A02	32346363	32346641	A02p52500.2_BraZ1	16.5	-	149	278	278	1.0000000
A02	32348531	32349194	A02p52510.2_BraZ1	446.25	+	220	663	663	1.0000000
A02	32349617	32350385	A02p52520.2_BraZ1	2311.88	+	236	768	768	1.0000000
A02	32368550	32368856	A02p52530.2_BraZ1	29.4	-	196	306	306	1.0000000
A02	32372050	32372596	A02p52540.2_BraZ1	2520	-	314	546	546	1.0000000
A02	32373899	32377459	A02p52550.2_BraZ1	156	-	1692	3478	3560	0.9769663
A02	32379999	32381284	A02p52560.2_BraZ1	1004.29	-	167	1190	1285	0.9260700
A02	32387672	32388069	A02p52570.2_BraZ1	36.3	+	540	397	397	1.0000000
A02	32389142	32389667	A02p52580.2_BraZ1	249	+	633	499	525	0.9504762
A02	32389925	32394019	A02p52590.2_BraZ1	696	-	1980	3300	4094	0.8060576
A02	32394868	32395033	A02p52600.2_BraZ1	16.2	+	94	165	165	1.0000000
A02	32397739	32398305	A02p52610.2_BraZ1	459	-	282	338	566	0.5971732
A02	32400968	32401759	A02p52620.2_BraZ1	405	+	322	703	791	0.8887484
A02	32404262	32405290	A02p52630.2_BraZ1	979.2	+	851	1028	1028	1.0000000
A02	32408270	32409325	A02p52640.2_BraZ1	963	+	18	229	1055	0.2170616
A02	32412387	32412687	A02p52650.2_BraZ1	30	+	8	46	300	0.1533333
A02	32429747	32434744	A02p52660.2_BraZ1	713.939	+	2356	4927	4997	0.9859916
A02	32435392	32435848	A02p52670.2_BraZ1	45.6	-	358	456	456	1.0000000
A02	32438267	32439693	A02p52680.2_BraZ1	1043.77	-	276	1194	1426	0.8373072
A02	32440713	32441141	A02p52690.2_BraZ1	36	-	188	428	428	1.0000000
A02	32441979	32443127	A02p52700.2_BraZ1	777	+	741	1148	1148	1.0000000
A02	32443452	32444359	A02p52710.2_BraZ1	681	-	688	907	907	1.0000000
A02	32444762	32445830	A02p52720.2_BraZ1	106.8	+	204	973	1068	0.9110487
A02	32446582	32448362	A02p52730.2_BraZ1	853.6	-	1128	1780	1780	1.0000000
A02	32452082	32452757	A02p52740.2_BraZ1	2095.2	-	161	523	675	0.7748148
A02	32453340	32453847	A02p52750.2_BraZ1	219	-	512	507	507	1.0000000
A02	32454496	32456277	A02p52760.2_BraZ1	957.467	-	704	1768	1781	0.9927008
A02	32457221	32461265	A02p52770.2_BraZ1	2110.21	+	2210	3897	4044	0.9636499
A02	32461599	32463434	A02p52780.2_BraZ1	1076.7	-	948	1835	1835	1.0000000
A02	32465975	32466791	A02p52790.2_BraZ1	552.5	-	538	816	816	1.0000000
A02	32466818	32467547	A02p52800.2_BraZ1	243	-	359	630	729	0.8641976
A02	32467837	32468192	A02p52810.2_BraZ1	183	-	280	355	355	1.0000000
A02	32468619	32469512	A02p52820.2_BraZ1	593.421	-	700	893	893	1.0000000
A02	32471187	32472973	A02p52830.2_BraZ1	1088.51	-	126	1118	1786	0.6259798
A02	32475408	32484574	A02p52840.2_BraZ1	1860.43	+	2385	7017	9166	0.7655466
A02	32485622	32485869	A02p52850.2_BraZ1	156	-	187	247	247	1.0000000
A02	32486016	32486675	A02p52860.2_BraZ1	384.429	-	84	424	659	0.6433991
A03	12553	13866	A03p00010.2_BraZ1	282.286	-	673	1313	1313	1.0000000
A03	14671	15115	A03p00020.2_BraZ1	44.4	-	298	444	444	1.0000000
A03	18454	22787	A03p00030.2_BraZ1	977.819	+	814	3562	4333	0.8220632
A03	21422	22004	A03p00040.2_BraZ1	276	-	1	17	582	0.0292096
A03	22830	22950	A03p00050.2_BraZ1	12	+	98	120	120	1.0000000
A03	24266	33981	A03p00060.2_BraZ1	2285.09	+	1981	8406	9715	0.8652599
A03	34866	39347	A03p00070.2_BraZ1	2683.33	+	2042	4173	4481	0.9312654
A03	39654	43065	A03p00080.2_BraZ1	1432.86	+	872	3010	3411	0.8824392
A03	43470	44957	A03p00090.2_BraZ1	11352	-	587	1379	1487	0.9273705
A03	49644	50046	A03p00100.2_BraZ1	336	-	95	173	402	0.4303482
A03	51974	53825	A03p00110.2_BraZ1	1201.2	-	315	519	1851	0.2803890
A03	54510	54975	A03p00120.2_BraZ1	46.5	+	12	123	465	0.2645161
A03	56010	56568	A03p00130.2_BraZ1	55.8	+	76	497	558	0.8906810
A03	59057	59744	A03p00140.2_BraZ1	68.7	-	296	564	687	0.8209607
A03	64608	65248	A03p00150.2_BraZ1	57.6	+	296	621	640	0.9703125
A03	67155	67284	A03p00160.2_BraZ1	12.9	+	167	129	129	1.0000000
A03	68775	71251	A03p00170.2_BraZ1	1755	-	398	2288	2476	0.9240711
A03	74927	76154	A03p00180.2_BraZ1	5065.88	-	98	1047	1227	0.8533008
A03	76303	76678	A03p00190.2_BraZ1	37.5	-	143	321	375	0.8560000
A03	80213	82792	A03p00200.2_BraZ1	2000.23	+	487	2126	2579	0.8243505
A03	85062	86586	A03p00210.2_BraZ1	152.4	+	356	1519	1524	0.9967192
A03	87455	90299	A03p00220.2_BraZ1	2220.22	-	214	1908	2844	0.6708861
A03	91528	93193	A03p00230.2_BraZ1	931.247	-	520	1665	1665	1.0000000
A03	93544	94429	A03p00240.2_BraZ1	323.053	+	222	859	885	0.9706215
A03	95402	96023	A03p00250.2_BraZ1	62.1	+	205	548	621	0.8824477
A03	96631	102383	A03p00260.2_BraZ1	2737.21	+	2133	4824	5752	0.8386648
A03	102687	104417	A03p00270.2_BraZ1	1302.45	-	426	1610	1730	0.9306358
A03	105200	106234	A03p00280.2_BraZ1	527.25	-	617	1016	1034	0.9825919
A03	108740	110146	A03p00290.2_BraZ1	646.211	+	903	1391	1406	0.9893314
A03	110957	111340	A03p00300.2_BraZ1	210	-	424	383	383	1.0000000
A03	116251	118537	A03p00310.2_BraZ1	1009.41	-	751	2082	2286	0.9107612
A03	118912	119921	A03p00320.2_BraZ1	661.2	+	650	1009	1009	1.0000000
A03	120776	126905	A03p00330.2_BraZ1	2088	+	1273	2605	6129	0.4250286
A03	132565	134644	A03p00340.2_BraZ1	207.9	+	552	1887	2079	0.9076479
A03	135062	136534	A03p00350.2_BraZ1	676.139	-	811	1472	1472	1.0000000
A03	141557	144705	A03p00360.2_BraZ1	1159.32	-	2508	2706	3148	0.8595934
A03	145062	147397	A03p00370.2_BraZ1	1080	-	1675	2188	2335	0.9370450
A03	147937	150320	A03p00380.2_BraZ1	1243.72	+	1045	2342	2383	0.9827948
A03	151327	152577	A03p00390.2_BraZ1	408.287	+	1152	1250	1250	1.0000000
A03	155020	156152	A03p00400.2_BraZ1	93	+	341	985	1132	0.8701413
A03	159467	161219	A03p00410.2_BraZ1	960	+	1883	1752	1752	1.0000000
A03	164248	166048	A03p00420.2_BraZ1	1166.15	+	350	1639	1800	0.9105555
A03	167935	170292	A03p00430.2_BraZ1	389.455	+	1447	2237	2357	0.9490878
A03	171398	174802	A03p00440.2_BraZ1	1908.57	-	1618	3300	3404	0.9694477
A03	175495	179269	A03p00450.2_BraZ1	2147	+	637	3284	3774	0.8701643
A03	180284	182254	A03p00460.2_BraZ1	1095.52	-	1517	1970	1970	1.0000000
A03	184223	187061	A03p00470.2_BraZ1	1440.52	+	2351	2739	2838	0.9651163
A03	187478	187722	A03p00480.2_BraZ1	162	-	165	244	244	1.0000000
A03	188080	190306	A03p00490.2_BraZ1	222.6	+	816	2087	2226	0.9375561
A03	190767	191832	A03p00500.2_BraZ1	106.5	-	166	1037	1065	0.9737089
A03	194226	194921	A03p00510.2_BraZ1	624	+	74	201	695	0.2892086
A03	198865	201751	A03p00520.2_BraZ1	1408.8	+	464	2493	2886	0.8638254
A03	208086	211428	A03p00530.2_BraZ1	1562.44	+	2296	3254	3342	0.9736685
A03	211900	214223	A03p00540.2_BraZ1	2232	-	1438	2149	2323	0.9250969
A03	217199	218353	A03p00550.2_BraZ1	507.5	-	947	1154	1154	1.0000000
A03	228013	229206	A03p00560.2_BraZ1	2124	-	0	0	1193	0.0000000
A03	233357	233564	A03p00570.2_BraZ1	20.7	+	0	0	207	0.0000000
A03	239570	242874	A03p00580.2_BraZ1	1658.8	+	2327	3304	3304	1.0000000
A03	245874	247121	A03p00590.2_BraZ1	561.522	+	810	1247	1247	1.0000000
A03	247583	248577	A03p00600.2_BraZ1	5655	-	318	994	994	1.0000000
A03	249113	249449	A03p00610.2_BraZ1	198	+	55	310	336	0.9226190
A03	253385	254442	A03p00620.2_BraZ1	6156	+	676	1018	1057	0.9631031
A03	256488	256725	A03p00630.2_BraZ1	23.7	+	454	237	237	1.0000000
A03	258488	260217	A03p00640.2_BraZ1	946.364	+	1479	1729	1729	1.0000000
A03	260526	261131	A03p00650.2_BraZ1	189.205	+	219	605	605	1.0000000
A03	261241	263354	A03p00660.2_BraZ1	1036.35	-	1506	2113	2113	1.0000000
A03	264515	265340	A03p00670.2_BraZ1	744	+	185	623	825	0.7551515
A03	270052	272908	A03p00680.2_BraZ1	1315.08	+	733	2450	2856	0.8578432
A03	276056	288593	A03p00690.2_BraZ1	761.438	+	1586	7325	12537	0.5842705
A03	291657	293233	A03p00700.2_BraZ1	1036.35	-	1616	1576	1576	1.0000000
A03	293545	294419	A03p00710.2_BraZ1	5857.5	+	604	874	874	1.0000000
A03	294687	296428	A03p00720.2_BraZ1	1081.92	-	181	1435	1741	0.8242390
A03	297218	304938	A03p00730.2_BraZ1	5121.25	+	1921	6999	7720	0.9066062
A03	305330	308185	A03p00740.2_BraZ1	1322.76	+	845	2752	2855	0.9639229
A03	308540	308863	A03p00750.2_BraZ1	243	-	95	323	323	1.0000000
A03	310290	315845	A03p00760.2_BraZ1	2728.37	-	4910	5505	5555	0.9909991
A03	319228	319561	A03p00770.2_BraZ1	33.3	+	14	185	333	0.5555556
A03	320825	323977	A03p00780.2_BraZ1	2289.94	+	542	2294	3152	0.7277919
A03	330322	331802	A03p00790.2_BraZ1	1212	-	146	824	1480	0.5567567
A03	333764	335436	A03p00800.2_BraZ1	800.752	-	637	1626	1672	0.9724880
A03	339024	340560	A03p00810.2_BraZ1	153.6	+	311	1357	1536	0.8834636
A03	341107	342131	A03p00820.2_BraZ1	68.625	-	585	1024	1024	1.0000000
A03	342187	343486	A03p00830.2_BraZ1	750.375	-	170	1209	1299	0.9307159
A03	348781	351063	A03p00840.2_BraZ1	828.969	+	383	1668	2282	0.7309378
A03	351720	351948	A03p00850.2_BraZ1	22.8	-	24	119	228	0.5219298
A03	358552	359166	A03p00860.2_BraZ1	35.7	+	260	614	614	1.0000000
A03	362298	362739	A03p00870.2_BraZ1	44.1	-	356	441	441	1.0000000
A03	363435	364377	A03p00880.2_BraZ1	94.2	+	922	942	942	1.0000000
A03	365441	366683	A03p00890.2_BraZ1	124.2	+	1154	1242	1242	1.0000000
A03	369687	370080	A03p00900.2_BraZ1	39.3	+	401	393	393	1.0000000
A03	372230	372691	A03p00910.2_BraZ1	28.2	-	532	461	461	1.0000000
A03	374006	375609	A03p00920.2_BraZ1	665	+	1425	1595	1603	0.9950094
A03	379916	381267	A03p00930.2_BraZ1	1038.2	+	1121	1351	1351	1.0000000
A03	382225	383034	A03p00940.2_BraZ1	1094.62	+	89	706	809	0.8726823
A03	383174	384920	A03p00950.2_BraZ1	1080.2	-	482	1695	1746	0.9707904
A03	388391	389759	A03p00960.2_BraZ1	1627.2	+	536	1292	1368	0.9444444
A03	390723	392370	A03p00970.2_BraZ1	709.333	+	473	1528	1647	0.9277474
A03	392899	394407	A03p00980.2_BraZ1	663	+	821	1298	1508	0.8607427
A03	395047	396467	A03p00990.2_BraZ1	1221	+	347	1223	1420	0.8612676
A03	398317	404528	A03p01000.2_BraZ1	4232.67	+	1820	4809	6211	0.7742714
A03	404882	406192	A03p01010.2_BraZ1	9801	-	255	1118	1310	0.8534351
A03	406831	409127	A03p01020.2_BraZ1	1353	+	977	1755	2296	0.7643728
A03	410020	410617	A03p01030.2_BraZ1	401.214	-	523	597	597	1.0000000
A03	411453	412094	A03p01040.2_BraZ1	6615	-	366	641	641	1.0000000
A03	412914	414801	A03p01050.2_BraZ1	21309.8	-	1221	1760	1887	0.9326974
A03	418649	419221	A03p01060.2_BraZ1	321	+	949	572	572	1.0000000
A03	421782	422132	A03p01070.2_BraZ1	261	+	573	350	350	1.0000000
A03	424908	427059	A03p01080.2_BraZ1	215.1	-	244	1269	2151	0.5899581
A03	432197	434781	A03p01090.2_BraZ1	1629.77	+	115	1899	2584	0.7349072
A03	436241	437487	A03p01100.2_BraZ1	366.115	+	86	352	1246	0.2825040
A03	438078	439053	A03p01110.2_BraZ1	750	-	176	774	975	0.7938461
A03	441820	441970	A03p01120.2_BraZ1	15	-	6	150	150	1.0000000
A03	442831	443361	A03p01130.2_BraZ1	285	-	16	228	530	0.4301887
A03	447843	448582	A03p01140.2_BraZ1	588	+	137	739	739	1.0000000
A03	451297	453980	A03p01150.2_BraZ1	1690.17	+	531	2063	2683	0.7689154
A03	455113	456799	A03p01160.2_BraZ1	1084.82	+	1015	1686	1686	1.0000000
A03	457312	459466	A03p01170.2_BraZ1	997.884	+	1706	2143	2154	0.9948932
A03	465361	467186	A03p01180.2_BraZ1	990.357	+	1522	1825	1825	1.0000000
A03	467685	471197	A03p01190.2_BraZ1	2078.55	-	1870	3512	3512	1.0000000
A03	476859	478663	A03p01200.2_BraZ1	1072.14	-	962	1776	1804	0.9844790
A03	479219	481196	A03p01210.2_BraZ1	879.938	+	1344	1967	1977	0.9949418
A03	481629	485070	A03p01220.2_BraZ1	1418.89	-	2684	3441	3441	1.0000000
A03	486049	487234	A03p01230.2_BraZ1	2718.75	+	760	1099	1185	0.9274262
A03	487914	488125	A03p01240.2_BraZ1	15.6	-	125	132	211	0.6255924
A03	492646	493480	A03p01250.2_BraZ1	83.4	+	231	727	834	0.8717026
A03	495332	497651	A03p01260.2_BraZ1	457.8	+	682	1710	2319	0.7373868
A03	498814	499150	A03p01270.2_BraZ1	201	+	603	336	336	1.0000000
A03	499706	502929	A03p01280.2_BraZ1	2097.67	-	500	2514	3223	0.7800186
A03	503468	505201	A03p01290.2_BraZ1	937.2	-	987	1579	1733	0.9111367
A03	506889	509883	A03p01300.2_BraZ1	1239.84	+	2288	2994	2994	1.0000000
A03	511004	511660	A03p01310.2_BraZ1	315	-	819	656	656	1.0000000
A03	516935	518455	A03p01320.2_BraZ1	634.2	-	969	1496	1520	0.9842106
A03	517223	518153	A03p01330.2_BraZ1	44.7	+	559	930	930	1.0000000
A03	519796	520238	A03p01340.2_BraZ1	43.2	-	502	442	442	1.0000000
A03	526384	526825	A03p01350.2_BraZ1	44.1	-	211	441	441	1.0000000
A03	530924	533354	A03p01360.2_BraZ1	1164.94	-	1049	2151	2430	0.8851852
A03	542309	544897	A03p01370.2_BraZ1	1554.14	+	260	1658	2588	0.6406491
A03	552918	555711	A03p01380.2_BraZ1	1719	+	954	2600	2793	0.9308987
A03	557616	557920	A03p01390.2_BraZ1	177	-	274	304	304	1.0000000
A03	558900	564145	A03p01400.2_BraZ1	2079.03	-	3041	5203	5245	0.9919924
A03	565696	574035	A03p01410.2_BraZ1	1274.57	-	2685	7692	8339	0.9224128
A03	574669	575153	A03p01420.2_BraZ1	306	+	355	484	484	1.0000000
A03	579969	581464	A03p01430.2_BraZ1	657	+	208	1082	1495	0.7237458
A03	582150	585163	A03p01440.2_BraZ1	1557	-	256	1920	3013	0.6372386
A03	586088	588021	A03p01450.2_BraZ1	1150.5	-	152	1302	1933	0.6735644
A03	590971	592891	A03p01460.2_BraZ1	1019.18	-	56	1090	1920	0.5677083
A03	600920	601980	A03p01470.2_BraZ1	515.263	-	82	599	1060	0.5650944
A03	603787	603982	A03p01480.2_BraZ1	19.5	-	50	195	195	1.0000000
A03	604718	605159	A03p01490.2_BraZ1	44.1	+	253	398	441	0.9024943
A03	607504	608611	A03p01500.2_BraZ1	110.7	-	222	654	1107	0.5907859
A03	622043	624604	A03p01510.2_BraZ1	876.158	-	2274	2506	2561	0.9785240
A03	626021	626668	A03p01520.2_BraZ1	297	+	62	423	647	0.6537867
A03	631197	631734	A03p01530.2_BraZ1	53.7	+	109	408	537	0.7597765
A03	632675	635751	A03p01540.2_BraZ1	2280	+	711	2889	3076	0.9392068
A03	638634	639378	A03p01550.2_BraZ1	297	+	72	594	744	0.7983871
A03	645729	646332	A03p01560.2_BraZ1	429	-	135	596	603	0.9883914
A03	646465	649715	A03p01570.2_BraZ1	67.8	+	739	2600	3250	0.8000000
A03	650123	650447	A03p01580.2_BraZ1	32.4	+	131	324	324	1.0000000
A03	651619	652274	A03p01590.2_BraZ1	282	+	42	607	655	0.9267176
A03	654619	655026	A03p01600.2_BraZ1	198	+	143	407	407	1.0000000
A03	660811	663395	A03p01610.2_BraZ1	1433.76	-	449	2319	2584	0.8974458
A03	666716	683359	A03p01620.2_BraZ1	647.801	-	6944	13047	16643	0.7839332
A03	675385	676713	A03p01630.2_BraZ1	370.563	+	0	0	1328	0.0000000
A03	684520	686810	A03p01640.2_BraZ1	846.545	+	1303	2290	2290	1.0000000
A03	689354	691210	A03p01650.2_BraZ1	924.545	+	1848	1832	1856	0.9870690
A03	700962	703613	A03p01660.2_BraZ1	1432.67	+	1998	2559	2651	0.9652961
A03	704501	708475	A03p01670.2_BraZ1	834.938	-	1539	3657	3974	0.9202315
A03	711400	714140	A03p01680.2_BraZ1	924.923	+	2634	2740	2740	1.0000000
A03	714488	714917	A03p01690.2_BraZ1	41.1	+	20	146	429	0.3403263
A03	719599	723144	A03p01700.2_BraZ1	1231.09	+	2187	3230	3545	0.9111425
A03	724519	725599	A03p01710.2_BraZ1	108	+	132	766	1080	0.7092593
A03	727625	729916	A03p01720.2_BraZ1	1374.41	+	796	2188	2291	0.9550415
A03	730160	732812	A03p01730.2_BraZ1	1299.61	-	1175	2509	2652	0.9460784
A03	733646	736075	A03p01740.2_BraZ1	818.889	-	1475	2429	2429	1.0000000
A03	737369	738078	A03p01750.2_BraZ1	408	+	483	709	709	1.0000000
A03	744267	744669	A03p01760.2_BraZ1	40.2	-	5	290	402	0.7213930
A03	750738	753748	A03p01770.2_BraZ1	844.892	+	1260	3003	3010	0.9976744
A03	755177	756312	A03p01780.2_BraZ1	849.7	-	326	1025	1135	0.9030837
A03	757994	759596	A03p01790.2_BraZ1	160.2	+	186	1061	1602	0.6622971
A03	760039	762628	A03p01800.2_BraZ1	2219.26	-	1143	2564	2589	0.9903437
A03	763362	763736	A03p01810.2_BraZ1	1428	-	292	374	374	1.0000000
A03	764524	770172	A03p01820.2_BraZ1	1858.33	-	6685	5552	5648	0.9830028
A03	776426	778876	A03p01830.2_BraZ1	805.212	-	1573	2378	2450	0.9706122
A03	779391	780095	A03p01840.2_BraZ1	339.9	+	379	704	704	1.0000000
A03	780587	781375	A03p01850.2_BraZ1	636	-	86	590	788	0.7487310
A03	786030	789036	A03p01860.2_BraZ1	1679	+	647	2565	3006	0.8532934
A03	792516	795364	A03p01870.2_BraZ1	2142	+	709	2487	2848	0.8732444
A03	796077	797285	A03p01880.2_BraZ1	421.8	-	1385	1208	1208	1.0000000
A03	798855	800037	A03p01890.2_BraZ1	710.765	-	893	1182	1182	1.0000000
A03	800631	802977	A03p01900.2_BraZ1	1736.69	-	447	1924	2346	0.8201194
A03	804975	807965	A03p01910.2_BraZ1	1696.5	+	1143	2659	2990	0.8892977
A03	808564	809712	A03p01920.2_BraZ1	4360.5	+	434	928	1148	0.8083624
A03	810046	812191	A03p01930.2_BraZ1	935.156	+	2540	2145	2145	1.0000000
A03	814728	815745	A03p01940.2_BraZ1	93.3	+	538	892	1017	0.8770895
A03	818285	819470	A03p01950.2_BraZ1	118.5	-	312	481	1185	0.4059072
A03	821089	821500	A03p01960.2_BraZ1	41.1	-	4	2	411	0.0048662
A03	823804	824101	A03p01970.2_BraZ1	267	+	406	297	297	1.0000000
A03	826905	827252	A03p01980.2_BraZ1	18.9	-	393	347	347	1.0000000
A03	827361	831564	A03p01990.2_BraZ1	3518.77	+	1644	4045	4203	0.9624078
A03	832259	834224	A03p02000.2_BraZ1	196.5	-	249	1736	1965	0.8834606
A03	836939	837386	A03p02010.2_BraZ1	243	+	78	372	447	0.8322148
A03	839104	840067	A03p02020.2_BraZ1	96.3	-	221	849	963	0.8816199
A03	842838	844524	A03p02030.2_BraZ1	4921	-	30	319	1686	0.1892052
A03	852670	854631	A03p02040.2_BraZ1	17100	+	373	1145	1961	0.5838858
A03	855174	859522	A03p02050.2_BraZ1	1962.78	-	1576	4065	4348	0.9349126
A03	865298	867525	A03p02060.2_BraZ1	1272.67	-	640	1939	2227	0.8706781
A03	868560	869930	A03p02070.2_BraZ1	844.032	-	431	1316	1370	0.9605839
A03	870608	876131	A03p02080.2_BraZ1	2105.95	+	1701	4057	5523	0.7345645
A03	877894	878838	A03p02090.2_BraZ1	3036	+	342	698	944	0.7394068
A03	879401	879723	A03p02100.2_BraZ1	122.4	-	22	110	322	0.3416149
A03	880610	881734	A03p02110.2_BraZ1	616.8	-	320	824	1124	0.7330961
A03	885248	886001	A03p02120.2_BraZ1	75.3	+	429	753	753	1.0000000
A03	887110	888587	A03p02130.2_BraZ1	837.375	-	615	1477	1477	1.0000000
A03	889000	890099	A03p02140.2_BraZ1	665.714	-	554	1099	1099	1.0000000
A03	890908	891458	A03p02150.2_BraZ1	44.7	+	272	450	550	0.8181818
A03	893673	894261	A03p02160.2_BraZ1	459	+	0	0	588	0.0000000
A03	894429	895335	A03p02170.2_BraZ1	699.867	-	0	0	906	0.0000000
A03	898380	900197	A03p02180.2_BraZ1	1097.97	+	1986	1817	1817	1.0000000
A03	901412	902958	A03p02190.2_BraZ1	1001.7	-	779	1511	1546	0.9773609
A03	903698	908131	A03p02200.2_BraZ1	2905.52	-	923	3969	4433	0.8953305
A03	908346	908982	A03p02210.2_BraZ1	272	-	436	636	636	1.0000000
A03	909332	910622	A03p02220.2_BraZ1	1224	+	438	1196	1290	0.9271318
A03	913063	915340	A03p02230.2_BraZ1	15795	+	358	1613	2277	0.7083882
A03	915638	918279	A03p02240.2_BraZ1	1365.73	-	1954	2641	2641	1.0000000
A03	918900	920062	A03p02250.2_BraZ1	1059	+	597	1162	1162	1.0000000
A03	923538	925178	A03p02260.2_BraZ1	789.286	-	313	1605	1640	0.9786586
A03	927836	928133	A03p02270.2_BraZ1	29.7	+	0	0	297	0.0000000
A03	930942	931924	A03p02280.2_BraZ1	924	+	432	958	982	0.9755601
A03	934343	934955	A03p02290.2_BraZ1	61.2	+	67	549	612	0.8970588
A03	940392	943249	A03p02300.2_BraZ1	1896.93	+	537	2770	2857	0.9695485
A03	943489	945364	A03p02310.2_BraZ1	6038.4	-	114	999	1875	0.5328000
A03	946282	946762	A03p02320.2_BraZ1	801	-	0	0	480	0.0000000
A03	952934	963656	A03p02330.2_BraZ1	4936.39	+	7114	10060	10722	0.9382578
A03	964431	965544	A03p02340.2_BraZ1	111.3	+	461	1063	1113	0.9550764
A03	966287	966640	A03p02350.2_BraZ1	285	-	106	353	353	1.0000000
A03	975089	977513	A03p02360.2_BraZ1	1119	+	556	1950	2424	0.8044555
A03	979493	980880	A03p02370.2_BraZ1	312	+	346	998	1387	0.7195386
A03	982088	982250	A03p02380.2_BraZ1	16.2	-	129	162	162	1.0000000
A03	982852	983858	A03p02390.2_BraZ1	555	-	864	1006	1006	1.0000000
A03	984274	989194	A03p02400.2_BraZ1	781.79	-	1902	4227	4920	0.8591464
A03	990690	993503	A03p02410.2_BraZ1	1751.29	-	751	2813	2813	1.0000000
A03	995154	998007	A03p02420.2_BraZ1	1442.73	-	1875	2853	2853	1.0000000
A03	998709	1000795	A03p02430.2_BraZ1	1049.69	-	1243	2026	2086	0.9712368
A03	1001232	1003315	A03p02440.2_BraZ1	864.464	+	895	2083	2083	1.0000000
A03	1004626	1006353	A03p02450.2_BraZ1	744.409	-	1021	1727	1727	1.0000000
A03	1008340	1010524	A03p02460.2_BraZ1	7661.25	+	1705	2184	2184	1.0000000
A03	1014138	1016200	A03p02470.2_BraZ1	12699	+	1838	2032	2062	0.9854510
A03	1016960	1024943	A03p02480.2_BraZ1	878.042	-	4115	5935	7983	0.7434548
A03	1025259	1026801	A03p02490.2_BraZ1	590.625	+	1266	1474	1542	0.9559014
A03	1027159	1028117	A03p02500.2_BraZ1	812.2	-	1340	958	958	1.0000000
A03	1032079	1032736	A03p02510.2_BraZ1	65.4	-	90	545	657	0.8295282
A03	1034182	1035610	A03p02520.2_BraZ1	142.8	-	88	650	1428	0.4551821
A03	1037035	1037556	A03p02530.2_BraZ1	243	+	0	0	521	0.0000000
A03	1038187	1043857	A03p02540.2_BraZ1	1011	-	2251	4880	5670	0.8606702
A03	1041090	1042521	A03p02550.2_BraZ1	143.1	+	213	694	1431	0.4849755
A03	1044285	1045260	A03p02560.2_BraZ1	97.5	+	625	967	975	0.9917949
A03	1046215	1047972	A03p02570.2_BraZ1	1142.1	-	555	1729	1757	0.9840637
A03	1048374	1049979	A03p02580.2_BraZ1	160.5	+	576	1472	1605	0.9171339
A03	1050466	1053425	A03p02590.2_BraZ1	1453.5	-	2971	2959	2959	1.0000000
A03	1055402	1057007	A03p02600.2_BraZ1	1327.78	+	387	1465	1605	0.9127726
A03	1057996	1065337	A03p02610.2_BraZ1	2726.56	+	4236	7178	7341	0.9777960
A03	1065857	1066555	A03p02620.2_BraZ1	476.625	+	342	698	698	1.0000000
A03	1069748	1071086	A03p02630.2_BraZ1	6834	-	553	1336	1338	0.9985052
A03	1087863	1088277	A03p02640.2_BraZ1	41.4	+	64	414	414	1.0000000
A03	1089851	1090217	A03p02650.2_BraZ1	36.6	+	26	352	366	0.9617487
A03	1095344	1096493	A03p02660.2_BraZ1	347.1	+	2680	1149	1149	1.0000000
A03	1098215	1098719	A03p02670.2_BraZ1	50.4	-	240	502	504	0.9960318
A03	1101702	1102410	A03p02680.2_BraZ1	70.8	-	271	708	708	1.0000000
A03	1103701	1104343	A03p02690.2_BraZ1	64.2	-	78	551	642	0.8582554
A03	1104936	1105674	A03p02700.2_BraZ1	73.8	-	645	738	738	1.0000000
A03	1109248	1109467	A03p02710.2_BraZ1	21.9	+	198	219	219	1.0000000
A03	1110398	1110857	A03p02720.2_BraZ1	246	-	64	265	459	0.5773420
A03	1111608	1113646	A03p02730.2_BraZ1	1374	+	346	1654	2038	0.8115800
A03	1114467	1116636	A03p02740.2_BraZ1	467.918	-	1082	2169	2169	1.0000000
A03	1115992	1118451	A03p02750.2_BraZ1	921.429	-	1779	2459	2459	1.0000000
A03	1119192	1119792	A03p02760.2_BraZ1	60	-	383	600	600	1.0000000
A03	1120636	1121380	A03p02770.2_BraZ1	74.4	-	302	744	744	1.0000000
A03	1123462	1126466	A03p02780.2_BraZ1	1005	-	170	1537	3004	0.5116512
A03	1127917	1136386	A03p02790.2_BraZ1	3238.76	-	1859	5990	8469	0.7072854
A03	1138648	1141832	A03p02800.2_BraZ1	948.857	+	1079	2806	3184	0.8812814
A03	1142450	1143077	A03p02810.2_BraZ1	62.7	-	217	564	627	0.8995215
A03	1143757	1144740	A03p02820.2_BraZ1	410	-	11	49	983	0.0498474
A03	1146178	1146805	A03p02830.2_BraZ1	62.7	-	11	104	627	0.1658692
A03	1154409	1178121	A03p02840.2_BraZ1	948.857	-	5277	16036	23712	0.6762820
A03	1158760	1160810	A03p02850.2_BraZ1	1806	+	658	1982	2050	0.9668292
A03	1162096	1164215	A03p02860.2_BraZ1	1061.29	-	719	2079	2119	0.9811231
A03	1170222	1171567	A03p02870.2_BraZ1	1314	+	414	1286	1345	0.9561338
A03	1181417	1182342	A03p02880.2_BraZ1	299.357	-	172	805	925	0.8702703
A03	1185217	1185786	A03p02890.2_BraZ1	483	-	40	308	569	0.5413005
A03	1191352	1193721	A03p02900.2_BraZ1	1034.23	+	1210	2194	2369	0.9261292
A03	1194606	1194911	A03p02910.2_BraZ1	186	-	171	305	305	1.0000000
A03	1195091	1198435	A03p02920.2_BraZ1	1924.05	+	1691	3128	3344	0.9354067
A03	1198626	1199592	A03p02930.2_BraZ1	195	-	823	966	966	1.0000000
A03	1200817	1206016	A03p02940.2_BraZ1	1182.34	+	1357	3751	5199	0.7214849
A03	1207193	1209575	A03p02950.2_BraZ1	238.2	-	244	1331	2382	0.5587741
A03	1210848	1212327	A03p02960.2_BraZ1	1125	+	166	901	1479	0.6091954
A03	1213198	1214313	A03p02970.2_BraZ1	617.4	+	190	1031	1115	0.9246637
A03	1215462	1216550	A03p02980.2_BraZ1	993	+	655	1088	1088	1.0000000
A03	1217845	1218928	A03p02990.2_BraZ1	996	+	698	1083	1083	1.0000000
A03	1219873	1234485	A03p03000.2_BraZ1	1605	+	2407	5597	14612	0.3830413
A03	1229911	1231025	A03p03010.2_BraZ1	651.765	-	0	0	1114	0.0000000
A03	1231053	1232759	A03p03020.2_BraZ1	261	-	78	422	1706	0.2473623
A03	1236394	1237474	A03p03030.2_BraZ1	108	-	31	822	1080	0.7611111
A03	1239114	1241114	A03p03040.2_BraZ1	1267.87	-	323	1321	2000	0.6605000
A03	1241796	1243464	A03p03050.2_BraZ1	3230.77	+	792	1668	1668	1.0000000
A03	1244008	1244665	A03p03060.2_BraZ1	65.7	+	212	584	657	0.8888889
A03	1244967	1246822	A03p03070.2_BraZ1	1271.41	-	609	1752	1855	0.9444744
A03	1247832	1252677	A03p03080.2_BraZ1	1357.08	+	3993	4556	4845	0.9403509
A03	1256740	1256887	A03p03090.2_BraZ1	14.7	+	0	0	147	0.0000000
A03	1257143	1258472	A03p03100.2_BraZ1	11654.2	-	76	670	1329	0.5041385
A03	1265681	1265922	A03p03110.2_BraZ1	180	+	48	241	241	1.0000000
A03	1274111	1278294	A03p03120.2_BraZ1	2124.55	+	991	3882	4183	0.9280421
A03	1280341	1282055	A03p03130.2_BraZ1	582.96	+	269	1459	1714	0.8512252
A03	1282206	1283526	A03p03140.2_BraZ1	901.875	-	601	1272	1320	0.9636363
A03	1284513	1287974	A03p03150.2_BraZ1	1615.86	+	1936	3461	3461	1.0000000
A03	1292194	1293167	A03p03160.2_BraZ1	771	+	238	634	973	0.6515930
A03	1296325	1296520	A03p03170.2_BraZ1	19.5	-	217	195	195	1.0000000
A03	1296534	1296645	A03p03180.2_BraZ1	11.1	-	143	111	111	1.0000000
A03	1300575	1305211	A03p03190.2_BraZ1	2896.37	-	1748	4537	4636	0.9786454
A03	1310863	1312447	A03p03200.2_BraZ1	1018.12	+	464	1508	1584	0.9520202
A03	1314971	1316891	A03p03210.2_BraZ1	1220.22	+	784	1888	1920	0.9833333
A03	1317193	1318092	A03p03220.2_BraZ1	666	-	480	812	899	0.9032258
A03	1319021	1319758	A03p03230.2_BraZ1	555	-	111	660	737	0.8955224
A03	1322531	1323268	A03p03240.2_BraZ1	555	-	135	737	737	1.0000000
A03	1326217	1326895	A03p03250.2_BraZ1	558	-	145	659	678	0.9719764
A03	1329081	1329817	A03p03260.2_BraZ1	555	-	273	736	736	1.0000000
A03	1331803	1332728	A03p03270.2_BraZ1	654	-	98	848	925	0.9167567
A03	1341109	1341746	A03p03280.2_BraZ1	453	+	238	637	637	1.0000000
A03	1343402	1344393	A03p03290.2_BraZ1	810	-	51	604	991	0.6094854
A03	1346118	1347139	A03p03300.2_BraZ1	816	-	224	833	1021	0.8158668
A03	1349787	1350560	A03p03310.2_BraZ1	351	-	526	736	773	0.9521345
A03	1354292	1355979	A03p03320.2_BraZ1	393.75	-	1374	1617	1687	0.9585062
A03	1356799	1357897	A03p03330.2_BraZ1	345	-	690	1030	1098	0.9380692
A03	1358453	1358983	A03p03340.2_BraZ1	41.4	+	304	530	530	1.0000000
A03	1359464	1359644	A03p03350.2_BraZ1	18	+	73	180	180	1.0000000
A03	1359700	1361026	A03p03360.2_BraZ1	132.6	+	454	1318	1326	0.9939668
A03	1361032	1366412	A03p03370.2_BraZ1	791.644	-	1953	4986	5380	0.9267658
A03	1374833	1376244	A03p03380.2_BraZ1	993	+	1566	1411	1411	1.0000000
A03	1380385	1381560	A03p03390.2_BraZ1	286	+	894	1055	1175	0.8978723
A03	1382076	1382916	A03p03400.2_BraZ1	738	-	1004	840	840	1.0000000
A03	1383643	1390351	A03p03410.2_BraZ1	4077.72	-	3195	6134	6708	0.9144306
A03	1397701	1399408	A03p03420.2_BraZ1	11396	+	750	1659	1707	0.9718805
A03	1399880	1406394	A03p03430.2_BraZ1	3095.28	-	1123	5247	6514	0.8054959
A03	1407825	1409383	A03p03440.2_BraZ1	333	+	193	1327	1558	0.8517330
A03	1410482	1411904	A03p03450.2_BraZ1	142.2	-	1102	1422	1422	1.0000000
A03	1418137	1419553	A03p03460.2_BraZ1	141.6	+	2313	1416	1416	1.0000000
A03	1419808	1420972	A03p03470.2_BraZ1	162.587	-	1048	1164	1164	1.0000000
A03	1422126	1423886	A03p03480.2_BraZ1	1103.3	-	994	1625	1760	0.9232954
A03	1425243	1426987	A03p03490.2_BraZ1	617.478	-	1117	1744	1744	1.0000000
A03	1428059	1430754	A03p03500.2_BraZ1	2134.44	-	1206	2680	2695	0.9944341
A03	1433878	1436608	A03p03510.2_BraZ1	1277.8	+	2321	2730	2730	1.0000000
A03	1437311	1437828	A03p03520.2_BraZ1	20.7	-	165	371	517	0.7176015
A03	1438130	1438671	A03p03530.2_BraZ1	474	+	9	327	541	0.6044362
A03	1438944	1439328	A03p03540.2_BraZ1	38.4	+	49	333	384	0.8671875
A03	1442416	1443157	A03p03550.2_BraZ1	74.1	+	354	741	741	1.0000000
A03	1445661	1446687	A03p03560.2_BraZ1	395	+	1074	1026	1026	1.0000000
A03	1449786	1453903	A03p03570.2_BraZ1	1256.21	-	1610	4009	4117	0.9737673
A03	1461568	1462435	A03p03580.2_BraZ1	86.7	+	366	867	867	1.0000000
A03	1463085	1463690	A03p03590.2_BraZ1	444	+	132	564	605	0.9322314
A03	1465429	1465843	A03p03600.2_BraZ1	41.4	-	5	157	414	0.3792270
A03	1469716	1472470	A03p03610.2_BraZ1	418.76	-	662	2332	2754	0.8467683
A03	1472929	1475028	A03p03620.2_BraZ1	1032.55	-	1504	2099	2099	1.0000000
A03	1475594	1477179	A03p03630.2_BraZ1	439.636	-	684	1585	1585	1.0000000
A03	1479272	1481066	A03p03640.2_BraZ1	1151.43	+	845	1738	1794	0.9687848
A03	1487428	1488322	A03p03650.2_BraZ1	672	-	170	767	894	0.8579418
A03	1490321	1494818	A03p03660.2_BraZ1	1422.39	+	1514	3606	4497	0.8018679
A03	1495250	1497192	A03p03670.2_BraZ1	1011.75	-	1608	1942	1942	1.0000000
A03	1497693	1498687	A03p03680.2_BraZ1	376.2	+	9	201	994	0.2022133
A03	1498664	1502478	A03p03690.2_BraZ1	1266.92	+	245	1024	3814	0.2684845
A03	1503300	1505068	A03p03700.2_BraZ1	989.419	+	869	1763	1768	0.9971719
A03	1505386	1506988	A03p03710.2_BraZ1	160.2	-	522	1602	1602	1.0000000
A03	1508763	1509468	A03p03720.2_BraZ1	70.5	+	362	705	705	1.0000000
A03	1511473	1512393	A03p03730.2_BraZ1	663	+	306	920	920	1.0000000
A03	1512562	1514219	A03p03740.2_BraZ1	1037	+	1174	1615	1657	0.9746530
A03	1514868	1515480	A03p03750.2_BraZ1	61.2	-	282	612	612	1.0000000
A03	1516900	1522512	A03p03760.2_BraZ1	1833.67	-	2695	5188	5612	0.9244476
A03	1526519	1526732	A03p03770.2_BraZ1	21.3	+	7	181	213	0.8497652
A03	1529499	1534116	A03p03780.2_BraZ1	2353.09	+	2884	4553	4617	0.9861382
A03	1534440	1536059	A03p03790.2_BraZ1	798.429	-	1276	1619	1619	1.0000000
A03	1536841	1540223	A03p03800.2_BraZ1	1209.67	-	2038	3238	3382	0.9574217
A03	1540933	1541624	A03p03810.2_BraZ1	56.5714	-	515	671	691	0.9710565
A03	1542062	1546332	A03p03820.2_BraZ1	2439.25	-	2379	3915	4270	0.9168618
A03	1549185	1549710	A03p03830.2_BraZ1	52.5	+	4	123	525	0.2342857
A03	1549858	1553752	A03p03840.2_BraZ1	2553	-	1393	3690	3894	0.9476117
A03	1554613	1554994	A03p03850.2_BraZ1	38.1	-	382	381	381	1.0000000
A03	1557444	1558905	A03p03860.2_BraZ1	145.5	-	704	1428	1461	0.9774128
A03	1563308	1564911	A03p03870.2_BraZ1	996.8	+	1460	1603	1603	1.0000000
A03	1568619	1572405	A03p03880.2_BraZ1	2427.77	-	1809	3520	3786	0.9297411
A03	1572824	1575267	A03p03890.2_BraZ1	1701.82	-	876	2403	2443	0.9836267
A03	1595898	1596436	A03p03900.2_BraZ1	143.1	+	74	433	538	0.8048327
A03	1597150	1599177	A03p03910.2_BraZ1	1469.12	+	913	2027	2027	1.0000000
A03	1599734	1602019	A03p03920.2_BraZ1	1152	-	2373	2285	2285	1.0000000
A03	1603070	1605084	A03p03930.2_BraZ1	971.25	+	1812	2014	2014	1.0000000
A03	1606246	1608434	A03p03940.2_BraZ1	7474.5	+	1922	2007	2188	0.9172760
A03	1608841	1612412	A03p03950.2_BraZ1	386.876	-	1422	2993	3571	0.8381405
A03	1615038	1617141	A03p03960.2_BraZ1	71.4	-	1406	1689	2103	0.8031384
A03	1617633	1620110	A03p03970.2_BraZ1	1686.29	-	741	2461	2477	0.9935406
A03	1620896	1623357	A03p03980.2_BraZ1	1626.24	+	369	1952	2461	0.7931735
A03	1624082	1625277	A03p03990.2_BraZ1	924	-	306	1159	1195	0.9698745
A03	1630147	1630264	A03p04000.2_BraZ1	11.7	+	207	117	117	1.0000000
A03	1630365	1632435	A03p04010.2_BraZ1	1417.77	+	1314	1936	2070	0.9352657
A03	1633437	1635534	A03p04020.2_BraZ1	1141.68	-	1178	2008	2097	0.9575584
A03	1636262	1636932	A03p04030.2_BraZ1	432	-	535	670	670	1.0000000
A03	1637477	1639022	A03p04040.2_BraZ1	1086.53	-	1053	1545	1545	1.0000000
A03	1639200	1639702	A03p04050.2_BraZ1	109.421	-	242	502	502	1.0000000
A03	1639878	1643326	A03p04060.2_BraZ1	2395.38	+	759	3125	3448	0.9063225
A03	1643663	1644836	A03p04070.2_BraZ1	14449.5	+	61	759	1173	0.6470588
A03	1647275	1648695	A03p04080.2_BraZ1	1008	-	708	1311	1420	0.9232394
A03	1649331	1649802	A03p04090.2_BraZ1	47.1	-	43	323	471	0.6857749
A03	1650272	1652808	A03p04100.2_BraZ1	1010.24	-	1234	2536	2536	1.0000000
A03	1653822	1656482	A03p04110.2_BraZ1	1251.12	+	686	2581	2660	0.9703007
A03	1659138	1659761	A03p04120.2_BraZ1	237	-	483	498	623	0.7993580
A03	1660126	1662954	A03p04130.2_BraZ1	2223.91	+	812	2825	2828	0.9989392
A03	1663392	1668449	A03p04140.2_BraZ1	1764	-	2332	4948	5057	0.9784457
A03	1669215	1669467	A03p04150.2_BraZ1	25.2	-	895	252	252	1.0000000
A03	1670882	1671611	A03p04160.2_BraZ1	72.9	+	159	654	729	0.8971193
A03	1673493	1675178	A03p04170.2_BraZ1	1329	+	110	1207	1685	0.7163205
A03	1676075	1677273	A03p04180.2_BraZ1	477.633	-	366	1194	1198	0.9966611
A03	1679842	1680182	A03p04190.2_BraZ1	229.5	+	29	224	340	0.6588235
A03	1681309	1681649	A03p04200.2_BraZ1	204	+	0	0	340	0.0000000
A03	1684799	1685114	A03p04210.2_BraZ1	31.5	+	12	245	315	0.7777778
A03	1695249	1696629	A03p04220.2_BraZ1	1134	+	429	1380	1380	1.0000000
A03	1698154	1699341	A03p04230.2_BraZ1	675	-	348	1187	1187	1.0000000
A03	1701867	1703527	A03p04240.2_BraZ1	882.692	-	1464	1660	1660	1.0000000
A03	1709379	1714505	A03p04250.2_BraZ1	2965.52	+	1715	4748	5126	0.9262583
A03	1715873	1716152	A03p04260.2_BraZ1	27.9	+	9	190	279	0.6810036
A03	1717676	1720549	A03p04270.2_BraZ1	1387.47	-	1578	2800	2873	0.9745910
A03	1720939	1722142	A03p04280.2_BraZ1	460.306	+	782	1178	1203	0.9792186
A03	1722941	1723568	A03p04290.2_BraZ1	62.7	+	367	591	627	0.9425837
A03	1725202	1729996	A03p04300.2_BraZ1	1062.13	+	2815	4465	4794	0.9313725
A03	1731808	1735210	A03p04310.2_BraZ1	2422.96	+	382	2476	3402	0.7278072
A03	1739690	1741486	A03p04320.2_BraZ1	822.929	+	749	1240	1796	0.6904232
A03	1741804	1746959	A03p04330.2_BraZ1	2653.24	-	1242	4229	5155	0.8203686
A03	1752094	1754405	A03p04340.2_BraZ1	289.8	-	261	561	2311	0.2427521
A03	1766623	1767760	A03p04350.2_BraZ1	890.727	-	412	1015	1137	0.8927001
A03	1769682	1770945	A03p04360.2_BraZ1	126.3	+	766	1263	1263	1.0000000
A03	1771649	1774569	A03p04370.2_BraZ1	473.478	-	908	2652	2920	0.9082192
A03	1775125	1775414	A03p04380.2_BraZ1	225	-	0	0	289	0.0000000
A03	1776448	1777593	A03p04390.2_BraZ1	675	+	501	1145	1145	1.0000000
A03	1778978	1781807	A03p04400.2_BraZ1	1685.69	-	375	1915	2829	0.6769176
A03	1784018	1785655	A03p04410.2_BraZ1	563.383	+	497	1582	1637	0.9664019
A03	1788702	1790925	A03p04420.2_BraZ1	333	+	3255	2223	2223	1.0000000
A03	1792038	1793536	A03p04430.2_BraZ1	890.769	+	397	1346	1498	0.8985314
A03	1794783	1796234	A03p04440.2_BraZ1	10033	-	1052	1385	1451	0.9545141
A03	1796680	1802348	A03p04450.2_BraZ1	4797.27	+	1207	3965	5668	0.6995413
A03	1803011	1803425	A03p04460.2_BraZ1	41.1	-	118	414	414	1.0000000
A03	1804138	1807225	A03p04470.2_BraZ1	1389.66	-	1663	2203	3087	0.7136378
A03	1809024	1811081	A03p04480.2_BraZ1	285	-	1867	1446	2057	0.7029655
A03	1812361	1815007	A03p04490.2_BraZ1	742.765	-	3502	2646	2646	1.0000000
A03	1817976	1818396	A03p04500.2_BraZ1	42	-	831	420	420	1.0000000
A03	1819988	1821020	A03p04510.2_BraZ1	280	-	1300	901	1032	0.8730620
A03	1822538	1829026	A03p04520.2_BraZ1	3624.69	-	7845	5925	6488	0.9132244
A03	1829658	1831850	A03p04530.2_BraZ1	554.39	-	677	2097	2192	0.9566606
A03	1832904	1834125	A03p04540.2_BraZ1	122.1	-	181	541	1221	0.4430794
A03	1837769	1838215	A03p04550.2_BraZ1	300	-	8	199	446	0.4461883
A03	1838470	1839655	A03p04560.2_BraZ1	118.5	-	176	718	1185	0.6059072
A03	1839966	1843196	A03p04570.2_BraZ1	1850.87	-	1575	3129	3230	0.9687306
A03	1850421	1854232	A03p04580.2_BraZ1	1563.89	+	101	1185	3811	0.3109420
A03	1855337	1857276	A03p04590.2_BraZ1	1603.88	-	303	666	1939	0.3434760
A03	1858929	1862821	A03p04600.2_BraZ1	1789.62	+	1210	3414	3892	0.8771840
A03	1863192	1864969	A03p04610.2_BraZ1	16359	-	454	1729	1777	0.9729882
A03	1864167	1865650	A03p04620.2_BraZ1	156	-	294	1448	1483	0.9763992
A03	1869278	1872145	A03p04630.2_BraZ1	1928.06	+	2265	2867	2867	1.0000000
A03	1872588	1874478	A03p04640.2_BraZ1	1515.97	-	783	1861	1890	0.9846561
A03	1877582	1878839	A03p04650.2_BraZ1	125.7	+	85	959	1257	0.7629276
A03	1879067	1879700	A03p04660.2_BraZ1	561	-	435	633	633	1.0000000
A03	1880219	1895483	A03p04670.2_BraZ1	1201.3	+	7226	14359	15264	0.9407102
A03	1885548	1887184	A03p04680.2_BraZ1	1158	+	539	1567	1636	0.9578239
A03	1895854	1896149	A03p04690.2_BraZ1	249	+	201	295	295	1.0000000
A03	1896148	1896379	A03p04700.2_BraZ1	156	+	199	231	231	1.0000000
A03	1898209	1899121	A03p04710.2_BraZ1	91.2	+	92	849	912	0.9309211
A03	1900524	1901779	A03p04720.2_BraZ1	532	+	785	1255	1255	1.0000000
A03	1902483	1905237	A03p04730.2_BraZ1	1690.6	-	736	2083	2754	0.7563544
A03	1906136	1908859	A03p04740.2_BraZ1	1844.5	+	1036	1983	2723	0.7282409
A03	1909516	1909666	A03p04750.2_BraZ1	15	+	202	150	150	1.0000000
A03	1909983	1911922	A03p04760.2_BraZ1	1254.65	+	1430	1939	1939	1.0000000
A03	1913453	1913917	A03p04770.2_BraZ1	205.2	-	531	464	464	1.0000000
A03	1915880	1917280	A03p04780.2_BraZ1	678.3	-	1488	1400	1400	1.0000000
A03	1920230	1921061	A03p04790.2_BraZ1	83.1	+	164	824	831	0.9915764
A03	1922412	1922917	A03p04800.2_BraZ1	34318.5	-	95	410	505	0.8118812
A03	1933651	1934803	A03p04810.2_BraZ1	357	-	1542	1090	1152	0.9461806
A03	1937045	1939465	A03p04820.2_BraZ1	1148.1	+	784	2070	2420	0.8553719
A03	1947513	1947978	A03p04830.2_BraZ1	45	-	279	431	465	0.9268817
A03	1948944	1949770	A03p04840.2_BraZ1	514.917	+	561	826	826	1.0000000
A03	1953739	1954408	A03p04850.2_BraZ1	66.9	+	369	669	669	1.0000000
A03	1960529	1964884	A03p04860.2_BraZ1	2903.33	+	1569	4355	4355	1.0000000
A03	1965561	1968462	A03p04870.2_BraZ1	34314.8	-	1446	2533	2901	0.8731472
A03	1975537	1976587	A03p04880.2_BraZ1	105	+	678	1050	1050	1.0000000
A03	1977780	1978128	A03p04890.2_BraZ1	34.8	-	159	338	348	0.9712644
A03	1979288	1983276	A03p04900.2_BraZ1	5070	-	2965	3988	3988	1.0000000
A03	1984445	1988379	A03p04910.2_BraZ1	4250	-	4125	3934	3934	1.0000000
A03	1989990	1990206	A03p04920.2_BraZ1	144	+	262	210	216	0.9722222
A03	1990431	1990683	A03p04930.2_BraZ1	25.2	+	255	252	252	1.0000000
A03	1990782	1990926	A03p04940.2_BraZ1	14.4	+	78	144	144	1.0000000
A03	1991627	1993018	A03p04950.2_BraZ1	642.857	+	514	1391	1391	1.0000000
A03	1993582	1994995	A03p04960.2_BraZ1	669.6	-	616	1413	1413	1.0000000
A03	1996914	1997985	A03p04970.2_BraZ1	615	-	804	1071	1071	1.0000000
A03	1998610	2000090	A03p04980.2_BraZ1	900.13	-	141	953	1480	0.6439189
A03	2000798	2001392	A03p04990.2_BraZ1	373.091	-	319	531	594	0.8939394
A03	2002336	2005157	A03p05000.2_BraZ1	1799.55	-	1352	2642	2821	0.9365473
A03	2011153	2013358	A03p05010.2_BraZ1	912.095	-	1724	2201	2205	0.9981859
A03	2014142	2017784	A03p05020.2_BraZ1	2326.77	+	3003	3642	3642	1.0000000
A03	2018283	2020153	A03p05030.2_BraZ1	618.092	+	1869	1836	1870	0.9818182
A03	2021494	2025469	A03p05040.2_BraZ1	2233.69	+	2441	3686	3975	0.9272956
A03	2026052	2028609	A03p05050.2_BraZ1	1125.64	-	2430	2405	2557	0.9405553
A03	2037937	2062013	A03p05060.2_BraZ1	2695.67	+	14617	22436	24076	0.9318824
A03	2045407	2046291	A03p05070.2_BraZ1	669	-	983	884	884	1.0000000
A03	2047423	2048327	A03p05080.2_BraZ1	480.125	-	880	904	904	1.0000000
A03	2062737	2063098	A03p05090.2_BraZ1	162	-	429	361	361	1.0000000
A03	2063144	2063919	A03p05100.2_BraZ1	408	-	664	775	775	1.0000000
A03	2064419	2072627	A03p05110.2_BraZ1	3819.98	-	2130	5643	8208	0.6875000
A03	2075149	2078463	A03p05120.2_BraZ1	2433.43	+	1217	3121	3314	0.9417622
A03	2078586	2080191	A03p05130.2_BraZ1	160.5	-	129	854	1605	0.5320872
A03	2081862	2083255	A03p05140.2_BraZ1	1164	+	852	1305	1393	0.9368270
A03	2084282	2085618	A03p05150.2_BraZ1	4235	+	817	1336	1336	1.0000000
A03	2087016	2087211	A03p05160.2_BraZ1	19.5	+	111	195	195	1.0000000
A03	2088464	2089986	A03p05170.2_BraZ1	696.339	+	1311	1392	1522	0.9145861
A03	2090388	2091413	A03p05180.2_BraZ1	591.979	-	404	993	1025	0.9687805
A03	2091893	2093798	A03p05190.2_BraZ1	654	-	475	1007	1905	0.5286089
A03	2097290	2099902	A03p05200.2_BraZ1	663.063	+	596	1909	2612	0.7308576
A03	2100480	2102178	A03p05210.2_BraZ1	845.536	+	1088	1698	1698	1.0000000
A03	2103504	2110024	A03p05220.2_BraZ1	2637.5	-	2716	5826	6520	0.8935583
A03	2110513	2111609	A03p05230.2_BraZ1	913.5	-	1033	1096	1096	1.0000000
A03	2114088	2116630	A03p05240.2_BraZ1	1482	-	1939	2445	2542	0.9618410
A03	2125990	2126836	A03p05250.2_BraZ1	84.6	+	299	846	846	1.0000000
A03	2128163	2129837	A03p05260.2_BraZ1	558.6	+	1687	1674	1674	1.0000000
A03	2130130	2131714	A03p05270.2_BraZ1	746.719	-	1481	1584	1584	1.0000000
A03	2132488	2143515	A03p05280.2_BraZ1	1804.93	+	4686	8930	11027	0.8098304
A03	2145176	2145599	A03p05290.2_BraZ1	42.3	-	46	238	423	0.5626478
A03	2147869	2148451	A03p05300.2_BraZ1	58.2	-	840	582	582	1.0000000
A03	2149050	2150017	A03p05310.2_BraZ1	398	+	44	765	967	0.7911065
A03	2150017	2151103	A03p05320.2_BraZ1	1110.67	+	16	722	1086	0.6648250
A03	2161001	2161325	A03p05330.2_BraZ1	32.4	+	251	324	324	1.0000000
A03	2166400	2166565	A03p05340.2_BraZ1	16.5	-	281	165	165	1.0000000
A03	2167019	2170423	A03p05350.2_BraZ1	1570.21	-	2181	3347	3404	0.9832550
A03	2171143	2171608	A03p05360.2_BraZ1	46.5	-	361	465	465	1.0000000
A03	2172201	2174408	A03p05370.2_BraZ1	878.704	+	1688	2207	2207	1.0000000
A03	2175649	2176840	A03p05380.2_BraZ1	119.1	+	364	1191	1191	1.0000000
A03	2180058	2180529	A03p05390.2_BraZ1	47.1	-	346	471	471	1.0000000
A03	2181239	2181862	A03p05400.2_BraZ1	333	-	555	623	623	1.0000000
A03	2184523	2185307	A03p05410.2_BraZ1	420	-	197	756	784	0.9642857
A03	2186767	2187184	A03p05420.2_BraZ1	41.7	-	321	417	417	1.0000000
A03	2190431	2193374	A03p05430.2_BraZ1	2150.89	-	1971	2943	2943	1.0000000
A03	2195523	2197290	A03p05440.2_BraZ1	176.7	-	1841	1767	1767	1.0000000
A03	2200373	2202359	A03p05450.2_BraZ1	1602.67	+	1273	1923	1986	0.9682779
A03	2203165	2203540	A03p05460.2_BraZ1	37.5	-	177	375	375	1.0000000
A03	2204698	2205081	A03p05470.2_BraZ1	195	+	158	260	383	0.6788512
A03	2206288	2212879	A03p05480.2_BraZ1	2805.75	+	4272	6579	6591	0.9981793
A03	2214229	2217120	A03p05490.2_BraZ1	1794.16	+	2066	2875	2891	0.9944656
A03	2217683	2218904	A03p05500.2_BraZ1	638.25	-	789	1221	1221	1.0000000
A03	2220931	2221237	A03p05510.2_BraZ1	30.6	+	41	197	306	0.6437908
A03	2222401	2224401	A03p05520.2_BraZ1	317.591	-	2644	2000	2000	1.0000000
A03	2225466	2227955	A03p05530.2_BraZ1	2859.38	+	2776	2489	2489	1.0000000
A03	2228065	2231523	A03p05540.2_BraZ1	1522.89	-	2946	3458	3458	1.0000000
A03	2232514	2233129	A03p05550.2_BraZ1	61.5	-	29	431	615	0.7008130
A03	2237654	2239213	A03p05560.2_BraZ1	793.108	-	273	1390	1559	0.8915972
A03	2240888	2242083	A03p05570.2_BraZ1	115.8	-	167	832	1195	0.6962343
A03	2243953	2245570	A03p05580.2_BraZ1	883.575	-	603	1617	1617	1.0000000
A03	2247283	2248447	A03p05590.2_BraZ1	116.4	-	164	1072	1164	0.9209622
A03	2249836	2251578	A03p05600.2_BraZ1	795	-	1174	1742	1742	1.0000000
A03	2257574	2262460	A03p05610.2_BraZ1	2345.62	-	2676	4688	4886	0.9594761
A03	2264323	2270822	A03p05620.2_BraZ1	3967.7	+	339	3775	6499	0.5808586
A03	2271633	2280898	A03p05630.2_BraZ1	1643.87	-	2190	6026	9265	0.6504048
A03	2282488	2292673	A03p05640.2_BraZ1	899.153	-	3186	6115	10185	0.6003928
A03	2289582	2291532	A03p05650.2_BraZ1	285	-	795	1628	1950	0.8348718
A03	2292324	2294437	A03p05660.2_BraZ1	1462.94	-	1222	1855	2113	0.8778987
A03	2300905	2301541	A03p05670.2_BraZ1	558	+	433	636	636	1.0000000
A03	2301715	2304072	A03p05680.2_BraZ1	1104.07	-	830	2146	2357	0.9104794
A03	2304546	2305935	A03p05690.2_BraZ1	712.241	-	1423	1389	1389	1.0000000
A03	2306887	2307022	A03p05700.2_BraZ1	13.5	+	2	83	135	0.6148148
A03	2308393	2310357	A03p05710.2_BraZ1	8430	-	570	1521	1964	0.7744399
A03	2313112	2315904	A03p05720.2_BraZ1	12397	-	840	2559	2792	0.9165473
A03	2316501	2319942	A03p05730.2_BraZ1	1149.61	-	3017	3345	3441	0.9721012
A03	2320602	2322593	A03p05740.2_BraZ1	1188.92	-	1300	1981	1991	0.9949774
A03	2324076	2324286	A03p05750.2_BraZ1	20.4	+	100	210	210	1.0000000
A03	2326813	2335491	A03p05760.2_BraZ1	1911.37	+	2084	5229	8678	0.6025582
A03	2336867	2339177	A03p05770.2_BraZ1	231	+	168	2063	2310	0.8930736
A03	2339440	2341923	A03p05780.2_BraZ1	815.778	-	775	1767	2483	0.7116392
A03	2343130	2343640	A03p05790.2_BraZ1	240	-	73	510	510	1.0000000
A03	2344474	2346579	A03p05800.2_BraZ1	1006.96	-	1308	2105	2105	1.0000000
A03	2347639	2350814	A03p05810.2_BraZ1	1793.3	+	2115	3149	3175	0.9918110
A03	2357673	2359002	A03p05820.2_BraZ1	5162.62	+	1098	1329	1329	1.0000000
A03	2359449	2361143	A03p05830.2_BraZ1	444	-	254	1138	1694	0.6717828
A03	2363704	2364463	A03p05840.2_BraZ1	75.9	-	573	759	759	1.0000000
A03	2367856	2372497	A03p05850.2_BraZ1	2571.43	+	3136	4410	4641	0.9502262
A03	2372813	2374629	A03p05860.2_BraZ1	729.13	-	1144	1524	1816	0.8392071
A03	2375840	2377724	A03p05870.2_BraZ1	188.4	-	227	1113	1884	0.5907643
A03	2379046	2381124	A03p05880.2_BraZ1	1148.85	+	923	2066	2078	0.9942252
A03	2382350	2384079	A03p05890.2_BraZ1	720.857	-	1661	1729	1729	1.0000000
A03	2400595	2401693	A03p05900.2_BraZ1	747	+	627	1081	1098	0.9845173
A03	2412974	2414432	A03p05910.2_BraZ1	2352	+	69	604	1458	0.4142661
A03	2414287	2414481	A03p05920.2_BraZ1	171	-	24	128	194	0.6597938
A03	2414758	2414932	A03p05930.2_BraZ1	17.4	-	126	174	174	1.0000000
A03	2419976	2420081	A03p05940.2_BraZ1	10.5	-	158	105	105	1.0000000
A03	2424897	2425068	A03p05950.2_BraZ1	17.1	-	75	92	171	0.5380117
A03	2431244	2438999	A03p05960.2_BraZ1	1054.61	+	2280	5716	7755	0.7370729
A03	2439681	2441108	A03p05970.2_BraZ1	846.429	-	791	1401	1427	0.9817799
A03	2442310	2447256	A03p05980.2_BraZ1	2258.29	-	2732	4690	4946	0.9482410
A03	2449600	2454525	A03p05990.2_BraZ1	1302.92	+	858	4357	4925	0.8846701
A03	2456685	2459044	A03p06000.2_BraZ1	410.083	+	651	2154	2359	0.9130988
A03	2463440	2467138	A03p06010.2_BraZ1	1134.93	+	958	3383	3698	0.9148188
A03	2467762	2469881	A03p06020.2_BraZ1	1125.28	-	1810	2088	2119	0.9853705
A03	2470503	2471993	A03p06030.2_BraZ1	398.87	-	1088	1490	1490	1.0000000
A03	2472700	2474171	A03p06040.2_BraZ1	589.13	-	1275	1471	1471	1.0000000
A03	2474590	2475781	A03p06050.2_BraZ1	735	-	820	1191	1191	1.0000000
A03	2477153	2479305	A03p06060.2_BraZ1	1272.23	+	1066	2079	2152	0.9660780
A03	2479712	2483940	A03p06070.2_BraZ1	1856.4	-	1609	3936	4228	0.9309366
A03	2485454	2486770	A03p06080.2_BraZ1	981.346	+	97	1078	1316	0.8191490
A03	2488242	2490389	A03p06090.2_BraZ1	465.206	+	1563	2147	2147	1.0000000
A03	2491715	2499286	A03p06100.2_BraZ1	4469.36	+	3107	6916	7571	0.9134856
A03	2499683	2503514	A03p06110.2_BraZ1	2066.4	-	2212	3598	3831	0.9391804
A03	2506954	2507991	A03p06120.2_BraZ1	48.3	-	336	880	1037	0.8486018
A03	2508476	2509661	A03p06130.2_BraZ1	118.5	+	369	1185	1185	1.0000000
A03	2510859	2516205	A03p06140.2_BraZ1	3611.17	-	1339	4641	5346	0.8681257
A03	2518926	2520571	A03p06150.2_BraZ1	1359.43	+	1509	1645	1645	1.0000000
A03	2521540	2524584	A03p06160.2_BraZ1	1407.57	-	878	2605	3044	0.8557819
A03	2526230	2533388	A03p06170.2_BraZ1	853.636	-	2418	6423	7158	0.8973177
A03	2533641	2541039	A03p06180.2_BraZ1	1633.52	+	3978	6622	7398	0.8951068
A03	2541557	2543236	A03p06190.2_BraZ1	953.04	-	1429	1590	1679	0.9469923
A03	2549041	2551016	A03p06200.2_BraZ1	1378.09	-	1009	1975	1975	1.0000000
A03	2552423	2553218	A03p06210.2_BraZ1	79.5	+	440	770	795	0.9685535
A03	2557579	2559959	A03p06220.2_BraZ1	1086.67	+	1640	2380	2380	1.0000000
A03	2560849	2563058	A03p06230.2_BraZ1	1405.66	-	1144	2204	2209	0.9977365
A03	2563824	2565152	A03p06240.2_BraZ1	790.903	-	105	722	1328	0.5436747
A03	2565892	2566387	A03p06250.2_BraZ1	49.5	-	350	495	495	1.0000000
A03	2567888	2568527	A03p06260.2_BraZ1	63.9	-	392	639	639	1.0000000
A03	2570982	2572357	A03p06270.2_BraZ1	1202.81	-	410	1375	1375	1.0000000
A03	2573268	2574722	A03p06280.2_BraZ1	1191	+	376	1421	1454	0.9773040
A03	2575510	2577291	A03p06290.2_BraZ1	1150.5	-	1170	1781	1781	1.0000000
A03	2578182	2581649	A03p06300.2_BraZ1	1454.33	+	1892	3337	3467	0.9625036
A03	2582408	2587921	A03p06310.2_BraZ1	2459.48	+	3939	5437	5513	0.9862144
A03	2588131	2590177	A03p06320.2_BraZ1	204.6	-	263	1866	2046	0.9120235
A03	2593817	2594681	A03p06330.2_BraZ1	73.5	+	547	853	864	0.9872685
A03	2597870	2598371	A03p06340.2_BraZ1	50.1	+	156	501	501	1.0000000
A03	2601571	2603737	A03p06350.2_BraZ1	1110.88	-	1683	2166	2166	1.0000000
A03	2604924	2606399	A03p06360.2_BraZ1	567.955	+	672	1468	1475	0.9952542
A03	2607479	2610916	A03p06370.2_BraZ1	1039.34	-	1378	3369	3437	0.9802153
A03	2610606	2610841	A03p06380.2_BraZ1	183	+	204	235	235	1.0000000
A03	2611441	2612220	A03p06390.2_BraZ1	289.385	+	473	779	779	1.0000000
A03	2612055	2613989	A03p06400.2_BraZ1	941.538	+	777	1887	1934	0.9756981
A03	2618466	2619105	A03p06410.2_BraZ1	414	+	164	476	639	0.7449139
A03	2621766	2623354	A03p06420.2_BraZ1	1084.77	+	399	1588	1588	1.0000000
A03	2626903	2627116	A03p06430.2_BraZ1	21.3	-	60	199	213	0.9342723
A03	2628897	2631662	A03p06440.2_BraZ1	1822.23	+	1202	2731	2765	0.9877034
A03	2633967	2634381	A03p06450.2_BraZ1	41.4	+	210	402	414	0.9710145
A03	2634576	2635973	A03p06460.2_BraZ1	1158	-	635	1363	1397	0.9756621
A03	2636487	2641945	A03p06470.2_BraZ1	2870.14	-	2792	5175	5458	0.9481495
A03	2647267	2654025	A03p06480.2_BraZ1	2149.04	+	1912	3718	6758	0.5501628
A03	2648013	2650770	A03p06490.2_BraZ1	513	-	0	0	2757	0.0000000
A03	2654244	2655368	A03p06500.2_BraZ1	726.304	-	708	1124	1124	1.0000000
A03	2656164	2658502	A03p06510.2_BraZ1	968.765	+	1516	2338	2338	1.0000000
A03	2659768	2661692	A03p06520.2_BraZ1	1296	+	700	1886	1924	0.9802495
A03	2662116	2662881	A03p06530.2_BraZ1	51	-	268	765	765	1.0000000
A03	2664229	2664834	A03p06540.2_BraZ1	381	-	631	605	605	1.0000000
A03	2667234	2668315	A03p06550.2_BraZ1	5992.5	+	188	587	1081	0.5430157
A03	2669916	2671833	A03p06560.2_BraZ1	191.7	-	770	1834	1917	0.9567032
A03	2675267	2676036	A03p06570.2_BraZ1	11316	+	194	658	769	0.8556567
A03	2676793	2680366	A03p06580.2_BraZ1	930	-	1134	2688	3573	0.7523090
A03	2684081	2684510	A03p06590.2_BraZ1	42.9	-	7	41	429	0.0955711
A03	2685930	2687880	A03p06600.2_BraZ1	1291.89	-	982	1950	1950	1.0000000
A03	2689183	2692384	A03p06610.2_BraZ1	1613.85	+	829	2386	3201	0.7453921
A03	2692722	2694080	A03p06620.2_BraZ1	748	-	186	1292	1358	0.9513991
A03	2696098	2698669	A03p06630.2_BraZ1	904.313	+	34	580	2571	0.2255931
A03	2701498	2702921	A03p06640.2_BraZ1	1167	+	340	1306	1423	0.9177793
A03	2703677	2703833	A03p06650.2_BraZ1	15.6	-	76	156	156	1.0000000
A03	2704655	2706514	A03p06660.2_BraZ1	960.75	-	477	1601	1859	0.8612157
A03	2710140	2711892	A03p06670.2_BraZ1	833	-	811	1615	1752	0.9218037
A03	2713989	2715059	A03p06680.2_BraZ1	984	-	216	1048	1070	0.9794393
A03	2717071	2720394	A03p06690.2_BraZ1	1760.79	-	1549	3161	3323	0.9512489
A03	2722626	2727438	A03p06700.2_BraZ1	2716.73	-	2532	4716	4812	0.9800498
A03	2729673	2732862	A03p06710.2_BraZ1	1421.75	-	2437	3006	3189	0.9426152
A03	2733167	2735543	A03p06720.2_BraZ1	1125.58	-	871	2248	2376	0.9461280
A03	2736545	2737615	A03p06730.2_BraZ1	340.278	+	686	1070	1070	1.0000000
A03	2742518	2744799	A03p06740.2_BraZ1	804.491	+	729	1827	2281	0.8009645
A03	2745407	2746962	A03p06750.2_BraZ1	784.833	-	883	1518	1555	0.9762058
A03	2748676	2750785	A03p06760.2_BraZ1	1440.86	+	511	1774	2109	0.8411570
A03	2751597	2760508	A03p06770.2_BraZ1	1167.71	+	1934	3922	8911	0.4401302
A03	2763844	2765468	A03p06780.2_BraZ1	1500	+	1922	1624	1624	1.0000000
A03	2765797	2773912	A03p06790.2_BraZ1	3359.73	-	1590	3798	8115	0.4680222
A03	2777515	2783751	A03p06800.2_BraZ1	3551.14	-	2195	5438	6236	0.8720334
A03	2790586	2804067	A03p06810.2_BraZ1	2702.98	+	6043	12361	13481	0.9169201
A03	2804858	2806885	A03p06820.2_BraZ1	1868.5	+	823	1971	2027	0.9723729
A03	2807690	2809572	A03p06830.2_BraZ1	1428	+	423	1245	1882	0.6615303
A03	2811000	2811333	A03p06840.2_BraZ1	216	+	81	333	333	1.0000000
A03	2812642	2813207	A03p06850.2_BraZ1	312	+	77	521	565	0.9221239
A03	2815185	2816846	A03p06860.2_BraZ1	848.25	+	760	1550	1661	0.9331728
A03	2817436	2818142	A03p06870.2_BraZ1	2145	-	407	706	706	1.0000000
A03	2825650	2827911	A03p06880.2_BraZ1	1586	+	168	1571	2261	0.6948253
A03	2829125	2831371	A03p06890.2_BraZ1	1557.22	+	359	1587	2246	0.7065895
A03	2833940	2835464	A03p06900.2_BraZ1	7777.5	-	170	1057	1524	0.6935695
A03	2845792	2846815	A03p06910.2_BraZ1	2707.5	-	97	648	1023	0.6334311
A03	2851658	2855857	A03p06920.2_BraZ1	1612.67	-	1968	3920	4199	0.9335556
A03	2857244	2858530	A03p06930.2_BraZ1	63	-	251	1269	1286	0.9867807
A03	2859260	2859902	A03p06940.2_BraZ1	459	-	405	642	642	1.0000000
A03	2863145	2864019	A03p06950.2_BraZ1	288.435	+	221	842	874	0.9633867
A03	2864911	2865556	A03p06960.2_BraZ1	64.5	-	263	645	645	1.0000000
A03	2866939	2867503	A03p06970.2_BraZ1	209.1	+	121	500	564	0.8865248
A03	2868789	2871147	A03p06980.2_BraZ1	1577.86	+	486	2229	2358	0.9452926
A03	2873011	2873741	A03p06990.2_BraZ1	564	+	395	730	730	1.0000000
A03	2877166	2878456	A03p07000.2_BraZ1	949.652	+	446	1290	1290	1.0000000
A03	2879895	2880600	A03p07010.2_BraZ1	155.688	+	493	705	705	1.0000000
A03	2882172	2883121	A03p07020.2_BraZ1	513	-	97	765	949	0.8061117
A03	2884706	2886095	A03p07030.2_BraZ1	138.9	+	749	1389	1389	1.0000000
A03	2887942	2888925	A03p07040.2_BraZ1	897	+	249	941	983	0.9572737
A03	2889448	2890163	A03p07050.2_BraZ1	38.4	-	214	614	715	0.8587413
A03	2891455	2894075	A03p07060.2_BraZ1	2147.87	-	912	2404	2620	0.9175572
A03	2895487	2896591	A03p07070.2_BraZ1	110.4	-	200	1021	1104	0.9248188
A03	2897544	2899983	A03p07080.2_BraZ1	1829.75	-	473	2385	2439	0.9778598
A03	2902045	2903988	A03p07090.2_BraZ1	1410	-	299	1647	1943	0.8476583
A03	2905628	2907021	A03p07100.2_BraZ1	704.9	+	1126	1379	1393	0.9899498
A03	2911458	2912188	A03p07110.2_BraZ1	5481	+	305	730	730	1.0000000
A03	2913503	2917115	A03p07120.2_BraZ1	2142.17	+	1199	3364	3612	0.9313400
A03	2918161	2924402	A03p07130.2_BraZ1	240.6	+	3438	6112	6241	0.9793302
A03	2923060	2924239	A03p07140.2_BraZ1	117.9	+	717	1179	1179	1.0000000
A03	2927640	2936593	A03p07150.2_BraZ1	2406.26	+	4841	8795	8953	0.9823523
A03	2943331	2943595	A03p07160.2_BraZ1	26.4	-	0	0	264	0.0000000
A03	2944087	2945797	A03p07170.2_BraZ1	1025.82	+	735	1685	1710	0.9853801
A03	2946035	2954823	A03p07180.2_BraZ1	5155.71	-	753	3506	8788	0.3989531
A03	2955055	2955533	A03p07190.2_BraZ1	55.625	-	384	478	478	1.0000000
A03	2956627	2957935	A03p07200.2_BraZ1	130.8	+	935	1297	1308	0.9915902
A03	2958392	2959848	A03p07210.2_BraZ1	1155.81	-	1356	1456	1456	1.0000000
A03	2962632	2964689	A03p07220.2_BraZ1	1289.61	-	2152	2057	2057	1.0000000
A03	2970457	2972287	A03p07230.2_BraZ1	183	+	6	19	1830	0.0103825
A03	2974619	2975934	A03p07240.2_BraZ1	549	+	1238	1315	1315	1.0000000
A03	2976860	2977784	A03p07250.2_BraZ1	574.588	+	92	728	924	0.7878788
A03	2978337	2980484	A03p07260.2_BraZ1	711.167	-	364	1942	2147	0.9045179
A03	2982666	2985575	A03p07270.2_BraZ1	1607.75	+	1277	2909	2909	1.0000000
A03	2994566	2995148	A03p07280.2_BraZ1	58.2	+	180	465	582	0.7989691
A03	2997186	2997360	A03p07290.2_BraZ1	17.4	-	111	174	174	1.0000000
A03	2998242	3000190	A03p07300.2_BraZ1	657.25	-	1123	1922	1948	0.9866530
A03	3004889	3007394	A03p07310.2_BraZ1	1035	+	0	0	2505	0.0000000
A03	3007545	3012547	A03p07320.2_BraZ1	1349.92	-	0	0	5002	0.0000000
A03	3013256	3013754	A03p07330.2_BraZ1	291	+	0	0	498	0.0000000
A03	3016444	3016942	A03p07340.2_BraZ1	291	-	0	0	498	0.0000000
A03	3017654	3022642	A03p07350.2_BraZ1	1184.97	+	0	0	4988	0.0000000
A03	3022793	3025298	A03p07360.2_BraZ1	1035	-	0	0	2505	0.0000000
A03	3033090	3034622	A03p07370.2_BraZ1	983.047	-	312	1278	1532	0.8342037
A03	3038281	3040303	A03p07380.2_BraZ1	202.2	+	1497	1986	2022	0.9821959
A03	3042023	3043820	A03p07390.2_BraZ1	1434	-	1238	1790	1797	0.9961046
A03	3044377	3045906	A03p07400.2_BraZ1	1025.03	+	375	1478	1529	0.9666449
A03	3046918	3050254	A03p07410.2_BraZ1	41737.5	+	670	2277	3336	0.6825539
A03	3051550	3052080	A03p07420.2_BraZ1	420	+	590	530	530	1.0000000
A03	3052174	3053266	A03p07430.2_BraZ1	109.2	+	755	1092	1092	1.0000000
A03	3058601	3061198	A03p07440.2_BraZ1	1763.46	+	944	1845	2597	0.7104351
A03	3061457	3062081	A03p07450.2_BraZ1	56.4706	+	528	615	624	0.9855769
A03	3065529	3066436	A03p07460.2_BraZ1	816	+	615	907	907	1.0000000
A03	3067973	3068126	A03p07470.2_BraZ1	15.3	-	69	96	153	0.6274510
A03	3072743	3074974	A03p07480.2_BraZ1	783.214	+	518	1743	2231	0.7812640
A03	3075769	3079254	A03p07490.2_BraZ1	1588.2	-	1478	3463	3485	0.9936872
A03	3081186	3082285	A03p07500.2_BraZ1	492.042	-	1416	1099	1099	1.0000000
A03	3084515	3085454	A03p07510.2_BraZ1	549.895	+	245	913	939	0.9723110
A03	3085738	3089390	A03p07520.2_BraZ1	1167.76	+	3044	3652	3652	1.0000000
A03	3090258	3091167	A03p07530.2_BraZ1	90.9	-	311	701	909	0.7711771
A03	3092226	3093789	A03p07540.2_BraZ1	1212	+	1405	1510	1563	0.9660909
A03	3094823	3097858	A03p07550.2_BraZ1	1193.06	-	1680	2919	3035	0.9617792
A03	3101145	3103121	A03p07560.2_BraZ1	13230	-	890	1823	1976	0.9225708
A03	3104666	3105212	A03p07570.2_BraZ1	54.6	-	204	546	546	1.0000000
A03	3106208	3111425	A03p07580.2_BraZ1	2620.7	+	7852	5217	5217	1.0000000
A03	3112017	3119425	A03p07590.2_BraZ1	3171.15	-	3662	5874	7408	0.7929265
A03	3120162	3123964	A03p07600.2_BraZ1	24476	+	2097	3623	3802	0.9529195
A03	3124199	3125530	A03p07610.2_BraZ1	934.471	-	2070	1331	1331	1.0000000
A03	3126300	3127103	A03p07620.2_BraZ1	735	-	796	803	803	1.0000000
A03	3128214	3129299	A03p07630.2_BraZ1	2799	-	1776	1085	1085	1.0000000
A03	3135738	3136460	A03p07640.2_BraZ1	569.605	-	250	558	722	0.7728532
A03	3136511	3136670	A03p07650.2_BraZ1	15.9	+	88	159	159	1.0000000
A03	3137076	3138732	A03p07660.2_BraZ1	165.6	-	348	1517	1656	0.9160628
A03	3140134	3140965	A03p07670.2_BraZ1	5610	-	346	831	831	1.0000000
A03	3141357	3143532	A03p07680.2_BraZ1	738	-	1676	2113	2175	0.9714943
A03	3144544	3146152	A03p07690.2_BraZ1	160.8	+	479	1434	1608	0.8917910
A03	3147595	3149474	A03p07700.2_BraZ1	753.136	+	751	1868	1879	0.9941458
A03	3150128	3150697	A03p07710.2_BraZ1	501	+	275	569	569	1.0000000
A03	3150882	3152190	A03p07720.2_BraZ1	1071	-	704	1308	1308	1.0000000
A03	3152999	3153542	A03p07730.2_BraZ1	54.3	+	96	497	543	0.9152855
A03	3154896	3156963	A03p07740.2_BraZ1	1607.36	-	83	1368	2067	0.6618288
A03	3157666	3157984	A03p07750.2_BraZ1	31.8	+	342	318	318	1.0000000
A03	3158217	3173936	A03p07760.2_BraZ1	1728.85	-	6048	12759	15719	0.8116928
A03	3166097	3168175	A03p07770.2_BraZ1	987.511	+	293	1638	2078	0.7882580
A03	3168775	3169810	A03p07780.2_BraZ1	530	+	778	1035	1035	1.0000000
A03	3183675	3186152	A03p07790.2_BraZ1	1001.45	+	264	1452	2477	0.5861930
A03	3186540	3189763	A03p07800.2_BraZ1	572.308	-	2907	3223	3223	1.0000000
A03	3189882	3194525	A03p07810.2_BraZ1	3380.71	-	1809	4506	4643	0.9704932
A03	3198200	3198980	A03p07820.2_BraZ1	723	+	176	714	780	0.9153846
A03	3200950	3203366	A03p07830.2_BraZ1	2346	+	590	2399	2416	0.9929636
A03	3204604	3205585	A03p07840.2_BraZ1	98.1	+	432	975	981	0.9938838
A03	3207025	3209334	A03p07850.2_BraZ1	1133	+	478	2245	2309	0.9722824
A03	3215004	3216550	A03p07860.2_BraZ1	1116.67	+	177	806	1546	0.5213454
A03	3218189	3219858	A03p07870.2_BraZ1	723.6	-	973	1669	1669	1.0000000
A03	3224515	3224833	A03p07880.2_BraZ1	726	+	474	318	318	1.0000000
A03	3226595	3227000	A03p07890.2_BraZ1	312	+	281	405	405	1.0000000
A03	3229357	3229768	A03p07900.2_BraZ1	318	+	287	411	411	1.0000000
A03	3233818	3235611	A03p07910.2_BraZ1	801.054	-	1349	1757	1793	0.9799219
A03	3236904	3238341	A03p07920.2_BraZ1	488.323	+	399	1421	1437	0.9888657
A03	3239362	3241738	A03p07930.2_BraZ1	1679	+	924	2337	2376	0.9835858
A03	3242606	3245101	A03p07940.2_BraZ1	2154	-	780	1690	2495	0.6773547
A03	3245787	3248101	A03p07950.2_BraZ1	1547.51	+	1541	2314	2314	1.0000000
A03	3248692	3249520	A03p07960.2_BraZ1	324	-	706	828	828	1.0000000
A03	3250971	3252348	A03p07970.2_BraZ1	1172.16	+	274	1132	1377	0.8220770
A03	3252797	3255387	A03p07980.2_BraZ1	1382.91	+	766	2419	2590	0.9339768
A03	3255690	3256101	A03p07990.2_BraZ1	41.1	-	384	411	411	1.0000000
A03	3256588	3256903	A03p08000.2_BraZ1	31.2	+	71	246	315	0.7809524
A03	3257978	3260227	A03p08010.2_BraZ1	867.504	-	788	2107	2249	0.9368608
A03	3261338	3268862	A03p08020.2_BraZ1	3043.26	+	705	4344	7524	0.5773525
A03	3269062	3270693	A03p08030.2_BraZ1	273.9	-	708	1380	1631	0.8461067
A03	3275438	3277099	A03p08040.2_BraZ1	459.092	+	544	1496	1661	0.9006622
A03	3278502	3279357	A03p08050.2_BraZ1	152	-	152	815	855	0.9532164
A03	3281706	3282011	A03p08060.2_BraZ1	228	+	0	0	305	0.0000000
A03	3282150	3282804	A03p08070.2_BraZ1	516	+	0	0	654	0.0000000
A03	3283105	3283503	A03p08080.2_BraZ1	388	+	0	0	398	0.0000000
A03	3285721	3289935	A03p08090.2_BraZ1	668.667	-	1074	3495	4214	0.8293782
A03	3291492	3292358	A03p08100.2_BraZ1	1266	-	778	866	866	1.0000000
A03	3294288	3296878	A03p08110.2_BraZ1	1284.8	-	806	2362	2590	0.9119691
A03	3297966	3299965	A03p08120.2_BraZ1	1185.55	-	708	1846	1999	0.9234617
A03	3304220	3306725	A03p08130.2_BraZ1	1296.24	-	1728	2467	2505	0.9848303
A03	3309753	3314577	A03p08140.2_BraZ1	1917.35	+	3750	4741	4824	0.9827943
A03	3314882	3322358	A03p08150.2_BraZ1	1804.95	-	4210	7223	7476	0.9661584
A03	3324047	3326292	A03p08160.2_BraZ1	1355.86	+	1075	1591	2245	0.7086860
A03	3327569	3362623	A03p08170.2_BraZ1	2576.17	+	9990	29652	35054	0.8458949
A03	3337542	3340245	A03p08180.2_BraZ1	375	-	283	2168	2703	0.8020718
A03	3343612	3343975	A03p08190.2_BraZ1	36.3	-	18	351	363	0.9669421
A03	3346690	3357251	A03p08200.2_BraZ1	210	-	2824	9298	10561	0.8804091
A03	3348273	3349146	A03p08210.2_BraZ1	363	-	208	846	873	0.9690722
A03	3351698	3352499	A03p08220.2_BraZ1	459	+	19	504	801	0.6292135
A03	3355033	3355396	A03p08230.2_BraZ1	36.3	-	115	342	363	0.9421487
A03	3363017	3367854	A03p08240.2_BraZ1	2615.77	-	941	4002	4837	0.8273723
A03	3368764	3371215	A03p08250.2_BraZ1	590.952	+	1081	2230	2451	0.9098327
A03	3372118	3373222	A03p08260.2_BraZ1	110.4	-	1050	1104	1104	1.0000000
A03	3375734	3376865	A03p08270.2_BraZ1	113.1	-	1305	1131	1131	1.0000000
A03	3378595	3379657	A03p08280.2_BraZ1	347.667	+	0	0	1062	0.0000000
A03	3382223	3383362	A03p08290.2_BraZ1	861	-	216	1139	1139	1.0000000
A03	3385852	3389853	A03p08300.2_BraZ1	1419	-	636	2218	4001	0.5543614
A03	3387381	3389160	A03p08310.2_BraZ1	2895	-	128	482	1779	0.2709387
A03	3393073	3394271	A03p08320.2_BraZ1	3549	+	734	1153	1198	0.9624374
A03	3394973	3395330	A03p08330.2_BraZ1	35.7	-	23	259	357	0.7254902
A03	3397289	3398279	A03p08340.2_BraZ1	99	-	718	990	990	1.0000000
A03	3400597	3401275	A03p08350.2_BraZ1	528	-	155	472	678	0.6961652
A03	3403419	3405063	A03p08360.2_BraZ1	672.75	-	845	1589	1644	0.9665450
A03	3407183	3409101	A03p08370.2_BraZ1	1467	-	485	1350	1918	0.7038582
A03	3411679	3413579	A03p08380.2_BraZ1	821.829	-	1478	1900	1900	1.0000000
A03	3414302	3416931	A03p08390.2_BraZ1	2096.86	-	613	2164	2629	0.8231267
A03	3420189	3422114	A03p08400.2_BraZ1	942	+	5088	468	1925	0.2431169
A03	3422961	3424912	A03p08410.2_BraZ1	915.722	-	21	118	1951	0.0604818
A03	3425759	3427434	A03p08420.2_BraZ1	351	+	90	1042	1675	0.6220896
A03	3428812	3429622	A03p08430.2_BraZ1	462.971	-	0	0	810	0.0000000
A03	3429912	3430251	A03p08440.2_BraZ1	33.3	+	22	125	339	0.3687316
A03	3430927	3436175	A03p08450.2_BraZ1	25498.5	-	2977	4933	5248	0.9399771
A03	3437539	3441921	A03p08460.2_BraZ1	6643.56	+	3288	4382	4382	1.0000000
A03	3445466	3446947	A03p08470.2_BraZ1	31032	+	13	424	1481	0.2862931
A03	3448362	3452854	A03p08480.2_BraZ1	72712.5	+	285	2334	4492	0.5195904
A03	3452880	3453180	A03p08490.2_BraZ1	30	-	9	79	300	0.2633333
A03	3459094	3462529	A03p08500.2_BraZ1	2161.49	+	566	2533	3435	0.7374090
A03	3463424	3463703	A03p08510.2_BraZ1	27.9	-	0	0	279	0.0000000
A03	3464536	3464821	A03p08520.2_BraZ1	28.5	+	10	80	285	0.2807018
A03	3465456	3465736	A03p08530.2_BraZ1	267	-	7	96	280	0.3428572
A03	3466428	3469131	A03p08540.2_BraZ1	438	+	374	2266	2703	0.8383278
A03	3467707	3470230	A03p08550.2_BraZ1	267	-	307	2440	2523	0.9671026
A03	3471242	3472874	A03p08560.2_BraZ1	163.2	+	187	1325	1632	0.8118873
A03	3475319	3476675	A03p08570.2_BraZ1	596.354	-	150	839	1356	0.6187316
A03	3477281	3478826	A03p08580.2_BraZ1	691.2	+	154	419	1545	0.2711974
A03	3480285	3481793	A03p08590.2_BraZ1	7353	+	26	452	1508	0.2997347
A03	3482588	3482916	A03p08600.2_BraZ1	252	-	13	273	328	0.8323171
A03	3486942	3488363	A03p08610.2_BraZ1	200.75	-	25	448	1421	0.3152709
A03	3516428	3517458	A03p08620.2_BraZ1	533.682	-	111	669	1030	0.6495146
A03	3518528	3519089	A03p08630.2_BraZ1	56.1	-	32	425	561	0.7575758
A03	3519744	3523191	A03p08640.2_BraZ1	1897.7	-	76	628	3447	0.1821874
A03	3524476	3529731	A03p08650.2_BraZ1	2313.71	-	477	2006	5255	0.3817317
A03	3530438	3533482	A03p08660.2_BraZ1	483.732	+	36	724	3044	0.2378449
A03	3537362	3538890	A03p08670.2_BraZ1	101.4	-	2	19	1528	0.0124346
A03	3554482	3563070	A03p08680.2_BraZ1	3017.25	-	799	3456	8588	0.4024220
A03	3569293	3572926	A03p08690.2_BraZ1	69.6	-	2806	3490	3633	0.9606386
A03	3571369	3572640	A03p08700.2_BraZ1	570	-	839	1128	1271	0.8874902
A03	3573792	3574209	A03p08710.2_BraZ1	231	-	334	417	417	1.0000000
A03	3576006	3585872	A03p08720.2_BraZ1	2306	-	4006	8595	9866	0.8711737
A03	3593224	3593614	A03p08730.2_BraZ1	156	-	223	389	390	0.9974359
A03	3594725	3596700	A03p08740.2_BraZ1	1419	-	1170	1935	1975	0.9797468
A03	3597012	3600468	A03p08750.2_BraZ1	2097	+	1262	2524	3456	0.7303241
A03	3601483	3601924	A03p08760.2_BraZ1	44.1	-	55	419	441	0.9501134
A03	3602217	3603609	A03p08770.2_BraZ1	139.2	+	566	1346	1392	0.9669541
A03	3604202	3606149	A03p08780.2_BraZ1	399.995	-	65	191	1947	0.0980996
A03	3606591	3616497	A03p08790.2_BraZ1	3057.17	-	4402	8944	9906	0.9028872
A03	3616975	3618423	A03p08800.2_BraZ1	6981	+	115	714	1448	0.4930939
A03	3618858	3619495	A03p08810.2_BraZ1	62.2857	-	205	630	637	0.9890110
A03	3620021	3623389	A03p08820.2_BraZ1	1039.32	-	1762	2962	3368	0.8794537
A03	3625395	3626274	A03p08830.2_BraZ1	87.9	-	6	160	879	0.1820250
A03	3631199	3632420	A03p08840.2_BraZ1	122.1	+	0	0	1221	0.0000000
A03	3632707	3635023	A03p08850.2_BraZ1	1528.96	-	53	391	2316	0.1688256
A03	3637114	3639147	A03p08860.2_BraZ1	1458.34	+	267	488	2033	0.2400393
A03	3640045	3641365	A03p08870.2_BraZ1	132	+	212	388	1320	0.2939394
A03	3645405	3647612	A03p08880.2_BraZ1	1157.57	+	281	1700	2207	0.7702764
A03	3650183	3651173	A03p08890.2_BraZ1	99	-	427	857	990	0.8656566
A03	3656187	3656764	A03p08900.2_BraZ1	504	+	710	577	577	1.0000000
A03	3657739	3660477	A03p08910.2_BraZ1	1262.41	+	1077	2714	2738	0.9912345
A03	3661078	3661387	A03p08920.2_BraZ1	30.9	-	169	309	309	1.0000000
A03	3672861	3675243	A03p08930.2_BraZ1	1389.18	+	1133	2381	2382	0.9995802
A03	3679276	3681417	A03p08940.2_BraZ1	713.855	+	1900	2141	2141	1.0000000
A03	3681807	3682324	A03p08950.2_BraZ1	324	-	420	483	517	0.9342360
A03	3682081	3682542	A03p08960.2_BraZ1	282	-	398	456	461	0.9891540
A03	3683796	3684952	A03p08970.2_BraZ1	189	-	92	929	1156	0.8036332
A03	3687358	3688950	A03p08980.2_BraZ1	514.133	+	191	1357	1592	0.8523870
A03	3690806	3693097	A03p08990.2_BraZ1	160.2	+	1479	2099	2291	0.9161938
A03	3694058	3696182	A03p09000.2_BraZ1	212.4	-	800	2046	2124	0.9632769
A03	3701389	3701751	A03p09010.2_BraZ1	1890	-	11	50	362	0.1381215
A03	3707470	3712847	A03p09020.2_BraZ1	2652.81	-	2373	5314	5377	0.9882835
A03	3713647	3715442	A03p09030.2_BraZ1	178.5	+	659	1692	1795	0.9426184
A03	3716353	3722109	A03p09040.2_BraZ1	11947.5	+	2683	5192	5756	0.9020153
A03	3723644	3725276	A03p09050.2_BraZ1	161.4	+	1416	1632	1632	1.0000000
A03	3728216	3729932	A03p09060.2_BraZ1	171.6	+	1471	1716	1716	1.0000000
A03	3730629	3749798	A03p09070.2_BraZ1	3910.12	+	10192	17748	19169	0.9258699
A03	3750052	3750229	A03p09080.2_BraZ1	17.7	-	202	177	177	1.0000000
A03	3750510	3751869	A03p09090.2_BraZ1	146.762	+	830	1359	1359	1.0000000
A03	3752861	3753219	A03p09100.2_BraZ1	30.6	+	498	358	358	1.0000000
A03	3753600	3756165	A03p09110.2_BraZ1	1294.12	-	1086	2536	2565	0.9886940
A03	3757078	3757642	A03p09120.2_BraZ1	228	+	391	564	564	1.0000000
A03	3758962	3760006	A03p09130.2_BraZ1	104.4	-	159	981	1044	0.9396552
A03	3773756	3776435	A03p09140.2_BraZ1	1014	+	888	2679	2679	1.0000000
A03	3784823	3785590	A03p09150.2_BraZ1	321	-	311	732	767	0.9543676
A03	3786650	3789008	A03p09160.2_BraZ1	235.8	+	428	2188	2358	0.9279050
A03	3791454	3793421	A03p09170.2_BraZ1	1303.82	+	1839	1967	1967	1.0000000
A03	3793736	3802081	A03p09180.2_BraZ1	1591.44	-	5780	7835	8345	0.9388856
A03	3802502	3807404	A03p09190.2_BraZ1	1219.12	+	4724	4695	4902	0.9577723
A03	3808187	3808784	A03p09200.2_BraZ1	700	+	44	570	597	0.9547738
A03	3810089	3811264	A03p09210.2_BraZ1	44.1	+	8	124	1175	0.1055319
A03	3811485	3811617	A03p09220.2_BraZ1	13.2	+	0	0	132	0.0000000
A03	3814611	3816006	A03p09230.2_BraZ1	79.5	+	976	1370	1395	0.9820789
A03	3816066	3818978	A03p09240.2_BraZ1	379.6	+	443	2043	2912	0.7015797
A03	3817024	3818052	A03p09250.2_BraZ1	402	-	166	1028	1028	1.0000000
A03	3818148	3818868	A03p09260.2_BraZ1	483	-	176	320	720	0.4444444
A03	3821435	3822249	A03p09270.2_BraZ1	326.667	-	61	496	814	0.6093366
A03	3822381	3822537	A03p09280.2_BraZ1	15.6	-	2	86	156	0.5512820
A03	3825475	3826753	A03p09290.2_BraZ1	622.2	+	625	1245	1278	0.9741784
A03	3829350	3830514	A03p09300.2_BraZ1	116.4	+	339	1082	1164	0.9295533
A03	3834067	3836973	A03p09310.2_BraZ1	75.9	+	3021	2497	2906	0.8592567
A03	3837518	3839543	A03p09320.2_BraZ1	767.407	-	3482	2023	2025	0.9990124
A03	3840115	3840295	A03p09330.2_BraZ1	18	+	380	180	180	1.0000000
A03	3841017	3843161	A03p09340.2_BraZ1	1229.68	+	1265	1974	2144	0.9207090
A03	3844163	3844710	A03p09350.2_BraZ1	459	+	398	547	547	1.0000000
A03	3851445	3852054	A03p09360.2_BraZ1	60.9	+	572	609	609	1.0000000
A03	3852975	3856916	A03p09370.2_BraZ1	1795.04	-	1481	3532	3941	0.8962193
A03	3858084	3858901	A03p09380.2_BraZ1	75.3	-	442	817	817	1.0000000
A03	3861549	3863985	A03p09390.2_BraZ1	1200.64	+	693	2007	2436	0.8238916
A03	3864318	3866751	A03p09400.2_BraZ1	863.592	-	2498	2433	2433	1.0000000
A03	3867630	3872067	A03p09410.2_BraZ1	2722.32	-	1032	2758	4437	0.6215912
A03	3873369	3874629	A03p09420.2_BraZ1	701.76	+	863	1260	1260	1.0000000
A03	3875801	3876534	A03p09430.2_BraZ1	288	+	890	733	733	1.0000000
A03	3877021	3878622	A03p09440.2_BraZ1	580.839	-	1859	1532	1601	0.9569019
A03	3881929	3884547	A03p09450.2_BraZ1	1872.5	+	1381	2542	2618	0.9709702
A03	3886100	3888966	A03p09460.2_BraZ1	1998.28	+	1207	2583	2866	0.9012561
A03	3890726	3893275	A03p09470.2_BraZ1	1385.45	+	1442	2399	2549	0.9411534
A03	3893870	3898196	A03p09480.2_BraZ1	1504.8	-	1498	4031	4326	0.9318077
A03	3901262	3902638	A03p09490.2_BraZ1	690	-	817	1376	1376	1.0000000
A03	3903445	3907674	A03p09500.2_BraZ1	2560	-	1122	2709	4229	0.6405770
A03	3908759	3913873	A03p09510.2_BraZ1	2215.28	+	2540	4676	5114	0.9143528
A03	3914286	3916236	A03p09520.2_BraZ1	891.391	+	1130	1950	1950	1.0000000
A03	3916706	3918782	A03p09530.2_BraZ1	918.75	-	1330	2076	2076	1.0000000
A03	3919462	3920540	A03p09540.2_BraZ1	321	-	246	610	1078	0.5658627
A03	3923949	3926280	A03p09550.2_BraZ1	53443.5	+	660	2306	2331	0.9892750
A03	3926595	3927354	A03p09560.2_BraZ1	75.9	-	92	677	759	0.8919631
A03	3928187	3934025	A03p09570.2_BraZ1	3109.6	-	716	3631	5838	0.6219596
A03	3937799	3937964	A03p09580.2_BraZ1	10.8	-	130	165	165	1.0000000
A03	3938536	3938832	A03p09590.2_BraZ1	174	+	75	296	296	1.0000000
A03	3938955	3942612	A03p09600.2_BraZ1	1398.6	+	3475	3592	3657	0.9822259
A03	3944250	3945193	A03p09610.2_BraZ1	617.7	+	1019	943	943	1.0000000
A03	3945509	3946796	A03p09620.2_BraZ1	431.354	-	413	1238	1287	0.9619269
A03	3948259	3948631	A03p09630.2_BraZ1	37.2	+	16	92	372	0.2473118
A03	3949100	3949226	A03p09640.2_BraZ1	12.6	+	71	126	126	1.0000000
A03	3950121	3951390	A03p09650.2_BraZ1	119.7	-	538	1269	1269	1.0000000
A03	3952106	3953060	A03p09660.2_BraZ1	658	+	342	954	954	1.0000000
A03	3954816	3967133	A03p09670.2_BraZ1	679.986	+	8560	11127	12317	0.9033856
A03	3968357	3968840	A03p09680.2_BraZ1	369	-	297	461	483	0.9544513
A03	3976297	3976651	A03p09690.2_BraZ1	234	-	4	21	354	0.0593220
A03	3979425	3979779	A03p09700.2_BraZ1	234	-	40	346	354	0.9774011
A03	3980375	3981389	A03p09710.2_BraZ1	101.4	-	68	814	1014	0.8027613
A03	3983506	3988465	A03p09720.2_BraZ1	1380	+	1273	4533	4959	0.9140956
A03	3988750	3989755	A03p09730.2_BraZ1	4575	-	905	1005	1005	1.0000000
A03	3991402	3993985	A03p09740.2_BraZ1	1256.14	-	1463	2534	2583	0.9810298
A03	3994766	3995003	A03p09750.2_BraZ1	23.7	-	19	148	237	0.6244726
A03	3998005	4009397	A03p09760.2_BraZ1	3409.27	+	4723	10345	11392	0.9080934
A03	4009966	4010679	A03p09770.2_BraZ1	312.17	-	501	713	713	1.0000000
A03	4011812	4012145	A03p09780.2_BraZ1	33.3	+	7	20	333	0.0600601
A03	4013324	4015297	A03p09790.2_BraZ1	627	-	662	1815	1973	0.9199189
A03	4017061	4018041	A03p09800.2_BraZ1	624	+	505	944	980	0.9632653
A03	4019370	4020411	A03p09810.2_BraZ1	765	+	352	925	1041	0.8885687
A03	4020817	4021618	A03p09820.2_BraZ1	603	-	559	801	801	1.0000000
A03	4023083	4023514	A03p09830.2_BraZ1	231	-	320	431	431	1.0000000
A03	4024367	4027247	A03p09840.2_BraZ1	1838.62	-	1453	2880	2880	1.0000000
A03	4027788	4028452	A03p09850.2_BraZ1	312	+	121	562	664	0.8463855
A03	4031231	4032192	A03p09860.2_BraZ1	810	+	613	946	961	0.9843913
A03	4034551	4035769	A03p09870.2_BraZ1	121.8	+	1283	1176	1218	0.9655172
A03	4038310	4040378	A03p09880.2_BraZ1	470.274	+	67	1008	2068	0.4874275
A03	4040859	4045996	A03p09890.2_BraZ1	1203.83	-	559	3125	5137	0.6083317
A03	4048060	4049698	A03p09900.2_BraZ1	948.857	-	1059	1638	1638	1.0000000
A03	4052272	4053552	A03p09910.2_BraZ1	11445.3	-	351	1184	1280	0.9250000
A03	4076430	4077099	A03p09920.2_BraZ1	189	+	1	132	669	0.1973094
A03	4088677	4090025	A03p09930.2_BraZ1	1152	+	16	227	1348	0.1683976
A03	4091146	4095174	A03p09940.2_BraZ1	1482.54	+	1446	3777	4028	0.9376862
A03	4096354	4100291	A03p09950.2_BraZ1	3097.42	+	2375	3894	3937	0.9890780
A03	4101389	4103470	A03p09960.2_BraZ1	2001	-	971	1974	2081	0.9485824
A03	4106928	4108098	A03p09970.2_BraZ1	486	-	0	0	1170	0.0000000
A03	4108188	4108517	A03p09980.2_BraZ1	282	+	1	40	329	0.1215805
A03	4109027	4109531	A03p09990.2_BraZ1	50.4	-	146	504	504	1.0000000
A03	4111914	4113359	A03p10000.2_BraZ1	1600	+	406	1383	1445	0.9570934
A03	4114126	4123947	A03p10010.2_BraZ1	3586.3	-	2926	7616	9821	0.7754811
A03	4125342	4125555	A03p10020.2_BraZ1	21.3	-	159	213	213	1.0000000
A03	4127240	4130934	A03p10030.2_BraZ1	1125	+	2535	3694	3694	1.0000000
A03	4133473	4133780	A03p10040.2_BraZ1	231	+	535	307	307	1.0000000
A03	4134267	4135375	A03p10050.2_BraZ1	360.132	-	1330	1108	1108	1.0000000
A03	4140221	4141680	A03p10060.2_BraZ1	1401	-	781	1453	1459	0.9958876
A03	4142903	4143539	A03p10070.2_BraZ1	63.6	-	390	636	636	1.0000000
A03	4148441	4150880	A03p10080.2_BraZ1	688.5	-	751	2114	2439	0.8667487
A03	4151568	4151961	A03p10090.2_BraZ1	39.3	-	109	393	393	1.0000000
A03	4154775	4155228	A03p10100.2_BraZ1	45.3	-	53	305	453	0.6732892
A03	4158102	4165207	A03p10110.2_BraZ1	794.114	+	4887	5948	7105	0.8371570
A03	4161498	4162086	A03p10120.2_BraZ1	2781	-	3	139	588	0.2363946
A03	4166413	4167735	A03p10130.2_BraZ1	658.091	+	752	1322	1322	1.0000000
A03	4169398	4170019	A03p10140.2_BraZ1	61.2	-	14	189	621	0.3043478
A03	4172077	4172653	A03p10150.2_BraZ1	57.6	-	16	296	576	0.5138889
A03	4174029	4175060	A03p10160.2_BraZ1	1962	-	782	1031	1031	1.0000000
A03	4177262	4178163	A03p10170.2_BraZ1	1928.62	-	11	605	901	0.6714761
A03	4180750	4183086	A03p10180.2_BraZ1	513	+	477	2045	2336	0.8754281
A03	4184087	4184471	A03p10190.2_BraZ1	38.4	-	290	384	384	1.0000000
A03	4187922	4191561	A03p10200.2_BraZ1	2230.36	-	740	3032	3639	0.8331959
A03	4199314	4205601	A03p10210.2_BraZ1	882.818	-	2018	5243	6287	0.8339431
A03	4207043	4208992	A03p10220.2_BraZ1	908.289	-	1483	1949	1949	1.0000000
A03	4211204	4212790	A03p10230.2_BraZ1	1515	-	378	1493	1586	0.9413619
A03	4213426	4214233	A03p10240.2_BraZ1	80.7	-	555	807	807	1.0000000
A03	4215485	4215989	A03p10250.2_BraZ1	50.4	-	155	504	504	1.0000000
A03	4218558	4232822	A03p10260.2_BraZ1	1774.77	-	3223	10395	14264	0.7287577
A03	4233168	4233675	A03p10270.2_BraZ1	354	+	235	507	507	1.0000000
A03	4233850	4238956	A03p10280.2_BraZ1	1513.4	-	3410	4581	5106	0.8971798
A03	4240178	4240990	A03p10290.2_BraZ1	693	+	202	812	812	1.0000000
A03	4241476	4245691	A03p10300.2_BraZ1	2396.64	-	2130	4047	4215	0.9601424
A03	4246613	4250775	A03p10310.2_BraZ1	1837.81	-	2202	4068	4162	0.9774147
A03	4251968	4254257	A03p10320.2_BraZ1	1370	+	1633	2263	2289	0.9886413
A03	4255115	4256264	A03p10330.2_BraZ1	1032	+	198	1113	1149	0.9686684
A03	4257086	4257329	A03p10340.2_BraZ1	24.3	-	68	243	243	1.0000000
A03	4258400	4260596	A03p10350.2_BraZ1	611.515	+	1354	2115	2196	0.9631147
A03	4265218	4266127	A03p10360.2_BraZ1	90.9	+	193	754	909	0.8294830
A03	4267295	4268267	A03p10370.2_BraZ1	56.4	-	392	972	972	1.0000000
A03	4269123	4271245	A03p10380.2_BraZ1	1565.92	+	1133	2122	2122	1.0000000
A03	4271673	4272807	A03p10390.2_BraZ1	774	-	558	1124	1134	0.9911817
A03	4273514	4274425	A03p10400.2_BraZ1	726	-	736	911	911	1.0000000
A03	4280612	4281038	A03p10410.2_BraZ1	273	+	647	426	426	1.0000000
A03	4281409	4284667	A03p10420.2_BraZ1	85.2	-	455	1670	3258	0.5125844
A03	4286980	4289682	A03p10430.2_BraZ1	1276.06	+	927	2376	2702	0.8793486
A03	4290469	4295224	A03p10440.2_BraZ1	191.143	+	2312	4197	4755	0.8826498
A03	4296315	4297510	A03p10450.2_BraZ1	117	+	1154	1195	1195	1.0000000
A03	4298095	4298233	A03p10460.2_BraZ1	13.5	-	201	138	138	1.0000000
A03	4299586	4304797	A03p10470.2_BraZ1	2427.51	-	2130	5104	5211	0.9794665
A03	4305593	4306858	A03p10480.2_BraZ1	825	-	333	976	1265	0.7715415
A03	4307401	4309411	A03p10490.2_BraZ1	716.366	+	670	1796	2010	0.8935323
A03	4309813	4311633	A03p10500.2_BraZ1	1199.11	-	584	1762	1820	0.9681318
A03	4313006	4313126	A03p10510.2_BraZ1	12	+	0	0	120	0.0000000
A03	4313365	4313595	A03p10520.2_BraZ1	198	+	0	0	230	0.0000000
A03	4313615	4313777	A03p10530.2_BraZ1	16.2	+	0	0	162	0.0000000
A03	4315105	4316191	A03p10540.2_BraZ1	108.6	+	169	960	1086	0.8839779
A03	4317439	4320856	A03p10550.2_BraZ1	2617.25	-	1116	2735	3417	0.8004097
A03	4338768	4340555	A03p10560.2_BraZ1	1074.14	-	1340	1787	1787	1.0000000
A03	4340827	4342373	A03p10570.2_BraZ1	858.667	-	1478	1546	1546	1.0000000
A03	4343063	4345415	A03p10580.2_BraZ1	1086	+	632	1983	2352	0.8431122
A03	4347611	4351239	A03p10590.2_BraZ1	1288.3	+	3185	3266	3628	0.9002205
A03	4351492	4352350	A03p10600.2_BraZ1	85.8	-	154	473	858	0.5512820
A03	4356354	4356633	A03p10610.2_BraZ1	27.9	-	6	79	279	0.2831541
A03	4358689	4359509	A03p10620.2_BraZ1	378	-	303	820	820	1.0000000
A03	4360596	4362518	A03p10630.2_BraZ1	1143.27	-	1402	1922	1922	1.0000000
A03	4364542	4366075	A03p10640.2_BraZ1	8645	-	712	1516	1533	0.9889106
A03	4368210	4370725	A03p10650.2_BraZ1	1268.65	-	647	2364	2515	0.9399602
A03	4371256	4373289	A03p10660.2_BraZ1	893.333	+	2018	2024	2033	0.9955730
A03	4374333	4375301	A03p10670.2_BraZ1	681.31	-	332	961	968	0.9927686
A03	4376941	4378215	A03p10680.2_BraZ1	675.818	-	236	1109	1274	0.8704867
A03	4384862	4402253	A03p10690.2_BraZ1	1321.82	+	1538	9557	17391	0.5495371
A03	4403125	4409954	A03p10700.2_BraZ1	3306.7	-	2336	6589	6829	0.9648558
A03	4412036	4413743	A03p10710.2_BraZ1	963.667	-	548	1504	1707	0.8810779
A03	4417068	4420929	A03p10720.2_BraZ1	1449.07	-	3179	3861	3861	1.0000000
A03	4421577	4422129	A03p10730.2_BraZ1	55.2	+	251	552	552	1.0000000
A03	4423569	4424651	A03p10740.2_BraZ1	797.727	+	765	1082	1082	1.0000000
A03	4426434	4428093	A03p10750.2_BraZ1	1095.75	-	727	1531	1659	0.9228451
A03	4430544	4433008	A03p10760.2_BraZ1	1217.14	-	977	2262	2464	0.9180195
A03	4431096	4431486	A03p10770.2_BraZ1	39	-	278	358	390	0.9179487
A03	4435025	4436691	A03p10780.2_BraZ1	2777.14	-	962	1666	1666	1.0000000
A03	4438115	4439702	A03p10790.2_BraZ1	2784	-	1534	1587	1587	1.0000000
A03	4440353	4441934	A03p10800.2_BraZ1	5580	-	646	1581	1581	1.0000000
A03	4446580	4451070	A03p10810.2_BraZ1	1544.1	-	1630	4000	4490	0.8908686
A03	4455710	4460601	A03p10820.2_BraZ1	2452.64	-	2173	4805	4891	0.9824167
A03	4461368	4467060	A03p10830.2_BraZ1	3014.88	+	1323	5090	5692	0.8942375
A03	4468642	4471440	A03p10840.2_BraZ1	1429.71	-	1067	2685	2798	0.9596140
A03	4472680	4473853	A03p10850.2_BraZ1	117.3	-	1087	1173	1173	1.0000000
A03	4474850	4476044	A03p10860.2_BraZ1	119.4	-	1024	1194	1194	1.0000000
A03	4477246	4477684	A03p10870.2_BraZ1	43.8	-	228	438	438	1.0000000
A03	4478593	4481704	A03p10880.2_BraZ1	2333.09	-	590	1938	3111	0.6229508
A03	4483367	4485284	A03p10890.2_BraZ1	857.207	+	735	1829	1917	0.9540949
A03	4486847	4488024	A03p10900.2_BraZ1	3993	-	201	687	1177	0.5836874
A03	4500083	4513395	A03p10910.2_BraZ1	1321.4	+	1210	5268	13312	0.3957332
A03	4514555	4515856	A03p10920.2_BraZ1	612.585	+	481	1250	1301	0.9607994
A03	4518251	4518719	A03p10930.2_BraZ1	46.8	-	1	121	468	0.2585470
A03	4520576	4521044	A03p10940.2_BraZ1	46.8	-	0	0	468	0.0000000
A03	4522962	4525329	A03p10950.2_BraZ1	1119.54	-	0	0	2367	0.0000000
A03	4528901	4529369	A03p10960.2_BraZ1	46.8	-	0	0	468	0.0000000
A03	4531291	4533659	A03p10970.2_BraZ1	1410.75	-	0	0	2368	0.0000000
A03	4537248	4537716	A03p10980.2_BraZ1	46.8	-	0	0	468	0.0000000
A03	4539632	4541998	A03p10990.2_BraZ1	1410.75	-	2	20	2366	0.0084531
A03	4544689	4545157	A03p11000.2_BraZ1	46.8	-	0	0	468	0.0000000
A03	4547839	4552963	A03p11010.2_BraZ1	179.77	+	3911	4800	5124	0.9367682
A03	4553011	4555454	A03p11020.2_BraZ1	1816.92	+	322	2176	2443	0.8907081
A03	4557099	4561244	A03p11030.2_BraZ1	1905.28	+	2762	3807	4145	0.9184560
A03	4565982	4567452	A03p11040.2_BraZ1	905.172	+	1018	1470	1470	1.0000000
A03	4568173	4569448	A03p11050.2_BraZ1	816	+	1465	1275	1275	1.0000000
A03	4571192	4571707	A03p11060.2_BraZ1	297	-	337	515	515	1.0000000
A03	4574103	4574569	A03p11070.2_BraZ1	219	-	84	286	466	0.6137339
A03	4575304	4575715	A03p11080.2_BraZ1	41.1	+	112	411	411	1.0000000
A03	4576602	4576982	A03p11090.2_BraZ1	237	+	162	380	380	1.0000000
A03	4577524	4578154	A03p11100.2_BraZ1	399	-	503	630	630	1.0000000
A03	4579552	4580960	A03p11110.2_BraZ1	1275	+	202	1184	1408	0.8409091
A03	4582923	4584664	A03p11120.2_BraZ1	1734.75	+	1018	1741	1741	1.0000000
A03	4585842	4586394	A03p11130.2_BraZ1	54.9	-	246	552	552	1.0000000
A03	4586842	4587070	A03p11140.2_BraZ1	22.8	+	6	228	228	1.0000000
A03	4587384	4587859	A03p11150.2_BraZ1	240	-	77	437	475	0.9200000
A03	4589657	4589987	A03p11160.2_BraZ1	33	+	110	330	330	1.0000000
A03	4593399	4593785	A03p11170.2_BraZ1	297	+	223	386	386	1.0000000
A03	4594343	4595828	A03p11180.2_BraZ1	72852	-	489	1485	1485	1.0000000
A03	4597939	4601226	A03p11190.2_BraZ1	340	-	1887	3156	3287	0.9601460
A03	4601839	4602164	A03p11200.2_BraZ1	204	-	0	0	325	0.0000000
A03	4602788	4604926	A03p11210.2_BraZ1	474.078	-	2138	2138	2138	1.0000000
A03	4609176	4616832	A03p11220.2_BraZ1	386.538	+	5036	7274	7656	0.9501045
A03	4611790	4614062	A03p11230.2_BraZ1	796.821	-	1567	2272	2272	1.0000000
A03	4617108	4619124	A03p11240.2_BraZ1	201.6	-	949	1910	2016	0.9474207
A03	4620616	4626013	A03p11250.2_BraZ1	3060	-	2193	5237	5397	0.9703539
A03	4627043	4629790	A03p11260.2_BraZ1	1144.89	-	1014	2448	2747	0.8911540
A03	4630823	4631594	A03p11270.2_BraZ1	77.1	+	276	771	771	1.0000000
A03	4632079	4633564	A03p11280.2_BraZ1	3003	-	888	1288	1485	0.8673401
A03	4636168	4643289	A03p11290.2_BraZ1	5730.4	+	3469	6354	7121	0.8922904
A03	4645790	4648074	A03p11300.2_BraZ1	2502	-	878	2118	2284	0.9273205
A03	4651194	4651341	A03p11310.2_BraZ1	14.7	-	217	127	147	0.8639456
A03	4652323	4652992	A03p11320.2_BraZ1	36.3	-	1	128	669	0.1913303
A03	4654114	4654792	A03p11330.2_BraZ1	67.8	-	456	678	678	1.0000000
A03	4656923	4657653	A03p11340.2_BraZ1	690	+	101	696	730	0.9534246
A03	4658846	4658996	A03p11350.2_BraZ1	15	-	4	72	150	0.4800000
A03	4659003	4663364	A03p11360.2_BraZ1	2579.2	-	2171	3666	4361	0.8406329
A03	4665567	4667611	A03p11370.2_BraZ1	1569.65	+	266	1232	2044	0.6027398
A03	4670669	4671836	A03p11380.2_BraZ1	116.7	+	1005	1167	1167	1.0000000
A03	4672377	4672953	A03p11390.2_BraZ1	57.6	+	641	576	576	1.0000000
A03	4674299	4676319	A03p11400.2_BraZ1	1701.5	-	434	1842	2020	0.9118812
A03	4682839	4684797	A03p11410.2_BraZ1	1073.83	+	1122	1958	1958	1.0000000
A03	4685415	4687386	A03p11420.2_BraZ1	197.1	-	1866	1971	1971	1.0000000
A03	4689428	4690186	A03p11430.2_BraZ1	465	-	477	758	758	1.0000000
A03	4691122	4692280	A03p11440.2_BraZ1	302.857	-	715	1158	1158	1.0000000
A03	4693717	4694857	A03p11450.2_BraZ1	186.171	-	991	1125	1140	0.9868421
A03	4695876	4696398	A03p11460.2_BraZ1	10504.5	+	102	522	522	1.0000000
A03	4696671	4707088	A03p11470.2_BraZ1	1064.58	+	5764	8502	10417	0.8161659
A03	4699541	4702885	A03p11480.2_BraZ1	276	-	442	1497	3344	0.4476674
A03	4708226	4708706	A03p11490.2_BraZ1	48	-	102	480	480	1.0000000
A03	4717338	4718754	A03p11500.2_BraZ1	724.5	+	1039	1416	1416	1.0000000
A03	4724069	4724998	A03p11510.2_BraZ1	72.9	+	560	929	929	1.0000000
A03	4727387	4727715	A03p11520.2_BraZ1	150	+	508	328	328	1.0000000
A03	4728133	4731211	A03p11530.2_BraZ1	945.972	+	1701	3006	3078	0.9766082
A03	4736279	4738151	A03p11540.2_BraZ1	187.2	+	95	1210	1872	0.6463675
A03	4739974	4740457	A03p11550.2_BraZ1	48.3	-	293	483	483	1.0000000
A03	4741489	4744721	A03p11560.2_BraZ1	1842.48	-	2019	3119	3232	0.9650371
A03	4746266	4746647	A03p11570.2_BraZ1	31.2	-	540	381	381	1.0000000
A03	4747607	4751607	A03p11580.2_BraZ1	2071.93	-	5512	4000	4000	1.0000000
A03	4752492	4752900	A03p11590.2_BraZ1	243	+	246	408	408	1.0000000
A03	4753622	4754702	A03p11600.2_BraZ1	108	-	524	1080	1080	1.0000000
A03	4756473	4758151	A03p11610.2_BraZ1	1068	-	734	1648	1678	0.9821216
A03	4758918	4759920	A03p11620.2_BraZ1	100.2	-	663	980	1002	0.9780439
A03	4760359	4760641	A03p11630.2_BraZ1	281.25	+	461	282	282	1.0000000
A03	4761092	4762549	A03p11640.2_BraZ1	1377	+	497	1424	1457	0.9773507
A03	4762646	4765775	A03p11650.2_BraZ1	710.325	+	569	2919	3129	0.9328859
A03	4766948	4768263	A03p11660.2_BraZ1	659.25	+	352	1274	1315	0.9688213
A03	4769021	4770498	A03p11670.2_BraZ1	821.25	+	366	1330	1477	0.9004740
A03	4772056	4773497	A03p11680.2_BraZ1	396.9	+	558	1437	1441	0.9972242
A03	4774562	4776109	A03p11690.2_BraZ1	935.85	+	507	1547	1547	1.0000000
A03	4777048	4778604	A03p11700.2_BraZ1	930.75	+	227	1401	1556	0.9003856
A03	4781675	4781852	A03p11710.2_BraZ1	17.7	-	0	0	177	0.0000000
A03	4782493	4783687	A03p11720.2_BraZ1	119.4	-	99	908	1194	0.7604690
A03	4785500	4787208	A03p11730.2_BraZ1	790.525	+	488	1695	1708	0.9923888
A03	4787957	4789696	A03p11740.2_BraZ1	113.7	-	1372	1614	1739	0.9281196
A03	4789402	4791016	A03p11750.2_BraZ1	129.9	-	1493	1614	1614	1.0000000
A03	4792333	4794153	A03p11760.2_BraZ1	247.263	-	1570	1817	1820	0.9983516
A03	4794453	4796163	A03p11770.2_BraZ1	11698.1	-	630	1700	1710	0.9941521
A03	4798338	4799154	A03p11780.2_BraZ1	81.6	-	389	816	816	1.0000000
A03	4801414	4801765	A03p11790.2_BraZ1	35.1	-	34	201	351	0.5726496
A03	4804301	4805333	A03p11800.2_BraZ1	387	+	605	1004	1032	0.9728682
A03	4805988	4807977	A03p11810.2_BraZ1	1018.5	+	1698	1989	1989	1.0000000
A03	4811003	4811798	A03p11820.2_BraZ1	79.5	+	179	746	795	0.9383648
A03	4813889	4814460	A03p11830.2_BraZ1	48.6	-	284	567	571	0.9929947
A03	4815375	4815837	A03p11840.2_BraZ1	46.2	+	8	56	462	0.1212121
A03	4817127	4819837	A03p11850.2_BraZ1	768.857	-	725	2305	2710	0.8505535
A03	4822368	4823074	A03p11860.2_BraZ1	399	-	38	341	706	0.4830028
A03	4828601	4828949	A03p11870.2_BraZ1	203.684	-	221	348	348	1.0000000
A03	4829909	4837220	A03p11880.2_BraZ1	2119.43	-	2432	5942	7311	0.8127479
A03	4838211	4839176	A03p11890.2_BraZ1	291	-	605	965	965	1.0000000
A03	4842585	4843783	A03p11900.2_BraZ1	1743.75	+	523	1198	1198	1.0000000
A03	4847082	4848260	A03p11910.2_BraZ1	452.045	-	1163	1178	1178	1.0000000
A03	4849997	4850839	A03p11920.2_BraZ1	447	-	249	740	842	0.8788599
A03	4851640	4853684	A03p11930.2_BraZ1	1712	-	710	1953	2044	0.9554794
A03	4856390	4856884	A03p11940.2_BraZ1	378	+	340	494	494	1.0000000
A03	4858335	4858744	A03p11950.2_BraZ1	1464	-	288	409	409	1.0000000
A03	4858932	4859284	A03p11960.2_BraZ1	522	+	329	352	352	1.0000000
A03	4859365	4861038	A03p11970.2_BraZ1	1481.06	+	530	1361	1673	0.8135087
A03	4862802	4864116	A03p11980.2_BraZ1	131.4	+	142	1168	1314	0.8888889
A03	4864613	4865144	A03p11990.2_BraZ1	53.1	-	148	531	531	1.0000000
A03	4876697	4877775	A03p12000.2_BraZ1	870	+	292	1075	1078	0.9972171
A03	4881265	4884435	A03p12010.2_BraZ1	2860	-	1300	2940	3170	0.9274448
A03	4885862	4887866	A03p12020.2_BraZ1	17767.5	+	705	1927	2004	0.9615768
A03	4888432	4889949	A03p12030.2_BraZ1	1244.35	-	1026	1455	1517	0.9591299
A03	4892748	4894692	A03p12040.2_BraZ1	194.4	+	2	80	1944	0.0411523
A03	4895316	4896872	A03p12050.2_BraZ1	814.857	-	1344	1556	1556	1.0000000
A03	4900852	4902006	A03p12060.2_BraZ1	195	-	1600	1154	1154	1.0000000
A03	4903373	4904812	A03p12070.2_BraZ1	798	+	897	1439	1439	1.0000000
A03	4906225	4908903	A03p12080.2_BraZ1	1353.54	+	863	2497	2678	0.9324123
A03	4909319	4910598	A03p12090.2_BraZ1	422.28	-	738	1160	1279	0.9069586
A03	4913386	4919195	A03p12100.2_BraZ1	1859.96	+	887	2824	5809	0.4861422
A03	4919558	4920885	A03p12110.2_BraZ1	642.24	-	575	1186	1327	0.8937453
A03	4923062	4923351	A03p12120.2_BraZ1	24.3	+	552	289	289	1.0000000
A03	4925458	4926382	A03p12130.2_BraZ1	92.4	+	668	924	924	1.0000000
A03	4927442	4928193	A03p12140.2_BraZ1	510.3	-	549	751	751	1.0000000
A03	4929177	4930287	A03p12150.2_BraZ1	301.875	-	305	1096	1110	0.9873874
A03	4930957	4932354	A03p12160.2_BraZ1	842.812	-	314	1397	1397	1.0000000
A03	4932856	4939673	A03p12170.2_BraZ1	2141.22	+	2409	6634	6817	0.9731553
A03	4945794	4946601	A03p12180.2_BraZ1	80.7	-	303	784	807	0.9714994
A03	4951190	4953730	A03p12190.2_BraZ1	1836	-	820	2483	2540	0.9775590
A03	4956314	4964824	A03p12200.2_BraZ1	3156.13	+	4277	7860	8510	0.9236193
A03	4967647	4970295	A03p12210.2_BraZ1	2565	+	851	2542	2648	0.9599698
A03	4970483	4972202	A03p12220.2_BraZ1	717.188	-	811	1717	1719	0.9988365
A03	4972805	4973517	A03p12230.2_BraZ1	3698	+	337	712	712	1.0000000
A03	4974145	4976002	A03p12240.2_BraZ1	185.7	+	191	1498	1857	0.8066775
A03	4979257	4989091	A03p12250.2_BraZ1	6164.74	-	1948	5512	9834	0.5605044
A03	4989882	4991515	A03p12260.2_BraZ1	847.6	+	1032	1633	1633	1.0000000
A03	4993455	4993781	A03p12270.2_BraZ1	258	-	331	326	326	1.0000000
A03	4994230	4994492	A03p12280.2_BraZ1	147	-	440	262	262	1.0000000
A03	4994689	4996677	A03p12290.2_BraZ1	1543.98	-	767	1842	1988	0.9265593
A03	4998239	4998455	A03p12300.2_BraZ1	21.6	+	226	216	216	1.0000000
A03	4998651	5000978	A03p12310.2_BraZ1	1288.52	+	1729	2327	2327	1.0000000
A03	5001315	5005457	A03p12320.2_BraZ1	3960	-	1929	3872	4142	0.9348141
A03	5005821	5011488	A03p12330.2_BraZ1	1969.47	-	961	4402	5667	0.7767779
A03	5012746	5016736	A03p12340.2_BraZ1	2018.11	-	1512	3739	3990	0.9370927
A03	5017496	5018354	A03p12350.2_BraZ1	627	+	817	858	858	1.0000000
A03	5018702	5021728	A03p12360.2_BraZ1	1626.19	-	1205	2985	3026	0.9864507
A03	5022219	5023908	A03p12370.2_BraZ1	7938	-	520	1401	1689	0.8294849
A03	5024853	5027241	A03p12380.2_BraZ1	1508.67	-	836	2354	2388	0.9857621
A03	5027754	5027934	A03p12390.2_BraZ1	15.9	+	47	152	180	0.8444445
A03	5031131	5033453	A03p12400.2_BraZ1	232.2	+	352	1897	2322	0.8169681
A03	5033758	5038371	A03p12410.2_BraZ1	2631.33	-	1514	4412	4613	0.9564275
A03	5039907	5040952	A03p12420.2_BraZ1	547.097	-	528	952	1045	0.9110048
A03	5042099	5042252	A03p12430.2_BraZ1	15.3	+	0	0	153	0.0000000
A03	5042378	5042543	A03p12440.2_BraZ1	16.5	+	0	0	165	0.0000000
A03	5047958	5048609	A03p12450.2_BraZ1	564	+	197	651	651	1.0000000
A03	5049649	5053120	A03p12460.2_BraZ1	1778.21	+	1241	3045	3471	0.8772688
A03	5053840	5058303	A03p12470.2_BraZ1	2678.67	-	2239	4126	4463	0.9244903
A03	5058549	5062298	A03p12480.2_BraZ1	1023.53	+	2393	3749	3749	1.0000000
A03	5063225	5066595	A03p12490.2_BraZ1	1285.58	-	396	2853	3370	0.8465875
A03	5067293	5070621	A03p12500.2_BraZ1	2327.04	+	1618	3319	3328	0.9972957
A03	5071131	5071836	A03p12510.2_BraZ1	633	+	158	662	705	0.9390071
A03	5072274	5072887	A03p12520.2_BraZ1	522	-	484	613	613	1.0000000
A03	5073899	5075105	A03p12530.2_BraZ1	733.667	+	288	1144	1206	0.9485904
A03	5076742	5077424	A03p12540.2_BraZ1	282	-	549	682	682	1.0000000
A03	5078304	5082141	A03p12550.2_BraZ1	1507.58	+	2623	3837	3837	1.0000000
A03	5082542	5082683	A03p12560.2_BraZ1	14.1	+	151	141	141	1.0000000
A03	5083190	5090738	A03p12570.2_BraZ1	877.5	+	671	3983	7548	0.5276895
A03	5091532	5092619	A03p12580.2_BraZ1	924	+	616	1087	1087	1.0000000
A03	5093674	5108016	A03p12590.2_BraZ1	2037.47	-	5776	14149	14342	0.9865430
A03	5098389	5098916	A03p12600.2_BraZ1	369	+	315	527	527	1.0000000
A03	5109045	5109609	A03p12610.2_BraZ1	504	+	392	564	564	1.0000000
A03	5119669	5119891	A03p12620.2_BraZ1	22.2	+	26	158	222	0.7117117
A03	5124797	5125034	A03p12630.2_BraZ1	23.1	-	49	228	237	0.9620253
A03	5130305	5132335	A03p12640.2_BraZ1	892.125	-	1617	1967	2030	0.9689655
A03	5132745	5135308	A03p12650.2_BraZ1	1380	+	710	2273	2563	0.8868514
A03	5136880	5137342	A03p12660.2_BraZ1	321	+	32	235	462	0.5086580
A03	5144748	5145189	A03p12670.2_BraZ1	44.1	+	110	418	441	0.9478458
A03	5147726	5153090	A03p12680.2_BraZ1	878.701	+	1798	4483	5364	0.8357569
A03	5153995	5155028	A03p12690.2_BraZ1	3296	-	421	908	1033	0.8789932
A03	5158905	5160519	A03p12700.2_BraZ1	996	-	420	1484	1614	0.9194548
A03	5168316	5168421	A03p12710.2_BraZ1	10.5	-	4	94	105	0.8952381
A03	5168475	5172270	A03p12720.2_BraZ1	3050.35	-	266	2353	3795	0.6200264
A03	5175100	5179366	A03p12730.2_BraZ1	1717.66	+	2657	4266	4266	1.0000000
A03	5180004	5181240	A03p12740.2_BraZ1	861	+	334	850	1236	0.6877022
A03	5185420	5186008	A03p12750.2_BraZ1	58.8	-	38	384	588	0.6530612
A03	5196027	5197475	A03p12760.2_BraZ1	954	+	407	1218	1448	0.8411602
A03	5198803	5200391	A03p12770.2_BraZ1	717.115	+	1153	1588	1588	1.0000000
A03	5201466	5203081	A03p12780.2_BraZ1	1542	+	313	1481	1615	0.9170279
A03	5207595	5209518	A03p12790.2_BraZ1	192.3	-	232	1838	1923	0.9557982
A03	5210208	5211805	A03p12800.2_BraZ1	1095	+	758	1444	1597	0.9041954
A03	5212900	5215268	A03p12810.2_BraZ1	975.6	+	1089	2069	2368	0.8737331
A03	5219947	5220781	A03p12820.2_BraZ1	83.4	-	399	834	834	1.0000000
A03	5221737	5223960	A03p12830.2_BraZ1	426	-	491	1920	2223	0.8636977
A03	5226126	5228520	A03p12840.2_BraZ1	1596.91	+	1232	2259	2394	0.9436090
A03	5229209	5231521	A03p12850.2_BraZ1	939	-	701	1967	2312	0.8507785
A03	5232246	5236939	A03p12860.2_BraZ1	2475.62	-	1976	4338	4693	0.9243554
A03	5238663	5240184	A03p12870.2_BraZ1	549.25	+	652	1521	1521	1.0000000
A03	5241056	5242821	A03p12880.2_BraZ1	1017.12	-	1879	1730	1765	0.9801700
A03	5244268	5246087	A03p12890.2_BraZ1	1112.01	+	850	1800	1819	0.9895547
A03	5247243	5249256	A03p12900.2_BraZ1	1509	+	312	1849	2013	0.9185296
A03	5250822	5253133	A03p12910.2_BraZ1	1358.5	-	570	2141	2311	0.9264387
A03	5259581	5261994	A03p12920.2_BraZ1	554.804	-	668	1971	2413	0.8168255
A03	5264206	5264595	A03p12930.2_BraZ1	588	+	64	347	389	0.8920308
A03	5266631	5268076	A03p12940.2_BraZ1	2538	-	1015	1445	1445	1.0000000
A03	5271939	5272179	A03p12950.2_BraZ1	24	+	609	240	240	1.0000000
A03	5276762	5278499	A03p12960.2_BraZ1	1128.27	+	821	1737	1737	1.0000000
A03	5281661	5285523	A03p12970.2_BraZ1	1415.02	-	1160	3399	3862	0.8801140
A03	5288770	5289097	A03p12980.2_BraZ1	231	-	184	304	327	0.9296636
A03	5289552	5289746	A03p12990.2_BraZ1	16.2	-	31	194	194	1.0000000
A03	5290626	5291064	A03p13000.2_BraZ1	189	-	149	225	438	0.5136986
A03	5293526	5294427	A03p13010.2_BraZ1	548.261	+	373	845	901	0.9378468
A03	5294780	5301708	A03p13020.2_BraZ1	2367	-	1337	5181	6928	0.7478349
A03	5303267	5303940	A03p13030.2_BraZ1	594	+	223	624	673	0.9271917
A03	5304634	5307172	A03p13040.2_BraZ1	1468.36	-	1537	2538	2538	1.0000000
A03	5308819	5311429	A03p13050.2_BraZ1	1140.35	-	1146	2581	2610	0.9888889
A03	5313127	5313949	A03p13060.2_BraZ1	521.518	+	203	774	822	0.9416059
A03	5318650	5319189	A03p13070.2_BraZ1	207	+	1202	539	539	1.0000000
A03	5328979	5331152	A03p13080.2_BraZ1	688.5	+	1361	2173	2173	1.0000000
A03	5332221	5335238	A03p13090.2_BraZ1	1031.14	-	1813	2902	3017	0.9618827
A03	5337024	5337993	A03p13100.2_BraZ1	573.333	-	561	969	969	1.0000000
A03	5339953	5340433	A03p13110.2_BraZ1	48	+	275	480	480	1.0000000
A03	5341712	5345748	A03p13120.2_BraZ1	1972.3	-	1581	3930	4036	0.9737363
A03	5359840	5361571	A03p13130.2_BraZ1	1110	-	3187	1731	1731	1.0000000
A03	5366673	5368409	A03p13140.2_BraZ1	1251.25	+	262	1382	1736	0.7960830
A03	5370158	5372489	A03p13150.2_BraZ1	1129.91	+	1635	2331	2331	1.0000000
A03	5375082	5376464	A03p13160.2_BraZ1	441	-	212	1004	1382	0.7264833
A03	5377885	5379690	A03p13170.2_BraZ1	675	-	1054	1636	1805	0.9063712
A03	5379690	5380458	A03p13180.2_BraZ1	76.5	-	803	768	768	1.0000000
A03	5381676	5382141	A03p13190.2_BraZ1	46.5	+	724	465	465	1.0000000
A03	5382542	5384036	A03p13200.2_BraZ1	1245.45	-	930	1494	1494	1.0000000
A03	5385287	5389089	A03p13210.2_BraZ1	530.4	-	2545	3802	3802	1.0000000
A03	5390151	5390736	A03p13220.2_BraZ1	3588	+	125	585	585	1.0000000
A03	5390736	5393960	A03p13230.2_BraZ1	663	-	1582	3224	3224	1.0000000
A03	5395922	5397317	A03p13240.2_BraZ1	936	+	405	1329	1395	0.9526882
A03	5398486	5401190	A03p13250.2_BraZ1	1008.5	-	1094	2619	2704	0.9685651
A03	5402242	5404731	A03p13260.2_BraZ1	1314.67	+	613	2355	2489	0.9461631
A03	5405331	5406222	A03p13270.2_BraZ1	36	+	610	891	891	1.0000000
A03	5407171	5409572	A03p13280.2_BraZ1	1542.9	-	1394	2397	2401	0.9983341
A03	5410402	5412388	A03p13290.2_BraZ1	198.6	+	303	1702	1986	0.8569990
A03	5415148	5415573	A03p13300.2_BraZ1	3036	+	402	425	425	1.0000000
A03	5415844	5418279	A03p13310.2_BraZ1	1334.35	-	2463	2378	2435	0.9765913
A03	5418915	5421299	A03p13320.2_BraZ1	1377	-	822	1970	2384	0.8263423
A03	5423228	5423942	A03p13330.2_BraZ1	399	+	139	714	714	1.0000000
A03	5424872	5426762	A03p13340.2_BraZ1	1122.59	+	392	1821	1890	0.9634920
A03	5427266	5428581	A03p13350.2_BraZ1	1072.5	-	1741	1315	1315	1.0000000
A03	5431348	5431979	A03p13360.2_BraZ1	513	+	289	581	631	0.9207607
A03	5434873	5435721	A03p13370.2_BraZ1	249	-	427	848	848	1.0000000
A03	5548935	5551018	A03p13380.2_BraZ1	1465.04	-	1366	1962	2083	0.9419107
A03	5555466	5558433	A03p13390.2_BraZ1	1590.45	-	2936	2910	2967	0.9807886
A03	5558947	5560421	A03p13400.2_BraZ1	982.312	+	261	1260	1474	0.8548169
A03	5562877	5565185	A03p13410.2_BraZ1	4528.12	-	412	2257	2308	0.9779029
A03	5566611	5568198	A03p13420.2_BraZ1	124.2	+	844	1587	1587	1.0000000
A03	5569658	5571074	A03p13430.2_BraZ1	3843	+	142	631	1416	0.4456215
A03	5571515	5572724	A03p13440.2_BraZ1	120.9	-	5378	1209	1209	1.0000000
A03	5574221	5575752	A03p13450.2_BraZ1	2119.5	+	1710	1485	1531	0.9699543
A03	5580539	5586169	A03p13460.2_BraZ1	633.458	+	2522	5208	5630	0.9250444
A03	5586962	5590661	A03p13470.2_BraZ1	1472	+	2424	3565	3699	0.9637740
A03	5595491	5597225	A03p13480.2_BraZ1	980.4	-	810	1481	1734	0.8540946
A03	5601625	5605736	A03p13490.2_BraZ1	1882.98	+	3083	4111	4111	1.0000000
A03	5607679	5610230	A03p13500.2_BraZ1	149.7	+	1854	2551	2551	1.0000000
A03	5611131	5617919	A03p13510.2_BraZ1	3229.2	-	2796	5881	6788	0.8663818
A03	5618760	5619006	A03p13520.2_BraZ1	24.6	-	31	170	246	0.6910569
A03	5620745	5622486	A03p13530.2_BraZ1	10741.5	-	929	1628	1741	0.9350948
A03	5623797	5625429	A03p13540.2_BraZ1	163.2	-	770	1554	1632	0.9522059
A03	5626157	5628422	A03p13550.2_BraZ1	5095.2	-	1733	2244	2265	0.9907285
A03	5641719	5646627	A03p13560.2_BraZ1	1732.45	-	2740	4877	4908	0.9936838
A03	5652914	5655006	A03p13570.2_BraZ1	1800.53	-	719	2092	2092	1.0000000
A03	5659451	5660003	A03p13580.2_BraZ1	55.2	+	22	546	552	0.9891304
A03	5660416	5661456	A03p13590.2_BraZ1	324	-	1488	1040	1040	1.0000000
A03	5666145	5668890	A03p13600.2_BraZ1	2259	+	1775	2571	2745	0.9366120
A03	5675294	5678643	A03p13610.2_BraZ1	4227.27	+	2050	3304	3349	0.9865631
A03	5679200	5679470	A03p13620.2_BraZ1	27	+	273	270	270	1.0000000
A03	5679854	5680955	A03p13630.2_BraZ1	110.1	-	484	1097	1101	0.9963669
A03	5682088	5683211	A03p13640.2_BraZ1	50.7	-	512	1117	1123	0.9946572
A03	5684069	5687120	A03p13650.2_BraZ1	572	-	434	2057	3051	0.6742052
A03	5688003	5692858	A03p13660.2_BraZ1	2935.15	-	781	3454	4855	0.7114315
A03	5694248	5695957	A03p13670.2_BraZ1	1699.5	-	1445	1709	1709	1.0000000
A03	5697056	5699464	A03p13680.2_BraZ1	856.304	-	2020	2408	2408	1.0000000
A03	5700652	5702951	A03p13690.2_BraZ1	72450	+	617	2299	2299	1.0000000
A03	5703611	5704915	A03p13700.2_BraZ1	660.56	-	628	1304	1304	1.0000000
A03	5707821	5709139	A03p13710.2_BraZ1	978	-	226	1192	1318	0.9044006
A03	5712664	5715017	A03p13720.2_BraZ1	2181	+	344	1979	2353	0.8410540
A03	5716286	5717564	A03p13730.2_BraZ1	566.206	+	568	1033	1278	0.8082942
A03	5723716	5725755	A03p13740.2_BraZ1	6081.43	-	1035	2039	2039	1.0000000
A03	5727521	5730231	A03p13750.2_BraZ1	1270	-	1707	2710	2710	1.0000000
A03	5731360	5738064	A03p13760.2_BraZ1	5081.31	-	1288	5291	6704	0.7892303
A03	5738344	5740183	A03p13770.2_BraZ1	508.857	+	1067	1692	1839	0.9200652
A03	5740419	5740952	A03p13780.2_BraZ1	459	-	293	533	533	1.0000000
A03	5743841	5746835	A03p13790.2_BraZ1	1338.13	-	1175	2852	2994	0.9525718
A03	5749828	5751920	A03p13800.2_BraZ1	585	+	1452	2020	2092	0.9655831
A03	5752798	5753431	A03p13810.2_BraZ1	63.3	+	209	633	633	1.0000000
A03	5753668	5756394	A03p13820.2_BraZ1	1499.72	-	366	1771	2726	0.6496698
A03	5758636	5759461	A03p13830.2_BraZ1	82.5	+	121	570	825	0.6909091
A03	5760214	5762191	A03p13840.2_BraZ1	197.7	+	630	1854	1977	0.9377845
A03	5763571	5764733	A03p13850.2_BraZ1	1092	-	47	681	1162	0.5860585
A03	5768025	5768328	A03p13860.2_BraZ1	30.3	-	0	0	303	0.0000000
A03	5768367	5769158	A03p13870.2_BraZ1	180	-	0	0	791	0.0000000
A03	5769345	5769525	A03p13880.2_BraZ1	18	-	0	0	180	0.0000000
A03	5772319	5772629	A03p13890.2_BraZ1	30.3	-	225	310	310	1.0000000
A03	5773381	5775151	A03p13900.2_BraZ1	516	+	1186	1770	1770	1.0000000
A03	5775344	5777784	A03p13910.2_BraZ1	1819.93	+	984	2386	2440	0.9778689
A03	5778604	5780634	A03p13920.2_BraZ1	1465.16	-	1003	1817	2030	0.8950739
A03	5781208	5783399	A03p13930.2_BraZ1	817.4	-	1404	2125	2191	0.9698768
A03	5788648	5789646	A03p13940.2_BraZ1	918	+	421	965	998	0.9669338
A03	5804810	5805161	A03p13950.2_BraZ1	164.25	+	35	122	351	0.3475783
A03	5805166	5806721	A03p13960.2_BraZ1	1305	+	232	1330	1555	0.8553055
A03	5808188	5809917	A03p13970.2_BraZ1	1248	-	253	1545	1729	0.8935801
A03	5811995	5813500	A03p13980.2_BraZ1	712.219	+	336	1416	1505	0.9408638
A03	5814518	5816415	A03p13990.2_BraZ1	1553.86	-	634	1897	1897	1.0000000
A03	5818314	5820317	A03p14000.2_BraZ1	10030	+	547	1850	2003	0.9236146
A03	5820619	5820880	A03p14010.2_BraZ1	26.1	-	136	261	261	1.0000000
A03	5821455	5827655	A03p14020.2_BraZ1	2373	-	3895	6122	6200	0.9874194
A03	5829484	5829784	A03p14030.2_BraZ1	30	-	0	0	300	0.0000000
A03	5830530	5830970	A03p14040.2_BraZ1	414	-	70	440	440	1.0000000
A03	5832698	5836108	A03p14050.2_BraZ1	1995.84	+	718	2572	3410	0.7542522
A03	5841571	5842587	A03p14060.2_BraZ1	48	+	65	653	1016	0.6427165
A03	5844281	5845322	A03p14070.2_BraZ1	104.1	+	1487	1041	1041	1.0000000
A03	5853290	5854349	A03p14080.2_BraZ1	105.9	+	201	980	1059	0.9254013
A03	5855591	5855909	A03p14090.2_BraZ1	31.8	+	55	222	318	0.6981132
A03	5856062	5856596	A03p14100.2_BraZ1	53.4	+	303	534	534	1.0000000
A03	5857997	5859014	A03p14110.2_BraZ1	101.7	+	840	1017	1017	1.0000000
A03	5859908	5860148	A03p14120.2_BraZ1	24	+	57	49	240	0.2041667
A03	5860595	5862765	A03p14130.2_BraZ1	213	+	822	2086	2170	0.9612903
A03	5861006	5861907	A03p14140.2_BraZ1	663	+	262	891	901	0.9889012
A03	5863663	5868018	A03p14150.2_BraZ1	1596.82	-	1757	4244	4355	0.9745120
A03	5868466	5869133	A03p14160.2_BraZ1	492	+	236	667	667	1.0000000
A03	5869685	5869896	A03p14170.2_BraZ1	156	-	83	211	211	1.0000000
A03	5870682	5872148	A03p14180.2_BraZ1	144	-	131	1360	1466	0.9276944
A03	5879539	5880640	A03p14190.2_BraZ1	110.1	+	494	1101	1101	1.0000000
A03	5882090	5882567	A03p14200.2_BraZ1	47.7	-	355	477	477	1.0000000
A03	5889068	5889557	A03p14210.2_BraZ1	48.9	-	419	489	489	1.0000000
A03	5897466	5898975	A03p14220.2_BraZ1	135.6	+	236	1389	1509	0.9204772
A03	5904861	5908190	A03p14230.2_BraZ1	1067.68	-	756	2954	3329	0.8873535
A03	5908892	5912906	A03p14240.2_BraZ1	1380.56	-	1177	3217	4014	0.8014449
A03	5918012	5924357	A03p14250.2_BraZ1	957.6	-	1701	4774	6345	0.7524034
A03	5929750	5932150	A03p14260.2_BraZ1	981.346	-	1259	2363	2400	0.9845833
A03	5937671	5939754	A03p14270.2_BraZ1	1665	+	624	1885	2083	0.9049448
A03	5940893	5943126	A03p14280.2_BraZ1	850.345	-	639	2161	2233	0.9677564
A03	5948095	5948830	A03p14290.2_BraZ1	554.114	-	53	595	735	0.8095238
A03	5951699	5952050	A03p14300.2_BraZ1	35.1	-	312	351	351	1.0000000
A03	5955496	5955990	A03p14310.2_BraZ1	405	+	112	359	494	0.7267206
A03	5957297	5958126	A03p14320.2_BraZ1	744	+	193	622	829	0.7503015
A03	5963368	5965700	A03p14330.2_BraZ1	1291.06	-	654	2275	2332	0.9755574
A03	5973445	5975288	A03p14340.2_BraZ1	14662.5	-	319	1734	1843	0.9408573
A03	5976702	5979650	A03p14350.2_BraZ1	1321.03	+	2298	2927	2948	0.9928765
A03	5980632	5983082	A03p14360.2_BraZ1	1047.05	-	907	2361	2450	0.9636735
A03	5985818	5988750	A03p14370.2_BraZ1	2049.41	+	283	1775	2932	0.6053888
A03	5988823	5989042	A03p14380.2_BraZ1	21.9	-	17	197	219	0.8995434
A03	5990400	5992237	A03p14390.2_BraZ1	1367.27	+	6	85	1837	0.0462711
A03	5994906	5996743	A03p14400.2_BraZ1	1410	+	29	164	1837	0.0892760
A03	6002119	6003497	A03p14410.2_BraZ1	892.5	+	1058	1378	1378	1.0000000
A03	6003810	6005275	A03p14420.2_BraZ1	691.393	-	1397	1465	1465	1.0000000
A03	6009604	6012551	A03p14430.2_BraZ1	2552.73	+	843	2718	2947	0.9222938
A03	6013138	6013932	A03p14440.2_BraZ1	537	-	431	756	794	0.9521410
A03	6016806	6018998	A03p14450.2_BraZ1	1215.1	-	2468	2192	2192	1.0000000
A03	6024888	6025448	A03p14460.2_BraZ1	378	-	667	560	560	1.0000000
A03	6031363	6032501	A03p14470.2_BraZ1	460.2	-	1413	1138	1138	1.0000000
A03	6033496	6035212	A03p14480.2_BraZ1	1260	+	711	1462	1716	0.8519813
A03	6041051	6043516	A03p14490.2_BraZ1	420	+	6529	2465	2465	1.0000000
A03	6055311	6057436	A03p14500.2_BraZ1	1856.47	+	256	1481	2125	0.6969412
A03	6065332	6065619	A03p14510.2_BraZ1	14.7	-	397	287	287	1.0000000
A03	6065962	6067211	A03p14520.2_BraZ1	735.714	-	678	1135	1249	0.9087270
A03	6076094	6077114	A03p14530.2_BraZ1	101.7	+	723	1020	1020	1.0000000
A03	6078654	6083467	A03p14540.2_BraZ1	2442	+	3086	4543	4813	0.9439020
A03	6085100	6086295	A03p14550.2_BraZ1	1042.42	-	360	1140	1195	0.9539749
A03	6090329	6091805	A03p14560.2_BraZ1	147.6	-	255	1367	1476	0.9261518
A03	6093643	6096929	A03p14570.2_BraZ1	985.768	+	2718	3203	3286	0.9747413
A03	6099270	6100215	A03p14580.2_BraZ1	94.5	+	168	945	945	1.0000000
A03	6101724	6102102	A03p14590.2_BraZ1	37.8	-	514	378	378	1.0000000
A03	6111418	6113102	A03p14600.2_BraZ1	945	+	333	1574	1684	0.9346793
A03	6116013	6116399	A03p14610.2_BraZ1	270	-	170	386	386	1.0000000
A03	6119711	6127909	A03p14620.2_BraZ1	428.4	-	4392	7508	8198	0.9158331
A03	6129832	6129991	A03p14630.2_BraZ1	15.9	-	18	159	159	1.0000000
A03	6134205	6134572	A03p14640.2_BraZ1	255	-	121	367	367	1.0000000
A03	6141629	6147421	A03p14650.2_BraZ1	3533.37	+	1225	5492	5792	0.9482044
A03	6147531	6147786	A03p14660.2_BraZ1	25.5	-	57	255	255	1.0000000
A03	6148713	6150839	A03p14670.2_BraZ1	109.5	-	288	1366	2126	0.6425211
A03	6153894	6154686	A03p14680.2_BraZ1	476.763	+	462	792	792	1.0000000
A03	6155811	6158142	A03p14690.2_BraZ1	672	+	1360	2331	2331	1.0000000
A03	6158789	6159248	A03p14700.2_BraZ1	360	+	321	459	459	1.0000000
A03	6159576	6160543	A03p14710.2_BraZ1	390	-	642	967	967	1.0000000
A03	6161160	6162504	A03p14720.2_BraZ1	134.4	+	191	1154	1344	0.8586310
A03	6164275	6165619	A03p14730.2_BraZ1	134.4	+	260	1303	1344	0.9694940
A03	6166598	6167657	A03p14740.2_BraZ1	411	+	508	1006	1059	0.9499528
A03	6174462	6175684	A03p14750.2_BraZ1	47.4	+	241	481	1222	0.3936170
A03	6177045	6177636	A03p14760.2_BraZ1	561	-	123	584	591	0.9881557
A03	6178061	6180640	A03p14770.2_BraZ1	1292.1	-	95	902	2579	0.3497480
A03	6182519	6182936	A03p14780.2_BraZ1	174	+	599	417	417	1.0000000
A03	6183568	6184921	A03p14790.2_BraZ1	135.3	+	104	863	1353	0.6378418
A03	6186073	6186767	A03p14800.2_BraZ1	397.895	-	133	694	694	1.0000000
A03	6187049	6187972	A03p14810.2_BraZ1	702	-	83	568	923	0.6153846
A03	6188263	6189368	A03p14820.2_BraZ1	789	+	170	652	1105	0.5900453
A03	6190239	6190602	A03p14830.2_BraZ1	36.3	+	1	38	363	0.1046832
A03	6190884	6194027	A03p14840.2_BraZ1	1047.27	+	1122	2272	3143	0.7228763
A03	6194696	6197068	A03p14850.2_BraZ1	1122	-	992	2273	2372	0.9582630
A03	6203174	6204179	A03p14860.2_BraZ1	100.5	-	972	1005	1005	1.0000000
A03	6215102	6215450	A03p14870.2_BraZ1	34.8	-	283	348	348	1.0000000
A03	6222613	6223329	A03p14880.2_BraZ1	636	+	486	716	716	1.0000000
A03	6224978	6225263	A03p14890.2_BraZ1	28.5	+	16	242	285	0.8491228
A03	6227172	6228476	A03p14900.2_BraZ1	3690	-	264	1080	1304	0.8282208
A03	6231199	6231814	A03p14910.2_BraZ1	61.5	-	89	569	615	0.9252033
A03	6232650	6233470	A03p14920.2_BraZ1	222	-	862	820	820	1.0000000
A03	6233889	6236820	A03p14930.2_BraZ1	1627.36	+	1464	2036	2931	0.6946434
A03	6239817	6241317	A03p14940.2_BraZ1	1287	-	46	469	1500	0.3126667
A03	6245338	6246832	A03p14950.2_BraZ1	1266.53	-	82	669	1494	0.4477912
A03	6249590	6249956	A03p14960.2_BraZ1	35.7	-	2	136	366	0.3715847
A03	6251488	6254770	A03p14970.2_BraZ1	326.4	-	1403	3167	3282	0.9649604
A03	6253138	6253382	A03p14980.2_BraZ1	153	+	309	244	244	1.0000000
A03	6256437	6258397	A03p14990.2_BraZ1	4168.12	+	685	1481	1960	0.7556123
A03	6259279	6262686	A03p15000.2_BraZ1	2127.5	-	653	1998	3407	0.5864397
A03	6264636	6267977	A03p15010.2_BraZ1	1992	-	674	2191	3341	0.6557917
A03	6276379	6278815	A03p15020.2_BraZ1	1707.15	+	1404	2182	2436	0.8957307
A03	6280408	6289282	A03p15030.2_BraZ1	5435.29	-	1979	8054	8874	0.9075952
A03	6305844	6309886	A03p15040.2_BraZ1	3003.75	+	2360	3905	4042	0.9661059
A03	6310358	6310943	A03p15050.2_BraZ1	165	-	404	585	585	1.0000000
A03	6331937	6334334	A03p15060.2_BraZ1	3749	+	1011	2327	2397	0.9707968
A03	6334578	6337772	A03p15070.2_BraZ1	1498.08	-	2542	3187	3194	0.9978084
A03	6338841	6340199	A03p15080.2_BraZ1	1736.36	-	1449	1319	1358	0.9712813
A03	6341537	6345646	A03p15090.2_BraZ1	1333.4	+	2168	3927	4109	0.9557070
A03	6359929	6361171	A03p15100.2_BraZ1	124.2	-	134	727	1242	0.5853462
A03	6365980	6367015	A03p15110.2_BraZ1	102.9	+	7	286	1035	0.2763285
A03	6378331	6379195	A03p15120.2_BraZ1	815.5	+	376	692	864	0.8009259
A03	6382100	6383060	A03p15130.2_BraZ1	988	+	207	591	960	0.6156250
A03	6385250	6386395	A03p15140.2_BraZ1	780	-	792	1047	1145	0.9144105
A03	6387633	6388241	A03p15150.2_BraZ1	534	+	316	540	608	0.8881579
A03	6389405	6389801	A03p15160.2_BraZ1	321	-	160	396	396	1.0000000
A03	6390339	6391945	A03p15170.2_BraZ1	1491.19	-	1390	1594	1606	0.9925280
A03	6399092	6401113	A03p15180.2_BraZ1	1050	+	521	1414	2021	0.6996536
A03	6404168	6405215	A03p15190.2_BraZ1	32.1	-	126	895	1047	0.8548233
A03	6413681	6413849	A03p15200.2_BraZ1	16.8	+	87	168	168	1.0000000
A03	6416765	6419725	A03p15210.2_BraZ1	1180.8	+	1037	2929	2960	0.9895270
A03	6420065	6420613	A03p15220.2_BraZ1	381.818	+	221	548	548	1.0000000
A03	6421432	6421851	A03p15230.2_BraZ1	55.6364	+	194	411	419	0.9809069
A03	6422821	6424356	A03p15240.2_BraZ1	542.386	-	1108	1534	1535	0.9993485
A03	6432350	6433373	A03p15250.2_BraZ1	765	+	28	573	1023	0.5601173
A03	6434979	6441619	A03p15260.2_BraZ1	1938.67	-	2111	5392	6640	0.8120482
A03	6443724	6445106	A03p15270.2_BraZ1	726	+	277	799	1382	0.5781476
A03	6445183	6446733	A03p15280.2_BraZ1	852.429	-	276	699	1550	0.4509677
A03	6449362	6450086	A03p15290.2_BraZ1	220.455	+	12	405	724	0.5593923
A03	6454159	6454876	A03p15300.2_BraZ1	226.333	+	13	211	717	0.2942817
A03	6458935	6459696	A03p15310.2_BraZ1	1862.25	+	15	438	761	0.5755585
A03	6462178	6464839	A03p15320.2_BraZ1	988.826	+	174	1529	2661	0.5745960
A03	6465828	6466690	A03p15330.2_BraZ1	239.143	+	0	0	862	0.0000000
A03	6470708	6473337	A03p15340.2_BraZ1	991.958	+	96	855	2629	0.3252187
A03	6474327	6475187	A03p15350.2_BraZ1	239.143	+	1	24	860	0.0279070
A03	6478596	6479354	A03p15360.2_BraZ1	1852.5	+	0	0	758	0.0000000
A03	6482995	6484155	A03p15370.2_BraZ1	645	+	2	168	1160	0.1448276
A03	6485654	6488315	A03p15380.2_BraZ1	988.826	+	11	310	2661	0.1164976
A03	6489305	6490167	A03p15390.2_BraZ1	239.143	+	0	0	862	0.0000000
A03	6492886	6493642	A03p15400.2_BraZ1	75.6	+	132	756	756	1.0000000
A03	6511979	6512493	A03p15410.2_BraZ1	459	+	247	514	514	1.0000000
A03	6513949	6515037	A03p15420.2_BraZ1	552	-	155	733	1088	0.6737132
A03	6524175	6528402	A03p15430.2_BraZ1	1150.64	+	1843	3989	4227	0.9436953
A03	6533176	6534218	A03p15440.2_BraZ1	9954	+	296	1042	1042	1.0000000
A03	6539987	6541707	A03p15450.2_BraZ1	513	-	1332	1705	1720	0.9912791
A03	6543403	6543886	A03p15460.2_BraZ1	387	-	161	352	483	0.7287785
A03	6547014	6549699	A03p15470.2_BraZ1	1028.02	-	721	2282	2685	0.8499069
A03	6550987	6551429	A03p15480.2_BraZ1	183.469	-	11	156	442	0.3529412
A03	6553484	6555830	A03p15490.2_BraZ1	822.222	+	829	2158	2346	0.9198636
A03	6556428	6557703	A03p15500.2_BraZ1	435.695	+	623	1275	1275	1.0000000
A03	6558469	6558872	A03p15510.2_BraZ1	390	-	153	403	403	1.0000000
A03	6559935	6560611	A03p15520.2_BraZ1	5700	+	222	631	676	0.9334319
A03	6561368	6561876	A03p15530.2_BraZ1	237	-	68	508	508	1.0000000
A03	6569074	6572223	A03p15540.2_BraZ1	1242.82	+	2871	3149	3149	1.0000000
A03	6572488	6572985	A03p15550.2_BraZ1	237	-	23	413	497	0.8309859
A03	6573594	6574595	A03p15560.2_BraZ1	244	-	471	972	1001	0.9710290
A03	6579222	6580509	A03p15570.2_BraZ1	768.4	-	847	1287	1287	1.0000000
A03	6581988	6584579	A03p15580.2_BraZ1	1509.82	-	160	1607	2591	0.6202239
A03	6593488	6593670	A03p15590.2_BraZ1	105	+	308	182	182	1.0000000
A03	6594386	6597430	A03p15600.2_BraZ1	1831.5	+	1316	2649	3044	0.8702365
A03	6599169	6600666	A03p15610.2_BraZ1	149.7	+	448	1259	1497	0.8410153
A03	6602232	6604592	A03p15620.2_BraZ1	1800	-	315	2015	2360	0.8538136
A03	6606546	6612494	A03p15630.2_BraZ1	4476.27	+	1096	5071	5948	0.8525555
A03	6613577	6614575	A03p15640.2_BraZ1	390.857	+	66	962	998	0.9639279
A03	6614899	6615982	A03p15650.2_BraZ1	782.842	-	122	817	1083	0.7543859
A03	6619255	6620411	A03p15660.2_BraZ1	106.5	-	343	1111	1156	0.9610727
A03	6621872	6623742	A03p15670.2_BraZ1	456.29	-	1259	1630	1870	0.8716577
A03	6624163	6624972	A03p15680.2_BraZ1	604.432	+	624	809	809	1.0000000
A03	6625788	6626481	A03p15690.2_BraZ1	69.3	+	360	686	693	0.9898990
A03	6630089	6630383	A03p15700.2_BraZ1	29.4	-	33	144	294	0.4897959
A03	6632237	6633333	A03p15710.2_BraZ1	2337.5	+	24	238	1096	0.2171533
A03	6635420	6639162	A03p15720.2_BraZ1	835.043	+	702	2793	3742	0.7463923
A03	6639952	6641215	A03p15730.2_BraZ1	817.15	+	1039	1263	1263	1.0000000
A03	6641805	6643512	A03p15740.2_BraZ1	757.971	-	126	988	1707	0.5787932
A03	6645429	6645646	A03p15750.2_BraZ1	21.3	+	414	217	217	1.0000000
A03	6648408	6652280	A03p15760.2_BraZ1	936	-	4371	3766	3872	0.9726239
A03	6659988	6661374	A03p15770.2_BraZ1	958.391	+	201	1303	1386	0.9401155
A03	6667054	6670605	A03p15780.2_BraZ1	1525.88	+	1091	2517	3551	0.7088144
A03	6671629	6673712	A03p15790.2_BraZ1	1731.6	+	1336	2065	2083	0.9913586
A03	6674426	6675950	A03p15800.2_BraZ1	152.4	-	992	1449	1524	0.9507874
A03	6681453	6691001	A03p15810.2_BraZ1	1164.38	-	913	6400	9548	0.6702974
A03	6692310	6693507	A03p15820.2_BraZ1	10571	-	822	1197	1197	1.0000000
A03	6699573	6700207	A03p15830.2_BraZ1	59.1	+	95	480	634	0.7570978
A03	6700946	6702113	A03p15840.2_BraZ1	116.7	+	327	968	1167	0.8294773
A03	6702186	6702288	A03p15850.2_BraZ1	10.2	+	136	102	102	1.0000000
A03	6703175	6705215	A03p15860.2_BraZ1	1288.78	+	1135	1978	2040	0.9696078
A03	6707059	6709572	A03p15870.2_BraZ1	1170	+	1359	2460	2513	0.9789097
A03	6710868	6721730	A03p15880.2_BraZ1	2314	-	5151	8262	10862	0.7606334
A03	6723041	6723692	A03p15890.2_BraZ1	65.1	-	0	0	651	0.0000000
A03	6725966	6727655	A03p15900.2_BraZ1	1317	+	939	1568	1689	0.9283600
A03	6731224	6734203	A03p15910.2_BraZ1	565.172	+	454	2480	2979	0.8324941
A03	6740208	6742368	A03p15920.2_BraZ1	588.75	+	570	1803	2160	0.8347222
A03	6746049	6747807	A03p15930.2_BraZ1	671	-	2184	1758	1758	1.0000000
A03	6748394	6749763	A03p15940.2_BraZ1	953.478	-	813	1369	1369	1.0000000
A03	6751057	6752890	A03p15950.2_BraZ1	183.3	-	808	1831	1833	0.9989089
A03	6754987	6757778	A03p15960.2_BraZ1	1204.28	-	613	2367	2791	0.8480831
A03	6766599	6767577	A03p15970.2_BraZ1	353.4	+	818	978	978	1.0000000
A03	6768165	6777104	A03p15980.2_BraZ1	3337.32	-	1232	4807	8939	0.5377559
A03	6777271	6778381	A03p15990.2_BraZ1	183	+	229	1090	1110	0.9819820
A03	6779464	6779593	A03p16000.2_BraZ1	12.9	-	52	129	129	1.0000000
A03	6780642	6782417	A03p16010.2_BraZ1	1252.12	+	1000	1635	1775	0.9211268
A03	6784902	6785544	A03p16020.2_BraZ1	64.2	-	282	642	642	1.0000000
A03	6786542	6788004	A03p16030.2_BraZ1	849.034	-	632	1329	1462	0.9090287
A03	6788756	6789497	A03p16040.2_BraZ1	366.448	-	167	741	741	1.0000000
A03	6790527	6791482	A03p16050.2_BraZ1	531	-	407	955	955	1.0000000
A03	6792393	6795997	A03p16060.2_BraZ1	2059.19	-	2377	3602	3604	0.9994451
A03	6797059	6798972	A03p16070.2_BraZ1	1584	+	997	1913	1913	1.0000000
A03	6799274	6801696	A03p16080.2_BraZ1	1636.48	-	1458	2422	2422	1.0000000
A03	6812080	6812413	A03p16090.2_BraZ1	33.3	+	134	331	333	0.9939940
A03	6815143	6817147	A03p16100.2_BraZ1	1969.2	-	932	1982	2004	0.9890220
A03	6817234	6817408	A03p16110.2_BraZ1	105	-	264	174	174	1.0000000
A03	6820182	6820544	A03p16120.2_BraZ1	264	-	205	362	362	1.0000000
A03	6822722	6823397	A03p16130.2_BraZ1	3564	-	486	675	675	1.0000000
A03	6823877	6825422	A03p16140.2_BraZ1	898.036	+	245	1450	1545	0.9385113
A03	6826337	6827879	A03p16150.2_BraZ1	1458	-	222	1363	1542	0.8839170
A03	6830056	6832321	A03p16160.2_BraZ1	226.5	+	99	482	2265	0.2128035
A03	6833959	6837341	A03p16170.2_BraZ1	1666	+	862	2999	3382	0.8867534
A03	6840271	6850729	A03p16180.2_BraZ1	1480.06	-	1618	6601	10458	0.6311914
A03	6856729	6857954	A03p16190.2_BraZ1	397.688	-	381	830	1225	0.6775510
A03	6861932	6862286	A03p16200.2_BraZ1	279	-	216	354	354	1.0000000
A03	6863642	6865004	A03p16210.2_BraZ1	1293	-	606	1324	1362	0.9720998
A03	6865467	6867967	A03p16220.2_BraZ1	1590	-	831	2303	2500	0.9212000
A03	6868990	6871376	A03p16230.2_BraZ1	991.091	+	1148	2277	2386	0.9543169
A03	6871727	6873669	A03p16240.2_BraZ1	888.351	-	1089	1890	1942	0.9732235
A03	6874427	6876156	A03p16250.2_BraZ1	1080.15	-	1090	1729	1729	1.0000000
A03	6877011	6878417	A03p16260.2_BraZ1	678	-	668	1337	1406	0.9509246
A03	6878772	6880106	A03p16270.2_BraZ1	6934.5	+	1030	1334	1334	1.0000000
A03	6880225	6880333	A03p16280.2_BraZ1	10.8	+	28	108	108	1.0000000
A03	6880971	6881328	A03p16290.2_BraZ1	35.7	+	38	214	357	0.5994398
A03	6887840	6889645	A03p16300.2_BraZ1	638.74	+	364	1700	1805	0.9418283
A03	6891021	6896611	A03p16310.2_BraZ1	2916	+	4639	5167	5590	0.9243292
A03	6896787	6898968	A03p16320.2_BraZ1	1794	-	1207	2181	2181	1.0000000
A03	6900228	6904678	A03p16330.2_BraZ1	2678.33	-	3248	4445	4450	0.9988764
A03	6908032	6908634	A03p16340.2_BraZ1	189	+	121	594	602	0.9867110
A03	6908917	6913730	A03p16350.2_BraZ1	2511.09	+	1641	3888	4813	0.8078122
A03	7248411	7249916	A03p16360.2_BraZ1	407.932	-	1022	1457	1505	0.9681063
A03	7251163	7254722	A03p16370.2_BraZ1	2740.18	+	1004	3062	3559	0.8603540
A03	7255197	7257084	A03p16380.2_BraZ1	1398	+	597	1713	1887	0.9077901
A03	7257535	7260741	A03p16390.2_BraZ1	37.8	+	623	2735	3206	0.8530880
A03	7264054	7265629	A03p16400.2_BraZ1	867.484	+	722	1393	1575	0.8844444
A03	7265953	7266109	A03p16410.2_BraZ1	15.6	+	98	156	156	1.0000000
A03	7279142	7280801	A03p16420.2_BraZ1	165.9	+	191	1439	1659	0.8673900
A03	7285584	7286894	A03p16430.2_BraZ1	530.75	+	525	1254	1310	0.9572519
A03	7289053	7291569	A03p16440.2_BraZ1	1569.52	+	908	2369	2516	0.9415739
A03	7292240	7294912	A03p16450.2_BraZ1	1092.5	-	1449	2549	2672	0.9539671
A03	7296265	7306339	A03p16460.2_BraZ1	1064.76	-	1896	5744	10074	0.5701807
A03	7300401	7302998	A03p16470.2_BraZ1	3623.36	+	249	950	2597	0.3658067
A03	7307038	7308339	A03p16480.2_BraZ1	825	-	49	656	1301	0.5042275
A03	7309238	7309629	A03p16490.2_BraZ1	231	+	135	391	391	1.0000000
A03	7320420	7320816	A03p16500.2_BraZ1	39.6	+	513	396	396	1.0000000
A03	7323223	7324556	A03p16510.2_BraZ1	683.571	+	24	629	1333	0.4718680
A03	7325453	7329659	A03p16520.2_BraZ1	2067.15	-	2069	3709	4206	0.8818355
A03	7332742	7333270	A03p16530.2_BraZ1	52.8	-	97	480	528	0.9090909
A03	7344110	7345931	A03p16540.2_BraZ1	765	+	690	1447	1821	0.7946184
A03	7347224	7347888	A03p16550.2_BraZ1	216	+	556	664	664	1.0000000
A03	7348019	7349414	A03p16560.2_BraZ1	339.25	+	209	1162	1395	0.8329749
A03	7354056	7355387	A03p16570.2_BraZ1	1029	+	1314	1331	1331	1.0000000
A03	7358587	7359046	A03p16580.2_BraZ1	249	-	16	124	459	0.2701525
A03	7361580	7365315	A03p16590.2_BraZ1	1122.38	-	1834	3670	3735	0.9825971
A03	7372965	7376002	A03p16600.2_BraZ1	1311.3	-	846	2802	3037	0.9226210
A03	7376966	7379277	A03p16610.2_BraZ1	408	-	1496	2311	2311	1.0000000
A03	7380969	7381614	A03p16620.2_BraZ1	64.5	+	288	645	645	1.0000000
A03	7390340	7390952	A03p16630.2_BraZ1	342	-	466	612	612	1.0000000
A03	7392643	7403088	A03p16640.2_BraZ1	636.462	+	2283	5382	10445	0.5152705
A03	7396049	7396466	A03p16650.2_BraZ1	41.7	-	0	0	417	0.0000000
A03	7397337	7400048	A03p16660.2_BraZ1	930.1	-	0	0	2711	0.0000000
A03	7405991	7407201	A03p16670.2_BraZ1	11844	+	281	1027	1210	0.8487603
A03	7415913	7420580	A03p16680.2_BraZ1	2052	+	1739	4152	4667	0.8896508
A03	7421710	7423236	A03p16690.2_BraZ1	599.4	+	1297	1526	1526	1.0000000
A03	7427379	7428323	A03p16700.2_BraZ1	453	-	164	540	944	0.5720339
A03	7440688	7444539	A03p16710.2_BraZ1	1776.93	+	927	3523	3851	0.9148273
A03	7445935	7452334	A03p16720.2_BraZ1	1158	+	6576	5813	6399	0.9084232
A03	7454060	7455128	A03p16730.2_BraZ1	106.8	+	814	1068	1068	1.0000000
A03	7455448	7459762	A03p16740.2_BraZ1	3165.01	-	1446	4008	4314	0.9290681
A03	7463769	7464585	A03p16750.2_BraZ1	570	+	1	12	816	0.0147059
A03	7467646	7469176	A03p16760.2_BraZ1	3640	+	404	1503	1530	0.9823529
A03	7469434	7470253	A03p16770.2_BraZ1	441	+	478	819	819	1.0000000
A03	7470660	7471010	A03p16780.2_BraZ1	228	-	477	350	350	1.0000000
A03	7471563	7472211	A03p16790.2_BraZ1	1395	+	0	0	648	0.0000000
A03	7482124	7483120	A03p16800.2_BraZ1	99.6	+	323	899	996	0.9026104
A03	7485714	7486041	A03p16810.2_BraZ1	231	-	105	327	327	1.0000000
A03	7488056	7489455	A03p16820.2_BraZ1	644	-	970	1399	1399	1.0000000
A03	7492270	7492801	A03p16830.2_BraZ1	53.1	+	183	347	531	0.6534840
A03	7494362	7500109	A03p16840.2_BraZ1	2785	-	873	3810	5747	0.6629546
A03	7502818	7503669	A03p16850.2_BraZ1	561	-	389	851	851	1.0000000
A03	7508238	7510071	A03p16860.2_BraZ1	14677.5	+	645	1829	1833	0.9978178
A03	7512942	7514806	A03p16870.2_BraZ1	1466.25	-	1061	1832	1864	0.9828326
A03	7516040	7517078	A03p16880.2_BraZ1	96.3	-	376	989	1038	0.9527938
A03	7518951	7519995	A03p16890.2_BraZ1	104.4	-	198	831	1044	0.7959770
A03	7525670	7528005	A03p16900.2_BraZ1	1055.75	-	1797	2335	2335	1.0000000
A03	7531327	7532611	A03p16910.2_BraZ1	128.4	-	463	1149	1284	0.8948598
A03	7536653	7545738	A03p16920.2_BraZ1	441	-	4271	6245	9085	0.6873968
A03	7537752	7544278	A03p16930.2_BraZ1	1650.6	+	2502	4570	6526	0.7002758
A03	7550848	7551836	A03p16940.2_BraZ1	180	-	29	240	988	0.2429150
A03	7551674	7551882	A03p16950.2_BraZ1	165	+	14	117	208	0.5625000
A03	7555732	7556662	A03p16960.2_BraZ1	93	+	95	858	930	0.9225807
A03	7559042	7563298	A03p16970.2_BraZ1	4788	+	7015	4256	4256	1.0000000
A03	7563566	7564644	A03p16980.2_BraZ1	209.667	+	1314	1078	1078	1.0000000
A03	7568137	7574016	A03p16990.2_BraZ1	25.8	-	2689	3249	5879	0.5526450
A03	7571430	7572344	A03p17000.2_BraZ1	213	-	0	0	914	0.0000000
A03	7576760	7577707	A03p17010.2_BraZ1	472.432	+	169	435	947	0.4593453
A03	7581287	7582737	A03p17020.2_BraZ1	1083	-	430	1219	1450	0.8406897
A03	7582790	7584134	A03p17030.2_BraZ1	306.8	+	275	894	1344	0.6651786
A03	7584607	7585603	A03p17040.2_BraZ1	99.6	-	162	988	996	0.9919679
A03	7587462	7591035	A03p17050.2_BraZ1	2175.6	-	685	3041	3573	0.8511055
A03	7594695	7596992	A03p17060.2_BraZ1	453.6	-	449	1104	2297	0.4806269
A03	7597519	7599385	A03p17070.2_BraZ1	1462.8	-	591	1834	1866	0.9828510
A03	7602177	7606729	A03p17080.2_BraZ1	866.52	-	3174	4462	4552	0.9802285
A03	7608833	7611491	A03p17090.2_BraZ1	1792	-	603	2180	2658	0.8201655
A03	7615327	7616778	A03p17100.2_BraZ1	824.954	+	726	1407	1451	0.9696761
A03	7617175	7617484	A03p17110.2_BraZ1	30.9	-	193	269	309	0.8705502
A03	7619668	7619851	A03p17120.2_BraZ1	18.3	+	241	183	183	1.0000000
A03	7622436	7623636	A03p17130.2_BraZ1	110.4	+	265	1164	1200	0.9700000
A03	7623649	7624018	A03p17140.2_BraZ1	36.9	+	444	369	369	1.0000000
A03	7630132	7630300	A03p17150.2_BraZ1	16.8	-	30	168	168	1.0000000
A03	7631803	7632638	A03p17160.2_BraZ1	762	+	272	835	835	1.0000000
A03	7633117	7634410	A03p17170.2_BraZ1	302	-	714	1285	1293	0.9938129
A03	7635152	7644054	A03p17180.2_BraZ1	1573.14	-	3684	7884	8902	0.8856437
A03	7645685	7647264	A03p17190.2_BraZ1	1115.61	+	671	1488	1579	0.9423686
A03	7651319	7651466	A03p17200.2_BraZ1	14.7	+	172	147	147	1.0000000
A03	7653454	7655790	A03p17210.2_BraZ1	1608.92	-	26	493	2336	0.2110445
A03	7671244	7673307	A03p17220.2_BraZ1	837.614	+	1841	2056	2063	0.9966069
A03	7676354	7677223	A03p17230.2_BraZ1	674.27	+	95	851	869	0.9792866
A03	7678798	7679937	A03p17240.2_BraZ1	315.243	+	491	986	1139	0.8656716
A03	7680647	7681763	A03p17250.2_BraZ1	218.077	-	918	1116	1116	1.0000000
A03	7681723	7682719	A03p17260.2_BraZ1	133.702	-	919	996	996	1.0000000
A03	7685824	7687872	A03p17270.2_BraZ1	741.818	+	510	1525	2048	0.7446289
A03	7690806	7693024	A03p17280.2_BraZ1	724.231	+	2195	2216	2218	0.9990983
A03	7694242	7696994	A03p17290.2_BraZ1	1078.57	+	2701	2752	2752	1.0000000
A03	7698223	7700937	A03p17300.2_BraZ1	62109	-	583	2361	2714	0.8699337
A03	7708535	7713635	A03p17310.2_BraZ1	1924.15	+	1201	2646	5100	0.5188235
A03	7714539	7714863	A03p17320.2_BraZ1	32.4	+	170	324	324	1.0000000
A03	7716252	7716771	A03p17330.2_BraZ1	354	-	235	397	519	0.7649326
A03	7717933	7718593	A03p17340.2_BraZ1	66	+	122	619	660	0.9378788
A03	7719087	7723452	A03p17350.2_BraZ1	1516.89	-	2288	4168	4365	0.9548683
A03	7738775	7739018	A03p17360.2_BraZ1	24.3	+	5	72	243	0.2962963
A03	7741720	7743520	A03p17370.2_BraZ1	1216.7	-	808	1706	1800	0.9477777
A03	7743865	7747772	A03p17380.2_BraZ1	985.385	-	1736	3769	3907	0.9646788
A03	7750460	7751430	A03p17390.2_BraZ1	724.114	-	61	768	970	0.7917526
A03	7753672	7757610	A03p17400.2_BraZ1	3668.5	+	2187	3332	3938	0.8461148
A03	7765233	7766654	A03p17410.2_BraZ1	741	-	76	599	1421	0.4215341
A03	7772461	7772635	A03p17420.2_BraZ1	17.4	+	0	0	174	0.0000000
A03	7774081	7776635	A03p17430.2_BraZ1	691.68	-	579	2491	2554	0.9753328
A03	7777228	7777951	A03p17440.2_BraZ1	70.2	-	48	186	723	0.2572614
A03	7784613	7787490	A03p17450.2_BraZ1	1797.58	-	1478	2553	2877	0.8873827
A03	7788806	7790961	A03p17460.2_BraZ1	1453.06	+	1473	2098	2155	0.9735499
A03	7795788	7797679	A03p17470.2_BraZ1	950.444	+	1403	1875	1891	0.9915389
A03	7802734	7804189	A03p17480.2_BraZ1	840.78	-	365	1345	1455	0.9243986
A03	7812520	7812724	A03p17490.2_BraZ1	20.4	+	0	0	204	0.0000000
A03	7816098	7816516	A03p17500.2_BraZ1	336	+	314	418	418	1.0000000
A03	7816958	7817573	A03p17510.2_BraZ1	480	+	306	600	615	0.9756098
A03	7817800	7820232	A03p17520.2_BraZ1	978	-	1236	2377	2432	0.9773849
A03	7823505	7823976	A03p17530.2_BraZ1	70.8	-	352	466	471	0.9893843
A03	7824169	7825549	A03p17540.2_BraZ1	529.667	-	460	1230	1380	0.8913044
A03	7826871	7828879	A03p17550.2_BraZ1	548.64	-	689	1866	2008	0.9292828
A03	7831169	7831586	A03p17560.2_BraZ1	159	+	288	394	417	0.9448441
A03	7834417	7836733	A03p17570.2_BraZ1	1022.84	-	1563	2213	2316	0.9555268
A03	7837075	7837699	A03p17580.2_BraZ1	216	+	367	609	624	0.9759616
A03	7838693	7841103	A03p17590.2_BraZ1	1670.9	+	253	1426	2410	0.5917013
A03	7841736	7844912	A03p17600.2_BraZ1	1413.34	-	3435	3176	3176	1.0000000
A03	7846777	7848252	A03p17610.2_BraZ1	5250	-	736	1357	1475	0.9200000
A03	7848775	7851721	A03p17620.2_BraZ1	1064.72	+	1628	2925	2946	0.9928717
A03	7852663	7853026	A03p17630.2_BraZ1	36.3	-	128	363	363	1.0000000
A03	7854927	7856226	A03p17640.2_BraZ1	999	-	307	1299	1299	1.0000000
A03	7857424	7858923	A03p17650.2_BraZ1	36525	+	604	1499	1499	1.0000000
A03	7859355	7860032	A03p17660.2_BraZ1	567	+	175	677	677	1.0000000
A03	7861689	7862350	A03p17670.2_BraZ1	180	+	0	0	661	0.0000000
A03	7864653	7866302	A03p17680.2_BraZ1	510	-	29	881	1649	0.5342632
A03	7868030	7869000	A03p17690.2_BraZ1	175.2	+	44	663	970	0.6835052
A03	7869960	7871544	A03p17700.2_BraZ1	1312.5	+	491	1584	1584	1.0000000
A03	7872195	7875479	A03p17710.2_BraZ1	1391.13	-	1891	2915	3284	0.8876370
A03	7876561	7877153	A03p17720.2_BraZ1	492	+	748	589	592	0.9949324
A03	7878484	7879937	A03p17730.2_BraZ1	861	-	885	1440	1453	0.9910530
A03	7881222	7882529	A03p17740.2_BraZ1	5947.5	+	1282	1307	1307	1.0000000
A03	7884217	7885672	A03p17750.2_BraZ1	34650	+	988	1455	1455	1.0000000
A03	7887036	7893974	A03p17760.2_BraZ1	2716.14	+	944	5481	6938	0.7899971
A03	7894723	7895888	A03p17770.2_BraZ1	744	-	438	1115	1165	0.9570816
A03	7898394	7899819	A03p17780.2_BraZ1	142.5	-	293	1188	1425	0.8336842
A03	7905887	7908491	A03p17790.2_BraZ1	378.583	-	2010	2604	2604	1.0000000
A03	7911767	7912167	A03p17800.2_BraZ1	168	-	189	400	400	1.0000000
A03	7912273	7912611	A03p17810.2_BraZ1	150	-	99	338	338	1.0000000
A03	7919194	7921225	A03p17820.2_BraZ1	15048	+	404	1496	2031	0.7365829
A03	7923208	7924901	A03p17830.2_BraZ1	1572	+	70	1267	1693	0.7483757
A03	7925423	7929475	A03p17840.2_BraZ1	1197.6	-	1429	3588	4052	0.8854886
A03	7931260	7934956	A03p17850.2_BraZ1	1229.45	+	2137	3696	3696	1.0000000
A03	7935684	7958648	A03p17860.2_BraZ1	4607.53	-	13462	21728	22964	0.9461766
A03	7941138	7943073	A03p17870.2_BraZ1	193.5	+	115	1429	1935	0.7385013
A03	7960408	7968910	A03p17880.2_BraZ1	3870.77	+	1281	4698	8502	0.5525759
A03	7970693	7976501	A03p17890.2_BraZ1	1190.89	-	1963	5547	5808	0.9550620
A03	7977626	7982892	A03p17900.2_BraZ1	2378.18	-	3557	5051	5266	0.9591721
A03	7983145	7983379	A03p17910.2_BraZ1	23.4	+	293	234	234	1.0000000
A03	7984931	7986110	A03p17920.2_BraZ1	117.9	+	658	1127	1179	0.9558948
A03	7986892	7987502	A03p17930.2_BraZ1	514.5	-	461	610	610	1.0000000
A03	7989304	7989625	A03p17940.2_BraZ1	207	-	0	0	321	0.0000000
A03	7991059	7992198	A03p17950.2_BraZ1	817	-	728	1139	1139	1.0000000
A03	7993226	7996015	A03p17960.2_BraZ1	13932	-	760	2510	2789	0.8999642
A03	8000167	8003925	A03p17970.2_BraZ1	498.6	+	1964	3601	3758	0.9582224
A03	8005538	8006272	A03p17980.2_BraZ1	462.717	+	3	94	734	0.1280654
A03	8008611	8010485	A03p17990.2_BraZ1	1455	+	337	1583	1874	0.8447172
A03	8009517	8010951	A03p18000.2_BraZ1	354	+	462	1249	1434	0.8709902
A03	8011586	8012514	A03p18010.2_BraZ1	746.786	-	87	568	928	0.6120690
A03	8013244	8015679	A03p18020.2_BraZ1	1373.86	-	372	1960	2435	0.8049281
A03	8023768	8026133	A03p18030.2_BraZ1	801.897	+	2888	2343	2365	0.9906977
A03	8026965	8028237	A03p18040.2_BraZ1	206.471	+	21	548	1272	0.4308176
A03	8029883	8030384	A03p18050.2_BraZ1	50.1	-	692	501	501	1.0000000
A03	8031373	8040649	A03p18060.2_BraZ1	4131.17	-	1886	7469	9276	0.8051962
A03	8042929	8044771	A03p18070.2_BraZ1	1236.6	-	508	1497	1842	0.8127036
A03	8056390	8057259	A03p18080.2_BraZ1	264	+	101	792	869	0.9113924
A03	8060029	8061675	A03p18090.2_BraZ1	812.266	-	1069	1646	1646	1.0000000
A03	8065383	8069536	A03p18100.2_BraZ1	736.095	+	1750	3571	4153	0.8598604
A03	8075505	8077350	A03p18110.2_BraZ1	184.5	+	811	1675	1845	0.9078591
A03	8077807	8081253	A03p18120.2_BraZ1	1661.31	-	956	2569	3446	0.7455021
A03	8082529	8084182	A03p18130.2_BraZ1	651.95	+	1572	1653	1653	1.0000000
A03	8084721	8087112	A03p18140.2_BraZ1	239.1	-	296	1478	2391	0.6181514
A03	8088603	8089245	A03p18150.2_BraZ1	64.2	-	158	618	642	0.9626168
A03	8091864	8099774	A03p18160.2_BraZ1	2647.39	+	2723	6754	7910	0.8538559
A03	8101374	8102792	A03p18170.2_BraZ1	713.368	+	702	1362	1418	0.9605078
A03	8104345	8105400	A03p18180.2_BraZ1	397.5	-	874	1055	1055	1.0000000
A03	8106579	8111413	A03p18190.2_BraZ1	3000.22	+	686	3922	4834	0.8113363
A03	8112367	8113873	A03p18200.2_BraZ1	150.6	+	144	1034	1506	0.6865870
A03	8115113	8117221	A03p18210.2_BraZ1	948.214	+	634	2008	2108	0.9525617
A03	8117828	8118670	A03p18220.2_BraZ1	36.6	+	109	422	842	0.5011876
A03	8120062	8120448	A03p18230.2_BraZ1	27	+	198	386	386	1.0000000
A03	8122985	8125739	A03p18240.2_BraZ1	1498.75	+	654	2564	2754	0.9310094
A03	8127689	8127881	A03p18250.2_BraZ1	19.2	+	73	192	192	1.0000000
A03	8130092	8130278	A03p18260.2_BraZ1	18.6	+	98	186	186	1.0000000
A03	8132430	8133076	A03p18270.2_BraZ1	543	-	34	348	646	0.5386997
A03	8141074	8143639	A03p18280.2_BraZ1	256.5	+	67	1406	2565	0.5481482
A03	8144584	8145106	A03p18290.2_BraZ1	52.2	+	345	522	522	1.0000000
A03	8146495	8152297	A03p18300.2_BraZ1	4611	-	2087	5212	5802	0.8983109
A03	8153182	8155256	A03p18310.2_BraZ1	940.111	+	1100	2027	2074	0.9773385
A03	8156125	8157286	A03p18320.2_BraZ1	116.1	-	316	874	1161	0.7527993
A03	8158971	8161527	A03p18330.2_BraZ1	631.711	-	494	2535	2556	0.9917840
A03	8162172	8164380	A03p18340.2_BraZ1	842.838	+	427	1427	2208	0.6462862
A03	8169199	8172581	A03p18350.2_BraZ1	2039.62	+	1585	3064	3382	0.9059728
A03	8174079	8179279	A03p18360.2_BraZ1	2388.82	+	6268	5200	5200	1.0000000
A03	8184290	8186493	A03p18370.2_BraZ1	1286.55	+	1176	2203	2203	1.0000000
A03	8188049	8189369	A03p18380.2_BraZ1	997.5	-	0	0	1320	0.0000000
A03	8196663	8197347	A03p18390.2_BraZ1	548.625	+	12	228	684	0.3333333
A03	8200741	8202061	A03p18400.2_BraZ1	997.5	-	0	0	1320	0.0000000
A03	8217658	8218342	A03p18410.2_BraZ1	389.647	-	676	684	684	1.0000000
A03	8222870	8226574	A03p18420.2_BraZ1	1962.28	-	2687	3702	3704	0.9994600
A03	8228808	8229036	A03p18430.2_BraZ1	22.8	+	80	178	228	0.7807018
A03	8232818	8234828	A03p18440.2_BraZ1	1057.06	+	951	2004	2010	0.9970149
A03	8236929	8239429	A03p18450.2_BraZ1	1923.49	+	794	2391	2500	0.9564000
A03	8241926	8244739	A03p18460.2_BraZ1	977.5	+	1444	2776	2813	0.9868468
A03	8245701	8246853	A03p18470.2_BraZ1	24920.2	-	961	1099	1152	0.9539931
A03	8249198	8252167	A03p18480.2_BraZ1	1325.51	-	2300	2969	2969	1.0000000
A03	8253806	8254097	A03p18490.2_BraZ1	29.1	+	298	291	291	1.0000000
A03	8256928	8258512	A03p18500.2_BraZ1	1221	+	570	1387	1584	0.8756313
A03	8259344	8260433	A03p18510.2_BraZ1	108.3	+	54	248	1089	0.2277319
A03	8261758	8262854	A03p18520.2_BraZ1	80.4	+	1158	1096	1096	1.0000000
A03	8264456	8268412	A03p18530.2_BraZ1	1356.59	-	932	3196	3956	0.8078868
A03	8268943	8269430	A03p18540.2_BraZ1	585	+	105	417	487	0.8562629
A03	8270155	8279839	A03p18550.2_BraZ1	3057.58	-	3378	7578	9684	0.7825279
A03	8280498	8281956	A03p18560.2_BraZ1	665.216	+	1282	1441	1458	0.9883402
A03	8283361	8285578	A03p18570.2_BraZ1	1875	+	57	483	2217	0.2178620
A03	8286407	8287523	A03p18580.2_BraZ1	72.6	-	416	1116	1116	1.0000000
A03	8295286	8298003	A03p18590.2_BraZ1	4290	+	1587	2627	2717	0.9668753
A03	8298628	8300181	A03p18600.2_BraZ1	622.286	-	138	1046	1553	0.6735351
A03	8302483	8303044	A03p18610.2_BraZ1	273	+	555	561	561	1.0000000
A03	8305414	8306918	A03p18620.2_BraZ1	1227	+	467	1504	1504	1.0000000
A03	8308611	8312912	A03p18630.2_BraZ1	2918.82	+	1279	3672	4301	0.8537549
A03	8313529	8314877	A03p18640.2_BraZ1	1143	-	731	1348	1348	1.0000000
A03	8316299	8324043	A03p18650.2_BraZ1	3212.68	+	1665	5273	7744	0.6809143
A03	8324948	8325143	A03p18660.2_BraZ1	19.5	-	267	195	195	1.0000000
A03	8327578	8329068	A03p18670.2_BraZ1	534	+	1811	1490	1490	1.0000000
A03	8329890	8330978	A03p18680.2_BraZ1	248.283	+	368	969	1088	0.8906250
A03	8334073	8336181	A03p18690.2_BraZ1	1485	+	983	2105	2108	0.9985769
A03	8337167	8337617	A03p18700.2_BraZ1	270.214	-	264	365	450	0.8111111
A03	8341813	8343645	A03p18710.2_BraZ1	878.538	+	321	1471	1832	0.8029476
A03	8343882	8345710	A03p18720.2_BraZ1	1378.41	-	367	1639	1828	0.8966083
A03	8345891	8347703	A03p18730.2_BraZ1	51.9	+	801	1765	1812	0.9740618
A03	8350745	8351259	A03p18740.2_BraZ1	441	+	163	367	514	0.7140078
A03	8354246	8354462	A03p18750.2_BraZ1	129	+	226	216	216	1.0000000
A03	8359777	8360779	A03p18760.2_BraZ1	100.2	+	52	579	1002	0.5778443
A03	8361142	8363068	A03p18770.2_BraZ1	192.6	-	346	1490	1926	0.7736241
A03	8363751	8364966	A03p18780.2_BraZ1	121.5	+	258	1069	1215	0.8798354
A03	8369236	8369928	A03p18790.2_BraZ1	538.2	+	1021	692	692	1.0000000
A03	8372750	8373249	A03p18800.2_BraZ1	411.667	-	182	473	499	0.9478958
A03	8374478	8380947	A03p18810.2_BraZ1	2255.68	-	4044	6310	6469	0.9754212
A03	8383632	8383869	A03p18820.2_BraZ1	204	-	18	173	237	0.7299578
A03	8389382	8391054	A03p18830.2_BraZ1	1107.27	-	232	1233	1672	0.7374402
A03	8401423	8404358	A03p18840.2_BraZ1	190	+	2990	2935	2935	1.0000000
A03	8409327	8410641	A03p18850.2_BraZ1	804.075	+	251	1127	1314	0.8576865
A03	8411291	8413938	A03p18860.2_BraZ1	1795.21	-	391	1760	2647	0.6649036
A03	8416939	8421402	A03p18870.2_BraZ1	1433.55	-	2991	4140	4463	0.9276271
A03	8425452	8428207	A03p18880.2_BraZ1	1108.63	-	842	2373	2755	0.8613430
A03	8432469	8432744	A03p18890.2_BraZ1	195	+	4	30	275	0.1090909
A03	8435199	8438114	A03p18900.2_BraZ1	2236.57	+	415	2504	2915	0.8590052
A03	8440343	8441137	A03p18910.2_BraZ1	3277.71	+	410	794	794	1.0000000
A03	8445222	8450365	A03p18920.2_BraZ1	2726.56	+	2099	4957	5143	0.9638343
A03	8451687	8453639	A03p18930.2_BraZ1	16057.1	+	486	1844	1952	0.9446721
A03	8454454	8458724	A03p18940.2_BraZ1	2244	-	2696	3972	4270	0.9302108
A03	8459300	8459783	A03p18950.2_BraZ1	318	-	355	483	483	1.0000000
A03	8461262	8461710	A03p18960.2_BraZ1	43.8	+	437	448	448	1.0000000
A03	8462015	8462493	A03p18970.2_BraZ1	147	-	550	478	478	1.0000000
A03	8464760	8470827	A03p18980.2_BraZ1	3654.29	+	1598	5547	6067	0.9142904
A03	8472484	8477740	A03p18990.2_BraZ1	2396.48	+	2772	5043	5256	0.9594749
A03	8478855	8482025	A03p19000.2_BraZ1	1497.54	+	2525	3040	3170	0.9589905
A03	8482648	8483449	A03p19010.2_BraZ1	80.1	-	117	652	801	0.8139825
A03	8486562	8487126	A03p19020.2_BraZ1	243	+	493	564	564	1.0000000
A03	8489975	8491028	A03p19030.2_BraZ1	6825	-	433	1053	1053	1.0000000
A03	8496317	8504470	A03p19040.2_BraZ1	1271.6	+	4780	7802	8153	0.9569483
A03	8504798	8506656	A03p19050.2_BraZ1	632.735	-	1266	1775	1858	0.9553283
A03	8508085	8508494	A03p19060.2_BraZ1	34.2	+	197	394	409	0.9633252
A03	8510008	8512543	A03p19070.2_BraZ1	1034.29	+	943	2095	2535	0.8264300
A03	8513196	8515615	A03p19080.2_BraZ1	2010.29	-	429	2090	2419	0.8639934
A03	8517541	8528370	A03p19090.2_BraZ1	4916.85	-	2618	8516	10829	0.7864069
A03	8528380	8529430	A03p19100.2_BraZ1	117	-	451	1050	1050	1.0000000
A03	8530494	8531751	A03p19110.2_BraZ1	690	+	696	1257	1257	1.0000000
A03	8532026	8533400	A03p19120.2_BraZ1	137.4	-	850	1374	1374	1.0000000
A03	8535662	8538419	A03p19130.2_BraZ1	2648.75	+	594	2497	2757	0.9056946
A03	8538918	8540427	A03p19140.2_BraZ1	1218.75	+	49	405	1509	0.2683897
A03	8540563	8543667	A03p19150.2_BraZ1	1721.39	-	638	2798	3104	0.9014176
A03	8546882	8548090	A03p19160.2_BraZ1	592.836	+	718	1208	1208	1.0000000
A03	8551693	8553340	A03p19170.2_BraZ1	164.7	+	169	1191	1647	0.7231330
A03	8554252	8554546	A03p19180.2_BraZ1	228	+	4	21	294	0.0714286
A03	8554630	8554774	A03p19190.2_BraZ1	14.4	+	0	0	144	0.0000000
A03	8558770	8559727	A03p19200.2_BraZ1	95.7	+	577	943	957	0.9853709
A03	8560551	8562847	A03p19210.2_BraZ1	835.227	+	237	2003	2296	0.8723868
A03	8563927	8564260	A03p19220.2_BraZ1	279	+	0	0	333	0.0000000
A03	8565869	8566715	A03p19230.2_BraZ1	84.6	+	11	326	846	0.3853428
A03	8567721	8567973	A03p19240.2_BraZ1	25.2	-	31	231	252	0.9166667
A03	8568544	8570006	A03p19250.2_BraZ1	47.1	-	54	606	1462	0.4145007
A03	8575274	8578001	A03p19260.2_BraZ1	272.4	-	957	2600	2727	0.9534287
A03	8582393	8587305	A03p19270.2_BraZ1	3727.23	+	297	2230	4912	0.4539902
A03	8587749	8589968	A03p19280.2_BraZ1	282	-	308	596	2219	0.2685895
A03	8592173	8592632	A03p19290.2_BraZ1	33	+	69	459	459	1.0000000
A03	8593999	8595909	A03p19300.2_BraZ1	1329	-	363	1770	1910	0.9267015
A03	8597567	8598206	A03p19310.2_BraZ1	267	+	82	457	639	0.7151800
A03	8600996	8601902	A03p19320.2_BraZ1	463.15	-	397	785	906	0.8664459
A03	8602537	8604738	A03p19330.2_BraZ1	1315.6	-	674	2084	2201	0.9468424
A03	8608121	8609873	A03p19340.2_BraZ1	756.478	+	392	1674	1752	0.9554794
A03	8612968	8614282	A03p19350.2_BraZ1	131.4	+	656	1299	1314	0.9885845
A03	8614927	8615480	A03p19360.2_BraZ1	282	-	463	553	553	1.0000000
A03	8616251	8618277	A03p19370.2_BraZ1	1074.45	+	970	1853	2026	0.9146101
A03	8624614	8625436	A03p19380.2_BraZ1	82.2	+	133	795	822	0.9671533
A03	8628675	8629960	A03p19390.2_BraZ1	914.185	-	849	1285	1285	1.0000000
A03	8633327	8634530	A03p19400.2_BraZ1	789	-	42	704	1203	0.5852036
A03	8639868	8642065	A03p19410.2_BraZ1	1070.76	+	1189	2035	2197	0.9262631
A03	8643428	8645956	A03p19420.2_BraZ1	853.332	-	1921	2528	2528	1.0000000
A03	8647178	8648279	A03p19430.2_BraZ1	834	+	867	1101	1101	1.0000000
A03	8648616	8650012	A03p19440.2_BraZ1	1128	-	1161	1384	1396	0.9914040
A03	8660484	8660761	A03p19450.2_BraZ1	26.1	-	3	77	277	0.2779783
A03	8663972	8665304	A03p19460.2_BraZ1	133.2	+	699	1332	1332	1.0000000
A03	8665941	8669096	A03p19470.2_BraZ1	1588.01	-	1274	2724	3155	0.8633915
A03	8671629	8685129	A03p19480.2_BraZ1	5637.41	+	1214	8652	13500	0.6408889
A03	8685912	8687772	A03p19490.2_BraZ1	186	-	1959	1860	1860	1.0000000
A03	8689975	8692489	A03p19500.2_BraZ1	1346.05	+	645	2361	2514	0.9391408
A03	8692930	8693478	A03p19510.2_BraZ1	930	-	491	519	548	0.9470803
A03	8694234	8696446	A03p19520.2_BraZ1	10822.5	-	414	1395	2212	0.6306510
A03	8697508	8699079	A03p19530.2_BraZ1	966.24	-	1215	1447	1571	0.9210694
A03	8700015	8701332	A03p19540.2_BraZ1	906	+	673	1263	1317	0.9589977
A03	8702702	8705815	A03p19550.2_BraZ1	1803.48	+	916	3020	3113	0.9701253
A03	8706372	8707277	A03p19560.2_BraZ1	326.806	+	0	0	905	0.0000000
A03	8707445	8708033	A03p19570.2_BraZ1	459	-	0	0	588	0.0000000
A03	8712338	8712950	A03p19580.2_BraZ1	61.2	+	113	401	612	0.6552287
A03	8719463	8720568	A03p19590.2_BraZ1	603	+	341	1006	1105	0.9104072
A03	8722966	8723368	A03p19600.2_BraZ1	237	+	34	301	402	0.7487562
A03	8724394	8724526	A03p19610.2_BraZ1	13.2	+	135	132	132	1.0000000
A03	8727614	8728745	A03p19620.2_BraZ1	735	+	329	1120	1131	0.9902741
A03	8730381	8730856	A03p19630.2_BraZ1	2440	+	830	475	475	1.0000000
A03	8731847	8734791	A03p19640.2_BraZ1	2244.13	+	1122	2838	2944	0.9639946
A03	8735166	8738165	A03p19650.2_BraZ1	1737.22	+	1428	2855	2999	0.9519840
A03	8740740	8742460	A03p19660.2_BraZ1	1188.99	+	1139	1631	1720	0.9482558
A03	8744172	8744583	A03p19670.2_BraZ1	282	+	55	395	411	0.9610705
A03	8748721	8750688	A03p19680.2_BraZ1	1338	+	409	1571	1967	0.7986782
A03	8752815	8754853	A03p19690.2_BraZ1	1209.83	-	1532	2038	2038	1.0000000
A03	8757769	8758909	A03p19700.2_BraZ1	775.2	+	900	1058	1140	0.9280702
A03	8759554	8760220	A03p19710.2_BraZ1	570	-	233	666	666	1.0000000
A03	8762388	8762940	A03p19720.2_BraZ1	52.8	-	24	187	552	0.3387681
A03	8767554	8768052	A03p19730.2_BraZ1	49.8	-	82	333	498	0.6686747
A03	8770162	8774620	A03p19740.2_BraZ1	2771.65	+	792	3651	4458	0.8189771
A03	8774931	8775964	A03p19750.2_BraZ1	444	-	602	864	1033	0.8363988
A03	8780375	8781620	A03p19760.2_BraZ1	123	-	221	1202	1245	0.9654619
A03	8787265	8790510	A03p19770.2_BraZ1	1674.56	-	477	2718	3245	0.8375963
A03	8809111	8810238	A03p19780.2_BraZ1	381	+	1144	1127	1127	1.0000000
A03	8811541	8814511	A03p19790.2_BraZ1	1273.7	+	2249	2859	2970	0.9626263
A03	8814933	8816586	A03p19800.2_BraZ1	680.96	-	104	734	1653	0.4440411
A03	8822825	8824087	A03p19810.2_BraZ1	621	-	475	1235	1262	0.9786054
A03	8827482	8828187	A03p19820.2_BraZ1	70.5	+	743	705	705	1.0000000
A03	8832716	8832887	A03p19830.2_BraZ1	17.1	+	79	171	171	1.0000000
A03	8836075	8838469	A03p19840.2_BraZ1	306.613	+	1214	2365	2394	0.9878864
A03	8839320	8842435	A03p19850.2_BraZ1	1668.13	-	477	2012	3115	0.6459069
A03	8844197	8845468	A03p19860.2_BraZ1	219.45	-	882	1271	1271	1.0000000
A03	8850846	8851230	A03p19870.2_BraZ1	38.4	-	263	384	384	1.0000000
A03	8854016	8855726	A03p19880.2_BraZ1	883.547	-	562	1521	1710	0.8894737
A03	8857265	8858970	A03p19890.2_BraZ1	891.536	+	1203	1705	1705	1.0000000
A03	8859126	8860176	A03p19900.2_BraZ1	105	+	110	318	1050	0.3028571
A03	8861238	8861451	A03p19910.2_BraZ1	21.3	-	4	77	213	0.3615023
A03	8866921	8868853	A03p19920.2_BraZ1	972.944	-	1910	1932	1932	1.0000000
A03	8872499	8872982	A03p19930.2_BraZ1	48.3	+	254	483	483	1.0000000
A03	8875587	8878368	A03p19940.2_BraZ1	1010.09	+	132	1482	2781	0.5329018
A03	8879934	8881809	A03p19950.2_BraZ1	187.2	+	290	1862	1875	0.9930667
A03	8882404	8882566	A03p19960.2_BraZ1	16.2	+	175	162	162	1.0000000
A03	8884960	8892251	A03p19970.2_BraZ1	3579.77	+	1326	5370	7291	0.7365245
A03	8892616	8894789	A03p19980.2_BraZ1	1107	-	445	1805	2173	0.8306489
A03	8902804	8903748	A03p19990.2_BraZ1	922.667	+	59	645	944	0.6832627
A03	8911138	8914651	A03p20000.2_BraZ1	2188.8	+	969	2446	3513	0.6962710
A03	8927703	8930207	A03p20010.2_BraZ1	1200	+	456	2154	2504	0.8602237
A03	8930768	8930936	A03p20020.2_BraZ1	16.8	+	7	107	168	0.6369048
A03	8932713	8933277	A03p20030.2_BraZ1	56.4	-	125	490	564	0.8687943
A03	8940387	8941353	A03p20040.2_BraZ1	96.6	-	246	869	966	0.8995859
A03	8944927	8955541	A03p20050.2_BraZ1	1452.29	-	4787	9967	10614	0.9390427
A03	8960415	8965983	A03p20060.2_BraZ1	2025	+	221	1545	5568	0.2774785
A03	8966652	8967240	A03p20070.2_BraZ1	58.8	-	98	507	588	0.8622449
A03	8969925	8971108	A03p20080.2_BraZ1	862.875	+	360	1168	1183	0.9873204
A03	8979272	8980376	A03p20090.2_BraZ1	110.4	+	1143	1104	1104	1.0000000
A03	8984115	8985270	A03p20100.2_BraZ1	115.5	-	279	990	1155	0.8571429
A03	8994822	9003605	A03p20110.2_BraZ1	234	-	3765	7437	8783	0.8467494
A03	9000567	9003090	A03p20120.2_BraZ1	4856.06	-	240	1780	2523	0.7055093
A03	9003899	9005554	A03p20130.2_BraZ1	851.351	-	2921	1655	1655	1.0000000
A03	9013044	9014235	A03p20140.2_BraZ1	117.3	-	1689	1191	1191	1.0000000
A03	9022594	9023996	A03p20150.2_BraZ1	870	+	196	1083	1402	0.7724679
A03	9028441	9029179	A03p20160.2_BraZ1	324	-	0	0	738	0.0000000
A03	9029302	9029545	A03p20170.2_BraZ1	24.3	-	0	0	243	0.0000000
A03	9043564	9048871	A03p20180.2_BraZ1	3503.51	+	1159	4541	5307	0.8556623
A03	9050958	9051775	A03p20190.2_BraZ1	361.354	-	335	737	817	0.9020808
A03	9054252	9055586	A03p20200.2_BraZ1	781.364	+	1024	1301	1334	0.9752623
A03	9068356	9068518	A03p20210.2_BraZ1	16.2	-	4	21	162	0.1296296
A03	9072533	9074201	A03p20220.2_BraZ1	617.76	+	1399	1668	1668	1.0000000
A03	9075333	9077207	A03p20230.2_BraZ1	985.32	+	2395	1874	1874	1.0000000
A03	9081645	9082020	A03p20240.2_BraZ1	37.5	+	95	289	375	0.7706667
A03	9086311	9091039	A03p20250.2_BraZ1	2546.78	+	1899	4580	4728	0.9686971
A03	9092322	9094242	A03p20260.2_BraZ1	1662	-	736	1853	1920	0.9651042
A03	9098246	9098785	A03p20270.2_BraZ1	43.5	+	612	539	539	1.0000000
A03	9100241	9101598	A03p20280.2_BraZ1	5989.5	+	399	1287	1357	0.9484156
A03	9103393	9105092	A03p20290.2_BraZ1	858.531	-	71	645	1699	0.3796351
A03	9110437	9112665	A03p20300.2_BraZ1	1655.16	-	425	2034	2228	0.9129264
A03	9114842	9115992	A03p20310.2_BraZ1	15762	-	154	923	1150	0.8026087
A03	9119528	9120685	A03p20320.2_BraZ1	32461	+	294	859	1157	0.7424374
A03	9121407	9121908	A03p20330.2_BraZ1	50.1	-	57	420	501	0.8383234
A03	9127116	9127894	A03p20340.2_BraZ1	451.636	+	504	778	778	1.0000000
A03	9128811	9131326	A03p20350.2_BraZ1	621	-	633	2267	2515	0.9013916
A03	9132850	9133068	A03p20360.2_BraZ1	20.4	+	61	218	218	1.0000000
A03	9141041	9142344	A03p20370.2_BraZ1	831.077	-	1055	1303	1303	1.0000000
A03	9143290	9143461	A03p20380.2_BraZ1	17.1	-	210	171	171	1.0000000
A03	9143673	9145917	A03p20390.2_BraZ1	224.4	-	462	1491	2244	0.6644385
A03	9146429	9148941	A03p20400.2_BraZ1	31322.5	+	111	1701	2512	0.6771497
A03	9149428	9150625	A03p20410.2_BraZ1	820.364	+	669	1090	1197	0.9106098
A03	9152714	9154260	A03p20420.2_BraZ1	884.87	+	697	1513	1546	0.9786546
A03	9154774	9157922	A03p20430.2_BraZ1	738.631	-	1099	3148	3148	1.0000000
A03	9159473	9161534	A03p20440.2_BraZ1	556.5	-	1121	2007	2061	0.9737991
A03	9167075	9167978	A03p20450.2_BraZ1	90.3	+	377	764	903	0.8460687
A03	9179644	9180637	A03p20460.2_BraZ1	99.3	-	651	993	993	1.0000000
A03	9226187	9226853	A03p20470.2_BraZ1	66.6	-	331	666	666	1.0000000
A03	9229852	9230398	A03p20480.2_BraZ1	54.6	+	48	481	546	0.8809524
A03	9234769	9237357	A03p20490.2_BraZ1	1394.49	+	295	2009	2588	0.7762751
A03	9238154	9240617	A03p20500.2_BraZ1	995.891	-	390	1806	2463	0.7332521
A03	9247031	9247833	A03p20510.2_BraZ1	567	+	301	802	802	1.0000000
A03	9249780	9250110	A03p20520.2_BraZ1	237	+	276	330	330	1.0000000
A03	9251445	9251820	A03p20530.2_BraZ1	37.5	+	165	375	375	1.0000000
A03	9252668	9254711	A03p20540.2_BraZ1	4814.14	-	788	2043	2043	1.0000000
A03	9255390	9256119	A03p20550.2_BraZ1	399	-	178	729	729	1.0000000
A03	9258114	9258825	A03p20560.2_BraZ1	71.1	+	162	708	711	0.9957806
A03	9264067	9265247	A03p20570.2_BraZ1	873	+	188	985	1180	0.8347458
A03	9267792	9271019	A03p20580.2_BraZ1	7128	-	2485	3227	3227	1.0000000
A03	9274210	9276006	A03p20590.2_BraZ1	126441	+	733	1796	1796	1.0000000
A03	9276456	9277497	A03p20600.2_BraZ1	104.1	-	253	988	1041	0.9490874
A03	9287880	9289902	A03p20610.2_BraZ1	202.2	+	181	1252	2022	0.6191889
A03	9293147	9293345	A03p20620.2_BraZ1	19.8	+	32	198	198	1.0000000
A03	9295902	9299168	A03p20630.2_BraZ1	1391.41	+	2772	3266	3266	1.0000000
A03	9299525	9302759	A03p20640.2_BraZ1	1312	-	4084	3234	3234	1.0000000
A03	9306205	9308242	A03p20650.2_BraZ1	203.7	-	670	1950	2037	0.9572901
A03	9310574	9310781	A03p20660.2_BraZ1	20.7	-	172	207	207	1.0000000
A03	9319205	9319439	A03p20670.2_BraZ1	23.4	+	46	198	234	0.8461539
A03	9321233	9323005	A03p20680.2_BraZ1	884.8	+	993	1734	1772	0.9785553
A03	9325541	9328105	A03p20690.2_BraZ1	710.486	+	1846	2382	2564	0.9290172
A03	9329172	9329874	A03p20700.2_BraZ1	70.2	-	49	145	702	0.2065527
A03	9334248	9334377	A03p20710.2_BraZ1	12.9	+	186	129	129	1.0000000
A03	9334500	9338838	A03p20720.2_BraZ1	1332	-	3186	4249	4338	0.9794836
A03	9344790	9348388	A03p20730.2_BraZ1	1827.58	+	691	2754	3598	0.7654253
A03	9349335	9351125	A03p20740.2_BraZ1	1281	+	651	1761	1790	0.9837989
A03	9352786	9353533	A03p20750.2_BraZ1	74.7	+	134	511	747	0.6840696
A03	9353896	9355963	A03p20760.2_BraZ1	904.694	-	220	1892	2067	0.9153363
A03	9357089	9359340	A03p20770.2_BraZ1	1756.57	-	195	1396	2251	0.6201688
A03	9362540	9363284	A03p20780.2_BraZ1	74.4	-	131	636	744	0.8548387
A03	9365400	9367221	A03p20790.2_BraZ1	865.2	+	1881	1790	1821	0.9829764
A03	9367594	9368915	A03p20800.2_BraZ1	654	-	537	1279	1321	0.9682059
A03	9373439	9374048	A03p20810.2_BraZ1	60.6	+	183	608	609	0.9983580
A03	9376163	9379497	A03p20820.2_BraZ1	1778.5	-	306	2640	3334	0.7918416
A03	9383613	9385965	A03p20830.2_BraZ1	888.643	+	1073	2352	2352	1.0000000
A03	9389888	9393838	A03p20840.2_BraZ1	2532.82	-	1257	3299	3950	0.8351899
A03	9397788	9399192	A03p20850.2_BraZ1	648.929	-	706	1255	1404	0.8938746
A03	9399990	9402924	A03p20860.2_BraZ1	2164.65	+	902	2800	2934	0.9543285
A03	9411506	9413019	A03p20870.2_BraZ1	9408	+	20	683	1513	0.4514210
A03	9425097	9427010	A03p20880.2_BraZ1	12963	+	156	1300	1913	0.6795609
A03	9431365	9439810	A03p20890.2_BraZ1	1205.22	+	4643	8141	8445	0.9640024
A03	9444014	9445395	A03p20900.2_BraZ1	667.625	-	32	954	1381	0.6908038
A03	9448893	9452517	A03p20910.2_BraZ1	474.197	+	3222	3624	3624	1.0000000
A03	9450083	9454824	A03p20920.2_BraZ1	894.125	+	4039	4686	4741	0.9883991
A03	9462103	9464763	A03p20930.2_BraZ1	1087.29	-	1188	2317	2660	0.8710526
A03	9475045	9476183	A03p20940.2_BraZ1	885	+	290	1007	1138	0.8848858
A03	9480260	9481844	A03p20950.2_BraZ1	882	-	415	1066	1584	0.6729798
A03	9483284	9486573	A03p20960.2_BraZ1	2561.09	+	516	2687	3289	0.8169656
A03	9491293	9491917	A03p20970.2_BraZ1	62.4	+	6	56	624	0.0897436
A03	9498653	9501067	A03p20980.2_BraZ1	1185.75	+	254	1301	2414	0.5389395
A03	9514001	9514918	A03p20990.2_BraZ1	421.571	+	213	792	917	0.8636859
A03	9514905	9516579	A03p21000.2_BraZ1	707	+	1113	1674	1674	1.0000000
A03	9518103	9518772	A03p21010.2_BraZ1	66.9	-	553	669	669	1.0000000
A03	9524802	9527056	A03p21020.2_BraZ1	4217.4	-	4	203	2254	0.0900621
A03	9527968	9529628	A03p21030.2_BraZ1	1443	-	1261	1620	1660	0.9759036
A03	9532961	9534893	A03p21040.2_BraZ1	5733	+	284	1138	1932	0.5890269
A03	9539157	9541165	A03p21050.2_BraZ1	942.3	+	524	1646	2008	0.8197211
A03	9544355	9546804	A03p21060.2_BraZ1	1354.34	+	298	1811	2449	0.7394855
A03	9547079	9548064	A03p21070.2_BraZ1	468	+	426	985	985	1.0000000
A03	9548085	9548385	A03p21080.2_BraZ1	20.7	+	308	300	300	1.0000000
A03	9549718	9555035	A03p21090.2_BraZ1	1127.75	-	3357	5229	5317	0.9834493
A03	9557029	9558300	A03p21100.2_BraZ1	574.376	-	3	241	1271	0.1896145
A03	9559996	9560634	A03p21110.2_BraZ1	2236.5	+	136	616	638	0.9655172
A03	9562005	9563960	A03p21120.2_BraZ1	1315.99	+	495	1476	1955	0.7549872
A03	9564459	9568506	A03p21130.2_BraZ1	1404	-	2108	3881	4047	0.9589820
A03	9573033	9574742	A03p21140.2_BraZ1	1125	-	313	1134	1709	0.6635459
A03	9576148	9576556	A03p21150.2_BraZ1	40.8	+	324	408	408	1.0000000
A03	9577763	9579104	A03p21160.2_BraZ1	1140	+	333	1239	1341	0.9239374
A03	9579600	9581214	A03p21170.2_BraZ1	909.071	-	1436	1602	1614	0.9925650
A03	9585262	9588770	A03p21180.2_BraZ1	1035.56	+	3462	3508	3508	1.0000000
A03	9589359	9591730	A03p21190.2_BraZ1	507.818	-	760	2129	2371	0.8979334
A03	9596798	9598169	A03p21200.2_BraZ1	771	+	1232	1264	1371	0.9219548
A03	9598827	9600655	A03p21210.2_BraZ1	862.727	-	762	1722	1828	0.9420131
A03	9603984	9605845	A03p21220.2_BraZ1	223.062	+	959	1841	1861	0.9892531
A03	9606950	9609430	A03p21230.2_BraZ1	975.703	+	973	2361	2480	0.9520161
A03	9610407	9611682	A03p21240.2_BraZ1	916.522	+	436	1268	1275	0.9945098
A03	9612159	9612353	A03p21250.2_BraZ1	18.6	-	46	172	194	0.8865979
A03	9613426	9614135	A03p21260.2_BraZ1	591	-	46	444	709	0.6262341
A03	9619797	9620493	A03p21270.2_BraZ1	588	-	17	86	696	0.1235632
A03	9624934	9628488	A03p21280.2_BraZ1	1524.9	-	2093	3262	3554	0.9178391
A03	9628547	9628670	A03p21290.2_BraZ1	12.3	+	168	123	123	1.0000000
A03	9628756	9629670	A03p21300.2_BraZ1	326	+	408	914	914	1.0000000
A03	9632295	9635077	A03p21310.2_BraZ1	1173.48	+	326	2327	2782	0.8364486
A03	9635519	9637385	A03p21320.2_BraZ1	887.047	-	1483	1866	1866	1.0000000
A03	9637723	9638489	A03p21330.2_BraZ1	480.917	-	997	766	766	1.0000000
A03	9639586	9640238	A03p21340.2_BraZ1	177	+	178	544	652	0.8343558
A03	9640654	9642421	A03p21350.2_BraZ1	526.449	+	2430	1767	1767	1.0000000
A03	9642886	9644445	A03p21360.2_BraZ1	569.933	-	1171	1559	1559	1.0000000
A03	9647459	9648832	A03p21370.2_BraZ1	685.714	-	390	1317	1373	0.9592134
A03	9649456	9651325	A03p21380.2_BraZ1	930.764	-	966	1869	1869	1.0000000
A03	9654052	9655534	A03p21390.2_BraZ1	482.909	+	752	1400	1482	0.9446694
A03	9656042	9659271	A03p21400.2_BraZ1	1177.5	+	2406	3122	3229	0.9668628
A03	9659654	9660248	A03p21410.2_BraZ1	59.4	-	376	594	594	1.0000000
A03	9660748	9662658	A03p21420.2_BraZ1	629.143	-	275	1162	1910	0.6083770
A03	9662960	9665579	A03p21430.2_BraZ1	951.746	+	1719	2519	2619	0.9618175
A03	9666353	9666677	A03p21440.2_BraZ1	32.4	-	47	324	324	1.0000000
A03	9667973	9669467	A03p21450.2_BraZ1	149.4	+	1139	1494	1494	1.0000000
A03	9670070	9670764	A03p21460.2_BraZ1	405	-	691	694	694	1.0000000
A03	9672243	9673346	A03p21470.2_BraZ1	10062	+	182	905	1103	0.8204896
A03	9674391	9675593	A03p21480.2_BraZ1	730.227	+	36	575	1202	0.4783694
A03	9677121	9681128	A03p21490.2_BraZ1	1523.34	+	3831	4007	4007	1.0000000
A03	9682117	9682783	A03p21500.2_BraZ1	153	-	841	666	666	1.0000000
A03	9685106	9687114	A03p21510.2_BraZ1	1054.7	+	1253	1961	2008	0.9765936
A03	9688536	9692518	A03p21520.2_BraZ1	1028.91	+	3008	3943	3982	0.9902059
A03	9693196	9693447	A03p21530.2_BraZ1	165	-	69	250	251	0.9960160
A03	9694172	9701070	A03p21540.2_BraZ1	1060.35	-	1560	5454	6898	0.7906640
A03	9705065	9706673	A03p21550.2_BraZ1	160.8	+	231	842	1608	0.5236318
A03	9708342	9711683	A03p21560.2_BraZ1	1929.61	+	730	2071	3341	0.6198743
A03	9720190	9722807	A03p21570.2_BraZ1	989.368	+	172	1613	2617	0.6163546
A03	9727759	9730149	A03p21580.2_BraZ1	1582.24	+	183	1802	2390	0.7539749
A03	9730425	9733252	A03p21590.2_BraZ1	600	-	2716	2827	2827	1.0000000
A03	9739756	9742701	A03p21600.2_BraZ1	2066.24	+	97	828	2945	0.2811545
A03	9745046	9745532	A03p21610.2_BraZ1	48.6	-	73	480	486	0.9876543
A03	9747842	9750614	A03p21620.2_BraZ1	86.7	+	1232	2354	2772	0.8492063
A03	9751661	9752366	A03p21630.2_BraZ1	70.5	+	172	705	705	1.0000000
A03	9753471	9755835	A03p21640.2_BraZ1	1010.8	-	376	1948	2364	0.8240271
A03	9756959	9771733	A03p21650.2_BraZ1	8687.08	-	2945	10549	14774	0.7140247
A03	9774184	9775755	A03p21660.2_BraZ1	1014	+	839	1571	1571	1.0000000
A03	9776836	9778226	A03p21670.2_BraZ1	728.689	-	142	1006	1390	0.7237410
A03	9779754	9781944	A03p21680.2_BraZ1	680.625	-	2040	2190	2190	1.0000000
A03	9782253	9782958	A03p21690.2_BraZ1	70.5	-	749	705	705	1.0000000
A03	9792803	9795164	A03p21700.2_BraZ1	236.1	-	316	1484	2361	0.6285473
A03	9799645	9804756	A03p21710.2_BraZ1	2284.65	+	937	3649	5111	0.7139503
A03	9805207	9810139	A03p21720.2_BraZ1	1140.93	-	2200	4697	4932	0.9523520
A03	9818549	9822349	A03p21730.2_BraZ1	1041.92	-	707	3104	3800	0.8168421
A03	9834388	9834811	A03p21740.2_BraZ1	297	-	494	423	423	1.0000000
A03	9835248	9839115	A03p21750.2_BraZ1	1274.16	-	506	2880	3867	0.7447634
A03	9848487	9850671	A03p21760.2_BraZ1	1803	-	634	1739	2184	0.7962454
A03	9861376	9863548	A03p21770.2_BraZ1	1452	-	326	1843	2172	0.8485267
A03	9870130	9870390	A03p21780.2_BraZ1	13.8	+	236	260	260	1.0000000
A03	9870787	9877804	A03p21790.2_BraZ1	2653.35	-	2943	6256	7017	0.8915491
A03	9879704	9879908	A03p21800.2_BraZ1	20.4	-	48	204	204	1.0000000
A03	9883985	9884207	A03p21810.2_BraZ1	22.2	-	99	214	222	0.9639640
A03	9885049	9886340	A03p21820.2_BraZ1	1240.52	+	1299	1291	1291	1.0000000
A03	9886731	9889512	A03p21830.2_BraZ1	2359.8	-	746	2714	2781	0.9759079
A03	9890683	9892670	A03p21840.2_BraZ1	1095.37	-	226	1157	1987	0.5822849
A03	9892732	9894101	A03p21850.2_BraZ1	14.3333	-	51	644	1369	0.4704164
A03	9893347	9894101	A03p21860.2_BraZ1	136	-	45	622	754	0.8249337
A03	9894625	9895171	A03p21870.2_BraZ1	221.667	+	138	504	546	0.9230769
A03	9896704	9899158	A03p21880.2_BraZ1	245.4	-	392	2233	2454	0.9099429
A03	9901106	9901211	A03p21890.2_BraZ1	10.5	-	177	105	105	1.0000000
A03	9901558	9903942	A03p21900.2_BraZ1	2304	-	695	1619	2384	0.6791108
A03	9904807	9906183	A03p21910.2_BraZ1	257.6	-	659	1376	1376	1.0000000
A03	9908815	9911472	A03p21920.2_BraZ1	819.491	+	1487	2502	2657	0.9416635
A03	9912859	9913789	A03p21930.2_BraZ1	93	+	305	930	930	1.0000000
A03	9914107	9915683	A03p21940.2_BraZ1	1330.56	-	519	1486	1576	0.9428934
A03	9917104	9918080	A03p21950.2_BraZ1	563.75	+	598	976	976	1.0000000
A03	9919384	9925054	A03p21960.2_BraZ1	4034.48	-	1179	3946	5670	0.6959435
A03	9927524	9930035	A03p21970.2_BraZ1	251.1	-	925	2395	2511	0.9538032
A03	9930791	9933163	A03p21980.2_BraZ1	892.426	-	701	1880	2372	0.7925801
A03	9936186	9938087	A03p21990.2_BraZ1	906	-	537	1736	1901	0.9132036
A03	9941343	9943583	A03p22000.2_BraZ1	1134.72	+	204	1425	2240	0.6361607
A03	9945081	9945327	A03p22010.2_BraZ1	162	-	28	181	246	0.7357724
A03	9945423	9946584	A03p22020.2_BraZ1	659.062	-	153	1161	1161	1.0000000
A03	9951302	9952175	A03p22030.2_BraZ1	557.5	-	97	522	873	0.5979381
A03	9958798	9959929	A03p22040.2_BraZ1	113.1	-	616	1131	1131	1.0000000
A03	9961933	9964079	A03p22050.2_BraZ1	1103.77	-	510	1730	2146	0.8061510
A03	9965395	9968563	A03p22060.2_BraZ1	2028	-	874	2736	3168	0.8636364
A03	9969604	9970243	A03p22070.2_BraZ1	63.9	-	316	398	639	0.6228482
A03	9971459	9974182	A03p22080.2_BraZ1	999.818	+	924	2408	2723	0.8843188
A03	9974832	9975501	A03p22090.2_BraZ1	66.9	-	90	531	669	0.7937220
A03	9978395	9980928	A03p22100.2_BraZ1	16008.7	+	1709	2365	2533	0.9336755
A03	9982073	9985885	A03p22110.2_BraZ1	1984.21	-	789	3665	3812	0.9614376
A03	9992275	9994223	A03p22120.2_BraZ1	831	-	859	1948	1948	1.0000000
A03	9995163	9999141	A03p22130.2_BraZ1	1502.75	-	1305	3836	3978	0.9643037
A03	10012086	10013645	A03p22140.2_BraZ1	16747.5	+	576	1546	1559	0.9916613
A03	10017821	10020000	A03p22150.2_BraZ1	1307.9	+	677	2179	2179	1.0000000
A03	10021186	10021960	A03p22160.2_BraZ1	57.1429	+	121	774	774	1.0000000
A03	10022373	10024252	A03p22170.2_BraZ1	1172.57	+	1128	1808	1879	0.9622139
A03	10024481	10027519	A03p22180.2_BraZ1	1034.25	-	931	2077	3038	0.6836734
A03	10028103	10029716	A03p22190.2_BraZ1	295.286	-	719	1613	1613	1.0000000
A03	10030883	10032546	A03p22200.2_BraZ1	882	-	687	1656	1663	0.9957907
A03	10033393	10034809	A03p22210.2_BraZ1	141.6	-	330	1410	1416	0.9957627
A03	10040862	10042492	A03p22220.2_BraZ1	960	-	970	1493	1630	0.9159509
A03	10046938	10047172	A03p22230.2_BraZ1	23.4	-	577	234	234	1.0000000
A03	10048956	10051396	A03p22240.2_BraZ1	1228.74	-	73	1113	2440	0.4561476
A03	10053855	10055799	A03p22250.2_BraZ1	1304.33	+	123	1306	1944	0.6718107
A03	10056253	10056499	A03p22260.2_BraZ1	24.6	+	70	246	246	1.0000000
A03	10059679	10060842	A03p22270.2_BraZ1	663.261	+	650	1159	1163	0.9965606
A03	10063999	10072313	A03p22280.2_BraZ1	5659.4	+	1766	4960	8314	0.5965841
A03	10072838	10074507	A03p22290.2_BraZ1	812.283	+	542	1669	1669	1.0000000
A03	10074839	10077468	A03p22300.2_BraZ1	1491.11	-	1137	2538	2629	0.9653861
A03	10078165	10078294	A03p22310.2_BraZ1	12.9	+	0	0	129	0.0000000
A03	10078620	10079075	A03p22320.2_BraZ1	189	+	0	0	455	0.0000000
A03	10081139	10081484	A03p22330.2_BraZ1	34.5	-	10	159	345	0.4608696
A03	10084882	10085711	A03p22340.2_BraZ1	252	-	288	829	829	1.0000000
A03	10086378	10088855	A03p22350.2_BraZ1	1549.99	-	1110	2174	2477	0.8776746
A03	10091156	10094178	A03p22360.2_BraZ1	627	+	768	2449	3022	0.8103905
A03	10096848	10099413	A03p22370.2_BraZ1	1627.52	+	378	2295	2565	0.8947368
A03	10107143	10110644	A03p22380.2_BraZ1	25827.8	+	648	2986	3501	0.8528992
A03	10113538	10115212	A03p22390.2_BraZ1	167.4	+	295	1590	1674	0.9498208
A03	10116579	10120548	A03p22400.2_BraZ1	1765.57	+	952	3290	3969	0.8289242
A03	10121503	10121873	A03p22410.2_BraZ1	267	-	326	370	370	1.0000000
A03	10127206	10132703	A03p22420.2_BraZ1	1674	+	2436	4669	5497	0.8493724
A03	10137826	10138991	A03p22430.2_BraZ1	726	+	511	1165	1165	1.0000000
A03	10139244	10143018	A03p22440.2_BraZ1	1002	-	2068	3451	3774	0.9144144
A03	10164626	10166018	A03p22450.2_BraZ1	139.2	-	452	1382	1392	0.9928161
A03	10183739	10185314	A03p22460.2_BraZ1	821.118	-	183	1391	1575	0.8831746
A03	10189139	10189469	A03p22470.2_BraZ1	33	-	651	330	330	1.0000000
A03	10191191	10193982	A03p22480.2_BraZ1	1536.99	-	2168	2788	2791	0.9989251
A03	10195060	10197432	A03p22490.2_BraZ1	932.531	-	1777	2320	2372	0.9780776
A03	10198416	10200103	A03p22500.2_BraZ1	1441.55	+	595	1687	1687	1.0000000
A03	10203832	10204471	A03p22510.2_BraZ1	63.9	-	328	639	639	1.0000000
A03	10206443	10207674	A03p22520.2_BraZ1	492.75	-	1227	1231	1231	1.0000000
A03	10208239	10208945	A03p22530.2_BraZ1	630	-	241	706	706	1.0000000
A03	10212009	10217161	A03p22540.2_BraZ1	1605.13	+	2854	4348	5152	0.8439441
A03	10219654	10220719	A03p22550.2_BraZ1	699	-	151	895	1065	0.8403756
A03	10224153	10224735	A03p22560.2_BraZ1	57.9	-	145	577	582	0.9914089
A03	10229135	10230870	A03p22570.2_BraZ1	1419	+	477	1618	1735	0.9325649
A03	10233213	10234107	A03p22580.2_BraZ1	321	+	448	750	894	0.8389262
A03	10236076	10236533	A03p22590.2_BraZ1	26.7	-	52	456	457	0.9978118
A03	10236954	10238403	A03p22600.2_BraZ1	243.848	-	754	1449	1449	1.0000000
A03	10238766	10240194	A03p22610.2_BraZ1	693.931	-	274	795	1428	0.5567227
A03	10245433	10247330	A03p22620.2_BraZ1	973.095	-	746	1891	1897	0.9968371
A03	10251411	10253514	A03p22630.2_BraZ1	1167.5	+	337	1890	2103	0.8987161
A03	10253815	10255606	A03p22640.2_BraZ1	976.286	-	1107	1691	1791	0.9441653
A03	10257536	10259524	A03p22650.2_BraZ1	897.629	-	383	1977	1988	0.9944668
A03	10261982	10262898	A03p22660.2_BraZ1	384.75	+	1115	916	916	1.0000000
A03	10264830	10267386	A03p22670.2_BraZ1	255.6	+	988	2322	2556	0.9084507
A03	10267591	10272772	A03p22680.2_BraZ1	2301.73	-	1299	4738	5181	0.9144953
A03	10274640	10276993	A03p22690.2_BraZ1	903	+	376	1935	2353	0.8223544
A03	10278966	10280542	A03p22700.2_BraZ1	1014	-	212	880	1576	0.5583757
A03	10289071	10289718	A03p22710.2_BraZ1	177	+	611	547	647	0.8454405
A03	10290322	10333052	A03p22720.2_BraZ1	558	+	23808	39559	42730	0.9257898
A03	10297166	10298368	A03p22730.2_BraZ1	4860	-	1331	1202	1202	1.0000000
A03	10299966	10301190	A03p22740.2_BraZ1	2599	-	509	1224	1224	1.0000000
A03	10302478	10303426	A03p22750.2_BraZ1	94.8	+	469	821	948	0.8660337
A03	10303945	10304239	A03p22760.2_BraZ1	207	+	291	294	294	1.0000000
A03	10305046	10306636	A03p22770.2_BraZ1	159	+	82	756	1590	0.4754717
A03	10307091	10310070	A03p22780.2_BraZ1	1877.8	-	1281	2805	2979	0.9415911
A03	10310268	10310727	A03p22790.2_BraZ1	369	+	445	456	459	0.9934641
A03	10311148	10313464	A03p22800.2_BraZ1	1507.91	-	406	2014	2316	0.8696027
A03	10318085	10320287	A03p22810.2_BraZ1	958.136	-	540	1892	2202	0.8592189
A03	10324725	10329176	A03p22820.2_BraZ1	3792.75	+	1421	4253	4451	0.9555156
A03	10333052	10333714	A03p22830.2_BraZ1	591	+	521	662	662	1.0000000
A03	10334440	10334632	A03p22840.2_BraZ1	19.2	+	1	24	192	0.1250000
A03	10336195	10337715	A03p22850.2_BraZ1	1398	+	1317	1520	1520	1.0000000
A03	10341145	10341692	A03p22860.2_BraZ1	150.75	+	520	547	547	1.0000000
A03	10344867	10345017	A03p22870.2_BraZ1	15	-	379	150	150	1.0000000
A03	10345910	10346454	A03p22880.2_BraZ1	486	+	65	355	544	0.6525735
A03	10349153	10351818	A03p22890.2_BraZ1	1218.86	+	1010	2553	2665	0.9579737
A03	10357037	10357463	A03p22900.2_BraZ1	42.6	+	184	426	426	1.0000000
A03	10359162	10362036	A03p22910.2_BraZ1	1474.66	-	1925	2848	2874	0.9909534
A03	10364244	10365393	A03p22920.2_BraZ1	425.25	+	638	1149	1149	1.0000000
A03	10366381	10369403	A03p22930.2_BraZ1	2283.3	+	539	2629	3022	0.8699537
A03	10372000	10382187	A03p22940.2_BraZ1	4462.14	+	1388	6688	10187	0.6565230
A03	10384251	10384539	A03p22950.2_BraZ1	28.8	-	1	36	288	0.1250000
A03	10390574	10390871	A03p22960.2_BraZ1	29.7	+	0	0	297	0.0000000
A03	10397624	10406878	A03p22970.2_BraZ1	950	-	2450	7671	9254	0.8289388
A03	10417364	10418600	A03p22980.2_BraZ1	620	+	68	1001	1236	0.8098705
A03	10419814	10419964	A03p22990.2_BraZ1	15	+	20	101	150	0.6733333
A03	10422015	10423392	A03p23000.2_BraZ1	1206	+	199	850	1377	0.6172839
A03	10423980	10424226	A03p23010.2_BraZ1	24.6	-	1	23	246	0.0934959
A03	10425399	10427004	A03p23020.2_BraZ1	781.671	+	1817	1605	1605	1.0000000
A03	10427789	10428888	A03p23030.2_BraZ1	709.364	-	956	1099	1099	1.0000000
A03	10432299	10434546	A03p23040.2_BraZ1	281.531	-	1450	2200	2247	0.9790832
A03	10443517	10444035	A03p23050.2_BraZ1	1127	+	372	518	518	1.0000000
A03	10444582	10447312	A03p23060.2_BraZ1	1215.84	+	911	2685	2730	0.9835165
A03	10448346	10449727	A03p23070.2_BraZ1	627.813	-	417	1191	1381	0.8624185
A03	10463014	10465235	A03p23080.2_BraZ1	1615.25	+	734	1720	2221	0.7744259
A03	10465680	10467289	A03p23090.2_BraZ1	829.091	-	1240	1609	1609	1.0000000
A03	10474128	10476294	A03p23100.2_BraZ1	1262.23	+	348	1614	2166	0.7451524
A03	10476901	10478787	A03p23110.2_BraZ1	654.875	-	306	1647	1886	0.8732768
A03	10484922	10485795	A03p23120.2_BraZ1	87.3	+	601	873	873	1.0000000
A03	10487816	10490473	A03p23130.2_BraZ1	1363.15	-	1261	2629	2657	0.9894618
A03	10494125	10495316	A03p23140.2_BraZ1	720	+	378	1059	1191	0.8891687
A03	10495606	10507605	A03p23150.2_BraZ1	4937.85	-	3369	9918	11999	0.8265689
A03	10509238	10511747	A03p23160.2_BraZ1	984.667	-	2468	2509	2509	1.0000000
A03	10513368	10518747	A03p23170.2_BraZ1	2653.64	-	1828	5004	5379	0.9302844
A03	10523763	10524996	A03p23180.2_BraZ1	672.218	+	448	1141	1233	0.9253852
A03	10525251	10527688	A03p23190.2_BraZ1	2301	-	330	2038	2437	0.8362741
A03	10528855	10529946	A03p23200.2_BraZ1	624.75	+	397	1058	1091	0.9697526
A03	10531370	10532819	A03p23210.2_BraZ1	888	-	563	1297	1449	0.8951001
A03	10536348	10538109	A03p23220.2_BraZ1	176.1	+	644	1719	1761	0.9761499
A03	10542346	10542537	A03p23230.2_BraZ1	18.6	+	54	191	191	1.0000000
A03	10550829	10551576	A03p23240.2_BraZ1	74.7	+	284	747	747	1.0000000
A03	10554073	10555409	A03p23250.2_BraZ1	424.366	-	1370	1336	1336	1.0000000
A03	10555732	10558655	A03p23260.2_BraZ1	1609.85	-	2482	2898	2923	0.9914472
A03	10559525	10564131	A03p23270.2_BraZ1	1266.7	-	1568	4329	4606	0.9398611
A03	10567274	10570011	A03p23280.2_BraZ1	904.156	-	496	1856	2737	0.6781147
A03	10570949	10572507	A03p23290.2_BraZ1	1152	-	1184	1558	1558	1.0000000
A03	10577413	10579024	A03p23300.2_BraZ1	80.7	+	1549	1510	1611	0.9373060
A03	10581402	10582221	A03p23310.2_BraZ1	81.9	+	406	819	819	1.0000000
A03	10582789	10584197	A03p23320.2_BraZ1	759.908	-	2094	1406	1408	0.9985796
A03	10595299	10602189	A03p23330.2_BraZ1	279	-	8189	6890	6890	1.0000000
A03	10598539	10599525	A03p23340.2_BraZ1	248	-	2699	986	986	1.0000000
A03	10598722	10599472	A03p23350.2_BraZ1	132	-	2243	750	750	1.0000000
A03	10602338	10603093	A03p23360.2_BraZ1	119.25	-	630	755	755	1.0000000
A03	10604537	10605183	A03p23370.2_BraZ1	1164	-	207	646	646	1.0000000
A03	10605517	10605888	A03p23380.2_BraZ1	702	+	97	321	371	0.8652291
A03	10610504	10611269	A03p23390.2_BraZ1	591	+	155	221	765	0.2888889
A03	10620767	10623670	A03p23400.2_BraZ1	1044.29	-	1837	2903	2903	1.0000000
A03	10626286	10627091	A03p23410.2_BraZ1	465	+	586	805	805	1.0000000
A03	10627537	10631560	A03p23420.2_BraZ1	1163.25	-	2253	3204	4023	0.7964206
A03	10637331	10639163	A03p23430.2_BraZ1	5975	+	325	1312	1832	0.7161572
A03	10645083	10646944	A03p23440.2_BraZ1	808.5	-	305	1487	1861	0.7990328
A03	10647657	10652872	A03p23450.2_BraZ1	454.088	-	1020	4440	5215	0.8513902
A03	10658546	10662088	A03p23460.2_BraZ1	1791.37	-	322	2535	3542	0.7156973
A03	10664276	10667033	A03p23470.2_BraZ1	843.632	-	1315	2620	2757	0.9503083
A03	10667844	10668529	A03p23480.2_BraZ1	457.6	-	119	663	685	0.9678832
A03	10670193	10670460	A03p23490.2_BraZ1	26.7	+	150	265	267	0.9925094
A03	10671658	10672756	A03p23500.2_BraZ1	408	-	350	1098	1098	1.0000000
A03	10675273	10675807	A03p23510.2_BraZ1	53.4	-	97	505	534	0.9456929
A03	10690269	10692747	A03p23520.2_BraZ1	2016	+	1066	2478	2478	1.0000000
A03	10693389	10695044	A03p23530.2_BraZ1	701.064	-	785	1591	1655	0.9613293
A03	10710894	10711428	A03p23540.2_BraZ1	53.4	+	42	326	534	0.6104869
A03	10716861	10718981	A03p23550.2_BraZ1	819.143	-	1379	2022	2120	0.9537736
A03	10723970	10725261	A03p23560.2_BraZ1	1092.25	-	1116	1286	1291	0.9961270
A03	10725230	10725633	A03p23570.2_BraZ1	177	+	376	403	403	1.0000000
A03	10726196	10727123	A03p23580.2_BraZ1	514.8	+	1036	927	927	1.0000000
A03	10730969	10733074	A03p23590.2_BraZ1	1002.02	+	1619	2105	2105	1.0000000
A03	10733898	10734084	A03p23600.2_BraZ1	18.6	+	326	186	186	1.0000000
A03	10736108	10736528	A03p23610.2_BraZ1	42	-	443	420	420	1.0000000
A03	10740301	10743876	A03p23620.2_BraZ1	1495.04	-	1049	2754	3575	0.7703496
A03	10749876	10753651	A03p23630.2_BraZ1	1023.68	+	2364	3686	3775	0.9764239
A03	10754189	10754580	A03p23640.2_BraZ1	237	-	134	391	391	1.0000000
A03	10762300	10765892	A03p23650.2_BraZ1	2327.25	+	1957	3565	3592	0.9924833
A03	10766941	10767719	A03p23660.2_BraZ1	41.1	+	83	605	778	0.7776350
A03	10768192	10769901	A03p23670.2_BraZ1	973.232	+	490	1391	1709	0.8139263
A03	10770455	10774533	A03p23680.2_BraZ1	1005.48	-	1825	3982	4078	0.9764590
A03	10778737	10780576	A03p23690.2_BraZ1	904.886	+	196	1288	1839	0.7003806
A03	10789397	10789559	A03p23700.2_BraZ1	16.2	+	14	151	162	0.9320987
A03	10789567	10792107	A03p23710.2_BraZ1	1443	+	717	2277	2540	0.8964567
A03	10792968	10793769	A03p23720.2_BraZ1	80.1	+	155	782	801	0.9762797
A03	10794587	10796997	A03p23730.2_BraZ1	1433.85	-	183	1770	2410	0.7344398
A03	10800690	10801041	A03p23740.2_BraZ1	35.1	+	98	346	351	0.9857550
A03	10802372	10803113	A03p23750.2_BraZ1	74.1	+	287	736	741	0.9932523
A03	10804287	10804538	A03p23760.2_BraZ1	17.4	+	163	251	251	1.0000000
A03	10805435	10805540	A03p23770.2_BraZ1	10.5	+	70	105	105	1.0000000
A03	10808994	10810544	A03p23780.2_BraZ1	851.348	+	48	876	1550	0.5651613
A03	10811390	10812122	A03p23790.2_BraZ1	642	-	265	732	732	1.0000000
A03	10813290	10815474	A03p23800.2_BraZ1	596.7	-	3078	2184	2184	1.0000000
A03	10817163	10817325	A03p23810.2_BraZ1	16.2	+	289	162	162	1.0000000
A03	10822438	10824817	A03p23820.2_BraZ1	486.5	+	1688	2246	2379	0.9440942
A03	10828399	10828941	A03p23830.2_BraZ1	170.625	-	0	0	542	0.0000000
A03	10828777	10831680	A03p23840.2_BraZ1	369.896	-	24	349	2903	0.1202205
A03	10834829	10834955	A03p23850.2_BraZ1	12.6	-	382	126	126	1.0000000
A03	10836398	10839959	A03p23860.2_BraZ1	6504	+	4865	3086	3561	0.8666105
A03	10840025	10840283	A03p23870.2_BraZ1	25.8	+	12	101	258	0.3914729
A03	10842122	10846588	A03p23880.2_BraZ1	2714.66	+	2005	4002	4466	0.8961039
A03	10846959	10849055	A03p23890.2_BraZ1	1296.14	-	763	1892	2096	0.9026718
A03	10850396	10852350	A03p23900.2_BraZ1	1208.96	+	775	1527	1954	0.7814739
A03	10852814	10853786	A03p23910.2_BraZ1	393	+	528	872	972	0.8971193
A03	10854115	10856736	A03p23920.2_BraZ1	1539	+	713	2116	2621	0.8073254
A03	10857109	10858933	A03p23930.2_BraZ1	1118	-	927	1824	1824	1.0000000
A03	10859393	10864537	A03p23940.2_BraZ1	1066.2	-	3373	4909	5144	0.9543157
A03	10863028	10865763	A03p23950.2_BraZ1	294	+	2285	2735	2735	1.0000000
A03	10867222	10867581	A03p23960.2_BraZ1	261	-	216	359	359	1.0000000
A03	10877117	10877805	A03p23970.2_BraZ1	64.5	-	507	582	688	0.8459302
A03	10881446	10883330	A03p23980.2_BraZ1	1056	-	799	1816	1884	0.9639066
A03	10884952	10885363	A03p23990.2_BraZ1	111	+	111	411	411	1.0000000
A03	10890768	10891397	A03p24000.2_BraZ1	546	+	128	596	629	0.9475358
A03	10892070	10893416	A03p24010.2_BraZ1	499.5	-	204	1046	1346	0.7771174
A03	10893770	10895888	A03p24020.2_BraZ1	1100.89	-	1141	2034	2118	0.9603400
A03	10896157	10897828	A03p24030.2_BraZ1	2846.57	+	1516	1662	1671	0.9946140
A03	10898912	10899083	A03p24040.2_BraZ1	17.1	+	47	171	171	1.0000000
A03	10902422	10906044	A03p24050.2_BraZ1	880.035	-	1853	3342	3622	0.9226946
A03	10907209	10908500	A03p24060.2_BraZ1	708.762	-	479	1291	1291	1.0000000
A03	10917381	10917813	A03p24070.2_BraZ1	312	+	13	291	432	0.6736111
A03	10920672	10924210	A03p24080.2_BraZ1	2669.33	+	282	1600	3538	0.4522329
A03	10925367	10925781	A03p24090.2_BraZ1	282	+	6	3	414	0.0072464
A03	10926909	10927333	A03p24100.2_BraZ1	270	+	38	186	424	0.4386792
A03	10930537	10934034	A03p24110.2_BraZ1	2628.27	+	384	2097	3497	0.5996568
A03	10935181	10935595	A03p24120.2_BraZ1	282	+	0	0	414	0.0000000
A03	10936730	10937152	A03p24130.2_BraZ1	270	+	23	348	422	0.8246446
A03	10938777	10939318	A03p24140.2_BraZ1	141	-	187	427	541	0.7892791
A03	10939835	10940955	A03p24150.2_BraZ1	849	-	166	816	1120	0.7285714
A03	10943680	10944978	A03p24160.2_BraZ1	798	-	17	154	1298	0.1186441
A03	10948614	10951697	A03p24170.2_BraZ1	4189.79	+	437	2682	3083	0.8699319
A03	10956066	10957381	A03p24180.2_BraZ1	807	-	145	624	1315	0.4745247
A03	10973823	10975218	A03p24190.2_BraZ1	927	-	189	1059	1395	0.7591398
A03	10978542	10980331	A03p24200.2_BraZ1	84.9	-	517	1372	1789	0.7669089
A03	10990053	10990227	A03p24210.2_BraZ1	17.4	-	474	174	174	1.0000000
A03	10994072	10995530	A03p24220.2_BraZ1	8370	-	178	836	1458	0.5733882
A03	10996250	10996983	A03p24230.2_BraZ1	364.671	-	151	706	733	0.9631651
A03	10997635	11004792	A03p24240.2_BraZ1	2594.53	+	1893	6400	7157	0.8942294
A03	11005380	11010216	A03p24250.2_BraZ1	2198.57	+	1167	4128	4836	0.8535980
A03	11012488	11014666	A03p24260.2_BraZ1	1021.83	+	1071	2103	2178	0.9655647
A03	11015708	11016299	A03p24270.2_BraZ1	59.1	-	517	591	591	1.0000000
A03	11017001	11017601	A03p24280.2_BraZ1	522	-	794	600	600	1.0000000
A03	11018652	11019503	A03p24290.2_BraZ1	687	-	277	758	851	0.8907168
A03	11020862	11021331	A03p24300.2_BraZ1	273	-	410	459	469	0.9786780
A03	11022690	11024846	A03p24310.2_BraZ1	918.72	+	820	1872	2156	0.8682746
A03	11026035	11027830	A03p24320.2_BraZ1	1337.69	+	492	1654	1795	0.9214485
A03	11028881	11029067	A03p24330.2_BraZ1	18.6	+	71	186	186	1.0000000
A03	11033143	11036098	A03p24340.2_BraZ1	2600.18	+	818	2617	2955	0.8856176
A03	11038070	11039513	A03p24350.2_BraZ1	1344	+	23	562	1443	0.3894664
A03	11047542	11048650	A03p24360.2_BraZ1	1011	+	40	658	1108	0.5938628
A03	11050689	11052133	A03p24370.2_BraZ1	2918.5	+	308	1357	1444	0.9397507
A03	11053480	11055919	A03p24380.2_BraZ1	5683.12	-	524	786	2439	0.3222632
A03	11061846	11064096	A03p24390.2_BraZ1	1158	-	545	1730	2250	0.7688889
A03	11068074	11073208	A03p24400.2_BraZ1	3713.32	-	436	3196	5134	0.6225166
A03	11073863	11087167	A03p24410.2_BraZ1	820.122	-	2328	8617	13304	0.6477000
A03	11087471	11089358	A03p24420.2_BraZ1	989.486	-	1511	1887	1887	1.0000000
A03	11089562	11091494	A03p24430.2_BraZ1	193.2	+	463	1599	1932	0.8276398
A03	11092554	11093178	A03p24440.2_BraZ1	62.4	+	25	239	624	0.3830128
A03	11096014	11096302	A03p24450.2_BraZ1	28.8	+	203	272	288	0.9444444
A03	11096941	11098591	A03p24460.2_BraZ1	980	-	792	1650	1650	1.0000000
A03	11098954	11106570	A03p24470.2_BraZ1	1032.19	+	3778	6891	7616	0.9048057
A03	11107733	11108409	A03p24480.2_BraZ1	453	+	191	561	676	0.8298817
A03	11108541	11109500	A03p24490.2_BraZ1	519.583	-	307	889	959	0.9270073
A03	11121227	11122439	A03p24500.2_BraZ1	121.2	+	935	1212	1212	1.0000000
A03	11124197	11126824	A03p24510.2_BraZ1	979.44	+	493	1514	2627	0.5763228
A03	11128760	11131111	A03p24520.2_BraZ1	877.333	-	123	1552	2351	0.6601446
A03	11131547	11133282	A03p24530.2_BraZ1	1242.6	+	486	1710	1735	0.9855908
A03	11133747	11135460	A03p24540.2_BraZ1	3630	+	302	1554	1713	0.9071804
A03	11137944	11153464	A03p24550.2_BraZ1	2480.1	+	2904	12819	15520	0.8259665
A03	11154595	11155024	A03p24560.2_BraZ1	42.9	+	118	412	429	0.9603730
A03	11159692	11160226	A03p24570.2_BraZ1	53.4	+	184	380	534	0.7116105
A03	11163339	11163792	A03p24580.2_BraZ1	45.3	+	105	385	453	0.8498896
A03	11166150	11170352	A03p24590.2_BraZ1	1387.06	+	2723	4049	4202	0.9635888
A03	11171720	11172065	A03p24600.2_BraZ1	34.5	+	438	345	345	1.0000000
A03	11172641	11173367	A03p24610.2_BraZ1	72.6	-	436	726	726	1.0000000
A03	11174316	11181094	A03p24620.2_BraZ1	1619.35	-	2757	5684	6778	0.8385954
A03	11183311	11184892	A03p24630.2_BraZ1	599.953	-	1284	1581	1581	1.0000000
A03	11185188	11185853	A03p24640.2_BraZ1	363	+	314	665	665	1.0000000
A03	11186335	11188153	A03p24650.2_BraZ1	1419	+	310	1664	1818	0.9152915
A03	11191260	11191649	A03p24660.2_BraZ1	285	+	143	346	389	0.8894601
A03	11193356	11194751	A03p24670.2_BraZ1	644	-	321	1150	1395	0.8243728
A03	11195414	11196485	A03p24680.2_BraZ1	107.1	-	164	824	1071	0.7693744
A03	11198925	11199780	A03p24690.2_BraZ1	603	-	206	855	855	1.0000000
A03	11203194	11204868	A03p24700.2_BraZ1	480.611	-	589	1515	1674	0.9050179
A03	11214501	11216516	A03p24710.2_BraZ1	680.062	+	1408	2001	2015	0.9930521
A03	11217865	11218688	A03p24720.2_BraZ1	588	-	112	583	823	0.7083840
A03	11222296	11225535	A03p24730.2_BraZ1	2325.27	-	696	2589	3239	0.7993208
A03	11233404	11234236	A03p24740.2_BraZ1	78.9	+	307	733	832	0.8810096
A03	11239308	11241857	A03p24750.2_BraZ1	715.5	-	677	2320	2549	0.9101608
A03	11249165	11250009	A03p24760.2_BraZ1	675	+	80	331	844	0.3921801
A03	11252594	11254012	A03p24770.2_BraZ1	767	+	216	1336	1418	0.9421721
A03	11254940	11258180	A03p24780.2_BraZ1	2118.87	-	716	2942	3240	0.9080247
A03	11264803	11265730	A03p24790.2_BraZ1	92.7	+	161	927	927	1.0000000
A03	11268911	11270253	A03p24800.2_BraZ1	764.156	+	736	1308	1342	0.9746647
A03	11271414	11275513	A03p24810.2_BraZ1	1344.02	+	1537	3808	4099	0.9290071
A03	11278169	11280209	A03p24820.2_BraZ1	181.8	-	354	1760	2040	0.8627451
A03	11287279	11288115	A03p24830.2_BraZ1	366.267	+	411	763	836	0.9126794
A03	11289918	11290365	A03p24840.2_BraZ1	44.7	+	162	447	447	1.0000000
A03	11291152	11291714	A03p24850.2_BraZ1	312	-	0	0	562	0.0000000
A03	11294671	11296780	A03p24860.2_BraZ1	678	-	455	1491	2109	0.7069702
A03	11307417	11308957	A03p24870.2_BraZ1	619.744	-	628	1519	1540	0.9863636
A03	11314908	11315394	A03p24880.2_BraZ1	48.6	+	6	53	486	0.1090535
A03	11320445	11322685	A03p24890.2_BraZ1	16863	-	379	1446	2240	0.6455357
A03	11328201	11329449	A03p24900.2_BraZ1	124.8	-	228	1150	1248	0.9214743
A03	11332934	11335203	A03p24910.2_BraZ1	1526.23	+	680	2086	2269	0.9193477
A03	11336502	11337810	A03p24920.2_BraZ1	130.8	+	50	692	1308	0.5290520
A03	11337993	11339865	A03p24930.2_BraZ1	1188	-	512	1772	1872	0.9465812
A03	11340303	11342947	A03p24940.2_BraZ1	1257.22	-	359	1973	2644	0.7462178
A03	11345845	11345995	A03p24950.2_BraZ1	15	+	39	150	150	1.0000000
A03	11347426	11348038	A03p24960.2_BraZ1	61.2	-	188	438	612	0.7156863
A03	11348304	11349504	A03p24970.2_BraZ1	120	+	105	533	1200	0.4441667
A03	11350077	11350458	A03p24980.2_BraZ1	279	-	33	307	381	0.8057743
A03	11350460	11350580	A03p24990.2_BraZ1	12	-	12	27	120	0.2250000
A03	11351284	11352412	A03p25000.2_BraZ1	288	-	103	722	1128	0.6400709
A03	11364641	11366537	A03p25010.2_BraZ1	1451.76	+	155	991	1896	0.5226793
A03	11367867	11369771	A03p25020.2_BraZ1	1117.61	+	988	1904	1904	1.0000000
A03	11370318	11371250	A03p25030.2_BraZ1	388.5	-	218	922	932	0.9892704
A03	11375660	11377437	A03p25040.2_BraZ1	624.403	+	1454	1737	1777	0.9774901
A03	11379012	11381395	A03p25050.2_BraZ1	632.182	-	1296	2251	2383	0.9446076
A03	11386631	11389434	A03p25060.2_BraZ1	15120	+	1473	2785	2803	0.9935783
A03	11393372	11394444	A03p25070.2_BraZ1	6075	-	1099	1072	1072	1.0000000
A03	11395303	11398344	A03p25080.2_BraZ1	1562.81	-	1544	3017	3041	0.9921079
A03	11399756	11400710	A03p25090.2_BraZ1	95.4	-	87	660	954	0.6918239
A03	11402077	11403860	A03p25100.2_BraZ1	1063.14	-	453	1370	1783	0.7683679
A03	11404280	11404820	A03p25110.2_BraZ1	90.2778	+	230	540	540	1.0000000
A03	11405174	11405357	A03p25120.2_BraZ1	10.5	-	267	183	183	1.0000000
A03	11405689	11408753	A03p25130.2_BraZ1	705.667	+	936	2791	3064	0.9109008
A03	11409034	11411238	A03p25140.2_BraZ1	740.165	-	576	2017	2204	0.9151543
A03	11411575	11413084	A03p25150.2_BraZ1	535.5	+	433	1430	1509	0.9476475
A03	11413820	11414432	A03p25160.2_BraZ1	61.2	-	22	207	612	0.3382353
A03	11424936	11427278	A03p25170.2_BraZ1	936.254	+	865	1815	2342	0.7749786
A03	11427651	11428657	A03p25180.2_BraZ1	593.455	-	115	890	1006	0.8846918
A03	11431804	11432103	A03p25190.2_BraZ1	216	+	0	0	299	0.0000000
A03	11432106	11432324	A03p25200.2_BraZ1	198	+	0	0	218	0.0000000
A03	11432518	11432748	A03p25210.2_BraZ1	189	+	0	0	230	0.0000000
A03	11438993	11439292	A03p25220.2_BraZ1	216	+	0	0	299	0.0000000
A03	11439295	11439513	A03p25230.2_BraZ1	198	+	0	0	218	0.0000000
A03	11439707	11439937	A03p25240.2_BraZ1	189	+	0	0	230	0.0000000
A03	11449498	11449797	A03p25250.2_BraZ1	216	+	0	0	299	0.0000000
A03	11449800	11450018	A03p25260.2_BraZ1	198	+	0	0	218	0.0000000
A03	11450212	11450442	A03p25270.2_BraZ1	189	+	0	0	230	0.0000000
A03	11453043	11454358	A03p25280.2_BraZ1	9504	-	0	0	1315	0.0000000
A03	11454755	11456002	A03p25290.2_BraZ1	1167	-	0	0	1247	0.0000000
A03	11463940	11464239	A03p25300.2_BraZ1	216	+	0	0	299	0.0000000
A03	11464242	11464460	A03p25310.2_BraZ1	198	+	0	0	218	0.0000000
A03	11464654	11464884	A03p25320.2_BraZ1	189	+	0	0	230	0.0000000
A03	11467485	11468799	A03p25330.2_BraZ1	9504	-	5	248	1314	0.1887367
A03	11469201	11470448	A03p25340.2_BraZ1	1167	-	0	0	1247	0.0000000
A03	11475439	11477489	A03p25350.2_BraZ1	1026.44	-	201	1171	2050	0.5712195
A03	11481088	11482637	A03p25360.2_BraZ1	33292	+	388	1549	1549	1.0000000
A03	11482931	11483731	A03p25370.2_BraZ1	514.737	-	171	725	800	0.9062500
A03	11484451	11492563	A03p25380.2_BraZ1	5521.42	+	489	2966	8112	0.3656312
A03	11493001	11494113	A03p25390.2_BraZ1	650.808	-	438	1080	1112	0.9712230
A03	11495555	11496451	A03p25400.2_BraZ1	210	-	461	896	896	1.0000000
A03	11497535	11499335	A03p25410.2_BraZ1	827.657	-	462	1468	1800	0.8155556
A03	11501459	11502773	A03p25420.2_BraZ1	682.839	+	852	1282	1314	0.9756469
A03	11503856	11504740	A03p25430.2_BraZ1	501	+	83	515	884	0.5825792
A03	11506389	11506585	A03p25440.2_BraZ1	165	+	201	196	196	1.0000000
A03	11507313	11508297	A03p25450.2_BraZ1	717	+	525	984	984	1.0000000
A03	11509070	11511091	A03p25460.2_BraZ1	842.322	+	626	1881	2021	0.9307274
A03	11511994	11514021	A03p25470.2_BraZ1	1523.5	+	881	1983	2027	0.9782931
A03	11516996	11517743	A03p25480.2_BraZ1	74.7	+	103	680	747	0.9103079
A03	11520188	11520588	A03p25490.2_BraZ1	249	+	28	400	400	1.0000000
A03	11521291	11521606	A03p25500.2_BraZ1	222	-	54	266	315	0.8444445
A03	11531181	11534821	A03p25510.2_BraZ1	2734.77	-	1528	3042	3640	0.8357143
A03	11537991	11543840	A03p25520.2_BraZ1	894.194	+	1746	4371	5849	0.7473072
A03	11538795	11539529	A03p25530.2_BraZ1	55.5	+	0	0	734	0.0000000
A03	11545942	11546344	A03p25540.2_BraZ1	40.2	+	172	402	402	1.0000000
A03	11546987	11547418	A03p25550.2_BraZ1	141	-	601	431	431	1.0000000
A03	11547895	11548927	A03p25560.2_BraZ1	877.059	-	528	1029	1032	0.9970930
A03	11553881	11554043	A03p25570.2_BraZ1	16.2	-	41	152	162	0.9382716
A03	11554459	11555172	A03p25580.2_BraZ1	253.324	-	366	713	713	1.0000000
A03	11557378	11559764	A03p25590.2_BraZ1	1100.17	+	1372	2386	2386	1.0000000
A03	11562009	11563026	A03p25600.2_BraZ1	609	+	813	1017	1017	1.0000000
A03	11563973	11564372	A03p25610.2_BraZ1	39.9	+	274	399	399	1.0000000
A03	11564973	11566035	A03p25620.2_BraZ1	426	-	1257	1062	1062	1.0000000
A03	11566035	11567662	A03p25630.2_BraZ1	855	-	207	1410	1627	0.8666257
A03	11569357	11569777	A03p25640.2_BraZ1	42	-	169	420	420	1.0000000
A03	11574607	11576452	A03p25650.2_BraZ1	1122	+	313	1186	1845	0.6428185
A03	11578797	11579251	A03p25660.2_BraZ1	40.5	+	78	339	454	0.7466961
A03	11579423	11580210	A03p25670.2_BraZ1	287.111	-	383	742	787	0.9428208
A03	11584830	11590118	A03p25680.2_BraZ1	207	+	1219	4737	5288	0.8958018
A03	11586945	11588032	A03p25690.2_BraZ1	106.5	+	359	909	1087	0.8362466
A03	11595014	11596178	A03p25700.2_BraZ1	115.8	+	1027	1164	1164	1.0000000
A03	11603051	11605274	A03p25710.2_BraZ1	1908	+	608	1733	2223	0.7795771
A03	11612485	11613412	A03p25720.2_BraZ1	92.7	+	81	446	927	0.4811219
A03	11617353	11618209	A03p25730.2_BraZ1	771	-	81	766	856	0.8948598
A03	11619923	11621920	A03p25740.2_BraZ1	786.857	-	112	1140	1997	0.5708563
A03	11627565	11628627	A03p25750.2_BraZ1	340.312	-	332	1062	1062	1.0000000
A03	11629465	11631455	A03p25760.2_BraZ1	1791	-	46	621	1990	0.3120603
A03	11633454	11634105	A03p25770.2_BraZ1	65.1	-	34	121	651	0.1858679
A03	11634919	11638230	A03p25780.2_BraZ1	1222.93	-	1506	3037	3311	0.9172456
A03	11639482	11642214	A03p25790.2_BraZ1	151.875	-	632	2360	2732	0.8638360
A03	11644048	11647049	A03p25800.2_BraZ1	1830	-	702	2408	3001	0.8023992
A03	11654258	11655692	A03p25810.2_BraZ1	517.711	+	1566	1426	1434	0.9944212
A03	11657949	11659539	A03p25820.2_BraZ1	159	+	125	1326	1590	0.8339623
A03	11659707	11662619	A03p25830.2_BraZ1	2027.2	-	405	2329	2912	0.7997940
A03	11663963	11669012	A03p25840.2_BraZ1	1821.28	+	4023	4907	5049	0.9718756
A03	11669279	11672022	A03p25850.2_BraZ1	1844.11	-	1049	2235	2743	0.8148013
A03	11675439	11675759	A03p25860.2_BraZ1	19.8	+	328	320	320	1.0000000
A03	11676269	11678626	A03p25870.2_BraZ1	1258.4	+	202	2074	2357	0.8799321
A03	11682018	11682939	A03p25880.2_BraZ1	92.1	+	340	921	921	1.0000000
A03	11684039	11684234	A03p25890.2_BraZ1	19.5	+	202	195	195	1.0000000
A03	11684847	11685228	A03p25900.2_BraZ1	38.1	+	51	296	381	0.7769029
A03	11685705	11686827	A03p25910.2_BraZ1	1035	+	62	816	1122	0.7272727
A03	11689737	11692315	A03p25920.2_BraZ1	1105.3	+	1849	2578	2578	1.0000000
A03	11693642	11695920	A03p25930.2_BraZ1	957.412	+	1186	2131	2278	0.9354697
A03	11695955	11696111	A03p25940.2_BraZ1	15.6	+	31	156	156	1.0000000
A03	11698606	11699770	A03p25950.2_BraZ1	584.22	+	151	1026	1164	0.8814433
A03	11700360	11705215	A03p25960.2_BraZ1	1719.9	+	2399	4684	4855	0.9647786
A03	11710866	11711364	A03p25970.2_BraZ1	195	-	142	498	498	1.0000000
A03	11715560	11716435	A03p25980.2_BraZ1	489	-	518	853	875	0.9748572
A03	11720007	11721111	A03p25990.2_BraZ1	775.5	+	380	1024	1104	0.9275362
A03	11721365	11724763	A03p26000.2_BraZ1	1422.9	-	854	3007	3398	0.8849323
A03	11724845	11725585	A03p26010.2_BraZ1	384	-	838	740	740	1.0000000
A03	11728285	11728756	A03p26020.2_BraZ1	47.1	-	119	471	471	1.0000000
A03	11737354	11739481	A03p26030.2_BraZ1	212.7	+	274	1601	2127	0.7527033
A03	11739758	11742269	A03p26040.2_BraZ1	1377.71	-	379	2127	2511	0.8470729
A03	11742582	11750602	A03p26050.2_BraZ1	2326.5	-	1312	6256	8020	0.7800499
A03	11749648	11750006	A03p26060.2_BraZ1	1221	-	142	358	358	1.0000000
A03	11751123	11752986	A03p26070.2_BraZ1	1221.2	+	497	1437	1863	0.7713366
A03	11758719	11759254	A03p26080.2_BraZ1	42.6	+	36	404	535	0.7551402
A03	11766428	11766845	A03p26090.2_BraZ1	41.7	-	151	417	417	1.0000000
A03	11767417	11773530	A03p26100.2_BraZ1	3665.73	-	1268	5244	6113	0.8578439
A03	11777744	11780402	A03p26110.2_BraZ1	7452	-	852	2466	2658	0.9277653
A03	11781289	11787886	A03p26120.2_BraZ1	2665.99	-	1543	5764	6597	0.8737305
A03	11790910	11791669	A03p26130.2_BraZ1	675	+	93	517	759	0.6811594
A03	11793320	11795027	A03p26140.2_BraZ1	20575.5	+	178	1354	1707	0.7932044
A03	11796932	11798505	A03p26150.2_BraZ1	776.471	-	266	1308	1573	0.8315321
A03	11800387	11801614	A03p26160.2_BraZ1	812.25	-	591	1227	1227	1.0000000
A03	11802413	11803535	A03p26170.2_BraZ1	391.95	-	335	836	1122	0.7450981
A03	11809350	11810509	A03p26180.2_BraZ1	767.083	+	111	695	1159	0.5996549
A03	11810873	11812954	A03p26190.2_BraZ1	984.474	-	39	768	2081	0.3690533
A03	11818286	11818709	A03p26200.2_BraZ1	42.3	+	475	423	423	1.0000000
A03	11823354	11825462	A03p26210.2_BraZ1	1338.53	-	586	1700	2108	0.8064516
A03	11837614	11837854	A03p26220.2_BraZ1	24	+	91	209	240	0.8708333
A03	11838891	11839233	A03p26230.2_BraZ1	34.2	-	68	277	342	0.8099415
A03	11840117	11840690	A03p26240.2_BraZ1	57.3	-	144	356	573	0.6212915
A03	11842690	11843730	A03p26250.2_BraZ1	681	-	723	1040	1040	1.0000000
A03	11855047	11855890	A03p26260.2_BraZ1	682.357	-	111	637	843	0.7556347
A03	11856916	11858693	A03p26270.2_BraZ1	8316	-	631	1699	1777	0.9561058
A03	11866292	11868367	A03p26280.2_BraZ1	1088.61	+	690	1620	2075	0.7807229
A03	11869413	11870637	A03p26290.2_BraZ1	1128	-	33	395	1224	0.3227124
A03	11871805	11872980	A03p26300.2_BraZ1	1098	-	9	181	1175	0.1540426
A03	11874100	11879494	A03p26310.2_BraZ1	2382.43	-	464	3824	5394	0.7089359
A03	11887949	11889438	A03p26320.2_BraZ1	696	+	705	1101	1489	0.7394224
A03	11892655	11893946	A03p26330.2_BraZ1	983.077	+	324	1081	1291	0.8373354
A03	11897340	11901748	A03p26340.2_BraZ1	1967.27	+	538	2722	4408	0.6175136
A03	11902576	11902927	A03p26350.2_BraZ1	35.1	+	42	346	351	0.9857550
A03	11903826	11907517	A03p26360.2_BraZ1	1683.9	+	497	2387	3691	0.6467082
A03	11909502	11909666	A03p26370.2_BraZ1	16.2	+	15	67	164	0.4085366
A03	11910953	11912237	A03p26380.2_BraZ1	926.3	-	40	460	1284	0.3582554
A03	11920785	11921450	A03p26390.2_BraZ1	490.696	-	629	620	665	0.9323308
A03	11929102	11929477	A03p26400.2_BraZ1	37.5	+	16	296	375	0.7893333
A03	11935742	11936730	A03p26410.2_BraZ1	819	+	178	745	988	0.7540486
A03	11942974	11943837	A03p26420.2_BraZ1	282.333	-	1	32	863	0.0370800
A03	11943744	11944075	A03p26430.2_BraZ1	117	-	7	175	331	0.5287009
A03	11954482	11954620	A03p26440.2_BraZ1	13.8	+	0	0	138	0.0000000
A03	11960817	11962930	A03p26450.2_BraZ1	343.875	+	1855	2113	2113	1.0000000
A03	11963204	11965544	A03p26460.2_BraZ1	1583.82	-	1406	1603	2340	0.6850427
A03	11967320	11969257	A03p26470.2_BraZ1	641.201	-	2762	1924	1937	0.9932886
A03	11969127	11974611	A03p26480.2_BraZ1	2147.23	-	927	3976	5484	0.7250183
A03	11976416	11977064	A03p26490.2_BraZ1	40.2	-	248	619	648	0.9552469
A03	11980773	11981601	A03p26500.2_BraZ1	82.8	+	245	821	828	0.9915459
A03	11983941	11986304	A03p26510.2_BraZ1	1271	-	1428	2363	2363	1.0000000
A03	11987690	11988605	A03p26520.2_BraZ1	816	+	162	732	915	0.8000000
A03	11995704	11996205	A03p26530.2_BraZ1	50.1	+	180	501	501	1.0000000
A03	11998796	12000621	A03p26540.2_BraZ1	522.133	-	442	1351	1825	0.7402740
A03	12008558	12008765	A03p26550.2_BraZ1	20.7	-	2	9	207	0.0434783
A03	12009887	12010040	A03p26560.2_BraZ1	15.3	-	238	153	153	1.0000000
A03	12010924	12011389	A03p26570.2_BraZ1	46.5	+	39	363	465	0.7806451
A03	12016000	12016791	A03p26580.2_BraZ1	315	+	253	662	791	0.8369153
A03	12020188	12021591	A03p26590.2_BraZ1	119.4	+	253	757	1403	0.5395581
A03	12026217	12027067	A03p26600.2_BraZ1	638.889	+	227	850	850	1.0000000
A03	12027287	12028300	A03p26610.2_BraZ1	578.667	-	580	945	1013	0.9328727
A03	12032293	12036310	A03p26620.2_BraZ1	1323	+	528	2921	4017	0.7271596
A03	12037202	12037772	A03p26630.2_BraZ1	57	-	161	568	570	0.9964913
A03	12038923	12039322	A03p26640.2_BraZ1	39.9	-	23	298	399	0.7468672
A03	12040568	12041081	A03p26650.2_BraZ1	51.3	-	53	175	513	0.3411306
A03	12041250	12041620	A03p26660.2_BraZ1	195	+	399	370	370	1.0000000
A03	12041837	12042578	A03p26670.2_BraZ1	678	+	637	741	741	1.0000000
A03	12043356	12044553	A03p26680.2_BraZ1	119.7	-	45	317	1197	0.2648287
A03	12047520	12048672	A03p26690.2_BraZ1	657.878	+	29	390	1152	0.3385417
A03	12050644	12051965	A03p26700.2_BraZ1	386.591	+	881	1291	1321	0.9772899
A03	12055686	12056721	A03p26710.2_BraZ1	103.5	+	142	670	1035	0.6473430
A03	12058415	12059626	A03p26720.2_BraZ1	483.6	-	595	982	1211	0.8109001
A03	12061909	12062629	A03p26730.2_BraZ1	72	-	178	418	720	0.5805556
A03	12067043	12069803	A03p26740.2_BraZ1	1354.57	-	391	2498	2760	0.9050725
A03	12070604	12071100	A03p26750.2_BraZ1	189	-	0	0	496	0.0000000
A03	12072695	12073555	A03p26760.2_BraZ1	579	-	86	765	860	0.8895349
A03	12077235	12083776	A03p26770.2_BraZ1	3199.56	+	867	4072	6541	0.6225348
A03	12085197	12085988	A03p26780.2_BraZ1	693	+	15	471	791	0.5954488
A03	12086905	12088738	A03p26790.2_BraZ1	183.3	+	133	1375	1833	0.7501364
A03	12089879	12093058	A03p26800.2_BraZ1	1979.25	+	683	1460	3179	0.4592639
A03	12097116	12097887	A03p26810.2_BraZ1	77.1	-	103	675	771	0.8754864
A03	12106068	12107179	A03p26820.2_BraZ1	1512	+	209	822	1111	0.7398740
A03	12112299	12112663	A03p26830.2_BraZ1	160.8	+	654	364	364	1.0000000
A03	12115707	12117423	A03p26840.2_BraZ1	171.6	+	171	975	1716	0.5681818
A03	12127859	12130432	A03p26850.2_BraZ1	1763	+	10	29	2573	0.0112709
A03	12132594	12143677	A03p26860.2_BraZ1	1798.84	+	3915	10256	11083	0.9253812
A03	12135189	12136606	A03p26870.2_BraZ1	660.706	-	150	1050	1417	0.7410021
A03	12144433	12148044	A03p26880.2_BraZ1	1240.67	+	1038	3422	3611	0.9476599
A03	12150427	12152471	A03p26890.2_BraZ1	1281.66	+	902	1844	2044	0.9021527
A03	12152899	12158289	A03p26900.2_BraZ1	3145.26	-	426	3556	5390	0.6597403
A03	12158783	12160091	A03p26910.2_BraZ1	1065.94	-	965	1308	1308	1.0000000
A03	12163421	12166357	A03p26920.2_BraZ1	692.007	+	992	2865	2936	0.9758174
A03	12175381	12177429	A03p26930.2_BraZ1	413.25	+	229	1704	2048	0.8320312
A03	12181358	12182955	A03p26940.2_BraZ1	853.159	+	583	1562	1597	0.9780839
A03	12184357	12186362	A03p26950.2_BraZ1	1438.83	-	273	1873	2005	0.9341646
A03	12191910	12193958	A03p26960.2_BraZ1	1641	+	41	553	2048	0.2700195
A03	12195134	12197451	A03p26970.2_BraZ1	1812	+	304	1213	2317	0.5235218
A03	12200689	12202115	A03p26980.2_BraZ1	1347	+	212	785	1426	0.5504909
A03	12203425	12206639	A03p26990.2_BraZ1	1461.18	+	688	3072	3214	0.9558183
A03	12212997	12213909	A03p27000.2_BraZ1	91.2	+	104	716	912	0.7850877
A03	12214841	12218463	A03p27010.2_BraZ1	961.071	-	1097	2920	3622	0.8061844
A03	12220091	12221563	A03p27020.2_BraZ1	2005	+	625	1472	1472	1.0000000
A03	12222826	12225107	A03p27030.2_BraZ1	1626	+	249	1117	2281	0.4896975
A03	12227091	12229347	A03p27040.2_BraZ1	1254	-	335	1752	2256	0.7765958
A03	12230848	12233222	A03p27050.2_BraZ1	2277	-	416	1868	2374	0.7868576
A03	12235000	12238650	A03p27060.2_BraZ1	1460.82	+	710	3225	3650	0.8835617
A03	12242806	12243921	A03p27070.2_BraZ1	984	-	92	894	1115	0.8017937
A03	12246777	12262378	A03p27080.2_BraZ1	6310.29	-	732	6634	15601	0.4252292
A03	12264460	12267346	A03p27090.2_BraZ1	1309.83	+	8719	2886	2886	1.0000000
A03	12271549	12272082	A03p27100.2_BraZ1	186	+	2402	533	533	1.0000000
A03	12271955	12274062	A03p27110.2_BraZ1	843.75	+	6324	2107	2107	1.0000000
A03	12277688	12280003	A03p27120.2_BraZ1	1280.77	+	271	1368	2315	0.5909287
A03	12281498	12284282	A03p27130.2_BraZ1	1540.35	+	224	1441	2784	0.5176006
A03	12289383	12294211	A03p27140.2_BraZ1	2871	+	372	2602	4828	0.5389395
A03	12296240	12297476	A03p27150.2_BraZ1	123.6	+	13	183	1236	0.1480583
A03	12299680	12301043	A03p27160.2_BraZ1	12006	+	419	1285	1363	0.9427733
A03	12305883	12308350	A03p27170.2_BraZ1	1662	+	424	1487	2467	0.6027564
A03	12308770	12310052	A03p27180.2_BraZ1	1170	+	87	670	1282	0.5226209
A03	12313585	12315731	A03p27190.2_BraZ1	1092.27	+	250	1774	2146	0.8266543
A03	12318674	12324754	A03p27200.2_BraZ1	3700.06	-	339	2582	6080	0.4246711
A03	12327185	12327809	A03p27210.2_BraZ1	62.4	+	7	47	624	0.0753205
A03	12329770	12329905	A03p27220.2_BraZ1	13.5	-	100	135	135	1.0000000
A03	12330095	12330449	A03p27230.2_BraZ1	153	-	193	354	354	1.0000000
A03	12330678	12331839	A03p27240.2_BraZ1	523.636	-	1330	1161	1161	1.0000000
A03	12333825	12342662	A03p27250.2_BraZ1	3708.43	+	1407	6297	8837	0.7125722
A03	12343133	12343826	A03p27260.2_BraZ1	69.3	+	105	537	693	0.7748918
A03	12345241	12347696	A03p27270.2_BraZ1	1242	-	304	1039	2455	0.4232179
A03	12350160	12351003	A03p27280.2_BraZ1	84.3	+	3	39	843	0.0462633
A03	12352837	12353551	A03p27290.2_BraZ1	71.4	-	15	192	714	0.2689076
A03	12354709	12363745	A03p27300.2_BraZ1	1668.8	-	5757	8739	9036	0.9671315
A03	12368268	12368498	A03p27310.2_BraZ1	189	-	198	230	230	1.0000000
A03	12368568	12370031	A03p27320.2_BraZ1	112	-	1964	1454	1463	0.9938483
A03	12370853	12372890	A03p27330.2_BraZ1	960	+	324	1517	2037	0.7447226
A03	12376239	12377356	A03p27340.2_BraZ1	813	+	124	938	1117	0.8397493
A03	12378541	12380999	A03p27350.2_BraZ1	207.9	-	331	1939	2458	0.7888528
A03	12381723	12384711	A03p27360.2_BraZ1	1485.75	-	889	1879	2988	0.6288487
A03	12385248	12387029	A03p27370.2_BraZ1	1457.23	+	435	1212	1781	0.6805165
A03	12389926	12390407	A03p27380.2_BraZ1	237	+	167	481	481	1.0000000
A03	12392378	12394695	A03p27390.2_BraZ1	1507.57	-	463	1847	2317	0.7971515
A03	12396785	12402574	A03p27400.2_BraZ1	1151.05	-	1988	4668	5789	0.8063569
A03	12406242	12406404	A03p27410.2_BraZ1	16.2	+	25	111	162	0.6851852
A03	12409809	12411729	A03p27420.2_BraZ1	192	+	705	1648	1920	0.8583333
A03	12415128	12417622	A03p27430.2_BraZ1	1092.18	-	919	1631	2494	0.6539695
A03	12418731	12419349	A03p27440.2_BraZ1	378	-	1	19	618	0.0307443
A03	12427067	12429353	A03p27450.2_BraZ1	35.7	+	906	1893	2286	0.8280840
A03	12431450	12431738	A03p27460.2_BraZ1	17.4	+	240	288	288	1.0000000
A03	12434174	12435027	A03p27470.2_BraZ1	61.1538	-	313	835	853	0.9788980
A03	12436284	12438674	A03p27480.2_BraZ1	1148.54	-	91	902	2390	0.3774059
A03	12439917	12441738	A03p27490.2_BraZ1	872.05	+	234	1409	1821	0.7737507
A03	12443490	12446555	A03p27500.2_BraZ1	1572.83	-	1387	2918	3065	0.9520391
A03	12447890	12450151	A03p27510.2_BraZ1	1408.44	-	102	1183	2261	0.5232198
A03	12456979	12458911	A03p27520.2_BraZ1	1142.28	+	525	1810	1932	0.9368530
A03	12458966	12459095	A03p27530.2_BraZ1	12.9	+	92	129	129	1.0000000
A03	12459128	12465690	A03p27540.2_BraZ1	2407.48	-	1477	5690	6562	0.8671137
A03	12468834	12469853	A03p27550.2_BraZ1	861	-	128	871	1019	0.8547596
A03	12480065	12481287	A03p27560.2_BraZ1	921	+	136	846	1222	0.6923077
A03	12482956	12483323	A03p27570.2_BraZ1	261	-	420	367	367	1.0000000
A03	12484686	12485904	A03p27580.2_BraZ1	121.2	-	36	222	1218	0.1822660
A03	12489693	12494134	A03p27590.2_BraZ1	2734.98	-	1995	4200	4441	0.9457330
A03	12494823	12495334	A03p27600.2_BraZ1	38.1	-	54	425	511	0.8317025
A03	12497083	12503573	A03p27610.2_BraZ1	2647.35	-	3441	5713	6490	0.8802773
A03	12510137	12510929	A03p27620.2_BraZ1	79.2	+	62	330	792	0.4166667
A03	12513813	12516342	A03p27630.2_BraZ1	1827.81	-	2475	2392	2529	0.9458284
A03	12520253	12520749	A03p27640.2_BraZ1	540	+	50	270	496	0.5443549
A03	12522276	12524876	A03p27650.2_BraZ1	1152.98	+	483	2457	2600	0.9450000
A03	12526068	12529064	A03p27660.2_BraZ1	2091.25	-	589	2099	2996	0.7006008
A03	12530145	12534678	A03p27670.2_BraZ1	2579.6	-	584	2913	4533	0.6426208
A03	12538442	12539323	A03p27680.2_BraZ1	801	-	306	881	881	1.0000000
A03	12540749	12545130	A03p27690.2_BraZ1	3026.77	-	401	2369	4381	0.5407441
A03	12546809	12547761	A03p27700.2_BraZ1	632.739	+	1224	952	952	1.0000000
A03	12548859	12550764	A03p27710.2_BraZ1	1410	+	600	1745	1905	0.9160105
A03	12553404	12556278	A03p27720.2_BraZ1	1495.14	+	1023	2765	2874	0.9620737
A03	12557743	12559830	A03p27730.2_BraZ1	1290	-	696	1727	2087	0.8275036
A03	12561335	12562258	A03p27740.2_BraZ1	264	+	845	923	923	1.0000000
A03	12563110	12565155	A03p27750.2_BraZ1	934.12	-	422	1996	2045	0.9760391
A03	12572314	12574277	A03p27760.2_BraZ1	1161.64	+	480	1862	1963	0.9485481
A03	12576511	12577099	A03p27770.2_BraZ1	58.8	+	132	321	588	0.5459183
A03	12582074	12582991	A03p27780.2_BraZ1	463.227	+	235	764	917	0.8331516
A03	12585320	12587226	A03p27790.2_BraZ1	771.179	+	648	1644	1906	0.8625394
A03	12589276	12590446	A03p27800.2_BraZ1	117	-	259	907	1170	0.7752137
A03	12594777	12595119	A03p27810.2_BraZ1	34.2	+	5	17	342	0.0497076
A03	12599182	12599928	A03p27820.2_BraZ1	177	-	735	746	746	1.0000000
A03	12601112	12602939	A03p27830.2_BraZ1	1012.68	+	186	1734	1827	0.9490969
A03	12606423	12607357	A03p27840.2_BraZ1	624	+	270	806	934	0.8629550
A03	12610575	12611825	A03p27850.2_BraZ1	633.026	+	311	1149	1250	0.9192000
A03	12618989	12619731	A03p27860.2_BraZ1	536.25	-	0	0	742	0.0000000
A03	12620773	12622431	A03p27870.2_BraZ1	1028.08	+	258	1466	1658	0.8841978
A03	12625907	12628124	A03p27880.2_BraZ1	2133	+	573	2038	2217	0.9192603
A03	12628361	12635536	A03p27890.2_BraZ1	2509.93	+	1634	5336	7175	0.7436934
A03	12641605	12644590	A03p27900.2_BraZ1	298.5	+	1036	2724	2985	0.9125628
A03	12645866	12648759	A03p27910.2_BraZ1	1669.06	-	1178	2806	2893	0.9699274
A03	12650402	12654322	A03p27920.2_BraZ1	1665.91	-	2165	3484	3920	0.8887755
A03	12655892	12658638	A03p27930.2_BraZ1	1670.22	-	800	2431	2746	0.8852877
A03	12666325	12668847	A03p27940.2_BraZ1	1367.58	+	1105	2245	2522	0.8901665
A03	12669217	12670415	A03p27950.2_BraZ1	688.8	-	187	971	1198	0.8105175
A03	12675507	12677045	A03p27960.2_BraZ1	652.929	+	440	1503	1538	0.9772432
A03	12678572	12680119	A03p27970.2_BraZ1	1026	+	151	1123	1547	0.7259212
A03	12681695	12681997	A03p27980.2_BraZ1	210	+	190	302	302	1.0000000
A03	12687480	12688787	A03p27990.2_BraZ1	1041.43	+	180	596	1307	0.4560061
A03	12693009	12693498	A03p28000.2_BraZ1	48.9	+	79	433	489	0.8854806
A03	12697500	12698463	A03p28010.2_BraZ1	850.5	+	268	712	963	0.7393562
A03	12699177	12700126	A03p28020.2_BraZ1	8646	-	297	880	949	0.9272919
A03	12701491	12702912	A03p28030.2_BraZ1	615.286	+	1314	1421	1421	1.0000000
A03	12704046	12705328	A03p28040.2_BraZ1	1200	-	457	1282	1282	1.0000000
A03	12706826	12708060	A03p28050.2_BraZ1	2906.25	+	229	1179	1234	0.9554295
A03	12710300	12713798	A03p28060.2_BraZ1	2206.88	-	1275	3368	3498	0.9628359
A03	12715403	12717698	A03p28070.2_BraZ1	2079	-	227	1608	2295	0.7006536
A03	12721524	12723053	A03p28080.2_BraZ1	525.13	-	893	1478	1529	0.9666449
A03	12744864	12746551	A03p28090.2_BraZ1	1395	+	198	1083	1687	0.6419680
A03	12750823	12754543	A03p28100.2_BraZ1	1274.86	-	1197	2853	3720	0.7669355
A03	12778700	12782255	A03p28110.2_BraZ1	2035.19	-	1174	1706	3555	0.4798875
A03	12782335	12782621	A03p28120.2_BraZ1	222	-	460	286	286	1.0000000
A03	12786105	12791870	A03p28130.2_BraZ1	285.6	-	4675	5655	5765	0.9809194
A03	12792374	12792903	A03p28140.2_BraZ1	421.2	-	733	529	529	1.0000000
A03	12794309	12795295	A03p28150.2_BraZ1	399	+	466	982	986	0.9959432
A03	12796899	12801961	A03p28160.2_BraZ1	2460.86	+	1784	4603	5062	0.9093243
A03	12802778	12804240	A03p28170.2_BraZ1	720.614	+	275	1347	1462	0.9213406
A03	12805499	12805742	A03p28180.2_BraZ1	24.3	-	172	243	243	1.0000000
A03	12807834	12808851	A03p28190.2_BraZ1	804	+	427	934	1017	0.9183874
A03	12811319	12812532	A03p28200.2_BraZ1	825	-	570	1011	1213	0.8334708
A03	12814263	12816711	A03p28210.2_BraZ1	1379.04	-	1032	2402	2448	0.9812092
A03	12818187	12818502	A03p28220.2_BraZ1	987	-	6	260	315	0.8253968
A03	12820743	12822649	A03p28230.2_BraZ1	1064.58	+	3	118	1906	0.0619098
A03	12824011	12825107	A03p28240.2_BraZ1	409.615	+	108	799	1096	0.7290146
A03	12829700	12831602	A03p28250.2_BraZ1	1405.25	-	2	46	1902	0.0241851
A03	12835014	12836664	A03p28260.2_BraZ1	1172.83	-	1348	1650	1650	1.0000000
A03	12842456	12842838	A03p28270.2_BraZ1	312	-	0	0	382	0.0000000
A03	12843117	12845011	A03p28280.2_BraZ1	1414.74	+	0	0	1894	0.0000000
A03	12848786	12849068	A03p28290.2_BraZ1	28.2	-	695	282	282	1.0000000
A03	12853667	12855566	A03p28300.2_BraZ1	1184	-	2	50	1899	0.0263296
A03	12855845	12856227	A03p28310.2_BraZ1	312	+	0	0	382	0.0000000
A03	12860950	12861172	A03p28320.2_BraZ1	22.2	+	105	222	222	1.0000000
A03	12870443	12871848	A03p28330.2_BraZ1	7029	-	512	1060	1405	0.7544484
A03	12875496	12876681	A03p28340.2_BraZ1	118.5	+	875	1185	1185	1.0000000
A03	12878279	12878824	A03p28350.2_BraZ1	480	+	167	545	545	1.0000000
A03	12879043	12880467	A03p28360.2_BraZ1	889.565	-	787	1424	1424	1.0000000
A03	12883166	12883475	A03p28370.2_BraZ1	30.9	-	0	0	309	0.0000000
A03	12887435	12887744	A03p28380.2_BraZ1	30.9	-	0	0	309	0.0000000
A03	12889463	12891143	A03p28390.2_BraZ1	168	-	105	1087	1680	0.6470238
A03	12893504	12897006	A03p28400.2_BraZ1	3087	-	316	2264	3502	0.6464877
A03	12899563	12900769	A03p28410.2_BraZ1	120.6	-	295	969	1206	0.8034826
A03	12905302	12906733	A03p28420.2_BraZ1	861.787	+	402	1331	1431	0.9301188
A03	12912678	12913623	A03p28430.2_BraZ1	94.5	+	88	508	945	0.5375661
A03	12915742	12917077	A03p28440.2_BraZ1	1206	+	365	1238	1335	0.9273408
A03	12920560	12921635	A03p28450.2_BraZ1	957	+	209	978	1075	0.9097674
A03	12922870	12924641	A03p28460.2_BraZ1	1001.92	-	275	1601	1771	0.9040090
A03	12925645	12929131	A03p28470.2_BraZ1	2763	+	1975	3348	3486	0.9604131
A03	12929987	12930483	A03p28480.2_BraZ1	266.175	-	264	496	496	1.0000000
A03	12936737	12940899	A03p28490.2_BraZ1	1655.75	+	644	3275	4162	0.7868813
A03	12941377	12942463	A03p28500.2_BraZ1	108.6	-	546	1086	1086	1.0000000
A03	12945100	12946201	A03p28510.2_BraZ1	110.1	-	96	626	1101	0.5685740
A03	12947490	12947871	A03p28520.2_BraZ1	38.1	+	436	381	381	1.0000000
A03	12954054	12955561	A03p28530.2_BraZ1	1013.29	-	836	1505	1507	0.9986728
A03	12955792	12956080	A03p28540.2_BraZ1	28.8	-	186	288	288	1.0000000
A03	12956621	12956984	A03p28550.2_BraZ1	36.3	-	47	253	363	0.6969697
A03	12959589	12960609	A03p28560.2_BraZ1	102	+	705	1020	1020	1.0000000
A03	12960773	12964496	A03p28570.2_BraZ1	2132.61	-	1520	3181	3723	0.8544185
A03	12967844	12970179	A03p28580.2_BraZ1	11591	+	955	2195	2335	0.9400429
A03	12971125	12971500	A03p28590.2_BraZ1	36.9	-	297	375	375	1.0000000
A03	12972812	12973979	A03p28600.2_BraZ1	116.7	+	97	543	1167	0.4652956
A03	12974494	12976866	A03p28610.2_BraZ1	1115.7	-	866	1560	2372	0.6576728
A03	12978275	12978612	A03p28620.2_BraZ1	23.7	-	236	337	337	1.0000000
A03	12979931	12980858	A03p28630.2_BraZ1	727.826	+	219	883	927	0.9525350
A03	12984480	12985399	A03p28640.2_BraZ1	282.857	+	97	793	919	0.8628945
A03	12986410	12987393	A03p28650.2_BraZ1	364.5	+	81	785	983	0.7985758
A03	12988582	12990999	A03p28660.2_BraZ1	1520.17	-	103	1013	2417	0.4191146
A03	12992772	12992970	A03p28670.2_BraZ1	19.8	-	315	198	198	1.0000000
A03	12995350	12995647	A03p28680.2_BraZ1	29.7	-	21	139	297	0.4680135
A03	13003798	13005550	A03p28690.2_BraZ1	1170.7	-	838	1629	1752	0.9297945
A03	13009812	13012249	A03p28700.2_BraZ1	1423.57	+	445	2205	2437	0.9048010
A03	13016472	13017049	A03p28710.2_BraZ1	300	-	275	553	577	0.9584056
A03	13019501	13020366	A03p28720.2_BraZ1	636	-	248	865	865	1.0000000
A03	13025257	13025525	A03p28730.2_BraZ1	201	+	285	268	268	1.0000000
A03	13033810	13035801	A03p28740.2_BraZ1	375	+	437	1991	1991	1.0000000
A03	13037171	13037876	A03p28750.2_BraZ1	70.5	-	98	667	705	0.9460993
A03	13039318	13040864	A03p28760.2_BraZ1	378	-	619	1546	1546	1.0000000
A03	13042734	13043997	A03p28770.2_BraZ1	1089	-	86	703	1263	0.5566112
A03	13046647	13048154	A03p28780.2_BraZ1	513.188	+	1013	1507	1507	1.0000000
A03	13049076	13051941	A03p28790.2_BraZ1	1277.49	+	1126	2179	2865	0.7605585
A03	13054450	13057152	A03p28800.2_BraZ1	1652.39	-	864	2507	2702	0.9278312
A03	13059826	13062121	A03p28810.2_BraZ1	357.5	+	2283	2295	2295	1.0000000
A03	13064391	13065589	A03p28820.2_BraZ1	337.395	+	900	1198	1198	1.0000000
A03	13066089	13067749	A03p28830.2_BraZ1	822.982	-	703	1649	1660	0.9933735
A03	13069656	13070808	A03p28840.2_BraZ1	573	+	536	1152	1152	1.0000000
A03	13072536	13072953	A03p28850.2_BraZ1	41.7	-	82	417	417	1.0000000
A03	13081342	13092493	A03p28860.2_BraZ1	780.686	-	6879	10085	11151	0.9044032
A03	13082821	13083117	A03p28870.2_BraZ1	186	+	362	296	296	1.0000000
A03	13086964	13087381	A03p28880.2_BraZ1	41.7	+	113	366	417	0.8776978
A03	13098325	13100541	A03p28890.2_BraZ1	1372.8	+	928	1852	2216	0.8357401
A03	13100811	13103026	A03p28900.2_BraZ1	1092.07	-	1073	2147	2215	0.9693002
A03	13105937	13106774	A03p28910.2_BraZ1	2000.1	+	910	837	837	1.0000000
A03	13107793	13110283	A03p28920.2_BraZ1	940.688	-	1164	2430	2490	0.9759036
A03	13112468	13113242	A03p28930.2_BraZ1	77.4	+	9	375	774	0.4844961
A03	13115691	13118198	A03p28940.2_BraZ1	1528.96	+	613	1877	2507	0.7487037
A03	13119150	13119745	A03p28950.2_BraZ1	59.4	+	180	549	595	0.9226891
A03	13120317	13121768	A03p28960.2_BraZ1	927.818	-	161	988	1451	0.6809097
A03	13122481	13123025	A03p28970.2_BraZ1	417	-	216	485	544	0.8915441
A03	13126324	13128559	A03p28980.2_BraZ1	2835	-	1752	2235	2235	1.0000000
A03	13134753	13135569	A03p28990.2_BraZ1	1140	+	451	783	816	0.9595588
A03	13136252	13136834	A03p29000.2_BraZ1	414	+	97	564	582	0.9690722
A03	13140838	13141173	A03p29010.2_BraZ1	28.2273	+	224	335	335	1.0000000
A03	13142587	13145210	A03p29020.2_BraZ1	1244.45	+	1515	2274	2623	0.8669462
A03	13147871	13149145	A03p29030.2_BraZ1	826.684	+	503	1272	1274	0.9984301
A03	13149431	13150983	A03p29040.2_BraZ1	450.439	-	340	1141	1552	0.7351804
A03	13156756	13163512	A03p29050.2_BraZ1	891.268	-	3742	6119	6756	0.9057134
A03	13171621	13172564	A03p29060.2_BraZ1	63	-	355	943	943	1.0000000
A03	13175995	13177440	A03p29070.2_BraZ1	983.357	+	355	1152	1445	0.7972319
A03	13180112	13180367	A03p29080.2_BraZ1	25.5	+	18	158	255	0.6196079
A03	13191765	13196793	A03p29090.2_BraZ1	1053	+	4152	4655	5028	0.9258155
A03	13198406	13202467	A03p29100.2_BraZ1	2230.86	-	1158	2561	4061	0.6306329
A03	13207428	13209336	A03p29110.2_BraZ1	1020	+	241	1502	1908	0.7872117
A03	13210037	13210670	A03p29120.2_BraZ1	222	+	728	633	633	1.0000000
A03	13210977	13211907	A03p29130.2_BraZ1	93	-	235	474	930	0.5096774
A03	13217462	13219551	A03p29140.2_BraZ1	1048.06	+	756	1846	2089	0.8836764
A03	13226578	13229639	A03p29150.2_BraZ1	1447.7	+	999	2819	3061	0.9209409
A03	13230330	13234751	A03p29160.2_BraZ1	5076	-	423	1702	4421	0.3849808
A03	13236113	13237347	A03p29170.2_BraZ1	724.5	+	240	1177	1234	0.9538087
A03	13244822	13251864	A03p29180.2_BraZ1	1090.4	-	3369	6617	7042	0.9396479
A03	13262405	13263311	A03p29190.2_BraZ1	90.6	+	42	603	906	0.6655629
A03	13265487	13269273	A03p29200.2_BraZ1	1080.81	-	1350	3350	3786	0.8848389
A03	13269724	13270393	A03p29210.2_BraZ1	98.0769	-	152	516	669	0.7713004
A03	13271594	13276531	A03p29220.2_BraZ1	3722.04	-	1033	2409	4937	0.4879481
A03	13282737	13285871	A03p29230.2_BraZ1	2084.79	-	4	507	3134	0.1617741
A03	13292965	13296155	A03p29240.2_BraZ1	1784.81	+	2044	3043	3190	0.9539185
A03	13299671	13300537	A03p29250.2_BraZ1	1117.93	-	0	0	866	0.0000000
A03	13301288	13304028	A03p29260.2_BraZ1	8493	-	1968	2516	2740	0.9182482
A03	13306366	13306673	A03p29270.2_BraZ1	29.7	-	6	41	307	0.1335505
A03	13314720	13316182	A03p29280.2_BraZ1	613.44	+	522	1360	1462	0.9302326
A03	13317795	13323563	A03p29290.2_BraZ1	3217.98	+	1896	4361	5768	0.7560679
A03	13324736	13325910	A03p29300.2_BraZ1	498	+	1076	1174	1174	1.0000000
A03	13329874	13333320	A03p29310.2_BraZ1	1532.52	-	1190	3169	3446	0.9196169
A03	13337284	13337512	A03p29320.2_BraZ1	22.8	-	32	228	228	1.0000000
A03	13338434	13341067	A03p29330.2_BraZ1	639.711	-	769	2325	2633	0.8830231
A03	13343464	13345939	A03p29340.2_BraZ1	3702.7	-	1559	2254	2475	0.9107071
A03	13347551	13348689	A03p29350.2_BraZ1	906	+	434	1110	1138	0.9753954
A03	13351324	13351582	A03p29360.2_BraZ1	25.8	+	104	258	258	1.0000000
A03	13353317	13355548	A03p29370.2_BraZ1	1440	+	778	2109	2231	0.9453160
A03	13359744	13367889	A03p29380.2_BraZ1	1764.95	+	2929	6610	8145	0.8115408
A03	13364438	13365536	A03p29390.2_BraZ1	109.8	+	53	383	1098	0.3488160
A03	13373360	13373622	A03p29400.2_BraZ1	19.2	+	189	262	262	1.0000000
A03	13375359	13376886	A03p29410.2_BraZ1	770.5	-	641	1454	1527	0.9521939
A03	13378418	13380045	A03p29420.2_BraZ1	682	+	705	1402	1627	0.8617086
A03	13380384	13382581	A03p29430.2_BraZ1	700.602	-	558	1992	2197	0.9066910
A03	13387831	13388236	A03p29440.2_BraZ1	40.5	-	296	405	405	1.0000000
A03	13389675	13390143	A03p29450.2_BraZ1	46.8	+	13	261	468	0.5576923
A03	13396232	13400117	A03p29460.2_BraZ1	2785.53	-	430	3259	3885	0.8388674
A03	13400241	13400394	A03p29470.2_BraZ1	15.3	-	70	153	153	1.0000000
A03	13405192	13407596	A03p29480.2_BraZ1	1281.8	+	780	2223	2404	0.9247088
A03	13409707	13416480	A03p29490.2_BraZ1	2586.86	+	1538	4295	6773	0.6341355
A03	13425430	13425901	A03p29500.2_BraZ1	219	-	56	471	471	1.0000000
A03	13433868	13434728	A03p29510.2_BraZ1	222	-	24	80	860	0.0930233
A03	13438791	13439784	A03p29520.2_BraZ1	739.8	+	200	855	993	0.8610272
A03	13443537	13444574	A03p29530.2_BraZ1	957	+	289	979	1037	0.9440694
A03	13445983	13447589	A03p29540.2_BraZ1	1110	-	205	1188	1606	0.7397260
A03	13455951	13465229	A03p29550.2_BraZ1	2312.69	-	4403	7951	9278	0.8569735
A03	13471277	13478254	A03p29560.2_BraZ1	2159.39	-	3095	6224	6977	0.8920739
A03	13481774	13482546	A03p29570.2_BraZ1	513	+	209	493	772	0.6386011
A03	13491050	13492721	A03p29580.2_BraZ1	813.733	+	832	1200	1671	0.7181329
A03	13495223	13496575	A03p29590.2_BraZ1	739.688	+	1068	1342	1352	0.9926035
A03	13505521	13507993	A03p29600.2_BraZ1	1178.31	-	77	1399	2472	0.5659385
A03	13510621	13512733	A03p29610.2_BraZ1	963	-	1573	1848	2112	0.8750000
A03	13513946	13518417	A03p29620.2_BraZ1	3411.36	-	39	136	4471	0.0304183
A03	13519049	13522990	A03p29630.2_BraZ1	3630	+	10	484	3941	0.1228115
A03	13524534	13526411	A03p29640.2_BraZ1	822.26	+	420	1294	1877	0.6893980
A03	13527303	13527641	A03p29650.2_BraZ1	240	-	103	338	338	1.0000000
A03	13528653	13532873	A03p29660.2_BraZ1	806.666	-	674	3180	4220	0.7535545
A03	13533856	13535514	A03p29670.2_BraZ1	3578.83	+	774	1658	1658	1.0000000
A03	13537663	13538821	A03p29680.2_BraZ1	115.8	-	222	1146	1158	0.9896373
A03	13539402	13539567	A03p29690.2_BraZ1	111	+	19	128	165	0.7757576
A03	13540621	13541290	A03p29700.2_BraZ1	66.9	-	121	573	669	0.8565022
A03	13543062	13543269	A03p29710.2_BraZ1	20.7	-	68	207	207	1.0000000
A03	13545046	13547092	A03p29720.2_BraZ1	1173	+	1472	1983	2046	0.9692082
A03	13550458	13551526	A03p29730.2_BraZ1	106.8	+	405	1068	1068	1.0000000
A03	13552492	13554511	A03p29740.2_BraZ1	4394.5	-	84	1110	2019	0.5497771
A03	13555584	13557563	A03p29750.2_BraZ1	5170	-	80	911	1979	0.4603335
A03	13562751	13563729	A03p29760.2_BraZ1	97.8	+	0	0	978	0.0000000
A03	13566741	13567719	A03p29770.2_BraZ1	97.8	+	1	91	978	0.0930470
A03	13570574	13571072	A03p29780.2_BraZ1	49.8	-	16	196	498	0.3935743
A03	13579664	13581777	A03p29790.2_BraZ1	534.678	-	105	945	2113	0.4472314
A03	13589526	13590602	A03p29800.2_BraZ1	219	-	137	779	1076	0.7239777
A03	13595360	13600038	A03p29810.2_BraZ1	1842.99	+	456	2777	4678	0.5936298
A03	13611040	13611634	A03p29820.2_BraZ1	51.6	-	48	399	594	0.6717172
A03	13618158	13618560	A03p29830.2_BraZ1	40.2	-	108	365	402	0.9079602
A03	13625472	13625874	A03p29840.2_BraZ1	40.2	-	103	402	402	1.0000000
A03	13628389	13629908	A03p29850.2_BraZ1	150	+	794	1445	1519	0.9512838
A03	13632823	13633207	A03p29860.2_BraZ1	38.4	+	47	336	384	0.8750000
A03	13639132	13639546	A03p29870.2_BraZ1	41.4	+	46	331	414	0.7995169
A03	13651323	13654116	A03p29880.2_BraZ1	2583	+	626	2166	2793	0.7755102
A03	13657485	13658847	A03p29890.2_BraZ1	1074	+	51	524	1362	0.3847283
A03	13665845	13666394	A03p29900.2_BraZ1	54.9	+	110	494	549	0.8998178
A03	13667620	13668415	A03p29910.2_BraZ1	11481	+	204	597	795	0.7509434
A03	13669708	13672576	A03p29920.2_BraZ1	1500.18	+	484	2082	2868	0.7259414
A03	13673743	13674139	A03p29930.2_BraZ1	39.6	-	271	396	396	1.0000000
A03	13676848	13677247	A03p29940.2_BraZ1	39.9	+	2	79	399	0.1979950
A03	13678194	13679479	A03p29950.2_BraZ1	741.391	+	635	1285	1285	1.0000000
A03	13680666	13681275	A03p29960.2_BraZ1	60.9	+	9	268	609	0.4400657
A03	13683857	13685304	A03p29970.2_BraZ1	984	+	657	1216	1447	0.8403594
A03	13685609	13686182	A03p29980.2_BraZ1	57.3	-	79	422	573	0.7364747
A03	13689239	13691754	A03p29990.2_BraZ1	132	+	2168	2215	2515	0.8807157
A03	13690616	13691228	A03p30000.2_BraZ1	61.2	-	26	391	612	0.6388889
A03	13693030	13694700	A03p30010.2_BraZ1	891.25	+	1300	1670	1670	1.0000000
A03	13695663	13698657	A03p30020.2_BraZ1	1504.92	+	945	2832	2994	0.9458918
A03	13702742	13706586	A03p30030.2_BraZ1	2135.45	+	748	2774	3844	0.7216441
A03	13706985	13708187	A03p30040.2_BraZ1	513.188	-	757	1188	1202	0.9883527
A03	13713546	13718154	A03p30050.2_BraZ1	2731.49	+	797	3049	4608	0.6616753
A03	13718230	13718929	A03p30060.2_BraZ1	546	-	108	619	699	0.8855508
A03	13722524	13724985	A03p30070.2_BraZ1	1492.17	+	120	1614	2461	0.6558310
A03	13728813	13731305	A03p30080.2_BraZ1	1405.98	+	259	1549	2492	0.6215891
A03	13732583	13733789	A03p30090.2_BraZ1	120.6	+	214	1124	1206	0.9320067
A03	13737316	13737621	A03p30100.2_BraZ1	288	-	152	305	305	1.0000000
A03	13738605	13742028	A03p30110.2_BraZ1	1733.33	+	2419	3190	3423	0.9319311
A03	13740166	13740499	A03p30120.2_BraZ1	33.3	-	6	119	333	0.3573574
A03	13745887	13748562	A03p30130.2_BraZ1	874.364	+	1048	2348	2675	0.8777570
A03	13753979	13757214	A03p30140.2_BraZ1	1392.93	+	365	2493	3235	0.7706337
A03	13764787	13765864	A03p30150.2_BraZ1	107.7	-	0	0	1077	0.0000000
A03	13767006	13769388	A03p30160.2_BraZ1	1240.53	+	143	1590	2382	0.6675063
A03	13772806	13775781	A03p30170.2_BraZ1	2005.66	+	2923	2711	2975	0.9112605
A03	13779994	13782547	A03p30180.2_BraZ1	1375.88	+	439	1411	2553	0.5526831
A03	13783831	13784272	A03p30190.2_BraZ1	44.1	-	14	289	441	0.6553288
A03	13787768	13789123	A03p30200.2_BraZ1	112.5	-	70	888	1355	0.6553506
A03	13792821	13797244	A03p30210.2_BraZ1	2755.07	+	1326	2952	4423	0.6674203
A03	13799791	13800209	A03p30220.2_BraZ1	258	+	119	397	418	0.9497608
A03	13801081	13801501	A03p30230.2_BraZ1	42	-	28	143	420	0.3404762
A03	13810054	13813672	A03p30240.2_BraZ1	1219.28	+	1000	3521	3618	0.9731896
A03	13815191	13815525	A03p30250.2_BraZ1	51.2727	-	568	245	334	0.7335329
A03	13815560	13816658	A03p30260.2_BraZ1	615.682	-	1612	1098	1098	1.0000000
A03	13817860	13818550	A03p30270.2_BraZ1	420.75	+	199	655	690	0.9492754
A03	13821012	13825206	A03p30280.2_BraZ1	2179.79	-	1586	3815	4194	0.9096328
A03	13829952	13835159	A03p30290.2_BraZ1	1946.81	-	4639	5084	5207	0.9763780
A03	13836000	13841100	A03p30300.2_BraZ1	2458.8	-	3403	4409	5100	0.8645098
A03	13841672	13843641	A03p30310.2_BraZ1	9321	-	970	1735	1969	0.8811579
A03	13845956	13846658	A03p30320.2_BraZ1	551.917	+	141	702	702	1.0000000
A03	13848013	13848932	A03p30330.2_BraZ1	259.286	-	981	919	919	1.0000000
A03	13851978	13852257	A03p30340.2_BraZ1	27.9	-	62	224	279	0.8028674
A03	13858427	13860119	A03p30350.2_BraZ1	977.786	-	83	1192	1692	0.7044917
A03	13861434	13863563	A03p30360.2_BraZ1	1473.21	-	845	1961	2129	0.9210897
A03	13864872	13865992	A03p30370.2_BraZ1	4935	-	392	1084	1120	0.9678571
A03	13870042	13873093	A03p30380.2_BraZ1	781.818	-	233	2211	3051	0.7246804
A03	13876343	13877291	A03p30390.2_BraZ1	762	-	72	507	948	0.5348101
A03	13877723	13884000	A03p30400.2_BraZ1	2030.84	-	1667	4693	6277	0.7476501
A03	13881580	13882852	A03p30410.2_BraZ1	127.2	+	534	1215	1272	0.9551887
A03	13886310	13887097	A03p30420.2_BraZ1	641.727	+	533	787	787	1.0000000
A03	13892219	13893924	A03p30430.2_BraZ1	1125.9	+	1048	1705	1705	1.0000000
A03	13895930	13897655	A03p30440.2_BraZ1	172.5	+	198	1039	1725	0.6023188
A03	13898949	13902322	A03p30450.2_BraZ1	1386.81	+	474	2090	3373	0.6196265
A03	13908094	13910576	A03p30460.2_BraZ1	1746.64	+	130	1234	2482	0.4971797
A03	13911023	13911982	A03p30470.2_BraZ1	37.8	+	32	242	959	0.2523462
A03	13917233	13918478	A03p30480.2_BraZ1	856.364	-	192	1200	1245	0.9638554
A03	13923434	13923800	A03p30490.2_BraZ1	197.1	-	0	0	366	0.0000000
A03	13926440	13928032	A03p30500.2_BraZ1	630.583	-	641	1592	1592	1.0000000
A03	13929949	13933664	A03p30510.2_BraZ1	1965.99	+	1286	3540	3715	0.9528937
A03	13938508	13941607	A03p30520.2_BraZ1	1253.54	+	1229	2846	3099	0.9183608
A03	13945155	13947100	A03p30530.2_BraZ1	501	-	690	1739	1945	0.8940874
A03	13948479	13949775	A03p30540.2_BraZ1	881.5	-	85	1162	1296	0.8966050
A03	13951112	13953273	A03p30550.2_BraZ1	2412.67	-	653	1762	2161	0.8153632
A03	13955716	13956645	A03p30560.2_BraZ1	563.523	+	234	926	929	0.9967707
A03	13960207	13960864	A03p30570.2_BraZ1	261	-	53	639	657	0.9726027
A03	13961802	13963767	A03p30580.2_BraZ1	2896.77	-	179	1862	1965	0.9475827
A03	13968979	13969105	A03p30590.2_BraZ1	11.1	-	265	126	126	1.0000000
A03	13969413	13969863	A03p30600.2_BraZ1	273	-	284	450	450	1.0000000
A03	13970763	13973245	A03p30610.2_BraZ1	1761	+	650	2190	2482	0.8823529
A03	13975257	13978755	A03p30620.2_BraZ1	1195.98	-	304	2627	3498	0.7510006
A03	13981859	13982815	A03p30630.2_BraZ1	306.963	-	407	771	956	0.8064854
A03	13985321	13987230	A03p30640.2_BraZ1	1159.89	-	1029	1905	1909	0.9979047
A03	13990122	13992722	A03p30650.2_BraZ1	15825	-	900	2177	2600	0.8373077
A03	13997534	14002491	A03p30660.2_BraZ1	2474.73	+	1349	4125	4957	0.8321565
A03	14003578	14005176	A03p30670.2_BraZ1	8000	-	1983	1598	1598	1.0000000
A03	14006660	14009192	A03p30680.2_BraZ1	1283.5	+	2	168	2532	0.0663507
A03	14010367	14011279	A03p30690.2_BraZ1	91.2	+	40	560	912	0.6140351
A03	14015999	14017787	A03p30700.2_BraZ1	6642	-	247	1521	1788	0.8506711
A03	14023231	14025605	A03p30710.2_BraZ1	1213.82	+	914	2281	2374	0.9608256
A03	14028235	14029448	A03p30720.2_BraZ1	597	+	90	363	1213	0.2992580
A03	14034312	14035554	A03p30730.2_BraZ1	124.2	-	407	1232	1242	0.9919485
A03	14038643	14039618	A03p30740.2_BraZ1	909	-	119	847	975	0.8687180
A03	14040487	14043143	A03p30750.2_BraZ1	1289.52	+	752	1991	2656	0.7496235
A03	14043799	14046000	A03p30760.2_BraZ1	1245	-	1325	1827	2201	0.8300772
A03	14046952	14050935	A03p30770.2_BraZ1	2175.25	-	1895	2856	3983	0.7170475
A03	14052216	14053562	A03p30780.2_BraZ1	1017.92	-	348	1164	1346	0.8647845
A03	14054247	14056457	A03p30790.2_BraZ1	1100	-	1112	2164	2210	0.9791855
A03	14059743	14061437	A03p30800.2_BraZ1	300	+	1254	1694	1694	1.0000000
A03	14061590	14062972	A03p30810.2_BraZ1	880.65	+	1358	1382	1382	1.0000000
A03	14065810	14067917	A03p30820.2_BraZ1	563.077	+	531	1046	2107	0.4964404
A03	14068133	14068797	A03p30830.2_BraZ1	1294.12	-	467	664	664	1.0000000
A03	14070226	14071375	A03p30840.2_BraZ1	518.092	-	85	794	1149	0.6910357
A03	14075007	14076308	A03p30850.2_BraZ1	863.625	-	862	1301	1301	1.0000000
A03	14078063	14080225	A03p30860.2_BraZ1	1040.49	-	580	1727	2162	0.7987974
A03	14093304	14125704	A03p30870.2_BraZ1	1776.96	+	28081	32079	32400	0.9900926
A03	14100688	14100992	A03p30880.2_BraZ1	228	-	61	304	304	1.0000000
A03	14126861	14127779	A03p30890.2_BraZ1	42.6	+	326	918	918	1.0000000
A03	14130340	14130655	A03p30900.2_BraZ1	30.6	+	36	268	315	0.8507937
A03	14133247	14134615	A03p30910.2_BraZ1	136.8	+	182	1100	1368	0.8040935
A03	14139701	14143055	A03p30920.2_BraZ1	2545.3	+	650	3160	3354	0.9421586
A03	14144680	14145625	A03p30930.2_BraZ1	431.43	+	498	918	945	0.9714286
A03	14145821	14157968	A03p30940.2_BraZ1	6764.88	+	158	2187	12147	0.1800445
A03	14158257	14158404	A03p30950.2_BraZ1	120	+	77	147	147	1.0000000
A03	14161022	14161124	A03p30960.2_BraZ1	10.2	+	344	102	102	1.0000000
A03	14161863	14163006	A03p30970.2_BraZ1	114.3	-	926	1098	1143	0.9606299
A03	14165255	14166304	A03p30980.2_BraZ1	1952.75	+	795	999	1049	0.9523355
A03	14166952	14168915	A03p30990.2_BraZ1	906.343	+	781	1963	1963	1.0000000
A03	14169768	14178263	A03p31000.2_BraZ1	2030.96	-	5302	8185	8495	0.9635080
A03	14180328	14180448	A03p31010.2_BraZ1	12	-	168	120	120	1.0000000
A03	14182432	14183508	A03p31020.2_BraZ1	625.105	+	647	1076	1076	1.0000000
A03	14185731	14186833	A03p31030.2_BraZ1	611.429	+	485	1095	1102	0.9936479
A03	14187981	14189992	A03p31040.2_BraZ1	1398	-	127	895	2011	0.4450522
A03	14191842	14192175	A03p31050.2_BraZ1	33.3	+	416	333	333	1.0000000
A03	14194223	14200952	A03p31060.2_BraZ1	2813.72	+	1609	5654	6729	0.8402437
A03	14203998	14205031	A03p31070.2_BraZ1	440.932	+	1036	879	1033	0.8509197
A03	14207519	14209559	A03p31080.2_BraZ1	204	+	883	1819	2040	0.8916667
A03	14211064	14213092	A03p31090.2_BraZ1	202.8	+	663	1944	2028	0.9585799
A03	14214979	14216850	A03p31100.2_BraZ1	848.357	+	584	1683	1871	0.8995190
A03	14217649	14221391	A03p31110.2_BraZ1	1805.68	-	1801	3302	3742	0.8824158
A03	14222245	14223198	A03p31120.2_BraZ1	630	+	293	953	953	1.0000000
A03	14227548	14227959	A03p31130.2_BraZ1	41.1	-	394	379	411	0.9221411
A03	14228770	14229148	A03p31140.2_BraZ1	285	+	14	272	378	0.7195767
A03	14234839	14235525	A03p31150.2_BraZ1	49.8	-	184	612	686	0.8921283
A03	14238626	14239922	A03p31160.2_BraZ1	2490	+	659	1276	1296	0.9845679
A03	14240786	14241335	A03p31170.2_BraZ1	54.9	-	376	549	549	1.0000000
A03	14244003	14244950	A03p31180.2_BraZ1	536.471	+	505	947	947	1.0000000
A03	14247573	14249594	A03p31190.2_BraZ1	929.571	-	2059	2011	2021	0.9950520
A03	14251217	14254573	A03p31200.2_BraZ1	895.385	-	89	442	3356	0.1317044
A03	14259366	14265524	A03p31210.2_BraZ1	1016.29	+	1901	4907	6158	0.7968496
A03	14268010	14268421	A03p31220.2_BraZ1	183	-	936	411	411	1.0000000
A03	14273868	14274408	A03p31230.2_BraZ1	54	-	56	499	540	0.9240741
A03	14276867	14279587	A03p31240.2_BraZ1	1492.59	+	695	2278	2720	0.8375000
A03	14287458	14288635	A03p31250.2_BraZ1	1059	+	388	1177	1177	1.0000000
A03	14288733	14289096	A03p31260.2_BraZ1	36.3	-	522	363	363	1.0000000
A03	14292997	14294235	A03p31270.2_BraZ1	726.75	+	1484	1238	1238	1.0000000
A03	14295154	14297508	A03p31280.2_BraZ1	1473	+	2079	2354	2354	1.0000000
A03	14300808	14305439	A03p31290.2_BraZ1	3483.19	-	3026	4497	4631	0.9710646
A03	14310078	14311775	A03p31300.2_BraZ1	972.321	+	974	1697	1697	1.0000000
A03	14314833	14316913	A03p31310.2_BraZ1	1744.11	-	234	1677	2080	0.8062500
A03	14324094	14325713	A03p31320.2_BraZ1	571.607	-	681	1619	1619	1.0000000
A03	14326486	14333528	A03p31330.2_BraZ1	3757.1	-	4530	6583	7042	0.9348196
A03	14334301	14338127	A03p31340.2_BraZ1	2085.34	-	2123	3754	3826	0.9811814
A03	14339854	14341949	A03p31350.2_BraZ1	1502.08	+	298	1500	2095	0.7159904
A03	14342268	14342702	A03p31360.2_BraZ1	41.7	-	227	434	434	1.0000000
A03	14343355	14343865	A03p31370.2_BraZ1	315	-	118	388	510	0.7607843
A03	14353971	14356950	A03p31380.2_BraZ1	297.9	+	110	1112	2979	0.3732796
A03	14359491	14362887	A03p31390.2_BraZ1	1860.26	-	1011	3089	3396	0.9095995
A03	14364481	14365998	A03p31400.2_BraZ1	651.257	-	1446	1517	1517	1.0000000
A03	14366939	14369219	A03p31410.2_BraZ1	1506	+	760	2247	2280	0.9855263
A03	14370228	14370372	A03p31420.2_BraZ1	14.4	+	188	144	144	1.0000000
A03	14380477	14382573	A03p31430.2_BraZ1	1620	+	433	1500	2096	0.7156488
A03	14386137	14387352	A03p31440.2_BraZ1	642.955	+	385	1215	1215	1.0000000
A03	14388575	14390009	A03p31450.2_BraZ1	6570.67	+	348	1371	1434	0.9560670
A03	14393655	14396006	A03p31460.2_BraZ1	1444.5	-	2576	2351	2351	1.0000000
A03	14398402	14401252	A03p31470.2_BraZ1	1269.78	-	244	1809	2850	0.6347368
A03	14402530	14404067	A03p31480.2_BraZ1	947.286	+	1195	1537	1537	1.0000000
A03	14404357	14405881	A03p31490.2_BraZ1	591	-	1755	1524	1524	1.0000000
A03	14406441	14407395	A03p31500.2_BraZ1	363.143	+	194	808	954	0.8469602
A03	14407494	14407911	A03p31510.2_BraZ1	41.7	-	188	417	417	1.0000000
A03	14408988	14411243	A03p31520.2_BraZ1	16947.6	-	266	916	2255	0.4062084
A03	14413100	14415035	A03p31530.2_BraZ1	1259.6	+	858	1907	1935	0.9855297
A03	14415863	14417916	A03p31540.2_BraZ1	195.3	+	127	1591	2053	0.7749634
A03	14424339	14425521	A03p31550.2_BraZ1	118.2	+	39	115	1182	0.0972927
A03	14426775	14432097	A03p31560.2_BraZ1	2751.15	+	1310	2783	5322	0.5229237
A03	14432235	14433844	A03p31570.2_BraZ1	299.376	-	849	1219	1609	0.7576134
A03	14437294	14438761	A03p31580.2_BraZ1	146.7	+	123	815	1467	0.5555556
A03	14444507	14444645	A03p31590.2_BraZ1	13.8	+	246	138	138	1.0000000
A03	14445675	14446958	A03p31600.2_BraZ1	7080	+	807	1010	1283	0.7872174
A03	14451029	14452597	A03p31610.2_BraZ1	9652.5	+	548	1568	1568	1.0000000
A03	14453388	14454614	A03p31620.2_BraZ1	768	-	1037	1074	1226	0.8760196
A03	14461037	14461445	A03p31630.2_BraZ1	38.1	+	83	408	408	1.0000000
A03	14473713	14475639	A03p31640.2_BraZ1	928.516	-	248	1294	1926	0.6718588
A03	14481509	14481898	A03p31650.2_BraZ1	351	+	420	389	389	1.0000000
A03	14501109	14503099	A03p31660.2_BraZ1	1001.14	-	103	1297	1990	0.6517588
A03	14507976	14509811	A03p31670.2_BraZ1	909.078	-	53	512	1835	0.2790191
A03	14511865	14512056	A03p31680.2_BraZ1	12.9	-	238	191	191	1.0000000
A03	14514308	14514998	A03p31690.2_BraZ1	69	-	201	672	690	0.9739130
A03	14517933	14518284	A03p31700.2_BraZ1	192	+	0	0	351	0.0000000
A03	14518675	14521079	A03p31710.2_BraZ1	2256	+	555	1803	2404	0.7500000
A03	14522487	14524203	A03p31720.2_BraZ1	726.375	+	211	1529	1716	0.8910257
A03	14527614	14528332	A03p31730.2_BraZ1	327	-	394	718	718	1.0000000
A03	14529808	14530901	A03p31740.2_BraZ1	561	+	443	919	1093	0.8408051
A03	14532783	14533106	A03p31750.2_BraZ1	243	+	141	243	323	0.7523220
A03	14537985	14544544	A03p31760.2_BraZ1	1502.86	+	1732	5402	6559	0.8236012
A03	14546179	14548181	A03p31770.2_BraZ1	1400.43	+	1125	1945	2002	0.9715285
A03	14548683	14550184	A03p31780.2_BraZ1	750.857	-	922	1445	1501	0.9626915
A03	14551110	14551433	A03p31790.2_BraZ1	243	-	168	323	323	1.0000000
A03	14552593	14554459	A03p31800.2_BraZ1	1264.53	-	1283	1776	1866	0.9517685
A03	14557695	14560255	A03p31810.2_BraZ1	708	+	2220	2560	2560	1.0000000
A03	14559685	14561335	A03p31820.2_BraZ1	423.429	+	1967	1650	1650	1.0000000
A03	14562282	14569135	A03p31830.2_BraZ1	1787.4	+	3509	6674	6853	0.9738801
A03	14569718	14571476	A03p31840.2_BraZ1	1179.82	-	1557	1637	1758	0.9311718
A03	14575028	14575610	A03p31850.2_BraZ1	111	-	368	457	582	0.7852234
A03	14581760	14585713	A03p31860.2_BraZ1	2039.07	-	2240	3735	3953	0.9448520
A03	14587800	14588550	A03p31870.2_BraZ1	582	+	374	750	750	1.0000000
A03	14589650	14594607	A03p31880.2_BraZ1	2420.61	+	2002	4263	4957	0.8599960
A03	14602763	14603251	A03p31890.2_BraZ1	22.8	+	33	238	488	0.4877049
A03	14605895	14607332	A03p31900.2_BraZ1	143.7	-	43	653	1437	0.4544189
A03	14612508	14615059	A03p31910.2_BraZ1	1800	-	1040	2059	2551	0.8071344
A03	14618653	14620848	A03p31920.2_BraZ1	994.896	+	781	2195	2195	1.0000000
A03	14621645	14622467	A03p31930.2_BraZ1	82.2	-	46	577	822	0.7019465
A03	14631908	14633561	A03p31940.2_BraZ1	1056	+	397	1484	1653	0.8977616
A03	14636163	14637226	A03p31950.2_BraZ1	453.75	+	702	1063	1063	1.0000000
A03	14637751	14639790	A03p31960.2_BraZ1	1051.6	-	415	1485	2039	0.7282982
A03	14641463	14645859	A03p31970.2_BraZ1	2975.33	-	1492	3571	4396	0.8123294
A03	14648128	14649680	A03p31980.2_BraZ1	1208.57	-	695	1552	1552	1.0000000
A03	14650651	14653177	A03p31990.2_BraZ1	1337.52	+	847	2047	2526	0.8103721
A03	14653555	14658229	A03p32000.2_BraZ1	2466.56	-	2405	4317	4674	0.9236200
A03	14659247	14660587	A03p32010.2_BraZ1	476.437	-	851	1289	1340	0.9619403
A03	14661431	14663834	A03p32020.2_BraZ1	1160.79	+	994	2146	2403	0.8930504
A03	14665230	14667050	A03p32030.2_BraZ1	1093.95	+	753	1781	1820	0.9785714
A03	14667468	14669151	A03p32040.2_BraZ1	13299	-	621	1535	1683	0.9120618
A03	14670250	14671614	A03p32050.2_BraZ1	1350	-	1185	1364	1364	1.0000000
A03	14674764	14677391	A03p32060.2_BraZ1	1202.78	+	1444	2627	2627	1.0000000
A03	14677898	14680446	A03p32070.2_BraZ1	1794	+	540	2531	2548	0.9933281
A03	14684906	14689178	A03p32080.2_BraZ1	2108.66	+	569	3520	4272	0.8239700
A03	14690861	14693526	A03p32090.2_BraZ1	1386.24	+	1680	2649	2665	0.9939963
A03	14694430	14696596	A03p32100.2_BraZ1	1367.84	-	465	2074	2166	0.9575254
A03	14697797	14700946	A03p32110.2_BraZ1	2994	-	406	2871	3149	0.9117180
A03	14704790	14705277	A03p32120.2_BraZ1	478.8	+	55	456	487	0.9363450
A03	14706147	14708847	A03p32130.2_BraZ1	1361.67	-	1047	2575	2700	0.9537037
A03	14709915	14711006	A03p32140.2_BraZ1	255	+	751	1091	1091	1.0000000
A03	14712974	14716483	A03p32150.2_BraZ1	1700.72	+	988	3328	3509	0.9484184
A03	14717311	14718248	A03p32160.2_BraZ1	432	-	516	928	937	0.9903949
A03	14718596	14721843	A03p32170.2_BraZ1	1152.24	-	2887	3247	3247	1.0000000
A03	14722714	14724357	A03p32180.2_BraZ1	1320.14	+	308	1381	1643	0.8405356
A03	14730186	14740239	A03p32190.2_BraZ1	2885.68	+	1966	8089	10053	0.8046354
A03	14740715	14748905	A03p32200.2_BraZ1	5180.32	-	577	2613	8190	0.3190476
A03	14754236	14757158	A03p32210.2_BraZ1	2309.76	-	978	2455	2922	0.8401780
A03	14767918	14769202	A03p32220.2_BraZ1	25335.7	+	383	1266	1284	0.9859813
A03	14770322	14773266	A03p32230.2_BraZ1	1381.42	+	1057	2681	2944	0.9106658
A03	14773862	14779372	A03p32240.2_BraZ1	2195.56	-	1252	4203	5510	0.7627949
A03	14782740	14784002	A03p32250.2_BraZ1	602.375	+	25	835	1262	0.6616482
A03	14790925	14791567	A03p32260.2_BraZ1	55.8	+	244	522	642	0.8130841
A03	14795618	14798602	A03p32270.2_BraZ1	1151.42	-	821	2406	2984	0.8063003
A03	14820685	14821099	A03p32280.2_BraZ1	41.4	+	76	253	414	0.6111111
A03	14821542	14824013	A03p32290.2_BraZ1	1090.36	-	96	1469	2471	0.5944961
A03	14824446	14824798	A03p32300.2_BraZ1	249	+	318	352	352	1.0000000
A03	14825185	14826937	A03p32310.2_BraZ1	175.2	-	48	731	1752	0.4172374
A03	14827539	14828949	A03p32320.2_BraZ1	619.826	-	268	1038	1410	0.7361702
A03	14830675	14831192	A03p32330.2_BraZ1	42.6	-	28	174	517	0.3365571
A03	14831837	14832943	A03p32340.2_BraZ1	801	+	497	1106	1106	1.0000000
A03	14833414	14836358	A03p32350.2_BraZ1	2122.29	-	577	2846	2944	0.9667119
A03	14837983	14839225	A03p32360.2_BraZ1	777.143	-	786	1242	1242	1.0000000
A03	14839330	14840920	A03p32370.2_BraZ1	523.32	+	803	1590	1590	1.0000000
A03	14841863	14844458	A03p32380.2_BraZ1	2928.92	-	417	2137	2595	0.8235068
A03	14846205	14846583	A03p32390.2_BraZ1	37.8	-	56	312	378	0.8253968
A03	14847648	14847922	A03p32400.2_BraZ1	27.3	-	275	274	274	1.0000000
A03	14849627	14852607	A03p32410.2_BraZ1	2312.87	+	472	2277	2980	0.7640939
A03	14853500	14855312	A03p32420.2_BraZ1	698.952	+	312	1747	1812	0.9641280
A03	14855795	14856206	A03p32430.2_BraZ1	41.1	-	37	274	411	0.6666667
A03	14856886	14860158	A03p32440.2_BraZ1	2177.16	-	800	3053	3272	0.9330685
A03	14861481	14863670	A03p32450.2_BraZ1	1340.28	-	815	2087	2189	0.9534034
A03	14864994	14866671	A03p32460.2_BraZ1	985.903	-	595	1595	1677	0.9511032
A03	14870529	14873737	A03p32470.2_BraZ1	1941.19	-	1397	2957	3208	0.9217581
A03	14874694	14879353	A03p32480.2_BraZ1	1564.34	-	1779	4545	4659	0.9755312
A03	14879853	14883006	A03p32490.2_BraZ1	2018.32	+	827	2027	3153	0.6428798
A03	14883838	14885738	A03p32500.2_BraZ1	1025.89	+	611	1803	1900	0.9489474
A03	14886527	14889545	A03p32510.2_BraZ1	1851.61	+	576	2374	3018	0.7866136
A03	14891378	14892285	A03p32520.2_BraZ1	599.739	+	83	795	907	0.8765160
A03	14892919	14895511	A03p32530.2_BraZ1	1493.87	+	412	2528	2592	0.9753087
A03	14896101	14897064	A03p32540.2_BraZ1	138	+	100	780	963	0.8099688
A03	14898381	14898773	A03p32550.2_BraZ1	279	+	87	392	392	1.0000000
A03	14899290	14900299	A03p32560.2_BraZ1	348.975	+	278	1008	1009	0.9990089
A03	14900846	14901911	A03p32570.2_BraZ1	106.5	-	595	1065	1065	1.0000000
A03	14902696	14903365	A03p32580.2_BraZ1	11356.5	+	270	669	669	1.0000000
A03	14905857	14912773	A03p32590.2_BraZ1	2462.59	+	1753	6311	6916	0.9125217
A03	14914366	14915454	A03p32600.2_BraZ1	809.978	+	440	1088	1088	1.0000000
A03	14916107	14917665	A03p32610.2_BraZ1	707.889	-	957	1558	1558	1.0000000
A03	14918666	14920635	A03p32620.2_BraZ1	15104	+	248	1170	1969	0.5942103
A03	14923635	14926631	A03p32630.2_BraZ1	1252.69	+	902	1885	2996	0.6291722
A03	14927294	14927681	A03p32640.2_BraZ1	38.7	+	38	293	387	0.7571059
A03	14930256	14930862	A03p32650.2_BraZ1	60.6	+	150	570	606	0.9405941
A03	14932393	14932774	A03p32660.2_BraZ1	38.1	+	9	179	381	0.4698163
A03	14934579	14935217	A03p32670.2_BraZ1	420	-	415	638	638	1.0000000
A03	14935668	14936652	A03p32680.2_BraZ1	759	-	233	886	984	0.9004065
A03	14937720	14938348	A03p32690.2_BraZ1	2937	+	433	588	628	0.9363058
A03	14938740	14939495	A03p32700.2_BraZ1	2052	+	223	755	755	1.0000000
A03	14940955	14947925	A03p32710.2_BraZ1	2953.13	+	2379	6394	6970	0.9173601
A03	14955710	14958359	A03p32720.2_BraZ1	2461	+	1256	2179	2649	0.8225746
A03	14958626	14963694	A03p32730.2_BraZ1	2427.27	-	733	3910	5068	0.7715075
A03	14969775	14971772	A03p32740.2_BraZ1	144.667	-	467	1952	1997	0.9774662
A03	14971821	14974286	A03p32750.2_BraZ1	1072.11	-	670	2201	2465	0.8929006
A03	14975319	14976304	A03p32760.2_BraZ1	95.7	-	435	985	985	1.0000000
A03	14976828	14978963	A03p32770.2_BraZ1	1345.76	+	651	2102	2135	0.9845433
A03	14979465	14979829	A03p32780.2_BraZ1	27.9	-	166	364	364	1.0000000
A03	14979890	14982557	A03p32790.2_BraZ1	330	-	1067	1602	2667	0.6006749
A03	14986494	14987640	A03p32800.2_BraZ1	114.6	+	170	1102	1146	0.9616056
A03	14988645	14989467	A03p32810.2_BraZ1	82.2	-	308	822	822	1.0000000
A03	14997997	14998996	A03p32820.2_BraZ1	99.9	+	9	320	999	0.3203203
A03	15001621	15002782	A03p32830.2_BraZ1	116.1	+	286	1009	1161	0.8690784
A03	15003034	15006051	A03p32840.2_BraZ1	2475.37	-	353	2320	3017	0.7689758
A03	15011258	15012006	A03p32850.2_BraZ1	290.053	+	343	684	748	0.9144385
A03	15012547	15014603	A03p32860.2_BraZ1	1181.5	+	352	1707	2056	0.8302529
A03	15017731	15019753	A03p32870.2_BraZ1	562.175	+	398	1650	2022	0.8160238
A03	15025867	15026608	A03p32880.2_BraZ1	316.286	+	1106	741	741	1.0000000
A03	15028716	15030871	A03p32890.2_BraZ1	1418.88	-	675	2147	2155	0.9962877
A03	15034732	15038175	A03p32900.2_BraZ1	1771.76	+	3008	3443	3443	1.0000000
A03	15040171	15041960	A03p32910.2_BraZ1	1721.02	+	127	428	1789	0.2392398
A03	15045945	15047720	A03p32920.2_BraZ1	1790.25	+	239	983	1775	0.5538028
A03	15048038	15049159	A03p32930.2_BraZ1	1074	-	227	1072	1121	0.9562891
A03	15050185	15050968	A03p32940.2_BraZ1	687	-	1031	783	783	1.0000000
A03	15052090	15056403	A03p32950.2_BraZ1	1751.69	+	2853	4309	4313	0.9990726
A03	15058064	15059541	A03p32960.2_BraZ1	1332	+	476	1417	1477	0.9593771
A03	15060512	15060924	A03p32970.2_BraZ1	210	+	201	412	412	1.0000000
A03	15061534	15063493	A03p32980.2_BraZ1	195.9	+	835	1932	1959	0.9862174
A03	15071908	15072049	A03p32990.2_BraZ1	14.1	-	50	141	141	1.0000000
A03	15076486	15080260	A03p33000.2_BraZ1	7509.38	+	686	2967	3774	0.7861685
A03	15080675	15081720	A03p33010.2_BraZ1	746.7	-	169	1045	1045	1.0000000
A03	15082798	15085525	A03p33020.2_BraZ1	1189.11	-	863	2423	2727	0.8885222
A03	15086179	15087051	A03p33030.2_BraZ1	783	-	246	872	872	1.0000000
A03	15089330	15090136	A03p33040.2_BraZ1	608	+	340	775	806	0.9615384
A03	15092938	15101777	A03p33050.2_BraZ1	1053.05	+	2730	6753	8839	0.7640005
A03	15102285	15103897	A03p33060.2_BraZ1	1094.76	+	715	1260	1612	0.7816377
A03	15104848	15107204	A03p33070.2_BraZ1	1893	+	1135	2271	2356	0.9639219
A03	15107304	15108190	A03p33080.2_BraZ1	801	-	181	822	886	0.9277653
A03	15109926	15111836	A03p33090.2_BraZ1	1102.5	-	817	1730	1910	0.9057592
A03	15113386	15116221	A03p33100.2_BraZ1	2230.8	-	851	2800	2835	0.9876543
A03	15116933	15118203	A03p33110.2_BraZ1	501	-	1373	1270	1270	1.0000000
A03	15118805	15120834	A03p33120.2_BraZ1	799.855	-	1313	1993	2029	0.9822572
A03	15122066	15123067	A03p33130.2_BraZ1	500.286	-	393	1001	1001	1.0000000
A03	15125492	15127715	A03p33140.2_BraZ1	1648.81	-	129	1332	2223	0.5991903
A03	15129246	15130921	A03p33150.2_BraZ1	682.688	+	665	1639	1675	0.9785075
A03	15131767	15132586	A03p33160.2_BraZ1	81.9	+	38	128	819	0.1562882
A03	15134707	15135814	A03p33170.2_BraZ1	110.7	+	73	1052	1107	0.9503162
A03	15135863	15140103	A03p33180.2_BraZ1	2158	-	1351	3586	4240	0.8457547
A03	15141913	15146302	A03p33190.2_BraZ1	1469.21	-	1764	3418	4389	0.7787651
A03	15148932	15150869	A03p33200.2_BraZ1	1368	+	929	1890	1937	0.9757357
A03	15152577	15156204	A03p33210.2_BraZ1	1404.42	-	2010	3627	3627	1.0000000
A03	15157652	15167362	A03p33220.2_BraZ1	1113.19	-	2738	4997	9710	0.5146241
A03	15167509	15167686	A03p33230.2_BraZ1	117	+	230	177	177	1.0000000
A03	15168342	15170209	A03p33240.2_BraZ1	357	-	241	1571	1867	0.8414569
A03	15170573	15170966	A03p33250.2_BraZ1	39.3	+	68	393	393	1.0000000
A03	15171190	15171415	A03p33260.2_BraZ1	22.5	-	74	203	225	0.9022222
A03	15172742	15173422	A03p33270.2_BraZ1	459	+	8	302	680	0.4441176
A03	15175723	15176113	A03p33280.2_BraZ1	39	-	0	0	390	0.0000000
A03	15177023	15177380	A03p33290.2_BraZ1	35.7	+	330	357	357	1.0000000
A03	15177870	15178122	A03p33300.2_BraZ1	25.2	+	314	252	252	1.0000000
A03	15178839	15180954	A03p33310.2_BraZ1	1512	-	395	1422	2115	0.6723405
A03	15182120	15183457	A03p33320.2_BraZ1	715.364	-	208	1055	1337	0.7890800
A03	15184583	15185546	A03p33330.2_BraZ1	96.3	-	562	963	963	1.0000000
A03	15186725	15189786	A03p33340.2_BraZ1	1408.02	-	989	2894	3061	0.9454427
A03	15191104	15194352	A03p33350.2_BraZ1	1768.22	+	831	2484	3248	0.7647783
A03	15194968	15195628	A03p33360.2_BraZ1	66	-	75	489	660	0.7409091
A03	15196636	15198868	A03p33370.2_BraZ1	4738.5	-	202	968	2232	0.4336918
A03	15200819	15205634	A03p33380.2_BraZ1	2524.93	+	1551	4543	4815	0.9435099
A03	15239568	15240305	A03p33390.2_BraZ1	105.882	+	67	152	737	0.2062415
A03	15248247	15248986	A03p33400.2_BraZ1	414	-	292	670	739	0.9066306
A03	15249499	15249886	A03p33410.2_BraZ1	38.7	-	20	41	387	0.1059432
A03	15252490	15252800	A03p33420.2_BraZ1	210	-	66	268	310	0.8645161
A03	15259963	15260861	A03p33430.2_BraZ1	431.75	+	420	872	898	0.9710467
A03	15263123	15266097	A03p33440.2_BraZ1	425	-	1919	2736	2974	0.9199731
A03	15263782	15265754	A03p33450.2_BraZ1	921	+	1523	1943	1972	0.9852941
A03	15266188	15268041	A03p33460.2_BraZ1	564	+	429	1381	1853	0.7452779
A03	15268671	15268926	A03p33470.2_BraZ1	25.5	+	141	163	255	0.6392157
A03	15269268	15272299	A03p33480.2_BraZ1	2303.5	-	1623	2625	3031	0.8660508
A03	15274473	15275316	A03p33490.2_BraZ1	387	+	9	439	843	0.5207592
A03	15282301	15286092	A03p33500.2_BraZ1	1934.15	+	2133	3614	3791	0.9533105
A03	15286319	15286860	A03p33510.2_BraZ1	234	-	129	490	541	0.9057301
A03	15287058	15290332	A03p33520.2_BraZ1	1954.15	-	1222	2812	3274	0.8588882
A03	15292027	15292347	A03p33530.2_BraZ1	240	+	114	320	320	1.0000000
A03	15292992	15294603	A03p33540.2_BraZ1	802.56	+	890	1558	1611	0.9671012
A03	15295191	15297932	A03p33550.2_BraZ1	2442	-	262	2216	2741	0.8084641
A03	15300551	15303643	A03p33560.2_BraZ1	1496.03	+	740	2864	3092	0.9262613
A03	15304385	15306025	A03p33570.2_BraZ1	1414.7	+	342	1346	1640	0.8207317
A03	15306651	15306840	A03p33580.2_BraZ1	18.9	-	15	183	189	0.9682540
A03	15309626	15310516	A03p33590.2_BraZ1	315	-	84	601	890	0.6752809
A03	15311184	15312968	A03p33600.2_BraZ1	896.403	+	413	1608	1784	0.9013453
A03	15313887	15316226	A03p33610.2_BraZ1	27004	-	546	2024	2339	0.8653271
A03	15321571	15322012	A03p33620.2_BraZ1	44.1	-	271	441	441	1.0000000
A03	15323107	15323906	A03p33630.2_BraZ1	423	-	338	772	799	0.9662077
A03	15325655	15328387	A03p33640.2_BraZ1	405.395	-	1973	2732	2732	1.0000000
A03	15331156	15331561	A03p33650.2_BraZ1	291	+	262	405	405	1.0000000
A03	15332161	15333284	A03p33660.2_BraZ1	810	-	536	1115	1123	0.9928762
A03	15333864	15335055	A03p33670.2_BraZ1	119.1	-	194	797	1191	0.6691856
A03	15337692	15341826	A03p33680.2_BraZ1	970.984	+	3025	3906	4134	0.9448476
A03	15344615	15347060	A03p33690.2_BraZ1	1060	+	1179	2258	2445	0.9235174
A03	15347628	15350732	A03p33700.2_BraZ1	2044.29	-	1770	3032	3104	0.9768041
A03	15353404	15353842	A03p33710.2_BraZ1	498	-	293	438	438	1.0000000
A03	15358537	15359866	A03p33720.2_BraZ1	542.304	-	309	1261	1329	0.9488337
A03	15369384	15369957	A03p33730.2_BraZ1	57.3	-	19	263	573	0.4589878
A03	15372691	15375188	A03p33740.2_BraZ1	996.35	+	305	1901	2497	0.7613136
A03	15375393	15376479	A03p33750.2_BraZ1	64.2	-	352	1070	1086	0.9852670
A03	15377882	15380054	A03p33760.2_BraZ1	217.2	+	448	1654	2172	0.7615101
A03	15381821	15384439	A03p33770.2_BraZ1	1734	-	382	2409	2618	0.9201680
A03	15384954	15388353	A03p33780.2_BraZ1	1504	-	2558	3236	3399	0.9520447
A03	15389687	15390691	A03p33790.2_BraZ1	451.568	-	185	889	1004	0.8854582
A03	15392828	15394354	A03p33800.2_BraZ1	432	+	1000	1526	1526	1.0000000
A03	15395187	15397612	A03p33810.2_BraZ1	1061.38	+	1887	2360	2425	0.9731959
A03	15398091	15399198	A03p33820.2_BraZ1	966	-	674	1066	1107	0.9629630
A03	15400253	15401012	A03p33830.2_BraZ1	417	-	127	759	759	1.0000000
A03	15401870	15404229	A03p33840.2_BraZ1	1179.74	-	2352	2359	2359	1.0000000
A03	15405946	15407023	A03p33850.2_BraZ1	304.737	+	185	762	1077	0.7075209
A03	15407464	15410418	A03p33860.2_BraZ1	675.192	+	1436	2622	2954	0.8876100
A03	15411711	15412206	A03p33870.2_BraZ1	49.5	-	547	495	495	1.0000000
A03	15413483	15414188	A03p33880.2_BraZ1	423	-	115	552	705	0.7829787
A03	15415399	15416735	A03p33890.2_BraZ1	645	-	393	1236	1336	0.9251497
A03	15427058	15430085	A03p33900.2_BraZ1	1361.54	+	949	2760	3027	0.9117938
A03	15430547	15434439	A03p33910.2_BraZ1	1988.75	-	1842	3653	3892	0.9385920
A03	15435834	15438424	A03p33920.2_BraZ1	849.347	+	1591	2532	2590	0.9776062
A03	15439286	15440579	A03p33930.2_BraZ1	764.987	+	316	1199	1293	0.9273009
A03	15441293	15443705	A03p33940.2_BraZ1	1439.64	-	822	2320	2412	0.9618574
A03	15446268	15447600	A03p33950.2_BraZ1	376.25	+	108	664	1332	0.4984985
A03	15449475	15449841	A03p33960.2_BraZ1	261	+	74	366	366	1.0000000
A03	15454451	15458112	A03p33970.2_BraZ1	1586.85	+	1096	3340	3661	0.9123191
A03	15461012	15464076	A03p33980.2_BraZ1	866.552	+	1396	2536	3064	0.8276762
A03	15464280	15465329	A03p33990.2_BraZ1	3078	-	53	751	1049	0.7159199
A03	15465561	15467227	A03p34000.2_BraZ1	261.6	-	1114	1663	1666	0.9981993
A03	15467446	15467805	A03p34010.2_BraZ1	264	-	83	325	359	0.9052925
A03	15470234	15474684	A03p34020.2_BraZ1	880	+	2863	4382	4450	0.9847191
A03	15475071	15475996	A03p34030.2_BraZ1	401.2	-	438	907	925	0.9805405
A03	15477107	15478227	A03p34040.2_BraZ1	228.727	+	1353	1120	1120	1.0000000
A03	15478936	15482837	A03p34050.2_BraZ1	2229.61	-	1397	3733	3901	0.9569341
A03	15484692	15486382	A03p34060.2_BraZ1	990	+	451	1661	1690	0.9828402
A03	15487059	15489441	A03p34070.2_BraZ1	1441.56	-	527	1772	2382	0.7439127
A03	15489312	15490583	A03p34080.2_BraZ1	111	-	29	475	1271	0.3737215
A03	15492319	15493468	A03p34090.2_BraZ1	114.9	+	167	1004	1149	0.8738033
A03	15497800	15509983	A03p34100.2_BraZ1	960.955	+	4288	10962	12183	0.8997784
A03	15510901	15512437	A03p34110.2_BraZ1	453.6	+	382	1433	1536	0.9329427
A03	15513053	15514223	A03p34120.2_BraZ1	117	+	135	476	1170	0.4068376
A03	15516927	15517938	A03p34130.2_BraZ1	639	+	2	19	1011	0.0187933
A03	15518679	15520599	A03p34140.2_BraZ1	777	-	118	1268	1920	0.6604167
A03	15520931	15521649	A03p34150.2_BraZ1	420	-	9	179	718	0.2493036
A03	15522898	15524415	A03p34160.2_BraZ1	832.673	-	636	1441	1517	0.9499011
A03	15525214	15526671	A03p34170.2_BraZ1	899.786	-	232	1338	1457	0.9183253
A03	15527579	15532653	A03p34180.2_BraZ1	540.443	-	2167	4919	5074	0.9694521
A03	15534744	15537640	A03p34190.2_BraZ1	1348.64	+	185	1393	2896	0.4810083
A03	15539591	15544136	A03p34200.2_BraZ1	1299.31	+	1063	4159	4545	0.9150715
A03	15544381	15547124	A03p34210.2_BraZ1	2386.25	-	643	2306	2743	0.8406854
A03	15550249	15550562	A03p34220.2_BraZ1	240	+	320	313	313	1.0000000
A03	15560698	15561025	A03p34230.2_BraZ1	249	+	39	309	327	0.9449542
A03	15561531	15561888	A03p34240.2_BraZ1	35.7	+	21	304	357	0.8515406
A03	15563070	15565442	A03p34250.2_BraZ1	1235.85	+	402	2069	2372	0.8722597
A03	15566333	15569143	A03p34260.2_BraZ1	467.171	+	2231	2484	2810	0.8839858
A03	15568688	15571461	A03p34270.2_BraZ1	816.98	+	1882	2637	2773	0.9509556
A03	15572426	15574691	A03p34280.2_BraZ1	1512.28	+	650	2059	2265	0.9090508
A03	15575850	15576319	A03p34290.2_BraZ1	375	+	77	389	469	0.8294243
A03	15577212	15579078	A03p34300.2_BraZ1	2782.67	-	443	1837	1866	0.9844587
A03	15580461	15581344	A03p34310.2_BraZ1	517.565	+	204	869	883	0.9841450
A03	15581805	15584226	A03p34320.2_BraZ1	19125	-	243	1792	2421	0.7401900
A03	15585503	15586885	A03p34330.2_BraZ1	711.02	+	622	1239	1382	0.8965268
A03	15588109	15591111	A03p34340.2_BraZ1	2342.73	+	1410	2908	3002	0.9686875
A03	15592290	15595848	A03p34350.2_BraZ1	16410	-	3606	3558	3558	1.0000000
A03	15599128	15600046	A03p34360.2_BraZ1	522	-	270	555	918	0.6045752
A03	15603622	15604180	A03p34370.2_BraZ1	477	-	124	417	558	0.7473118
A03	15604320	15627873	A03p34380.2_BraZ1	8692.17	-	10551	21369	23553	0.9072729
A03	15628992	15630378	A03p34390.2_BraZ1	775	-	774	1369	1386	0.9877345
A03	15636732	15639342	A03p34400.2_BraZ1	1099.42	-	189	977	2610	0.3743295
A03	15641838	15642287	A03p34410.2_BraZ1	267	+	84	449	449	1.0000000
A03	15647488	15648055	A03p34420.2_BraZ1	56.7	+	27	213	567	0.3756614
A03	15651642	15654067	A03p34430.2_BraZ1	1215.96	+	782	2166	2425	0.8931959
A03	15655101	15656230	A03p34440.2_BraZ1	322.964	+	191	857	1129	0.7590789
A03	15659505	15659778	A03p34450.2_BraZ1	27.3	+	1	64	273	0.2344322
A03	15662269	15663106	A03p34460.2_BraZ1	486	+	281	837	837	1.0000000
A03	15664346	15664617	A03p34470.2_BraZ1	165	-	327	271	271	1.0000000
A03	15666546	15666818	A03p34480.2_BraZ1	168	-	73	272	272	1.0000000
A03	15668965	15673442	A03p34490.2_BraZ1	1989.98	-	1677	4048	4477	0.9041769
A03	15676252	15677139	A03p34500.2_BraZ1	657	+	175	665	887	0.7497181
A03	15677927	15678257	A03p34510.2_BraZ1	33	-	46	303	330	0.9181818
A03	15679777	15680104	A03p34520.2_BraZ1	32.7	-	69	327	327	1.0000000
A03	15681920	15684788	A03p34530.2_BraZ1	1556.8	+	947	2431	2868	0.8476290
A03	15686113	15687011	A03p34540.2_BraZ1	5985	+	181	883	898	0.9832962
A03	15690507	15694372	A03p34550.2_BraZ1	3142.29	-	4650	3865	3865	1.0000000
A03	15695916	15698614	A03p34560.2_BraZ1	1205.53	-	603	2435	2698	0.9025204
A03	15699844	15704873	A03p34570.2_BraZ1	1972.19	-	1930	4298	5029	0.8546430
A03	15714617	15724948	A03p34580.2_BraZ1	792	+	322	4123	10331	0.3990901
A03	15731355	15732192	A03p34590.2_BraZ1	83.7	+	380	791	837	0.9450418
A03	15746498	15747466	A03p34600.2_BraZ1	330.214	-	671	913	968	0.9431818
A03	15748163	15748724	A03p34610.2_BraZ1	912	-	309	554	561	0.9875223
A03	15749435	15749812	A03p34620.2_BraZ1	35.1	+	485	377	377	1.0000000
A03	15753962	15754488	A03p34630.2_BraZ1	5328	-	569	526	526	1.0000000
A03	15756452	15758725	A03p34640.2_BraZ1	1265.54	-	589	1927	2273	0.8477783
A03	15763707	15764871	A03p34650.2_BraZ1	624	+	91	699	1164	0.6005155
A03	15765480	15767105	A03p34660.2_BraZ1	1428	-	82	984	1625	0.6055385
A03	15768584	15770345	A03p34670.2_BraZ1	176.1	-	911	1704	1761	0.9676321
A03	15772582	15774411	A03p34680.2_BraZ1	12322	+	284	1406	1829	0.7687261
A03	15775332	15775848	A03p34690.2_BraZ1	51.6	+	261	445	516	0.8624031
A03	15775883	15776447	A03p34700.2_BraZ1	477	+	624	564	564	1.0000000
A03	15777496	15778714	A03p34710.2_BraZ1	121.8	+	362	1218	1218	1.0000000
A03	15781705	15782281	A03p34720.2_BraZ1	258	-	286	576	576	1.0000000
A03	15789422	15790463	A03p34730.2_BraZ1	104.1	-	104	821	1041	0.7886648
A03	15792470	15793621	A03p34740.2_BraZ1	11182.5	+	302	1144	1151	0.9939184
A03	15794770	15802675	A03p34750.2_BraZ1	4297.86	-	3125	6522	7905	0.8250474
A03	15803082	15804971	A03p34760.2_BraZ1	882.984	+	930	1758	1889	0.9306511
A03	15809009	15811559	A03p34770.2_BraZ1	1170.54	+	1174	2360	2550	0.9254902
A03	15811954	15818978	A03p34780.2_BraZ1	2264.02	-	3743	6877	7024	0.9790717
A03	15820278	15822584	A03p34790.2_BraZ1	1292.44	-	2220	2295	2306	0.9952298
A03	15828268	15829594	A03p34800.2_BraZ1	478.929	-	1114	1326	1326	1.0000000
A03	15830152	15830484	A03p34810.2_BraZ1	279	-	309	332	332	1.0000000
A03	15830976	15834387	A03p34820.2_BraZ1	1895.86	-	1566	3367	3411	0.9871005
A03	15837676	15838513	A03p34830.2_BraZ1	83.7	+	150	803	837	0.9593787
A03	15839139	15842998	A03p34840.2_BraZ1	3162	-	507	2086	3859	0.5405545
A03	15844007	15846086	A03p34850.2_BraZ1	1099.29	-	508	2078	2079	0.9995190
A03	15852981	15854807	A03p34860.2_BraZ1	849.643	+	214	1644	1826	0.9003286
A03	15861815	15862450	A03p34870.2_BraZ1	177	-	43	232	635	0.3653543
A03	15865070	15876038	A03p34880.2_BraZ1	4818.95	+	1972	9613	10968	0.8764588
A03	15876322	15879625	A03p34890.2_BraZ1	1170	-	1070	2518	3303	0.7623373
A03	15881117	15881332	A03p34900.2_BraZ1	198	+	304	215	215	1.0000000
A03	15882744	15886278	A03p34910.2_BraZ1	1360.05	-	2547	3318	3534	0.9388794
A03	15887528	15891130	A03p34920.2_BraZ1	2244.24	+	1467	2856	3602	0.7928928
A03	15893753	15902009	A03p34930.2_BraZ1	813	-	3936	6251	8256	0.7571463
A03	15904643	15908003	A03p34940.2_BraZ1	1276.27	-	2096	3327	3360	0.9901786
A03	15908963	15909631	A03p34950.2_BraZ1	1404	+	78	598	668	0.8952096
A03	15911797	15914015	A03p34960.2_BraZ1	859.5	+	2207	2218	2218	1.0000000
A03	15917228	15923535	A03p34970.2_BraZ1	2426.68	-	3808	5719	6307	0.9067702
A03	15925031	15938973	A03p34980.2_BraZ1	262.098	-	2315	7860	13942	0.5637642
A03	15926083	15930764	A03p34990.2_BraZ1	2845.38	-	730	3684	4681	0.7870113
A03	15931639	15932990	A03p35000.2_BraZ1	92.7	-	318	1155	1351	0.8549223
A03	15941167	15942923	A03p35010.2_BraZ1	6697.5	+	1107	1736	1756	0.9886105
A03	15943388	15945576	A03p35020.2_BraZ1	1029.54	-	483	1798	2188	0.8217551
A03	15948184	15949404	A03p35030.2_BraZ1	681	-	787	1074	1220	0.8803279
A03	15951724	15952272	A03p35040.2_BraZ1	471	+	444	548	548	1.0000000
A03	15952538	15953571	A03p35050.2_BraZ1	4940	-	1756	1033	1033	1.0000000
A03	15954749	15957300	A03p35060.2_BraZ1	1734	+	439	2181	2551	0.8549588
A03	15957960	15960709	A03p35070.2_BraZ1	1385.28	-	1543	2716	2749	0.9879956
A03	15961582	15965817	A03p35080.2_BraZ1	2109.16	+	2108	4185	4235	0.9881936
A03	15966751	15967627	A03p35090.2_BraZ1	87.6	+	1565	876	876	1.0000000
A03	15969268	15974101	A03p35100.2_BraZ1	2710.57	-	1776	4575	4833	0.9466170
A03	15975911	15976292	A03p35110.2_BraZ1	38.1	+	7	188	381	0.4934383
A03	15977251	15980137	A03p35120.2_BraZ1	2793	+	744	2361	2886	0.8180873
A03	15980987	15983661	A03p35130.2_BraZ1	2262	-	333	1976	2674	0.7389678
A03	15984319	15986161	A03p35140.2_BraZ1	801.627	+	665	1632	1842	0.8859935
A03	15986529	15988402	A03p35150.2_BraZ1	839.437	-	448	859	1873	0.4586225
A03	15989588	15992854	A03p35160.2_BraZ1	828	+	2481	3266	3266	1.0000000
A03	15993455	15996278	A03p35170.2_BraZ1	1721.24	-	899	2605	2823	0.9227772
A03	15997637	15999581	A03p35180.2_BraZ1	934.457	-	1712	1944	1944	1.0000000
A03	15999708	16001194	A03p35190.2_BraZ1	572.559	+	853	1477	1486	0.9939435
A03	16001800	16004394	A03p35200.2_BraZ1	1372.05	-	1088	2594	2594	1.0000000
A03	16006006	16007934	A03p35210.2_BraZ1	1216.17	+	104	682	1928	0.3537344
A03	16009891	16011343	A03p35220.2_BraZ1	4576	+	1213	1452	1452	1.0000000
A03	16011920	16016435	A03p35230.2_BraZ1	2859.61	-	3294	4424	4515	0.9798450
A03	16016811	16017018	A03p35240.2_BraZ1	20.7	-	134	207	207	1.0000000
A03	16018732	16019746	A03p35250.2_BraZ1	101.4	+	686	1014	1014	1.0000000
A03	16023256	16024555	A03p35260.2_BraZ1	129.9	-	93	848	1299	0.6528099
A03	16027156	16027933	A03p35270.2_BraZ1	257.429	-	250	752	777	0.9678250
A03	16029582	16035638	A03p35280.2_BraZ1	609	+	3496	5504	6056	0.9088507
A03	16035936	16048595	A03p35290.2_BraZ1	4627.53	-	3800	8560	12659	0.6761988
A03	16057412	16058662	A03p35300.2_BraZ1	245.071	+	765	1250	1250	1.0000000
A03	16062353	16063226	A03p35310.2_BraZ1	659.375	+	110	489	873	0.5601375
A03	16063528	16064924	A03p35320.2_BraZ1	867	-	359	1237	1396	0.8861032
A03	16066839	16069163	A03p35330.2_BraZ1	1347	-	2248	2324	2324	1.0000000
A03	16072291	16073969	A03p35340.2_BraZ1	4494.75	-	420	1571	1678	0.9362336
A03	16075513	16078578	A03p35350.2_BraZ1	1911.09	-	1066	2868	3065	0.9357259
A03	16082877	16084633	A03p35360.2_BraZ1	1371	+	593	1520	1756	0.8656036
A03	16086819	16087189	A03p35370.2_BraZ1	261	-	537	370	370	1.0000000
A03	16095400	16096225	A03p35380.2_BraZ1	82.5	+	443	825	825	1.0000000
A03	16097069	16099672	A03p35390.2_BraZ1	1584.16	-	1268	2535	2603	0.9738763
A03	16102192	16102489	A03p35400.2_BraZ1	29.7	+	8	135	297	0.4545455
A03	16102886	16103198	A03p35410.2_BraZ1	31.2	-	2	20	312	0.0641026
A03	16105222	16106307	A03p35420.2_BraZ1	4590	-	78	812	1085	0.7483871
A03	16110183	16110645	A03p35430.2_BraZ1	46.2	+	19	349	462	0.7554113
A03	16111809	16112385	A03p35440.2_BraZ1	57.6	-	98	576	576	1.0000000
A03	16113375	16116385	A03p35450.2_BraZ1	876	-	1524	2943	3010	0.9777409
A03	16116641	16116749	A03p35460.2_BraZ1	10.8	-	238	108	108	1.0000000
A03	16117379	16119919	A03p35470.2_BraZ1	2223	-	1497	2540	2540	1.0000000
A03	16121356	16122580	A03p35480.2_BraZ1	2679	-	463	1068	1224	0.8725490
A03	16123296	16125018	A03p35490.2_BraZ1	708.267	+	462	1613	1722	0.9367015
A03	16126000	16127828	A03p35500.2_BraZ1	710.875	-	489	1661	1828	0.9086433
A03	16128398	16128677	A03p35510.2_BraZ1	27.9	-	213	279	279	1.0000000
A03	16130292	16131223	A03p35520.2_BraZ1	176.559	+	138	508	931	0.5456498
A03	16131510	16132256	A03p35530.2_BraZ1	417.529	-	152	699	746	0.9369973
A03	16133727	16135951	A03p35540.2_BraZ1	1080.29	+	1225	2086	2224	0.9379497
A03	16136490	16138307	A03p35550.2_BraZ1	726	+	1303	1817	1817	1.0000000
A03	16140764	16142206	A03p35560.2_BraZ1	1040	+	379	1035	1442	0.7177531
A03	16143750	16144625	A03p35570.2_BraZ1	673.918	+	249	875	875	1.0000000
A03	16147114	16147222	A03p35580.2_BraZ1	10.8	-	324	108	108	1.0000000
A03	16147369	16148323	A03p35590.2_BraZ1	577.688	-	246	954	954	1.0000000
A03	16149809	16151337	A03p35600.2_BraZ1	1425	+	149	1304	1528	0.8534032
A03	16153029	16154413	A03p35610.2_BraZ1	1148.4	-	204	816	1384	0.5895954
A03	16155928	16156810	A03p35620.2_BraZ1	88.2	+	1139	882	882	1.0000000
A03	16158202	16159839	A03p35630.2_BraZ1	1135.47	-	333	1374	1637	0.8393403
A03	16161727	16163768	A03p35640.2_BraZ1	1453.56	-	336	1062	2041	0.5203332
A03	16164569	16165487	A03p35650.2_BraZ1	571.371	+	679	918	918	1.0000000
A03	16168617	16169847	A03p35660.2_BraZ1	123	+	31	389	1230	0.3162602
A03	16172010	16173145	A03p35670.2_BraZ1	657.429	+	617	1135	1135	1.0000000
A03	16174068	16176320	A03p35680.2_BraZ1	1055.97	-	1426	2169	2252	0.9631439
A03	16177555	16177798	A03p35690.2_BraZ1	141	+	167	243	243	1.0000000
A03	16178268	16178882	A03p35700.2_BraZ1	133.2	-	328	614	614	1.0000000
A03	16183278	16185450	A03p35710.2_BraZ1	1128.99	+	120	1680	2172	0.7734807
A03	16186498	16189595	A03p35720.2_BraZ1	1641.14	+	310	1671	3097	0.5395544
A03	16193217	16195719	A03p35730.2_BraZ1	1297.58	+	670	1999	2502	0.7989608
A03	16196112	16203071	A03p35740.2_BraZ1	3375.89	-	3016	6640	6959	0.9541601
A03	16203487	16204152	A03p35750.2_BraZ1	342.136	+	282	665	665	1.0000000
A03	16204145	16205459	A03p35760.2_BraZ1	619.636	+	793	1305	1314	0.9931507
A03	16205832	16210350	A03p35770.2_BraZ1	1454.54	-	4231	4419	4518	0.9780877
A03	16221593	16226589	A03p35780.2_BraZ1	1468.04	-	1167	3279	4996	0.6563250
A03	16236647	16237878	A03p35790.2_BraZ1	10741.5	-	127	548	1231	0.4451665
A03	16241427	16242855	A03p35800.2_BraZ1	10323	-	897	1424	1428	0.9971989
A03	16243446	16243715	A03p35810.2_BraZ1	177	+	120	223	269	0.8289963
A03	16244702	16252787	A03p35820.2_BraZ1	4843.93	-	2247	6474	8085	0.8007421
A03	16254263	16254579	A03p35830.2_BraZ1	234	+	364	316	316	1.0000000
A03	16255503	16262712	A03p35840.2_BraZ1	2823.75	+	3261	6700	7209	0.9293938
A03	16263222	16265061	A03p35850.2_BraZ1	965.469	-	974	1807	1839	0.9825993
A03	16268844	16269283	A03p35860.2_BraZ1	246	-	677	439	439	1.0000000
A03	16271207	16274598	A03p35870.2_BraZ1	1657.98	+	1322	3191	3391	0.9410204
A03	16275679	16276951	A03p35880.2_BraZ1	127.2	+	389	1194	1272	0.9386792
A03	16279255	16279747	A03p35890.2_BraZ1	45.6	+	368	492	492	1.0000000
A03	16280721	16281914	A03p35900.2_BraZ1	479.118	-	451	961	1193	0.8055323
A03	16285071	16287176	A03p35910.2_BraZ1	840	+	1314	1728	2105	0.8209026
A03	16287567	16288429	A03p35920.2_BraZ1	516	+	56	696	862	0.8074246
A03	16289227	16289437	A03p35930.2_BraZ1	21	-	335	210	210	1.0000000
A03	16291531	16292729	A03p35940.2_BraZ1	547.371	-	1413	1198	1198	1.0000000
A03	16294532	16296092	A03p35950.2_BraZ1	4226.25	+	661	1547	1560	0.9916667
A03	16296490	16299088	A03p35960.2_BraZ1	1884.6	-	1021	2598	2598	1.0000000
A03	16303146	16304216	A03p35970.2_BraZ1	502.765	+	752	1070	1070	1.0000000
A03	16308641	16311348	A03p35980.2_BraZ1	1130.95	+	1560	2648	2707	0.9782047
A03	16312099	16313443	A03p35990.2_BraZ1	29.7	+	25	397	1344	0.2953869
A03	16320923	16321569	A03p36000.2_BraZ1	222	+	743	624	646	0.9659443
A03	16322601	16324666	A03p36010.2_BraZ1	1425	+	788	2063	2065	0.9990315
A03	16325933	16326557	A03p36020.2_BraZ1	465	+	551	624	624	1.0000000
A03	16329560	16331037	A03p36030.2_BraZ1	15873	-	719	1393	1477	0.9431280
A03	16332661	16333240	A03p36040.2_BraZ1	57.9	-	425	579	579	1.0000000
A03	16334113	16336740	A03p36050.2_BraZ1	1688.67	-	1091	2004	2627	0.7628474
A03	16337915	16338597	A03p36060.2_BraZ1	361.25	+	752	682	682	1.0000000
A03	16339123	16340986	A03p36070.2_BraZ1	186.3	-	402	1693	1863	0.9087493
A03	16341865	16342702	A03p36080.2_BraZ1	5587.5	-	605	837	837	1.0000000
A03	16342980	16345268	A03p36090.2_BraZ1	1188.41	+	1193	2085	2288	0.9112762
A03	16348062	16350655	A03p36100.2_BraZ1	2064	+	741	1925	2593	0.7423834
A03	16351869	16352205	A03p36110.2_BraZ1	240	+	13	217	336	0.6458333
A03	16352860	16353862	A03p36120.2_BraZ1	100.2	-	324	1002	1002	1.0000000
A03	16354299	16367691	A03p36130.2_BraZ1	517.8	-	6620	12523	13392	0.9351105
A03	16363266	16363575	A03p36140.2_BraZ1	30.9	-	96	194	309	0.6278317
A03	16373481	16373892	A03p36150.2_BraZ1	41.1	-	162	405	411	0.9854015
A03	16377780	16379383	A03p36160.2_BraZ1	997.642	-	2136	1603	1603	1.0000000
A03	16379950	16383086	A03p36170.2_BraZ1	1403	+	1392	2849	3136	0.9084821
A03	16383895	16385343	A03p36180.2_BraZ1	769.682	+	1076	1332	1448	0.9198895
A03	16386159	16388174	A03p36190.2_BraZ1	1493.33	-	785	1951	2015	0.9682382
A03	16389207	16389777	A03p36200.2_BraZ1	57	-	478	570	570	1.0000000
A03	16401089	16401425	A03p36210.2_BraZ1	33.6	+	91	336	336	1.0000000
A03	16408241	16411091	A03p36220.2_BraZ1	1347.5	+	558	1721	2850	0.6038597
A03	16412015	16412138	A03p36230.2_BraZ1	12.3	-	9	123	123	1.0000000
A03	16412190	16415731	A03p36240.2_BraZ1	492	-	1229	2967	3541	0.8378989
A03	16413819	16417589	A03p36250.2_BraZ1	1360.31	+	1125	3161	3770	0.8384615
A03	16417921	16419718	A03p36260.2_BraZ1	9576	-	754	1492	1797	0.8302727
A03	16420288	16421965	A03p36270.2_BraZ1	967.737	+	994	1677	1677	1.0000000
A03	16422469	16425309	A03p36280.2_BraZ1	907.98	+	609	2740	2840	0.9647887
A03	16431480	16433484	A03p36290.2_BraZ1	200.4	+	382	1704	2004	0.8502994
A03	16434695	16436759	A03p36300.2_BraZ1	206.4	+	634	1735	2064	0.8406008
A03	16438139	16438469	A03p36310.2_BraZ1	33	+	174	330	330	1.0000000
A03	16438565	16440360	A03p36320.2_BraZ1	1389.33	-	971	1795	1795	1.0000000
A03	16443074	16444355	A03p36330.2_BraZ1	128.1	+	722	1281	1281	1.0000000
A03	16445367	16448463	A03p36340.2_BraZ1	308.7	+	1018	2964	3096	0.9573643
A03	16449214	16451669	A03p36350.2_BraZ1	6132	+	691	1937	2455	0.7890021
A03	16452276	16454488	A03p36360.2_BraZ1	1098.07	+	1410	2178	2212	0.9846293
A03	16455108	16456149	A03p36370.2_BraZ1	104.1	-	414	1041	1041	1.0000000
A03	16461657	16463637	A03p36380.2_BraZ1	1145.4	-	593	1960	1980	0.9898990
A03	16465705	16472184	A03p36390.2_BraZ1	2917.71	+	2031	4936	6479	0.7618459
A03	16472920	16474735	A03p36400.2_BraZ1	861.818	-	1392	1815	1815	1.0000000
A03	16475412	16478653	A03p36410.2_BraZ1	1482.92	-	923	2774	3241	0.8559087
A03	16479166	16481315	A03p36420.2_BraZ1	100.5	+	515	2046	2149	0.9520707
A03	16482088	16483564	A03p36430.2_BraZ1	639.6	+	464	1248	1476	0.8455285
A03	16484108	16485419	A03p36440.2_BraZ1	1059.17	-	1156	1311	1311	1.0000000
A03	16485357	16485664	A03p36450.2_BraZ1	243	-	147	307	307	1.0000000
A03	16485696	16486248	A03p36460.2_BraZ1	267.3	-	93	552	552	1.0000000
A03	16488812	16491928	A03p36470.2_BraZ1	1374.58	+	1191	2943	3116	0.9444801
A03	16493984	16510178	A03p36480.2_BraZ1	4243.46	+	7712	13337	16194	0.8235766
A03	16511385	16511727	A03p36490.2_BraZ1	34.2	+	43	325	342	0.9502924
A03	16513382	16516169	A03p36500.2_BraZ1	597.767	-	2254	2787	2787	1.0000000
A03	16517941	16520670	A03p36510.2_BraZ1	1608	-	745	2645	2729	0.9692195
A03	16521729	16524817	A03p36520.2_BraZ1	1693.42	-	1136	2759	3088	0.8934585
A03	16528799	16530999	A03p36530.2_BraZ1	1736.42	+	1272	2200	2200	1.0000000
A03	16531692	16531806	A03p36540.2_BraZ1	11.4	+	67	114	114	1.0000000
A03	16534079	16535003	A03p36550.2_BraZ1	92.4	-	525	924	924	1.0000000
A03	16540482	16540602	A03p36560.2_BraZ1	12	-	262	120	120	1.0000000
A03	16546449	16547034	A03p36570.2_BraZ1	58.5	+	114	538	585	0.9196581
A03	16548533	16550366	A03p36580.2_BraZ1	357	+	921	1763	1833	0.9618112
A03	16551043	16555170	A03p36590.2_BraZ1	2293.98	-	2251	3967	4127	0.9612309
A03	16565411	16574284	A03p36600.2_BraZ1	2267.88	-	1254	5933	8873	0.6686577
A03	16575190	16578325	A03p36610.2_BraZ1	2320.92	+	783	2626	3135	0.8376396
A03	16578709	16579819	A03p36620.2_BraZ1	592.8	-	180	1049	1110	0.9450451
A03	16580093	16582885	A03p36630.2_BraZ1	1420.2	-	1078	2709	2792	0.9702722
A03	16584386	16585589	A03p36640.2_BraZ1	120.3	-	509	1158	1203	0.9625935
A03	16585781	16589452	A03p36650.2_BraZ1	369	-	2888	3621	3671	0.9863797
A03	16590672	16591937	A03p36660.2_BraZ1	1233	-	1099	1265	1265	1.0000000
A03	16593333	16594891	A03p36670.2_BraZ1	693	+	727	1360	1558	0.8729140
A03	16595427	16597957	A03p36680.2_BraZ1	1269	+	2108	2220	2530	0.8774704
A03	16599120	16602582	A03p36690.2_BraZ1	1350.4	+	854	3111	3462	0.8986135
A03	16606398	16606770	A03p36700.2_BraZ1	37.2	-	79	343	372	0.9220430
A03	16611584	16616120	A03p36710.2_BraZ1	1585.63	+	1381	3902	4536	0.8602293
A03	16618425	16620341	A03p36720.2_BraZ1	832.229	+	150	1395	1916	0.7280793
A03	16621848	16622670	A03p36730.2_BraZ1	82.2	+	377	666	822	0.8102190
A03	16622997	16624298	A03p36740.2_BraZ1	632.984	-	518	1301	1301	1.0000000
A03	16624961	16630057	A03p36750.2_BraZ1	3911.05	-	793	3789	5096	0.7435243
A03	16630959	16636255	A03p36760.2_BraZ1	2065.86	-	2178	5225	5296	0.9865937
A03	16637088	16642893	A03p36770.2_BraZ1	2705.37	-	3522	5706	5805	0.9829457
A03	16644665	16647301	A03p36780.2_BraZ1	1432.94	+	1119	2512	2636	0.9529590
A03	16647952	16651771	A03p36790.2_BraZ1	1417.33	-	2811	3810	3819	0.9976434
A03	16654657	16655068	A03p36800.2_BraZ1	41.1	+	301	411	411	1.0000000
A03	16661196	16661499	A03p36810.2_BraZ1	30.3	+	277	303	303	1.0000000
A03	16662131	16663576	A03p36820.2_BraZ1	8083.5	-	817	1445	1445	1.0000000
A03	16665141	16665603	A03p36830.2_BraZ1	321	+	0	0	462	0.0000000
A03	16668434	16669436	A03p36840.2_BraZ1	6270	+	769	998	1002	0.9960080
A03	16670795	16671437	A03p36850.2_BraZ1	64.2	-	463	642	642	1.0000000
A03	16673290	16673881	A03p36860.2_BraZ1	59.1	-	106	570	591	0.9644670
A03	16677390	16680193	A03p36870.2_BraZ1	1001.74	+	2332	2746	2803	0.9796646
A03	16683519	16683705	A03p36880.2_BraZ1	18.6	-	281	186	186	1.0000000
A03	16686874	16688917	A03p36890.2_BraZ1	1203.84	-	308	1123	2043	0.5496818
A03	16692078	16692424	A03p36900.2_BraZ1	31.5	+	89	339	346	0.9797688
A03	16693702	16695181	A03p36910.2_BraZ1	597	-	1137	1479	1479	1.0000000
A03	16697280	16698432	A03p36920.2_BraZ1	115.2	+	305	1044	1152	0.9062500
A03	16701088	16704941	A03p36930.2_BraZ1	161.538	+	2877	3472	3853	0.9011160
A03	16704960	16706327	A03p36940.2_BraZ1	1101.54	+	2326	1367	1367	1.0000000
A03	16707747	16710533	A03p36950.2_BraZ1	2163	-	653	2360	2786	0.8470926
A03	16711248	16713553	A03p36960.2_BraZ1	1533	-	388	2156	2305	0.9353579
A03	16715603	16716793	A03p36970.2_BraZ1	477	+	898	1190	1190	1.0000000
A03	16717492	16718144	A03p36980.2_BraZ1	384.75	-	59	427	652	0.6549080
A03	16719275	16727521	A03p36990.2_BraZ1	4816.79	-	5503	7236	8246	0.8775164
A03	16729049	16731323	A03p37000.2_BraZ1	1191.28	+	1900	2274	2274	1.0000000
A03	16732049	16733712	A03p37010.2_BraZ1	618.237	-	1629	1663	1663	1.0000000
A03	16736185	16741220	A03p37020.2_BraZ1	3249.64	-	4892	5031	5035	0.9992056
A03	16742480	16744700	A03p37030.2_BraZ1	7161.19	-	4472	2220	2220	1.0000000
A03	16753049	16754513	A03p37040.2_BraZ1	146.4	+	318	1165	1464	0.7957650
A03	16755664	16756645	A03p37050.2_BraZ1	366.632	+	1019	981	981	1.0000000
A03	16757288	16758934	A03p37060.2_BraZ1	854.681	-	411	1226	1646	0.7448360
A03	16763096	16765738	A03p37070.2_BraZ1	1497	-	1747	2621	2642	0.9920515
A03	16766566	16768816	A03p37080.2_BraZ1	225	+	748	1326	2250	0.5893334
A03	16771252	16771881	A03p37090.2_BraZ1	350	+	1048	629	629	1.0000000
A03	16772717	16774181	A03p37100.2_BraZ1	9292.5	+	704	1355	1464	0.9255465
A03	16776176	16776380	A03p37110.2_BraZ1	20.4	-	0	0	204	0.0000000
A03	16778397	16781628	A03p37120.2_BraZ1	1506	+	768	3194	3231	0.9885485
A03	16783523	16783772	A03p37130.2_BraZ1	24.9	+	0	0	249	0.0000000
A03	16785340	16787272	A03p37140.2_BraZ1	193.2	-	613	1862	1932	0.9637681
A03	16798708	16801637	A03p37150.2_BraZ1	700.235	+	3240	2929	2929	1.0000000
A03	16805282	16806344	A03p37160.2_BraZ1	462	-	80	885	1062	0.8333333
A03	16807293	16807881	A03p37170.2_BraZ1	58.8	+	269	588	588	1.0000000
A03	16808659	16810263	A03p37180.2_BraZ1	2621.86	-	1698	1604	1604	1.0000000
A03	16811741	16813004	A03p37190.2_BraZ1	389.2	-	1228	1263	1263	1.0000000
A03	16816753	16820686	A03p37200.2_BraZ1	2600.03	+	515	3398	3933	0.8639715
A03	16821348	16822344	A03p37210.2_BraZ1	601.63	+	263	996	996	1.0000000
A03	16822912	16825374	A03p37220.2_BraZ1	552	-	1194	2174	2462	0.8830220
A03	16827657	16829168	A03p37230.2_BraZ1	2755.12	-	348	1297	1511	0.8583719
A03	16833158	16833308	A03p37240.2_BraZ1	15	-	0	0	150	0.0000000
A03	16841703	16843353	A03p37250.2_BraZ1	6055.5	+	768	1649	1650	0.9993939
A03	16845245	16845769	A03p37260.2_BraZ1	435	+	535	524	524	1.0000000
A03	16850822	16851086	A03p37270.2_BraZ1	16.5	-	0	0	264	0.0000000
A03	16851699	16852059	A03p37280.2_BraZ1	36	+	32	103	360	0.2861111
A03	16853692	16856012	A03p37290.2_BraZ1	952.703	-	1882	2320	2320	1.0000000
A03	16856457	16858029	A03p37300.2_BraZ1	783.529	+	419	1430	1572	0.9096692
A03	16861454	16864327	A03p37310.2_BraZ1	1863.09	-	1391	2720	2873	0.9467456
A03	16864930	16867547	A03p37320.2_BraZ1	1427.71	-	1286	2539	2617	0.9701949
A03	16868795	16870618	A03p37330.2_BraZ1	574.276	-	1446	1823	1823	1.0000000
A03	16874378	16875408	A03p37340.2_BraZ1	585	+	327	1030	1030	1.0000000
A03	16876223	16878185	A03p37350.2_BraZ1	484.826	-	679	1893	1962	0.9648318
A03	16879532	16880670	A03p37360.2_BraZ1	670.909	+	884	1138	1138	1.0000000
A03	16880998	16882549	A03p37370.2_BraZ1	1005	-	638	1447	1551	0.9329465
A03	16883935	16887788	A03p37380.2_BraZ1	1322.88	+	1466	3516	3853	0.9125357
A03	16889038	16891217	A03p37390.2_BraZ1	9340	-	936	1875	2179	0.8604864
A03	16892963	16894508	A03p37400.2_BraZ1	293.55	-	1895	1545	1545	1.0000000
A03	16895211	16897496	A03p37410.2_BraZ1	1494.45	+	969	2195	2285	0.9606127
A03	16898583	16906837	A03p37420.2_BraZ1	2876.67	-	3315	7704	8254	0.9333656
A03	16909229	16910647	A03p37430.2_BraZ1	525.381	+	745	1333	1418	0.9400564
A03	16912354	16913597	A03p37440.2_BraZ1	632.851	-	1269	1243	1243	1.0000000
A03	16917383	16919734	A03p37450.2_BraZ1	1132.65	-	1171	2303	2351	0.9795831
A03	16920310	16922327	A03p37460.2_BraZ1	21384	-	1848	2017	2017	1.0000000
A03	16924172	16930179	A03p37470.2_BraZ1	3693.25	+	3108	5704	6007	0.9495589
A03	16933056	16934397	A03p37480.2_BraZ1	134.1	-	842	1267	1341	0.9448173
A03	16936093	16938171	A03p37490.2_BraZ1	827.053	-	1160	1893	2078	0.9109721
A03	16942826	16944313	A03p37500.2_BraZ1	790.947	-	279	1084	1487	0.7289845
A03	16945017	16945316	A03p37510.2_BraZ1	53.6667	+	518	299	299	1.0000000
A03	16945613	16948908	A03p37520.2_BraZ1	1207.92	+	3697	3268	3295	0.9918058
A03	16949621	16951308	A03p37530.2_BraZ1	770.25	-	1128	1687	1687	1.0000000
A03	16957839	16959715	A03p37540.2_BraZ1	866.25	-	1937	1876	1876	1.0000000
A03	16967256	16969447	A03p37550.2_BraZ1	757.68	-	1097	2087	2191	0.9525331
A03	16970592	16972018	A03p37560.2_BraZ1	666	-	182	1106	1426	0.7755961
A03	16980144	16981975	A03p37570.2_BraZ1	971.111	+	1027	1831	1831	1.0000000
A03	16982474	16983640	A03p37580.2_BraZ1	432	-	958	1138	1166	0.9759863
A03	16985654	16987924	A03p37590.2_BraZ1	1607.36	+	990	2270	2270	1.0000000
A03	16988199	16993843	A03p37600.2_BraZ1	2276.17	-	897	4708	5644	0.8341601
A03	16994068	16995653	A03p37610.2_BraZ1	766.615	+	719	1541	1585	0.9722397
A03	16996225	16997094	A03p37620.2_BraZ1	597.073	-	246	851	869	0.9792866
A03	16997878	16999092	A03p37630.2_BraZ1	702.587	+	416	1210	1214	0.9967051
A03	17000337	17001389	A03p37640.2_BraZ1	2568.29	+	809	948	1052	0.9011407
A03	17001882	17004298	A03p37650.2_BraZ1	1806	-	1510	2379	2416	0.9846854
A03	17004802	17006922	A03p37660.2_BraZ1	866.7	+	1641	2074	2120	0.9783019
A03	17008992	17010897	A03p37670.2_BraZ1	1053	-	2103	1905	1905	1.0000000
A03	17014089	17017804	A03p37680.2_BraZ1	1916.28	-	1925	3623	3715	0.9752355
A03	17018384	17019667	A03p37690.2_BraZ1	580.826	-	390	1270	1283	0.9898675
A03	17020579	17023134	A03p37700.2_BraZ1	1641.04	+	1008	2373	2555	0.9287671
A03	17024152	17035918	A03p37710.2_BraZ1	4275.19	-	3482	10228	11766	0.8692844
A03	17036423	17037933	A03p37720.2_BraZ1	402.679	+	589	1484	1510	0.9827815
A03	17039210	17040329	A03p37730.2_BraZ1	111.9	-	108	864	1119	0.7721180
A03	17042923	17043403	A03p37740.2_BraZ1	48	+	221	480	480	1.0000000
A03	17044886	17047887	A03p37750.2_BraZ1	1783.21	+	1615	2975	3001	0.9913362
A03	17048019	17048730	A03p37760.2_BraZ1	71.1	-	553	711	711	1.0000000
A03	17051444	17052245	A03p37770.2_BraZ1	80.1	+	78	426	801	0.5318352
A03	17053219	17054775	A03p37780.2_BraZ1	350.4	-	1330	1556	1556	1.0000000
A03	17058817	17061064	A03p37790.2_BraZ1	1329	+	746	1926	2247	0.8571429
A03	17062623	17067135	A03p37800.2_BraZ1	1310.62	+	3010	4450	4512	0.9862589
A03	17068580	17069726	A03p37810.2_BraZ1	114.6	+	323	924	1146	0.8062827
A03	17069909	17075363	A03p37820.2_BraZ1	446.119	-	2935	5454	5454	1.0000000
A03	17076348	17077890	A03p37830.2_BraZ1	6142.5	-	1156	1480	1542	0.9597925
A03	17081730	17082250	A03p37840.2_BraZ1	38.1	-	252	520	520	1.0000000
A03	17089395	17091895	A03p37850.2_BraZ1	1704.42	+	1632	2500	2500	1.0000000
A03	17096337	17097736	A03p37860.2_BraZ1	833	+	1363	1357	1399	0.9699786
A03	17099172	17099319	A03p37870.2_BraZ1	14.7	-	312	147	147	1.0000000
A03	17104516	17106721	A03p37880.2_BraZ1	1047.48	+	446	1005	2205	0.4557823
A03	17111690	17113202	A03p37890.2_BraZ1	912	+	726	1465	1512	0.9689153
A03	17120291	17121397	A03p37900.2_BraZ1	1023	-	71	692	1106	0.6256781
A03	17129373	17131119	A03p37910.2_BraZ1	176.375	-	1581	1746	1746	1.0000000
A03	17136686	17137709	A03p37920.2_BraZ1	102.3	-	1219	1023	1023	1.0000000
A03	17138997	17141062	A03p37930.2_BraZ1	814.143	+	951	2065	2065	1.0000000
A03	17144231	17151496	A03p37940.2_BraZ1	4593.27	+	5391	7220	7265	0.9938059
A03	17152016	17154601	A03p37950.2_BraZ1	1531.75	-	1149	2285	2585	0.8839458
A03	17156638	17158431	A03p37960.2_BraZ1	1710	-	1055	1793	1793	1.0000000
A03	17161318	17161843	A03p37970.2_BraZ1	52.5	+	35	331	525	0.6304762
A03	17165391	17165789	A03p37980.2_BraZ1	152.087	-	764	398	398	1.0000000
A03	17166193	17167983	A03p37990.2_BraZ1	1148.39	-	484	1770	1790	0.9888268
A03	17170655	17171393	A03p38000.2_BraZ1	378	-	0	0	738	0.0000000
A03	17173760	17176362	A03p38010.2_BraZ1	1343.59	+	1179	2520	2602	0.9684858
A03	17176475	17176920	A03p38020.2_BraZ1	249	+	309	445	445	1.0000000
A03	17176956	17177516	A03p38030.2_BraZ1	297	+	369	560	560	1.0000000
A03	17178730	17180401	A03p38040.2_BraZ1	1187.76	+	626	1584	1671	0.9479353
A03	17180882	17184208	A03p38050.2_BraZ1	1763.68	-	646	2836	3326	0.8526759
A03	17185204	17191425	A03p38060.2_BraZ1	7256.49	-	1523	5395	6221	0.8672239
A03	17193385	17194480	A03p38070.2_BraZ1	596.875	+	847	1045	1095	0.9543379
A03	17197284	17202615	A03p38080.2_BraZ1	53071.4	+	791	3616	5331	0.6782967
A03	17203931	17204564	A03p38090.2_BraZ1	63.3	+	15	191	633	0.3017378
A03	17209107	17210296	A03p38100.2_BraZ1	118.2	-	137	1137	1189	0.9562657
A03	17210883	17212441	A03p38110.2_BraZ1	693.769	+	356	1550	1558	0.9948652
A03	17213651	17214002	A03p38120.2_BraZ1	35.1	+	0	0	351	0.0000000
A03	17214843	17215719	A03p38130.2_BraZ1	87.6	-	78	286	876	0.3264840
A03	17216543	17220256	A03p38140.2_BraZ1	1180.97	-	1469	3408	3713	0.9178562
A03	17223821	17224298	A03p38150.2_BraZ1	47.7	-	112	469	477	0.9832285
A03	17228272	17230956	A03p38160.2_BraZ1	1006.65	+	1242	2681	2684	0.9988823
A03	17231600	17241106	A03p38170.2_BraZ1	5282.36	-	1494	5989	9506	0.6300231
A03	17247658	17249852	A03p38180.2_BraZ1	1034.53	+	1276	2185	2194	0.9958979
A03	17250438	17251812	A03p38190.2_BraZ1	1961.18	-	390	1244	1374	0.9053857
A03	17252857	17254851	A03p38200.2_BraZ1	1710.77	-	308	1371	1994	0.6875627
A03	17256842	17259376	A03p38210.2_BraZ1	1656	+	489	1875	2534	0.7399369
A03	17262398	17262587	A03p38220.2_BraZ1	18.9	+	171	189	189	1.0000000
A03	17263465	17265469	A03p38230.2_BraZ1	861.766	-	740	2004	2004	1.0000000
A03	17266228	17266642	A03p38240.2_BraZ1	282	-	0	0	414	0.0000000
A03	17282573	17282886	A03p38250.2_BraZ1	177	+	57	313	313	1.0000000
A03	17286936	17287166	A03p38260.2_BraZ1	111	+	118	208	230	0.9043478
A03	17289122	17291881	A03p38270.2_BraZ1	1509.68	-	1254	2529	2759	0.9166365
A03	17293776	17296566	A03p38280.2_BraZ1	1499.85	+	2197	2790	2790	1.0000000
A03	17297917	17298228	A03p38290.2_BraZ1	234	+	417	311	311	1.0000000
A03	17299067	17300524	A03p38300.2_BraZ1	738	-	1776	1457	1457	1.0000000
A03	17300825	17301255	A03p38310.2_BraZ1	114	-	411	430	430	1.0000000
A03	17305027	17305532	A03p38320.2_BraZ1	219	-	14	245	505	0.4851485
A03	17306661	17314074	A03p38330.2_BraZ1	3506.99	-	4661	7398	7413	0.9979765
A03	17314816	17314921	A03p38340.2_BraZ1	10.5	-	140	105	105	1.0000000
A03	17332705	17334835	A03p38350.2_BraZ1	999.429	+	983	1743	2130	0.8183098
A03	17336296	17338071	A03p38360.2_BraZ1	1086	+	215	1580	1775	0.8901408
A03	17341479	17343350	A03p38370.2_BraZ1	1434	-	452	1471	1871	0.7862106
A03	17344388	17347059	A03p38380.2_BraZ1	11476	-	1607	2633	2671	0.9857731
A03	17349057	17349696	A03p38390.2_BraZ1	63.9	+	360	639	639	1.0000000
A03	17351938	17361222	A03p38400.2_BraZ1	2224.51	+	6922	9237	9284	0.9949375
A03	17353894	17356840	A03p38410.2_BraZ1	282	+	2336	2946	2946	1.0000000
A03	17361384	17362275	A03p38420.2_BraZ1	788.857	-	21	227	891	0.2547699
A03	17363476	17365213	A03p38430.2_BraZ1	375.056	+	523	1558	1737	0.8969488
A03	17375252	17378248	A03p38440.2_BraZ1	1690.5	+	1364	2723	2996	0.9088785
A03	17379031	17380948	A03p38450.2_BraZ1	191.4	+	769	1011	1917	0.5273865
A03	17386042	17386709	A03p38460.2_BraZ1	204	-	38	199	667	0.2983508
A03	17388582	17389354	A03p38470.2_BraZ1	294.938	-	5	238	772	0.3082902
A03	17390471	17392349	A03p38480.2_BraZ1	187.2	+	503	1519	1878	0.8088392
A03	17393686	17396377	A03p38490.2_BraZ1	1854.67	-	1597	2602	2691	0.9669268
A03	17397921	17400265	A03p38500.2_BraZ1	984.5	+	1473	2339	2344	0.9978669
A03	17404394	17406930	A03p38510.2_BraZ1	1501.5	+	1403	2304	2536	0.9085174
A03	17411809	17412013	A03p38520.2_BraZ1	20.4	+	268	204	204	1.0000000
A03	17412371	17415289	A03p38530.2_BraZ1	1594.16	-	1556	2918	2918	1.0000000
A03	17415801	17418067	A03p38540.2_BraZ1	403.125	-	1115	2204	2266	0.9726390
A03	17418585	17423168	A03p38550.2_BraZ1	1591.07	-	279	1763	4583	0.3846825
A03	17429736	17430913	A03p38560.2_BraZ1	444	+	55	834	1177	0.7085811
A03	17432047	17433288	A03p38570.2_BraZ1	639	-	146	1176	1241	0.9476229
A03	17433827	17438408	A03p38580.2_BraZ1	1624.79	-	293	2079	4581	0.4538310
A03	17440112	17441274	A03p38590.2_BraZ1	447	+	251	1162	1162	1.0000000
A03	17442153	17442793	A03p38600.2_BraZ1	369	+	50	602	640	0.9406250
A03	17443590	17443872	A03p38610.2_BraZ1	28.2	-	21	156	282	0.5531915
A03	17444991	17446416	A03p38620.2_BraZ1	20187.5	-	241	1420	1425	0.9964913
A03	17447760	17451154	A03p38630.2_BraZ1	1516.67	+	1258	3083	3394	0.9083677
A03	17453321	17454629	A03p38640.2_BraZ1	1076.4	+	149	1061	1308	0.8111621
A03	17456476	17457019	A03p38650.2_BraZ1	54.3	-	689	543	543	1.0000000
A03	17458349	17468763	A03p38660.2_BraZ1	1161.92	+	547	3920	10414	0.3764164
A03	17469497	17470526	A03p38670.2_BraZ1	40.2	-	563	993	1029	0.9650146
A03	17471308	17472727	A03p38680.2_BraZ1	942	-	152	1151	1419	0.8111346
A03	17473494	17475374	A03p38690.2_BraZ1	929.488	-	1822	1705	1880	0.9069149
A03	17476114	17476560	A03p38700.2_BraZ1	357	+	81	446	446	1.0000000
A03	17477097	17484695	A03p38710.2_BraZ1	2803.57	-	3768	7242	7598	0.9531456
A03	17484324	17486299	A03p38720.2_BraZ1	331.428	+	1296	1975	1975	1.0000000
A03	17487191	17488544	A03p38730.2_BraZ1	676.929	-	669	1353	1353	1.0000000
A03	17489302	17489757	A03p38740.2_BraZ1	189	-	0	0	455	0.0000000
A03	17490083	17490212	A03p38750.2_BraZ1	12.9	-	0	0	129	0.0000000
A03	17492177	17492801	A03p38760.2_BraZ1	62.4	+	799	624	624	1.0000000
A03	17494752	17496472	A03p38770.2_BraZ1	1059	-	1855	1720	1720	1.0000000
A03	17499436	17501740	A03p38780.2_BraZ1	230.4	-	240	1637	2304	0.7105035
A03	17503502	17504512	A03p38790.2_BraZ1	915	-	68	570	1010	0.5643564
A03	17505467	17506272	A03p38800.2_BraZ1	693	-	28	755	805	0.9378882
A03	17515206	17521404	A03p38810.2_BraZ1	4943.33	+	491	4409	6198	0.7113585
A03	17522616	17525005	A03p38820.2_BraZ1	1770	-	125	1038	2389	0.4344914
A03	17527045	17533208	A03p38830.2_BraZ1	1864.8	-	4411	6163	6163	1.0000000
A03	17533923	17534310	A03p38840.2_BraZ1	37.5	-	106	363	387	0.9379845
A03	17534882	17535107	A03p38850.2_BraZ1	22.5	+	53	210	225	0.9333333
A03	17535312	17535459	A03p38860.2_BraZ1	14.7	-	8	137	147	0.9319728
A03	17539565	17539812	A03p38870.2_BraZ1	22.8	+	199	247	247	1.0000000
A03	17540381	17540731	A03p38880.2_BraZ1	309	-	238	329	350	0.9400000
A03	17541297	17541846	A03p38890.2_BraZ1	54.9	-	414	549	549	1.0000000
A03	17548101	17549598	A03p38900.2_BraZ1	149.7	-	431	1497	1497	1.0000000
A03	17557383	17559024	A03p38910.2_BraZ1	786	+	695	1580	1641	0.9628276
A03	17560269	17561807	A03p38920.2_BraZ1	762	+	973	1538	1538	1.0000000
A03	17562527	17562662	A03p38930.2_BraZ1	13.5	-	117	135	135	1.0000000
A03	17573571	17575350	A03p38940.2_BraZ1	177.9	-	99	1437	1779	0.8077571
A03	17578011	17580312	A03p38950.2_BraZ1	240	-	3527	2301	2301	1.0000000
A03	17602780	17604880	A03p38960.2_BraZ1	926.5	+	332	1509	2100	0.7185714
A03	17606086	17610474	A03p38970.2_BraZ1	1365.9	-	5812	4388	4388	1.0000000
A03	17611076	17612436	A03p38980.2_BraZ1	430.8	-	284	1161	1360	0.8536765
A03	17613258	17615566	A03p38990.2_BraZ1	1548.8	-	111	1532	2308	0.6637782
A03	17619385	17621507	A03p39000.2_BraZ1	17865.8	-	2	257	2122	0.1211122
A03	17626005	17627232	A03p39010.2_BraZ1	293.909	+	548	1196	1227	0.9747351
A03	17628258	17628939	A03p39020.2_BraZ1	1622.73	+	231	635	681	0.9324523
A03	17633693	17633951	A03p39030.2_BraZ1	192	+	0	0	258	0.0000000
A03	17637677	17640106	A03p39040.2_BraZ1	1388.18	+	359	1757	2429	0.7233430
A03	17641334	17643061	A03p39050.2_BraZ1	222	+	1013	1700	1727	0.9843659
A03	17643682	17651928	A03p39060.2_BraZ1	1529.29	+	2570	7904	8246	0.9585254
A03	17646844	17649508	A03p39070.2_BraZ1	405	+	802	2386	2664	0.8956456
A03	17649626	17649968	A03p39080.2_BraZ1	34.2	+	37	332	342	0.9707602
A03	17653514	17656569	A03p39090.2_BraZ1	2679.54	-	254	1685	3055	0.5515548
A03	17659332	17659944	A03p39100.2_BraZ1	321	-	617	612	612	1.0000000
A03	17662600	17662837	A03p39110.2_BraZ1	23.7	-	563	237	237	1.0000000
A03	17663042	17666320	A03p39120.2_BraZ1	1455.75	-	8035	3278	3278	1.0000000
A03	17672198	17673492	A03p39130.2_BraZ1	49.5	-	0	0	1294	0.0000000
A03	17679298	17708486	A03p39140.2_BraZ1	606	+	11869	25642	29188	0.8785117
A03	17683230	17684655	A03p39150.2_BraZ1	587.6	+	293	1254	1425	0.8800000
A03	17709655	17710681	A03p39160.2_BraZ1	498	+	0	0	1026	0.0000000
A03	17715316	17717505	A03p39170.2_BraZ1	1375.83	-	486	1952	2189	0.8917314
A03	17728343	17729663	A03p39180.2_BraZ1	132	+	180	1310	1320	0.9924242
A03	17730722	17733889	A03p39190.2_BraZ1	1433.96	+	2015	3064	3167	0.9674771
A03	17734873	17736995	A03p39200.2_BraZ1	182.1	+	1463	2122	2122	1.0000000
A03	17740902	17745490	A03p39210.2_BraZ1	2787.84	+	2567	4588	4588	1.0000000
A03	17745932	17748162	A03p39220.2_BraZ1	977.273	-	1866	2155	2230	0.9663677
A03	17750679	17752744	A03p39230.2_BraZ1	1064.25	+	730	1992	2065	0.9646489
A03	17753647	17755149	A03p39240.2_BraZ1	1167	+	1106	1470	1502	0.9786951
A03	17761966	17763184	A03p39250.2_BraZ1	121.8	+	279	1212	1218	0.9950739
A03	17765169	17766343	A03p39260.2_BraZ1	720	-	549	1086	1174	0.9250426
A03	17769135	17770099	A03p39270.2_BraZ1	657	+	322	911	964	0.9450207
A03	17770373	17772061	A03p39280.2_BraZ1	1335	-	871	1688	1688	1.0000000
A03	17773182	17773599	A03p39290.2_BraZ1	264	+	566	417	417	1.0000000
A03	17774398	17776263	A03p39300.2_BraZ1	1039.83	+	671	1594	1865	0.8546917
A03	17776904	17783271	A03p39310.2_BraZ1	5260.5	-	2177	5577	6367	0.8759227
A03	17785130	17787185	A03p39320.2_BraZ1	205.5	-	956	2051	2055	0.9980536
A03	17787585	17790696	A03p39330.2_BraZ1	1471.57	+	1207	3081	3111	0.9903568
A03	17792653	17794180	A03p39340.2_BraZ1	917.45	+	687	1527	1527	1.0000000
A03	17794882	17795784	A03p39350.2_BraZ1	3304.8	+	632	902	902	1.0000000
A03	17798855	17799491	A03p39360.2_BraZ1	63.6	+	54	477	636	0.7500000
A03	17803357	17803630	A03p39370.2_BraZ1	27.3	+	85	184	273	0.6739927
A03	17805268	17805529	A03p39380.2_BraZ1	26.1	-	80	261	261	1.0000000
A03	17806337	17808142	A03p39390.2_BraZ1	896.318	+	855	1728	1805	0.9573407
A03	17812912	17816084	A03p39400.2_BraZ1	1722.63	-	460	2941	3172	0.9271753
A03	17818949	17821405	A03p39410.2_BraZ1	1333.2	+	2022	2456	2456	1.0000000
A03	17821853	17823486	A03p39420.2_BraZ1	2207.57	+	39	905	1633	0.5541947
A03	17825597	17829404	A03p39430.2_BraZ1	363.862	+	460	2481	3807	0.6516942
A03	17831939	17833686	A03p39440.2_BraZ1	1494	-	1129	1741	1747	0.9965655
A03	17834692	17838014	A03p39450.2_BraZ1	1939.28	+	1292	2842	3322	0.8555087
A03	17839666	17841282	A03p39460.2_BraZ1	812.313	-	634	1616	1616	1.0000000
A03	17844005	17845090	A03p39470.2_BraZ1	925	+	69	697	1085	0.6423963
A03	17849309	17849444	A03p39480.2_BraZ1	13.5	+	366	135	135	1.0000000
A03	17857477	17857585	A03p39490.2_BraZ1	10.8	+	0	0	108	0.0000000
A03	17857928	17858463	A03p39500.2_BraZ1	189	+	0	0	535	0.0000000
A03	17858535	17858827	A03p39510.2_BraZ1	19.2	+	0	0	292	0.0000000
A03	17863395	17865087	A03p39520.2_BraZ1	902.571	+	265	1355	1692	0.8008274
A03	17873910	17875033	A03p39530.2_BraZ1	585	+	759	1064	1123	0.9474621
A03	17876672	17879296	A03p39540.2_BraZ1	1314.78	-	865	2487	2624	0.9477896
A03	17882550	17882886	A03p39550.2_BraZ1	33.6	-	397	336	336	1.0000000
A03	17883757	17885254	A03p39560.2_BraZ1	190.933	+	1742	1497	1497	1.0000000
A03	17885793	17887092	A03p39570.2_BraZ1	289.63	+	1242	1299	1299	1.0000000
A03	17893547	17896878	A03p39580.2_BraZ1	387	+	1154	2658	3331	0.7979586
A03	17897914	17899514	A03p39590.2_BraZ1	722.937	+	1288	1600	1600	1.0000000
A03	17900398	17901215	A03p39600.2_BraZ1	723	-	861	817	817	1.0000000
A03	17912061	17912807	A03p39610.2_BraZ1	492	+	86	414	746	0.5549598
A03	17914443	17914683	A03p39620.2_BraZ1	21.6	+	455	240	240	1.0000000
A03	17916075	17918211	A03p39630.2_BraZ1	1307.52	-	387	1427	2136	0.6680712
A03	17923465	17924076	A03p39640.2_BraZ1	429	+	295	611	611	1.0000000
A03	17926216	17927814	A03p39650.2_BraZ1	642	-	269	893	1598	0.5588235
A03	17929782	17932237	A03p39660.2_BraZ1	819.724	+	189	1865	2455	0.7596741
A03	17933102	17934696	A03p39670.2_BraZ1	698.276	-	119	1307	1594	0.8199498
A03	17935210	17936868	A03p39680.2_BraZ1	1016.81	+	321	1057	1658	0.6375151
A03	17940320	17942066	A03p39690.2_BraZ1	796.5	+	31	466	1746	0.2668958
A03	17944084	17946455	A03p39700.2_BraZ1	1072.5	+	85	1403	2371	0.5917335
A03	17953006	17954257	A03p39710.2_BraZ1	528	+	44	105	1251	0.0839329
A03	17954845	17961777	A03p39720.2_BraZ1	962	+	2659	6482	6932	0.9350837
A03	17958968	17959254	A03p39730.2_BraZ1	171	+	200	286	286	1.0000000
A03	17962522	17968743	A03p39740.2_BraZ1	3129.93	-	2928	6144	6221	0.9876226
A03	17973948	17975637	A03p39750.2_BraZ1	1007.95	+	756	1689	1689	1.0000000
A03	17975953	17976361	A03p39760.2_BraZ1	222	-	423	408	408	1.0000000
A03	17977212	17977782	A03p39770.2_BraZ1	57	-	187	465	570	0.8157895
A03	17982437	17983577	A03p39780.2_BraZ1	858	-	840	1140	1140	1.0000000
A03	17984997	17990725	A03p39790.2_BraZ1	2500.3	-	485	2470	5728	0.4312151
A03	18007721	18011539	A03p39800.2_BraZ1	1872.33	+	458	2741	3818	0.7179151
A03	18011854	18014319	A03p39810.2_BraZ1	2099.6	-	1530	2412	2465	0.9784990
A03	18015014	18017030	A03p39820.2_BraZ1	1923	+	1643	2016	2016	1.0000000
A03	18018201	18019031	A03p39830.2_BraZ1	419.182	-	1236	830	830	1.0000000
A03	18019545	18021127	A03p39840.2_BraZ1	240.74	-	1806	1582	1582	1.0000000
A03	18024423	18026216	A03p39850.2_BraZ1	462	-	1206	1793	1793	1.0000000
A03	18026556	18027137	A03p39860.2_BraZ1	447	-	22	405	581	0.6970740
A03	18035641	18036438	A03p39870.2_BraZ1	239.842	-	903	797	797	1.0000000
A03	18037695	18038468	A03p39880.2_BraZ1	615.923	-	695	773	773	1.0000000
A03	18040598	18046616	A03p39890.2_BraZ1	738	+	51976	5979	6018	0.9935194
A03	18048108	18049170	A03p39900.2_BraZ1	741	+	1810	1062	1062	1.0000000
A03	18049293	18056737	A03p39910.2_BraZ1	355.2	+	5316	7396	7444	0.9935519
A03	18059146	18059769	A03p39920.2_BraZ1	1298.31	+	840	623	623	1.0000000
A03	18060884	18061973	A03p39930.2_BraZ1	108.9	-	918	1089	1089	1.0000000
A03	18065835	18067929	A03p39940.2_BraZ1	1084.41	+	931	1671	2094	0.7979943
A03	18078359	18079758	A03p39950.2_BraZ1	750	+	183	1191	1399	0.8513224
A03	18080350	18081050	A03p39960.2_BraZ1	627	-	56	424	700	0.6057143
A03	18082712	18083327	A03p39970.2_BraZ1	61.5	+	199	515	615	0.8373984
A03	18089682	18097072	A03p39980.2_BraZ1	890.795	+	2537	5087	7390	0.6883627
A03	18105083	18106166	A03p39990.2_BraZ1	385.92	+	18	291	1083	0.2686981
A03	18109385	18113433	A03p40000.2_BraZ1	1399.54	+	3026	4048	4048	1.0000000
A03	18129737	18131043	A03p40010.2_BraZ1	1043	+	545	1101	1306	0.8430322
A03	18131650	18132954	A03p40020.2_BraZ1	574.05	+	428	1185	1304	0.9087423
A03	18139463	18140857	A03p40030.2_BraZ1	1122	-	756	1310	1394	0.9397417
A03	18162402	18163707	A03p40040.2_BraZ1	677.793	-	916	1305	1305	1.0000000
A03	18168996	18170214	A03p40050.2_BraZ1	121.8	-	207	1171	1218	0.9614121
A03	18173545	18173947	A03p40060.2_BraZ1	40.2	+	115	336	402	0.8358209
A03	18174967	18175288	A03p40070.2_BraZ1	32.1	-	9	154	321	0.4797508
A03	18175484	18176023	A03p40080.2_BraZ1	336	-	109	537	539	0.9962894
A03	18177352	18178338	A03p40090.2_BraZ1	502.878	-	597	986	986	1.0000000
A03	18182210	18183662	A03p40100.2_BraZ1	609.429	-	2192	1452	1452	1.0000000
A03	18185554	18186391	A03p40110.2_BraZ1	83.7	+	468	837	837	1.0000000
A03	18199811	18200235	A03p40120.2_BraZ1	141	+	255	424	424	1.0000000
A03	18201524	18202607	A03p40130.2_BraZ1	738	+	214	969	1083	0.8947368
A03	18207470	18208242	A03p40140.2_BraZ1	468	+	300	772	772	1.0000000
A03	18212786	18214550	A03p40150.2_BraZ1	1271.74	+	843	1716	1764	0.9727891
A03	18220296	18223021	A03p40160.2_BraZ1	1549.38	+	1322	2725	2725	1.0000000
A03	18224098	18224713	A03p40170.2_BraZ1	525	-	541	615	615	1.0000000
A03	18227451	18230886	A03p40180.2_BraZ1	1565.06	-	1914	3099	3435	0.9021834
A03	18232001	18232823	A03p40190.2_BraZ1	684.205	-	257	818	822	0.9951338
A03	18234307	18235601	A03p40200.2_BraZ1	879.158	+	469	1279	1294	0.9884080
A03	18237309	18238751	A03p40210.2_BraZ1	224	+	312	1248	1442	0.8654646
A03	18239179	18240106	A03p40220.2_BraZ1	492	-	559	927	927	1.0000000
A03	18240497	18241332	A03p40230.2_BraZ1	555	+	678	835	835	1.0000000
A03	18242603	18243593	A03p40240.2_BraZ1	918	+	14284	990	990	1.0000000
A03	18244032	18245456	A03p40250.2_BraZ1	967.5	-	227	1011	1424	0.7099719
A03	18247057	18248466	A03p40260.2_BraZ1	675.692	+	441	1217	1409	0.8637332
A03	18251796	18252745	A03p40270.2_BraZ1	480	-	108	524	949	0.5521601
A03	18262429	18262783	A03p40280.2_BraZ1	35.4	+	0	0	354	0.0000000
A03	18263432	18264252	A03p40290.2_BraZ1	665.795	+	127	676	820	0.8243902
A03	18265391	18265943	A03p40300.2_BraZ1	55.2	-	37	443	552	0.8025362
A03	18266811	18268464	A03p40310.2_BraZ1	546	-	1035	1483	1653	0.8971567
A03	18270636	18271200	A03p40320.2_BraZ1	56.4	-	367	564	564	1.0000000
A03	18272749	18274509	A03p40330.2_BraZ1	1584	-	2250	1760	1760	1.0000000
A03	18275177	18276764	A03p40340.2_BraZ1	158.7	-	771	1460	1587	0.9199748
A03	18278201	18279098	A03p40350.2_BraZ1	272.392	+	1137	897	897	1.0000000
A03	18279553	18280975	A03p40360.2_BraZ1	711	-	1913	1422	1422	1.0000000
A03	18282340	18283727	A03p40370.2_BraZ1	819.714	+	1650	1387	1387	1.0000000
A03	18284204	18285795	A03p40380.2_BraZ1	1182	-	240	1299	1591	0.8164676
A03	18288733	18290594	A03p40390.2_BraZ1	553	+	66	430	1861	0.2310586
A03	18293809	18295698	A03p40400.2_BraZ1	1026.56	+	757	1725	1889	0.9131816
A03	18296335	18298108	A03p40410.2_BraZ1	729	-	848	1552	1773	0.8753525
A03	18303242	18304042	A03p40420.2_BraZ1	318	-	3	214	800	0.2675000
A03	18307433	18308021	A03p40430.2_BraZ1	58.8	+	256	567	588	0.9642857
A03	18311505	18312306	A03p40440.2_BraZ1	318	-	21	454	801	0.5667915
A03	18321416	18324258	A03p40450.2_BraZ1	21204.8	+	954	2213	2842	0.7786770
A03	18324904	18328531	A03p40460.2_BraZ1	1104.35	-	436	2402	3627	0.6622553
A03	18335791	18336622	A03p40470.2_BraZ1	83.1	-	329	831	831	1.0000000
A03	18345712	18346882	A03p40480.2_BraZ1	117	+	665	1152	1170	0.9846154
A03	18349107	18349351	A03p40490.2_BraZ1	24.3	+	0	0	244	0.0000000
A03	18356131	18356377	A03p40500.2_BraZ1	24.6	+	2	56	246	0.2276423
A03	18361110	18361476	A03p40510.2_BraZ1	276	-	0	0	366	0.0000000
A03	18362658	18363402	A03p40520.2_BraZ1	380.636	-	96	724	744	0.9731183
A03	18366580	18367479	A03p40530.2_BraZ1	520.95	+	45	786	899	0.8743048
A03	18369510	18372334	A03p40540.2_BraZ1	2400	+	274	2019	2824	0.7149433
A03	18374137	18375328	A03p40550.2_BraZ1	119.1	+	567	1191	1191	1.0000000
A03	18375996	18378700	A03p40560.2_BraZ1	1862.59	+	1018	2576	2704	0.9526627
A03	18381195	18390379	A03p40570.2_BraZ1	966.429	-	2377	8950	9184	0.9745209
A03	18398432	18401483	A03p40580.2_BraZ1	1829.82	+	2462	2814	3051	0.9223205
A03	18407371	18408341	A03p40590.2_BraZ1	108	+	5	244	970	0.2515464
A03	18408481	18409603	A03p40600.2_BraZ1	112.2	-	418	1075	1122	0.9581105
A03	18417190	18418089	A03p40610.2_BraZ1	822	-	213	700	899	0.7786430
A03	18418216	18419013	A03p40620.2_BraZ1	383.5	+	319	665	797	0.8343789
A03	18419089	18419205	A03p40630.2_BraZ1	10.5	+	66	116	116	1.0000000
A03	18420877	18421978	A03p40640.2_BraZ1	110.1	+	32	106	1101	0.0962761
A03	18426317	18427811	A03p40650.2_BraZ1	1191.93	-	8	302	1494	0.2021419
A03	18430994	18433621	A03p40660.2_BraZ1	1468.75	-	240	1574	2627	0.5991625
A03	18439034	18440537	A03p40670.2_BraZ1	1209.5	-	0	0	1503	0.0000000
A03	18441706	18442822	A03p40680.2_BraZ1	110.1	+	0	0	1116	0.0000000
A03	18445681	18447184	A03p40690.2_BraZ1	1259.29	-	0	0	1503	0.0000000
A03	18448355	18449471	A03p40700.2_BraZ1	110.1	+	0	0	1116	0.0000000
A03	18449706	18451288	A03p40710.2_BraZ1	876.429	-	323	1235	1582	0.7806574
A03	18452236	18452565	A03p40720.2_BraZ1	252	+	98	154	329	0.4680851
A03	18455387	18455717	A03p40730.2_BraZ1	33	-	61	212	330	0.6424242
A03	18456583	18457276	A03p40740.2_BraZ1	330	-	34	125	693	0.1803752
A03	18459465	18460261	A03p40750.2_BraZ1	1326.38	+	0	0	796	0.0000000
A03	18461411	18463639	A03p40760.2_BraZ1	1041.7	+	417	1946	2228	0.8734291
A03	18469834	18479206	A03p40770.2_BraZ1	2355.23	+	5308	7666	9372	0.8179684
A03	18483198	18484347	A03p40780.2_BraZ1	113.1	-	113	970	1149	0.8442124
A03	18485001	18486240	A03p40790.2_BraZ1	745.043	-	190	1200	1239	0.9685230
A03	18487959	18493545	A03p40800.2_BraZ1	621	+	163	739	5586	0.1322950
A03	18495212	18499882	A03p40810.2_BraZ1	1877.79	+	3828	4670	4670	1.0000000
A03	18508285	18510314	A03p40820.2_BraZ1	1028.29	-	374	1870	2029	0.9216363
A03	18514652	18515571	A03p40830.2_BraZ1	633	-	353	904	919	0.9836779
A03	18520258	18522710	A03p40840.2_BraZ1	1857	-	1176	2151	2452	0.8772430
A03	18526309	18526704	A03p40850.2_BraZ1	306	-	210	395	395	1.0000000
A03	18526615	18528454	A03p40860.2_BraZ1	97.2	-	994	1834	1839	0.9972811
A03	18531158	18532724	A03p40870.2_BraZ1	1017	+	287	1367	1566	0.8729246
A03	18534675	18536172	A03p40880.2_BraZ1	1072.46	+	247	1362	1497	0.9098197
A03	18536529	18538243	A03p40890.2_BraZ1	1077.18	-	751	1704	1714	0.9941657
A03	18539938	18541798	A03p40900.2_BraZ1	943.325	-	942	1860	1860	1.0000000
A03	18546613	18547820	A03p40910.2_BraZ1	621	-	219	1080	1207	0.8947805
A03	18551305	18551596	A03p40920.2_BraZ1	29.1	+	2	142	291	0.4879725
A03	18552429	18553044	A03p40930.2_BraZ1	434.455	+	341	615	615	1.0000000
A03	18553272	18554543	A03p40940.2_BraZ1	371.455	+	936	1243	1271	0.9779701
A03	18554893	18558501	A03p40950.2_BraZ1	2327.88	+	653	3084	3608	0.8547672
A03	18558961	18561955	A03p40960.2_BraZ1	857.143	-	340	2710	2994	0.9051436
A03	18563794	18564196	A03p40970.2_BraZ1	321	+	200	399	402	0.9925373
A03	18579007	18579160	A03p40980.2_BraZ1	15.3	+	103	153	153	1.0000000
A03	18588460	18592054	A03p40990.2_BraZ1	1149.39	+	2462	3594	3594	1.0000000
A03	18592610	18596265	A03p41000.2_BraZ1	1884.44	-	1767	3141	3655	0.8593707
A03	18606407	18608189	A03p41010.2_BraZ1	905.25	+	1890	1782	1782	1.0000000
A03	18620380	18620878	A03p41020.2_BraZ1	49.8	-	145	498	498	1.0000000
A03	18621908	18622555	A03p41030.2_BraZ1	558	+	156	509	647	0.7867079
A03	18624199	18627260	A03p41040.2_BraZ1	1686.3	-	2106	3061	3061	1.0000000
A03	18628681	18629873	A03p41050.2_BraZ1	921.818	+	560	1042	1192	0.8741611
A03	18630919	18631537	A03p41060.2_BraZ1	61.8	-	496	618	618	1.0000000
A03	18634840	18642227	A03p41070.2_BraZ1	931.968	+	748	2309	7387	0.3125761
A03	18642479	18643124	A03p41080.2_BraZ1	64.5	-	118	645	645	1.0000000
A03	18644070	18645345	A03p41090.2_BraZ1	127.5	-	586	1275	1275	1.0000000
A03	18653250	18653535	A03p41100.2_BraZ1	28.5	+	39	200	285	0.7017544
A03	18656545	18656990	A03p41110.2_BraZ1	339	+	262	445	445	1.0000000
A03	18657013	18657352	A03p41120.2_BraZ1	33.9	+	406	302	339	0.8908554
A03	18657687	18660208	A03p41130.2_BraZ1	1375.59	-	1479	2521	2521	1.0000000
A03	18661076	18661858	A03p41140.2_BraZ1	420	-	421	782	782	1.0000000
A03	18663828	18664482	A03p41150.2_BraZ1	65.4	+	205	654	654	1.0000000
A03	18671787	18673089	A03p41160.2_BraZ1	29106	+	282	1000	1302	0.7680492
A03	18673723	18676835	A03p41170.2_BraZ1	1738.43	-	2128	3094	3112	0.9942160
A03	18677555	18679093	A03p41180.2_BraZ1	561.857	+	1312	1538	1538	1.0000000
A03	18679576	18682226	A03p41190.2_BraZ1	1599	-	410	2253	2650	0.8501887
A03	18690477	18695492	A03p41200.2_BraZ1	2158.92	+	4158	4784	5015	0.9539382
A03	18696041	18696366	A03p41210.2_BraZ1	249	-	496	325	325	1.0000000
A03	18697923	18698049	A03p41220.2_BraZ1	12.6	-	323	126	126	1.0000000
A03	18699992	18700229	A03p41230.2_BraZ1	153	-	276	237	237	1.0000000
A03	18704173	18705772	A03p41240.2_BraZ1	838.115	-	1549	1599	1599	1.0000000
A03	18727951	18729331	A03p41250.2_BraZ1	138	+	1042	1380	1380	1.0000000
A03	18733256	18738020	A03p41260.2_BraZ1	1383.07	-	2045	3806	4764	0.7989085
A03	18741053	18742343	A03p41270.2_BraZ1	11682	-	7	35	1290	0.0271318
A03	18744576	18744858	A03p41280.2_BraZ1	19.8	-	639	282	282	1.0000000
A03	18750248	18754320	A03p41290.2_BraZ1	3462	-	2818	3408	4072	0.8369352
A03	18754965	18756540	A03p41300.2_BraZ1	846.562	+	1123	1575	1575	1.0000000
A03	18757307	18757490	A03p41310.2_BraZ1	18.3	-	20	81	183	0.4426230
A03	18762600	18762783	A03p41320.2_BraZ1	18.3	-	28	183	183	1.0000000
A03	18766637	18767163	A03p41330.2_BraZ1	312.955	+	477	526	526	1.0000000
A03	18771084	18771941	A03p41340.2_BraZ1	264	+	1124	857	857	1.0000000
A03	18782995	18785119	A03p41350.2_BraZ1	67.2	+	1069	2064	2124	0.9717514
A03	18786157	18788882	A03p41360.2_BraZ1	1234.55	+	1025	2510	2725	0.9211009
A03	18790493	18792979	A03p41370.2_BraZ1	1647.22	+	1180	2256	2486	0.9074819
A03	18793260	18794601	A03p41380.2_BraZ1	134.1	-	570	1341	1341	1.0000000
A03	18797472	18800043	A03p41390.2_BraZ1	1177.9	-	1099	2348	2571	0.9132633
A03	18801395	18802286	A03p41400.2_BraZ1	89.1	-	991	891	891	1.0000000
A03	18805076	18805859	A03p41410.2_BraZ1	587.52	-	659	783	783	1.0000000
A03	18810786	18812176	A03p41420.2_BraZ1	11772	-	180	1096	1390	0.7884892
A03	18815113	18820067	A03p41430.2_BraZ1	2674.85	-	1662	4429	4954	0.8940250
A03	18822198	18823251	A03p41440.2_BraZ1	104.1	+	284	1053	1053	1.0000000
A03	18824199	18825877	A03p41450.2_BraZ1	874	-	1027	1678	1678	1.0000000
A03	18829976	18832237	A03p41460.2_BraZ1	1282.56	-	1685	2250	2261	0.9951349
A03	18837354	18837537	A03p41470.2_BraZ1	18.3	-	257	183	183	1.0000000
A03	18838931	18840420	A03p41480.2_BraZ1	8096	+	990	1438	1489	0.9657488
A03	18840729	18841386	A03p41490.2_BraZ1	233.846	-	106	625	657	0.9512938
A03	18843243	18843708	A03p41500.2_BraZ1	1166.67	+	561	465	465	1.0000000
A03	18844312	18845463	A03p41510.2_BraZ1	1068	+	517	1151	1151	1.0000000
A03	18847978	18848835	A03p41520.2_BraZ1	294	-	1134	857	857	1.0000000
A03	18849787	18852757	A03p41530.2_BraZ1	1707.03	+	923	2776	2970	0.9346802
A03	18852968	18855477	A03p41540.2_BraZ1	1764	-	486	2027	2509	0.8078916
A03	18856333	18857574	A03p41550.2_BraZ1	584.22	-	453	1241	1241	1.0000000
A03	18858760	18861562	A03p41560.2_BraZ1	15213.1	+	875	2665	2802	0.9511064
A03	18863482	18864043	A03p41570.2_BraZ1	56.1	+	0	0	561	0.0000000
A03	18867686	18868898	A03p41580.2_BraZ1	121.2	-	142	710	1212	0.5858086
A03	18871088	18871948	A03p41590.2_BraZ1	1536	-	587	860	860	1.0000000
A03	18875115	18876366	A03p41600.2_BraZ1	122.7	-	219	900	1251	0.7194245
A03	18879646	18880453	A03p41610.2_BraZ1	80.7	-	173	807	807	1.0000000
A03	18883251	18887541	A03p41620.2_BraZ1	1362	-	2540	4290	4290	1.0000000
A03	18888004	18890166	A03p41630.2_BraZ1	1231.36	-	522	1921	2162	0.8885291
A03	18890568	18890859	A03p41640.2_BraZ1	29.1	-	42	291	291	1.0000000
A03	18891611	18893404	A03p41650.2_BraZ1	1113	-	632	1666	1793	0.9291690
A03	18894616	18897230	A03p41660.2_BraZ1	1308	-	1534	2614	2614	1.0000000
A03	18903529	18904340	A03p41670.2_BraZ1	744	+	519	810	811	0.9987670
A03	18904575	18905082	A03p41680.2_BraZ1	50.7	-	46	374	507	0.7376726
A03	18907295	18909779	A03p41690.2_BraZ1	925.063	-	338	1839	2484	0.7403381
A03	18912073	18912296	A03p41700.2_BraZ1	21.3	-	266	223	223	1.0000000
A03	18925543	18928038	A03p41710.2_BraZ1	1185.46	+	1124	2371	2495	0.9503006
A03	18929280	18931731	A03p41720.2_BraZ1	1647	-	816	2246	2451	0.9163607
A03	18937705	18938307	A03p41730.2_BraZ1	384	-	175	602	602	1.0000000
A03	18942147	18944967	A03p41740.2_BraZ1	1178.48	-	525	2515	2820	0.8918440
A03	18950652	18951849	A03p41750.2_BraZ1	119.7	+	391	825	1197	0.6892231
A03	18961551	18962222	A03p41760.2_BraZ1	204	-	233	504	671	0.7511177
A03	18963652	18964324	A03p41770.2_BraZ1	288	-	608	672	672	1.0000000
A03	18964637	18975854	A03p41780.2_BraZ1	427.5	+	3574	8242	11217	0.7347776
A03	18969668	18970197	A03p41790.2_BraZ1	2247.75	-	32	222	529	0.4196597
A03	18973882	18974332	A03p41800.2_BraZ1	45	-	91	450	450	1.0000000
A03	18979460	18981549	A03p41810.2_BraZ1	1868.71	+	609	1899	2089	0.9090474
A03	18982321	18983236	A03p41820.2_BraZ1	90.6	+	1151	915	915	1.0000000
A03	18993586	18998649	A03p41830.2_BraZ1	1496.61	+	2708	4986	5063	0.9847916
A03	18999380	19001721	A03p41840.2_BraZ1	901.884	+	1890	2325	2341	0.9931653
A03	19002544	19043324	A03p41850.2_BraZ1	4368.25	+	30864	39001	40780	0.9563757
A03	19008315	19016243	A03p41860.2_BraZ1	1846.55	-	5123	7588	7928	0.9571140
A03	19021480	19023544	A03p41870.2_BraZ1	1076	+	349	1267	2064	0.6138566
A03	19034838	19035262	A03p41880.2_BraZ1	405	-	606	424	424	1.0000000
A03	19035640	19037255	A03p41890.2_BraZ1	11475	+	1391	1615	1615	1.0000000
A03	19047035	19048113	A03p41900.2_BraZ1	106.8	+	1050	1078	1078	1.0000000
A03	19049114	19050545	A03p41910.2_BraZ1	143.1	+	245	1360	1431	0.9503843
A03	19050713	19051252	A03p41920.2_BraZ1	321	-	749	539	539	1.0000000
A03	19051414	19053598	A03p41930.2_BraZ1	1999.5	+	614	1619	2184	0.7413003
A03	19055681	19057212	A03p41940.2_BraZ1	1029.55	+	316	1414	1531	0.9235793
A03	19057553	19060919	A03p41950.2_BraZ1	1939.71	-	1966	3284	3366	0.9756387
A03	19062426	19063831	A03p41960.2_BraZ1	1035.82	-	494	1405	1405	1.0000000
A03	19064714	19065014	A03p41970.2_BraZ1	30	-	195	300	300	1.0000000
A03	19065206	19065470	A03p41980.2_BraZ1	26.4	-	145	257	264	0.9734849
A03	19067219	19069253	A03p41990.2_BraZ1	1237.33	-	166	1737	2034	0.8539823
A03	19073909	19074557	A03p42000.2_BraZ1	64.8	-	407	636	648	0.9814815
A03	19079141	19080871	A03p42010.2_BraZ1	990	-	2334	1730	1730	1.0000000
A03	19084835	19094594	A03p42020.2_BraZ1	1077.68	+	13461	9759	9759	1.0000000
A03	19096882	19097176	A03p42030.2_BraZ1	29.4	+	157	294	294	1.0000000
A03	19111701	19114450	A03p42040.2_BraZ1	573.745	+	2498	2749	2749	1.0000000
A03	19114361	19128531	A03p42050.2_BraZ1	1823.05	+	10180	13646	14170	0.9630204
A03	19118018	19119606	A03p42060.2_BraZ1	65.4	-	1122	1588	1588	1.0000000
A03	19128919	19130082	A03p42070.2_BraZ1	510.545	-	1428	1163	1163	1.0000000
A03	19135086	19137361	A03p42080.2_BraZ1	1384.93	+	2567	2275	2275	1.0000000
A03	19138938	19140455	A03p42090.2_BraZ1	157.3	+	491	1402	1517	0.9241925
A03	19140716	19143500	A03p42100.2_BraZ1	1257.25	+	181	1914	2784	0.6875000
A03	19145314	19146768	A03p42110.2_BraZ1	1060.72	+	251	1199	1454	0.8246217
A03	19147320	19150094	A03p42120.2_BraZ1	859.68	-	1740	2737	2774	0.9866619
A03	19151537	19162293	A03p42130.2_BraZ1	1410.46	+	2364	9064	10756	0.8426924
A03	19167217	19167914	A03p42140.2_BraZ1	615	-	411	697	697	1.0000000
A03	19168479	19171177	A03p42150.2_BraZ1	1965.19	-	938	2561	2698	0.9492217
A03	19176656	19177298	A03p42160.2_BraZ1	63.6	+	484	642	642	1.0000000
A03	19178594	19183918	A03p42170.2_BraZ1	2260.18	-	1978	4773	5324	0.8965064
A03	19185912	19188053	A03p42180.2_BraZ1	773.28	+	1741	2141	2141	1.0000000
A03	19193721	19195141	A03p42190.2_BraZ1	1108.71	+	1224	1420	1420	1.0000000
A03	19200523	19202936	A03p42200.2_BraZ1	1262.12	-	375	1864	2413	0.7724824
A03	19212757	19213465	A03p42210.2_BraZ1	39.6	+	418	708	708	1.0000000
A03	19227168	19227609	A03p42220.2_BraZ1	44.1	-	650	441	441	1.0000000
A03	19229904	19231119	A03p42230.2_BraZ1	121.5	-	390	975	1215	0.8024691
A03	19238133	19239220	A03p42240.2_BraZ1	542.318	+	550	1073	1087	0.9871205
A03	19241098	19242844	A03p42250.2_BraZ1	174.6	-	729	1625	1746	0.9306988
A03	19248581	19249703	A03p42260.2_BraZ1	112.2	-	947	1122	1122	1.0000000
A03	19251359	19252199	A03p42270.2_BraZ1	84	+	53	551	840	0.6559524
A03	19256641	19257065	A03p42280.2_BraZ1	41.4	+	9	155	424	0.3655660
A03	19260075	19261425	A03p42290.2_BraZ1	840.786	+	884	1322	1350	0.9792593
A03	19261763	19263527	A03p42300.2_BraZ1	965.337	-	720	1735	1764	0.9835601
A03	19268780	19269177	A03p42310.2_BraZ1	330	+	272	397	397	1.0000000
A03	19271480	19272689	A03p42320.2_BraZ1	120.9	+	386	1209	1209	1.0000000
A03	19272975	19273296	A03p42330.2_BraZ1	32.1	-	299	321	321	1.0000000
A03	19274222	19276660	A03p42340.2_BraZ1	1463.33	-	1529	2360	2438	0.9680066
A03	19281073	19283473	A03p42350.2_BraZ1	1190.03	-	1022	2348	2400	0.9783334
A03	19283902	19285623	A03p42360.2_BraZ1	1204.24	+	319	1339	1721	0.7780360
A03	19286143	19287797	A03p42370.2_BraZ1	1581	-	633	1457	1654	0.8808948
A03	19288823	19290808	A03p42380.2_BraZ1	1103.3	-	878	1985	1985	1.0000000
A03	19291611	19292307	A03p42390.2_BraZ1	69.6	-	107	623	696	0.8951150
A03	19293157	19296346	A03p42400.2_BraZ1	1615.97	-	2197	3189	3189	1.0000000
A03	19301127	19319954	A03p42410.2_BraZ1	3670.86	+	4832	11214	18827	0.5956339
A03	19309429	19310124	A03p42420.2_BraZ1	6439.5	-	1	3	695	0.0043165
A03	19325562	19326639	A03p42430.2_BraZ1	107.7	+	149	775	1077	0.7195914
A03	19327829	19332314	A03p42440.2_BraZ1	1328.32	-	2053	3808	4485	0.8490524
A03	19333912	19334053	A03p42450.2_BraZ1	14.1	+	9	141	141	1.0000000
A03	19335435	19338339	A03p42460.2_BraZ1	1379.62	-	2175	2872	2904	0.9889807
A03	19343686	19345818	A03p42470.2_BraZ1	341.333	+	1776	2087	2132	0.9788930
A03	19348952	19349573	A03p42480.2_BraZ1	62.1	+	151	543	621	0.8743961
A03	19361632	19361938	A03p42490.2_BraZ1	30.6	+	186	306	306	1.0000000
A03	19362838	19363057	A03p42500.2_BraZ1	21.9	+	156	219	219	1.0000000
A03	19363884	19365788	A03p42510.2_BraZ1	1222.67	-	310	1222	1904	0.6418067
A03	19376499	19377507	A03p42520.2_BraZ1	100.8	+	693	1008	1008	1.0000000
A03	19379854	19384159	A03p42530.2_BraZ1	1856.88	-	1411	3697	4305	0.8587689
A03	19387118	19387480	A03p42540.2_BraZ1	702	+	178	362	362	1.0000000
A03	19390504	19391696	A03p42550.2_BraZ1	576	-	503	1192	1192	1.0000000
A03	19392475	19393666	A03p42560.2_BraZ1	119.1	-	510	1182	1191	0.9924433
A03	19402249	19402592	A03p42570.2_BraZ1	30.9	-	123	268	343	0.7813411
A03	19405526	19405835	A03p42580.2_BraZ1	30.9	-	7	100	309	0.3236246
A03	19413675	19414834	A03p42590.2_BraZ1	306	+	760	1116	1159	0.9628990
A03	19415071	19418332	A03p42600.2_BraZ1	1885.44	-	1347	2906	3261	0.8911377
A03	19443633	19445481	A03p42610.2_BraZ1	1298.43	-	1168	1797	1848	0.9724026
A03	19450425	19451420	A03p42620.2_BraZ1	843	-	10	289	995	0.2904523
A03	19451986	19452412	A03p42630.2_BraZ1	42.6	-	11	398	426	0.9342723
A03	19453378	19455616	A03p42640.2_BraZ1	979.364	-	3001	2217	2238	0.9906166
A03	19456084	19457832	A03p42650.2_BraZ1	8253.75	-	2185	1748	1748	1.0000000
A03	19459616	19460574	A03p42660.2_BraZ1	491.429	-	1188	958	958	1.0000000
A03	19461513	19464486	A03p42670.2_BraZ1	2090.76	-	1232	2611	2973	0.8782375
A03	19468779	19470002	A03p42680.2_BraZ1	49.2	+	8	293	1223	0.2395748
A03	19478633	19479191	A03p42690.2_BraZ1	363	-	904	558	558	1.0000000
A03	19480805	19481280	A03p42700.2_BraZ1	432	-	199	475	475	1.0000000
A03	19481405	19482370	A03p42710.2_BraZ1	482.906	-	624	955	965	0.9896373
A03	19501189	19505706	A03p42720.2_BraZ1	1145	+	1710	4099	4517	0.9074607
A03	19508401	19509746	A03p42730.2_BraZ1	829.705	+	778	1345	1345	1.0000000
A03	19513371	19514517	A03p42740.2_BraZ1	657.286	+	99	763	1146	0.6657941
A03	19526364	19527344	A03p42750.2_BraZ1	448.875	-	520	980	980	1.0000000
A03	19528418	19528913	A03p42760.2_BraZ1	49.5	+	380	336	495	0.6787879
A03	19534234	19539075	A03p42770.2_BraZ1	984.506	-	2000	4227	4841	0.8731667
A03	19542201	19542582	A03p42780.2_BraZ1	170	-	272	381	381	1.0000000
A03	19542356	19542990	A03p42790.2_BraZ1	381	-	381	634	634	1.0000000
A03	19548386	19549853	A03p42800.2_BraZ1	146.7	+	619	1467	1467	1.0000000
A03	19552146	19553580	A03p42810.2_BraZ1	143.4	+	898	1434	1434	1.0000000
A03	19557207	19558608	A03p42820.2_BraZ1	140.1	-	636	1368	1401	0.9764454
A03	19560481	19560616	A03p42830.2_BraZ1	13.5	+	195	135	135	1.0000000
A03	19561913	19563906	A03p42840.2_BraZ1	821.435	-	1975	1993	1993	1.0000000
A03	19565703	19566677	A03p42850.2_BraZ1	8379	+	201	925	974	0.9496920
A03	19571954	19573318	A03p42860.2_BraZ1	789	+	271	1362	1364	0.9985337
A03	19578148	19579605	A03p42870.2_BraZ1	786	+	619	1139	1457	0.7817433
A03	19581736	19582320	A03p42880.2_BraZ1	44.1	-	131	584	584	1.0000000
A03	19585673	19586433	A03p42890.2_BraZ1	624	+	569	760	760	1.0000000
A03	19598819	19599089	A03p42900.2_BraZ1	27	-	116	270	270	1.0000000
A03	19600028	19601749	A03p42910.2_BraZ1	1117.2	-	1944	1721	1721	1.0000000
A03	19603395	19609737	A03p42920.2_BraZ1	583.714	-	5225	6299	6342	0.9932198
A03	19611887	19612295	A03p42930.2_BraZ1	40.8	-	361	408	408	1.0000000
A03	19617359	19620734	A03p42940.2_BraZ1	279	-	1114	2099	3375	0.6219260
A03	19622799	19624290	A03p42950.2_BraZ1	149.1	-	886	1491	1491	1.0000000
A03	19629007	19630733	A03p42960.2_BraZ1	594.413	+	697	1465	1726	0.8487833
A03	19632979	19633933	A03p42970.2_BraZ1	60.8	+	669	954	954	1.0000000
A03	19635291	19635861	A03p42980.2_BraZ1	369	-	551	570	570	1.0000000
A03	19642082	19644597	A03p42990.2_BraZ1	935.888	+	2259	2515	2515	1.0000000
A03	19645725	19646860	A03p43000.2_BraZ1	2220	+	1284	1135	1135	1.0000000
A03	19647627	19648645	A03p43010.2_BraZ1	604.216	-	827	1018	1018	1.0000000
A03	19649718	19651815	A03p43020.2_BraZ1	1041	+	905	2074	2097	0.9890320
A03	19656753	19662142	A03p43030.2_BraZ1	3808.12	+	2371	5086	5389	0.9437743
A03	19664681	19665238	A03p43040.2_BraZ1	291	+	88	505	557	0.9066427
A03	19670585	19673029	A03p43050.2_BraZ1	1406.42	+	553	1839	2444	0.7524550
A03	19673628	19674063	A03p43060.2_BraZ1	43.5	+	180	435	435	1.0000000
A03	19674245	19675168	A03p43070.2_BraZ1	715.929	-	749	923	923	1.0000000
A03	19678030	19680117	A03p43080.2_BraZ1	18933.8	+	1656	2087	2087	1.0000000
A03	19681588	19683494	A03p43090.2_BraZ1	582	+	2578	1906	1906	1.0000000
A03	19685060	19685516	A03p43100.2_BraZ1	45.6	-	60	388	456	0.8508772
A03	19695122	19696017	A03p43110.2_BraZ1	795	-	309	895	895	1.0000000
A03	19711890	19712610	A03p43120.2_BraZ1	618	+	51	699	720	0.9708334
A03	19715946	19717107	A03p43130.2_BraZ1	116.1	+	339	747	1161	0.6434109
A03	19719849	19721441	A03p43140.2_BraZ1	702	+	1295	1592	1592	1.0000000
A03	19721927	19722824	A03p43150.2_BraZ1	89.7	-	513	897	897	1.0000000
A03	19725894	19726287	A03p43160.2_BraZ1	39.3	+	409	393	393	1.0000000
A03	19726515	19728189	A03p43170.2_BraZ1	167.4	-	742	1668	1674	0.9964158
A03	19729540	19730118	A03p43180.2_BraZ1	486	+	174	459	578	0.7941176
A03	19731207	19732961	A03p43190.2_BraZ1	1248	-	618	1593	1754	0.9082098
A03	19738466	19751332	A03p43200.2_BraZ1	3226.67	+	5516	11726	12866	0.9113944
A03	19745628	19746220	A03p43210.2_BraZ1	222	-	437	592	592	1.0000000
A03	19755084	19756190	A03p43220.2_BraZ1	540.96	-	277	1051	1106	0.9502712
A03	19757395	19757725	A03p43230.2_BraZ1	33	+	126	330	330	1.0000000
A03	19759672	19760646	A03p43240.2_BraZ1	595.833	+	681	974	974	1.0000000
A03	19761224	19762365	A03p43250.2_BraZ1	750	+	366	1011	1141	0.8860648
A03	19762653	19763080	A03p43260.2_BraZ1	354	-	174	423	427	0.9906323
A03	19763020	19763595	A03p43270.2_BraZ1	285	-	253	553	575	0.9617391
A03	19778790	19779198	A03p43280.2_BraZ1	24	-	129	408	408	1.0000000
A03	19779978	19782193	A03p43290.2_BraZ1	1343.83	+	632	2016	2215	0.9101580
A03	19784377	19785791	A03p43300.2_BraZ1	3354.64	-	59	539	1414	0.3811881
A03	19790473	19791397	A03p43310.2_BraZ1	92.4	+	171	393	924	0.4253247
A03	19805863	19806818	A03p43320.2_BraZ1	251.6	+	505	831	955	0.8701571
A03	19807107	19808790	A03p43330.2_BraZ1	596.143	-	857	1604	1683	0.9530600
A03	19809883	19813106	A03p43340.2_BraZ1	1597.04	+	1321	2622	3223	0.8135278
A03	19833787	19834867	A03p43350.2_BraZ1	1002	+	237	1015	1080	0.9398148
A03	19842723	19844924	A03p43360.2_BraZ1	290	-	1854	2201	2201	1.0000000
A03	19850831	19851693	A03p43370.2_BraZ1	6192	-	230	705	862	0.8178654
A03	19864988	19866838	A03p43380.2_BraZ1	613.594	+	518	1457	1850	0.7875676
A03	19872543	19874505	A03p43390.2_BraZ1	1137.5	+	1388	1962	1962	1.0000000
A03	19876268	19879530	A03p43400.2_BraZ1	2585.45	-	798	3101	3262	0.9506438
A03	19885632	19886148	A03p43410.2_BraZ1	51.6	+	434	485	516	0.9399225
A03	19889858	19890189	A03p43420.2_BraZ1	31.2	-	289	331	331	1.0000000
A03	19899489	19900726	A03p43430.2_BraZ1	421.35	+	201	993	1237	0.8027486
A03	19904177	19904384	A03p43440.2_BraZ1	20.7	-	24	135	207	0.6521739
A03	19906732	19907917	A03p43450.2_BraZ1	825.125	+	92	655	1185	0.5527426
A03	19918177	19919063	A03p43460.2_BraZ1	498	+	789	873	886	0.9853273
A03	19918375	19919285	A03p43470.2_BraZ1	297	+	1116	910	910	1.0000000
A03	19919720	19920822	A03p43480.2_BraZ1	1056	+	722	1102	1102	1.0000000
A03	19924368	19926648	A03p43490.2_BraZ1	1658.66	+	693	1681	2280	0.7372807
A03	19928556	19929308	A03p43500.2_BraZ1	539.478	+	544	752	752	1.0000000
A03	19930208	19931025	A03p43510.2_BraZ1	280.317	+	322	789	817	0.9657283
A03	19932822	19937318	A03p43520.2_BraZ1	8268	+	1547	4038	4496	0.8981317
A03	19938563	19938923	A03p43530.2_BraZ1	36	-	403	360	360	1.0000000
A03	19942360	19952316	A03p43540.2_BraZ1	2172.79	+	4662	8231	9956	0.8267376
A03	19953589	19954036	A03p43550.2_BraZ1	44.7	+	178	411	447	0.9194631
A03	19955647	19957386	A03p43560.2_BraZ1	796.5	-	1456	1739	1739	1.0000000
A03	19968729	19969990	A03p43570.2_BraZ1	8556	-	31	529	1261	0.4195083
A03	19970843	19972489	A03p43580.2_BraZ1	1405.03	+	82	834	1646	0.5066829
A03	19974229	19978688	A03p43590.2_BraZ1	1951.57	+	2137	4314	4459	0.9674815
A03	19978996	19979353	A03p43600.2_BraZ1	35.7	+	490	357	357	1.0000000
A03	19980217	19982433	A03p43610.2_BraZ1	71442	-	715	1951	2216	0.8804151
A03	19984252	19987512	A03p43620.2_BraZ1	641.778	-	2034	3107	3260	0.9530675
A03	20003456	20004833	A03p43630.2_BraZ1	137.7	+	152	1224	1377	0.8888889
A03	20008584	20010201	A03p43640.2_BraZ1	953.314	+	43	367	1617	0.2269635
A03	20013216	20014493	A03p43650.2_BraZ1	816	+	426	1172	1277	0.9177760
A03	20018085	20021512	A03p43660.2_BraZ1	1905.74	-	1408	3378	3427	0.9857018
A03	20022207	20023987	A03p43670.2_BraZ1	844.773	-	1036	1761	1780	0.9893258
A03	20033824	20035284	A03p43680.2_BraZ1	967.647	-	756	1460	1460	1.0000000
A03	20046473	20062741	A03p43690.2_BraZ1	464	-	15322	16132	16268	0.9916400
A03	20063989	20066167	A03p43700.2_BraZ1	1063.77	+	1981	2175	2178	0.9986226
A03	20066937	20070226	A03p43710.2_BraZ1	1289.39	-	2988	3289	3289	1.0000000
A03	20072235	20073324	A03p43720.2_BraZ1	5691	+	606	1065	1089	0.9779614
A03	20075572	20075833	A03p43730.2_BraZ1	26.1	+	10	224	261	0.8582376
A03	20077006	20077399	A03p43740.2_BraZ1	39.3	+	119	393	393	1.0000000
A03	20077984	20081160	A03p43750.2_BraZ1	1274.34	-	3185	3163	3176	0.9959068
A03	20082415	20086880	A03p43760.2_BraZ1	1404.91	+	1599	4037	4465	0.9041433
A03	20093708	20094134	A03p43770.2_BraZ1	228	+	497	426	426	1.0000000
A03	20095323	20097476	A03p43780.2_BraZ1	1635.53	-	1295	2153	2153	1.0000000
A03	20109099	20109480	A03p43790.2_BraZ1	38.1	-	47	263	381	0.6902887
A03	20111917	20112295	A03p43800.2_BraZ1	37.8	-	58	220	378	0.5820106
A03	20114582	20116085	A03p43810.2_BraZ1	150.3	-	63	1025	1503	0.6819694
A03	20128671	20129702	A03p43820.2_BraZ1	825	-	138	1016	1031	0.9854510
A03	20137333	20139520	A03p43830.2_BraZ1	1384.24	+	774	2042	2187	0.9336991
A03	20139871	20141465	A03p43840.2_BraZ1	610.767	-	962	1594	1594	1.0000000
A03	20142420	20145770	A03p43850.2_BraZ1	18480	-	1634	3157	3350	0.9423881
A03	20150353	20150959	A03p43860.2_BraZ1	60	-	106	503	606	0.8300330
A03	20156130	20157948	A03p43870.2_BraZ1	970.773	+	1004	1818	1818	1.0000000
A03	20158366	20160925	A03p43880.2_BraZ1	1036.24	-	811	2456	2559	0.9597499
A03	20162720	20164932	A03p43890.2_BraZ1	2050	+	214	1490	2212	0.6735985
A03	20176135	20178325	A03p43900.2_BraZ1	413.386	-	429	1982	2190	0.9050229
A03	20183112	20185438	A03p43910.2_BraZ1	1060.89	-	1515	2242	2326	0.9638865
A03	20204435	20206727	A03p43920.2_BraZ1	229.2	-	8178	2175	2292	0.9489529
A03	20219978	20220989	A03p43930.2_BraZ1	101.1	+	466	981	1011	0.9703264
A03	20222035	20225973	A03p43940.2_BraZ1	1380.5	-	844	3059	3938	0.7767903
A03	20229455	20229647	A03p43950.2_BraZ1	19.2	+	264	192	192	1.0000000
A03	20230142	20230419	A03p43960.2_BraZ1	25.2	-	425	277	277	1.0000000
A03	20246188	20247112	A03p43970.2_BraZ1	70.3333	-	694	924	924	1.0000000
A03	20247382	20247736	A03p43980.2_BraZ1	243	+	51	354	354	1.0000000
A03	20247895	20249900	A03p43990.2_BraZ1	1623.43	-	1830	2005	2005	1.0000000
A03	20251338	20257898	A03p44000.2_BraZ1	2741.71	-	2312	6460	6560	0.9847561
A03	20258900	20259089	A03p44010.2_BraZ1	18.9	+	20	186	189	0.9841270
A03	20259835	20260762	A03p44020.2_BraZ1	92.7	+	498	919	927	0.9913700
A03	20266867	20268861	A03p44030.2_BraZ1	675.659	-	1586	1994	1994	1.0000000
A03	20270341	20270542	A03p44040.2_BraZ1	20.1	-	327	201	201	1.0000000
A03	20272332	20272809	A03p44050.2_BraZ1	47.4	-	37	348	477	0.7295597
A03	20275444	20276882	A03p44060.2_BraZ1	742.674	-	908	1437	1438	0.9993046
A03	20279920	20283226	A03p44070.2_BraZ1	1375.83	-	559	2654	3306	0.8027828
A03	20292619	20295439	A03p44080.2_BraZ1	2095.25	+	854	2224	2820	0.7886525
A03	20299896	20302142	A03p44090.2_BraZ1	2109	+	893	1751	2246	0.7796082
A03	20303014	20303732	A03p44100.2_BraZ1	66.9	+	5	281	718	0.3913649
A03	20304605	20305323	A03p44110.2_BraZ1	66.9	+	1	58	718	0.0807799
A03	20307226	20307961	A03p44120.2_BraZ1	303	-	1043	735	735	1.0000000
A03	20309241	20312882	A03p44130.2_BraZ1	2412.6	+	821	3139	3641	0.8621258
A03	20313056	20313864	A03p44140.2_BraZ1	537	-	796	808	808	1.0000000
A03	20319853	20320153	A03p44150.2_BraZ1	30	+	0	0	300	0.0000000
A03	20324068	20325900	A03p44160.2_BraZ1	1025.3	+	1006	1832	1832	1.0000000
A03	20329354	20329652	A03p44170.2_BraZ1	22.2	-	292	298	298	1.0000000
A03	20332623	20333381	A03p44180.2_BraZ1	600	+	461	758	758	1.0000000
A03	20336606	20338538	A03p44190.2_BraZ1	954.667	-	753	1741	1932	0.9011387
A03	20340861	20342163	A03p44200.2_BraZ1	575.719	+	583	1206	1302	0.9262673
A03	20343162	20351774	A03p44210.2_BraZ1	5306.7	-	2279	6069	8612	0.7047144
A03	20352971	20354218	A03p44220.2_BraZ1	590.4	+	926	1247	1247	1.0000000
A03	20360993	20361198	A03p44230.2_BraZ1	20.4	-	185	205	205	1.0000000
A03	20365139	20366957	A03p44240.2_BraZ1	180.3	+	874	1796	1818	0.9878988
A03	20367520	20370983	A03p44250.2_BraZ1	1068.18	-	2540	3463	3463	1.0000000
A03	20373524	20374698	A03p44260.2_BraZ1	65.1	+	794	1130	1174	0.9625213
A03	20376969	20397880	A03p44270.2_BraZ1	1866	+	9781	18806	20911	0.8993353
A03	20397683	20398334	A03p44280.2_BraZ1	276	+	395	651	651	1.0000000
A03	20399311	20399815	A03p44290.2_BraZ1	273	+	364	504	504	1.0000000
A03	20403995	20405633	A03p44300.2_BraZ1	512.615	-	357	1501	1638	0.9163614
A03	20406306	20408133	A03p44310.2_BraZ1	1680	+	417	1646	1827	0.9009305
A03	20408604	20409984	A03p44320.2_BraZ1	819	-	358	1262	1380	0.9144927
A03	20415549	20417889	A03p44330.2_BraZ1	1248.29	-	725	1476	2340	0.6307693
A03	20427073	20428234	A03p44340.2_BraZ1	660	+	77	759	1161	0.6537468
A03	20429524	20437755	A03p44350.2_BraZ1	1092.75	+	5695	7826	8231	0.9507958
A03	20439336	20440099	A03p44360.2_BraZ1	288	+	431	753	763	0.9868938
A03	20443814	20444921	A03p44370.2_BraZ1	451.722	+	1447	1107	1107	1.0000000
A03	20445892	20447229	A03p44380.2_BraZ1	337.125	+	0	0	1337	0.0000000
A03	20449767	20452490	A03p44390.2_BraZ1	1532.73	+	2831	2717	2723	0.9977965
A03	20453263	20454112	A03p44400.2_BraZ1	84.9	+	673	849	849	1.0000000
A03	20458136	20460245	A03p44410.2_BraZ1	1407.27	+	347	1518	2109	0.7197724
A03	20463057	20465731	A03p44420.2_BraZ1	1471.46	+	1139	2588	2674	0.9678385
A03	20469814	20471326	A03p44430.2_BraZ1	2291.25	-	392	1262	1512	0.8346561
A03	20472606	20474499	A03p44440.2_BraZ1	808.714	+	1077	1861	1893	0.9830956
A03	20474998	20476009	A03p44450.2_BraZ1	787.786	-	970	1011	1011	1.0000000
A03	20476610	20480075	A03p44460.2_BraZ1	3108.44	-	1000	2970	3465	0.8571429
A03	20487643	20489610	A03p44470.2_BraZ1	867.045	+	860	1896	1967	0.9639044
A03	20490114	20494426	A03p44480.2_BraZ1	832.364	-	4659	4280	4312	0.9925789
A03	20499855	20504948	A03p44490.2_BraZ1	1808.02	-	1426	4117	5093	0.8083645
A03	20509011	20514863	A03p44500.2_BraZ1	1668.82	-	1626	5222	5852	0.8923445
A03	20516212	20516374	A03p44510.2_BraZ1	16.2	+	28	162	162	1.0000000
A03	20519529	20520052	A03p44520.2_BraZ1	432	+	498	523	523	1.0000000
A03	20520844	20521300	A03p44530.2_BraZ1	45.6	-	420	456	456	1.0000000
A03	20524762	20525080	A03p44540.2_BraZ1	222	-	73	225	318	0.7075472
A03	20527814	20530947	A03p44550.2_BraZ1	1940.74	+	379	2037	3133	0.6501756
A03	20531502	20533796	A03p44560.2_BraZ1	1282.88	+	2308	2279	2294	0.9934612
A03	20535186	20536466	A03p44570.2_BraZ1	1578	-	684	1280	1280	1.0000000
A03	20541503	20541847	A03p44580.2_BraZ1	249	-	14	254	344	0.7383721
A03	20545300	20546557	A03p44590.2_BraZ1	125.7	+	508	1250	1257	0.9944312
A03	20550352	20551156	A03p44600.2_BraZ1	261	+	434	765	804	0.9514925
A03	20552335	20552614	A03p44610.2_BraZ1	27.9	+	231	269	279	0.9641577
A03	20561641	20562325	A03p44620.2_BraZ1	68.4	+	220	684	684	1.0000000
A03	20562607	20563045	A03p44630.2_BraZ1	43.8	-	91	331	438	0.7557077
A03	20564386	20565925	A03p44640.2_BraZ1	919.658	+	540	1539	1539	1.0000000
A03	20566054	20568716	A03p44650.2_BraZ1	1327.95	-	1638	2662	2662	1.0000000
A03	20569890	20571314	A03p44660.2_BraZ1	525.13	+	405	1304	1424	0.9157304
A03	20573947	20575463	A03p44670.2_BraZ1	1059	+	163	1130	1516	0.7453826
A03	20579512	20580081	A03p44680.2_BraZ1	653.25	+	13	361	569	0.6344464
A03	20581092	20581374	A03p44690.2_BraZ1	28.2	-	97	173	282	0.6134752
A03	20582157	20591107	A03p44700.2_BraZ1	1637.55	+	2923	8246	8950	0.9213408
A03	20597350	20598121	A03p44710.2_BraZ1	77.1	+	310	750	771	0.9727626
A03	20598699	20600784	A03p44720.2_BraZ1	1633.33	+	1491	2011	2085	0.9645084
A03	20599813	20600125	A03p44730.2_BraZ1	31.2	-	551	312	312	1.0000000
A03	20603483	20605122	A03p44740.2_BraZ1	1435	-	2086	1554	1639	0.9481391
A03	20609565	20610850	A03p44750.2_BraZ1	381	+	1139	1285	1285	1.0000000
A03	20613682	20616420	A03p44760.2_BraZ1	1523.67	-	748	2276	2738	0.8312637
A03	20617098	20618838	A03p44770.2_BraZ1	547.826	-	1195	1681	1740	0.9660919
A03	20619057	20620786	A03p44780.2_BraZ1	1212	+	422	1386	1729	0.8016194
A03	20621438	20623514	A03p44790.2_BraZ1	207.6	-	912	2076	2076	1.0000000
A03	20624251	20626708	A03p44800.2_BraZ1	1662.5	+	405	1913	2457	0.7785918
A03	20628918	20629233	A03p44810.2_BraZ1	31.5	-	48	285	315	0.9047619
A03	20629442	20630437	A03p44820.2_BraZ1	462.5	-	59	692	995	0.6954774
A03	20633285	20635065	A03p44830.2_BraZ1	1303.27	+	1145	1780	1780	1.0000000
A03	20635736	20641058	A03p44840.2_BraZ1	3085.16	-	2046	5261	5322	0.9885381
A03	20645016	20647923	A03p44850.2_BraZ1	1121.99	-	2263	2907	2907	1.0000000
A03	20650279	20651288	A03p44860.2_BraZ1	675.692	+	259	905	1009	0.8969277
A03	20652435	20653319	A03p44870.2_BraZ1	30324	-	70	829	884	0.9377828
A03	20654152	20658835	A03p44880.2_BraZ1	2898	-	2940	4649	4683	0.9927397
A03	20664202	20666425	A03p44890.2_BraZ1	1451.81	+	538	1750	2223	0.7872245
A03	20667557	20667911	A03p44900.2_BraZ1	35.4	-	252	354	354	1.0000000
A03	20669009	20671091	A03p44910.2_BraZ1	208.2	-	316	1621	2082	0.7785783
A03	20676220	20677483	A03p44920.2_BraZ1	126.3	+	873	1261	1263	0.9984165
A03	20679185	20680460	A03p44930.2_BraZ1	359.735	+	3828	1275	1275	1.0000000
A03	20685394	20688599	A03p44940.2_BraZ1	252.9	-	3295	3150	3205	0.9828393
A03	20693431	20694172	A03p44950.2_BraZ1	375	+	227	741	741	1.0000000
A03	20696475	20697358	A03p44960.2_BraZ1	4050	-	131	638	883	0.7225368
A03	20700754	20701642	A03p44970.2_BraZ1	465	+	228	865	888	0.9740991
A03	20708384	20710226	A03p44980.2_BraZ1	610.341	+	1821	1842	1842	1.0000000
A03	20710616	20711100	A03p44990.2_BraZ1	396	-	398	484	484	1.0000000
A03	20711618	20712733	A03p45000.2_BraZ1	347.727	-	939	1115	1115	1.0000000
A03	20714869	20719794	A03p45010.2_BraZ1	2570.42	+	394	2413	4925	0.4899492
A03	20721389	20723945	A03p45020.2_BraZ1	1081.5	+	511	1606	2556	0.6283255
A03	20725106	20727762	A03p45030.2_BraZ1	1566	+	2072	2553	2656	0.9612199
A03	20729164	20732257	A03p45040.2_BraZ1	685.389	-	276	2473	3093	0.7995474
A03	20737157	20740667	A03p45050.2_BraZ1	1922.46	+	1049	3174	3510	0.9042735
A03	20742826	20746374	A03p45060.2_BraZ1	2757.07	-	439	2586	3548	0.7288613
A03	20748692	20753748	A03p45070.2_BraZ1	2182.15	-	1267	3794	5056	0.7503956
A03	20757141	20760301	A03p45080.2_BraZ1	1882.68	+	1109	3079	3160	0.9743671
A03	20761463	20762604	A03p45090.2_BraZ1	587.812	-	1350	1141	1141	1.0000000
A03	20763556	20765310	A03p45100.2_BraZ1	888	-	79	1285	1754	0.7326112
A03	20774601	20775786	A03p45110.2_BraZ1	637.32	+	553	1061	1185	0.8953586
A03	20780286	20786618	A03p45120.2_BraZ1	3125.61	+	2112	5451	6332	0.8608655
A03	20787674	20790083	A03p45130.2_BraZ1	1136.25	+	1460	2225	2409	0.9236197
A03	20791198	20793112	A03p45140.2_BraZ1	1051.73	-	920	1908	1914	0.9968652
A03	20796196	20798266	A03p45150.2_BraZ1	1412.84	+	496	1890	2070	0.9130435
A03	20800209	20801058	A03p45160.2_BraZ1	798	+	79	189	849	0.2226148
A03	20802294	20803915	A03p45170.2_BraZ1	780.295	+	967	1523	1621	0.9395435
A03	20805338	20805953	A03p45180.2_BraZ1	61.5	+	567	615	615	1.0000000
A03	20807401	20807515	A03p45190.2_BraZ1	11.4	-	97	114	114	1.0000000
A03	20807565	20808738	A03p45200.2_BraZ1	501	-	517	1173	1173	1.0000000
A03	20811397	20814534	A03p45210.2_BraZ1	1462.72	-	1196	3080	3137	0.9818298
A03	20815517	20815682	A03p45220.2_BraZ1	16.5	+	0	0	165	0.0000000
A03	20818713	20820050	A03p45230.2_BraZ1	747	-	279	806	1337	0.6028422
A03	20824180	20826514	A03p45240.2_BraZ1	1316.09	-	746	2171	2334	0.9301628
A03	20831164	20832457	A03p45250.2_BraZ1	129.3	+	923	1293	1293	1.0000000
A03	20837492	20840145	A03p45260.2_BraZ1	1596.41	+	1694	2642	2653	0.9958537
A03	20844006	20845550	A03p45270.2_BraZ1	720.741	+	546	1126	1544	0.7292746
A03	20846487	20847051	A03p45280.2_BraZ1	56.4	-	21	308	564	0.5460993
A03	20850958	20852966	A03p45290.2_BraZ1	871.697	+	422	1565	2008	0.7793825
A03	20853878	20855093	A03p45300.2_BraZ1	121.5	-	12	608	1215	0.5004115
A03	20855766	20855951	A03p45310.2_BraZ1	159	-	158	185	185	1.0000000
A03	20856146	20860653	A03p45320.2_BraZ1	1426.11	-	2868	4507	4507	1.0000000
A03	20861612	20867301	A03p45330.2_BraZ1	2110.71	-	5059	5581	5689	0.9810160
A03	20869578	20871541	A03p45340.2_BraZ1	851.2	-	415	1782	1963	0.9077942
A03	20877082	20877712	A03p45350.2_BraZ1	63	-	88	300	630	0.4761905
A03	20878906	20888183	A03p45360.2_BraZ1	2073	+	2108	6664	9277	0.7183357
A03	20881529	20883428	A03p45370.2_BraZ1	189.9	-	528	1886	1899	0.9931543
A03	20883737	20896595	A03p45380.2_BraZ1	402	+	8859	10556	12858	0.8209675
A03	20893151	20896126	A03p45390.2_BraZ1	1341	+	2320	2975	2975	1.0000000
A03	20898399	20899623	A03p45400.2_BraZ1	472.381	-	601	1163	1224	0.9501634
A03	20899559	20901389	A03p45410.2_BraZ1	725.349	-	1646	1568	1830	0.8568306
A03	20909288	20913219	A03p45420.2_BraZ1	1274.63	+	428	2888	3931	0.7346731
A03	20916356	20919229	A03p45430.2_BraZ1	1760.1	-	322	2275	2873	0.7918552
A03	20919560	20920353	A03p45440.2_BraZ1	82.4348	-	165	793	793	1.0000000
A03	20922208	20923708	A03p45450.2_BraZ1	502.174	-	521	1132	1500	0.7546667
A03	20927575	20927767	A03p45460.2_BraZ1	19.2	-	137	192	192	1.0000000
A03	20927832	20931085	A03p45470.2_BraZ1	12064	-	694	2631	3253	0.8087919
A03	20931888	20932393	A03p45480.2_BraZ1	489	+	0	0	505	0.0000000
A03	20932630	20932860	A03p45490.2_BraZ1	210	+	10	123	230	0.5347826
A03	20935049	20936973	A03p45500.2_BraZ1	1288.18	-	981	1855	1924	0.9641372
A03	20938549	20939320	A03p45510.2_BraZ1	400.812	+	886	771	771	1.0000000
A03	20949521	20953793	A03p45520.2_BraZ1	1786.83	+	1470	3638	4272	0.8515918
A03	20954840	20956843	A03p45530.2_BraZ1	1578	-	1871	2003	2003	1.0000000
A03	20958824	20963241	A03p45540.2_BraZ1	4582.33	-	2000	4389	4417	0.9936609
A03	20961246	20961632	A03p45550.2_BraZ1	363	-	180	386	386	1.0000000
A03	20966982	20968742	A03p45560.2_BraZ1	617.391	+	342	1274	1760	0.7238637
A03	20970152	20972325	A03p45570.2_BraZ1	987.566	+	1777	2173	2173	1.0000000
A03	20973558	20975884	A03p45580.2_BraZ1	1146.76	-	1726	2253	2326	0.9686157
A03	20977920	20978409	A03p45590.2_BraZ1	48.9	+	550	489	489	1.0000000
A03	20979416	20979878	A03p45600.2_BraZ1	46.2	+	257	462	462	1.0000000
A03	20983357	20985347	A03p45610.2_BraZ1	1147.01	+	2113	1937	1990	0.9733669
A03	20986952	20987435	A03p45620.2_BraZ1	48.3	-	79	261	483	0.5403727
A03	20992544	20993030	A03p45630.2_BraZ1	48.6	-	502	486	486	1.0000000
A03	21000720	21002671	A03p45640.2_BraZ1	835.698	-	1110	1951	1951	1.0000000
A03	21007219	21010264	A03p45650.2_BraZ1	1432.52	+	1431	3035	3045	0.9967159
A03	21011086	21012526	A03p45660.2_BraZ1	685.071	+	671	1407	1440	0.9770833
A03	21014621	21016729	A03p45670.2_BraZ1	2034	+	515	1777	2108	0.8429791
A03	21017530	21020186	A03p45680.2_BraZ1	973.312	+	1449	2655	2656	0.9996235
A03	21021903	21022698	A03p45690.2_BraZ1	79.5	+	435	795	795	1.0000000
A03	21024333	21027166	A03p45700.2_BraZ1	456	+	1395	1966	2833	0.6939640
A03	21031806	21033068	A03p45710.2_BraZ1	573	+	403	1262	1262	1.0000000
A03	21036921	21037460	A03p45720.2_BraZ1	321	-	13	338	539	0.6270872
A03	21038405	21038700	A03p45730.2_BraZ1	243	+	543	295	295	1.0000000
A03	21041424	21041809	A03p45740.2_BraZ1	306	-	464	385	385	1.0000000
A03	21042862	21043153	A03p45750.2_BraZ1	29.1	-	139	291	291	1.0000000
A03	21049557	21049848	A03p45760.2_BraZ1	29.1	-	126	291	291	1.0000000
A03	21051168	21051276	A03p45770.2_BraZ1	10.8	+	1	44	108	0.4074074
A03	21051618	21052517	A03p45780.2_BraZ1	365.625	+	0	0	899	0.0000000
A03	21054895	21056470	A03p45790.2_BraZ1	157.5	-	80	889	1575	0.5644444
A03	21063898	21066721	A03p45800.2_BraZ1	282.3	+	2441	2823	2823	1.0000000
A03	21069235	21069913	A03p45810.2_BraZ1	67.8	+	304	668	678	0.9852507
A03	21075127	21076928	A03p45820.2_BraZ1	809.4	-	422	1564	1801	0.8684064
A03	21077435	21077549	A03p45830.2_BraZ1	11.4	-	88	114	114	1.0000000
A03	21083291	21083858	A03p45840.2_BraZ1	56.7	+	68	453	567	0.7989418
A03	21084396	21084854	A03p45850.2_BraZ1	207	+	429	458	458	1.0000000
A03	21096775	21097762	A03p45860.2_BraZ1	98.7	-	92	916	987	0.9280648
A03	21102335	21103957	A03p45870.2_BraZ1	1455	+	251	1390	1622	0.8569667
A03	21106704	21107324	A03p45880.2_BraZ1	375	+	63	533	620	0.8596774
A03	21107339	21107710	A03p45890.2_BraZ1	418.5	+	130	371	371	1.0000000
A03	21109814	21110150	A03p45900.2_BraZ1	249	+	153	336	336	1.0000000
A03	21114209	21114350	A03p45910.2_BraZ1	14.1	+	57	141	141	1.0000000
A03	21114479	21117637	A03p45920.2_BraZ1	1509.8	+	1574	3158	3158	1.0000000
A03	21118091	21118452	A03p45930.2_BraZ1	180	-	597	361	361	1.0000000
A03	21120324	21120739	A03p45940.2_BraZ1	330	+	24	167	415	0.4024096
A03	21125240	21125872	A03p45950.2_BraZ1	222	+	664	632	632	1.0000000
A03	21128333	21128525	A03p45960.2_BraZ1	19.2	-	134	192	192	1.0000000
A03	21131462	21137812	A03p45970.2_BraZ1	312.66	-	3348	5551	6350	0.8741732
A03	21138284	21138953	A03p45980.2_BraZ1	315	-	319	484	669	0.7234679
A03	21139635	21139970	A03p45990.2_BraZ1	246	-	183	335	335	1.0000000
A03	21140697	21141421	A03p46000.2_BraZ1	887.25	-	213	701	724	0.9682320
A03	21141497	21142033	A03p46010.2_BraZ1	292.5	-	14	285	536	0.5317164
A03	21142687	21143102	A03p46020.2_BraZ1	330	+	355	415	415	1.0000000
A03	21145348	21145951	A03p46030.2_BraZ1	196	+	257	603	603	1.0000000
A03	21147630	21149585	A03p46040.2_BraZ1	243	+	2144	1943	1955	0.9938619
A03	21153764	21155276	A03p46050.2_BraZ1	151.2	-	1492	1512	1512	1.0000000
A03	21156845	21157004	A03p46060.2_BraZ1	15.9	-	44	159	159	1.0000000
A03	21158557	21160611	A03p46070.2_BraZ1	1092.73	-	790	1963	2054	0.9556962
A03	21168969	21170997	A03p46080.2_BraZ1	1015.74	+	1821	2017	2028	0.9945759
A03	21175982	21176102	A03p46090.2_BraZ1	12	+	258	120	120	1.0000000
A03	21180118	21180352	A03p46100.2_BraZ1	23.4	+	51	165	234	0.7051282
A03	21186991	21189982	A03p46110.2_BraZ1	1311	-	1267	2661	2991	0.8896690
A03	21190798	21192659	A03p46120.2_BraZ1	897.273	+	1373	1861	1861	1.0000000
A03	21193353	21195930	A03p46130.2_BraZ1	257.7	-	3101	2105	2577	0.8168413
A03	21196307	21201927	A03p46140.2_BraZ1	603	-	596	2860	5620	0.5088968
A03	21204424	21207471	A03p46150.2_BraZ1	675.294	-	1470	2941	3047	0.9652117
A03	21209637	21209859	A03p46160.2_BraZ1	22.2	+	452	222	222	1.0000000
A03	21213599	21214434	A03p46170.2_BraZ1	526.125	+	249	814	835	0.9748503
A03	21216114	21218316	A03p46180.2_BraZ1	1545.78	-	467	1999	2202	0.9078111
A03	21222935	21223085	A03p46190.2_BraZ1	13.8	+	341	150	150	1.0000000
A03	21225171	21226186	A03p46200.2_BraZ1	828	-	674	1015	1015	1.0000000
A03	21228618	21230056	A03p46210.2_BraZ1	941.25	+	466	1438	1438	1.0000000
A03	21232586	21235711	A03p46220.2_BraZ1	2601	-	1653	3125	3125	1.0000000
A03	21237228	21238619	A03p46230.2_BraZ1	502.2	-	957	1391	1391	1.0000000
A03	21242172	21243636	A03p46240.2_BraZ1	146.4	+	1580	1464	1464	1.0000000
A03	21248652	21249980	A03p46250.2_BraZ1	1245	+	1456	1328	1328	1.0000000
A03	21250369	21251048	A03p46260.2_BraZ1	197.921	-	826	679	679	1.0000000
A03	21251764	21253868	A03p46270.2_BraZ1	1412.21	-	1223	2104	2104	1.0000000
A03	21256911	21257873	A03p46280.2_BraZ1	372	+	20	143	962	0.1486486
A03	21271348	21279135	A03p46290.2_BraZ1	4121.55	+	3764	7063	7787	0.9070245
A03	21279514	21281096	A03p46300.2_BraZ1	1350	-	332	1547	1582	0.9778761
A03	21285355	21287215	A03p46310.2_BraZ1	702.188	+	2546	1860	1860	1.0000000
A03	21290218	21291424	A03p46320.2_BraZ1	669	-	1434	1206	1206	1.0000000
A03	21297184	21299517	A03p46330.2_BraZ1	1569.18	+	3125	2332	2333	0.9995714
A03	21304342	21305550	A03p46340.2_BraZ1	546	-	1410	1208	1208	1.0000000
A03	21309018	21311085	A03p46350.2_BraZ1	758.875	-	729	1991	2067	0.9632317
A03	21315214	21319233	A03p46360.2_BraZ1	2380.91	-	329	2139	4019	0.5322220
A03	21320247	21320535	A03p46370.2_BraZ1	28.8	-	152	288	288	1.0000000
A03	21321143	21322230	A03p46380.2_BraZ1	35516.2	+	788	1069	1087	0.9834406
A03	21322879	21329078	A03p46390.2_BraZ1	820.863	-	2167	5550	6199	0.8953057
A03	21330089	21331477	A03p46400.2_BraZ1	504	-	1453	1388	1388	1.0000000
A03	21334938	21335265	A03p46410.2_BraZ1	32.7	-	210	327	327	1.0000000
A03	21344001	21346798	A03p46420.2_BraZ1	1397.5	-	1017	2642	2797	0.9445835
A03	21366289	21367189	A03p46430.2_BraZ1	813	+	0	0	900	0.0000000
A03	21373612	21376513	A03p46440.2_BraZ1	493.714	+	335	1240	2901	0.4274388
A03	21374360	21374861	A03p46450.2_BraZ1	50.1	-	0	0	501	0.0000000
A03	21378627	21379828	A03p46460.2_BraZ1	406.107	+	978	1201	1201	1.0000000
A03	21380962	21381574	A03p46470.2_BraZ1	61.2	-	982	612	612	1.0000000
A03	21388068	21388401	A03p46480.2_BraZ1	216	+	12	220	333	0.6606607
A03	21389714	21390279	A03p46490.2_BraZ1	312	+	36	396	565	0.7008849
A03	21404095	21405061	A03p46500.2_BraZ1	864	-	86	644	966	0.6666667
A03	21410719	21413072	A03p46510.2_BraZ1	782.708	-	1211	2353	2353	1.0000000
A03	21414752	21418818	A03p46520.2_BraZ1	2420	-	1914	2370	4066	0.5828825
A03	21421848	21423362	A03p46530.2_BraZ1	420.2	+	879	1514	1514	1.0000000
A03	21424857	21426034	A03p46540.2_BraZ1	318.212	+	753	1177	1177	1.0000000
A03	21427847	21428667	A03p46550.2_BraZ1	440.227	+	355	765	820	0.9329268
A03	21437105	21437846	A03p46560.2_BraZ1	74.1	+	825	741	741	1.0000000
A03	21438373	21439020	A03p46570.2_BraZ1	1602	-	264	647	647	1.0000000
A03	21443084	21443688	A03p46580.2_BraZ1	261	+	83	542	604	0.8973510
A03	21445824	21448085	A03p46590.2_BraZ1	1953	+	992	2226	2261	0.9845201
A03	21451642	21451933	A03p46600.2_BraZ1	225	+	164	291	291	1.0000000
A03	21454470	21454739	A03p46610.2_BraZ1	19.2	+	594	269	269	1.0000000
A03	21463043	21465246	A03p46620.2_BraZ1	1455.86	+	1411	2203	2203	1.0000000
A03	21468026	21469470	A03p46630.2_BraZ1	1200	-	817	1444	1444	1.0000000
A03	21477907	21480220	A03p46640.2_BraZ1	1573.99	+	374	1998	2313	0.8638132
A03	21480717	21487343	A03p46650.2_BraZ1	2532.82	-	2311	4856	6626	0.7328705
A03	21489273	21490845	A03p46660.2_BraZ1	402.5	-	96	819	1572	0.5209923
A03	21495434	21511887	A03p46670.2_BraZ1	391.2	-	9453	12717	16453	0.7729290
A03	21507431	21508439	A03p46680.2_BraZ1	246	-	1674	1008	1008	1.0000000
A03	21521883	21528671	A03p46690.2_BraZ1	1450.26	+	3430	6577	6788	0.9689158
A03	21530193	21530337	A03p46700.2_BraZ1	14.4	+	89	144	144	1.0000000
A03	21531456	21540915	A03p46710.2_BraZ1	1040.48	+	10135	9459	9459	1.0000000
A03	21541374	21548607	A03p46720.2_BraZ1	4488.75	-	1613	5463	7233	0.7552882
A03	21554920	21556478	A03p46730.2_BraZ1	5844	+	712	1558	1558	1.0000000
A03	21562025	21563032	A03p46740.2_BraZ1	831.9	+	96	634	1007	0.6295928
A03	21566139	21566931	A03p46750.2_BraZ1	79.2	+	647	792	792	1.0000000
A03	21568000	21568774	A03p46760.2_BraZ1	77.4	+	108	716	774	0.9250646
A03	21578279	21579005	A03p46770.2_BraZ1	348	+	725	720	726	0.9917355
A03	21581807	21584080	A03p46780.2_BraZ1	1368.9	-	616	2216	2273	0.9749230
A03	21589184	21591151	A03p46790.2_BraZ1	1575	-	738	1926	1967	0.9791561
A03	21592027	21594333	A03p46800.2_BraZ1	706.335	-	1412	2306	2306	1.0000000
A03	21597474	21599629	A03p46810.2_BraZ1	950.78	-	1724	2155	2155	1.0000000
A03	21600291	21602157	A03p46820.2_BraZ1	1399.43	+	665	1866	1866	1.0000000
A03	21602375	21604157	A03p46830.2_BraZ1	905.25	-	1425	1770	1782	0.9932660
A03	21605842	21606843	A03p46840.2_BraZ1	1920	-	15	222	1001	0.2217782
A03	21608136	21609564	A03p46850.2_BraZ1	391.125	+	281	1080	1428	0.7563025
A03	21612600	21615056	A03p46860.2_BraZ1	1671	+	854	2359	2456	0.9605049
A03	21615741	21616823	A03p46870.2_BraZ1	103.5	+	532	1082	1082	1.0000000
A03	21619401	21624590	A03p46880.2_BraZ1	3561.13	-	2321	5013	5189	0.9660821
A03	21627355	21628150	A03p46890.2_BraZ1	708	-	562	795	795	1.0000000
A03	21628413	21630027	A03p46900.2_BraZ1	1150.43	-	1393	1614	1614	1.0000000
A03	21631654	21633877	A03p46910.2_BraZ1	1099.8	-	1321	2223	2223	1.0000000
A03	21634314	21651369	A03p46920.2_BraZ1	11336.6	-	2023	8377	17055	0.4911756
A03	21652715	21653058	A03p46930.2_BraZ1	1511.25	+	114	343	343	1.0000000
A03	21669731	21670574	A03p46940.2_BraZ1	84.3	-	694	843	843	1.0000000
A03	21673127	21673718	A03p46950.2_BraZ1	59.1	+	0	0	591	0.0000000
A03	21680883	21686210	A03p46960.2_BraZ1	2826	+	1684	4825	5327	0.9057631
A03	21686982	21687846	A03p46970.2_BraZ1	86.4	-	510	864	864	1.0000000
A03	21690074	21690286	A03p46980.2_BraZ1	16.5	+	55	212	212	1.0000000
A03	21691833	21693725	A03p46990.2_BraZ1	983.58	+	1310	1892	1892	1.0000000
A03	21694903	21700720	A03p47000.2_BraZ1	2186.22	+	5681	5696	5817	0.9791989
A03	21701824	21704062	A03p47010.2_BraZ1	1192.83	-	1637	2238	2238	1.0000000
A03	21704723	21706514	A03p47020.2_BraZ1	492	-	1971	1791	1791	1.0000000
A03	21707206	21712822	A03p47030.2_BraZ1	980.571	-	4694	5616	5616	1.0000000
A03	21723532	21724096	A03p47040.2_BraZ1	56.4	+	9	416	564	0.7375886
A03	21728954	21730217	A03p47050.2_BraZ1	126.3	+	446	1162	1263	0.9200317
A03	21731594	21732167	A03p47060.2_BraZ1	55.2	+	146	450	573	0.7853403
A03	21732370	21733103	A03p47070.2_BraZ1	400.5	-	755	733	733	1.0000000
A03	21746974	21747859	A03p47080.2_BraZ1	88.5	+	93	472	885	0.5333334
A03	21750096	21752054	A03p47090.2_BraZ1	1215.35	-	1013	1920	1958	0.9805924
A03	21752940	21754050	A03p47100.2_BraZ1	509.211	-	99	760	1110	0.6846847
A03	21764923	21766314	A03p47110.2_BraZ1	951	+	271	1309	1391	0.9410496
A03	21775322	21779213	A03p47120.2_BraZ1	14904	-	1392	3438	3891	0.8835775
A03	21780112	21780358	A03p47130.2_BraZ1	24.6	+	245	246	246	1.0000000
A03	21781769	21784544	A03p47140.2_BraZ1	4004	-	2108	2775	2775	1.0000000
A03	21796708	21816946	A03p47150.2_BraZ1	1012.15	-	10789	13654	20238	0.6746714
A03	21800440	21802531	A03p47160.2_BraZ1	414	+	1261	2091	2091	1.0000000
A03	21818825	21825090	A03p47170.2_BraZ1	3614.35	-	1435	5164	6265	0.8242618
A03	21825594	21828067	A03p47180.2_BraZ1	1123.04	+	1658	2473	2473	1.0000000
A03	21828201	21829089	A03p47190.2_BraZ1	560.118	-	571	886	888	0.9977477
A03	21829536	21829968	A03p47200.2_BraZ1	43.2	-	84	279	432	0.6458333
A03	21838803	21839883	A03p47210.2_BraZ1	108	-	111	550	1080	0.5092593
A03	21848762	21851820	A03p47220.2_BraZ1	997.118	+	2197	3058	3058	1.0000000
A03	21852399	21855005	A03p47230.2_BraZ1	1019.39	-	1795	2606	2606	1.0000000
A03	21854924	21857970	A03p47240.2_BraZ1	1216.98	-	1297	3015	3046	0.9898227
A03	21860364	21864226	A03p47250.2_BraZ1	2225.14	+	2480	3827	3862	0.9909374
A03	21864510	21866392	A03p47260.2_BraZ1	8365.5	-	1109	1873	1882	0.9952179
A03	21867708	21870778	A03p47270.2_BraZ1	1762.56	-	902	2525	3070	0.8224756
A03	21871216	21873474	A03p47280.2_BraZ1	1881	-	827	2217	2258	0.9818423
A03	21877171	21883071	A03p47290.2_BraZ1	1305.09	-	3691	5130	5900	0.8694915
A03	21885417	21887094	A03p47300.2_BraZ1	645.937	-	605	1608	1677	0.9588551
A03	21887988	21888821	A03p47310.2_BraZ1	405.551	+	523	807	833	0.9687875
A03	21892623	21903545	A03p47320.2_BraZ1	547.879	+	6327	10675	10922	0.9773851
A03	21904152	21904626	A03p47330.2_BraZ1	357	+	737	474	474	1.0000000
A03	21906062	21908204	A03p47340.2_BraZ1	481.25	+	0	0	2142	0.0000000
A03	21910399	21913620	A03p47350.2_BraZ1	1404.38	+	807	2965	3221	0.9205216
A03	21915277	21916562	A03p47360.2_BraZ1	904.842	+	368	1274	1285	0.9914397
A03	21917002	21917266	A03p47370.2_BraZ1	26.4	-	225	264	264	1.0000000
A03	21917885	21918165	A03p47380.2_BraZ1	23.7	-	256	280	280	1.0000000
A03	21918774	21919302	A03p47390.2_BraZ1	52.8	+	213	528	528	1.0000000
A03	21920438	21922651	A03p47400.2_BraZ1	953.623	+	2241	2213	2213	1.0000000
A03	21923008	21925663	A03p47410.2_BraZ1	1418.53	-	864	2420	2655	0.9114878
A03	21928764	21930129	A03p47420.2_BraZ1	136.5	+	379	1365	1365	1.0000000
A03	21930416	21936761	A03p47430.2_BraZ1	1699.45	-	1604	5390	6345	0.8494878
A03	21943959	21947109	A03p47440.2_BraZ1	1171.9	+	1653	2883	3150	0.9152381
A03	21948597	21951367	A03p47450.2_BraZ1	1245.69	+	486	2165	2770	0.7815884
A03	21951916	21955919	A03p47460.2_BraZ1	1335	-	2423	3999	4003	0.9990007
A03	21957012	21958082	A03p47470.2_BraZ1	97.5	-	97	937	1070	0.8757010
A03	21961660	21963176	A03p47480.2_BraZ1	6804	-	51	517	1516	0.3410290
A03	21963334	21963958	A03p47490.2_BraZ1	1408	+	24	432	624	0.6923077
A03	21964168	21965620	A03p47500.2_BraZ1	145.2	-	24	712	1452	0.4903581
A03	21966901	21967527	A03p47510.2_BraZ1	1760	+	125	604	626	0.9648562
A03	21967648	21969100	A03p47520.2_BraZ1	145.2	-	81	908	1452	0.6253443
A03	21970591	21971578	A03p47530.2_BraZ1	729	+	6	20	987	0.0202634
A03	21971834	21972167	A03p47540.2_BraZ1	33.3	-	61	32	333	0.0960961
A03	21974233	21976427	A03p47550.2_BraZ1	1494.21	+	1811	2194	2194	1.0000000
A03	21977184	21978869	A03p47560.2_BraZ1	687.983	-	1490	1685	1685	1.0000000
A03	21979511	21979793	A03p47570.2_BraZ1	28.2	-	337	282	282	1.0000000
A03	21995226	21996801	A03p47580.2_BraZ1	8658	-	460	1318	1575	0.8368254
A03	22013449	22014594	A03p47590.2_BraZ1	1168.5	-	29	412	1145	0.3598253
A03	22020393	22021441	A03p47600.2_BraZ1	2554.86	+	1073	1048	1048	1.0000000
A03	22022775	22025209	A03p47610.2_BraZ1	1065.05	-	3194	2434	2434	1.0000000
A03	22026799	22029570	A03p47620.2_BraZ1	502.714	+	3185	2771	2771	1.0000000
A03	22031581	22040977	A03p47630.2_BraZ1	4311.94	-	2560	7431	9396	0.7908685
A03	22041851	22042929	A03p47640.2_BraZ1	245.143	+	523	1078	1078	1.0000000
A03	22042191	22042558	A03p47650.2_BraZ1	35.1	+	175	367	367	1.0000000
A03	22045919	22046513	A03p47660.2_BraZ1	238	-	0	0	594	0.0000000
A03	22046734	22047154	A03p47670.2_BraZ1	42	+	4	99	420	0.2357143
A03	22047932	22048760	A03p47680.2_BraZ1	82.8	+	171	630	828	0.7608696
A03	22050146	22053445	A03p47690.2_BraZ1	3093	-	659	2915	3299	0.8836011
A03	22059805	22060861	A03p47700.2_BraZ1	790.263	+	698	1056	1056	1.0000000
A03	22061249	22063015	A03p47710.2_BraZ1	874.2	-	981	1754	1766	0.9932050
A03	22063848	22066046	A03p47720.2_BraZ1	1440.23	-	787	2088	2198	0.9499545
A03	22069428	22073610	A03p47730.2_BraZ1	1441.19	+	2948	4093	4182	0.9787183
A03	22075039	22081983	A03p47740.2_BraZ1	2377.55	+	1099	5703	6944	0.8212845
A03	22085074	22086433	A03p47750.2_BraZ1	135.9	+	776	1359	1359	1.0000000
A03	22091904	22095068	A03p47760.2_BraZ1	1944	+	929	3086	3164	0.9753476
A03	22101028	22102829	A03p47770.2_BraZ1	1083	+	643	1718	1801	0.9539145
A03	22103221	22105535	A03p47780.2_BraZ1	2226	-	630	2221	2314	0.9598098
A03	22105949	22108580	A03p47790.2_BraZ1	1480.56	+	666	2342	2631	0.8901559
A03	22109179	22109785	A03p47800.2_BraZ1	60.6	-	47	403	606	0.6650165
A03	22113630	22114407	A03p47810.2_BraZ1	77.7	-	123	441	777	0.5675676
A03	22116954	22117128	A03p47820.2_BraZ1	17.4	+	244	174	174	1.0000000
A03	22119143	22120614	A03p47830.2_BraZ1	594	+	437	1466	1471	0.9966009
A03	22125008	22126190	A03p47840.2_BraZ1	775.568	+	195	1081	1182	0.9145516
A03	22126433	22127216	A03p47850.2_BraZ1	444	-	157	739	783	0.9438059
A03	22132025	22132764	A03p47860.2_BraZ1	799	+	897	739	739	1.0000000
A03	22136394	22140086	A03p47870.2_BraZ1	2508	+	4257	3436	3692	0.9306609
A03	22140477	22140897	A03p47880.2_BraZ1	42	-	54	345	420	0.8214286
A03	22150316	22160527	A03p47890.2_BraZ1	2878.82	-	5516	8988	10211	0.8802272
A03	22160837	22178669	A03p47900.2_BraZ1	2534.2	+	4573	12298	17832	0.6896591
A03	22165825	22167116	A03p47910.2_BraZ1	204	+	1386	904	1291	0.7002324
A03	22167343	22169093	A03p47920.2_BraZ1	1407.71	+	132	1125	1750	0.6428571
A03	22178791	22179406	A03p47930.2_BraZ1	61.5	-	121	570	615	0.9268293
A03	22185591	22188661	A03p47940.2_BraZ1	2982	+	772	2750	3070	0.8957655
A03	22199806	22201501	A03p47950.2_BraZ1	1413	-	424	1506	1695	0.8884956
A03	22202803	22203154	A03p47960.2_BraZ1	35.1	+	233	351	351	1.0000000
A03	22203180	22203985	A03p47970.2_BraZ1	2640	+	827	805	805	1.0000000
A03	22204609	22206813	A03p47980.2_BraZ1	595.174	-	869	2121	2204	0.9623412
A03	22209783	22212620	A03p47990.2_BraZ1	2484	+	1560	2743	2837	0.9668664
A03	22214143	22215220	A03p48000.2_BraZ1	107.7	-	221	1077	1077	1.0000000
A03	22221787	22222869	A03p48010.2_BraZ1	656.679	+	545	1082	1082	1.0000000
A03	22223280	22225850	A03p48020.2_BraZ1	444	-	1737	2570	2570	1.0000000
A03	22227079	22229065	A03p48030.2_BraZ1	803.857	+	1812	1986	1986	1.0000000
A03	22229569	22230010	A03p48040.2_BraZ1	44.1	+	141	397	441	0.9002268
A03	22231175	22232509	A03p48050.2_BraZ1	650.95	-	737	1334	1334	1.0000000
A03	22239334	22239965	A03p48060.2_BraZ1	60.6	+	123	602	631	0.9540412
A03	22244837	22245656	A03p48070.2_BraZ1	726	+	493	819	819	1.0000000
A03	22253320	22253959	A03p48080.2_BraZ1	213.15	-	1	39	639	0.0610329
A03	22255557	22257003	A03p48090.2_BraZ1	144.6	-	192	1132	1446	0.7828493
A03	22266245	22267457	A03p48100.2_BraZ1	1950	-	979	1212	1212	1.0000000
A03	22268987	22269869	A03p48110.2_BraZ1	88.2	-	250	882	882	1.0000000
A03	22275238	22275737	A03p48120.2_BraZ1	264	+	235	499	499	1.0000000
A03	22284339	22285568	A03p48130.2_BraZ1	936.385	-	267	1138	1229	0.9259561
A03	22288722	22289035	A03p48140.2_BraZ1	249	-	64	313	313	1.0000000
A03	22290122	22292920	A03p48150.2_BraZ1	1592.33	-	1372	2767	2798	0.9889206
A03	22294433	22295747	A03p48160.2_BraZ1	540	-	296	914	1314	0.6955860
A03	22299003	22304520	A03p48170.2_BraZ1	9218	-	1193	4306	5517	0.7804967
A03	22309856	22311597	A03p48180.2_BraZ1	753	-	162	925	1741	0.5313038
A03	22316776	22318830	A03p48190.2_BraZ1	1643.5	-	163	898	2054	0.4371957
A03	22323506	22324901	A03p48200.2_BraZ1	139.5	+	155	881	1395	0.6315412
A03	22325587	22325931	A03p48210.2_BraZ1	355.333	+	681	344	344	1.0000000
A03	22334651	22335380	A03p48220.2_BraZ1	72.9	+	203	676	729	0.9272977
A03	22335589	22337728	A03p48230.2_BraZ1	213.9	-	996	2137	2139	0.9990650
A03	22338908	22340074	A03p48240.2_BraZ1	769.043	-	222	1132	1166	0.9708405
A03	22353308	22354469	A03p48250.2_BraZ1	615	+	1376	1161	1161	1.0000000
A03	22355212	22357014	A03p48260.2_BraZ1	984.56	-	709	1702	1802	0.9445061
A03	22359936	22361118	A03p48270.2_BraZ1	118.2	-	1483	1171	1182	0.9906937
A03	22365250	22366465	A03p48280.2_BraZ1	789.622	-	340	1198	1215	0.9860082
A03	22380782	22381669	A03p48290.2_BraZ1	63.9	+	1460	887	887	1.0000000
A03	22385817	22388114	A03p48300.2_BraZ1	1473	-	1393	1704	2297	0.7418372
A03	22394779	22396237	A03p48310.2_BraZ1	145.8	-	33	393	1458	0.2695473
A03	22404993	22405968	A03p48320.2_BraZ1	858	-	259	762	975	0.7815385
A03	22407582	22407741	A03p48330.2_BraZ1	15.9	-	33	159	159	1.0000000
A03	22407792	22408515	A03p48340.2_BraZ1	676.406	+	1	15	723	0.0207469
A03	22418564	22419581	A03p48350.2_BraZ1	101.7	+	93	896	1017	0.8810226
A03	22426988	22427600	A03p48360.2_BraZ1	61.2	+	278	531	612	0.8676471
A03	22428038	22428698	A03p48370.2_BraZ1	33	-	0	0	660	0.0000000
A03	22433179	22434338	A03p48380.2_BraZ1	954	-	1057	1159	1159	1.0000000
A03	22435799	22436270	A03p48390.2_BraZ1	47.1	-	219	471	471	1.0000000
A03	22440454	22441071	A03p48400.2_BraZ1	342.857	-	178	554	617	0.8978930
A03	22444015	22445043	A03p48410.2_BraZ1	594.261	-	699	1028	1028	1.0000000
A03	22448065	22449325	A03p48420.2_BraZ1	390.391	+	1051	1260	1260	1.0000000
A03	22485783	22486966	A03p48430.2_BraZ1	837	+	390	1060	1183	0.8960270
A03	22497405	22498415	A03p48440.2_BraZ1	1136	+	371	1010	1010	1.0000000
A03	22499648	22500071	A03p48450.2_BraZ1	42.3	+	147	423	423	1.0000000
A03	22502184	22503593	A03p48460.2_BraZ1	1210.25	+	1300	1409	1409	1.0000000
A03	22503981	22504984	A03p48470.2_BraZ1	500.32	-	1182	1003	1003	1.0000000
A03	22509835	22510594	A03p48480.2_BraZ1	75.9	+	416	758	759	0.9986825
A03	22514049	22514398	A03p48490.2_BraZ1	312	+	5	152	349	0.4355301
A03	22515738	22517250	A03p48500.2_BraZ1	150.9	+	396	1439	1512	0.9517196
A03	22517737	22523271	A03p48510.2_BraZ1	1205.21	-	2984	5447	5534	0.9842790
A03	22523775	22524365	A03p48520.2_BraZ1	395.357	+	546	590	590	1.0000000
A03	22526473	22527397	A03p48530.2_BraZ1	34.5	-	792	924	924	1.0000000
A03	22528473	22534152	A03p48540.2_BraZ1	2460.71	+	2941	4860	5679	0.8557845
A03	22535632	22537066	A03p48550.2_BraZ1	729.167	-	1392	1434	1434	1.0000000
A03	22537846	22539277	A03p48560.2_BraZ1	635.5	-	601	1431	1431	1.0000000
A03	22540641	22546348	A03p48570.2_BraZ1	3468.8	-	2501	5571	5707	0.9761696
A03	22550329	22551267	A03p48580.2_BraZ1	411	+	124	670	938	0.7142857
A03	22552685	22557613	A03p48590.2_BraZ1	1072.31	+	4071	4868	4928	0.9878247
A03	22561255	22562028	A03p48600.2_BraZ1	270.375	+	980	773	773	1.0000000
A03	22562142	22566478	A03p48610.2_BraZ1	2957.38	+	2265	4249	4336	0.9799354
A03	22566853	22567939	A03p48620.2_BraZ1	108.6	-	145	974	1086	0.8968692
A03	22569309	22570254	A03p48630.2_BraZ1	780	-	144	900	945	0.9523810
A03	22571542	22572221	A03p48640.2_BraZ1	576	-	315	679	679	1.0000000
A03	22573487	22574831	A03p48650.2_BraZ1	638.182	+	445	1283	1344	0.9546131
A03	22575696	22577041	A03p48660.2_BraZ1	772.308	+	556	1345	1345	1.0000000
A03	22578061	22580898	A03p48670.2_BraZ1	1309.96	+	1677	2823	2837	0.9950652
A03	22581348	22582805	A03p48680.2_BraZ1	128.7	+	873	1457	1457	1.0000000
A03	22583885	22584938	A03p48690.2_BraZ1	346.182	+	1261	1053	1053	1.0000000
A03	22585221	22587961	A03p48700.2_BraZ1	1313.18	-	1711	2510	2740	0.9160584
A03	22595701	22596089	A03p48710.2_BraZ1	312	-	161	358	388	0.9226804
A03	22598327	22599161	A03p48720.2_BraZ1	83.4	-	110	414	834	0.4964029
A03	22601769	22602609	A03p48730.2_BraZ1	84	-	94	681	840	0.8107143
A03	22607001	22610440	A03p48740.2_BraZ1	184.8	+	1459	2158	3439	0.6275080
A03	22608039	22609923	A03p48750.2_BraZ1	188.4	-	774	1174	1884	0.6231422
A03	22610797	22612421	A03p48760.2_BraZ1	894.034	+	909	1624	1624	1.0000000
A03	22613190	22615884	A03p48770.2_BraZ1	269.4	-	662	2582	2694	0.9584261
A03	22617037	22619110	A03p48780.2_BraZ1	3289.5	-	1081	2010	2073	0.9696093
A03	22621345	22621762	A03p48790.2_BraZ1	41.7	-	87	262	417	0.6282974
A03	22624079	22624584	A03p48800.2_BraZ1	396	-	11	307	505	0.6079208
A03	22625589	22625856	A03p48810.2_BraZ1	161	-	283	267	267	1.0000000
A03	22626481	22627374	A03p48820.2_BraZ1	46.6667	-	917	842	893	0.9428892
A03	22629243	22632143	A03p48830.2_BraZ1	1651.91	+	801	2739	2900	0.9444827
A03	22633403	22633736	A03p48840.2_BraZ1	33.3	+	64	333	333	1.0000000
A03	22636774	22637780	A03p48850.2_BraZ1	339	-	657	858	1006	0.8528827
A03	22643098	22643353	A03p48860.2_BraZ1	25.5	+	285	255	255	1.0000000
A03	22652326	22659731	A03p48870.2_BraZ1	642.357	+	1910	5325	7405	0.7191087
A03	22666946	22668006	A03p48880.2_BraZ1	903	-	216	755	1060	0.7122642
A03	22673509	22675288	A03p48890.2_BraZ1	1536	+	457	1415	1779	0.7953907
A03	22676268	22677391	A03p48900.2_BraZ1	637.98	+	462	1094	1123	0.9741763
A03	22677932	22678538	A03p48910.2_BraZ1	795	-	163	586	606	0.9669967
A03	22679046	22679370	A03p48920.2_BraZ1	32.4	-	172	324	324	1.0000000
A03	22680016	22683037	A03p48930.2_BraZ1	2712.04	-	849	2598	3021	0.8599802
A03	22685089	22686599	A03p48940.2_BraZ1	673.524	-	1380	1510	1510	1.0000000
A03	22687392	22689551	A03p48950.2_BraZ1	1122	-	1870	2159	2159	1.0000000
A03	22695646	22697882	A03p48960.2_BraZ1	1478.03	+	838	2236	2236	1.0000000
A03	22709824	22712994	A03p48970.2_BraZ1	1341.09	+	1725	3011	3170	0.9498423
A03	22714720	22715894	A03p48980.2_BraZ1	489.409	-	1051	1174	1174	1.0000000
A03	22727970	22732609	A03p48990.2_BraZ1	1850.73	-	2381	4445	4639	0.9581807
A03	22742595	22743898	A03p49000.2_BraZ1	2439	+	301	1258	1303	0.9654643
A03	22746913	22748209	A03p49010.2_BraZ1	810	+	305	1094	1296	0.8441358
A03	22753564	22755752	A03p49020.2_BraZ1	898.378	-	1036	2188	2188	1.0000000
A03	22757368	22757945	A03p49030.2_BraZ1	645	+	658	577	577	1.0000000
A03	22759134	22761359	A03p49040.2_BraZ1	1154.37	+	549	2016	2225	0.9060674
A03	22761502	22761941	A03p49050.2_BraZ1	260	-	380	439	439	1.0000000
A03	22763345	22765650	A03p49060.2_BraZ1	667.738	-	1509	2305	2305	1.0000000
A03	22767185	22770333	A03p49070.2_BraZ1	2087.8	+	650	2768	3148	0.8792884
A03	22770829	22771362	A03p49080.2_BraZ1	186	-	571	533	533	1.0000000
A03	22771924	22775034	A03p49090.2_BraZ1	1564.04	+	2416	3110	3110	1.0000000
A03	22777094	22777560	A03p49100.2_BraZ1	40.2	-	166	466	466	1.0000000
A03	22778390	22779350	A03p49110.2_BraZ1	675	+	482	914	960	0.9520833
A03	22779618	22781120	A03p49120.2_BraZ1	1374	-	1405	1502	1502	1.0000000
A03	22781544	22783331	A03p49130.2_BraZ1	130.8	-	1639	1787	1787	1.0000000
A03	22786248	22793540	A03p49140.2_BraZ1	6065.81	+	2265	6278	7292	0.8609435
A03	22793862	22798142	A03p49150.2_BraZ1	1192.12	-	3139	4280	4280	1.0000000
A03	22799181	22800632	A03p49160.2_BraZ1	597.927	-	1059	1451	1451	1.0000000
A03	22801374	22802382	A03p49170.2_BraZ1	100.8	+	170	1008	1008	1.0000000
A03	22802750	22803510	A03p49180.2_BraZ1	3162	-	606	760	760	1.0000000
A03	22803761	22805469	A03p49190.2_BraZ1	1020	-	1808	1708	1708	1.0000000
A03	22806169	22807522	A03p49200.2_BraZ1	546	+	802	1060	1353	0.7834442
A03	22807958	22809194	A03p49210.2_BraZ1	123	-	157	899	1236	0.7273463
A03	22811612	22812494	A03p49220.2_BraZ1	327	+	753	882	882	1.0000000
A03	22817862	22819041	A03p49230.2_BraZ1	1057.68	+	1204	1179	1179	1.0000000
A03	22820829	22822198	A03p49240.2_BraZ1	1005	-	601	1369	1369	1.0000000
A03	22823815	22829660	A03p49250.2_BraZ1	1397.21	+	2530	5406	5845	0.9248931
A03	22830716	22831509	A03p49260.2_BraZ1	72.6	+	70	586	793	0.7389659
A03	22838182	22839454	A03p49270.2_BraZ1	127.2	-	27	456	1272	0.3584906
A03	22841836	22842795	A03p49280.2_BraZ1	324	-	6	461	959	0.4807091
A03	22846490	22847393	A03p49290.2_BraZ1	90.3	+	164	873	903	0.9667774
A03	22850451	22851078	A03p49300.2_BraZ1	62.7	+	80	282	627	0.4497608
A03	22854114	22857175	A03p49310.2_BraZ1	2370	-	1091	2690	3061	0.8787978
A03	22868043	22868400	A03p49320.2_BraZ1	24.3	-	26	357	357	1.0000000
A03	22872636	22878596	A03p49330.2_BraZ1	3550.15	-	1664	4824	5960	0.8093960
A03	22882872	22891335	A03p49340.2_BraZ1	2921.84	+	1777	7200	8463	0.8507621
A03	22884273	22885528	A03p49350.2_BraZ1	750	-	51	897	1255	0.7147411
A03	22892134	22894200	A03p49360.2_BraZ1	1479	-	2465	2066	2066	1.0000000
A03	22897728	22897878	A03p49370.2_BraZ1	15	-	244	150	150	1.0000000
A03	22901686	22903111	A03p49380.2_BraZ1	142.5	+	592	1425	1425	1.0000000
A03	22903592	22904939	A03p49390.2_BraZ1	134.7	-	743	1341	1347	0.9955457
A03	22909120	22913584	A03p49400.2_BraZ1	1035.45	+	734	3763	4464	0.8429660
A03	22917736	22921397	A03p49410.2_BraZ1	1411.97	+	3143	3661	3661	1.0000000
A03	22922732	22924331	A03p49420.2_BraZ1	1240	+	2170	1599	1599	1.0000000
A03	22925357	22926903	A03p49430.2_BraZ1	16939.5	+	553	1546	1546	1.0000000
A03	22928037	22929570	A03p49440.2_BraZ1	855	+	273	1343	1533	0.8760600
A03	22935650	22940324	A03p49450.2_BraZ1	1470	+	2249	4346	4674	0.9298246
A03	22940645	22941046	A03p49460.2_BraZ1	33.6	-	422	401	401	1.0000000
A03	22943771	22944905	A03p49470.2_BraZ1	263.667	+	683	1134	1134	1.0000000
A03	22947741	22950254	A03p49480.2_BraZ1	1432.58	+	615	2094	2513	0.8332670
A03	22950539	22950745	A03p49490.2_BraZ1	189	+	223	206	206	1.0000000
A03	22953742	22955215	A03p49500.2_BraZ1	147.3	-	124	872	1473	0.5919892
A03	22956819	22957854	A03p49510.2_BraZ1	628.455	+	922	1035	1035	1.0000000
A03	22958276	22966652	A03p49520.2_BraZ1	2454.58	-	4381	8108	8376	0.9680038
A03	22966553	22967750	A03p49530.2_BraZ1	109.8	-	730	1189	1197	0.9933167
A03	22974858	22975076	A03p49540.2_BraZ1	21.3	-	80	218	218	1.0000000
A03	22975960	22978824	A03p49550.2_BraZ1	1590.75	+	583	2673	2864	0.9333100
A03	22979594	22980483	A03p49560.2_BraZ1	456	-	165	705	889	0.7930259
A03	22985276	22986468	A03p49570.2_BraZ1	744	+	47	924	1192	0.7751678
A03	22986579	22987149	A03p49580.2_BraZ1	57	+	2	76	570	0.1333333
A03	22987354	22987713	A03p49590.2_BraZ1	198	+	0	0	359	0.0000000
A03	22994733	22995201	A03p49600.2_BraZ1	68.6842	-	295	416	468	0.8888889
A03	22995245	22997944	A03p49610.2_BraZ1	387.068	-	4793	2699	2699	1.0000000
A03	22998442	22998781	A03p49620.2_BraZ1	267	-	192	338	339	0.9970502
A03	22999776	23001333	A03p49630.2_BraZ1	873	+	298	1389	1557	0.8921002
A03	23002044	23002635	A03p49640.2_BraZ1	59.1	+	666	591	591	1.0000000
A03	23010106	23010529	A03p49650.2_BraZ1	42.3	-	495	423	423	1.0000000
A03	23013117	23014891	A03p49660.2_BraZ1	573	+	979	1459	1774	0.8224352
A03	23016737	23017826	A03p49670.2_BraZ1	678	+	195	994	1089	0.9127640
A03	23022209	23022518	A03p49680.2_BraZ1	30.9	+	100	309	309	1.0000000
A03	23028604	23030446	A03p49690.2_BraZ1	183.9	+	429	1690	1842	0.9174810
A03	23035144	23036035	A03p49700.2_BraZ1	89.1	+	779	891	891	1.0000000
A03	23036544	23037921	A03p49710.2_BraZ1	137.7	-	700	1377	1377	1.0000000
A03	23039739	23040369	A03p49720.2_BraZ1	63	-	260	539	630	0.8555555
A03	23041439	23042022	A03p49730.2_BraZ1	290.769	-	190	564	583	0.9674100
A03	23041979	23043784	A03p49740.2_BraZ1	532.431	-	685	1652	1805	0.9152355
A03	23044221	23045225	A03p49750.2_BraZ1	744	-	340	867	1004	0.8635458
A03	23046590	23047154	A03p49760.2_BraZ1	56.4	+	22	480	564	0.8510638
A03	23050002	23050338	A03p49770.2_BraZ1	33.6	+	69	336	336	1.0000000
A03	23051976	23052926	A03p49780.2_BraZ1	438.75	-	661	950	950	1.0000000
A03	23056775	23058594	A03p49790.2_BraZ1	1411.71	+	1116	1819	1819	1.0000000
A03	23059437	23063204	A03p49800.2_BraZ1	2261.55	+	986	3456	3767	0.9174410
A03	23065106	23065730	A03p49810.2_BraZ1	343.818	+	462	624	624	1.0000000
A03	23069125	23081259	A03p49820.2_BraZ1	170.386	+	976	5699	12134	0.4696720
A03	23075199	23075508	A03p49830.2_BraZ1	30.9	+	5	207	309	0.6699029
A03	23079479	23079788	A03p49840.2_BraZ1	30.9	+	4	115	309	0.3721683
A03	23083936	23086282	A03p49850.2_BraZ1	1203.64	-	2209	2346	2346	1.0000000
A03	23088490	23090712	A03p49860.2_BraZ1	892.8	-	148	1279	2222	0.5756075
A03	23092006	23092332	A03p49870.2_BraZ1	135	-	40	326	326	1.0000000
A03	23094841	23096374	A03p49880.2_BraZ1	1132.86	+	115	911	1533	0.5942596
A03	23099076	23103661	A03p49890.2_BraZ1	2212.22	-	852	3869	4585	0.8438386
A03	23105921	23111297	A03p49900.2_BraZ1	3957.47	+	691	3704	5376	0.6889881
A03	23111714	23115044	A03p49910.2_BraZ1	1379.2	+	3005	3131	3330	0.9402403
A03	23115935	23118836	A03p49920.2_BraZ1	605.943	-	1335	2708	2901	0.9334712
A03	23121983	23122647	A03p49930.2_BraZ1	366	+	458	664	664	1.0000000
A03	23122993	23124249	A03p49940.2_BraZ1	934.286	-	404	1256	1256	1.0000000
A03	23126081	23126183	A03p49950.2_BraZ1	10.2	-	96	102	102	1.0000000
A03	23126515	23128209	A03p49960.2_BraZ1	831.481	-	1805	1694	1694	1.0000000
A03	23137397	23137938	A03p49970.2_BraZ1	456	+	754	541	541	1.0000000
A03	23144047	23145562	A03p49980.2_BraZ1	1052.7	+	1098	1515	1515	1.0000000
A03	23145889	23147633	A03p49990.2_BraZ1	558.09	-	1308	1724	1744	0.9885321
A03	23148236	23148338	A03p50000.2_BraZ1	10.2	+	194	102	102	1.0000000
A03	23153989	23157327	A03p50010.2_BraZ1	2004.17	-	1034	2523	3338	0.7558419
A03	23160757	23160895	A03p50020.2_BraZ1	13.8	-	128	138	138	1.0000000
A03	23162077	23163563	A03p50030.2_BraZ1	591.083	+	1427	1486	1486	1.0000000
A03	23171510	23174605	A03p50040.2_BraZ1	1739.23	+	2144	3079	3095	0.9948304
A03	23176302	23176967	A03p50050.2_BraZ1	504	-	494	665	665	1.0000000
A03	23180633	23194395	A03p50060.2_BraZ1	2435.5	-	4789	11138	13762	0.8093300
A03	23198789	23201097	A03p50070.2_BraZ1	365.891	-	929	2068	2308	0.8960139
A03	23201438	23202637	A03p50080.2_BraZ1	395.6	+	1251	1199	1199	1.0000000
A03	23204276	23204942	A03p50090.2_BraZ1	66.6	+	414	666	666	1.0000000
A03	23205674	23210454	A03p50100.2_BraZ1	2373.44	-	1930	4493	4780	0.9399582
A03	23210756	23212109	A03p50110.2_BraZ1	963.81	+	542	1235	1353	0.9127864
A03	23212264	23212738	A03p50120.2_BraZ1	47.4	-	16	345	474	0.7278481
A03	23212975	23213936	A03p50130.2_BraZ1	762.273	-	236	961	961	1.0000000
A03	23219722	23220184	A03p50140.2_BraZ1	405	-	8	342	462	0.7402598
A03	23221558	23224895	A03p50150.2_BraZ1	1003.22	+	438	2354	3337	0.7054240
A03	23231293	23232417	A03p50160.2_BraZ1	663.52	+	1093	1124	1124	1.0000000
A03	23235562	23236461	A03p50170.2_BraZ1	78.3	+	408	899	899	1.0000000
A03	23237053	23243705	A03p50180.2_BraZ1	612	+	5919	6297	6652	0.9466326
A03	23244589	23246954	A03p50190.2_BraZ1	1418.81	-	999	2327	2365	0.9839324
A03	23249079	23250450	A03p50200.2_BraZ1	137.1	+	518	1371	1371	1.0000000
A03	23250682	23251733	A03p50210.2_BraZ1	654.457	-	1293	1051	1051	1.0000000
A03	23252408	23253470	A03p50220.2_BraZ1	549	-	1030	1062	1062	1.0000000
A03	23256595	23256973	A03p50230.2_BraZ1	37.8	+	40	187	378	0.4947090
A03	23258476	23258889	A03p50240.2_BraZ1	324	+	248	413	413	1.0000000
A03	23260851	23261551	A03p50250.2_BraZ1	531	+	473	700	700	1.0000000
A03	23271058	23272963	A03p50260.2_BraZ1	1746	+	458	1579	1905	0.8288714
A03	23273614	23275099	A03p50270.2_BraZ1	1368	-	543	1440	1485	0.9696970
A03	23290001	23295064	A03p50280.2_BraZ1	534	+	2863	5057	5063	0.9988149
A03	23293035	23293377	A03p50290.2_BraZ1	34.2	-	177	342	342	1.0000000
A03	23296022	23296268	A03p50300.2_BraZ1	24.6	-	68	177	246	0.7195122
A03	23297589	23298974	A03p50310.2_BraZ1	353.872	-	863	1322	1385	0.9545127
A03	23299992	23300745	A03p50320.2_BraZ1	75.3	+	292	753	753	1.0000000
A03	23301720	23301894	A03p50330.2_BraZ1	17.4	+	223	174	174	1.0000000
A03	23302057	23303026	A03p50340.2_BraZ1	1422.33	-	634	969	969	1.0000000
A03	23305774	23306835	A03p50350.2_BraZ1	661.889	-	1824	1061	1061	1.0000000
A03	23308982	23312325	A03p50360.2_BraZ1	1388.83	-	283	2499	3343	0.7475321
A03	23314661	23315936	A03p50370.2_BraZ1	1030.08	-	354	1271	1275	0.9968628
A03	23316500	23318196	A03p50380.2_BraZ1	253.8	-	1173	1612	1696	0.9504717
A03	23321427	23330730	A03p50390.2_BraZ1	595.818	-	4575	8829	9303	0.9490487
A03	23331554	23332829	A03p50400.2_BraZ1	222	-	683	1177	1275	0.9231372
A03	23333320	23341158	A03p50410.2_BraZ1	1493.39	+	3345	6820	7838	0.8701199
A03	23343464	23344109	A03p50420.2_BraZ1	64.5	-	589	588	645	0.9116279
A03	23347247	23348945	A03p50430.2_BraZ1	1023.75	-	900	1686	1698	0.9929329
A03	23351557	23354315	A03p50440.2_BraZ1	378.667	+	1585	2735	2758	0.9916606
A03	23356141	23356722	A03p50450.2_BraZ1	192	-	123	581	581	1.0000000
A03	23361326	23362728	A03p50460.2_BraZ1	1885	-	49	612	1402	0.4365193
A03	23363467	23364758	A03p50470.2_BraZ1	1095	-	357	1190	1291	0.9217661
A03	23365289	23368968	A03p50480.2_BraZ1	275.625	-	2842	3675	3679	0.9989128
A03	23368666	23371156	A03p50490.2_BraZ1	421.875	-	1176	2490	2490	1.0000000
A03	23373143	23375550	A03p50500.2_BraZ1	1613.3	+	1175	2312	2407	0.9605318
A03	23376864	23380754	A03p50510.2_BraZ1	2255.28	+	252	2215	3890	0.5694087
A03	23383290	23384119	A03p50520.2_BraZ1	28.5	+	603	829	829	1.0000000
A03	23384694	23385553	A03p50530.2_BraZ1	599.386	-	321	814	859	0.9476135
A03	23386444	23387671	A03p50540.2_BraZ1	122.7	+	83	581	1227	0.4735126
A03	23401958	23402492	A03p50550.2_BraZ1	53.4	-	255	534	534	1.0000000
A03	23407297	23407556	A03p50560.2_BraZ1	228	+	455	259	259	1.0000000
A03	23407975	23410885	A03p50570.2_BraZ1	807.714	-	2198	2892	2910	0.9938144
A03	23418101	23419634	A03p50580.2_BraZ1	153.3	+	330	1430	1533	0.9328115
A03	23420344	23424747	A03p50590.2_BraZ1	6362.79	-	719	3110	4403	0.7063366
A03	23425617	23426410	A03p50600.2_BraZ1	81.1429	-	303	546	793	0.6885246
A03	23427121	23437523	A03p50610.2_BraZ1	2088	-	1022	5561	10402	0.5346087
A03	23437566	23439980	A03p50620.2_BraZ1	1399.47	+	280	1308	2414	0.5418392
A03	23442923	23443457	A03p50630.2_BraZ1	53.4	+	158	534	534	1.0000000
A03	23444798	23446661	A03p50640.2_BraZ1	6588.75	-	1419	1863	1863	1.0000000
A03	23453162	23455381	A03p50650.2_BraZ1	876.615	-	1479	2188	2219	0.9860297
A03	23455742	23458151	A03p50660.2_BraZ1	835.012	+	1097	2337	2409	0.9701121
A03	23467677	23472661	A03p50670.2_BraZ1	1607.61	+	1202	4132	4984	0.8290530
A03	23473054	23473828	A03p50680.2_BraZ1	369	-	257	774	774	1.0000000
A03	23473950	23474208	A03p50690.2_BraZ1	174	+	260	258	258	1.0000000
A03	23474641	23476543	A03p50700.2_BraZ1	1541.42	-	226	1711	1902	0.8995794
A03	23478906	23481119	A03p50710.2_BraZ1	1138.79	-	1275	1948	2213	0.8802531
A03	23482901	23484565	A03p50720.2_BraZ1	1593	-	493	1664	1664	1.0000000
A03	23487022	23487538	A03p50730.2_BraZ1	4917	+	352	516	516	1.0000000
A03	23488032	23490304	A03p50740.2_BraZ1	1227.54	-	1415	2272	2272	1.0000000
A03	23492189	23494420	A03p50750.2_BraZ1	1182	+	701	2094	2231	0.9385926
A03	23495508	23496631	A03p50760.2_BraZ1	1053	+	341	1037	1123	0.9234194
A03	23498201	23500359	A03p50770.2_BraZ1	969	+	1146	1989	2158	0.9216868
A03	23501994	23505697	A03p50780.2_BraZ1	1898	+	1493	3609	3703	0.9746152
A03	23507650	23509019	A03p50790.2_BraZ1	633.938	-	655	1369	1369	1.0000000
A03	23510368	23511729	A03p50800.2_BraZ1	894	+	712	1295	1361	0.9515063
A03	23513422	23514575	A03p50810.2_BraZ1	753.75	-	556	1128	1153	0.9783174
A03	23518336	23520410	A03p50820.2_BraZ1	540.4	+	23	619	2074	0.2984571
A03	23521126	23521963	A03p50830.2_BraZ1	2295	+	516	837	837	1.0000000
A03	23528034	23528283	A03p50840.2_BraZ1	24.9	+	0	0	249	0.0000000
A03	23528664	23529204	A03p50850.2_BraZ1	54	+	0	0	540	0.0000000
A03	23536774	23537879	A03p50860.2_BraZ1	840	+	668	1102	1105	0.9972851
A03	23538575	23542602	A03p50870.2_BraZ1	858	-	1546	3702	4027	0.9192948
A03	23543161	23544055	A03p50880.2_BraZ1	64.8	-	468	894	894	1.0000000
A03	23545021	23546478	A03p50890.2_BraZ1	596.538	-	1552	1457	1457	1.0000000
A03	23547021	23548743	A03p50900.2_BraZ1	586.109	+	989	1712	1722	0.9941928
A03	23549151	23550266	A03p50910.2_BraZ1	594.79	-	905	1115	1115	1.0000000
A03	23553832	23555760	A03p50920.2_BraZ1	2000.25	+	3884	1928	1928	1.0000000
A03	23557251	23558084	A03p50930.2_BraZ1	357	-	586	833	833	1.0000000
A03	23558529	23560214	A03p50940.2_BraZ1	10413	-	379	1659	1685	0.9845697
A03	23561691	23565034	A03p50950.2_BraZ1	663	+	2414	3342	3343	0.9997008
A03	23570435	23570843	A03p50960.2_BraZ1	40.8	+	117	408	408	1.0000000
A03	23572243	23576614	A03p50970.2_BraZ1	2283.52	+	2564	4371	4371	1.0000000
A03	23577540	23580374	A03p50980.2_BraZ1	1500	+	1207	2756	2834	0.9724771
A03	23580885	23582378	A03p50990.2_BraZ1	724.862	+	1033	1493	1493	1.0000000
A03	23582775	23583566	A03p51000.2_BraZ1	351	+	1073	791	791	1.0000000
A03	23584678	23585316	A03p51010.2_BraZ1	510	-	195	550	638	0.8620690
A03	23587578	23587734	A03p51020.2_BraZ1	10.5	+	68	156	156	1.0000000
A03	23605277	23606490	A03p51030.2_BraZ1	900.13	-	697	1213	1213	1.0000000
A03	23612470	23612689	A03p51040.2_BraZ1	21.9	-	29	219	219	1.0000000
A03	23613124	23614262	A03p51050.2_BraZ1	99	+	500	826	1138	0.7258348
A03	23621417	23622249	A03p51060.2_BraZ1	267	-	1115	832	832	1.0000000
A03	23628698	23629106	A03p51070.2_BraZ1	288	-	464	408	408	1.0000000
A03	23630134	23631959	A03p51080.2_BraZ1	627	-	504	1734	1825	0.9501370
A03	23633834	23634466	A03p51090.2_BraZ1	417	-	182	607	632	0.9604430
A03	23634707	23635119	A03p51100.2_BraZ1	306	-	83	401	412	0.9733010
A03	23635461	23635757	A03p51110.2_BraZ1	27.3	+	0	0	296	0.0000000
A03	23638323	23639488	A03p51120.2_BraZ1	699.75	-	950	1165	1165	1.0000000
A03	23640676	23642016	A03p51130.2_BraZ1	794.543	+	935	1340	1340	1.0000000
A03	23642398	23644928	A03p51140.2_BraZ1	1347.86	-	2740	2530	2530	1.0000000
A03	23646783	23648136	A03p51150.2_BraZ1	667.52	+	807	1353	1353	1.0000000
A03	23654270	23657185	A03p51160.2_BraZ1	18983.2	+	936	2859	2915	0.9807890
A03	23657346	23658522	A03p51170.2_BraZ1	117.3	-	358	1139	1176	0.9685374
A03	23659332	23660569	A03p51180.2_BraZ1	3768.75	-	461	1187	1237	0.9595796
A03	23669864	23670130	A03p51190.2_BraZ1	19.2	+	98	249	266	0.9360902
A03	23674121	23676482	A03p51200.2_BraZ1	709.5	+	602	2037	2361	0.8627700
A03	23679758	23680634	A03p51210.2_BraZ1	87.6	-	15	346	876	0.3949772
A03	23704188	23704791	A03p51220.2_BraZ1	60.3	+	6	73	603	0.1210614
A03	23708103	23710128	A03p51230.2_BraZ1	1192.33	+	506	1925	2025	0.9506173
A03	23710293	23712029	A03p51240.2_BraZ1	962.023	-	1676	1736	1736	1.0000000
A03	23712493	23713069	A03p51250.2_BraZ1	57.6	+	61	247	576	0.4288194
A03	23720344	23727081	A03p51260.2_BraZ1	2060.61	+	3672	6562	6737	0.9740241
A03	23728164	23728602	A03p51270.2_BraZ1	366	-	5	243	438	0.5547945
A03	23734290	23735925	A03p51280.2_BraZ1	626.304	+	591	1634	1635	0.9993884
A03	23737759	23738059	A03p51290.2_BraZ1	30	-	546	300	300	1.0000000
A03	23738121	23739513	A03p51300.2_BraZ1	139.2	-	423	1392	1392	1.0000000
A03	23740791	23741993	A03p51310.2_BraZ1	978	-	599	1072	1202	0.8918469
A03	23743560	23744796	A03p51320.2_BraZ1	397.333	-	1538	1236	1236	1.0000000
A03	23748420	23750635	A03p51330.2_BraZ1	342	+	2171	2215	2215	1.0000000
A03	23751642	23753272	A03p51340.2_BraZ1	1090.29	+	2007	1630	1630	1.0000000
A03	23757809	23760082	A03p51350.2_BraZ1	1610.51	+	482	2032	2273	0.8939727
A03	23761758	23762879	A03p51360.2_BraZ1	848.522	-	100	942	1121	0.8403211
A03	23768397	23768545	A03p51370.2_BraZ1	14.1	-	120	148	148	1.0000000
A03	23770976	23778805	A03p51380.2_BraZ1	1189.83	-	2839	5982	7829	0.7640823
A03	23780991	23785141	A03p51390.2_BraZ1	615.85	+	278	581	4150	0.1400000
A03	23787824	23790856	A03p51400.2_BraZ1	1816.17	-	648	2743	3032	0.9046834
A03	23812001	23814908	A03p51410.2_BraZ1	1470.5	-	1586	2586	2907	0.8895769
A03	23823458	23824115	A03p51420.2_BraZ1	277.895	-	292	650	657	0.9893455
A03	23833907	23839095	A03p51430.2_BraZ1	3477.69	+	136	2008	5188	0.3870470
A03	23839641	23841554	A03p51440.2_BraZ1	958.222	-	283	1529	1913	0.7992682
A03	23842673	23847087	A03p51450.2_BraZ1	1344.2	+	1404	4051	4414	0.9177617
A03	23847780	23854794	A03p51460.2_BraZ1	3695.15	-	3858	6782	7014	0.9669233
A03	23855689	23856395	A03p51470.2_BraZ1	402	-	250	706	706	1.0000000
A03	23857455	23857865	A03p51480.2_BraZ1	243	+	569	410	410	1.0000000
A03	23858019	23858664	A03p51490.2_BraZ1	471	+	507	638	645	0.9891473
A03	23861272	23861650	A03p51500.2_BraZ1	279	+	63	367	378	0.9708995
A03	23865108	23866605	A03p51510.2_BraZ1	4714.67	+	507	1401	1497	0.9358717
A03	23872659	23884780	A03p51520.2_BraZ1	1610	+	7704	11720	12121	0.9669169
A03	23885175	23902676	A03p51530.2_BraZ1	6700.75	-	13109	17017	17501	0.9723445
A03	23889818	23890631	A03p51540.2_BraZ1	500.25	+	742	809	813	0.9950799
A03	23899047	23899760	A03p51550.2_BraZ1	501	-	954	713	713	1.0000000
A03	23904693	23909369	A03p51560.2_BraZ1	1441	-	2943	4165	4676	0.8907186
A03	23910818	23913541	A03p51570.2_BraZ1	1005.79	-	1203	2525	2723	0.9272861
A03	23916372	23916822	A03p51580.2_BraZ1	45	+	70	445	450	0.9888889
A03	23917516	23919495	A03p51590.2_BraZ1	1175.91	-	366	1153	1979	0.5826175
A03	23929104	23929750	A03p51600.2_BraZ1	372	+	121	646	646	1.0000000
A03	23942469	23944218	A03p51610.2_BraZ1	174.9	+	39	728	1749	0.4162379
A03	23945490	23945882	A03p51620.2_BraZ1	300	+	0	0	392	0.0000000
A03	23951195	23953290	A03p51630.2_BraZ1	1107	-	1492	2095	2095	1.0000000
A03	23954251	23954596	A03p51640.2_BraZ1	34.5	-	278	345	345	1.0000000
A03	23956576	23957746	A03p51650.2_BraZ1	117	-	247	1096	1170	0.9367521
A03	23959935	23961343	A03p51660.2_BraZ1	84	-	49	261	1408	0.1853693
A03	23963566	23963843	A03p51670.2_BraZ1	210	+	195	277	277	1.0000000
A03	23966307	23968280	A03p51680.2_BraZ1	356.5	-	1467	1973	1973	1.0000000
A03	23969162	23969479	A03p51690.2_BraZ1	23.7	+	311	317	317	1.0000000
A03	23969822	23970089	A03p51700.2_BraZ1	26.7	-	36	206	267	0.7715356
A03	23972857	23972965	A03p51710.2_BraZ1	10.8	+	141	108	108	1.0000000
A03	23976488	23977473	A03p51720.2_BraZ1	6213	-	144	778	985	0.7898477
A03	23978737	23980854	A03p51730.2_BraZ1	1551.92	-	1230	2117	2117	1.0000000
A03	23981359	23982857	A03p51740.2_BraZ1	1114.94	-	464	1423	1498	0.9499332
A03	23986159	23990039	A03p51750.2_BraZ1	1749.01	+	1202	3400	3880	0.8762887
A03	23992521	23992986	A03p51760.2_BraZ1	46.5	+	191	397	465	0.8537635
A03	23999744	23999981	A03p51770.2_BraZ1	23.7	+	24	203	237	0.8565401
A03	24004335	24004572	A03p51780.2_BraZ1	23.7	+	134	237	237	1.0000000
A03	24013342	24015193	A03p51790.2_BraZ1	185.1	-	119	1086	1851	0.5867099
A03	24015616	24018488	A03p51800.2_BraZ1	1040.55	+	1140	2654	2872	0.9240947
A03	24020620	24021387	A03p51810.2_BraZ1	560.87	+	523	736	767	0.9595828
A03	24022371	24024576	A03p51820.2_BraZ1	16159.5	-	220	2130	2205	0.9659864
A03	24025988	24029730	A03p51830.2_BraZ1	1432.2	-	1635	3438	3742	0.9187600
A03	24033668	24033995	A03p51840.2_BraZ1	32.7	-	16	34	327	0.1039755
A03	24034067	24035393	A03p51850.2_BraZ1	1257	-	259	352	1326	0.2654600
A03	24045626	24048570	A03p51860.2_BraZ1	1751.65	+	1861	2881	2944	0.9786006
A03	24050071	24051368	A03p51870.2_BraZ1	5934	+	741	1289	1297	0.9938319
A03	24056824	24057400	A03p51880.2_BraZ1	57.6	+	85	475	576	0.8246528
A03	24058462	24058767	A03p51890.2_BraZ1	30.3	-	222	305	305	1.0000000
A03	24066702	24068308	A03p51900.2_BraZ1	1374	+	1138	1606	1606	1.0000000
A03	24071963	24073998	A03p51910.2_BraZ1	798	+	1221	1800	2035	0.8845209
A03	24082251	24083768	A03p51920.2_BraZ1	1131.62	+	1434	1517	1517	1.0000000
A03	24084786	24085618	A03p51930.2_BraZ1	14628	+	391	832	832	1.0000000
A03	24086886	24088339	A03p51940.2_BraZ1	1153.86	+	507	1445	1453	0.9944941
A03	24089035	24092881	A03p51950.2_BraZ1	2076.49	-	879	3336	3846	0.8673947
A03	24093932	24096023	A03p51960.2_BraZ1	1599	-	687	1890	2091	0.9038737
A03	24097077	24097910	A03p51970.2_BraZ1	648	-	42	684	833	0.8211284
A03	24102361	24102737	A03p51980.2_BraZ1	396	-	106	376	376	1.0000000
A03	24105666	24106938	A03p51990.2_BraZ1	1044	+	302	997	1272	0.7838050
A03	24108788	24110104	A03p52000.2_BraZ1	2124	+	222	1211	1316	0.9202127
A03	24112693	24114364	A03p52010.2_BraZ1	1077.3	-	1180	1643	1671	0.9832436
A03	24115751	24115892	A03p52020.2_BraZ1	14.1	+	413	141	141	1.0000000
A03	24118005	24118212	A03p52030.2_BraZ1	20.7	+	0	0	207	0.0000000
A03	24118592	24119084	A03p52040.2_BraZ1	372	+	14	255	492	0.5182927
A03	24121196	24123438	A03p52050.2_BraZ1	5196	-	1494	2198	2242	0.9803747
A03	24125822	24127066	A03p52060.2_BraZ1	1173	-	551	1244	1244	1.0000000
A03	24133453	24135339	A03p52070.2_BraZ1	831	+	503	1710	1886	0.9066808
A03	24139031	24143217	A03p52080.2_BraZ1	420	-	2310	2263	4186	0.5406116
A03	24144138	24145306	A03p52090.2_BraZ1	403.2	+	1269	1168	1168	1.0000000
A03	24155042	24156976	A03p52100.2_BraZ1	816.911	+	1112	1676	1934	0.8665977
A03	24157255	24157501	A03p52110.2_BraZ1	24.6	+	175	246	246	1.0000000
A03	24158844	24159980	A03p52120.2_BraZ1	1442.1	+	524	1136	1136	1.0000000
A03	24160284	24161235	A03p52130.2_BraZ1	246	+	1259	951	951	1.0000000
A03	24161299	24161485	A03p52140.2_BraZ1	18.6	+	388	186	186	1.0000000
A03	24170397	24174532	A03p52150.2_BraZ1	840.727	+	3280	4114	4135	0.9949214
A03	24175676	24177138	A03p52160.2_BraZ1	1011.95	-	1011	1461	1462	0.9993160
A03	24185222	24186198	A03p52170.2_BraZ1	396	-	993	976	976	1.0000000
A03	24185289	24185568	A03p52180.2_BraZ1	108	-	530	279	279	1.0000000
A03	24187080	24187410	A03p52190.2_BraZ1	33	+	215	330	330	1.0000000
A03	24188656	24190777	A03p52200.2_BraZ1	971.5	-	1107	2011	2121	0.9481377
A03	24191283	24191388	A03p52210.2_BraZ1	10.5	-	191	105	105	1.0000000
A03	24204210	24216082	A03p52220.2_BraZ1	3002.75	-	4318	10531	11872	0.8870451
A03	24210705	24210871	A03p52230.2_BraZ1	129	-	57	166	166	1.0000000
A03	24225423	24228931	A03p52240.2_BraZ1	1476.96	-	835	3143	3508	0.8959521
A03	24231985	24232183	A03p52250.2_BraZ1	19.8	+	125	196	198	0.9898990
A03	24238655	24241151	A03p52260.2_BraZ1	464.539	-	1547	2332	2496	0.9342949
A03	24243888	24246180	A03p52270.2_BraZ1	2163	-	1050	1803	2292	0.7866492
A03	24246766	24248191	A03p52280.2_BraZ1	655.526	+	1241	1425	1425	1.0000000
A03	24249000	24251991	A03p52290.2_BraZ1	518	-	848	2768	2991	0.9254430
A03	24251791	24252484	A03p52300.2_BraZ1	444	-	233	654	693	0.9437230
A03	24253718	24256531	A03p52310.2_BraZ1	1672.56	+	1167	2578	2813	0.9164593
A03	24256987	24259840	A03p52320.2_BraZ1	285.3	-	786	2707	2853	0.9488258
A03	24277203	24277365	A03p52330.2_BraZ1	16.2	-	0	0	162	0.0000000
A03	24277385	24277596	A03p52340.2_BraZ1	14.7	-	0	0	211	0.0000000
A03	24277836	24277956	A03p52350.2_BraZ1	12	-	0	0	120	0.0000000
A03	24283944	24284604	A03p52360.2_BraZ1	66	+	510	660	660	1.0000000
A03	24297863	24299861	A03p52370.2_BraZ1	1313.42	+	300	1795	1998	0.8983984
A03	24309509	24310485	A03p52380.2_BraZ1	390.45	+	1064	976	976	1.0000000
A03	24311067	24312488	A03p52390.2_BraZ1	832.842	+	343	1405	1421	0.9887403
A03	24314391	24321937	A03p52400.2_BraZ1	556.5	-	5918	6511	7546	0.8628412
A03	24323954	24325374	A03p52410.2_BraZ1	2110.5	-	1157	1420	1420	1.0000000
A03	24326096	24326698	A03p52420.2_BraZ1	204	-	889	602	602	1.0000000
A03	24338162	24338669	A03p52430.2_BraZ1	50.7	-	88	444	507	0.8757396
A03	24340947	24341807	A03p52440.2_BraZ1	591	-	1570	860	860	1.0000000
A03	24347144	24350897	A03p52450.2_BraZ1	10965	+	2119	3749	3753	0.9989342
A03	24353049	24356198	A03p52460.2_BraZ1	1988.21	+	1102	3149	3149	1.0000000
A03	24358689	24363171	A03p52470.2_BraZ1	3634.99	-	2572	4394	4482	0.9803659
A03	24363176	24367162	A03p52480.2_BraZ1	10931.8	+	2249	3709	3986	0.9305068
A03	24367971	24374287	A03p52490.2_BraZ1	2983.53	+	2164	5898	6316	0.9338189
A03	24375400	24375613	A03p52500.2_BraZ1	21.3	-	222	213	213	1.0000000
A03	24377511	24377619	A03p52510.2_BraZ1	10.8	+	4	108	108	1.0000000
A03	24378517	24380523	A03p52520.2_BraZ1	3063.75	-	1991	2006	2006	1.0000000
A03	24381486	24382746	A03p52530.2_BraZ1	126	-	2761	1260	1260	1.0000000
A03	24384269	24385675	A03p52540.2_BraZ1	1312.5	-	823	1406	1406	1.0000000
A03	24388665	24389895	A03p52550.2_BraZ1	1016.53	+	26	612	1230	0.4975610
A03	24402624	24403821	A03p52560.2_BraZ1	961.111	+	620	1176	1197	0.9824561
A03	24408290	24409526	A03p52570.2_BraZ1	838.1	+	36	590	1236	0.4773463
A03	24414723	24415830	A03p52580.2_BraZ1	921	-	300	1045	1107	0.9439928
A03	24432518	24434893	A03p52590.2_BraZ1	1497.63	-	607	2137	2375	0.8997895
A03	24436125	24437704	A03p52600.2_BraZ1	1199.38	-	548	1533	1579	0.9708676
A03	24438789	24438924	A03p52610.2_BraZ1	13.5	-	0	0	135	0.0000000
A03	24442098	24442336	A03p52620.2_BraZ1	156	-	1	68	238	0.2857143
A03	24443401	24444718	A03p52630.2_BraZ1	131.7	+	491	1317	1317	1.0000000
A03	24445258	24445956	A03p52640.2_BraZ1	366	-	144	426	698	0.6103152
A03	24448042	24448956	A03p52650.2_BraZ1	375.667	-	8	71	914	0.0776805
A03	24449299	24449407	A03p52660.2_BraZ1	10.8	-	0	0	108	0.0000000
A03	24451448	24452780	A03p52670.2_BraZ1	133.2	+	235	979	1332	0.7349850
A03	24476169	24478863	A03p52680.2_BraZ1	2028	+	354	1788	2694	0.6636971
A03	24479332	24480147	A03p52690.2_BraZ1	135	+	1328	815	815	1.0000000
A03	24480661	24481408	A03p52700.2_BraZ1	642	-	5	415	747	0.5555556
A03	24483797	24485123	A03p52710.2_BraZ1	132.6	+	986	1326	1326	1.0000000
A03	24487128	24487855	A03p52720.2_BraZ1	618	-	664	727	727	1.0000000
A03	24487474	24487977	A03p52730.2_BraZ1	630	-	443	503	503	1.0000000
A03	24490356	24493691	A03p52740.2_BraZ1	1491.94	+	1900	3323	3335	0.9964018
A03	24494090	24494321	A03p52750.2_BraZ1	23.1	+	203	231	231	1.0000000
A03	24498264	24502037	A03p52760.2_BraZ1	2554.16	+	3493	3773	3773	1.0000000
A03	24511486	24513165	A03p52770.2_BraZ1	1030.91	+	792	1473	1679	0.8773079
A03	24514290	24516114	A03p52780.2_BraZ1	977.85	+	931	1698	1824	0.9309211
A03	24516424	24518442	A03p52790.2_BraZ1	889.688	-	1532	2018	2018	1.0000000
A03	24518772	24519426	A03p52800.2_BraZ1	20.1	+	304	654	654	1.0000000
A03	24519506	24521273	A03p52810.2_BraZ1	1398.48	-	481	1744	1767	0.9869836
A03	24522720	24523221	A03p52820.2_BraZ1	450	-	36	342	501	0.6826347
A03	24523363	24531993	A03p52830.2_BraZ1	994	-	1468	4849	8630	0.5618772
A03	24531982	24532342	A03p52840.2_BraZ1	268.125	-	195	360	360	1.0000000
A03	24535246	24538164	A03p52850.2_BraZ1	1572.65	+	1151	2581	2918	0.8845099
A03	24543104	24547845	A03p52860.2_BraZ1	2254.69	-	2878	4700	4741	0.9913520
A03	24551973	24552421	A03p52870.2_BraZ1	5616	-	322	448	448	1.0000000
A03	24554628	24559957	A03p52880.2_BraZ1	1580	-	1909	4813	5329	0.9031713
A03	24558154	24558843	A03p52890.2_BraZ1	239.266	+	287	678	689	0.9840348
A03	24560704	24564136	A03p52900.2_BraZ1	1274.31	-	1581	3328	3432	0.9696970
A03	24570231	24576563	A03p52910.2_BraZ1	1504.17	-	3925	6299	6332	0.9947883
A03	24589417	24591238	A03p52920.2_BraZ1	673.464	+	0	0	1821	0.0000000
A03	24592589	24592796	A03p52930.2_BraZ1	20.7	+	0	0	207	0.0000000
A03	24593143	24593667	A03p52940.2_BraZ1	553.5	+	2	2	524	0.0038168
A03	24596958	24598504	A03p52950.2_BraZ1	696.571	-	1076	1546	1546	1.0000000
A03	24602609	24604288	A03p52960.2_BraZ1	714	+	789	1679	1679	1.0000000
A03	24614370	24617697	A03p52970.2_BraZ1	2904	+	316	2021	3327	0.6074542
A03	24621380	24622410	A03p52980.2_BraZ1	327	+	9	360	1030	0.3495146
A03	24642942	24650389	A03p52990.2_BraZ1	2210.64	+	2935	7218	7447	0.9692494
A03	24651221	24652643	A03p53000.2_BraZ1	142.2	+	150	1250	1422	0.8790436
A03	24653615	24654601	A03p53010.2_BraZ1	538.47	+	216	986	986	1.0000000
A03	24655343	24655763	A03p53020.2_BraZ1	42	+	183	385	420	0.9166667
A03	24656133	24657071	A03p53030.2_BraZ1	474	-	1062	926	938	0.9872068
A03	24657262	24658353	A03p53040.2_BraZ1	601.125	-	396	1010	1091	0.9257562
A03	24659196	24660830	A03p53050.2_BraZ1	1551	-	675	1634	1634	1.0000000
A03	24661555	24665183	A03p53060.2_BraZ1	1608	+	1072	3151	3628	0.8685226
A03	24668212	24669832	A03p53070.2_BraZ1	162	+	260	1569	1620	0.9685185
A03	24673177	24682166	A03p53080.2_BraZ1	3842.96	-	6793	8984	8989	0.9994438
A03	24684702	24685867	A03p53090.2_BraZ1	1152	-	311	1165	1165	1.0000000
A03	24688088	24689788	A03p53100.2_BraZ1	66565.5	+	403	1583	1700	0.9311765
A03	24690021	24691643	A03p53110.2_BraZ1	6819.75	-	876	1622	1622	1.0000000
A03	24693053	24694311	A03p53120.2_BraZ1	450	+	1334	1258	1258	1.0000000
A03	24700093	24701443	A03p53130.2_BraZ1	800.275	+	78	661	1350	0.4896296
A03	24705572	24706019	A03p53140.2_BraZ1	44.7	+	253	447	447	1.0000000
A03	24709040	24709661	A03p53150.2_BraZ1	62.1	+	177	433	621	0.6972625
A03	24711452	24711710	A03p53160.2_BraZ1	25.8	+	37	162	258	0.6279070
A03	24712726	24713084	A03p53170.2_BraZ1	207	+	194	358	358	1.0000000
A03	24713979	24714727	A03p53180.2_BraZ1	424.727	+	316	748	748	1.0000000
A03	24716027	24719365	A03p53190.2_BraZ1	1676.25	+	1326	3138	3338	0.9400839
A03	24721282	24728354	A03p53200.2_BraZ1	2482.26	+	4424	6970	7072	0.9855769
A03	24728520	24729607	A03p53210.2_BraZ1	1026	-	998	1087	1087	1.0000000
A03	24729846	24730816	A03p53220.2_BraZ1	239.571	+	595	970	970	1.0000000
A03	24737448	24739930	A03p53230.2_BraZ1	1017	+	125	1549	2482	0.6240935
A03	24742712	24745080	A03p53240.2_BraZ1	828	-	810	2329	2368	0.9835304
A03	24748492	24753999	A03p53250.2_BraZ1	2237.14	+	556	3433	5507	0.6233884
A03	24760128	24763189	A03p53260.2_BraZ1	1932.29	+	1158	2894	3061	0.9454427
A03	24765225	24768536	A03p53270.2_BraZ1	332.4	-	632	2913	3311	0.8797946
A03	24771000	24774874	A03p53280.2_BraZ1	2424.32	-	1787	3863	3874	0.9971606
A03	24777517	24777858	A03p53290.2_BraZ1	240	+	0	0	341	0.0000000
A03	24781516	24782006	A03p53300.2_BraZ1	126	-	726	383	490	0.7816327
A03	24782447	24782931	A03p53310.2_BraZ1	445.5	-	26	208	484	0.4297521
A03	24785444	24785839	A03p53320.2_BraZ1	183	+	110	395	395	1.0000000
A03	24785839	24786218	A03p53330.2_BraZ1	321	+	92	366	379	0.9656992
A03	24793051	24794274	A03p53340.2_BraZ1	49.2	-	0	0	1223	0.0000000
A03	24801090	24802347	A03p53350.2_BraZ1	1047	-	759	1257	1257	1.0000000
A03	24805190	24805369	A03p53360.2_BraZ1	168	-	102	179	179	1.0000000
A03	24810630	24813133	A03p53370.2_BraZ1	459	+	666	2014	2503	0.8046345
A03	24811277	24812459	A03p53380.2_BraZ1	1035	-	133	776	1182	0.6565144
A03	24813498	24813899	A03p53390.2_BraZ1	306	-	238	401	401	1.0000000
A03	24816049	24818416	A03p53400.2_BraZ1	1328.73	-	1141	2367	2367	1.0000000
A03	24823075	24823471	A03p53410.2_BraZ1	39.6	+	30	320	396	0.8080808
A03	24823783	24846745	A03p53420.2_BraZ1	1715.44	-	10963	20514	22962	0.8933891
A03	24852020	24852805	A03p53430.2_BraZ1	189	-	504	785	785	1.0000000
A03	24852971	24853451	A03p53440.2_BraZ1	1368	-	81	476	480	0.9916667
A03	24854222	24859166	A03p53450.2_BraZ1	2651.14	+	1552	4630	4944	0.9364887
A03	24859491	24861495	A03p53460.2_BraZ1	1794.73	-	381	1929	2004	0.9625748
A03	24872788	24882613	A03p53470.2_BraZ1	3713.54	-	2631	9042	9825	0.9203054
A03	24882887	24884383	A03p53480.2_BraZ1	399.214	+	842	1419	1496	0.9485294
A03	24884892	24885354	A03p53490.2_BraZ1	46.2	+	77	437	462	0.9458874
A03	24888372	24889500	A03p53500.2_BraZ1	471.273	+	28	371	1128	0.3289007
A03	24904125	24907585	A03p53510.2_BraZ1	2233.78	+	358	2738	3460	0.7913295
A03	24908600	24911334	A03p53520.2_BraZ1	1258.47	+	970	2657	2734	0.9718361
A03	24913485	24916894	A03p53530.2_BraZ1	993.943	+	1760	3179	3409	0.9325315
A03	24918450	24919922	A03p53540.2_BraZ1	456.703	+	1156	1472	1472	1.0000000
A03	24919912	24920480	A03p53550.2_BraZ1	153.195	+	386	517	568	0.9102113
A03	24920484	24920817	A03p53560.2_BraZ1	33.3	+	57	261	333	0.7837838
A03	24921511	24922165	A03p53570.2_BraZ1	168	+	360	654	654	1.0000000
A03	24922617	24923958	A03p53580.2_BraZ1	612.75	-	579	1327	1341	0.9895600
A03	24925020	24925836	A03p53590.2_BraZ1	81.6	-	360	816	816	1.0000000
A03	24928586	24932034	A03p53600.2_BraZ1	1424.61	-	1985	3437	3448	0.9968097
A03	24947087	24951673	A03p53610.2_BraZ1	1384.48	-	2496	4050	4586	0.8831226
A03	24953522	24959240	A03p53620.2_BraZ1	810.939	-	1710	5208	5718	0.9108080
A03	24971934	24972529	A03p53630.2_BraZ1	435	+	460	595	595	1.0000000
A03	24979076	24979433	A03p53640.2_BraZ1	35.7	-	1	42	357	0.1176471
A03	24984816	24985360	A03p53650.2_BraZ1	150.75	+	163	457	544	0.8400735
A03	24985521	24985810	A03p53660.2_BraZ1	201	+	184	289	289	1.0000000
A03	24986267	24990513	A03p53670.2_BraZ1	4585	-	3220	4246	4246	1.0000000
A03	24992044	24992598	A03p53680.2_BraZ1	504	+	95	513	554	0.9259928
A03	24993002	24998981	A03p53690.2_BraZ1	5247	-	1703	5305	5979	0.8872721
A03	24999960	25000205	A03p53700.2_BraZ1	20.4	-	139	245	245	1.0000000
A03	25009619	25014083	A03p53710.2_BraZ1	3980.8	-	4702	4464	4464	1.0000000
A03	25016590	25016752	A03p53720.2_BraZ1	16.2	+	103	162	162	1.0000000
A03	25016918	25017392	A03p53730.2_BraZ1	47.4	+	127	402	474	0.8481013
A03	25019858	25020831	A03p53740.2_BraZ1	395.518	+	524	960	973	0.9866393
A03	25021228	25022814	A03p53750.2_BraZ1	5909.4	-	290	1549	1586	0.9766709
A03	25039916	25041032	A03p53760.2_BraZ1	111.6	+	583	1116	1116	1.0000000
A03	25044868	25045189	A03p53770.2_BraZ1	32.1	-	318	321	321	1.0000000
A03	25049015	25050028	A03p53780.2_BraZ1	1148	-	864	1013	1013	1.0000000
A03	25052464	25053185	A03p53790.2_BraZ1	429	+	525	721	721	1.0000000
A03	25063234	25063794	A03p53800.2_BraZ1	546	+	488	560	560	1.0000000
A03	25070159	25070802	A03p53810.2_BraZ1	318	-	290	325	643	0.5054432
A03	25078577	25080433	A03p53820.2_BraZ1	958.375	+	1267	1856	1856	1.0000000
A03	25083397	25083523	A03p53830.2_BraZ1	12.6	-	215	126	126	1.0000000
A03	25105044	25106146	A03p53840.2_BraZ1	804	+	1238	1102	1102	1.0000000
A03	25107929	25108996	A03p53850.2_BraZ1	339	-	125	363	1067	0.3402062
A03	25109458	25110009	A03p53860.2_BraZ1	285	-	763	551	551	1.0000000
A03	25110766	25111703	A03p53870.2_BraZ1	59.7	+	1623	937	937	1.0000000
A03	25134716	25141560	A03p53880.2_BraZ1	189	-	2628	4663	6844	0.6813267
A03	25142431	25142813	A03p53890.2_BraZ1	216	+	171	382	382	1.0000000
A03	25147426	25148022	A03p53900.2_BraZ1	327	+	175	596	596	1.0000000
A03	25150202	25150352	A03p53910.2_BraZ1	15	-	348	150	150	1.0000000
A03	25151290	25151722	A03p53920.2_BraZ1	4752	-	236	432	432	1.0000000
A03	25153250	25154806	A03p53930.2_BraZ1	682.189	-	869	1497	1556	0.9620823
A03	25158767	25159886	A03p53940.2_BraZ1	111.9	+	2906	1119	1119	1.0000000
A03	25160455	25161491	A03p53950.2_BraZ1	43.2	-	956	1036	1036	1.0000000
A03	25163706	25164176	A03p53960.2_BraZ1	246	-	10	163	470	0.3468085
A03	25164193	25164883	A03p53970.2_BraZ1	14.4	-	35	644	690	0.9333333
A03	25168782	25169393	A03p53980.2_BraZ1	429	-	321	547	611	0.8952537
A03	25170223	25170589	A03p53990.2_BraZ1	36.6	+	224	366	366	1.0000000
A03	25172030	25172243	A03p54000.2_BraZ1	21.3	-	269	213	213	1.0000000
A03	25172835	25173429	A03p54010.2_BraZ1	59.4	-	112	508	594	0.8552188
A03	25174685	25181492	A03p54020.2_BraZ1	220.725	-	2299	4351	6807	0.6391950
A03	25182329	25184427	A03p54030.2_BraZ1	1342.37	+	405	1632	2098	0.7778837
A03	25185207	25190672	A03p54040.2_BraZ1	3028.53	-	3606	5390	5465	0.9862763
A03	25191934	25203038	A03p54050.2_BraZ1	732.682	-	3413	10697	11104	0.9633465
A03	25206043	25207966	A03p54060.2_BraZ1	1329	-	158	1581	1923	0.8221529
A03	25211756	25214648	A03p54070.2_BraZ1	1227.11	-	1776	2852	2892	0.9861687
A03	25214954	25215960	A03p54080.2_BraZ1	290.353	+	638	1006	1006	1.0000000
A03	25216746	25217935	A03p54090.2_BraZ1	602.857	-	1038	1189	1189	1.0000000
A03	25220069	25220905	A03p54100.2_BraZ1	768	+	204	790	836	0.9449761
A03	25221558	25223747	A03p54110.2_BraZ1	1342.29	-	688	2172	2189	0.9922339
A03	25225285	25226922	A03p54120.2_BraZ1	1101	+	622	1637	1637	1.0000000
A03	25230998	25231373	A03p54130.2_BraZ1	21.9	-	948	354	375	0.9440000
A03	25236826	25237084	A03p54140.2_BraZ1	25.8	+	168	258	258	1.0000000
A03	25239518	25239890	A03p54150.2_BraZ1	37.2	-	27	368	372	0.9892473
A03	25241864	25242349	A03p54160.2_BraZ1	150	-	453	485	485	1.0000000
A03	25243317	25246409	A03p54170.2_BraZ1	2436	+	1583	2851	3092	0.9220569
A03	25250300	25252354	A03p54180.2_BraZ1	965.833	+	551	2053	2054	0.9995131
A03	25254704	25255245	A03p54190.2_BraZ1	264	-	557	541	541	1.0000000
A03	25257634	25261980	A03p54200.2_BraZ1	542.182	-	1433	3495	4346	0.8041878
A03	25273589	25273745	A03p54210.2_BraZ1	15.6	-	80	156	156	1.0000000
A03	25277063	25278196	A03p54220.2_BraZ1	1032	+	220	1003	1133	0.8852603
A03	25281603	25283255	A03p54230.2_BraZ1	1488	+	921	1652	1652	1.0000000
A03	25286333	25287521	A03p54240.2_BraZ1	1068	+	231	820	1188	0.6902357
A03	25287762	25289511	A03p54250.2_BraZ1	1030.92	-	324	1606	1749	0.9182390
A03	25314735	25315194	A03p54260.2_BraZ1	45.9	+	19	389	459	0.8474945
A03	25319200	25320488	A03p54270.2_BraZ1	8943	-	98	1050	1288	0.8152174
A03	25332773	25333141	A03p54280.2_BraZ1	177	+	582	368	368	1.0000000
A03	25334668	25335154	A03p54290.2_BraZ1	378	-	40	417	486	0.8580247
A03	25337551	25339141	A03p54300.2_BraZ1	157.8	+	201	1276	1590	0.8025157
A03	25340848	25341456	A03p54310.2_BraZ1	107.679	+	277	608	608	1.0000000
A03	25342488	25343325	A03p54320.2_BraZ1	59.4643	+	164	837	837	1.0000000
A03	25344210	25346119	A03p54330.2_BraZ1	1391	+	941	1887	1909	0.9884756
A03	25347950	25352968	A03p54340.2_BraZ1	420.429	+	653	4680	5018	0.9326425
A03	25353277	25353594	A03p54350.2_BraZ1	273	+	138	317	317	1.0000000
A03	25355755	25356298	A03p54360.2_BraZ1	396	+	1372	543	543	1.0000000
A03	25359080	25360810	A03p54370.2_BraZ1	938.6	-	895	1698	1730	0.9815029
A03	25362993	25364260	A03p54380.2_BraZ1	594	+	36	1154	1267	0.9108129
A03	25365541	25366407	A03p54390.2_BraZ1	810	+	0	0	866	0.0000000
A03	25366865	25367369	A03p54400.2_BraZ1	17.1	-	4	233	504	0.4623016
A03	25367462	25369865	A03p54410.2_BraZ1	122.1	-	9	672	2403	0.2796504
A03	25372444	25373515	A03p54420.2_BraZ1	55.8	-	10	378	1071	0.3529412
A03	25373094	25374759	A03p54430.2_BraZ1	61.2	-	9	314	1665	0.1885886
A03	25374462	25378067	A03p54440.2_BraZ1	107.1	-	34	829	3605	0.2299584
A03	25379181	25379494	A03p54450.2_BraZ1	30.9	+	94	313	313	1.0000000
A03	25381313	25384079	A03p54460.2_BraZ1	445.696	-	959	2711	2766	0.9801157
A03	25384218	25385345	A03p54470.2_BraZ1	194.022	-	476	1082	1127	0.9600710
A03	25387066	25388145	A03p54480.2_BraZ1	462	-	672	1012	1079	0.9379055
A03	25389727	25391177	A03p54490.2_BraZ1	990	-	54	870	1450	0.6000000
A03	25394492	25395139	A03p54500.2_BraZ1	48.3	-	0	0	647	0.0000000
A03	25397784	25399975	A03p54510.2_BraZ1	1150.05	-	167	1351	2191	0.6166134
A03	25401029	25401245	A03p54520.2_BraZ1	21.6	+	37	216	216	1.0000000
A03	25402238	25402525	A03p54530.2_BraZ1	171	-	234	287	287	1.0000000
A03	25402726	25403814	A03p54540.2_BraZ1	1065	+	1698	1088	1088	1.0000000
A03	25405467	25405754	A03p54550.2_BraZ1	171	-	148	287	287	1.0000000
A03	25418798	25420316	A03p54560.2_BraZ1	151.8	-	839	1438	1518	0.9472991
A03	25423315	25424433	A03p54570.2_BraZ1	1620	-	82	891	1118	0.7969589
A03	25429864	25430848	A03p54580.2_BraZ1	98.4	+	94	971	984	0.9867886
A03	25433982	25434522	A03p54590.2_BraZ1	54	-	321	540	540	1.0000000
A03	25439589	25439953	A03p54600.2_BraZ1	204	-	323	364	364	1.0000000
A03	25450093	25456632	A03p54610.2_BraZ1	1656.73	-	4338	6539	6539	1.0000000
A03	25458909	25462082	A03p54620.2_BraZ1	1406.66	+	1502	3079	3173	0.9703751
A03	25462693	25462795	A03p54630.2_BraZ1	10.2	-	4	102	102	1.0000000
A03	25464868	25466031	A03p54640.2_BraZ1	1074	-	131	1091	1163	0.9380912
A03	25467173	25468837	A03p54650.2_BraZ1	920.706	+	310	1634	1664	0.9819711
A03	25470208	25471324	A03p54660.2_BraZ1	111.6	+	128	940	1116	0.8422939
A03	25479962	25482593	A03p54670.2_BraZ1	1201.97	+	950	2365	2631	0.8988978
A03	25483593	25484728	A03p54680.2_BraZ1	737.391	-	707	1053	1135	0.9277533
A03	25486066	25488034	A03p54690.2_BraZ1	987.643	+	1322	1968	1968	1.0000000
A03	25488907	25493366	A03p54700.2_BraZ1	624.8	-	4223	4459	4459	1.0000000
A03	25502033	25511870	A03p54710.2_BraZ1	5670.81	-	3038	7175	9837	0.7293890
A03	25512688	25517117	A03p54720.2_BraZ1	2968.03	+	836	3858	4429	0.8710770
A03	25517395	25519679	A03p54730.2_BraZ1	440.611	-	728	2226	2284	0.9746060
A03	25522602	25523690	A03p54740.2_BraZ1	465	-	546	1013	1088	0.9310662
A03	25528690	25530081	A03p54750.2_BraZ1	531	+	0	0	1391	0.0000000
A03	25540535	25542077	A03p54760.2_BraZ1	154.2	+	98	1285	1542	0.8333333
A03	25545993	25549399	A03p54770.2_BraZ1	1324.19	+	2360	3406	3406	1.0000000
A03	25555943	25558408	A03p54780.2_BraZ1	1359.45	+	2110	2465	2465	1.0000000
A03	25562185	25563324	A03p54790.2_BraZ1	891	+	703	1139	1139	1.0000000
A03	25565042	25565830	A03p54800.2_BraZ1	288	+	1328	788	788	1.0000000
A03	25587796	25591200	A03p54810.2_BraZ1	1136.25	+	389	639	3404	0.1877203
A03	25594955	25595192	A03p54820.2_BraZ1	22.8	-	350	237	237	1.0000000
A03	25600166	25600658	A03p54830.2_BraZ1	109	+	442	492	492	1.0000000
A03	25603548	25607648	A03p54840.2_BraZ1	591.222	+	3321	4100	4100	1.0000000
A03	25608408	25610938	A03p54850.2_BraZ1	1312	-	703	2486	2530	0.9826087
A03	25618819	25621829	A03p54860.2_BraZ1	1379.89	-	3515	3010	3010	1.0000000
A03	25627696	25628248	A03p54870.2_BraZ1	55.2	+	11	256	552	0.4637681
A03	25630549	25632254	A03p54880.2_BraZ1	1053	+	60	905	1705	0.5307918
A03	25636840	25637674	A03p54890.2_BraZ1	573	-	55	562	834	0.6738609
A03	25640859	25641456	A03p54900.2_BraZ1	59.7	+	21	357	597	0.5979900
A03	25643633	25645409	A03p54910.2_BraZ1	510.75	+	121	962	1776	0.5416667
A03	25661109	25661512	A03p54920.2_BraZ1	372	+	357	403	403	1.0000000
A03	25661880	25662157	A03p54930.2_BraZ1	195	+	8	67	277	0.2418773
A03	25663115	25664909	A03p54940.2_BraZ1	186	+	5272	1794	1794	1.0000000
A03	25664923	25666080	A03p54950.2_BraZ1	1109.5	+	1153	1147	1157	0.9913570
A03	25667701	25667830	A03p54960.2_BraZ1	12.9	-	561	129	129	1.0000000
A03	25683725	25683869	A03p54970.2_BraZ1	14.4	-	144	144	144	1.0000000
A03	25695223	25699353	A03p54980.2_BraZ1	964.971	-	1438	3440	4130	0.8329298
A03	25713172	25716009	A03p54990.2_BraZ1	937.6	-	1891	2770	2837	0.9763835
A03	25721716	25724263	A03p55000.2_BraZ1	1505.58	-	322	1804	2547	0.7082843
A03	25726832	25734934	A03p55010.2_BraZ1	1498.27	-	2598	6938	8102	0.8563318
A03	25728525	25729395	A03p55020.2_BraZ1	87	-	374	817	870	0.9390805
A03	25735674	25739368	A03p55030.2_BraZ1	970.444	+	1450	3193	3694	0.8643746
A03	25740679	25746867	A03p55040.2_BraZ1	2628.3	+	3869	6041	6188	0.9762443
A03	25747719	25748769	A03p55050.2_BraZ1	105	-	357	1040	1050	0.9904762
A03	25749941	25754329	A03p55060.2_BraZ1	1765.84	-	1642	3796	4388	0.8650866
A03	25759586	25760491	A03p55070.2_BraZ1	114	-	230	720	905	0.7955801
A03	25760988	25762193	A03p55080.2_BraZ1	8856	+	287	1091	1205	0.9053942
A03	25763805	25764837	A03p55090.2_BraZ1	846	+	438	929	1032	0.9001938
A03	25771078	25773790	A03p55100.2_BraZ1	271.2	+	833	2599	2712	0.9583333
A03	25774205	25774867	A03p55110.2_BraZ1	1386	-	332	662	662	1.0000000
A03	25774914	25777468	A03p55120.2_BraZ1	842.625	-	1755	2532	2554	0.9913861
A03	25778735	25783159	A03p55130.2_BraZ1	2466.79	-	1889	3892	4424	0.8797469
A03	25783638	25785118	A03p55140.2_BraZ1	701.265	+	1013	1480	1480	1.0000000
A03	25785553	25787845	A03p55150.2_BraZ1	1530	-	780	1930	2292	0.8420593
A03	25789799	25790297	A03p55160.2_BraZ1	553.125	+	387	498	498	1.0000000
A03	25790153	25791374	A03p55170.2_BraZ1	1950.75	+	1268	1221	1221	1.0000000
A03	25792696	25793069	A03p55180.2_BraZ1	165	+	232	262	373	0.7024128
A03	25793576	25794100	A03p55190.2_BraZ1	223.2	+	21	313	524	0.5973282
A03	25794132	25794884	A03p55200.2_BraZ1	183	+	201	689	752	0.9162234
A03	25797858	25798473	A03p55210.2_BraZ1	333.714	+	284	615	615	1.0000000
A03	25798469	25799291	A03p55220.2_BraZ1	257.143	+	196	761	822	0.9257907
A03	25798769	25804387	A03p55230.2_BraZ1	1044	+	2273	5116	5618	0.9106444
A03	25801134	25803176	A03p55240.2_BraZ1	387.143	+	387	1756	2042	0.8599412
A03	25805198	25805876	A03p55250.2_BraZ1	67.8	-	540	678	678	1.0000000
A03	25806168	25806877	A03p55260.2_BraZ1	48.3	+	499	709	709	1.0000000
A03	25807520	25812675	A03p55270.2_BraZ1	335.4	-	3089	4906	5155	0.9516974
A03	25819994	25824298	A03p55280.2_BraZ1	1348.33	+	3005	3741	4304	0.8691915
A03	25825202	25836840	A03p55290.2_BraZ1	889.35	-	2577	10739	11638	0.9227530
A03	25834465	25835295	A03p55300.2_BraZ1	292.679	+	63	644	830	0.7759036
A03	25839805	25840945	A03p55310.2_BraZ1	114	+	178	1089	1140	0.9552631
A03	25848694	25849959	A03p55320.2_BraZ1	10800	+	314	1041	1265	0.8229249
A03	25852762	25855283	A03p55330.2_BraZ1	1371.3	-	80	1426	2521	0.5656486
A03	25868952	25870466	A03p55340.2_BraZ1	339.205	+	2351	1514	1514	1.0000000
A03	25870517	25870838	A03p55350.2_BraZ1	234	+	271	321	321	1.0000000
A03	25871724	25873732	A03p55360.2_BraZ1	346.5	+	2364	2008	2008	1.0000000
A03	25880070	25882046	A03p55370.2_BraZ1	1261.94	+	1085	1650	1976	0.8350202
A03	25886370	25886910	A03p55380.2_BraZ1	54	-	626	540	540	1.0000000
A03	25887899	25888203	A03p55390.2_BraZ1	228	-	84	304	304	1.0000000
A03	25898197	25900441	A03p55400.2_BraZ1	1179.83	+	146	1121	2244	0.4995544
A03	25904726	25904975	A03p55410.2_BraZ1	15.6	-	283	249	249	1.0000000
A03	25929714	25931972	A03p55420.2_BraZ1	1156.97	+	271	1851	2258	0.8197520
A03	25933799	25935338	A03p55430.2_BraZ1	1161	+	264	1469	1539	0.9545159
A03	25935660	25939403	A03p55440.2_BraZ1	1490.93	-	716	3384	3743	0.9040876
A03	25939467	25945419	A03p55450.2_BraZ1	2699.01	+	164	3442	5952	0.5782930
A03	25956838	25958023	A03p55460.2_BraZ1	580.031	+	475	1185	1185	1.0000000
A03	25964358	25967096	A03p55470.2_BraZ1	1712.45	-	669	2546	2738	0.9298759
A03	25967421	25969116	A03p55480.2_BraZ1	1132.01	-	1583	1660	1695	0.9793510
A03	25971348	25971961	A03p55490.2_BraZ1	4104	-	605	613	613	1.0000000
A03	25983692	25984354	A03p55500.2_BraZ1	47.7	-	582	662	662	1.0000000
A03	25986764	25987328	A03p55510.2_BraZ1	56.4	-	34	513	564	0.9095744
A03	25989480	25992730	A03p55520.2_BraZ1	2472	-	959	3075	3250	0.9461538
A03	25999666	26000230	A03p55530.2_BraZ1	326.833	+	493	564	564	1.0000000
A03	26004965	26005630	A03p55540.2_BraZ1	333	-	4	149	665	0.2240601
A03	26013991	26014942	A03p55550.2_BraZ1	95.1	+	177	389	951	0.4090431
A03	26025496	26026067	A03p55560.2_BraZ1	222	-	396	455	571	0.7968476
A03	26029424	26035905	A03p55570.2_BraZ1	2462.4	-	2401	5881	6481	0.9074217
A03	26042937	26044593	A03p55580.2_BraZ1	838.174	+	1676	1656	1656	1.0000000
A03	26051078	26053075	A03p55590.2_BraZ1	1851	+	475	1826	1997	0.9143716
A03	26073561	26074494	A03p55600.2_BraZ1	93.3	+	550	933	933	1.0000000
A03	26079700	26079991	A03p55610.2_BraZ1	29.1	+	310	291	291	1.0000000
A03	26087792	26088353	A03p55620.2_BraZ1	2070	+	748	561	561	1.0000000
A03	26091252	26093007	A03p55630.2_BraZ1	1270.76	+	794	1726	1755	0.9834758
A03	26093673	26094844	A03p55640.2_BraZ1	972	-	1186	1171	1171	1.0000000
A03	26103297	26106107	A03p55650.2_BraZ1	1285.25	-	1264	2258	2810	0.8035587
A03	26106758	26109308	A03p55660.2_BraZ1	1617.92	+	825	2335	2550	0.9156862
A03	26111216	26111564	A03p55670.2_BraZ1	34.8	+	17	137	348	0.3936782
A03	26114734	26115334	A03p55680.2_BraZ1	60	-	170	499	600	0.8316666
A03	26116943	26117400	A03p55690.2_BraZ1	258	+	370	457	457	1.0000000
A03	26117691	26118426	A03p55700.2_BraZ1	73.5	-	687	735	735	1.0000000
A03	26119530	26120800	A03p55710.2_BraZ1	838.5	+	1034	1270	1270	1.0000000
A03	26131706	26133946	A03p55720.2_BraZ1	1003.37	+	853	2136	2240	0.9535714
A03	26134493	26135084	A03p55730.2_BraZ1	59.1	-	459	591	591	1.0000000
A03	26136271	26137343	A03p55740.2_BraZ1	276	+	1025	1072	1072	1.0000000
A03	26145644	26148745	A03p55750.2_BraZ1	1473.39	+	623	2549	3101	0.8219929
A03	26150880	26157278	A03p55760.2_BraZ1	2232.26	+	2186	5272	6398	0.8240075
A03	26157736	26159005	A03p55770.2_BraZ1	525	-	527	1207	1269	0.9511426
A03	26176152	26179565	A03p55780.2_BraZ1	2269.09	+	1245	3171	3413	0.9290946
A03	26181690	26181948	A03p55790.2_BraZ1	25.8	+	191	258	258	1.0000000
A03	26183508	26186138	A03p55800.2_BraZ1	1330.62	+	1916	2593	2630	0.9859316
A03	26189063	26189470	A03p55810.2_BraZ1	243	+	552	407	407	1.0000000
A03	26189972	26190107	A03p55820.2_BraZ1	13.5	+	167	135	135	1.0000000
A03	26203785	26206280	A03p55830.2_BraZ1	970.457	+	381	1714	2495	0.6869739
A03	26221450	26222878	A03p55840.2_BraZ1	1032	+	184	1112	1428	0.7787115
A03	26225618	26226855	A03p55850.2_BraZ1	445.2	+	845	1237	1237	1.0000000
A03	26227465	26227687	A03p55860.2_BraZ1	22.2	+	293	222	222	1.0000000
A03	26232805	26235528	A03p55870.2_BraZ1	2016	+	533	2430	2723	0.8923981
A03	26237134	26237831	A03p55880.2_BraZ1	606	+	127	660	697	0.9469153
A03	26239715	26239895	A03p55890.2_BraZ1	18	-	552	180	180	1.0000000
A03	26242025	26243519	A03p55900.2_BraZ1	1438.5	+	1048	1494	1494	1.0000000
A03	26244296	26246170	A03p55910.2_BraZ1	1148.32	+	1028	1874	1874	1.0000000
A03	26247271	26248682	A03p55920.2_BraZ1	2835	-	1111	1411	1411	1.0000000
A03	26249134	26252643	A03p55930.2_BraZ1	2189.84	-	1021	2823	3509	0.8045027
A03	26254393	26255489	A03p55940.2_BraZ1	606.553	-	518	1052	1096	0.9598540
A03	26256988	26258197	A03p55950.2_BraZ1	1140	+	511	1209	1209	1.0000000
A03	26258943	26260347	A03p55960.2_BraZ1	1129.33	-	1228	1404	1404	1.0000000
A03	26261956	26263780	A03p55970.2_BraZ1	1047	+	377	1467	1824	0.8042763
A03	26264299	26266925	A03p55980.2_BraZ1	1358.64	-	615	2288	2626	0.8712871
A03	26278656	26281110	A03p55990.2_BraZ1	1594.29	-	1161	2299	2454	0.9368378
A03	26288160	26289393	A03p56000.2_BraZ1	297.857	-	350	1233	1233	1.0000000
A03	26289975	26290470	A03p56010.2_BraZ1	218.4	+	2	93	495	0.1878788
A03	26291500	26292857	A03p56020.2_BraZ1	3420	-	49	907	1357	0.6683862
A03	26293754	26294209	A03p56030.2_BraZ1	363	-	86	402	455	0.8835165
A03	26294568	26294810	A03p56040.2_BraZ1	165	-	253	242	242	1.0000000
A03	26294839	26295760	A03p56050.2_BraZ1	469.125	-	903	921	921	1.0000000
A03	26311328	26314002	A03p56060.2_BraZ1	2424	-	1364	2674	2674	1.0000000
A03	26317885	26318246	A03p56070.2_BraZ1	225	-	162	361	361	1.0000000
A03	26319208	26321830	A03p56080.2_BraZ1	2328.7	-	1623	2622	2622	1.0000000
A03	26323118	26323649	A03p56090.2_BraZ1	384	+	340	530	531	0.9981167
A03	26326716	26329605	A03p56100.2_BraZ1	2152.04	+	1171	2768	2889	0.9581170
A03	26330687	26332653	A03p56110.2_BraZ1	706.15	-	1581	1966	1966	1.0000000
A03	26333267	26335519	A03p56120.2_BraZ1	1366.23	-	1050	2154	2252	0.9564831
A03	26344583	26345008	A03p56130.2_BraZ1	189	+	747	425	425	1.0000000
A03	26346752	26348667	A03p56140.2_BraZ1	252.049	+	1974	1915	1915	1.0000000
A03	26349811	26351670	A03p56150.2_BraZ1	660.038	+	1005	1859	1859	1.0000000
A03	26351961	26352772	A03p56160.2_BraZ1	630	-	278	696	811	0.8581998
A03	26353646	26356349	A03p56170.2_BraZ1	1838.25	-	1088	2672	2703	0.9885312
A03	26356807	26357938	A03p56180.2_BraZ1	978	+	188	1063	1131	0.9398762
A03	26358470	26362084	A03p56190.2_BraZ1	2044.5	-	840	3034	3614	0.8395130
A03	26363268	26363556	A03p56200.2_BraZ1	28.8	-	157	122	288	0.4236111
A03	26364917	26367847	A03p56210.2_BraZ1	549.818	-	2819	2930	2930	1.0000000
A03	26369528	26370696	A03p56220.2_BraZ1	627.84	+	459	1039	1168	0.8895548
A03	26371096	26375624	A03p56230.2_BraZ1	2718.16	-	1448	4214	4528	0.9306537
A03	26377075	26377453	A03p56240.2_BraZ1	37.8	+	451	378	378	1.0000000
A03	26377896	26383221	A03p56250.2_BraZ1	2330.32	-	4265	5325	5325	1.0000000
A03	26390896	26391604	A03p56260.2_BraZ1	498	+	1	69	708	0.0974576
A03	26392840	26396427	A03p56270.2_BraZ1	651	+	0	0	3587	0.0000000
A03	26397031	26397382	A03p56280.2_BraZ1	35.1	-	0	0	351	0.0000000
A03	26399326	26400580	A03p56290.2_BraZ1	125.4	-	28	843	1254	0.6722488
A03	26406020	26406242	A03p56300.2_BraZ1	22.2	-	0	0	222	0.0000000
A03	26430604	26436171	A03p56310.2_BraZ1	423	+	1942	4275	5567	0.7679181
A03	26431570	26432296	A03p56320.2_BraZ1	534	+	188	612	726	0.8429752
A03	26448966	26450924	A03p56330.2_BraZ1	1257.86	+	312	1688	1958	0.8621042
A03	26452278	26452822	A03p56340.2_BraZ1	492	+	35	422	544	0.7757353
A03	26459872	26460561	A03p56350.2_BraZ1	1071	-	41	644	689	0.9346880
A03	26461627	26461903	A03p56360.2_BraZ1	162	+	11	194	276	0.7028986
A03	26463383	26464076	A03p56370.2_BraZ1	69.3	-	110	668	693	0.9639249
A03	26466689	26466983	A03p56380.2_BraZ1	273	-	7	173	294	0.5884354
A03	26489147	26490411	A03p56390.2_BraZ1	888	+	18	648	1264	0.5126582
A03	26490662	26493968	A03p56400.2_BraZ1	1298.86	-	2320	2337	3306	0.7068965
A03	26500881	26501079	A03p56410.2_BraZ1	19.8	-	16	198	198	1.0000000
A03	26504550	26519548	A03p56420.2_BraZ1	352.75	-	365	2544	14998	0.1696226
A03	26508339	26508757	A03p56430.2_BraZ1	330	-	16	248	418	0.5933014
A03	26510848	26512114	A03p56440.2_BraZ1	126.6	+	63	718	1266	0.5671406
A03	26513061	26513412	A03p56450.2_BraZ1	35.1	+	0	0	351	0.0000000
A03	26514013	26517601	A03p56460.2_BraZ1	938	-	0	0	3588	0.0000000
A03	26522870	26524293	A03p56470.2_BraZ1	676	+	0	0	1423	0.0000000
A03	26545854	26547117	A03p56480.2_BraZ1	126.3	+	0	0	1263	0.0000000
A03	26547353	26547825	A03p56490.2_BraZ1	73.3846	-	0	0	472	0.0000000
A03	26547825	26549173	A03p56500.2_BraZ1	496.615	-	0	0	1348	0.0000000
A03	26551823	26552580	A03p56510.2_BraZ1	147	-	0	0	757	0.0000000
A03	26555851	26557274	A03p56520.2_BraZ1	676	+	0	0	1423	0.0000000
A03	26578836	26580099	A03p56530.2_BraZ1	43.8	+	0	0	1263	0.0000000
A03	26580335	26580807	A03p56540.2_BraZ1	59.625	-	0	0	472	0.0000000
A03	26580807	26582155	A03p56550.2_BraZ1	410.375	-	0	0	1348	0.0000000
A03	26584797	26585554	A03p56560.2_BraZ1	119.438	-	0	0	757	0.0000000
A03	26588812	26590235	A03p56570.2_BraZ1	676	+	0	0	1423	0.0000000
A03	26615426	26616686	A03p56580.2_BraZ1	126	+	102	977	1260	0.7753968
A03	26616924	26631762	A03p56590.2_BraZ1	355.68	-	85	1537	14838	0.1035854
A03	26623223	26624474	A03p56600.2_BraZ1	125.1	+	8	523	1251	0.4180655
A03	26625423	26625774	A03p56610.2_BraZ1	35.1	+	0	0	351	0.0000000
A03	26626378	26629967	A03p56620.2_BraZ1	651	-	0	0	3589	0.0000000
A03	26638638	26639870	A03p56630.2_BraZ1	725.345	+	821	1232	1232	1.0000000
A03	26640313	26646158	A03p56640.2_BraZ1	2443.41	-	2259	5257	5845	0.8994012
A03	26648063	26651292	A03p56650.2_BraZ1	1800.33	-	450	3056	3229	0.9464231
A03	26654367	26660223	A03p56660.2_BraZ1	3951.99	+	960	4010	5856	0.6847678
A03	26662149	26665008	A03p56670.2_BraZ1	1752.32	+	926	2828	2859	0.9891570
A03	26666532	26668202	A03p56680.2_BraZ1	1034.08	-	872	1670	1670	1.0000000
A03	26672117	26673721	A03p56690.2_BraZ1	848.455	-	576	1515	1604	0.9445137
A03	26675696	26676068	A03p56700.2_BraZ1	37.2	-	43	347	372	0.9327957
A03	26680545	26681904	A03p56710.2_BraZ1	333	-	127	873	1359	0.6423841
A03	26680930	26681261	A03p56720.2_BraZ1	255	-	19	263	331	0.7945619
A03	26688433	26691457	A03p56730.2_BraZ1	2324.08	+	1542	2880	3024	0.9523810
A03	26691682	26692110	A03p56740.2_BraZ1	147.6	+	424	428	428	1.0000000
A03	26693711	26695920	A03p56750.2_BraZ1	1120.45	-	1943	2195	2209	0.9936623
A03	26697830	26700331	A03p56760.2_BraZ1	788.668	-	2270	2430	2501	0.9716114
A03	26700914	26705098	A03p56770.2_BraZ1	2067.69	-	740	2669	4184	0.6379063
A03	26714542	26716791	A03p56780.2_BraZ1	1186.45	+	747	2215	2249	0.9848822
A03	26717228	26718146	A03p56790.2_BraZ1	91.8	-	1127	918	918	1.0000000
A03	26719553	26719962	A03p56800.2_BraZ1	210	-	410	409	409	1.0000000
A03	26720923	26723353	A03p56810.2_BraZ1	941.516	+	2296	2430	2430	1.0000000
A03	26724081	26724664	A03p56820.2_BraZ1	185.613	+	173	583	583	1.0000000
A03	26726362	26730300	A03p56830.2_BraZ1	1708.4	+	2463	3779	3938	0.9596242
A03	26731820	26732655	A03p56840.2_BraZ1	36.9	-	879	835	835	1.0000000
A03	26734083	26735717	A03p56850.2_BraZ1	799.582	-	145	1105	1634	0.6762546
A03	26743154	26746961	A03p56860.2_BraZ1	794.761	+	2304	3152	3807	0.8279485
A03	26748572	26753458	A03p56870.2_BraZ1	573	+	1679	4330	4886	0.8862055
A03	26755968	26757121	A03p56880.2_BraZ1	513	+	56	692	1153	0.6001735
A03	26763784	26764556	A03p56890.2_BraZ1	398.545	+	22	563	772	0.7292746
A03	26765396	26766669	A03p56900.2_BraZ1	939	+	881	1155	1273	0.9073056
A03	26767089	26772364	A03p56910.2_BraZ1	2399.65	-	2153	4798	5275	0.9095734
A03	26774879	26775220	A03p56920.2_BraZ1	240	-	0	0	341	0.0000000
A03	26776970	26777252	A03p56930.2_BraZ1	222	+	109	282	282	1.0000000
A03	26778273	26782465	A03p56940.2_BraZ1	1717.98	-	775	3356	4192	0.8005725
A03	26785149	26792334	A03p56950.2_BraZ1	3302.26	+	3573	7082	7185	0.9856646
A03	26792828	26793829	A03p56960.2_BraZ1	4972.5	-	614	1001	1001	1.0000000
A03	26798662	26799643	A03p56970.2_BraZ1	552	+	781	981	981	1.0000000
A03	26800565	26804364	A03p56980.2_BraZ1	2285.42	-	1006	3230	3799	0.8502237
A03	26807382	26809050	A03p56990.2_BraZ1	1307.71	-	757	1641	1668	0.9838129
A03	26810386	26811487	A03p57000.2_BraZ1	110.1	+	208	1052	1101	0.9554950
A03	26812093	26812264	A03p57010.2_BraZ1	17.1	-	136	171	171	1.0000000
A03	26813456	26815248	A03p57020.2_BraZ1	126.321	+	8	39	1792	0.0217634
A03	26817372	26819872	A03p57030.2_BraZ1	464.625	+	275	621	2500	0.2484000
A03	26823293	26824378	A03p57040.2_BraZ1	229.688	+	17	310	1085	0.2857143
A03	26827032	26830379	A03p57050.2_BraZ1	1643.58	+	2188	3213	3347	0.9599642
A03	26835137	26835737	A03p57060.2_BraZ1	60	+	59	392	600	0.6533333
A03	26837657	26838263	A03p57070.2_BraZ1	60.6	-	69	485	606	0.8003300
A03	26838786	26839215	A03p57080.2_BraZ1	294	-	80	400	429	0.9324009
A03	26839334	26842386	A03p57090.2_BraZ1	1876.93	-	1751	2997	3052	0.9819790
A03	26842728	26844033	A03p57100.2_BraZ1	591.667	+	990	1274	1305	0.9762452
A03	26844614	26845967	A03p57110.2_BraZ1	274.977	-	1536	1353	1353	1.0000000
A03	26857394	26859096	A03p57120.2_BraZ1	1103.21	+	530	1645	1702	0.9665100
A03	26863883	26864720	A03p57130.2_BraZ1	681	+	257	777	837	0.9283154
A03	26865735	26868036	A03p57140.2_BraZ1	1226.67	-	1692	2301	2301	1.0000000
A03	26869321	26871512	A03p57150.2_BraZ1	12307.5	+	462	1802	2191	0.8224555
A03	26872038	26872894	A03p57160.2_BraZ1	113.4	-	251	849	856	0.9918224
A03	26872894	26873466	A03p57170.2_BraZ1	396	-	126	539	572	0.9423077
A03	26876295	26878064	A03p57180.2_BraZ1	816.829	+	2272	1769	1769	1.0000000
A03	26878503	26878899	A03p57190.2_BraZ1	39.6	-	276	396	396	1.0000000
A03	26880044	26881868	A03p57200.2_BraZ1	182.4	+	806	1824	1824	1.0000000
A03	26884567	26886231	A03p57210.2_BraZ1	543.438	+	1657	1664	1664	1.0000000
A03	26899600	26900480	A03p57220.2_BraZ1	6734.25	+	109	576	880	0.6545454
A03	26920620	26922875	A03p57230.2_BraZ1	976.8	-	255	1947	2255	0.8634146
A03	26942161	26942803	A03p57240.2_BraZ1	54	-	465	642	642	1.0000000
A03	26951496	26951640	A03p57250.2_BraZ1	14.4	+	273	144	144	1.0000000
A03	26963414	26964043	A03p57260.2_BraZ1	174	+	1030	629	629	1.0000000
A03	26966239	26969174	A03p57270.2_BraZ1	1788.52	+	1717	2920	2935	0.9948893
A03	26970297	26986379	A03p57280.2_BraZ1	4003.16	-	5525	14639	16082	0.9102724
A03	26986706	26988577	A03p57290.2_BraZ1	559.192	+	1341	1871	1871	1.0000000
A03	26990471	26991435	A03p57300.2_BraZ1	764.357	+	121	759	964	0.7873444
A03	27022693	27024398	A03p57310.2_BraZ1	727.091	-	705	1531	1705	0.8979472
A03	27024945	27026937	A03p57320.2_BraZ1	1597.28	+	651	1886	1992	0.9467871
A03	27027558	27029387	A03p57330.2_BraZ1	182	-	1417	1802	1829	0.9852378
A03	27035829	27043237	A03p57340.2_BraZ1	2393.35	+	5549	7135	7408	0.9631479
A03	27043686	27045277	A03p57350.2_BraZ1	1350	-	627	1471	1591	0.9245757
A03	27050740	27052599	A03p57360.2_BraZ1	832.852	+	1876	1859	1859	1.0000000
A03	27053165	27059207	A03p57370.2_BraZ1	1510.81	-	6188	5467	6042	0.9048328
A03	27059279	27060130	A03p57380.2_BraZ1	2047.5	-	764	851	851	1.0000000
A03	27062487	27064478	A03p57390.2_BraZ1	730.541	-	318	1309	1991	0.6574585
A03	27065855	27069498	A03p57400.2_BraZ1	2311.81	-	1502	3453	3643	0.9478452
A03	27070224	27071114	A03p57410.2_BraZ1	481.765	-	367	890	890	1.0000000
A03	27086824	27087981	A03p57420.2_BraZ1	393	-	311	980	1157	0.8470181
A03	27089525	27091340	A03p57430.2_BraZ1	549	+	744	1713	1815	0.9438016
A03	27091573	27092281	A03p57440.2_BraZ1	70.8	+	339	708	708	1.0000000
A03	27093811	27095110	A03p57450.2_BraZ1	129.9	+	262	1031	1299	0.7936875
A03	27095543	27095960	A03p57460.2_BraZ1	41.7	+	146	417	417	1.0000000
A03	27103442	27113428	A03p57470.2_BraZ1	1840	+	7189	9847	9986	0.9860805
A03	27117843	27119334	A03p57480.2_BraZ1	676.564	+	803	1267	1491	0.8497652
A03	27119843	27121639	A03p57490.2_BraZ1	997.905	-	1861	1748	1796	0.9732739
A03	27125735	27128751	A03p57500.2_BraZ1	1938.07	+	803	2891	3016	0.9585544
A03	27129331	27129999	A03p57510.2_BraZ1	327	-	744	668	668	1.0000000
A03	27134374	27140094	A03p57520.2_BraZ1	2760.04	+	1633	5217	5720	0.9120629
A03	27140309	27141955	A03p57530.2_BraZ1	1216	-	897	1497	1646	0.9094775
A03	27145363	27145817	A03p57540.2_BraZ1	294	-	0	0	454	0.0000000
A03	27153682	27155838	A03p57550.2_BraZ1	1278.75	+	1394	2156	2156	1.0000000
A03	27156653	27158099	A03p57560.2_BraZ1	935.016	+	410	1067	1446	0.7378976
A03	27160076	27161199	A03p57570.2_BraZ1	572.203	+	37	591	1123	0.5262689
A03	27161499	27163036	A03p57580.2_BraZ1	683.265	-	1965	1537	1537	1.0000000
A03	27169938	27171160	A03p57590.2_BraZ1	49.2	+	0	0	1222	0.0000000
A03	27173317	27174259	A03p57600.2_BraZ1	94.2	+	0	0	942	0.0000000
A03	27178213	27179155	A03p57610.2_BraZ1	94.2	+	38	339	942	0.3598726
A03	27183145	27183466	A03p57620.2_BraZ1	32.1	-	184	321	321	1.0000000
A03	27185535	27186955	A03p57630.2_BraZ1	1823.25	-	1469	1420	1420	1.0000000
A03	27192136	27192940	A03p57640.2_BraZ1	326.25	+	221	804	804	1.0000000
A03	27196645	27201253	A03p57650.2_BraZ1	1125	+	2972	4608	4608	1.0000000
A03	27201942	27212161	A03p57660.2_BraZ1	926.6	-	2250	8547	10219	0.8363832
A03	27217993	27220218	A03p57670.2_BraZ1	974.11	+	934	2059	2225	0.9253933
A03	27220608	27222117	A03p57680.2_BraZ1	1173	-	275	1498	1509	0.9927104
A03	27223226	27224680	A03p57690.2_BraZ1	135.6	-	141	745	1454	0.5123796
A03	27229667	27234176	A03p57700.2_BraZ1	1916.44	-	1220	4461	4509	0.9893546
A03	27237977	27238795	A03p57710.2_BraZ1	213	+	242	573	818	0.7004890
A03	27245145	27246620	A03p57720.2_BraZ1	1050.78	+	305	1171	1475	0.7938983
A03	27265106	27266703	A03p57730.2_BraZ1	1175.2	+	38	894	1597	0.5597996
A03	27269925	27271646	A03p57740.2_BraZ1	576.542	+	1590	1633	1721	0.9488670
A03	27272287	27272826	A03p57750.2_BraZ1	2982	-	259	539	539	1.0000000
A03	27277899	27280561	A03p57760.2_BraZ1	848.838	+	804	2608	2662	0.9797145
A03	27283180	27284170	A03p57770.2_BraZ1	99	-	17	291	990	0.2939394
A03	27285344	27288910	A03p57780.2_BraZ1	1836.29	-	1439	3539	3566	0.9924285
A03	27289931	27290111	A03p57790.2_BraZ1	18	-	14	140	180	0.7777778
A03	27291343	27291631	A03p57800.2_BraZ1	28.8	-	198	288	288	1.0000000
A03	27293281	27296925	A03p57810.2_BraZ1	2098.8	+	1408	3527	3644	0.9678924
A03	27297918	27299346	A03p57820.2_BraZ1	1275	+	1403	1428	1428	1.0000000
A03	27301434	27302836	A03p57830.2_BraZ1	1152	+	772	1324	1402	0.9443652
A03	27304055	27305786	A03p57840.2_BraZ1	845.288	-	649	1645	1731	0.9503177
A03	27306562	27307531	A03p57850.2_BraZ1	96.9	-	211	952	969	0.9824561
A03	27308139	27309843	A03p57860.2_BraZ1	670.617	+	1307	1704	1704	1.0000000
A03	27310095	27311051	A03p57870.2_BraZ1	828	-	288	907	956	0.9487448
A03	27314063	27316255	A03p57880.2_BraZ1	751.929	+	1734	2181	2192	0.9949818
A03	27316488	27318388	A03p57890.2_BraZ1	3941.67	-	556	1807	1900	0.9510526
A03	27321334	27323715	A03p57900.2_BraZ1	2045.33	+	788	2381	2381	1.0000000
A03	27324490	27325566	A03p57910.2_BraZ1	477	-	909	1076	1076	1.0000000
A03	27327893	27328818	A03p57920.2_BraZ1	614.136	+	380	792	925	0.8562162
A03	27329251	27331683	A03p57930.2_BraZ1	896.854	-	1198	2397	2432	0.9856086
A03	27333045	27334295	A03p57940.2_BraZ1	708.32	-	99	1204	1250	0.9632000
A03	27334648	27337835	A03p57950.2_BraZ1	951.429	-	1481	3076	3187	0.9651710
A03	27337951	27338921	A03p57960.2_BraZ1	280.5	-	189	917	970	0.9453608
A03	27340546	27349895	A03p57970.2_BraZ1	1963.18	-	3000	8164	9349	0.8732485
A03	27346793	27347756	A03p57980.2_BraZ1	96.3	-	475	963	963	1.0000000
A03	27353112	27354446	A03p57990.2_BraZ1	543.75	-	0	0	1334	0.0000000
A03	27355178	27355805	A03p58000.2_BraZ1	62.4	+	189	444	627	0.7081340
A03	27356274	27358997	A03p58010.2_BraZ1	1176.17	-	1340	2434	2723	0.8938671
A03	27364073	27365606	A03p58020.2_BraZ1	1389	+	213	1269	1533	0.8277887
A03	27367158	27370309	A03p58030.2_BraZ1	1723.24	-	977	2953	3151	0.9371628
A03	27373174	27374070	A03p58040.2_BraZ1	385.7	+	266	896	896	1.0000000
A03	27374218	27374914	A03p58050.2_BraZ1	69.6	-	201	678	696	0.9741379
A03	27375277	27377024	A03p58060.2_BraZ1	880.038	+	212	1521	1747	0.8706354
A03	27377683	27378631	A03p58070.2_BraZ1	336	-	668	948	948	1.0000000
A03	27385388	27385746	A03p58080.2_BraZ1	222	-	36	337	358	0.9413408
A03	27386675	27387260	A03p58090.2_BraZ1	1184.5	+	188	585	585	1.0000000
A03	27387338	27387951	A03p58100.2_BraZ1	961.875	+	49	503	613	0.8205547
A03	27388210	27388330	A03p58110.2_BraZ1	12	-	40	120	120	1.0000000
A03	27393778	27394228	A03p58120.2_BraZ1	45	+	256	450	450	1.0000000
A03	27401369	27409342	A03p58130.2_BraZ1	405	+	84271	7796	7973	0.9778001
A03	27410184	27410485	A03p58140.2_BraZ1	138	-	33	205	301	0.6810631
A03	27412844	27415908	A03p58150.2_BraZ1	741.75	-	1928	2927	3064	0.9552872
A03	27416541	27418137	A03p58160.2_BraZ1	149.7	-	413	1596	1596	1.0000000
A03	27420438	27421109	A03p58170.2_BraZ1	306	+	234	671	671	1.0000000
A03	27421655	27423244	A03p58180.2_BraZ1	1060.2	-	387	1586	1589	0.9981120
A03	27423310	27427750	A03p58190.2_BraZ1	309	-	1618	4263	4440	0.9601352
A03	27428107	27430183	A03p58200.2_BraZ1	967.2	-	2172	2076	2076	1.0000000
A03	27431993	27432494	A03p58210.2_BraZ1	50.1	-	388	501	501	1.0000000
A03	27436135	27441588	A03p58220.2_BraZ1	983.99	-	4388	5453	5453	1.0000000
A03	27443339	27446021	A03p58230.2_BraZ1	752.84	-	1468	2682	2682	1.0000000
A03	27446549	27447425	A03p58240.2_BraZ1	87.6	+	383	876	876	1.0000000
A03	27447783	27449190	A03p58250.2_BraZ1	683.278	-	1016	1407	1407	1.0000000
A03	27450468	27452515	A03p58260.2_BraZ1	1999.5	+	1106	2047	2047	1.0000000
A03	27453453	27462632	A03p58270.2_BraZ1	2540.3	-	5207	8909	9179	0.9705850
A03	27456151	27457183	A03p58280.2_BraZ1	366	+	1333	1032	1032	1.0000000
A03	27463205	27463581	A03p58290.2_BraZ1	264	+	81	376	376	1.0000000
A03	27467587	27471308	A03p58300.2_BraZ1	1385.68	+	1831	3616	3721	0.9717818
A03	27471916	27472797	A03p58310.2_BraZ1	405	-	719	881	881	1.0000000
A03	27473404	27475319	A03p58320.2_BraZ1	847.192	-	1006	1915	1915	1.0000000
A03	27475924	27477584	A03p58330.2_BraZ1	320.829	-	1103	1658	1660	0.9987952
A03	27477923	27478493	A03p58340.2_BraZ1	57	+	463	570	570	1.0000000
A03	27486287	27486764	A03p58350.2_BraZ1	47.7	+	85	266	477	0.5576520
A03	27487721	27491850	A03p58360.2_BraZ1	3150	+	1829	3180	4129	0.7701623
A03	27493271	27495247	A03p58370.2_BraZ1	1015.06	-	1155	1875	1976	0.9488866
A03	27496132	27496632	A03p58380.2_BraZ1	38.7	+	375	500	500	1.0000000
A03	27504967	27507272	A03p58390.2_BraZ1	1865.27	+	642	2097	2305	0.9097614
A03	27508492	27508921	A03p58400.2_BraZ1	42.9	+	536	429	429	1.0000000
A03	27516552	27519436	A03p58410.2_BraZ1	2013.99	+	454	2170	2884	0.7524272
A03	27531447	27532471	A03p58420.2_BraZ1	801	-	230	979	1024	0.9560547
A03	27538202	27539433	A03p58430.2_BraZ1	592.922	-	660	1231	1231	1.0000000
A03	27540322	27542000	A03p58440.2_BraZ1	1026	+	520	1330	1678	0.7926102
A03	27542965	27544090	A03p58450.2_BraZ1	918.833	-	533	1111	1125	0.9875556
A03	27547280	27549888	A03p58460.2_BraZ1	1842.86	-	481	2220	2608	0.8512270
A03	27552395	27552575	A03p58470.2_BraZ1	18	+	97	180	180	1.0000000
A03	27554159	27555242	A03p58480.2_BraZ1	489.375	+	678	1083	1083	1.0000000
A03	27555810	27559151	A03p58490.2_BraZ1	1498.55	+	1662	3282	3341	0.9823406
A03	27559556	27561053	A03p58500.2_BraZ1	1243.73	-	952	1383	1497	0.9238477
A03	27563596	27564234	A03p58510.2_BraZ1	174	+	641	638	638	1.0000000
A03	27566258	27568486	A03p58520.2_BraZ1	1764.13	+	1086	2194	2228	0.9847397
A03	27571141	27572979	A03p58530.2_BraZ1	5684.25	-	1844	1838	1838	1.0000000
A03	27576415	27580531	A03p58540.2_BraZ1	2314.05	+	821	3417	4116	0.8301749
A03	27580848	27581253	A03p58550.2_BraZ1	312	-	532	405	405	1.0000000
A03	27583995	27584397	A03p58560.2_BraZ1	40.2	+	422	402	402	1.0000000
A03	27587591	27589409	A03p58570.2_BraZ1	1322.04	-	1242	1818	1818	1.0000000
A03	27590247	27591989	A03p58580.2_BraZ1	1540	-	1899	1742	1742	1.0000000
A03	27593634	27599076	A03p58590.2_BraZ1	2913.16	-	3540	5442	5442	1.0000000
A03	27600391	27600962	A03p58600.2_BraZ1	402	+	1047	571	571	1.0000000
A03	27605768	27609053	A03p58610.2_BraZ1	936.352	-	1709	3283	3285	0.9993912
A03	27610883	27622108	A03p58620.2_BraZ1	408	+	19213	11197	11225	0.9975055
A03	27624584	27624773	A03p58630.2_BraZ1	18.9	+	145	189	189	1.0000000
A03	27625550	27625739	A03p58640.2_BraZ1	18.9	+	375	189	189	1.0000000
A03	27627108	27627267	A03p58650.2_BraZ1	15.9	-	14	159	159	1.0000000
A03	27630855	27631567	A03p58660.2_BraZ1	501.848	-	318	712	712	1.0000000
A03	27632718	27634126	A03p58670.2_BraZ1	1104	+	1389	1280	1408	0.9090909
A03	27635418	27636913	A03p58680.2_BraZ1	568.135	+	423	1495	1495	1.0000000
A03	27639282	27641854	A03p58690.2_BraZ1	234.779	+	1621	2529	2572	0.9832815
A03	27642624	27643948	A03p58700.2_BraZ1	409.619	+	829	1324	1324	1.0000000
A03	27645151	27647235	A03p58710.2_BraZ1	1104.78	-	884	2083	2084	0.9995202
A03	27669734	27671264	A03p58720.2_BraZ1	104.7	-	14	289	1530	0.1888889
A03	27672548	27673435	A03p58730.2_BraZ1	570	-	424	887	887	1.0000000
A03	27677965	27678718	A03p58740.2_BraZ1	75.3	-	174	710	753	0.9428951
A03	27691737	27694562	A03p58750.2_BraZ1	1146.97	+	2746	2825	2825	1.0000000
A03	27695930	27697206	A03p58760.2_BraZ1	904.853	+	1030	1276	1276	1.0000000
A03	27700330	27700702	A03p58770.2_BraZ1	273	+	391	372	372	1.0000000
A03	27716841	27717783	A03p58780.2_BraZ1	94.2	+	279	832	942	0.8832272
A03	27721115	27722114	A03p58790.2_BraZ1	867	+	182	947	999	0.9479479
A03	27723385	27728396	A03p58800.2_BraZ1	2365.67	+	4814	5011	5011	1.0000000
A03	27734114	27735092	A03p58810.2_BraZ1	97.8	-	677	978	978	1.0000000
A03	27742346	27748566	A03p58820.2_BraZ1	550.8	-	2790	5612	6220	0.9022508
A03	27750344	27752306	A03p58830.2_BraZ1	10707	-	874	1927	1962	0.9821610
A03	27753518	27755108	A03p58840.2_BraZ1	158.1	+	1282	1590	1590	1.0000000
A03	27756708	27760809	A03p58850.2_BraZ1	2443.98	+	1471	3826	4101	0.9329432
A03	27761208	27762731	A03p58860.2_BraZ1	490.455	-	1148	1523	1523	1.0000000
A03	27763299	27764734	A03p58870.2_BraZ1	761.875	-	900	1435	1435	1.0000000
A03	27765716	27766868	A03p58880.2_BraZ1	795	-	443	1115	1152	0.9678819
A03	27767250	27768588	A03p58890.2_BraZ1	248.451	-	6	108	1338	0.0807175
A03	27769332	27769772	A03p58900.2_BraZ1	245.368	-	4	70	440	0.1590909
A03	27770933	27778836	A03p58910.2_BraZ1	4875.05	-	1976	6112	7903	0.7733772
A03	27785684	27786749	A03p58920.2_BraZ1	712.8	+	269	1029	1065	0.9661972
A03	27794208	27798619	A03p58930.2_BraZ1	660	+	3214	4411	4411	1.0000000
A03	27806764	27806980	A03p58940.2_BraZ1	21.6	+	293	216	216	1.0000000
A03	27807438	27811547	A03p58950.2_BraZ1	795	+	2910	4109	4109	1.0000000
A03	27826059	27826388	A03p58960.2_BraZ1	150	-	204	329	329	1.0000000
A03	27829200	27831688	A03p58970.2_BraZ1	536.25	-	2033	2225	2488	0.8942926
A03	27832110	27833319	A03p58980.2_BraZ1	3324.75	-	269	1173	1209	0.9702233
A03	27837303	27840101	A03p58990.2_BraZ1	1432.31	+	711	2243	2798	0.8016440
A03	27841088	27851534	A03p59000.2_BraZ1	321	+	4039	10258	10446	0.9820027
A03	27847601	27848086	A03p59010.2_BraZ1	450	+	70	485	485	1.0000000
A03	27853121	27853932	A03p59020.2_BraZ1	1209	-	157	775	811	0.9556103
A03	27854773	27856717	A03p59030.2_BraZ1	5720.25	-	735	1875	1944	0.9645061
A03	27856686	27857442	A03p59040.2_BraZ1	1465.71	-	220	681	756	0.9007937
A03	27859895	27860681	A03p59050.2_BraZ1	78.6	-	587	786	786	1.0000000
A03	27862075	27863363	A03p59060.2_BraZ1	808.364	-	258	1288	1288	1.0000000
A03	27866525	27866936	A03p59070.2_BraZ1	41.1	+	283	409	411	0.9951338
A03	27869087	27870322	A03p59080.2_BraZ1	531	-	390	666	1235	0.5392712
A03	27870543	27871045	A03p59090.2_BraZ1	480	+	832	502	502	1.0000000
A03	27874795	27875677	A03p59100.2_BraZ1	156.484	-	4	115	882	0.1303855
A03	27875865	27875973	A03p59110.2_BraZ1	10.8	-	12	47	108	0.4351852
A03	27877043	27878583	A03p59120.2_BraZ1	721.456	+	137	1164	1540	0.7558442
A03	27879574	27880918	A03p59130.2_BraZ1	1050	+	529	1344	1344	1.0000000
A03	27881661	27884497	A03p59140.2_BraZ1	1619.35	+	522	1958	2836	0.6904090
A03	27885225	27885501	A03p59150.2_BraZ1	27.6	-	266	276	276	1.0000000
A03	27886387	27886549	A03p59160.2_BraZ1	16.2	+	20	162	162	1.0000000
A03	27890603	27891992	A03p59170.2_BraZ1	731.5	-	443	1226	1389	0.8826494
A03	27896032	27897707	A03p59180.2_BraZ1	1509	+	449	1582	1675	0.9444776
A03	27898529	27899120	A03p59190.2_BraZ1	59.1	-	186	586	591	0.9915398
A03	27902747	27903452	A03p59200.2_BraZ1	5313	+	224	705	705	1.0000000
A03	27905480	27907160	A03p59210.2_BraZ1	1497.27	+	1012	1680	1680	1.0000000
A03	27907762	27908314	A03p59220.2_BraZ1	55.2	+	460	552	552	1.0000000
A03	27919341	27920678	A03p59230.2_BraZ1	867.818	+	150	1228	1337	0.9184742
A03	27922404	27922768	A03p59240.2_BraZ1	270	-	52	263	364	0.7225274
A03	27924912	27925086	A03p59250.2_BraZ1	17.4	+	135	174	174	1.0000000
A03	27930834	27937695	A03p59260.2_BraZ1	1042.33	+	4768	6821	6861	0.9941700
A03	27932592	27934425	A03p59270.2_BraZ1	531	-	1467	1825	1833	0.9956356
A03	27932981	27933362	A03p59280.2_BraZ1	294	-	253	376	381	0.9868767
A03	27947155	27954113	A03p59290.2_BraZ1	1022.73	+	1398	5779	6958	0.8305548
A03	27954169	27960648	A03p59300.2_BraZ1	114	+	909	2930	6479	0.4522303
A03	27968937	27972350	A03p59310.2_BraZ1	1194.34	+	1760	3177	3413	0.9308527
A03	27973238	27974070	A03p59320.2_BraZ1	9000	+	713	832	832	1.0000000
A03	27974486	27977207	A03p59330.2_BraZ1	1290.09	-	669	2298	2721	0.8445424
A03	27978560	27978782	A03p59340.2_BraZ1	22.2	+	261	222	222	1.0000000
A03	27979626	27984395	A03p59350.2_BraZ1	2497.85	-	2439	4758	4769	0.9976934
A03	27985277	27986551	A03p59360.2_BraZ1	989	+	390	1242	1274	0.9748822
A03	27986727	27987567	A03p59370.2_BraZ1	603	-	372	840	840	1.0000000
A03	27989023	27989596	A03p59380.2_BraZ1	57.3	+	88	571	573	0.9965096
A03	27990792	27993820	A03p59390.2_BraZ1	1962.5	+	1709	2926	3028	0.9663144
A03	27999883	28002343	A03p59400.2_BraZ1	1014.63	+	783	1923	2460	0.7817073
A03	28003643	28004102	A03p59410.2_BraZ1	45.9	+	38	435	459	0.9477124
A03	28006810	28008254	A03p59420.2_BraZ1	897.9	+	0	0	1444	0.0000000
A03	28008314	28008416	A03p59430.2_BraZ1	10.2	+	0	0	102	0.0000000
A03	28010494	28020289	A03p59440.2_BraZ1	465.87	+	9171	9292	9795	0.9486473
A03	28021975	28023419	A03p59450.2_BraZ1	897.9	+	0	0	1444	0.0000000
A03	28023479	28023581	A03p59460.2_BraZ1	10.2	+	0	0	102	0.0000000
A03	28051390	28052865	A03p59470.2_BraZ1	648	+	0	0	1475	0.0000000
A03	28062392	28063867	A03p59480.2_BraZ1	69.9	+	0	0	1475	0.0000000
A03	28073420	28074895	A03p59490.2_BraZ1	1185.3	+	0	0	1475	0.0000000
A03	28084445	28085921	A03p59500.2_BraZ1	136.8	+	0	0	1476	0.0000000
A03	28090389	28094726	A03p59510.2_BraZ1	950.4	-	2866	4167	4337	0.9608024
A03	28116298	28120302	A03p59520.2_BraZ1	3255.48	-	313	2498	4004	0.6238761
A03	28121139	28123841	A03p59530.2_BraZ1	1377.54	+	678	2609	2702	0.9655811
A03	28126128	28129204	A03p59540.2_BraZ1	2061.11	+	991	2897	3076	0.9418076
A03	28134164	28135264	A03p59550.2_BraZ1	1998	-	68	687	1100	0.6245455
A03	28135351	28136109	A03p59560.2_BraZ1	696	-	172	758	758	1.0000000
A03	28140739	28140964	A03p59570.2_BraZ1	22.5	-	285	225	225	1.0000000
A03	28141019	28142660	A03p59580.2_BraZ1	738.592	-	1047	1641	1641	1.0000000
A03	28146466	28152944	A03p59590.2_BraZ1	1025.16	+	2217	6139	6478	0.9476690
A03	28154091	28155621	A03p59600.2_BraZ1	153	+	122	1202	1530	0.7856209
A03	28157734	28158925	A03p59610.2_BraZ1	117.9	-	303	821	1191	0.6893367
A03	28173045	28179633	A03p59620.2_BraZ1	1177.5	-	2926	6526	6588	0.9905890
A03	28182550	28183877	A03p59630.2_BraZ1	513.489	+	1203	1327	1327	1.0000000
A03	28184230	28185581	A03p59640.2_BraZ1	101.7	+	477	1317	1351	0.9748334
A03	28186188	28186564	A03p59650.2_BraZ1	243	-	476	376	376	1.0000000
A03	28187082	28190162	A03p59660.2_BraZ1	1523.31	-	1217	2976	3080	0.9662338
A03	28191541	28191934	A03p59670.2_BraZ1	39.3	+	589	393	393	1.0000000
A03	28192664	28194643	A03p59680.2_BraZ1	471.167	-	1100	1979	1979	1.0000000
A03	28194305	28195529	A03p59690.2_BraZ1	618.469	+	478	1224	1224	1.0000000
A03	28217849	28219457	A03p59700.2_BraZ1	544.714	+	285	1515	1608	0.9421642
A03	28221247	28223630	A03p59710.2_BraZ1	1263.82	+	980	2259	2383	0.9479647
A03	28224124	28224436	A03p59720.2_BraZ1	31.2	+	280	312	312	1.0000000
A03	28225328	28226585	A03p59730.2_BraZ1	125.7	-	431	1249	1257	0.9936357
A03	28227427	28228839	A03p59740.2_BraZ1	1146	-	1052	1412	1412	1.0000000
A03	28232785	28233677	A03p59750.2_BraZ1	570	+	1089	892	892	1.0000000
A03	28234416	28236697	A03p59760.2_BraZ1	912.6	-	27	245	2281	0.1074090
A03	28244045	28244661	A03p59770.2_BraZ1	270	-	92	566	616	0.9188312
A03	28254725	28256140	A03p59780.2_BraZ1	923.867	-	22	398	1415	0.2812721
A03	28259676	28260888	A03p59790.2_BraZ1	121.2	-	1070	1212	1212	1.0000000
A03	28261801	28264233	A03p59800.2_BraZ1	1028.95	+	374	2059	2432	0.8466283
A03	28268700	28270552	A03p59810.2_BraZ1	116.69	+	521	1751	1852	0.9454644
A03	28272749	28274101	A03p59820.2_BraZ1	1092	+	2	67	1352	0.0495562
A03	28274990	28281790	A03p59830.2_BraZ1	249.6	+	6119	6756	6800	0.9935294
A03	28281908	28284176	A03p59840.2_BraZ1	1383.46	+	579	2246	2268	0.9902998
A03	28285843	28290219	A03p59850.2_BraZ1	1804.43	-	314	1441	4376	0.3292962
A03	28291840	28294269	A03p59860.2_BraZ1	1028.95	+	165	1439	2429	0.5924249
A03	28302715	28306329	A03p59870.2_BraZ1	850.5	+	1223	2501	3614	0.6920310
A03	28305054	28306289	A03p59880.2_BraZ1	294	+	952	1235	1235	1.0000000
A03	28306340	28309064	A03p59890.2_BraZ1	1241.62	+	648	2623	2724	0.9629222
A03	28310739	28315129	A03p59900.2_BraZ1	1573.09	-	419	2299	4390	0.5236902
A03	28317900	28318125	A03p59910.2_BraZ1	22.5	-	362	225	225	1.0000000
A03	28321048	28321471	A03p59920.2_BraZ1	42.3	+	555	423	423	1.0000000
A03	28323025	28323349	A03p59930.2_BraZ1	32.4	+	223	324	324	1.0000000
A03	28324505	28324961	A03p59940.2_BraZ1	45.6	+	3	112	456	0.2456140
A03	28326505	28328267	A03p59950.2_BraZ1	479.25	-	1654	1762	1762	1.0000000
A03	28330806	28334194	A03p59960.2_BraZ1	960.091	+	2890	3388	3388	1.0000000
A03	28365717	28369676	A03p59970.2_BraZ1	1178.36	+	1641	3514	3959	0.8875979
A03	28374897	28375450	A03p59980.2_BraZ1	46.2	-	529	553	553	1.0000000
A03	28378417	28379047	A03p59990.2_BraZ1	63	+	92	494	630	0.7841270
A03	28393061	28393229	A03p60000.2_BraZ1	16.8	-	114	168	168	1.0000000
A03	28407846	28409469	A03p60010.2_BraZ1	162.3	+	124	981	1623	0.6044362
A03	28418420	28420170	A03p60020.2_BraZ1	1140.48	+	468	1609	1750	0.9194286
A03	28424048	28428421	A03p60030.2_BraZ1	901.545	+	4294	4373	4373	1.0000000
A03	28428841	28432829	A03p60040.2_BraZ1	2271.3	+	1374	3838	3988	0.9623871
A03	28433573	28433823	A03p60050.2_BraZ1	14.4	-	192	250	250	1.0000000
A03	28436641	28437691	A03p60060.2_BraZ1	105	-	361	1050	1050	1.0000000
A03	28438894	28439035	A03p60070.2_BraZ1	14.1	+	255	141	141	1.0000000
A03	28451211	28451583	A03p60080.2_BraZ1	37.2	-	78	289	372	0.7768817
A03	28461548	28461905	A03p60090.2_BraZ1	30.6	+	32	237	357	0.6638656
A03	28465624	28474964	A03p60100.2_BraZ1	1310.34	+	3345	6241	9340	0.6682013
A03	28476002	28478392	A03p60110.2_BraZ1	1538.04	+	1494	2366	2390	0.9899582
A03	28478771	28479269	A03p60120.2_BraZ1	351	-	550	498	498	1.0000000
A03	28481387	28481666	A03p60130.2_BraZ1	177	+	108	279	279	1.0000000
A03	28481778	28481895	A03p60140.2_BraZ1	11.7	+	36	117	117	1.0000000
A03	28487220	28487453	A03p60150.2_BraZ1	174	-	86	233	233	1.0000000
A03	28488533	28495135	A03p60160.2_BraZ1	1473.83	+	2359	5914	6602	0.8957891
A03	28499950	28501168	A03p60170.2_BraZ1	121.8	+	121	748	1218	0.6141215
A03	28501343	28502524	A03p60180.2_BraZ1	786	-	563	1181	1181	1.0000000
A03	28512985	28513583	A03p60190.2_BraZ1	231	+	184	534	598	0.8929766
A03	28514802	28515387	A03p60200.2_BraZ1	237	+	62	383	585	0.6547009
A03	28516548	28518729	A03p60210.2_BraZ1	1961.14	+	410	1840	2181	0.8436497
A03	28519373	28520112	A03p60220.2_BraZ1	405	+	65	557	739	0.7537212
A03	28527131	28528337	A03p60230.2_BraZ1	120.6	+	247	890	1206	0.7379768
A03	28533075	28534326	A03p60240.2_BraZ1	125.1	+	155	727	1251	0.5811351
A03	28535160	28536705	A03p60250.2_BraZ1	1512	-	1765	1545	1545	1.0000000
A03	28537126	28537772	A03p60260.2_BraZ1	423	-	305	646	646	1.0000000
A03	28538549	28540366	A03p60270.2_BraZ1	942.078	+	1552	1817	1817	1.0000000
A03	28540763	28542685	A03p60280.2_BraZ1	894.444	-	1716	1922	1922	1.0000000
A03	28546791	28547631	A03p60290.2_BraZ1	84	+	9	424	840	0.5047619
A03	28548431	28549376	A03p60300.2_BraZ1	94.5	+	242	945	945	1.0000000
A03	28549993	28554036	A03p60310.2_BraZ1	1791.9	-	1366	3451	4043	0.8535741
A03	28563114	28564662	A03p60320.2_BraZ1	154.8	-	1129	1548	1548	1.0000000
A03	28565373	28566512	A03p60330.2_BraZ1	2028	+	70	272	1139	0.2388060
A03	28576000	28576876	A03p60340.2_BraZ1	274.054	-	966	876	876	1.0000000
A03	28586462	28589974	A03p60350.2_BraZ1	1439.22	+	2542	3512	3512	1.0000000
A03	28590525	28592382	A03p60360.2_BraZ1	1353.79	-	399	1600	1857	0.8616048
A03	28596151	28597426	A03p60370.2_BraZ1	127.5	-	748	1275	1275	1.0000000
A03	28603291	28603555	A03p60380.2_BraZ1	26.4	+	87	264	264	1.0000000
A03	28604733	28605135	A03p60390.2_BraZ1	222	-	698	402	402	1.0000000
A03	28605715	28607535	A03p60400.2_BraZ1	1590	-	281	1331	1820	0.7313187
A03	28612369	28614102	A03p60410.2_BraZ1	476	+	1292	1733	1733	1.0000000
A03	28618361	28620926	A03p60420.2_BraZ1	1136.19	+	1239	2467	2565	0.9617934
A03	28621877	28622069	A03p60430.2_BraZ1	19.2	-	65	192	192	1.0000000
A03	28625826	28629380	A03p60440.2_BraZ1	2117.71	+	3047	3554	3554	1.0000000
A03	28629564	28631449	A03p60450.2_BraZ1	4332	-	1338	1885	1885	1.0000000
A03	28633199	28633798	A03p60460.2_BraZ1	465	+	486	599	599	1.0000000
A03	28634974	28636921	A03p60470.2_BraZ1	194.7	-	1582	1947	1947	1.0000000
A03	28640840	28642721	A03p60480.2_BraZ1	188.1	-	996	1881	1881	1.0000000
A03	28647329	28648751	A03p60490.2_BraZ1	142.2	+	498	1399	1422	0.9838256
A03	28650331	28653360	A03p60500.2_BraZ1	661.305	+	1607	2934	3029	0.9686365
A03	28652669	28655278	A03p60510.2_BraZ1	440.292	+	1757	2561	2609	0.9816021
A03	28657817	28658636	A03p60520.2_BraZ1	81.9	-	738	819	819	1.0000000
A03	28663983	28664525	A03p60530.2_BraZ1	384	+	134	542	542	1.0000000
A03	28666059	28666912	A03p60540.2_BraZ1	369	-	141	853	853	1.0000000
A03	28669285	28669558	A03p60550.2_BraZ1	27.3	-	266	273	273	1.0000000
A03	28669817	28670411	A03p60560.2_BraZ1	519	-	538	594	594	1.0000000
A03	28673717	28673906	A03p60570.2_BraZ1	18.9	-	163	189	189	1.0000000
A03	28675186	28676113	A03p60580.2_BraZ1	312	-	463	927	927	1.0000000
A03	28676559	28677084	A03p60590.2_BraZ1	52.5	+	231	525	525	1.0000000
A03	28678046	28679330	A03p60600.2_BraZ1	1101	-	867	1250	1284	0.9735203
A03	28680498	28682694	A03p60610.2_BraZ1	1159.67	+	2150	2196	2196	1.0000000
A03	28685629	28692753	A03p60620.2_BraZ1	3035.14	-	1783	6335	7124	0.8892476
A03	28709946	28710150	A03p60630.2_BraZ1	20.4	-	531	204	204	1.0000000
A03	28721199	28731862	A03p60640.2_BraZ1	728.64	+	5507	9557	10663	0.8962768
A03	28726361	28727884	A03p60650.2_BraZ1	62.1	+	180	756	1523	0.4963887
A03	28732158	28733005	A03p60660.2_BraZ1	603	-	1394	847	847	1.0000000
A03	28735079	28735580	A03p60670.2_BraZ1	50.1	-	293	491	501	0.9800399
A03	28736420	28736693	A03p60680.2_BraZ1	27.3	+	46	273	273	1.0000000
A03	28740744	28744215	A03p60690.2_BraZ1	2412.21	+	778	3122	3471	0.8994526
A03	28745393	28747611	A03p60700.2_BraZ1	1151.43	-	1902	2152	2218	0.9702435
A03	28751409	28752046	A03p60710.2_BraZ1	317.625	+	362	637	637	1.0000000
A03	28756032	28756564	A03p60720.2_BraZ1	384	+	133	532	532	1.0000000
A03	28758129	28758977	A03p60730.2_BraZ1	369	-	45	746	848	0.8797170
A03	28767766	28770987	A03p60740.2_BraZ1	1259.45	-	421	2909	3221	0.9031357
A03	28774643	28779985	A03p60750.2_BraZ1	3805.01	+	1079	3273	5342	0.6126919
A03	28780364	28784532	A03p60760.2_BraZ1	2673.24	-	1361	3916	4168	0.9395394
A03	28799075	28800483	A03p60770.2_BraZ1	324	-	188	1289	1408	0.9154829
A03	28802623	28803660	A03p60780.2_BraZ1	270	+	670	1037	1037	1.0000000
A03	28803929	28804456	A03p60790.2_BraZ1	330	-	322	527	527	1.0000000
A03	28809989	28814560	A03p60800.2_BraZ1	2754.23	+	955	4416	4571	0.9660906
A03	28815815	28816370	A03p60810.2_BraZ1	55.5	+	180	555	555	1.0000000
A03	28818134	28821257	A03p60820.2_BraZ1	1731.87	+	961	2652	3123	0.8491835
A03	28823518	28824072	A03p60830.2_BraZ1	345	-	36	287	554	0.5180506
A03	28830338	28832310	A03p60840.2_BraZ1	898.97	+	531	1654	1972	0.8387424
A03	28833833	28838175	A03p60850.2_BraZ1	2216.17	-	213	2859	4342	0.6584523
A03	28842892	28846935	A03p60860.2_BraZ1	2182.7	+	478	2819	4043	0.6972545
A03	28850034	28851373	A03p60870.2_BraZ1	7573.5	+	38	570	1339	0.4256908
A03	28851840	28853081	A03p60880.2_BraZ1	1458	+	25	806	1241	0.6494762
A03	28856678	28857161	A03p60890.2_BraZ1	48.3	+	107	483	483	1.0000000
A03	28859986	28860177	A03p60900.2_BraZ1	15.6	+	1245	191	191	1.0000000
A03	28869394	28870513	A03p60910.2_BraZ1	111.9	-	169	849	1119	0.7587131
A03	28872356	28874258	A03p60920.2_BraZ1	190.2	-	920	1787	1902	0.9395373
A03	28884450	28887787	A03p60930.2_BraZ1	1848.81	+	862	3026	3337	0.9068025
A03	28891327	28899823	A03p60940.2_BraZ1	50.7	-	3021	7100	8496	0.8356874
A03	28906151	28906943	A03p60950.2_BraZ1	79.2	+	100	653	792	0.8244950
A03	28912326	28913117	A03p60960.2_BraZ1	330	-	374	681	791	0.8609355
A03	28914371	28915482	A03p60970.2_BraZ1	10920	-	916	1111	1111	1.0000000
A03	28924982	28927678	A03p60980.2_BraZ1	396	+	48	684	2696	0.2537092
A03	28930658	28931810	A03p60990.2_BraZ1	810.409	-	185	942	1152	0.8177083
A03	28933781	28935005	A03p61000.2_BraZ1	844.227	-	148	663	1224	0.5416667
A03	28935479	28937001	A03p61010.2_BraZ1	228	-	804	1514	1522	0.9947438
A03	28937411	28940717	A03p61020.2_BraZ1	1558.53	+	1939	3282	3306	0.9927405
A03	28941433	28941934	A03p61030.2_BraZ1	50.1	+	214	443	501	0.8842315
A03	28959220	28961998	A03p61040.2_BraZ1	6198.75	+	1276	2707	2778	0.9744421
A03	28968173	28968410	A03p61050.2_BraZ1	150	-	244	237	237	1.0000000
A03	28971570	28972137	A03p61060.2_BraZ1	291	-	398	567	567	1.0000000
A03	28983705	28985064	A03p61070.2_BraZ1	135.9	+	92	460	1359	0.3384842
A03	28990014	28990215	A03p61080.2_BraZ1	20.1	+	2	106	201	0.5273632
A03	28996483	28998152	A03p61090.2_BraZ1	947.1	+	64	1054	1669	0.6315159
A03	29003475	29004725	A03p61100.2_BraZ1	362.727	-	247	1242	1250	0.9936000
A03	29004881	29005238	A03p61110.2_BraZ1	291	-	419	357	357	1.0000000
A03	29009901	29011452	A03p61120.2_BraZ1	1021.5	+	1963	1551	1551	1.0000000
A03	29017284	29017602	A03p61130.2_BraZ1	267	-	419	318	318	1.0000000
A03	29045724	29050531	A03p61140.2_BraZ1	1487.45	+	240	1788	4807	0.3719576
A03	29051398	29052537	A03p61150.2_BraZ1	615.6	-	44	637	1139	0.5592625
A03	29054752	29056045	A03p61160.2_BraZ1	129.3	-	13	368	1293	0.2846094
A03	29057772	29058504	A03p61170.2_BraZ1	235.667	-	85	472	732	0.6448088
A03	29059751	29060589	A03p61180.2_BraZ1	330	-	613	838	838	1.0000000
A03	29069961	29070441	A03p61190.2_BraZ1	48	-	66	423	480	0.8812500
A03	29079129	29081674	A03p61200.2_BraZ1	866.4	+	602	2334	2545	0.9170923
A03	29083266	29086759	A03p61210.2_BraZ1	1275.82	-	3348	3451	3493	0.9879760
A03	29087462	29088484	A03p61220.2_BraZ1	466.071	+	624	1022	1022	1.0000000
A03	29089058	29091203	A03p61230.2_BraZ1	986.24	-	1534	2003	2145	0.9337995
A03	29092416	29095318	A03p61240.2_BraZ1	1395.03	-	2728	2902	2902	1.0000000
A03	29100830	29100971	A03p61250.2_BraZ1	14.1	-	157	141	141	1.0000000
A03	29106183	29107707	A03p61260.2_BraZ1	721.625	+	510	839	1524	0.5505250
A03	29108572	29111357	A03p61270.2_BraZ1	2045.51	-	633	2507	2785	0.9001795
A03	29112985	29116510	A03p61280.2_BraZ1	1207.91	-	2730	3525	3525	1.0000000
A03	29117129	29117974	A03p61290.2_BraZ1	5700	-	192	845	845	1.0000000
A03	29119984	29122491	A03p61300.2_BraZ1	1848	-	1095	2459	2507	0.9808536
A03	29124483	29124690	A03p61310.2_BraZ1	20.7	-	231	207	207	1.0000000
A03	29128643	29133496	A03p61320.2_BraZ1	1338.46	+	3163	4586	4853	0.9449825
A03	29140517	29147421	A03p61330.2_BraZ1	569.318	+	2949	6224	6904	0.9015064
A03	29141394	29144948	A03p61340.2_BraZ1	1453.5	-	2083	3549	3554	0.9985932
A03	29148726	29149070	A03p61350.2_BraZ1	33.9	+	164	344	344	1.0000000
A03	29150729	29151051	A03p61360.2_BraZ1	228	+	384	322	322	1.0000000
A03	29152614	29152929	A03p61370.2_BraZ1	31.5	-	314	315	315	1.0000000
A03	29154172	29157234	A03p61380.2_BraZ1	2288.72	-	1132	2903	3062	0.9480731
A03	29158672	29160201	A03p61390.2_BraZ1	765.616	+	1738	1523	1529	0.9960759
A03	29160453	29172899	A03p61400.2_BraZ1	2894.62	-	5983	9730	12446	0.7817773
A03	29163537	29164874	A03p61410.2_BraZ1	574.737	+	362	1337	1337	1.0000000
A03	29167925	29168631	A03p61420.2_BraZ1	354	+	21	176	706	0.2492918
A03	29181497	29181614	A03p61430.2_BraZ1	11.7	-	167	117	117	1.0000000
A03	29181685	29184777	A03p61440.2_BraZ1	2080	-	1452	3006	3092	0.9721863
A03	29188033	29188498	A03p61450.2_BraZ1	46.5	-	83	447	465	0.9612903
A03	29189837	29192020	A03p61460.2_BraZ1	1632.96	+	888	2144	2183	0.9821347
A03	29195844	29200057	A03p61470.2_BraZ1	2958.38	-	3177	4213	4213	1.0000000
A03	29217341	29219645	A03p61480.2_BraZ1	500.35	+	1277	2293	2304	0.9952257
A03	29220354	29221345	A03p61490.2_BraZ1	574.398	+	1387	991	991	1.0000000
A03	29224056	29227967	A03p61500.2_BraZ1	1253.78	-	1891	3852	3911	0.9849144
A03	29228810	29229246	A03p61510.2_BraZ1	366	+	310	436	436	1.0000000
A03	29229407	29231220	A03p61520.2_BraZ1	859.143	-	757	1813	1813	1.0000000
A03	29235155	29244847	A03p61530.2_BraZ1	693.741	-	5009	8220	9692	0.8481222
A03	29245553	29247960	A03p61540.2_BraZ1	698.162	-	2014	2407	2407	1.0000000
A03	29250676	29250949	A03p61550.2_BraZ1	27.3	-	408	273	273	1.0000000
A03	29253091	29253296	A03p61560.2_BraZ1	51.6	-	549	205	205	1.0000000
A03	29253356	29254634	A03p61570.2_BraZ1	1008	-	1952	1278	1278	1.0000000
A03	29263364	29265143	A03p61580.2_BraZ1	356.25	+	742	1764	1779	0.9915683
A03	29265819	29266060	A03p61590.2_BraZ1	207	+	97	241	241	1.0000000
A03	29279815	29280720	A03p61600.2_BraZ1	252	+	422	905	905	1.0000000
A03	29286834	29288279	A03p61610.2_BraZ1	903.462	+	1080	1445	1445	1.0000000
A03	29290126	29291551	A03p61620.2_BraZ1	6949.5	+	479	1425	1425	1.0000000
A03	29300964	29302278	A03p61630.2_BraZ1	131.4	+	560	1314	1314	1.0000000
A03	29303400	29303888	A03p61640.2_BraZ1	303	-	4	398	488	0.8155738
A03	29317834	29329923	A03p61650.2_BraZ1	7148.53	+	4643	11109	12089	0.9189346
A03	29331547	29332253	A03p61660.2_BraZ1	36.9	+	330	706	706	1.0000000
A03	29332830	29334258	A03p61670.2_BraZ1	911.982	-	714	1428	1428	1.0000000
A03	29336634	29338325	A03p61680.2_BraZ1	571.851	-	1246	1691	1691	1.0000000
A03	29338629	29340432	A03p61690.2_BraZ1	180	-	723	1786	1803	0.9905713
A03	29342655	29344241	A03p61700.2_BraZ1	723.864	+	246	1483	1586	0.9350567
A03	29344568	29361732	A03p61710.2_BraZ1	1695.03	-	6659	15141	17164	0.8821371
A03	29357056	29359457	A03p61720.2_BraZ1	1235	-	962	1621	2401	0.6751354
A03	29362904	29369728	A03p61730.2_BraZ1	5319.75	+	900	3969	6824	0.5816237
A03	29370216	29371533	A03p61740.2_BraZ1	1230	-	382	1093	1317	0.8299165
A03	29374557	29384120	A03p61750.2_BraZ1	4187.08	+	6374	9537	9563	0.9972812
A03	29384700	29387829	A03p61760.2_BraZ1	1965.72	-	593	2765	3129	0.8836689
A03	29397791	29399714	A03p61770.2_BraZ1	697.068	+	1468	1923	1923	1.0000000
A03	29400079	29401179	A03p61780.2_BraZ1	469.366	+	881	1100	1100	1.0000000
A03	29402912	29403542	A03p61790.2_BraZ1	63	-	329	630	630	1.0000000
A03	29412330	29413181	A03p61800.2_BraZ1	777	+	214	697	851	0.8190364
A03	29423660	29426365	A03p61810.2_BraZ1	1092.41	+	1497	2364	2705	0.8739371
A03	29430205	29431350	A03p61820.2_BraZ1	3672	-	681	1029	1145	0.8986900
A03	29440699	29441074	A03p61830.2_BraZ1	37.5	+	184	375	375	1.0000000
A03	29443008	29444632	A03p61840.2_BraZ1	1040.45	+	900	1624	1624	1.0000000
A03	29446324	29446537	A03p61850.2_BraZ1	21.3	-	73	213	213	1.0000000
A03	29446661	29448122	A03p61860.2_BraZ1	204	+	992	1461	1461	1.0000000
A03	29449498	29451111	A03p61870.2_BraZ1	531.375	+	1415	1613	1613	1.0000000
A03	29451367	29451928	A03p61880.2_BraZ1	303	+	387	561	561	1.0000000
A03	29455973	29456318	A03p61890.2_BraZ1	324	+	159	345	345	1.0000000
A03	29457519	29458811	A03p61900.2_BraZ1	1131	+	1145	1292	1292	1.0000000
A03	29459086	29467181	A03p61910.2_BraZ1	641.778	-	3305	7329	8095	0.9053737
A03	29467021	29468744	A03p61920.2_BraZ1	369	+	2180	1723	1723	1.0000000
A03	29475537	29476083	A03p61930.2_BraZ1	54.6	-	427	546	546	1.0000000
A03	29479418	29482640	A03p61940.2_BraZ1	106671	+	495	2250	3222	0.6983240
A03	29484034	29485003	A03p61950.2_BraZ1	645	-	537	969	969	1.0000000
A03	29487107	29489409	A03p61960.2_BraZ1	49.5	-	596	2026	2302	0.8801042
A03	29490648	29499988	A03p61970.2_BraZ1	1542	+	8345	9191	9340	0.9840471
A03	29500732	29502373	A03p61980.2_BraZ1	853.714	+	1374	1641	1641	1.0000000
A03	29502755	29503679	A03p61990.2_BraZ1	497.375	-	867	924	924	1.0000000
A03	29509018	29510400	A03p62000.2_BraZ1	987	-	442	1380	1382	0.9985528
A03	29517872	29518487	A03p62010.2_BraZ1	288.811	+	1158	615	615	1.0000000
A03	29521752	29522216	A03p62020.2_BraZ1	381	+	11	254	464	0.5474138
A03	29522964	29527690	A03p62030.2_BraZ1	11238.8	-	136	1453	4726	0.3074481
A03	29528676	29537579	A03p62040.2_BraZ1	6517.07	+	4770	8527	8903	0.9577671
A03	29538181	29539157	A03p62050.2_BraZ1	511.364	+	850	976	976	1.0000000
A03	29539971	29542323	A03p62060.2_BraZ1	2050.42	-	1582	2352	2352	1.0000000
A03	29545147	29572305	A03p62070.2_BraZ1	1266.67	-	31742	26017	27158	0.9579866
A03	29556204	29556622	A03p62080.2_BraZ1	396	-	71	345	418	0.8253589
A03	29568432	29569520	A03p62090.2_BraZ1	503.719	+	637	1088	1088	1.0000000
A03	29574656	29574926	A03p62100.2_BraZ1	27	+	199	270	270	1.0000000
A03	29585291	29585786	A03p62110.2_BraZ1	49.5	+	32	346	495	0.6989899
A03	29586649	29587048	A03p62120.2_BraZ1	21.3	-	145	351	399	0.8796992
A03	29592653	29593267	A03p62130.2_BraZ1	285	-	849	614	614	1.0000000
A03	29593402	29593661	A03p62140.2_BraZ1	102	-	232	259	259	1.0000000
A03	29593661	29594544	A03p62150.2_BraZ1	624	+	459	883	883	1.0000000
A03	29597453	29599863	A03p62160.2_BraZ1	1074.56	-	2419	2410	2410	1.0000000
A03	29600549	29602959	A03p62170.2_BraZ1	1535.25	+	1045	2263	2410	0.9390041
A03	29608556	29609707	A03p62180.2_BraZ1	870.435	+	394	1143	1151	0.9930495
A03	29613759	29615069	A03p62190.2_BraZ1	894	+	255	1135	1310	0.8664122
A03	29618443	29619043	A03p62200.2_BraZ1	516	+	80	549	600	0.9150000
A03	29626093	29629390	A03p62210.2_BraZ1	329.7	+	1465	3288	3297	0.9972702
A03	29629671	29631474	A03p62220.2_BraZ1	871.186	-	1000	1803	1803	1.0000000
A03	29635344	29636571	A03p62230.2_BraZ1	576	+	364	1142	1227	0.9307253
A03	29636953	29637474	A03p62240.2_BraZ1	456	-	1016	521	521	1.0000000
A03	29639604	29642705	A03p62250.2_BraZ1	489.9	-	1054	2581	3101	0.8323122
A03	29644091	29644262	A03p62260.2_BraZ1	17.1	-	0	0	171	0.0000000
A03	29649281	29649717	A03p62270.2_BraZ1	318	+	6915	436	436	1.0000000
A03	29654160	29659126	A03p62280.2_BraZ1	2583.52	-	1993	4340	4966	0.8739428
A03	29667989	29672437	A03p62290.2_BraZ1	1782.38	+	1326	4109	4448	0.9237860
A03	29679698	29679854	A03p62300.2_BraZ1	15.6	+	380	156	156	1.0000000
A03	29680004	29680301	A03p62310.2_BraZ1	29.7	-	394	297	297	1.0000000
A03	29687441	29689786	A03p62320.2_BraZ1	1383	+	168	711	2345	0.3031983
A03	29690423	29692770	A03p62330.2_BraZ1	1275.98	-	2330	2299	2347	0.9795483
A03	29696834	29697932	A03p62340.2_BraZ1	723.13	-	1086	1098	1098	1.0000000
A03	29698341	29698791	A03p62350.2_BraZ1	168	+	282	450	450	1.0000000
A03	29699442	29702333	A03p62360.2_BraZ1	1252.24	-	1570	2820	2891	0.9754410
A03	29705405	29709432	A03p62370.2_BraZ1	2056	+	1828	3896	4027	0.9674696
A03	29712941	29713478	A03p62380.2_BraZ1	53.7	+	168	537	537	1.0000000
A03	29716443	29716752	A03p62390.2_BraZ1	30.9	-	180	309	309	1.0000000
A03	29718045	29719960	A03p62400.2_BraZ1	714.536	+	1158	1913	1915	0.9989556
A03	29727460	29728897	A03p62410.2_BraZ1	1089.43	+	1036	1437	1437	1.0000000
A03	29730099	29732295	A03p62420.2_BraZ1	219.6	-	1383	2196	2196	1.0000000
A03	29733082	29733539	A03p62430.2_BraZ1	360	-	152	392	457	0.8577681
A03	29740646	29744085	A03p62440.2_BraZ1	1955.42	+	970	3223	3439	0.9371911
A03	29746406	29746944	A03p62450.2_BraZ1	348.075	-	782	538	538	1.0000000
A03	29752973	29754826	A03p62460.2_BraZ1	825.6	-	430	1799	1853	0.9708581
A03	29761773	29762925	A03p62470.2_BraZ1	709.818	+	173	917	1152	0.7960069
A03	29768053	29768387	A03p62480.2_BraZ1	135	-	40	280	334	0.8383234
A03	29768684	29769016	A03p62490.2_BraZ1	159	-	120	332	332	1.0000000
A03	29773112	29774264	A03p62500.2_BraZ1	115.2	-	156	1067	1152	0.9262153
A03	29775826	29776984	A03p62510.2_BraZ1	871	+	1265	1156	1158	0.9982729
A03	29781536	29784035	A03p62520.2_BraZ1	249.9	+	963	2475	2499	0.9903961
A03	29784690	29786648	A03p62530.2_BraZ1	819.617	+	1097	1443	1958	0.7369765
A03	29789007	29790823	A03p62540.2_BraZ1	574	-	75	814	1816	0.4482379
A03	29793327	29795177	A03p62550.2_BraZ1	1135.01	+	398	1698	1850	0.9178379
A03	29796162	29800666	A03p62560.2_BraZ1	2926.33	-	1225	4349	4504	0.9655861
A03	29801543	29803147	A03p62570.2_BraZ1	2772	+	2293	1604	1604	1.0000000
A03	29806802	29807750	A03p62580.2_BraZ1	433.5	+	392	932	948	0.9831223
A03	29810532	29811256	A03p62590.2_BraZ1	258	+	366	724	724	1.0000000
A03	29811508	29812054	A03p62600.2_BraZ1	340.2	+	0	0	546	0.0000000
A03	29813026	29813266	A03p62610.2_BraZ1	24	-	4	84	240	0.3500000
A03	29831206	29832525	A03p62620.2_BraZ1	960.238	+	147	1033	1319	0.7831691
A03	29833956	29835872	A03p62630.2_BraZ1	594	+	24	820	1916	0.4279749
A03	29841637	29843559	A03p62640.2_BraZ1	1566	-	1073	1906	1922	0.9916753
A03	29844469	29846032	A03p62650.2_BraZ1	2919.75	-	20	409	1563	0.2616763
A03	29854422	29855014	A03p62660.2_BraZ1	318	+	69	543	592	0.9172297
A03	29856113	29856695	A03p62670.2_BraZ1	243	+	415	582	582	1.0000000
A03	29857432	29859768	A03p62680.2_BraZ1	1400	-	233	1540	2336	0.6592466
A03	29877126	29877830	A03p62690.2_BraZ1	426	+	122	554	704	0.7869318
A03	29878288	29879684	A03p62700.2_BraZ1	294	-	346	1036	1396	0.7421203
A03	29879879	29882623	A03p62710.2_BraZ1	1845.94	-	494	2530	2744	0.9220117
A03	29883652	29889893	A03p62720.2_BraZ1	2551.5	-	3055	5872	6241	0.9408749
A03	29890479	29894987	A03p62730.2_BraZ1	2549.69	+	3066	4475	4508	0.9926797
A03	29895599	29897043	A03p62740.2_BraZ1	912	-	654	1444	1444	1.0000000
A03	29898624	29898753	A03p62750.2_BraZ1	12.9	-	0	0	129	0.0000000
A03	29900031	29903837	A03p62760.2_BraZ1	1876.72	-	1141	2896	3806	0.7609038
A03	29914047	29914557	A03p62770.2_BraZ1	39.6	-	525	510	510	1.0000000
A03	29924074	29928319	A03p62780.2_BraZ1	2454.55	+	1013	3685	4245	0.8680801
A03	29928623	29928753	A03p62790.2_BraZ1	114	-	113	130	130	1.0000000
A03	29928857	29930272	A03p62800.2_BraZ1	588	-	1651	1415	1415	1.0000000
A03	29931375	29935463	A03p62810.2_BraZ1	1733.33	+	3060	4088	4088	1.0000000
A03	29937129	29939995	A03p62820.2_BraZ1	1344.55	+	2411	2866	2866	1.0000000
A03	29950592	29951300	A03p62830.2_BraZ1	70.8	+	413	708	708	1.0000000
A03	29964345	29964965	A03p62840.2_BraZ1	1453.5	+	651	620	620	1.0000000
A03	29967413	29968001	A03p62850.2_BraZ1	58.8	-	9	295	588	0.5017007
A03	29972187	29972673	A03p62860.2_BraZ1	48.6	+	140	396	486	0.8148148
A03	29973977	29974085	A03p62870.2_BraZ1	10.8	-	209	108	108	1.0000000
A03	29978380	29979652	A03p62880.2_BraZ1	942	+	518	1272	1272	1.0000000
A03	29981297	29982346	A03p62890.2_BraZ1	332.129	+	1059	1049	1049	1.0000000
A03	29982919	29989347	A03p62900.2_BraZ1	3950.53	-	3854	6425	6428	0.9995333
A03	29995768	29996710	A03p62910.2_BraZ1	526.105	+	785	942	942	1.0000000
A03	29997486	29998883	A03p62920.2_BraZ1	958.705	-	989	1397	1397	1.0000000
A03	30003715	30003907	A03p62930.2_BraZ1	19.2	-	167	192	192	1.0000000
A03	30004179	30005378	A03p62940.2_BraZ1	78.9	-	843	1127	1199	0.9399499
A03	30005759	30007359	A03p62950.2_BraZ1	1423.5	-	771	1556	1600	0.9725000
A03	30013083	30015706	A03p62960.2_BraZ1	634.184	+	1633	2424	2623	0.9241326
A03	30018206	30020376	A03p62970.2_BraZ1	11880	+	480	1836	2170	0.8460829
A03	30023471	30023897	A03p62980.2_BraZ1	42.6	-	174	409	426	0.9600939
A03	30027507	30035116	A03p62990.2_BraZ1	806.562	-	16011	7486	7609	0.9838349
A03	30038770	30039202	A03p63000.2_BraZ1	43.2	-	363	432	432	1.0000000
A03	30041125	30044210	A03p63010.2_BraZ1	1162.35	-	1991	2924	3085	0.9478120
A03	30053122	30055809	A03p63020.2_BraZ1	153.571	-	168	1758	2687	0.6542612
A03	30056975	30059191	A03p63030.2_BraZ1	1029	+	2269	2216	2216	1.0000000
A03	30059768	30062515	A03p63040.2_BraZ1	875.81	-	490	2337	2747	0.8507463
A03	30065928	30068170	A03p63050.2_BraZ1	1156.38	-	561	2242	2242	1.0000000
A03	30073807	30073969	A03p63060.2_BraZ1	16.2	-	656	162	162	1.0000000
A03	30076403	30076805	A03p63070.2_BraZ1	38.4	-	147	402	402	1.0000000
A03	30087568	30088992	A03p63080.2_BraZ1	118.5	+	520	1401	1424	0.9838483
A03	30089783	30092677	A03p63090.2_BraZ1	892.5	+	1376	2804	2894	0.9689012
A03	30094990	30128170	A03p63100.2_BraZ1	409.8	-	20505	32187	33180	0.9700723
A03	30115803	30116638	A03p63110.2_BraZ1	723	-	637	835	835	1.0000000
A03	30129950	30132405	A03p63120.2_BraZ1	1827	-	332	1808	2455	0.7364562
A03	30138254	30144815	A03p63130.2_BraZ1	2086.11	-	2942	6268	6561	0.9553422
A03	30145743	30146172	A03p63140.2_BraZ1	42.9	+	197	377	429	0.8787879
A03	30146650	30148009	A03p63150.2_BraZ1	1008	-	681	1333	1359	0.9808683
A03	30148537	30151912	A03p63160.2_BraZ1	863.291	+	2485	3252	3375	0.9635556
A03	30156278	30157578	A03p63170.2_BraZ1	1258	+	793	1300	1300	1.0000000
A03	30160029	30161638	A03p63180.2_BraZ1	857.6	+	540	1468	1609	0.9123679
A03	30162210	30164764	A03p63190.2_BraZ1	1786.46	-	1156	2433	2554	0.9526233
A03	30175314	30177742	A03p63200.2_BraZ1	1357.36	+	393	1400	2428	0.5766063
A03	30180072	30180907	A03p63210.2_BraZ1	726	-	98	751	835	0.8994012
A03	30182228	30183359	A03p63220.2_BraZ1	387	-	368	1078	1131	0.9531388
A03	30185332	30185699	A03p63230.2_BraZ1	1862	-	150	367	367	1.0000000
A03	30189963	30190893	A03p63240.2_BraZ1	93	+	583	930	930	1.0000000
A03	30192060	30193880	A03p63250.2_BraZ1	943	+	798	1801	1820	0.9895604
A03	30194058	30195453	A03p63260.2_BraZ1	139.5	-	472	1395	1395	1.0000000
A03	30195531	30196735	A03p63270.2_BraZ1	542.25	+	821	1204	1204	1.0000000
A03	30197273	30199550	A03p63280.2_BraZ1	1432.5	-	2063	2137	2277	0.9385156
A03	30200489	30202752	A03p63290.2_BraZ1	1384.63	-	1880	2227	2263	0.9840919
A03	30203705	30209976	A03p63300.2_BraZ1	621.25	-	1617	2798	6271	0.4461808
A03	30207662	30208621	A03p63310.2_BraZ1	279.375	-	0	0	959	0.0000000
A03	30210453	30211605	A03p63320.2_BraZ1	1104	+	1188	1152	1152	1.0000000
A03	30211557	30213178	A03p63330.2_BraZ1	155.7	+	384	840	1621	0.5181987
A03	30213861	30215186	A03p63340.2_BraZ1	303	-	62	617	1325	0.4656604
A03	30215477	30219394	A03p63350.2_BraZ1	1871.1	+	1448	3341	3917	0.8529487
A03	30220554	30225434	A03p63360.2_BraZ1	2250.03	+	2096	4069	4880	0.8338115
A03	30226024	30226455	A03p63370.2_BraZ1	225	-	265	431	431	1.0000000
A03	30228792	30230141	A03p63380.2_BraZ1	773.182	-	689	1188	1349	0.8806523
A03	30233531	30234023	A03p63390.2_BraZ1	49.2	+	10	282	492	0.5731707
A03	30245089	30245602	A03p63400.2_BraZ1	51.3	+	190	513	513	1.0000000
A03	30246024	30246516	A03p63410.2_BraZ1	49.2	-	6	151	492	0.3069106
A03	30253769	30255045	A03p63420.2_BraZ1	1137	-	682	1276	1276	1.0000000
A03	30262008	30263069	A03p63430.2_BraZ1	183.75	+	376	1060	1061	0.9990575
A03	30266662	30267151	A03p63440.2_BraZ1	48.9	+	451	489	489	1.0000000
A03	30272110	30272649	A03p63450.2_BraZ1	219	+	52	539	539	1.0000000
A03	30276538	30279386	A03p63460.2_BraZ1	1135.05	+	2378	2705	2848	0.9497893
A03	30283419	30284015	A03p63470.2_BraZ1	1032	-	680	596	596	1.0000000
A03	30287205	30296385	A03p63480.2_BraZ1	519	-	1348	3963	9180	0.4316993
A03	30302389	30302881	A03p63490.2_BraZ1	49.2	+	1	89	492	0.1808943
A03	30305363	30305631	A03p63500.2_BraZ1	183	-	29	99	268	0.3694030
A03	30307070	30307962	A03p63510.2_BraZ1	765	+	720	892	892	1.0000000
A03	30313582	30314863	A03p63520.2_BraZ1	128.1	+	477	1279	1281	0.9984387
A03	30315353	30317673	A03p63530.2_BraZ1	1024.83	-	1457	2320	2320	1.0000000
A03	30339138	30341972	A03p63540.2_BraZ1	24832.5	+	36	286	2834	0.1009174
A03	30349435	30350310	A03p63550.2_BraZ1	301.6	-	13	320	875	0.3657143
A03	30350819	30352416	A03p63560.2_BraZ1	739.8	+	148	1069	1597	0.6693801
A03	30354107	30354445	A03p63570.2_BraZ1	234	+	19	84	338	0.2485207
A03	30358608	30361855	A03p63580.2_BraZ1	907.5	+	6368	3247	3247	1.0000000
A03	30358869	30359688	A03p63590.2_BraZ1	61.8	+	2280	819	819	1.0000000
A03	30359652	30365695	A03p63600.2_BraZ1	39.6	+	8690	5697	6043	0.9427437
A03	30364128	30364562	A03p63610.2_BraZ1	6254	+	38	367	434	0.8456221
A03	30366619	30368767	A03p63620.2_BraZ1	1257	-	1254	2112	2148	0.9832402
A03	30368976	30370271	A03p63630.2_BraZ1	954.25	-	1483	1295	1295	1.0000000
A03	30371035	30372770	A03p63640.2_BraZ1	1224	-	636	1732	1735	0.9982709
A03	30374447	30376744	A03p63650.2_BraZ1	1376.17	-	2295	2297	2297	1.0000000
A03	30375237	30375970	A03p63660.2_BraZ1	339	-	748	733	733	1.0000000
A03	30396805	30399638	A03p63670.2_BraZ1	1210	+	41	700	2833	0.2470879
A03	30413713	30419307	A03p63680.2_BraZ1	490.875	+	3636	4770	5594	0.8526993
A03	30419724	30420162	A03p63690.2_BraZ1	163.5	+	65	438	438	1.0000000
A03	30422045	30422656	A03p63700.2_BraZ1	384	-	357	611	611	1.0000000
A03	30423180	30437181	A03p63710.2_BraZ1	13308.3	-	11065	9264	14001	0.6616670
A03	30438021	30438722	A03p63720.2_BraZ1	333	+	184	377	701	0.5378031
A03	30443201	30444899	A03p63730.2_BraZ1	1125	-	565	1434	1698	0.8445230
A03	30449491	30449614	A03p63740.2_BraZ1	11.4	+	142	123	123	1.0000000
A03	30457708	30458851	A03p63750.2_BraZ1	803.967	+	431	1061	1143	0.9282590
A03	30459386	30461721	A03p63760.2_BraZ1	886.9	-	1067	2271	2335	0.9725910
A03	30463158	30463431	A03p63770.2_BraZ1	27.3	+	23	101	273	0.3699634
A03	30474002	30475586	A03p63780.2_BraZ1	1017.1	+	142	1092	1584	0.6893939
A03	30481425	30483349	A03p63790.2_BraZ1	1094.8	+	21	749	1924	0.3892931
A03	30492511	30494382	A03p63800.2_BraZ1	1116	+	358	1371	1871	0.7327632
A03	30493588	30494962	A03p63810.2_BraZ1	23.7	+	107	1192	1374	0.8675400
A03	30497059	30497447	A03p63820.2_BraZ1	31.5	-	25	388	388	1.0000000
A03	30500410	30500752	A03p63830.2_BraZ1	34.2	+	123	342	342	1.0000000
A03	30501625	30509901	A03p63840.2_BraZ1	242.4	-	40488	8054	8276	0.9731755
A03	30512243	30513167	A03p63850.2_BraZ1	675	-	55	768	924	0.8311688
A03	30515795	30515942	A03p63860.2_BraZ1	14.7	+	25	140	147	0.9523810
A03	30519213	30520380	A03p63870.2_BraZ1	92.1	-	672	1167	1167	1.0000000
A03	30520805	30523303	A03p63880.2_BraZ1	1776.55	+	750	2171	2498	0.8690953
A03	30524295	30525057	A03p63890.2_BraZ1	76.2	-	85	627	762	0.8228347
A03	30525263	30528023	A03p63900.2_BraZ1	1558.71	+	1146	2704	2760	0.9797102
A03	30529918	30533607	A03p63910.2_BraZ1	528	+	1993	3627	3689	0.9831933
A03	30538765	30539648	A03p63920.2_BraZ1	307.125	+	0	0	883	0.0000000
A03	30542274	30543157	A03p63930.2_BraZ1	228.75	+	148	165	883	0.1868630
A03	30549888	30552005	A03p63940.2_BraZ1	19383	-	13	477	2117	0.2253188
A03	30559884	30564956	A03p63950.2_BraZ1	1133.92	-	503	2443	5072	0.4816640
A03	30569757	30570640	A03p63960.2_BraZ1	307.125	+	0	0	883	0.0000000
A03	30573122	30573823	A03p63970.2_BraZ1	276	-	266	357	701	0.5092725
A03	30584663	30585151	A03p63980.2_BraZ1	207	-	19	250	488	0.5122951
A03	30585654	30586839	A03p63990.2_BraZ1	653.594	+	572	1180	1185	0.9957806
A03	30589176	30591176	A03p64000.2_BraZ1	987.516	+	241	1624	2000	0.8120000
A03	30594147	30594282	A03p64010.2_BraZ1	13.5	-	320	135	135	1.0000000
A03	30601185	30601383	A03p64020.2_BraZ1	19.8	+	5	27	198	0.1363636
A03	30606119	30608559	A03p64030.2_BraZ1	241.2	-	1460	1305	2440	0.5348361
A03	30619423	30620605	A03p64040.2_BraZ1	118.2	+	38	144	1182	0.1218274
A03	30621575	30622112	A03p64050.2_BraZ1	53.7	+	484	537	537	1.0000000
A03	30625401	30626556	A03p64060.2_BraZ1	656.636	-	990	1155	1155	1.0000000
A03	30627693	30628389	A03p64070.2_BraZ1	69.6	+	217	696	696	1.0000000
A03	30633731	30634803	A03p64080.2_BraZ1	813	-	548	1053	1072	0.9822761
A03	30635475	30636102	A03p64090.2_BraZ1	432	-	252	581	627	0.9266348
A03	30637843	30638065	A03p64100.2_BraZ1	22.2	+	138	222	222	1.0000000
A03	30638218	30639657	A03p64110.2_BraZ1	681.5	-	1009	1439	1439	1.0000000
A03	30642440	30643343	A03p64120.2_BraZ1	76.0714	+	621	869	903	0.9623477
A03	30643745	30646030	A03p64130.2_BraZ1	732.375	+	1444	2285	2285	1.0000000
A03	30647278	30648470	A03p64140.2_BraZ1	845.625	+	282	963	1192	0.8078859
A03	30649197	30651052	A03p64150.2_BraZ1	738.689	-	504	1695	1855	0.9137467
A03	30651343	30659347	A03p64160.2_BraZ1	1192.5	+	1639	5347	8004	0.6680410
A03	30661417	30662910	A03p64170.2_BraZ1	601.99	+	1745	1493	1493	1.0000000
A03	30663881	30665894	A03p64180.2_BraZ1	538.829	+	1347	2013	2013	1.0000000
A03	30666817	30668152	A03p64190.2_BraZ1	1073.45	+	537	1316	1335	0.9857678
A03	30677515	30678703	A03p64200.2_BraZ1	951.923	-	231	898	1188	0.7558923
A03	30681828	30682353	A03p64210.2_BraZ1	303.333	-	9	246	525	0.4685714
A03	30688322	30691007	A03p64220.2_BraZ1	1217.74	+	1786	2598	2685	0.9675978
A03	30691563	30692869	A03p64230.2_BraZ1	739.304	-	596	1306	1306	1.0000000
A03	30697991	30698350	A03p64240.2_BraZ1	228	+	1	71	359	0.1977716
A03	30700063	30700422	A03p64250.2_BraZ1	228	+	2	18	359	0.0501393
A03	30701999	30702386	A03p64260.2_BraZ1	273	+	96	370	387	0.9560723
A03	30706791	30707356	A03p64270.2_BraZ1	273	-	189	548	565	0.9699115
A03	30727616	30728522	A03p64280.2_BraZ1	34.2	-	2169	906	906	1.0000000
A03	30728444	30730375	A03p64290.2_BraZ1	91.2	-	217	1751	1931	0.9067841
A03	30730086	30732850	A03p64300.2_BraZ1	156.9	-	1940	2617	2764	0.9468162
A03	30733354	30735202	A03p64310.2_BraZ1	76.2	-	2106	1739	1848	0.9410173
A03	30736424	30741308	A03p64320.2_BraZ1	98.4	-	2613	3749	4884	0.7676085
A03	30741713	30742744	A03p64330.2_BraZ1	250	+	235	502	1031	0.4869059
A03	30745071	30746232	A03p64340.2_BraZ1	116.1	+	640	1141	1161	0.9827735
A03	30750852	30751986	A03p64350.2_BraZ1	207	+	3049	1134	1134	1.0000000
A03	30753216	30754302	A03p64360.2_BraZ1	108.6	+	2	1	1086	0.0009208
A03	30762239	30763956	A03p64370.2_BraZ1	496.6	-	167	529	1717	0.3080955
A03	30769401	30771999	A03p64380.2_BraZ1	1797	-	760	2480	2598	0.9545804
A03	30773338	30776418	A03p64390.2_BraZ1	687.854	-	2509	3055	3080	0.9918831
A03	30778749	30780613	A03p64400.2_BraZ1	1204.41	-	367	1461	1864	0.7837983
A03	30783061	30785863	A03p64410.2_BraZ1	1321.12	+	3542	2802	2802	1.0000000
A03	30791784	30793251	A03p64420.2_BraZ1	144.9	+	1235	1467	1467	1.0000000
A03	30793745	30802043	A03p64430.2_BraZ1	81	-	3246	6777	8298	0.8167028
A03	30794595	30796127	A03p64440.2_BraZ1	240	+	1514	1526	1532	0.9960836
A03	30819673	30821835	A03p64450.2_BraZ1	649.091	+	1844	2162	2162	1.0000000
A03	30823358	30823815	A03p64460.2_BraZ1	318	-	117	436	457	0.9540482
A03	30825704	30826664	A03p64470.2_BraZ1	4899	+	1296	960	960	1.0000000
A03	30831590	30834563	A03p64480.2_BraZ1	1137	+	575	1911	2973	0.6427851
A03	30832814	30833120	A03p64490.2_BraZ1	30.6	+	11	200	306	0.6535948
A03	30836628	30838098	A03p64500.2_BraZ1	147	+	611	1470	1470	1.0000000
A03	30839628	30839835	A03p64510.2_BraZ1	20.7	-	17	205	207	0.9903381
A03	30840088	30840404	A03p64520.2_BraZ1	108	-	4	135	316	0.4272152
A03	30842228	30842954	A03p64530.2_BraZ1	72.6	-	367	683	726	0.9407713
A03	30843889	30845197	A03p64540.2_BraZ1	56.4	-	271	1220	1308	0.9327217
A03	30846115	30848649	A03p64550.2_BraZ1	588	+	3404	2534	2534	1.0000000
A03	30849794	30850059	A03p64560.2_BraZ1	162	-	112	265	265	1.0000000
A03	30854382	30856263	A03p64570.2_BraZ1	998.486	+	1429	1854	1881	0.9856459
A03	30857760	30861454	A03p64580.2_BraZ1	915	+	1043	3446	3694	0.9328641
A03	30863344	30864163	A03p64590.2_BraZ1	81.9	+	482	819	819	1.0000000
A03	30864500	30865597	A03p64600.2_BraZ1	326.229	-	1235	1097	1097	1.0000000
A03	30866836	30872977	A03p64610.2_BraZ1	1907.18	-	2803	5884	6141	0.9581501
A03	30874154	30874909	A03p64620.2_BraZ1	405	-	566	755	755	1.0000000
A03	30883392	30884061	A03p64630.2_BraZ1	66.9	+	723	669	669	1.0000000
A03	30890109	30892690	A03p64640.2_BraZ1	1181.2	-	1837	2581	2581	1.0000000
A03	30894365	30896031	A03p64650.2_BraZ1	387	-	518	1640	1666	0.9843938
A03	30897732	30900448	A03p64660.2_BraZ1	1294.12	+	2124	2716	2716	1.0000000
A03	30903669	30903979	A03p64670.2_BraZ1	23.4	+	165	310	310	1.0000000
A03	30908827	30909289	A03p64680.2_BraZ1	46.2	+	15	131	462	0.2835498
A03	30924202	30926774	A03p64690.2_BraZ1	3209.14	+	2230	2572	2572	1.0000000
A03	30940987	30943223	A03p64700.2_BraZ1	921	-	157	1266	2236	0.5661896
A03	30943223	30944283	A03p64710.2_BraZ1	500.5	-	55	460	1060	0.4339623
A03	30948848	30951603	A03p64720.2_BraZ1	1172.31	-	218	1679	2755	0.6094374
A03	30954469	30955134	A03p64730.2_BraZ1	249	+	27	316	665	0.4751880
A03	30955644	30961489	A03p64740.2_BraZ1	1314.11	-	3377	5499	5845	0.9408041
A03	30961489	30972114	A03p64750.2_BraZ1	263.795	+	4442	9908	10625	0.9325176
A03	30972088	30975043	A03p64760.2_BraZ1	231.25	+	357	2326	2955	0.7871404
A03	30976238	30977441	A03p64770.2_BraZ1	773.213	+	1015	1203	1203	1.0000000
A03	30978540	30979949	A03p64780.2_BraZ1	1055.25	+	272	1406	1409	0.9978708
A03	30985382	30986257	A03p64790.2_BraZ1	801	+	304	803	875	0.9177143
A03	30987599	30988738	A03p64800.2_BraZ1	355.283	+	1228	1139	1139	1.0000000
A03	30993613	30995680	A03p64810.2_BraZ1	206.7	-	724	2011	2067	0.9729076
A03	30999780	31000041	A03p64820.2_BraZ1	26.1	-	689	261	261	1.0000000
A03	31010504	31013299	A03p64830.2_BraZ1	3826.55	-	3318	2795	2795	1.0000000
A03	31013651	31015049	A03p64840.2_BraZ1	510	-	2348	1398	1398	1.0000000
A03	31020340	31020763	A03p64850.2_BraZ1	42.3	-	116	423	423	1.0000000
A03	31031252	31031570	A03p64860.2_BraZ1	31.8	+	25	224	318	0.7044025
A03	31035337	31036620	A03p64870.2_BraZ1	49.8	+	88	1067	1283	0.8316446
A03	31052846	31054128	A03p64880.2_BraZ1	316.875	-	2760	1282	1282	1.0000000
A03	31055138	31059882	A03p64890.2_BraZ1	465	+	4480	4392	4744	0.9258010
A03	31061490	31062283	A03p64900.2_BraZ1	303	-	43	238	793	0.3001261
A03	31066689	31068235	A03p64910.2_BraZ1	34191	+	364	1294	1546	0.8369987
A03	31068510	31068999	A03p64920.2_BraZ1	393	-	574	489	489	1.0000000
A03	31071268	31071872	A03p64930.2_BraZ1	414	+	35	489	604	0.8096027
A03	31074477	31076823	A03p64940.2_BraZ1	234.6	-	525	2149	2346	0.9160273
A03	31077866	31078691	A03p64950.2_BraZ1	609	-	145	823	825	0.9975758
A03	31081449	31082331	A03p64960.2_BraZ1	816	-	112	875	882	0.9920635
A03	31085109	31086971	A03p64970.2_BraZ1	866.023	-	782	1425	1862	0.7653061
A03	31087618	31091643	A03p64980.2_BraZ1	2302	-	740	3093	4025	0.7684472
A03	31093378	31093621	A03p64990.2_BraZ1	24.3	-	161	243	243	1.0000000
A03	31094207	31096463	A03p65000.2_BraZ1	312	-	2635	2256	2256	1.0000000
A03	31098974	31101103	A03p65010.2_BraZ1	375.778	+	2104	2129	2129	1.0000000
A03	31114731	31114956	A03p65020.2_BraZ1	22.5	-	86	225	225	1.0000000
A03	31118758	31119549	A03p65030.2_BraZ1	708	+	685	791	791	1.0000000
A03	31121005	31122056	A03p65040.2_BraZ1	1315.8	-	1531	1051	1051	1.0000000
A03	31125393	31127544	A03p65050.2_BraZ1	1673.08	-	484	1929	2151	0.8967922
A03	31132852	31133353	A03p65060.2_BraZ1	339	-	52	300	501	0.5988024
A03	31136480	31137861	A03p65070.2_BraZ1	84.6	+	832	1346	1381	0.9746560
A03	31138591	31139824	A03p65080.2_BraZ1	123.3	-	502	1233	1233	1.0000000
A03	31140900	31141296	A03p65090.2_BraZ1	39.6	+	361	396	396	1.0000000
A03	31143143	31146940	A03p65100.2_BraZ1	9909	-	2340	3758	3797	0.9897287
A03	31148122	31151674	A03p65110.2_BraZ1	1104	-	5597	3532	3552	0.9943694
A03	31163284	31164775	A03p65120.2_BraZ1	1798.67	+	891	1380	1491	0.9255533
A03	31165134	31166946	A03p65130.2_BraZ1	1304.42	-	199	1439	1812	0.7941501
A03	31179223	31179388	A03p65140.2_BraZ1	16.5	+	0	0	165	0.0000000
A03	31185739	31185904	A03p65150.2_BraZ1	16.5	+	0	0	165	0.0000000
A03	31186921	31188316	A03p65160.2_BraZ1	813	+	647	1374	1395	0.9849463
A03	31192167	31192862	A03p65170.2_BraZ1	225	-	0	0	695	0.0000000
A03	31193555	31203749	A03p65180.2_BraZ1	429.562	+	248	5372	10194	0.5269766
A03	31205363	31206736	A03p65190.2_BraZ1	279	+	1102	1249	1373	0.9096868
A03	31206210	31206618	A03p65200.2_BraZ1	40.8	-	439	408	408	1.0000000
A03	31216930	31219885	A03p65210.2_BraZ1	2373.29	-	1163	2927	2955	0.9905245
A03	31225708	31226590	A03p65220.2_BraZ1	88.2	-	169	713	882	0.8083900
A03	31228804	31229576	A03p65230.2_BraZ1	297.273	-	41	770	772	0.9974093
A03	31231814	31234345	A03p65240.2_BraZ1	637.5	+	1899	2531	2531	1.0000000
A03	31234531	31235736	A03p65250.2_BraZ1	256.5	-	971	1202	1205	0.9975104
A03	31236090	31257508	A03p65260.2_BraZ1	1382.23	+	9567	16897	21418	0.7889159
A03	31260058	31261985	A03p65270.2_BraZ1	982.248	+	1736	1927	1927	1.0000000
A03	31262207	31263830	A03p65280.2_BraZ1	5110	+	608	1566	1623	0.9648799
A03	31268859	31269193	A03p65290.2_BraZ1	135	-	178	334	334	1.0000000
A03	31269474	31269680	A03p65300.2_BraZ1	144	-	57	206	206	1.0000000
A03	31272934	31275052	A03p65310.2_BraZ1	1638	+	1451	2118	2118	1.0000000
A03	31279399	31279963	A03p65320.2_BraZ1	56.4	+	177	536	564	0.9503546
A03	31282579	31283152	A03p65330.2_BraZ1	57.3	-	166	572	573	0.9982548
A03	31292545	31293016	A03p65340.2_BraZ1	47.1	+	122	471	471	1.0000000
A03	31294294	31294765	A03p65350.2_BraZ1	47.1	+	123	389	471	0.8259023
A03	31295525	31297104	A03p65360.2_BraZ1	23205	+	767	1579	1579	1.0000000
A03	31298725	31299559	A03p65370.2_BraZ1	83.4	-	882	834	834	1.0000000
A03	31302221	31308123	A03p65380.2_BraZ1	2786.87	+	4301	5902	5902	1.0000000
A03	31308360	31309354	A03p65390.2_BraZ1	553.466	-	1436	994	994	1.0000000
A03	31310133	31311200	A03p65400.2_BraZ1	1373.18	-	569	1012	1067	0.9484536
A03	31319856	31320230	A03p65410.2_BraZ1	30.3	-	216	374	374	1.0000000
A03	31329967	31335372	A03p65420.2_BraZ1	2879.89	+	3308	5334	5405	0.9868640
A03	31335928	31337750	A03p65430.2_BraZ1	540.27	-	1755	1822	1822	1.0000000
A03	31341726	31343993	A03p65440.2_BraZ1	1260.44	+	890	2073	2267	0.9144244
A03	31344742	31346930	A03p65450.2_BraZ1	895.304	+	1093	2140	2188	0.9780622
A03	31349793	31351504	A03p65460.2_BraZ1	124.2	+	1337	1711	1711	1.0000000
A03	31351329	31361089	A03p65470.2_BraZ1	269.4	+	3288	5003	9760	0.5126024
A03	31357674	31358525	A03p65480.2_BraZ1	421.667	-	4	273	851	0.3207991
A03	31361585	31364054	A03p65490.2_BraZ1	165.3	+	620	2309	2469	0.9351965
A03	31374268	31375082	A03p65500.2_BraZ1	1209	-	159	691	814	0.8488944
A03	31375923	31377190	A03p65510.2_BraZ1	726	-	224	1059	1267	0.8358327
A03	31391183	31393185	A03p65520.2_BraZ1	1119.25	+	983	1950	2002	0.9740260
A03	31395357	31395549	A03p65530.2_BraZ1	19.2	+	25	176	192	0.9166667
A03	31398082	31398928	A03p65540.2_BraZ1	84.6	+	653	846	846	1.0000000
A03	31401080	31401461	A03p65550.2_BraZ1	38.1	-	66	145	381	0.3805774
A03	31407399	31413313	A03p65560.2_BraZ1	1099.78	+	2499	4535	5914	0.7668245
A03	31417061	31417401	A03p65570.2_BraZ1	135	+	9	331	340	0.9735294
A03	31420480	31421780	A03p65580.2_BraZ1	499.714	+	468	1244	1300	0.9569231
A03	31423955	31424459	A03p65590.2_BraZ1	36	+	73	311	504	0.6170635
A03	31424446	31427178	A03p65600.2_BraZ1	1987.2	+	1078	2131	2732	0.7800146
A03	31427602	31428008	A03p65610.2_BraZ1	339	-	648	406	406	1.0000000
A03	31430463	31431021	A03p65620.2_BraZ1	216	-	282	558	558	1.0000000
A03	31431604	31432005	A03p65630.2_BraZ1	246	-	363	401	401	1.0000000
A03	31440840	31441564	A03p65640.2_BraZ1	276	+	400	662	724	0.9143646
A03	31447553	31451128	A03p65650.2_BraZ1	2223.33	-	2201	3482	3575	0.9739860
A03	31454634	31455786	A03p65660.2_BraZ1	630	+	730	1152	1152	1.0000000
A03	31471332	31472253	A03p65670.2_BraZ1	714	+	728	921	921	1.0000000
A03	31472909	31474080	A03p65680.2_BraZ1	657.2	-	1465	1171	1171	1.0000000
A03	31476938	31479605	A03p65690.2_BraZ1	981	+	2532	2667	2667	1.0000000
A03	31483302	31484331	A03p65700.2_BraZ1	780	+	850	1029	1029	1.0000000
A03	31485580	31486373	A03p65710.2_BraZ1	231.848	-	932	793	793	1.0000000
A03	31487063	31489430	A03p65720.2_BraZ1	1241.52	-	1446	2367	2367	1.0000000
A03	31489505	31490666	A03p65730.2_BraZ1	201	-	1173	1161	1161	1.0000000
A03	31493113	31494274	A03p65740.2_BraZ1	1700	+	362	1161	1161	1.0000000
A03	31495182	31496675	A03p65750.2_BraZ1	1095	+	1154	1416	1493	0.9484260
A03	31497082	31505486	A03p65760.2_BraZ1	5540.4	-	3029	7060	8404	0.8400761
A03	31507409	31508180	A03p65770.2_BraZ1	77.1	-	289	771	771	1.0000000
A03	31513548	31515525	A03p65780.2_BraZ1	197.7	-	278	1800	1977	0.9104704
A03	31515684	31515789	A03p65790.2_BraZ1	10.5	+	92	105	105	1.0000000
A03	31531963	31532449	A03p65800.2_BraZ1	48.6	-	93	486	486	1.0000000
A03	31535502	31536599	A03p65810.2_BraZ1	1697.4	+	949	1097	1097	1.0000000
A03	31537018	31539546	A03p65820.2_BraZ1	1407.49	-	3132	2528	2528	1.0000000
A03	31543952	31544252	A03p65830.2_BraZ1	30	+	36	177	300	0.5900000
A03	31552520	31553831	A03p65840.2_BraZ1	84	+	602	1311	1311	1.0000000
A03	31554538	31554727	A03p65850.2_BraZ1	18.9	+	335	189	189	1.0000000
A03	31559222	31561520	A03p65860.2_BraZ1	1168.65	-	208	1527	2298	0.6644909
A03	31566710	31569521	A03p65870.2_BraZ1	1272.11	+	1383	2804	2811	0.9975098
A03	31583583	31587877	A03p65880.2_BraZ1	1518.95	-	1098	3126	4294	0.7279925
A03	31597010	31597187	A03p65890.2_BraZ1	17.7	+	39	177	177	1.0000000
A03	31598804	31599399	A03p65900.2_BraZ1	391.125	+	424	595	595	1.0000000
A03	31599543	31599858	A03p65910.2_BraZ1	240	+	230	315	315	1.0000000
A03	31600402	31600898	A03p65920.2_BraZ1	384	+	250	399	496	0.8044355
A03	31601629	31602644	A03p65930.2_BraZ1	556.818	+	657	1004	1015	0.9891626
A03	31620687	31621131	A03p65940.2_BraZ1	44.4	-	34	349	444	0.7860360
A03	31622565	31622802	A03p65950.2_BraZ1	23.7	-	8	151	237	0.6371308
A03	31626403	31628760	A03p65960.2_BraZ1	1370.85	+	982	2357	2357	1.0000000
A03	31631301	31632642	A03p65970.2_BraZ1	942	-	248	976	1341	0.7278151
A03	31638055	31638166	A03p65980.2_BraZ1	11.1	-	29	111	111	1.0000000
A03	31638219	31654981	A03p65990.2_BraZ1	1471.43	-	8490	16163	16762	0.9642644
A03	31638349	31638560	A03p66000.2_BraZ1	132	-	141	211	211	1.0000000
A03	31657249	31659947	A03p66010.2_BraZ1	439.977	-	2686	2698	2698	1.0000000
A03	31665463	31665798	A03p66020.2_BraZ1	1344	+	429	335	335	1.0000000
A03	31665816	31666050	A03p66030.2_BraZ1	23.4	+	128	234	234	1.0000000
A03	31669188	31673464	A03p66040.2_BraZ1	1368.11	-	471	2845	4276	0.6653414
A03	31677593	31682487	A03p66050.2_BraZ1	1808.2	+	3834	4894	4894	1.0000000
A03	31683829	31684345	A03p66060.2_BraZ1	51.6	-	238	516	516	1.0000000
A03	31685107	31686358	A03p66070.2_BraZ1	929.6	-	424	1251	1251	1.0000000
A03	31687476	31690207	A03p66080.2_BraZ1	1284.32	-	1769	2731	2731	1.0000000
A03	31691163	31692844	A03p66090.2_BraZ1	978.091	+	380	1222	1681	0.7269483
A03	31693307	31693676	A03p66100.2_BraZ1	36.9	-	110	243	369	0.6585366
A03	31695922	31697177	A03p66110.2_BraZ1	739.84	+	878	1180	1255	0.9402391
A03	31697405	31699057	A03p66120.2_BraZ1	1211.6	-	527	1550	1652	0.9382567
A03	31701751	31702532	A03p66130.2_BraZ1	570	-	6	392	781	0.5019206
A03	31711910	31716091	A03p66140.2_BraZ1	2327.62	-	2016	4011	4181	0.9593399
A03	31724071	31725280	A03p66150.2_BraZ1	870	-	138	750	1209	0.6203474
A03	31729659	31731509	A03p66160.2_BraZ1	1783.36	-	796	1385	1850	0.7486486
A03	31731736	31734579	A03p66170.2_BraZ1	318.75	-	1774	2577	2843	0.9064369
A03	31732795	31734703	A03p66180.2_BraZ1	730.922	-	636	1642	1908	0.8605870
A03	31737479	31737732	A03p66190.2_BraZ1	234	+	380	253	253	1.0000000
A03	31741096	31743723	A03p66200.2_BraZ1	653.143	-	1702	2125	2627	0.8089075
A03	31748282	31748477	A03p66210.2_BraZ1	19.5	-	27	188	195	0.9641026
A03	31749720	31749912	A03p66220.2_BraZ1	19.2	+	261	192	192	1.0000000
A03	31750086	31750554	A03p66230.2_BraZ1	580.5	+	300	468	468	1.0000000
A03	31750728	31751276	A03p66240.2_BraZ1	487.5	+	519	548	548	1.0000000
A03	31764878	31765101	A03p66250.2_BraZ1	19.8	-	25	86	223	0.3856502
A03	31766021	31768083	A03p66260.2_BraZ1	3150	+	1974	2062	2062	1.0000000
A03	31769797	31770225	A03p66270.2_BraZ1	393	+	32	394	428	0.9205608
A03	31770827	31771591	A03p66280.2_BraZ1	684	-	270	746	764	0.9764398
A03	31773394	31774012	A03p66290.2_BraZ1	498	-	272	601	618	0.9724919
A03	31777272	31780038	A03p66300.2_BraZ1	418.385	+	3925	2766	2766	1.0000000
A03	31780499	31786111	A03p66310.2_BraZ1	1858.33	-	4028	5612	5612	1.0000000
A03	31787256	31787523	A03p66320.2_BraZ1	26.7	-	131	267	267	1.0000000
A03	31791730	31792933	A03p66330.2_BraZ1	120.3	+	847	1203	1203	1.0000000
A03	31794692	31796916	A03p66340.2_BraZ1	361.5	+	565	1811	2224	0.8142986
A03	31798351	31798702	A03p66350.2_BraZ1	35.1	-	26	343	351	0.9772080
A03	31802890	31805180	A03p66360.2_BraZ1	1125.75	+	1205	2284	2290	0.9973799
A03	31806026	31806989	A03p66370.2_BraZ1	300	+	739	963	963	1.0000000
A03	31818188	31821564	A03p66380.2_BraZ1	654	-	1828	3195	3376	0.9463863
A03	31836018	31837615	A03p66390.2_BraZ1	22344	+	789	1575	1597	0.9862242
A03	31838652	31839948	A03p66400.2_BraZ1	930	-	480	1218	1296	0.9398148
A03	31840634	31840871	A03p66410.2_BraZ1	23.7	+	60	221	237	0.9324895
A03	31843174	31843787	A03p66420.2_BraZ1	39.3	+	69	236	613	0.3849919
A03	31844551	31844836	A03p66430.2_BraZ1	28.5	-	8	131	285	0.4596491
A03	31851469	31851778	A03p66440.2_BraZ1	30.9	+	239	309	309	1.0000000
A03	31855916	31857457	A03p66450.2_BraZ1	1113	+	393	1495	1541	0.9701493
A03	31862314	31862422	A03p66460.2_BraZ1	10.8	+	0	0	108	0.0000000
A03	31865248	31865356	A03p66470.2_BraZ1	10.8	+	40	106	108	0.9814815
A03	31867394	31867859	A03p66480.2_BraZ1	46.5	+	204	465	465	1.0000000
A03	31872762	31877436	A03p66490.2_BraZ1	906	+	2903	4607	4674	0.9856654
A03	31893745	31894261	A03p66500.2_BraZ1	51.6	-	124	492	516	0.9534883
A03	31895986	31897295	A03p66510.2_BraZ1	960	-	600	1299	1309	0.9923606
A03	31901216	31903169	A03p66520.2_BraZ1	494.455	+	1689	1953	1953	1.0000000
A03	31903855	31906247	A03p66530.2_BraZ1	327	+	3652	2392	2392	1.0000000
A03	31913793	31916038	A03p66540.2_BraZ1	1339.56	-	1842	2243	2245	0.9991091
A03	31916005	31938070	A03p66550.2_BraZ1	609.171	-	6166	12839	22065	0.5818717
A03	31916532	31933945	A03p66560.2_BraZ1	357	-	2284	8187	17413	0.4701660
A03	31930400	31930922	A03p66570.2_BraZ1	52.2	+	317	522	522	1.0000000
A03	31931697	31932173	A03p66580.2_BraZ1	402	+	518	476	476	1.0000000
A03	31935108	31935801	A03p66590.2_BraZ1	69	+	450	693	693	1.0000000
A03	31938791	31942318	A03p66600.2_BraZ1	645	-	4164	3527	3527	1.0000000
A03	31945113	31947368	A03p66610.2_BraZ1	1611.11	+	831	1935	2255	0.8580931
A03	31948934	31949297	A03p66620.2_BraZ1	176	+	442	363	363	1.0000000
A03	31952849	31953050	A03p66630.2_BraZ1	20.1	-	190	201	201	1.0000000
A03	31961017	31963645	A03p66640.2_BraZ1	401.333	+	1561	2616	2628	0.9954338
A03	31964871	31975183	A03p66650.2_BraZ1	1032.27	+	3783	6099	10312	0.5914469
A03	31982872	31985033	A03p66660.2_BraZ1	1182.68	+	879	1687	2161	0.7806571
A03	31986936	31988036	A03p66670.2_BraZ1	547.059	-	38	788	1100	0.7163636
A03	31988581	31989593	A03p66680.2_BraZ1	801	+	1482	1012	1012	1.0000000
A03	31996497	31997404	A03p66690.2_BraZ1	816	-	432	892	907	0.9834620
A03	32000166	32001566	A03p66700.2_BraZ1	1139.7	+	598	1398	1400	0.9985715
A03	32001767	32031647	A03p66710.2_BraZ1	984.533	-	33892	26240	29880	0.8781794
A03	32007847	32008984	A03p66720.2_BraZ1	259.636	-	181	891	1137	0.7836412
A03	32009102	32009938	A03p66730.2_BraZ1	605.515	-	2	185	836	0.2212919
A03	32032278	32035166	A03p66740.2_BraZ1	1304.92	+	645	2247	2888	0.7780471
A03	32039762	32040323	A03p66750.2_BraZ1	56.1	+	27	344	561	0.6131907
A03	32046802	32048805	A03p66760.2_BraZ1	993	+	834	2003	2003	1.0000000
A03	32048805	32049790	A03p66770.2_BraZ1	273	+	142	899	985	0.9126903
A03	32052879	32055232	A03p66780.2_BraZ1	1178.49	+	285	1579	2353	0.6710582
A03	32057180	32058694	A03p66790.2_BraZ1	1101	-	450	1468	1514	0.9696169
A03	32059149	32063428	A03p66800.2_BraZ1	1155	-	21181	4257	4279	0.9948586
A03	32067340	32067971	A03p66810.2_BraZ1	318	+	423	631	631	1.0000000
A03	32068835	32071667	A03p66820.2_BraZ1	1548.25	-	1859	2832	2832	1.0000000
A03	32085144	32087306	A03p66830.2_BraZ1	1140.23	-	758	1763	2162	0.8154486
A03	32095529	32097589	A03p66840.2_BraZ1	644.694	+	1783	2060	2060	1.0000000
A03	32098421	32099000	A03p66850.2_BraZ1	57.9	-	333	562	579	0.9706391
A03	32104706	32105424	A03p66860.2_BraZ1	443.077	-	271	718	718	1.0000000
A03	32121063	32121324	A03p66870.2_BraZ1	26.1	-	120	261	261	1.0000000
A03	32121355	32121895	A03p66880.2_BraZ1	378	-	114	518	540	0.9592593
A03	32123512	32125982	A03p66890.2_BraZ1	101.684	+	1655	2421	2470	0.9801620
A03	32126382	32126653	A03p66900.2_BraZ1	216	-	194	271	271	1.0000000
A03	32126866	32129647	A03p66910.2_BraZ1	20.7	+	1689	2781	2781	1.0000000
A03	32127288	32127516	A03p66920.2_BraZ1	141	-	247	228	228	1.0000000
A03	32129165	32129784	A03p66930.2_BraZ1	29.7	+	455	619	619	1.0000000
A03	32132697	32133495	A03p66940.2_BraZ1	79.8	+	315	693	798	0.8684211
A03	32136159	32136417	A03p66950.2_BraZ1	25.8	-	154	258	258	1.0000000
A03	32146550	32146805	A03p66960.2_BraZ1	25.5	+	2	87	255	0.3411765
A03	32147692	32155011	A03p66970.2_BraZ1	714	+	7469	6996	7319	0.9558683
A03	32156081	32158426	A03p66980.2_BraZ1	1530.41	-	760	1974	2345	0.8417910
A03	32163651	32165797	A03p66990.2_BraZ1	1483.36	-	721	1415	2146	0.6593663
A03	32166374	32168581	A03p67000.2_BraZ1	1437.12	-	499	2135	2207	0.9673765
A03	32169195	32170683	A03p67010.2_BraZ1	485.625	-	705	1488	1488	1.0000000
A03	32174527	32174644	A03p67020.2_BraZ1	11.7	+	186	117	117	1.0000000
A03	32175923	32176955	A03p67030.2_BraZ1	2030	-	843	1032	1032	1.0000000
A03	32178535	32180713	A03p67040.2_BraZ1	647.182	-	2147	2178	2178	1.0000000
A03	32182137	32183486	A03p67050.2_BraZ1	519.429	-	480	1244	1349	0.9221646
A03	32185905	32186627	A03p67060.2_BraZ1	55.2	+	1105	722	722	1.0000000
A03	32187133	32193064	A03p67070.2_BraZ1	975	+	4233	5845	5931	0.9854999
A03	32193088	32193484	A03p67080.2_BraZ1	255	+	36	370	396	0.9343435
A03	32195506	32196497	A03p67090.2_BraZ1	404.429	+	76	857	991	0.8647830
A03	32199883	32200084	A03p67100.2_BraZ1	20.1	-	275	201	201	1.0000000
A03	32202692	32204257	A03p67110.2_BraZ1	941.76	+	1267	1558	1565	0.9955271
A03	32211902	32218209	A03p67120.2_BraZ1	186.75	-	3696	5625	6307	0.8918662
A03	32214283	32216885	A03p67130.2_BraZ1	940.5	-	543	1920	2602	0.7378939
A03	32217515	32218143	A03p67140.2_BraZ1	286.615	-	799	628	628	1.0000000
A03	32220229	32221117	A03p67150.2_BraZ1	373.75	-	1919	888	888	1.0000000
A03	32227276	32228253	A03p67160.2_BraZ1	366.275	-	50	462	977	0.4728762
A03	32236186	32237062	A03p67170.2_BraZ1	699	-	873	876	876	1.0000000
A03	32262721	32263535	A03p67180.2_BraZ1	366	-	0	0	814	0.0000000
A03	32268410	32270100	A03p67190.2_BraZ1	1161.5	+	156	1061	1690	0.6278107
A03	32283586	32283703	A03p67200.2_BraZ1	11.7	-	189	117	117	1.0000000
A03	32285542	32287552	A03p67210.2_BraZ1	173.7	-	1055	2010	2010	1.0000000
A03	32293571	32295463	A03p67220.2_BraZ1	455.318	+	2304	1742	1892	0.9207188
A03	32295636	32297254	A03p67230.2_BraZ1	1159	-	637	1566	1618	0.9678615
A03	32300031	32300886	A03p67240.2_BraZ1	450	+	1066	855	855	1.0000000
A03	32300679	32307510	A03p67250.2_BraZ1	882	+	2557	5011	6831	0.7335675
A03	32310176	32310401	A03p67260.2_BraZ1	22.5	+	539	225	225	1.0000000
A03	32310454	32311996	A03p67270.2_BraZ1	173.6	+	3649	1542	1542	1.0000000
A03	32331094	32331514	A03p67280.2_BraZ1	981	-	480	420	420	1.0000000
A03	32337244	32338636	A03p67290.2_BraZ1	882.36	+	552	1392	1392	1.0000000
A03	32340772	32345525	A03p67300.2_BraZ1	2791.25	-	1848	4665	4753	0.9814854
A03	32352715	32354314	A03p67310.2_BraZ1	159.9	+	96	1059	1599	0.6622889
A03	32357773	32358268	A03p67320.2_BraZ1	49.5	+	664	495	495	1.0000000
A03	32358331	32360724	A03p67330.2_BraZ1	1616.37	-	1155	2382	2393	0.9954032
A03	32369945	32372700	A03p67340.2_BraZ1	1133.37	+	1155	2550	2755	0.9255899
A03	32378979	32380296	A03p67350.2_BraZ1	131.7	+	109	638	1317	0.4844343
A03	32380971	32381450	A03p67360.2_BraZ1	45	-	67	425	479	0.8872651
A03	32383758	32384103	A03p67370.2_BraZ1	34.5	+	30	208	345	0.6028985
A03	32384558	32384911	A03p67380.2_BraZ1	255	-	15	193	353	0.5467422
A03	32387987	32388275	A03p67390.2_BraZ1	28.8	-	418	288	288	1.0000000
A03	32388550	32388742	A03p67400.2_BraZ1	19.2	+	359	192	192	1.0000000
A03	32397428	32397797	A03p67410.2_BraZ1	36.9	+	140	369	369	1.0000000
A03	32399300	32400142	A03p67420.2_BraZ1	75	+	9	299	842	0.3551069
A03	32401571	32403991	A03p67430.2_BraZ1	528.667	-	1975	2420	2420	1.0000000
A03	32404758	32406705	A03p67440.2_BraZ1	1154.4	-	983	1844	1947	0.9470981
A03	32436650	32439000	A03p67450.2_BraZ1	1167	+	1974	2350	2350	1.0000000
A03	32440273	32440708	A03p67460.2_BraZ1	360	+	477	435	435	1.0000000
A03	32441765	32451558	A03p67470.2_BraZ1	537	-	4041	8719	9793	0.8903298
A03	32475915	32477252	A03p67480.2_BraZ1	306	+	89	379	1337	0.2834705
A03	32477439	32478552	A03p67490.2_BraZ1	431.424	+	21	384	1113	0.3450135
A03	32495907	32498352	A03p67500.2_BraZ1	1671	+	418	1528	2445	0.6249489
A03	32500074	32500269	A03p67510.2_BraZ1	19.5	-	205	195	195	1.0000000
A03	32502961	32503345	A03p67520.2_BraZ1	21.6	+	158	384	384	1.0000000
A03	32506934	32507111	A03p67530.2_BraZ1	17.7	+	95	177	177	1.0000000
A03	32508646	32509305	A03p67540.2_BraZ1	234	-	443	659	659	1.0000000
A03	32520106	32520888	A03p67550.2_BraZ1	360.614	+	603	782	782	1.0000000
A03	32545147	32546195	A03p67560.2_BraZ1	846	+	20	336	1048	0.3206107
A03	32548090	32549384	A03p67570.2_BraZ1	1131.95	+	613	1233	1294	0.9528593
A03	32561837	32565803	A03p67580.2_BraZ1	912.095	-	1839	3540	3966	0.8925870
A03	32575870	32578780	A03p67590.2_BraZ1	1523.5	-	887	2862	2910	0.9835051
A03	32584694	32586717	A03p67600.2_BraZ1	363	+	1341	2023	2023	1.0000000
A03	32593217	32594463	A03p67610.2_BraZ1	402.188	+	2723	1246	1246	1.0000000
A03	32605799	32608115	A03p67620.2_BraZ1	12193.5	-	579	1874	2316	0.8091537
A03	32621604	32621896	A03p67630.2_BraZ1	159	-	174	292	292	1.0000000
A03	32621978	32625988	A03p67640.2_BraZ1	2443	-	785	2692	4010	0.6713217
A03	32631864	32633245	A03p67650.2_BraZ1	351	-	810	1381	1381	1.0000000
A03	32636473	32639812	A03p67660.2_BraZ1	1557.62	+	529	2330	3339	0.6978137
A03	32640365	32640776	A03p67670.2_BraZ1	41.1	+	22	218	411	0.5304136
A03	32654419	32656870	A03p67680.2_BraZ1	393	+	3132	2390	2451	0.9751122
A03	32658364	32659714	A03p67690.2_BraZ1	553.875	-	196	1145	1350	0.8481482
A03	32659999	32660149	A03p67700.2_BraZ1	14.7	+	16	150	150	1.0000000
A03	32663889	32665615	A03p67710.2_BraZ1	357.955	+	1644	1726	1726	1.0000000
A03	32667442	32668672	A03p67720.2_BraZ1	1014	-	974	1230	1230	1.0000000
A03	32672342	32672543	A03p67730.2_BraZ1	20.1	+	185	201	201	1.0000000
A03	32683655	32686013	A03p67740.2_BraZ1	276	-	945	2321	2358	0.9843087
A03	32689014	32690365	A03p67750.2_BraZ1	978	-	84	703	1351	0.5203553
A03	32691496	32693623	A03p67760.2_BraZ1	1701	-	186	727	2127	0.3417960
A03	32702677	32704067	A03p67770.2_BraZ1	857.769	-	38	890	1390	0.6402878
A03	32705298	32706372	A03p67780.2_BraZ1	107.4	-	749	1074	1074	1.0000000
A03	32712079	32712487	A03p67790.2_BraZ1	252	-	23	362	408	0.8872549
A03	32715002	32715924	A03p67800.2_BraZ1	257.714	-	161	762	922	0.8264642
A03	32717113	32718543	A03p67810.2_BraZ1	658.6	-	270	1324	1430	0.9258741
A03	32719362	32719893	A03p67820.2_BraZ1	53.1	-	361	531	531	1.0000000
A03	32720431	32722012	A03p67830.2_BraZ1	948.75	-	1983	1581	1581	1.0000000
A03	32722749	32723781	A03p67840.2_BraZ1	546	-	1009	1032	1032	1.0000000
A03	32746882	32747665	A03p67850.2_BraZ1	78.3	-	772	783	783	1.0000000
A03	32749603	32751462	A03p67860.2_BraZ1	477.917	-	1045	1851	1859	0.9956966
A03	32758491	32758635	A03p67870.2_BraZ1	14.4	-	276	144	144	1.0000000
A03	32758978	32759296	A03p67880.2_BraZ1	31.8	-	471	318	318	1.0000000
A03	32771920	32774341	A03p67890.2_BraZ1	2036.36	-	666	2207	2421	0.9116068
A03	32793616	32794974	A03p67900.2_BraZ1	1335	+	865	1358	1358	1.0000000
A03	32806894	32807167	A03p67910.2_BraZ1	27.3	-	659	273	273	1.0000000
A03	32807339	32807783	A03p67920.2_BraZ1	31.2	+	239	444	444	1.0000000
A03	32807858	32809667	A03p67930.2_BraZ1	1438.67	-	4190	1809	1809	1.0000000
A03	32810054	32814293	A03p67940.2_BraZ1	17321.4	-	4360	4222	4239	0.9959896
A03	32815029	32819835	A03p67950.2_BraZ1	167.647	+	2524	4678	4806	0.9733666
A03	32842821	32845704	A03p67960.2_BraZ1	483	-	742	2345	2883	0.8133888
A03	32851801	32853246	A03p67970.2_BraZ1	107.7	-	1557	1445	1445	1.0000000
A03	32854837	32855552	A03p67980.2_BraZ1	58.2	-	1898	715	715	1.0000000
A03	32855641	32859425	A03p67990.2_BraZ1	150.9	-	5996	3784	3784	1.0000000
A03	32864197	32864302	A03p68000.2_BraZ1	10.5	+	129	105	105	1.0000000
A03	32886301	32886541	A03p68010.2_BraZ1	24	-	231	240	240	1.0000000
A03	32902211	32904215	A03p68020.2_BraZ1	3660	-	1462	2004	2004	1.0000000
A03	32909083	32909861	A03p68030.2_BraZ1	651	-	471	778	778	1.0000000
A03	32919944	32921294	A03p68040.2_BraZ1	363	-	876	1350	1350	1.0000000
A03	32925713	32926215	A03p68050.2_BraZ1	165	-	563	502	502	1.0000000
A03	32929547	32929742	A03p68060.2_BraZ1	19.5	-	368	195	195	1.0000000
A03	32957695	32958210	A03p68070.2_BraZ1	1270.5	-	106	515	515	1.0000000
A03	32961533	32961948	A03p68080.2_BraZ1	162	+	558	415	415	1.0000000
A03	32961834	32962539	A03p68090.2_BraZ1	405.333	+	831	705	705	1.0000000
A03	32964934	32965246	A03p68100.2_BraZ1	31.2	+	411	312	312	1.0000000
A03	32969341	32972166	A03p68110.2_BraZ1	2598.75	+	1077	2702	2825	0.9564602
A03	32974644	32976692	A03p68120.2_BraZ1	1911	+	1263	2041	2048	0.9965820
A03	32977189	32980014	A03p68130.2_BraZ1	650.893	-	2526	2825	2825	1.0000000
A03	32982154	32987483	A03p68140.2_BraZ1	1948.56	-	3453	5322	5329	0.9986864
A03	33000778	33005781	A03p68150.2_BraZ1	57.9	-	6045	5003	5003	1.0000000
A03	33008189	33012462	A03p68160.2_BraZ1	692.364	-	6470	4273	4273	1.0000000
A03	33016219	33016584	A03p68170.2_BraZ1	228	+	612	365	365	1.0000000
A03	33020212	33043950	A03p68180.2_BraZ1	3266.54	-	3918	12715	23738	0.5356390
A03	33027217	33032555	A03p68190.2_BraZ1	2551.33	-	662	2733	5338	0.5119895
A03	33038564	33038917	A03p68200.2_BraZ1	180	+	0	0	353	0.0000000
A03	33056120	33056398	A03p68210.2_BraZ1	228	+	570	278	278	1.0000000
A03	33063012	33063274	A03p68220.2_BraZ1	24.6	+	184	262	262	1.0000000
A03	33065852	33071155	A03p68230.2_BraZ1	390	-	955	4718	5303	0.8896851
A03	33093233	33093640	A03p68240.2_BraZ1	324	+	523	407	407	1.0000000
A03	33110242	33112138	A03p68250.2_BraZ1	187.2	+	941	1893	1896	0.9984177
A03	33127740	33136294	A03p68260.2_BraZ1	970.187	-	15111	8412	8554	0.9833996
A03	33138128	33139344	A03p68270.2_BraZ1	625.5	-	1593	1216	1216	1.0000000
A03	33144911	33152037	A03p68280.2_BraZ1	2109.22	-	2304	6393	7126	0.8971372
A03	33196758	33197857	A03p68290.2_BraZ1	222	+	572	1099	1099	1.0000000
A03	33197857	33198112	A03p68300.2_BraZ1	135	-	258	255	255	1.0000000
A03	33226778	33229267	A03p68310.2_BraZ1	216	+	790	2443	2489	0.9815187
A03	33230093	33232566	A03p68320.2_BraZ1	456.32	+	720	2420	2473	0.9785686
A03	33233653	33234346	A03p68330.2_BraZ1	348	+	157	638	693	0.9206349
A03	33235819	33238729	A03p68340.2_BraZ1	608	+	1598	2721	2910	0.9350516
A03	33261453	33266570	A03p68350.2_BraZ1	1219.43	+	2793	5012	5117	0.9794801
A03	33303960	33304722	A03p68360.2_BraZ1	72	+	14	411	762	0.5393701
A03	33355827	33356869	A03p68370.2_BraZ1	534.086	+	666	1042	1042	1.0000000
A03	33384427	33384980	A03p68380.2_BraZ1	43.5	+	264	553	553	1.0000000
A03	33482503	33482881	A03p68390.2_BraZ1	279	+	153	378	378	1.0000000
A03	33497339	33499908	A03p68400.2_BraZ1	1406.29	-	749	2234	2569	0.8695990
A03	33516457	33517105	A03p68410.2_BraZ1	64.8	+	929	648	648	1.0000000
A03	33557033	33557681	A03p68420.2_BraZ1	64.8	+	236	572	648	0.8827161
A03	33602564	33603002	A03p68430.2_BraZ1	43.8	+	600	438	438	1.0000000
A03	33603708	33604599	A03p68440.2_BraZ1	508.5	-	681	891	891	1.0000000
A03	33607480	33608013	A03p68450.2_BraZ1	366	-	978	533	533	1.0000000
A03	33638821	33639012	A03p68460.2_BraZ1	108	-	343	191	191	1.0000000
A03	33654436	33655498	A03p68470.2_BraZ1	393.525	-	117	1028	1062	0.9679849
A03	33656438	33698751	A03p68480.2_BraZ1	1404.85	+	44992	40473	42313	0.9565145
A03	33687063	33688014	A03p68490.2_BraZ1	95.1	-	114	746	951	0.7844374
A03	33699301	33700201	A03p68500.2_BraZ1	1360.8	-	1115	900	900	1.0000000
A03	33700534	33701036	A03p68510.2_BraZ1	245.7	-	685	502	502	1.0000000
A03	33702122	33702380	A03p68520.2_BraZ1	25.8	+	197	258	258	1.0000000
A03	33703513	33703825	A03p68530.2_BraZ1	31.2	+	336	312	312	1.0000000
A03	33704273	33704756	A03p68540.2_BraZ1	369	+	370	483	483	1.0000000
A03	33705331	33706401	A03p68550.2_BraZ1	481.25	-	649	1070	1070	1.0000000
A03	33707443	33718018	A03p68560.2_BraZ1	1790.36	-	5579	9494	10575	0.8977778
A03	33781617	33782309	A03p68570.2_BraZ1	56.1	+	450	692	692	1.0000000
A03	33783157	33783499	A03p68580.2_BraZ1	34.2	-	372	342	342	1.0000000
A03	33784488	33785183	A03p68590.2_BraZ1	516	+	200	695	695	1.0000000
A03	33793355	33796523	A03p68600.2_BraZ1	2032.69	-	2264	3168	3168	1.0000000
A03	33795250	33796039	A03p68610.2_BraZ1	442.4	-	672	789	789	1.0000000
A03	33796448	33797312	A03p68620.2_BraZ1	562.5	-	766	864	864	1.0000000
A03	33819304	33819541	A03p68630.2_BraZ1	201	+	753	237	237	1.0000000
A03	33821577	33822207	A03p68640.2_BraZ1	484.5	-	1275	630	630	1.0000000
A03	33822207	33838422	A03p68650.2_BraZ1	1171.48	-	13950	16215	16215	1.0000000
A03	33845704	33846015	A03p68660.2_BraZ1	20.1	-	623	311	311	1.0000000
A03	33853140	33858105	A03p68670.2_BraZ1	2128	-	4927	4965	4965	1.0000000
A03	33859228	33859786	A03p68680.2_BraZ1	55.8	+	272	427	558	0.7652330
A03	33864273	33864684	A03p68690.2_BraZ1	41.1	+	1080	411	411	1.0000000
A03	33889148	33889364	A03p68700.2_BraZ1	21.6	-	126	216	216	1.0000000
A03	33960630	33961209	A03p68710.2_BraZ1	54.9	-	27	192	579	0.3316062
A03	33964898	33965321	A03p68720.2_BraZ1	42.3	-	209	423	423	1.0000000
A03	33976092	33978481	A03p68730.2_BraZ1	343.846	-	1371	2195	2389	0.9187945
A03	33980565	33984495	A03p68740.2_BraZ1	2068.2	-	1780	3887	3930	0.9890585
A03	33987174	33998448	A03p68750.2_BraZ1	950.625	+	5787	11070	11274	0.9819053
A03	34005579	34185393	A03p68760.2_BraZ1	1433.25	-	170895	178180	179814	0.9909129
A03	34009857	34010962	A03p68770.2_BraZ1	558	+	1202	1105	1105	1.0000000
A03	34164451	34168895	A03p68780.2_BraZ1	1070.53	-	3148	4444	4444	1.0000000
A03	34169250	34171094	A03p68790.2_BraZ1	444.122	+	1833	1844	1844	1.0000000
A03	34275542	34276246	A03p68800.2_BraZ1	462	-	801	704	704	1.0000000
A03	34291340	34293767	A03p68810.2_BraZ1	156	+	2285	2427	2427	1.0000000
A03	34335349	34336935	A03p68820.2_BraZ1	412.5	-	1319	1586	1586	1.0000000
A03	34504592	34505192	A03p68830.2_BraZ1	540	-	397	600	600	1.0000000
A03	34506073	34506265	A03p68840.2_BraZ1	19.2	-	160	192	192	1.0000000
A03	34508096	34509194	A03p68850.2_BraZ1	442.75	-	1036	1098	1098	1.0000000
A03	34509603	34513208	A03p68860.2_BraZ1	1122.08	-	1638	3584	3605	0.9941748
A03	34513516	34514559	A03p68870.2_BraZ1	963	+	385	1010	1043	0.9683605
A03	34958856	34959802	A03p68880.2_BraZ1	438	+	964	946	946	1.0000000
A03	34960751	35001805	A03p68890.2_BraZ1	253.909	+	22145	39642	41054	0.9656063
A03	34974015	34974982	A03p68900.2_BraZ1	585	+	243	945	967	0.9772492
A03	34975678	34976575	A03p68910.2_BraZ1	834	+	550	897	897	1.0000000
A03	34979757	34981275	A03p68920.2_BraZ1	552.094	+	1822	1518	1518	1.0000000
A03	34981194	34984651	A03p68930.2_BraZ1	576.818	+	2434	2782	3457	0.8047440
A03	34982806	34983371	A03p68940.2_BraZ1	228	+	508	565	565	1.0000000
A03	35004591	35005228	A03p68950.2_BraZ1	243.375	-	420	637	637	1.0000000
A03	35006513	35007002	A03p68960.2_BraZ1	318	+	294	489	489	1.0000000
A03	35009617	35011133	A03p68970.2_BraZ1	231	+	801	1516	1516	1.0000000
A03	35026988	35027283	A03p68980.2_BraZ1	273	+	160	295	295	1.0000000
A03	35028601	35029787	A03p68990.2_BraZ1	702	-	721	1186	1186	1.0000000
A03	35030637	35031114	A03p69000.2_BraZ1	465	-	503	477	477	1.0000000
A03	35035882	35041133	A03p69010.2_BraZ1	1360	-	444	4711	5251	0.8971624
A03	35044279	35052405	A03p69020.2_BraZ1	213	+	54586	8126	8126	1.0000000
A03	35052807	35053014	A03p69030.2_BraZ1	20.7	+	190	207	207	1.0000000
A03	35053740	35065985	A03p69040.2_BraZ1	738	-	19158	12245	12245	1.0000000
A03	35064524	35065467	A03p69050.2_BraZ1	729	-	1171	943	943	1.0000000
A03	35066864	35068295	A03p69060.2_BraZ1	334.091	-	3811	1431	1431	1.0000000
A03	35073810	35075101	A03p69070.2_BraZ1	4392	+	709	1063	1291	0.8233927
A03	35129416	35130579	A03p69080.2_BraZ1	453	-	1361	1163	1163	1.0000000
A03	35133121	35133809	A03p69090.2_BraZ1	288	-	864	688	688	1.0000000
A03	35135035	35136330	A03p69100.2_BraZ1	1492.5	-	1453	1295	1295	1.0000000
A03	35136330	35145624	A03p69110.2_BraZ1	328	-	3673	9249	9294	0.9951582
A03	35140911	35141257	A03p69120.2_BraZ1	1296	+	83	346	346	1.0000000
A03	35141922	35144773	A03p69130.2_BraZ1	3105	-	539	2818	2851	0.9884251
A03	35149096	35150178	A03p69140.2_BraZ1	133.091	+	730	1082	1082	1.0000000
A03	35150234	35152500	A03p69150.2_BraZ1	974.909	+	1181	2199	2266	0.9704325
A03	35164008	35166156	A03p69160.2_BraZ1	654.182	-	1663	2148	2148	1.0000000
A03	35164086	35164309	A03p69170.2_BraZ1	195	-	335	223	223	1.0000000
A03	35182300	35182996	A03p69180.2_BraZ1	69.6	+	387	696	696	1.0000000
A03	35184290	35184632	A03p69190.2_BraZ1	34.2	-	603	342	342	1.0000000
A03	35185993	35186689	A03p69200.2_BraZ1	69.6	+	319	696	696	1.0000000
A03	35195838	35196469	A03p69210.2_BraZ1	351	-	326	631	631	1.0000000
A03	35196835	35197761	A03p69220.2_BraZ1	771	-	584	926	926	1.0000000
A03	35219755	35220936	A03p69230.2_BraZ1	33.9	-	1552	1181	1181	1.0000000
A03	35220947	35221175	A03p69240.2_BraZ1	22.8	-	549	228	228	1.0000000
A03	35221394	35221580	A03p69250.2_BraZ1	18.6	+	280	186	186	1.0000000
A03	35225345	35226842	A03p69260.2_BraZ1	405	+	2213	1497	1497	1.0000000
A03	35230451	35231766	A03p69270.2_BraZ1	783	-	305	1066	1315	0.8106464
A03	35248299	35248686	A03p69280.2_BraZ1	38.7	-	699	387	387	1.0000000
A03	35337746	35338148	A03p69290.2_BraZ1	40.2	+	284	402	402	1.0000000
A03	35435935	35437161	A03p69300.2_BraZ1	727.091	-	1343	1226	1226	1.0000000
A03	35473995	35478232	A03p69310.2_BraZ1	926	+	1140	4226	4237	0.9974038
A03	35483879	35484032	A03p69320.2_BraZ1	15.3	-	29	153	153	1.0000000
A03	35505007	35505349	A03p69330.2_BraZ1	219	+	333	342	342	1.0000000
A03	35526862	35534752	A03p69340.2_BraZ1	1106.7	+	3444	4576	7890	0.5799747
A03	35530188	35532549	A03p69350.2_BraZ1	1938.6	-	0	0	2361	0.0000000
A03	35544629	35544950	A03p69360.2_BraZ1	30.3	+	614	321	321	1.0000000
A03	35567119	35567338	A03p69370.2_BraZ1	21.9	-	144	217	219	0.9908676
A03	35595269	35607177	A03p69380.2_BraZ1	519	-	7608	11750	11908	0.9867316
A03	35604400	35605291	A03p69390.2_BraZ1	89.1	-	382	809	891	0.9079686
A03	35611079	35611877	A03p69400.2_BraZ1	170.743	-	1815	798	798	1.0000000
A03	35612342	35613090	A03p69410.2_BraZ1	357	-	839	748	748	1.0000000
A03	35662795	35663242	A03p69420.2_BraZ1	44.7	-	111	447	447	1.0000000
A03	35665968	35669793	A03p69430.2_BraZ1	1586.03	-	2118	3502	3825	0.9155555
A03	35722190	35723222	A03p69440.2_BraZ1	103.2	-	194	1032	1032	1.0000000
A03	35742486	35743100	A03p69450.2_BraZ1	324	+	210	562	614	0.9153094
A03	35743989	35745477	A03p69460.2_BraZ1	1078.12	+	400	1313	1488	0.8823925
A03	35753662	35760835	A03p69470.2_BraZ1	465.5	-	3294	7093	7173	0.9888471
A03	35794729	35795257	A03p69480.2_BraZ1	52.8	+	1368	528	528	1.0000000
A03	35827355	35840050	A03p69490.2_BraZ1	537.75	-	4018	10897	12695	0.8583694
A03	35876240	35876548	A03p69500.2_BraZ1	276	-	10405	308	308	1.0000000
A03	35876548	35878132	A03p69510.2_BraZ1	930	-	19520	1584	1584	1.0000000
A03	35885354	35886649	A03p69520.2_BraZ1	289.227	-	1488	1295	1295	1.0000000
A03	35891357	35893207	A03p69530.2_BraZ1	1500	+	1272	1850	1850	1.0000000
A03	35899693	35901023	A03p69540.2_BraZ1	1065	+	1580	1330	1330	1.0000000
A03	36181340	36186979	A03p69550.2_BraZ1	1811.25	+	2507	5550	5639	0.9842170
A03	36205413	36206051	A03p69560.2_BraZ1	234	+	408	638	638	1.0000000
A03	36233445	36233784	A03p69570.2_BraZ1	33.9	+	1309	339	339	1.0000000
A03	36235659	36236083	A03p69580.2_BraZ1	3078	+	2841	424	424	1.0000000
A03	36276080	36276341	A03p69590.2_BraZ1	26.1	+	398	261	261	1.0000000
A03	36290710	36291054	A03p69600.2_BraZ1	26.1	+	145	344	344	1.0000000
A03	36318860	36319539	A03p69610.2_BraZ1	309	-	456	679	679	1.0000000
A03	36322882	36323086	A03p69620.2_BraZ1	17.4	-	77	204	204	1.0000000
A03	36325067	36331037	A03p69630.2_BraZ1	1936.46	-	3375	5938	5970	0.9946399
A03	36342522	36342659	A03p69640.2_BraZ1	126	+	189	137	137	1.0000000
A03	36352265	36352759	A03p69650.2_BraZ1	26.7	+	484	494	494	1.0000000
A03	36352997	36353584	A03p69660.2_BraZ1	189	-	1300	587	587	1.0000000
A03	36353667	36354004	A03p69670.2_BraZ1	264	-	820	337	337	1.0000000
A03	36357026	36357164	A03p69680.2_BraZ1	13.8	-	0	0	138	0.0000000
A03	36358082	36359125	A03p69690.2_BraZ1	479.411	+	851	1043	1043	1.0000000
A03	36363111	36364687	A03p69700.2_BraZ1	1065	+	3906	1576	1576	1.0000000
A03	36375229	36380440	A03p69710.2_BraZ1	330	+	4849	5211	5211	1.0000000
A03	36383087	36383825	A03p69720.2_BraZ1	73.8	+	629	738	738	1.0000000
A03	36392207	36394700	A03p69730.2_BraZ1	1138.8	+	1408	2493	2493	1.0000000
A03	36395507	36396804	A03p69740.2_BraZ1	645.75	+	620	1297	1297	1.0000000
A03	36404054	36405853	A03p69750.2_BraZ1	928.667	-	2461	1799	1799	1.0000000
A03	36421301	36422554	A03p69760.2_BraZ1	502.5	+	1187	1253	1253	1.0000000
A03	36426418	36426615	A03p69770.2_BraZ1	141	-	141	197	197	1.0000000
A03	36461309	36463078	A03p69780.2_BraZ1	369	+	255	1769	1769	1.0000000
A03	36463048	36464353	A03p69790.2_BraZ1	684	+	271	1305	1305	1.0000000
A03	36476075	36476378	A03p69800.2_BraZ1	30.3	+	373	303	303	1.0000000
A03	36478813	36479436	A03p69810.2_BraZ1	159	+	523	623	623	1.0000000
A03	36484562	36485066	A03p69820.2_BraZ1	459	-	3753	504	504	1.0000000
A03	36485066	36486897	A03p69830.2_BraZ1	1138.5	-	2008	1831	1831	1.0000000
A03	36488326	36488734	A03p69840.2_BraZ1	202.5	-	186	408	408	1.0000000
A03	36491464	36499151	A03p69850.2_BraZ1	2378.79	-	1849	6624	7687	0.8617146
A03	36526537	36527142	A03p69860.2_BraZ1	438	+	569	605	605	1.0000000
A03	36529147	36532245	A03p69870.2_BraZ1	618.429	-	3001	3098	3098	1.0000000
A03	36537429	36537920	A03p69880.2_BraZ1	360	-	290	491	491	1.0000000
A03	36542404	36543778	A03p69890.2_BraZ1	137.4	-	794	1374	1374	1.0000000
A03	36545413	36546282	A03p69900.2_BraZ1	221.667	+	123	869	869	1.0000000
A03	36546282	36547741	A03p69910.2_BraZ1	539	+	208	1196	1459	0.8197395
A03	36548494	36548840	A03p69920.2_BraZ1	243	-	92	288	346	0.8323699
A03	36556990	36557231	A03p69930.2_BraZ1	18.9	+	237	241	241	1.0000000
A03	36557622	36558844	A03p69940.2_BraZ1	996.545	-	183	1059	1222	0.8666121
A03	36561198	36567339	A03p69950.2_BraZ1	155.455	+	1645	3609	6141	0.5876893
A03	36568790	36570029	A03p69960.2_BraZ1	123.9	+	696	1239	1239	1.0000000
A03	36581194	36581815	A03p69970.2_BraZ1	62.1	+	625	621	621	1.0000000
A03	36586372	36587490	A03p69980.2_BraZ1	3517.71	+	193	1052	1118	0.9409660
A03	36587809	36593693	A03p69990.2_BraZ1	1622.31	-	4168	5884	5884	1.0000000
A03	36598277	36599362	A03p70000.2_BraZ1	324	-	1324	1085	1085	1.0000000
A03	36600354	36601022	A03p70010.2_BraZ1	59.4	-	471	668	668	1.0000000
A03	36603005	36604524	A03p70020.2_BraZ1	1106.76	-	1011	1376	1519	0.9058591
A03	36618250	36618584	A03p70030.2_BraZ1	135	-	167	334	334	1.0000000
A03	36620585	36620717	A03p70040.2_BraZ1	13.2	-	3	132	132	1.0000000
A03	36623506	36623638	A03p70050.2_BraZ1	13.2	-	6	64	132	0.4848485
A03	36626444	36626576	A03p70060.2_BraZ1	13.2	-	0	0	132	0.0000000
A03	36627079	36627499	A03p70070.2_BraZ1	198	-	354	420	420	1.0000000
A03	36629458	36629590	A03p70080.2_BraZ1	13.2	-	0	0	132	0.0000000
A03	36688127	36689669	A03p70090.2_BraZ1	1305	-	594	1472	1542	0.9546044
A03	36702886	36705136	A03p70100.2_BraZ1	23109.4	-	1291	2214	2250	0.9840000
A03	36720211	36720808	A03p70110.2_BraZ1	59.7	+	44	400	597	0.6700168
A03	36728209	36728311	A03p70120.2_BraZ1	10.2	+	412	102	102	1.0000000
A03	36728460	36728682	A03p70130.2_BraZ1	22.2	-	303	222	222	1.0000000
A03	36730178	36730880	A03p70140.2_BraZ1	408	+	1620	702	702	1.0000000
A03	36746887	36747325	A03p70150.2_BraZ1	43.8	-	296	423	438	0.9657534
A03	36756574	36757032	A03p70160.2_BraZ1	426	+	991	458	458	1.0000000
A03	36767783	36769205	A03p70170.2_BraZ1	1275	+	404	1384	1422	0.9732771
A03	36807490	36819956	A03p70180.2_BraZ1	1126.4	+	9574	12404	12466	0.9950265
A03	36820056	36820418	A03p70190.2_BraZ1	261	+	413	362	362	1.0000000
A03	36821157	36821362	A03p70200.2_BraZ1	120	+	364	205	205	1.0000000
A03	36853848	36856898	A03p70210.2_BraZ1	2110	+	995	2935	3050	0.9622951
A03	36863538	36863748	A03p70220.2_BraZ1	21	+	7	203	210	0.9666666
A03	36865371	36867378	A03p70230.2_BraZ1	195.6	+	721	2007	2007	1.0000000
A03	36884359	36885322	A03p70240.2_BraZ1	938.25	+	539	963	963	1.0000000
A03	36961136	36962720	A03p70250.2_BraZ1	990	-	614	1535	1584	0.9690657
A03	36967810	36968049	A03p70260.2_BraZ1	129	+	196	239	239	1.0000000
A03	36970177	36971473	A03p70270.2_BraZ1	541.8	+	812	1283	1296	0.9899691
A03	36977898	36978213	A03p70280.2_BraZ1	31.5	-	544	315	315	1.0000000
A03	36980356	36981017	A03p70290.2_BraZ1	557.812	-	1280	661	661	1.0000000
A03	36980914	36981731	A03p70300.2_BraZ1	149.625	-	952	817	817	1.0000000
A03	36981727	36981991	A03p70310.2_BraZ1	132	-	342	264	264	1.0000000
A03	36984684	36985031	A03p70320.2_BraZ1	150	+	484	347	347	1.0000000
A03	37010519	37011298	A03p70330.2_BraZ1	258	-	49	453	779	0.5815148
A03	37051423	37051653	A03p70340.2_BraZ1	201	-	471	230	230	1.0000000
A03	37096627	37097353	A03p70350.2_BraZ1	72.6	+	475	726	726	1.0000000
A03	37105157	37105782	A03p70360.2_BraZ1	60.3	+	865	625	625	1.0000000
A03	37117885	37123301	A03p70370.2_BraZ1	336.462	+	3762	5416	5416	1.0000000
A03	37125932	37126745	A03p70380.2_BraZ1	81.3	-	165	803	813	0.9876999
A03	37147857	37150804	A03p70390.2_BraZ1	403.071	-	869	2518	2947	0.8544282
A03	37151354	37153564	A03p70400.2_BraZ1	370	-	1124	2182	2210	0.9873303
A03	37155594	37157031	A03p70410.2_BraZ1	977.45	-	707	1391	1437	0.9679888
A03	37157693	37158620	A03p70420.2_BraZ1	92.7	-	531	927	927	1.0000000
A03	37159662	37160066	A03p70430.2_BraZ1	533.25	+	271	404	404	1.0000000
A03	37160504	37160808	A03p70440.2_BraZ1	165	+	171	304	304	1.0000000
A03	37160792	37161265	A03p70450.2_BraZ1	555	-	340	473	473	1.0000000
A03	37161110	37161658	A03p70460.2_BraZ1	153	+	647	548	548	1.0000000
A03	37171581	37171878	A03p70470.2_BraZ1	18.6	+	67	297	297	1.0000000
A03	37175430	37175568	A03p70480.2_BraZ1	13.8	+	45	138	138	1.0000000
A03	37213256	37214302	A03p70490.2_BraZ1	294	+	400	1046	1046	1.0000000
A03	37217247	37217919	A03p70500.2_BraZ1	67.2	+	60	616	672	0.9166667
A03	37220886	37222241	A03p70510.2_BraZ1	2143.8	+	8	114	1355	0.0841328
A03	37289954	37290451	A03p70520.2_BraZ1	186	-	56	453	497	0.9114688
A03	37295729	37296345	A03p70530.2_BraZ1	59.1	-	982	616	616	1.0000000
A03	37298806	37299710	A03p70540.2_BraZ1	651	+	372	892	904	0.9867257
A03	37310466	37311560	A03p70550.2_BraZ1	646.3	+	157	1028	1094	0.9396709
A03	37326122	37326468	A03p70560.2_BraZ1	216	+	269	346	346	1.0000000
A03	37327427	37327756	A03p70570.2_BraZ1	240	-	28	329	329	1.0000000
A03	37330295	37342096	A03p70580.2_BraZ1	663.3	+	5308	11096	11801	0.9402593
A03	37340724	37341181	A03p70590.2_BraZ1	29.7	-	141	411	457	0.8993436
A03	37345454	37347439	A03p70600.2_BraZ1	280.147	-	1914	1985	1985	1.0000000
A03	37349138	37349501	A03p70610.2_BraZ1	138	-	288	363	363	1.0000000
A03	37350554	37350689	A03p70620.2_BraZ1	13.5	-	85	135	135	1.0000000
A03	37422455	37422740	A03p70630.2_BraZ1	216	-	487	285	285	1.0000000
A03	37447381	37449011	A03p70640.2_BraZ1	1174.48	-	278	1334	1630	0.8184049
A03	37464570	37464741	A03p70650.2_BraZ1	17.1	-	224	171	171	1.0000000
A03	37465064	37465460	A03p70660.2_BraZ1	360	-	508	396	396	1.0000000
A03	37467056	37469365	A03p70670.2_BraZ1	1564	+	1118	2229	2309	0.9653530
A03	37469415	37470314	A03p70680.2_BraZ1	109.8	+	1052	899	899	1.0000000
A03	37476454	37478007	A03p70690.2_BraZ1	612	-	4906	1553	1553	1.0000000
A03	37478349	37479976	A03p70700.2_BraZ1	384	-	1080	1627	1627	1.0000000
A03	37487137	37487640	A03p70710.2_BraZ1	294	-	919	503	503	1.0000000
A03	37487724	37489573	A03p70720.2_BraZ1	165.363	-	1881	1849	1849	1.0000000
A03	37501608	37502838	A03p70730.2_BraZ1	123	+	774	1168	1230	0.9495935
A03	37534139	37534331	A03p70740.2_BraZ1	10.5	-	306	192	192	1.0000000
A03	37534600	37534849	A03p70750.2_BraZ1	24.9	-	650	249	249	1.0000000
A03	37553479	37553611	A03p70760.2_BraZ1	13.2	+	214	132	132	1.0000000
A03	37566512	37567348	A03p70770.2_BraZ1	176.71	+	1130	836	836	1.0000000
A03	37574475	37576556	A03p70780.2_BraZ1	20389.5	-	1070	2081	2081	1.0000000
A03	37582130	37582826	A03p70790.2_BraZ1	588	+	268	696	696	1.0000000
A03	37583326	37583623	A03p70800.2_BraZ1	243	-	231	297	297	1.0000000
A03	37583912	37585278	A03p70810.2_BraZ1	399	+	477	1341	1366	0.9816984
A03	37587092	37587333	A03p70820.2_BraZ1	207	+	75	241	241	1.0000000
A03	37592625	37592866	A03p70830.2_BraZ1	207	-	126	241	241	1.0000000
A03	37611966	37613373	A03p70840.2_BraZ1	140.7	-	573	1407	1407	1.0000000
A03	37623760	37624310	A03p70850.2_BraZ1	36	-	346	550	550	1.0000000
A03	37624414	37626046	A03p70860.2_BraZ1	1308.57	-	1073	1601	1632	0.9810049
A03	37627789	37628749	A03p70870.2_BraZ1	279.375	-	2	26	960	0.0270833
A03	37630910	37647597	A03p70880.2_BraZ1	1968	+	54614	16687	16687	1.0000000
A03	37648386	37648736	A03p70890.2_BraZ1	267	-	444	350	350	1.0000000
A03	37649391	37649953	A03p70900.2_BraZ1	276	-	636	562	562	1.0000000
A03	37669951	37670074	A03p70910.2_BraZ1	12.3	+	5011	123	123	1.0000000
A03	37673415	37675022	A03p70920.2_BraZ1	792	+	1693	1607	1607	1.0000000
A03	37674523	37674799	A03p70930.2_BraZ1	180	-	415	276	276	1.0000000
A03	37719826	37721132	A03p70940.2_BraZ1	804.545	-	879	1306	1306	1.0000000
A03	37726365	37726572	A03p70950.2_BraZ1	20.7	+	203	207	207	1.0000000
A03	37748803	37750112	A03p70960.2_BraZ1	1134	-	1085	1309	1309	1.0000000
A03	37763574	37765150	A03p70970.2_BraZ1	1042.5	+	1528	1576	1576	1.0000000
A03	37778372	37778872	A03p70980.2_BraZ1	953.143	-	247	409	500	0.8180000
A03	37780720	37781329	A03p70990.2_BraZ1	199.143	-	535	609	609	1.0000000
A03	37787933	37788110	A03p71000.2_BraZ1	17.7	-	46	177	177	1.0000000
A03	37806902	37807259	A03p71010.2_BraZ1	35.7	-	57	357	357	1.0000000
A03	37807829	37808054	A03p71020.2_BraZ1	22.5	-	0	0	225	0.0000000
A03	37815522	37819075	A03p71030.2_BraZ1	959.538	+	1264	3228	3553	0.9085280
A03	37832774	37835548	A03p71040.2_BraZ1	1445.33	-	1947	2671	2774	0.9628695
A03	37839947	37840442	A03p71050.2_BraZ1	222	-	189	495	495	1.0000000
A03	37855949	37856345	A03p71060.2_BraZ1	39.6	-	212	396	396	1.0000000
A03	37868188	37868440	A03p71070.2_BraZ1	23.1	-	220	252	252	1.0000000
A03	37882751	37885054	A03p71080.2_BraZ1	6839.58	-	10597	2303	2303	1.0000000
A03	37886169	37888155	A03p71090.2_BraZ1	688.5	-	3061	1986	1986	1.0000000
A03	37892016	37893043	A03p71100.2_BraZ1	201	-	813	1027	1027	1.0000000
A03	37898643	37901144	A03p71110.2_BraZ1	1563.09	-	1452	2464	2501	0.9852059
A03	37903107	37903986	A03p71120.2_BraZ1	948	+	1169	879	879	1.0000000
A03	37904313	37904628	A03p71130.2_BraZ1	31.5	+	223	315	315	1.0000000
A03	37932803	37946179	A03p71140.2_BraZ1	864	+	6731	13376	13376	1.0000000
A03	37949595	37952743	A03p71150.2_BraZ1	1243.64	-	3997	3148	3148	1.0000000
A03	37960546	37963238	A03p71160.2_BraZ1	1326	+	5056	2692	2692	1.0000000
A03	37979658	37979949	A03p71170.2_BraZ1	147	+	419	291	291	1.0000000
A03	38010347	38010563	A03p71180.2_BraZ1	21.6	-	161	216	216	1.0000000
A03	38023364	38024375	A03p71190.2_BraZ1	63	+	787	1011	1011	1.0000000
A03	38026205	38026532	A03p71200.2_BraZ1	32.7	+	430	327	327	1.0000000
A03	38030632	38032619	A03p71210.2_BraZ1	1057.89	-	1726	1980	1987	0.9964771
A03	38037990	38038387	A03p71220.2_BraZ1	261	+	291	397	397	1.0000000
A03	38038518	38039458	A03p71230.2_BraZ1	300	+	474	923	940	0.9819149
A03	38046661	38046881	A03p71240.2_BraZ1	19.2	-	71	220	220	1.0000000
A03	38048425	38050217	A03p71250.2_BraZ1	279	-	1184	1748	1792	0.9754464
A03	38066109	38067075	A03p71260.2_BraZ1	96.6	+	0	0	966	0.0000000
A03	38073609	38074575	A03p71270.2_BraZ1	96.6	+	0	0	966	0.0000000
A03	38076914	38083400	A03p71280.2_BraZ1	1027.2	+	237	1982	6486	0.3055812
A03	38086212	38086757	A03p71290.2_BraZ1	492	-	124	536	545	0.9834862
A03	38093318	38093492	A03p71300.2_BraZ1	17.4	+	30	174	174	1.0000000
A03	38101712	38102678	A03p71310.2_BraZ1	96.6	+	0	0	966	0.0000000
A03	38105018	38111512	A03p71320.2_BraZ1	1029.6	+	426	2666	6494	0.4105328
A03	38114320	38114865	A03p71330.2_BraZ1	492	-	0	0	545	0.0000000
A03	38116742	38118149	A03p71340.2_BraZ1	1368	-	513	1407	1407	1.0000000
A03	38129807	38130773	A03p71350.2_BraZ1	96.6	+	2	229	966	0.2370600
A03	38133101	38137069	A03p71360.2_BraZ1	1025.5	+	1923	3968	3968	1.0000000
A03	38146680	38147022	A03p71370.2_BraZ1	34.2	+	259	342	342	1.0000000
A03	38147189	38148343	A03p71380.2_BraZ1	171	-	644	1154	1154	1.0000000
A03	38160928	38162677	A03p71390.2_BraZ1	450	-	1256	1749	1749	1.0000000
A03	38167711	38175595	A03p71400.2_BraZ1	1534.29	-	2548	4474	7884	0.5674784
A03	38186440	38190977	A03p71410.2_BraZ1	1937.97	-	3118	4462	4537	0.9834692
A03	38196786	38200251	A03p71420.2_BraZ1	1567.06	-	3458	3465	3465	1.0000000
A03	38210581	38210940	A03p71430.2_BraZ1	2247.75	+	398	359	359	1.0000000
A03	38212062	38212281	A03p71440.2_BraZ1	16.5	-	221	219	219	1.0000000
A03	38219582	38219873	A03p71450.2_BraZ1	29.1	-	163	291	291	1.0000000
A03	38224669	38226422	A03p71460.2_BraZ1	126.857	-	1253	1753	1753	1.0000000
A03	38227525	38232895	A03p71470.2_BraZ1	2475.52	-	2171	4696	5370	0.8744879
A03	38288272	38288908	A03p71480.2_BraZ1	63.6	+	162	629	636	0.9889937
A03	38289815	38298133	A03p71490.2_BraZ1	383.906	+	10184	8317	8318	0.9998798
A03	38349507	38351125	A03p71500.2_BraZ1	898.8	+	498	1561	1618	0.9647713
A03	38366003	38368320	A03p71510.2_BraZ1	934.737	-	1038	2317	2317	1.0000000
A03	38369447	38369921	A03p71520.2_BraZ1	126	+	1297	474	474	1.0000000
A03	38369479	38370667	A03p71530.2_BraZ1	1716.75	+	2489	1188	1188	1.0000000
A03	38373984	38375056	A03p71540.2_BraZ1	714	+	1159	1072	1072	1.0000000
A03	38377793	38378705	A03p71550.2_BraZ1	530.25	+	189	855	912	0.9375000
A03	38408275	38408717	A03p71560.2_BraZ1	153	-	579	442	442	1.0000000
A03	38415645	38417016	A03p71570.2_BraZ1	734.5	-	1635	1371	1371	1.0000000
A03	38428600	38428770	A03p71580.2_BraZ1	14.7	+	479	170	170	1.0000000
A03	38468320	38468701	A03p71590.2_BraZ1	277.846	-	945	381	381	1.0000000
A03	38477117	38477369	A03p71600.2_BraZ1	25.2	+	198	252	252	1.0000000
A03	38489120	38490906	A03p71610.2_BraZ1	543	-	1343	1786	1786	1.0000000
A03	38501240	38501664	A03p71620.2_BraZ1	3762	+	135	424	424	1.0000000
A03	38502509	38503203	A03p71630.2_BraZ1	1116	-	140	694	694	1.0000000
A03	38503203	38505301	A03p71640.2_BraZ1	1053.75	-	607	2089	2098	0.9957102
A03	38506709	38506974	A03p71650.2_BraZ1	183	-	32	265	265	1.0000000
A03	38576750	38577164	A03p71660.2_BraZ1	41.4	-	219	399	414	0.9637681
A03	38585587	38586064	A03p71670.2_BraZ1	396	+	378	477	477	1.0000000
A03	38589036	38589801	A03p71680.2_BraZ1	402	+	614	765	765	1.0000000
A03	38594708	38594952	A03p71690.2_BraZ1	15	-	204	244	244	1.0000000
A03	38596444	38619839	A03p71700.2_BraZ1	318	-	6652	20346	23395	0.8696730
A03	38596557	38619616	A03p71710.2_BraZ1	723	-	6580	20233	23059	0.8774448
A03	38620149	38620554	A03p71720.2_BraZ1	40.5	-	0	0	405	0.0000000
A03	38646629	38647305	A03p71730.2_BraZ1	339	-	110	325	676	0.4807692
A03	38648552	38648957	A03p71740.2_BraZ1	40.5	-	0	0	405	0.0000000
A03	38682544	38683220	A03p71750.2_BraZ1	339	-	1	9	676	0.0133136
A03	38684466	38684871	A03p71760.2_BraZ1	40.5	-	0	0	405	0.0000000
A03	38718731	38719407	A03p71770.2_BraZ1	339	-	0	0	676	0.0000000
A03	38729123	38730113	A03p71780.2_BraZ1	99	+	1385	990	990	1.0000000
A03	38798842	38799178	A03p71790.2_BraZ1	264	+	754	336	336	1.0000000
A03	38806298	38806481	A03p71800.2_BraZ1	18.3	+	668	183	183	1.0000000
A03	38818816	38822119	A03p71810.2_BraZ1	483.242	-	1621	3202	3303	0.9694217
A03	38822119	38826594	A03p71820.2_BraZ1	333.343	-	7326	4475	4475	1.0000000
A03	38826578	38830503	A03p71830.2_BraZ1	1242.89	-	1518	3771	3925	0.9607643
A03	38832115	38837361	A03p71840.2_BraZ1	129	+	616	3193	5246	0.6086542
A03	38849922	38850478	A03p71850.2_BraZ1	453	-	383	556	556	1.0000000
A03	38892141	38894076	A03p71860.2_BraZ1	308	+	2372	1935	1935	1.0000000
A03	38894339	38894816	A03p71870.2_BraZ1	174	+	423	477	477	1.0000000
A03	38895667	38895838	A03p71880.2_BraZ1	17.1	+	1118	171	171	1.0000000
A03	38897494	38898495	A03p71890.2_BraZ1	234	-	1437	1001	1001	1.0000000
A03	38898916	38910330	A03p71900.2_BraZ1	1122.2	+	10216	11407	11414	0.9993867
A03	38900102	38900351	A03p71910.2_BraZ1	138	+	1775	249	249	1.0000000
A03	38911525	38912144	A03p71920.2_BraZ1	408	-	1524	619	619	1.0000000
A03	38912547	38915242	A03p71930.2_BraZ1	2945.25	-	1849	2695	2695	1.0000000
A03	38918399	38920127	A03p71940.2_BraZ1	166.4	+	429	1708	1728	0.9884259
A03	38924689	38927942	A03p71950.2_BraZ1	661.333	-	4431	3253	3253	1.0000000
A03	38928584	38928725	A03p71960.2_BraZ1	14.1	-	193	141	141	1.0000000
A03	38929645	38929846	A03p71970.2_BraZ1	20.1	-	263	201	201	1.0000000
A03	38938825	38939676	A03p71980.2_BraZ1	675	+	272	732	851	0.8601645
A03	38955001	38955375	A03p71990.2_BraZ1	150	+	190	374	374	1.0000000
A03	38958650	38959249	A03p72000.2_BraZ1	282	+	284	599	599	1.0000000
A03	38967826	38968321	A03p72010.2_BraZ1	116	-	844	495	495	1.0000000
A03	38976545	38976779	A03p72020.2_BraZ1	23.4	+	162	234	234	1.0000000
A03	38981198	38982977	A03p72030.2_BraZ1	340.667	+	31	605	1779	0.3400787
A03	38983058	38983994	A03p72040.2_BraZ1	46.5	-	146	911	936	0.9732906
A03	38983862	38987280	A03p72050.2_BraZ1	189	-	958	2848	3418	0.8332358
A03	38987157	38987577	A03p72060.2_BraZ1	261	-	74	420	420	1.0000000
A03	38988639	38990658	A03p72070.2_BraZ1	32.7	-	255	1300	2019	0.6438831
A03	38990237	38994285	A03p72080.2_BraZ1	249.9	-	577	2585	4048	0.6385869
A03	38996716	38997147	A03p72090.2_BraZ1	324	+	385	431	431	1.0000000
A03	39001170	39001978	A03p72100.2_BraZ1	183	+	2552	808	808	1.0000000
A03	39029770	39030917	A03p72110.2_BraZ1	653.082	-	691	1147	1147	1.0000000
A03	39031245	39031578	A03p72120.2_BraZ1	33.3	+	438	333	333	1.0000000
A03	39042413	39042893	A03p72130.2_BraZ1	279	-	681	480	480	1.0000000
A03	39047430	39048536	A03p72140.2_BraZ1	616.8	+	1043	1106	1106	1.0000000
A03	39071080	39071272	A03p72150.2_BraZ1	18.3	+	111	192	192	1.0000000
A03	39087904	39089581	A03p72160.2_BraZ1	1361.6	-	752	1677	1677	1.0000000
A03	39090400	39091665	A03p72170.2_BraZ1	1404	-	390	1265	1265	1.0000000
A03	39091863	39092817	A03p72180.2_BraZ1	497.25	-	637	954	954	1.0000000
A03	39094220	39099885	A03p72190.2_BraZ1	918.5	+	3841	5665	5665	1.0000000
A03	39099394	39099564	A03p72200.2_BraZ1	126	+	274	170	170	1.0000000
A03	39101789	39102008	A03p72210.2_BraZ1	21.9	-	299	219	219	1.0000000
A03	39103929	39106962	A03p72220.2_BraZ1	2135.96	+	2981	3033	3033	1.0000000
A03	39107962	39113659	A03p72230.2_BraZ1	3991.73	-	3092	5599	5697	0.9827980
A03	39141955	39142572	A03p72240.2_BraZ1	50.4	+	1461	617	617	1.0000000
A03	39165158	39165680	A03p72250.2_BraZ1	252.844	-	32	129	522	0.2471264
A03	39167928	39168108	A03p72260.2_BraZ1	18	-	137	180	180	1.0000000
A03	39182601	39183770	A03p72270.2_BraZ1	633	-	9	21	1169	0.0179641
A03	39203699	39205172	A03p72280.2_BraZ1	857.25	+	112	845	1473	0.5736592
A03	39227266	39235940	A03p72290.2_BraZ1	141.75	-	8113	6603	8674	0.7612405
A03	39239430	39239860	A03p72300.2_BraZ1	132	-	1571	418	430	0.9720930
A03	39239543	39239758	A03p72310.2_BraZ1	105.188	-	767	215	215	1.0000000
A03	39240114	39242111	A03p72320.2_BraZ1	339.25	+	1497	1176	1997	0.5888833
A03	39255349	39255898	A03p72330.2_BraZ1	54.9	-	163	549	549	1.0000000
A03	39258856	39259120	A03p72340.2_BraZ1	26.4	+	276	264	264	1.0000000
A03	39263563	39264096	A03p72350.2_BraZ1	768	+	803	533	533	1.0000000
A03	39271395	39271713	A03p72360.2_BraZ1	31.8	+	24	201	318	0.6320755
A03	39292687	39293042	A03p72370.2_BraZ1	234	+	6	24	355	0.0676056
A03	39295622	39295794	A03p72380.2_BraZ1	150	+	24	156	172	0.9069768
A03	39297548	39299062	A03p72390.2_BraZ1	644	+	752	1514	1514	1.0000000
A03	39320896	39321299	A03p72400.2_BraZ1	324	+	0	0	403	0.0000000
A03	39322485	39328263	A03p72410.2_BraZ1	879.911	-	256	3351	5778	0.5799584
A03	39328398	39331266	A03p72420.2_BraZ1	648	+	2822	2864	2868	0.9986053
A03	39361256	39361451	A03p72430.2_BraZ1	19.5	-	324	195	195	1.0000000
A03	39362295	39362803	A03p72440.2_BraZ1	354	-	9	19	508	0.0374016
A03	39363238	39363789	A03p72450.2_BraZ1	303	+	314	551	551	1.0000000
A03	39367152	39369278	A03p72460.2_BraZ1	843.81	+	772	2067	2126	0.9722484
A03	39386881	39389281	A03p72470.2_BraZ1	937.143	+	2713	2400	2400	1.0000000
A03	39390312	39391685	A03p72480.2_BraZ1	1083	-	1666	1373	1373	1.0000000
A03	39395437	39395760	A03p72490.2_BraZ1	159	-	711	323	323	1.0000000
A03	39398216	39400917	A03p72500.2_BraZ1	1168.12	-	1359	2280	2701	0.8441318
A03	39402061	39402270	A03p72510.2_BraZ1	174	+	1	80	209	0.3827751
A03	39402214	39402865	A03p72520.2_BraZ1	65.1	-	0	0	651	0.0000000
A03	39435847	39436237	A03p72530.2_BraZ1	267	-	3748	390	390	1.0000000
A03	39444953	39445342	A03p72540.2_BraZ1	267	-	0	0	389	0.0000000
A03	39454058	39454447	A03p72550.2_BraZ1	267	-	1	95	389	0.2442159
A03	39462973	39463361	A03p72560.2_BraZ1	267	-	1	87	388	0.2242268
A03	39471879	39472267	A03p72570.2_BraZ1	267	-	1	90	388	0.2319588
A03	39480785	39481174	A03p72580.2_BraZ1	267	-	375	385	389	0.9897172
A03	39489682	39490070	A03p72590.2_BraZ1	267	-	18	96	388	0.2474227
A03	39516098	39516897	A03p72600.2_BraZ1	429	+	20	166	799	0.2077597
A03	39542910	39543295	A03p72610.2_BraZ1	228	-	0	0	385	0.0000000
A03	39551747	39552132	A03p72620.2_BraZ1	228	-	0	0	385	0.0000000
A03	39560321	39561107	A03p72630.2_BraZ1	429	+	17	425	786	0.5407125
A03	39569420	39569809	A03p72640.2_BraZ1	267	-	3	147	389	0.3778920
A03	39578252	39578640	A03p72650.2_BraZ1	267	-	0	0	388	0.0000000
A03	39587087	39587474	A03p72660.2_BraZ1	228	-	100	387	387	1.0000000
A03	39610811	39611591	A03p72670.2_BraZ1	354	+	124	661	780	0.8474359
A04	6525	10340	A04p00010.2_BraZ1	405	-	1154	3297	3815	0.8642202
A04	10403	10897	A04p00020.2_BraZ1	387	+	371	494	494	1.0000000
A04	11904	12681	A04p00030.2_BraZ1	276	+	750	777	777	1.0000000
A04	12682	13923	A04p00040.2_BraZ1	679.074	+	1185	1241	1241	1.0000000
A04	14517	17439	A04p00050.2_BraZ1	1145.25	-	2050	2870	2922	0.9822040
A04	17801	19557	A04p00060.2_BraZ1	981.364	-	1087	1756	1756	1.0000000
A04	22278	23358	A04p00070.2_BraZ1	151.8	-	1082	1080	1080	1.0000000
A04	23596	26908	A04p00080.2_BraZ1	1246.65	-	2631	3312	3312	1.0000000
A04	28099	34263	A04p00090.2_BraZ1	2599.96	+	2841	6053	6164	0.9819922
A04	35182	36142	A04p00100.2_BraZ1	678.261	+	428	960	960	1.0000000
A04	36421	38984	A04p00110.2_BraZ1	1363.54	-	1223	2563	2563	1.0000000
A04	41462	46445	A04p00120.2_BraZ1	2317.8	-	3304	4983	4983	1.0000000
A04	46935	48246	A04p00130.2_BraZ1	1161	+	392	1111	1311	0.8474447
A04	49472	53620	A04p00140.2_BraZ1	1814.91	+	3200	4148	4148	1.0000000
A04	54227	54737	A04p00150.2_BraZ1	1436.4	-	554	510	510	1.0000000
A04	55978	60497	A04p00160.2_BraZ1	432	+	3081	4011	4519	0.8875858
A04	60427	61377	A04p00170.2_BraZ1	204	+	832	950	950	1.0000000
A04	97035	97707	A04p00180.2_BraZ1	558	+	107	621	672	0.9241071
A04	114891	115092	A04p00190.2_BraZ1	20.1	+	203	201	201	1.0000000
A04	121860	122855	A04p00200.2_BraZ1	2115.75	+	0	0	995	0.0000000
A04	132145	133386	A04p00210.2_BraZ1	11640	-	185	1070	1241	0.8622079
A04	136429	138168	A04p00220.2_BraZ1	995.625	+	1748	1739	1739	1.0000000
A04	141948	145803	A04p00230.2_BraZ1	2390.89	+	2611	3783	3855	0.9813229
A04	146111	147246	A04p00240.2_BraZ1	735.429	-	612	1135	1135	1.0000000
A04	147594	151046	A04p00250.2_BraZ1	1918.56	+	1447	3401	3452	0.9852260
A04	151661	153288	A04p00260.2_BraZ1	1158.26	+	933	1586	1627	0.9748002
A04	153559	155179	A04p00270.2_BraZ1	162	-	1559	1620	1620	1.0000000
A04	167033	168038	A04p00280.2_BraZ1	100.5	+	394	1005	1005	1.0000000
A04	170179	170986	A04p00290.2_BraZ1	80.7	-	745	807	807	1.0000000
A04	171840	173049	A04p00300.2_BraZ1	488.67	-	584	1209	1209	1.0000000
A04	173682	180564	A04p00310.2_BraZ1	3879.74	-	2428	5900	6882	0.8573089
A04	181151	187130	A04p00320.2_BraZ1	692.631	+	2596	4558	5979	0.7623348
A04	187296	192730	A04p00330.2_BraZ1	1402.2	+	3125	5434	5434	1.0000000
A04	199212	199686	A04p00340.2_BraZ1	47.4	+	513	474	474	1.0000000
A04	199838	201714	A04p00350.2_BraZ1	1321.58	-	1015	1758	1876	0.9371002
A04	204935	206242	A04p00360.2_BraZ1	20035.5	-	660	1307	1307	1.0000000
A04	208296	209683	A04p00370.2_BraZ1	2856.6	-	1338	1387	1387	1.0000000
A04	250372	250716	A04p00380.2_BraZ1	20.1	-	456	344	344	1.0000000
A04	253315	255673	A04p00390.2_BraZ1	1672.26	+	776	2163	2358	0.9173028
A04	259084	259393	A04p00400.2_BraZ1	30.9	-	36	280	309	0.9061489
A04	265666	265978	A04p00410.2_BraZ1	31.2	-	10	210	312	0.6730769
A04	269726	270777	A04p00420.2_BraZ1	972	+	525	1051	1051	1.0000000
A04	271859	272168	A04p00430.2_BraZ1	30.9	+	179	309	309	1.0000000
A04	272442	272868	A04p00440.2_BraZ1	237	-	544	426	426	1.0000000
A04	279065	281777	A04p00450.2_BraZ1	1133.24	+	3114	2712	2712	1.0000000
A04	282040	283219	A04p00460.2_BraZ1	116.4	-	808	1179	1179	1.0000000
A04	283686	284662	A04p00470.2_BraZ1	355.109	+	1045	976	976	1.0000000
A04	285292	290354	A04p00480.2_BraZ1	1236.23	+	3371	5062	5062	1.0000000
A04	293598	296430	A04p00490.2_BraZ1	1022	-	3622	2816	2832	0.9943503
A04	307610	308019	A04p00500.2_BraZ1	321	-	88	334	409	0.8166259
A04	308497	309316	A04p00510.2_BraZ1	81.9	+	543	811	819	0.9902320
A04	309992	311576	A04p00520.2_BraZ1	1161.67	+	821	1584	1584	1.0000000
A04	312213	313050	A04p00530.2_BraZ1	660	+	478	802	837	0.9581840
A04	313751	316376	A04p00540.2_BraZ1	1464.78	-	768	2490	2625	0.9485714
A04	319172	320558	A04p00550.2_BraZ1	138.6	-	274	1120	1386	0.8080808
A04	321242	324065	A04p00560.2_BraZ1	1851.5	+	310	1716	2823	0.6078640
A04	325178	326258	A04p00570.2_BraZ1	999	-	623	1080	1080	1.0000000
A04	332523	333560	A04p00580.2_BraZ1	936	-	378	1021	1037	0.9845709
A04	337722	339708	A04p00590.2_BraZ1	11521	+	624	1647	1986	0.8293051
A04	340494	342759	A04p00600.2_BraZ1	1470	-	223	1259	2265	0.5558499
A04	344168	345051	A04p00610.2_BraZ1	4838	-	19	122	883	0.1381653
A04	345869	353719	A04p00620.2_BraZ1	1915.74	-	4275	6948	7850	0.8850955
A04	357656	358532	A04p00630.2_BraZ1	480.562	+	195	876	876	1.0000000
A04	362223	367577	A04p00640.2_BraZ1	1966.02	+	1839	5133	5354	0.9587225
A04	370951	373211	A04p00650.2_BraZ1	1607.4	+	1144	2221	2260	0.9827434
A04	373674	375548	A04p00660.2_BraZ1	264.533	+	571	1874	1874	1.0000000
A04	377292	378546	A04p00670.2_BraZ1	425.04	+	1134	1254	1254	1.0000000
A04	379071	379545	A04p00680.2_BraZ1	47.4	-	68	380	474	0.8016878
A04	380905	382306	A04p00690.2_BraZ1	140.1	-	1069	1401	1401	1.0000000
A04	383204	386472	A04p00700.2_BraZ1	1178.18	+	367	2229	3268	0.6820685
A04	391822	393646	A04p00710.2_BraZ1	104.4	-	2406	1824	1824	1.0000000
A04	394700	396604	A04p00720.2_BraZ1	18144	+	1	62	1904	0.0325630
A04	400651	401554	A04p00730.2_BraZ1	519	-	104	721	903	0.7984496
A04	421008	423710	A04p00740.2_BraZ1	1370.97	-	1648	2303	2702	0.8523316
A04	426269	426479	A04p00750.2_BraZ1	21	+	156	210	210	1.0000000
A04	426641	427933	A04p00760.2_BraZ1	715.065	-	451	1247	1292	0.9651703
A04	443530	443809	A04p00770.2_BraZ1	27.9	+	73	279	279	1.0000000
A04	448462	449425	A04p00780.2_BraZ1	96.3	-	52	453	963	0.4704050
A04	463261	463465	A04p00790.2_BraZ1	20.4	+	191	204	204	1.0000000
A04	464463	465797	A04p00800.2_BraZ1	2461	-	1004	1334	1334	1.0000000
A04	465840	466181	A04p00810.2_BraZ1	204	+	196	341	341	1.0000000
A04	466812	467823	A04p00820.2_BraZ1	59.7	-	511	953	1011	0.9426311
A04	483909	484411	A04p00830.2_BraZ1	333.333	+	28	243	502	0.4840637
A04	485597	485927	A04p00840.2_BraZ1	33	-	2	5	330	0.0151515
A04	493538	495290	A04p00850.2_BraZ1	918	+	1589	1746	1752	0.9965754
A04	495436	495885	A04p00860.2_BraZ1	354	+	310	449	449	1.0000000
A04	501306	502370	A04p00870.2_BraZ1	687	+	78	772	1064	0.7255639
A04	505998	506304	A04p00880.2_BraZ1	30.6	-	141	306	306	1.0000000
A04	526759	528592	A04p00890.2_BraZ1	1689	+	74	1030	1833	0.5619203
A04	539386	540963	A04p00900.2_BraZ1	969	-	103	844	1577	0.5351934
A04	554792	555044	A04p00910.2_BraZ1	25.2	+	98	252	252	1.0000000
A04	555342	556794	A04p00920.2_BraZ1	145.2	+	134	812	1452	0.5592287
A04	560674	562388	A04p00930.2_BraZ1	981	+	1032	1714	1714	1.0000000
A04	562759	563408	A04p00940.2_BraZ1	195	-	336	588	649	0.9060093
A04	563397	564159	A04p00950.2_BraZ1	366	-	269	762	762	1.0000000
A04	564906	568446	A04p00960.2_BraZ1	779.982	+	1495	3190	3540	0.9011300
A04	571603	574146	A04p00970.2_BraZ1	1886.32	-	1532	2543	2543	1.0000000
A04	585510	586589	A04p00980.2_BraZ1	872.714	+	1424	1079	1079	1.0000000
A04	588585	589641	A04p00990.2_BraZ1	117	+	670	1046	1056	0.9905303
A04	589490	589702	A04p01000.2_BraZ1	117	+	304	212	212	1.0000000
A04	590659	590988	A04p01010.2_BraZ1	240	+	280	329	329	1.0000000
A04	592810	599216	A04p01020.2_BraZ1	538.062	+	4719	6147	6406	0.9595692
A04	602784	604029	A04p01030.2_BraZ1	123.3	-	405	1171	1245	0.9405622
A04	614439	615789	A04p01040.2_BraZ1	135	-	126	986	1350	0.7303703
A04	618305	618935	A04p01050.2_BraZ1	1078	-	298	630	630	1.0000000
A04	619281	619857	A04p01060.2_BraZ1	57.6	-	470	576	576	1.0000000
A04	620819	622029	A04p01070.2_BraZ1	809.521	-	372	1188	1210	0.9818182
A04	627112	628263	A04p01080.2_BraZ1	43.8	-	1234	1151	1151	1.0000000
A04	634310	634898	A04p01090.2_BraZ1	58.8	+	181	543	588	0.9234694
A04	651582	652173	A04p01100.2_BraZ1	348	-	14	343	591	0.5803723
A04	655284	657192	A04p01110.2_BraZ1	1027.16	-	700	1433	1908	0.7510482
A04	659546	660888	A04p01120.2_BraZ1	67.8	-	1298	1342	1342	1.0000000
A04	665495	667156	A04p01130.2_BraZ1	819	-	872	1651	1661	0.9939795
A04	667730	669279	A04p01140.2_BraZ1	970.222	-	1047	1504	1549	0.9709490
A04	674391	677109	A04p01150.2_BraZ1	1718.11	+	1093	2597	2718	0.9554819
A04	677342	679106	A04p01160.2_BraZ1	259.568	-	1173	1764	1764	1.0000000
A04	677922	678497	A04p01170.2_BraZ1	267	+	168	575	575	1.0000000
A04	679741	680077	A04p01180.2_BraZ1	33.6	+	509	336	336	1.0000000
A04	680419	682261	A04p01190.2_BraZ1	14200	-	1213	1842	1842	1.0000000
A04	684133	684832	A04p01200.2_BraZ1	273	+	578	699	699	1.0000000
A04	684898	685102	A04p01210.2_BraZ1	20.4	-	435	204	204	1.0000000
A04	687026	688551	A04p01220.2_BraZ1	984	+	954	1525	1525	1.0000000
A04	688722	694752	A04p01230.2_BraZ1	3579.37	-	1774	5422	6030	0.8991708
A04	695629	696648	A04p01240.2_BraZ1	4275	-	514	1019	1019	1.0000000
A04	699617	700505	A04p01250.2_BraZ1	510.125	+	575	888	888	1.0000000
A04	700687	702913	A04p01260.2_BraZ1	741.632	-	388	1677	2226	0.7533693
A04	715510	716246	A04p01270.2_BraZ1	503.438	+	308	736	736	1.0000000
A04	745328	745883	A04p01280.2_BraZ1	55.5	+	236	555	555	1.0000000
A04	748850	749849	A04p01290.2_BraZ1	453	-	0	0	999	0.0000000
A04	754345	755082	A04p01300.2_BraZ1	395	-	798	737	737	1.0000000
A04	756639	757093	A04p01310.2_BraZ1	222	+	49	344	454	0.7577093
A04	761980	762416	A04p01320.2_BraZ1	294	+	278	436	436	1.0000000
A04	762885	765067	A04p01330.2_BraZ1	1280.98	-	1184	2116	2182	0.9697526
A04	768176	772957	A04p01340.2_BraZ1	754.875	+	3079	4462	4781	0.9332775
A04	773291	774815	A04p01350.2_BraZ1	7318.5	-	1028	1397	1524	0.9166667
A04	777465	780090	A04p01360.2_BraZ1	1440.33	-	1132	2143	2625	0.8163810
A04	781929	784594	A04p01370.2_BraZ1	2184.92	+	638	1963	2665	0.7365854
A04	788432	788960	A04p01380.2_BraZ1	450	-	205	504	528	0.9545454
A04	790043	792412	A04p01390.2_BraZ1	1673.08	+	1018	2369	2369	1.0000000
A04	799289	801759	A04p01400.2_BraZ1	1352.7	+	1166	2470	2470	1.0000000
A04	803192	815525	A04p01410.2_BraZ1	7546.56	+	5556	11644	12333	0.9441336
A04	819946	820322	A04p01420.2_BraZ1	610.714	+	337	376	376	1.0000000
A04	821056	822549	A04p01430.2_BraZ1	1098	-	1460	1493	1493	1.0000000
A04	822984	829451	A04p01440.2_BraZ1	4986.78	-	1651	5589	6467	0.8642338
A04	832087	833501	A04p01450.2_BraZ1	562.411	+	1009	1305	1414	0.9229137
A04	833191	835208	A04p01460.2_BraZ1	656.111	+	1098	1894	2017	0.9390184
A04	836079	837258	A04p01470.2_BraZ1	617.839	+	864	1179	1179	1.0000000
A04	838799	840270	A04p01480.2_BraZ1	876.826	+	1020	1471	1471	1.0000000
A04	841138	843601	A04p01490.2_BraZ1	1366.44	-	949	2450	2463	0.9947219
A04	849613	850428	A04p01500.2_BraZ1	216	+	565	815	815	1.0000000
A04	860772	863262	A04p01510.2_BraZ1	1007	-	1423	2490	2490	1.0000000
A04	868497	869450	A04p01520.2_BraZ1	480.125	+	858	953	953	1.0000000
A04	870308	873689	A04p01530.2_BraZ1	1901.33	-	1544	3169	3381	0.9372966
A04	874652	880281	A04p01540.2_BraZ1	3672.8	+	3805	5521	5629	0.9808136
A04	882463	882904	A04p01550.2_BraZ1	44.1	-	0	0	441	0.0000000
A04	890688	891201	A04p01560.2_BraZ1	51.3	-	170	513	513	1.0000000
A04	897738	902693	A04p01570.2_BraZ1	285	-	3988	4923	4955	0.9935419
A04	904190	905413	A04p01580.2_BraZ1	957	+	86	151	1223	0.1234669
A04	906125	906656	A04p01590.2_BraZ1	53.1	+	0	0	531	0.0000000
A04	912799	914174	A04p01600.2_BraZ1	715.875	+	731	1375	1375	1.0000000
A04	915545	924597	A04p01610.2_BraZ1	503.7	-	4944	8824	9052	0.9748122
A04	932153	933806	A04p01620.2_BraZ1	165.3	+	1095	1653	1653	1.0000000
A04	934468	934699	A04p01630.2_BraZ1	159	-	160	231	231	1.0000000
A04	937040	938078	A04p01640.2_BraZ1	657	+	0	0	1038	0.0000000
A04	941477	943268	A04p01650.2_BraZ1	628.571	-	1342	1723	1791	0.9620324
A04	943734	944724	A04p01660.2_BraZ1	96.6	-	732	990	990	1.0000000
A04	962400	963249	A04p01670.2_BraZ1	84.9	-	660	849	849	1.0000000
A04	965536	967120	A04p01680.2_BraZ1	1053.09	-	1224	1391	1584	0.8781565
A04	968609	969950	A04p01690.2_BraZ1	134.1	-	693	1341	1341	1.0000000
A04	971415	971643	A04p01700.2_BraZ1	19.8	+	244	208	228	0.9122807
A04	986409	987316	A04p01710.2_BraZ1	822	+	622	904	907	0.9966924
A04	989272	990626	A04p01720.2_BraZ1	432	-	50	81	1354	0.0598227
A04	995808	996147	A04p01730.2_BraZ1	33.9	+	96	339	339	1.0000000
A04	997244	998590	A04p01740.2_BraZ1	9405	-	17	108	1346	0.0802377
A04	1014069	1014477	A04p01750.2_BraZ1	40.8	-	11	42	408	0.1029412
A04	1014603	1015527	A04p01760.2_BraZ1	777	-	19	79	924	0.0854978
A04	1016673	1018021	A04p01770.2_BraZ1	742.56	-	836	1348	1348	1.0000000
A04	1020802	1022139	A04p01780.2_BraZ1	709.19	-	574	1328	1337	0.9932685
A04	1023869	1025259	A04p01790.2_BraZ1	748.913	-	182	1246	1390	0.8964029
A04	1029333	1030641	A04p01800.2_BraZ1	763.25	-	364	1252	1308	0.9571865
A04	1037511	1039558	A04p01810.2_BraZ1	189.9	+	2201	2035	2047	0.9941378
A04	1040306	1049330	A04p01820.2_BraZ1	544.259	+	4064	8564	9024	0.9490248
A04	1049296	1050106	A04p01830.2_BraZ1	393.722	+	801	810	810	1.0000000
A04	1051791	1055242	A04p01840.2_BraZ1	2504.23	+	1912	3425	3451	0.9924660
A04	1057646	1062931	A04p01850.2_BraZ1	2504.91	-	1830	4173	5285	0.7895932
A04	1065826	1068734	A04p01860.2_BraZ1	2146.79	+	2813	2908	2908	1.0000000
A04	1069093	1071405	A04p01870.2_BraZ1	1435.54	-	1923	2312	2312	1.0000000
A04	1071780	1072550	A04p01880.2_BraZ1	414	+	18	380	770	0.4935065
A04	1072991	1074573	A04p01890.2_BraZ1	994.95	-	1907	1582	1582	1.0000000
A04	1075785	1077639	A04p01900.2_BraZ1	1029.25	-	613	1410	1854	0.7605178
A04	1080051	1081815	A04p01910.2_BraZ1	621	+	883	1755	1764	0.9948980
A04	1082632	1085043	A04p01920.2_BraZ1	812.497	-	1500	2239	2411	0.9286603
A04	1087311	1087984	A04p01930.2_BraZ1	352.038	-	629	673	673	1.0000000
A04	1088825	1089835	A04p01940.2_BraZ1	939	+	1021	1010	1010	1.0000000
A04	1090293	1096332	A04p01950.2_BraZ1	4453.19	-	2678	5532	6039	0.9160457
A04	1100370	1101255	A04p01960.2_BraZ1	88.5	-	466	885	885	1.0000000
A04	1103177	1107562	A04p01970.2_BraZ1	1767.54	+	3163	4018	4385	0.9163056
A04	1109095	1109491	A04p01980.2_BraZ1	39.3	+	161	396	396	1.0000000
A04	1110436	1111449	A04p01990.2_BraZ1	423.225	-	1090	1013	1013	1.0000000
A04	1112047	1112402	A04p02000.2_BraZ1	147	-	1438	355	355	1.0000000
A04	1115378	1119081	A04p02010.2_BraZ1	1644.89	-	323	2432	3703	0.6567648
A04	1125939	1130075	A04p02020.2_BraZ1	339.978	-	1124	3771	4136	0.9117505
A04	1126623	1127064	A04p02030.2_BraZ1	44.1	+	409	441	441	1.0000000
A04	1130864	1133614	A04p02040.2_BraZ1	1529.88	-	1126	2613	2750	0.9501818
A04	1138136	1145121	A04p02050.2_BraZ1	1558.89	-	2574	3500	6985	0.5010737
A04	1146901	1150383	A04p02060.2_BraZ1	1337.25	-	2946	3335	3482	0.9577829
A04	1152648	1153101	A04p02070.2_BraZ1	44.1	-	181	453	453	1.0000000
A04	1163435	1165607	A04p02080.2_BraZ1	1319.28	+	1389	2172	2172	1.0000000
A04	1166928	1168254	A04p02090.2_BraZ1	132.6	+	747	1326	1326	1.0000000
A04	1169724	1175399	A04p02100.2_BraZ1	1331.46	+	2426	5330	5675	0.9392071
A04	1183944	1186183	A04p02110.2_BraZ1	864.882	+	423	1905	2239	0.8508263
A04	1187837	1188317	A04p02120.2_BraZ1	48	+	227	425	480	0.8854167
A04	1190249	1192472	A04p02130.2_BraZ1	963.409	+	2522	2223	2223	1.0000000
A04	1195220	1197847	A04p02140.2_BraZ1	1495.03	+	367	2291	2627	0.8720974
A04	1201713	1202133	A04p02150.2_BraZ1	42	+	23	420	420	1.0000000
A04	1203058	1203733	A04p02160.2_BraZ1	67.5	-	122	316	675	0.4681481
A04	1206293	1207954	A04p02170.2_BraZ1	978	-	377	1454	1661	0.8753763
A04	1215948	1218028	A04p02180.2_BraZ1	1249.09	+	961	1950	2080	0.9375000
A04	1219127	1222045	A04p02190.2_BraZ1	1245.64	-	1647	2847	2918	0.9756683
A04	1223690	1226917	A04p02200.2_BraZ1	1805.65	+	1128	2688	3227	0.8329718
A04	1227308	1227908	A04p02210.2_BraZ1	2790	-	627	600	600	1.0000000
A04	1228490	1228695	A04p02220.2_BraZ1	15.9	-	54	195	205	0.9512195
A04	1229083	1230619	A04p02230.2_BraZ1	62.4	+	863	1536	1536	1.0000000
A04	1230988	1232930	A04p02240.2_BraZ1	879.822	-	707	1935	1942	0.9963955
A04	1239612	1241453	A04p02250.2_BraZ1	728.495	-	776	1840	1841	0.9994568
A04	1246177	1247742	A04p02260.2_BraZ1	753	+	1816	1546	1565	0.9878594
A04	1248387	1251267	A04p02270.2_BraZ1	1195.14	+	1756	2731	2880	0.9482639
A04	1256449	1258330	A04p02280.2_BraZ1	84	+	2853	1881	1881	1.0000000
A04	1258486	1262002	A04p02290.2_BraZ1	1323	+	5367	3516	3516	1.0000000
A04	1262808	1263142	A04p02300.2_BraZ1	234	+	273	334	334	1.0000000
A04	1263923	1265906	A04p02310.2_BraZ1	197.4	-	1958	1983	1983	1.0000000
A04	1268346	1275538	A04p02320.2_BraZ1	1013.79	+	3716	6359	7192	0.8841769
A04	1277578	1278232	A04p02330.2_BraZ1	315	-	627	654	654	1.0000000
A04	1280357	1281015	A04p02340.2_BraZ1	851.4	+	312	658	658	1.0000000
A04	1281921	1283429	A04p02350.2_BraZ1	1215.91	-	710	1475	1508	0.9781167
A04	1285472	1290365	A04p02360.2_BraZ1	3573.33	-	1733	4303	4893	0.8794196
A04	1295288	1296545	A04p02370.2_BraZ1	125.7	+	673	1207	1257	0.9602228
A04	1296672	1298057	A04p02380.2_BraZ1	583.337	-	1122	1385	1385	1.0000000
A04	1298280	1298388	A04p02390.2_BraZ1	10.8	+	104	108	108	1.0000000
A04	1298735	1300200	A04p02400.2_BraZ1	2337	+	1614	1465	1465	1.0000000
A04	1300342	1301772	A04p02410.2_BraZ1	2701.3	-	542	1393	1430	0.9741259
A04	1306638	1307261	A04p02420.2_BraZ1	513	+	42	425	623	0.6821830
A04	1313245	1316659	A04p02430.2_BraZ1	1044.75	+	3217	3414	3414	1.0000000
A04	1317258	1320313	A04p02440.2_BraZ1	1607.61	-	1658	3055	3055	1.0000000
A04	1321357	1323257	A04p02450.2_BraZ1	979.776	+	2481	1900	1900	1.0000000
A04	1329300	1329486	A04p02460.2_BraZ1	18.6	+	0	0	186	0.0000000
A04	1331535	1331808	A04p02470.2_BraZ1	27.3	-	82	273	273	1.0000000
A04	1339988	1341364	A04p02480.2_BraZ1	1317	+	359	1273	1376	0.9251453
A04	1343413	1344407	A04p02490.2_BraZ1	296.7	+	852	994	994	1.0000000
A04	1344999	1346404	A04p02500.2_BraZ1	799.524	-	1634	1405	1405	1.0000000
A04	1349042	1350653	A04p02510.2_BraZ1	1179.63	-	809	1611	1611	1.0000000
A04	1351716	1352028	A04p02520.2_BraZ1	562.5	+	500	312	312	1.0000000
A04	1352657	1354378	A04p02530.2_BraZ1	187.105	-	1790	1721	1721	1.0000000
A04	1356986	1357202	A04p02540.2_BraZ1	21.6	-	289	216	216	1.0000000
A04	1358421	1358789	A04p02550.2_BraZ1	231	-	303	368	368	1.0000000
A04	1361531	1367740	A04p02560.2_BraZ1	3095.75	+	3034	6048	6209	0.9740699
A04	1380621	1382981	A04p02570.2_BraZ1	1578	+	919	2300	2360	0.9745763
A04	1385635	1387249	A04p02580.2_BraZ1	3552	+	524	1596	1614	0.9888476
A04	1397259	1397673	A04p02590.2_BraZ1	41.4	+	31	57	414	0.1376812
A04	1406253	1409066	A04p02600.2_BraZ1	673.432	-	1351	2566	2813	0.9121934
A04	1414555	1417664	A04p02610.2_BraZ1	1231.96	-	2161	3058	3109	0.9835960
A04	1428778	1434080	A04p02620.2_BraZ1	1266.19	+	4279	5024	5302	0.9475669
A04	1434855	1435646	A04p02630.2_BraZ1	2754	+	333	791	791	1.0000000
A04	1437383	1438901	A04p02640.2_BraZ1	840	-	614	1453	1518	0.9571805
A04	1441215	1441461	A04p02650.2_BraZ1	24.6	-	590	246	246	1.0000000
A04	1443446	1444155	A04p02660.2_BraZ1	32460.8	-	682	709	709	1.0000000
A04	1445288	1446043	A04p02670.2_BraZ1	6220.5	-	1518	755	755	1.0000000
A04	1447656	1449656	A04p02680.2_BraZ1	803.338	+	2345	1960	2000	0.9800000
A04	1450850	1452047	A04p02690.2_BraZ1	119.7	-	1267	1197	1197	1.0000000
A04	1453161	1453891	A04p02700.2_BraZ1	201	-	678	730	730	1.0000000
A04	1454139	1457401	A04p02710.2_BraZ1	1693.71	-	1572	3233	3262	0.9911097
A04	1457899	1458053	A04p02720.2_BraZ1	13.8	+	106	154	154	1.0000000
A04	1462077	1463853	A04p02730.2_BraZ1	867.818	+	1640	1668	1776	0.9391892
A04	1465112	1467293	A04p02740.2_BraZ1	218.1	-	2202	2181	2181	1.0000000
A04	1468208	1469673	A04p02750.2_BraZ1	524.875	-	200	569	1465	0.3883959
A04	1477025	1477866	A04p02760.2_BraZ1	327.68	-	8	312	841	0.3709869
A04	1482982	1483145	A04p02770.2_BraZ1	47	-	60	163	163	1.0000000
A04	1484076	1487676	A04p02780.2_BraZ1	1490.85	+	2606	3600	3600	1.0000000
A04	1488634	1489342	A04p02790.2_BraZ1	504.6	+	548	708	708	1.0000000
A04	1490801	1493809	A04p02800.2_BraZ1	850.517	+	2345	2903	3008	0.9650931
A04	1495124	1497774	A04p02810.2_BraZ1	1494.23	-	1019	2532	2650	0.9554717
A04	1507190	1507792	A04p02820.2_BraZ1	619.667	+	890	602	602	1.0000000
A04	1508736	1511904	A04p02830.2_BraZ1	968.677	+	1989	2801	3168	0.8841540
A04	1512403	1513214	A04p02840.2_BraZ1	1111.8	+	689	811	811	1.0000000
A04	1521350	1522142	A04p02850.2_BraZ1	510	+	120	562	792	0.7095960
A04	1523652	1528456	A04p02860.2_BraZ1	1661.34	+	3841	4713	4804	0.9810575
A04	1529841	1530468	A04p02870.2_BraZ1	543	+	300	627	627	1.0000000
A04	1532779	1533940	A04p02880.2_BraZ1	636	+	316	1161	1161	1.0000000
A04	1534452	1534985	A04p02890.2_BraZ1	462	+	944	533	533	1.0000000
A04	1536198	1536384	A04p02900.2_BraZ1	18.6	+	187	186	186	1.0000000
A04	1539548	1540080	A04p02910.2_BraZ1	3969	+	108	412	532	0.7744361
A04	1540902	1541936	A04p02920.2_BraZ1	729	+	1423	1034	1034	1.0000000
A04	1561984	1562761	A04p02930.2_BraZ1	660	+	218	580	777	0.7464607
A04	1564517	1570785	A04p02940.2_BraZ1	3058.32	-	5513	6268	6268	1.0000000
A04	1587542	1588899	A04p02950.2_BraZ1	635.227	+	923	1357	1357	1.0000000
A04	1592076	1593994	A04p02960.2_BraZ1	1467	+	1754	1918	1918	1.0000000
A04	1594646	1595477	A04p02970.2_BraZ1	246	+	1123	831	831	1.0000000
A04	1595514	1598300	A04p02980.2_BraZ1	897	+	2616	2786	2786	1.0000000
A04	1605363	1607234	A04p02990.2_BraZ1	1009.03	+	462	1538	1871	0.8220203
A04	1608538	1610212	A04p03000.2_BraZ1	93.6	-	742	1674	1674	1.0000000
A04	1612133	1613448	A04p03010.2_BraZ1	301.091	+	74	95	1315	0.0722433
A04	1616521	1617430	A04p03020.2_BraZ1	876	-	451	909	909	1.0000000
A04	1620091	1621586	A04p03030.2_BraZ1	897	+	1081	1495	1495	1.0000000
A04	1622180	1622717	A04p03040.2_BraZ1	53.4	-	799	537	537	1.0000000
A04	1625402	1626443	A04p03050.2_BraZ1	104.1	+	823	1041	1041	1.0000000
A04	1627136	1628679	A04p03060.2_BraZ1	434.239	-	1443	1543	1543	1.0000000
A04	1629725	1630268	A04p03070.2_BraZ1	54.3	-	292	543	543	1.0000000
A04	1635844	1636651	A04p03080.2_BraZ1	405	+	479	807	807	1.0000000
A04	1638358	1639599	A04p03090.2_BraZ1	4495	+	740	1241	1241	1.0000000
A04	1640202	1641014	A04p03100.2_BraZ1	37.8	-	554	812	812	1.0000000
A04	1642213	1645699	A04p03110.2_BraZ1	1694.94	-	1146	3378	3486	0.9690189
A04	1651026	1653583	A04p03120.2_BraZ1	2481	+	1816	2557	2557	1.0000000
A04	1658176	1658446	A04p03130.2_BraZ1	177	+	620	270	270	1.0000000
A04	1678557	1683096	A04p03140.2_BraZ1	667.784	+	3407	3935	4539	0.8669310
A04	1694977	1697255	A04p03150.2_BraZ1	1686.07	+	2578	2265	2278	0.9942932
A04	1698377	1698590	A04p03160.2_BraZ1	21.3	+	451	213	213	1.0000000
A04	1699834	1706617	A04p03170.2_BraZ1	1443	+	7469	6349	6783	0.9360165
A04	1702718	1704149	A04p03180.2_BraZ1	357	+	1080	1383	1431	0.9664570
A04	1704604	1705718	A04p03190.2_BraZ1	982.5	-	614	949	1114	0.8518851
A04	1716521	1717074	A04p03200.2_BraZ1	362.917	-	43	488	553	0.8824593
A04	1717978	1718968	A04p03210.2_BraZ1	99	+	904	977	990	0.9868687
A04	1719600	1720617	A04p03220.2_BraZ1	101.7	-	395	989	1017	0.9724680
A04	1721684	1721870	A04p03230.2_BraZ1	18.6	-	0	0	186	0.0000000
A04	1729492	1729639	A04p03240.2_BraZ1	14.7	+	0	0	147	0.0000000
A04	1735977	1738029	A04p03250.2_BraZ1	1095	-	1046	1786	2052	0.8703704
A04	1761258	1761645	A04p03260.2_BraZ1	38.7	-	801	387	387	1.0000000
A04	1762029	1764819	A04p03270.2_BraZ1	835.762	-	3550	2790	2790	1.0000000
A04	1766919	1768986	A04p03280.2_BraZ1	1453.62	+	1932	2067	2067	1.0000000
A04	1769814	1770594	A04p03290.2_BraZ1	78	-	750	780	780	1.0000000
A04	1774224	1774464	A04p03300.2_BraZ1	171	-	340	240	240	1.0000000
A04	1782546	1783572	A04p03310.2_BraZ1	102.6	+	855	1026	1026	1.0000000
A04	1784753	1790153	A04p03320.2_BraZ1	958.182	-	3037	5110	5400	0.9462963
A04	1792933	1793780	A04p03330.2_BraZ1	768	-	146	390	847	0.4604487
A04	1795441	1795776	A04p03340.2_BraZ1	255	-	137	335	335	1.0000000
A04	1806057	1807250	A04p03350.2_BraZ1	624	+	447	1132	1193	0.9488684
A04	1807023	1807217	A04p03360.2_BraZ1	129	-	52	183	194	0.9432990
A04	1807748	1810735	A04p03370.2_BraZ1	411	-	1157	1756	2987	0.5878808
A04	1815762	1821990	A04p03380.2_BraZ1	2576.72	+	5503	5844	6228	0.9383430
A04	1822624	1822918	A04p03390.2_BraZ1	29.4	-	26	70	294	0.2380952
A04	1831998	1832403	A04p03400.2_BraZ1	180	+	72	204	405	0.5037037
A04	1836904	1837297	A04p03410.2_BraZ1	180	+	125	172	393	0.4376590
A04	1850982	1851597	A04p03420.2_BraZ1	138	+	202	615	615	1.0000000
A04	1851648	1852756	A04p03430.2_BraZ1	1389.75	+	136	1030	1108	0.9296029
A04	1852275	1852504	A04p03440.2_BraZ1	102	+	36	216	229	0.9432315
A04	1859119	1860463	A04p03450.2_BraZ1	134.4	-	999	1344	1344	1.0000000
A04	1867933	1869458	A04p03460.2_BraZ1	663.265	-	1313	1525	1525	1.0000000
A04	1874185	1878019	A04p03470.2_BraZ1	1162.53	+	3529	3834	3834	1.0000000
A04	1878220	1879352	A04p03480.2_BraZ1	820.125	-	866	1132	1132	1.0000000
A04	1879709	1882085	A04p03490.2_BraZ1	908.25	-	1185	2129	2376	0.8960438
A04	1881963	1897009	A04p03500.2_BraZ1	2314.24	-	8890	13804	15046	0.9174532
A04	1898259	1901143	A04p03510.2_BraZ1	1271.88	+	1880	2822	2884	0.9785021
A04	1901549	1902203	A04p03520.2_BraZ1	263.571	-	499	654	654	1.0000000
A04	1909898	1911019	A04p03530.2_BraZ1	1041	+	717	1121	1121	1.0000000
A04	1930175	1931363	A04p03540.2_BraZ1	1092	+	235	1185	1188	0.9974747
A04	1943631	1944580	A04p03550.2_BraZ1	72.9	+	990	949	949	1.0000000
A04	1950818	1951149	A04p03560.2_BraZ1	231	+	101	331	331	1.0000000
A04	1951149	1952467	A04p03570.2_BraZ1	519	+	206	1243	1318	0.9430956
A04	1963674	1964817	A04p03580.2_BraZ1	1029	+	793	1143	1143	1.0000000
A04	1972297	1977372	A04p03590.2_BraZ1	613.6	+	3376	5075	5075	1.0000000
A04	1981082	1982208	A04p03600.2_BraZ1	1552.5	+	260	1126	1126	1.0000000
A04	1986212	1987019	A04p03610.2_BraZ1	612	+	287	466	807	0.5774474
A04	1989260	1992028	A04p03620.2_BraZ1	1130.5	-	2105	2768	2768	1.0000000
A04	1996810	1997636	A04p03630.2_BraZ1	420	-	485	826	826	1.0000000
A04	2012777	2014820	A04p03640.2_BraZ1	4365	-	810	1952	2043	0.9554577
A04	2024591	2025773	A04p03650.2_BraZ1	118.2	-	819	1182	1182	1.0000000
A04	2027312	2033364	A04p03660.2_BraZ1	3698.55	+	1347	4648	6052	0.7680106
A04	2033973	2036608	A04p03670.2_BraZ1	1270.23	+	1038	2635	2635	1.0000000
A04	2037294	2038386	A04p03680.2_BraZ1	668.571	-	305	1065	1092	0.9752747
A04	2049122	2054600	A04p03690.2_BraZ1	296.125	-	719	4486	5478	0.8189120
A04	2061384	2061652	A04p03700.2_BraZ1	252	+	420	268	268	1.0000000
A04	2062049	2062529	A04p03710.2_BraZ1	48	-	731	480	480	1.0000000
A04	2063294	2064929	A04p03720.2_BraZ1	1110.06	+	769	1635	1635	1.0000000
A04	2067393	2070515	A04p03730.2_BraZ1	941.769	+	1729	3121	3122	0.9996797
A04	2071542	2074402	A04p03740.2_BraZ1	105.692	+	1842	2860	2860	1.0000000
A04	2077100	2077943	A04p03750.2_BraZ1	756	+	606	832	843	0.9869514
A04	2080357	2082022	A04p03760.2_BraZ1	1110.06	+	639	1629	1665	0.9783784
A04	2089576	2089918	A04p03770.2_BraZ1	231	+	382	342	342	1.0000000
A04	2090737	2091025	A04p03780.2_BraZ1	28.8	-	110	288	288	1.0000000
A04	2097704	2097902	A04p03790.2_BraZ1	19.8	+	107	198	198	1.0000000
A04	2100534	2108753	A04p03800.2_BraZ1	1227.67	+	2744	7183	8219	0.8739506
A04	2117206	2118048	A04p03810.2_BraZ1	753	+	158	697	842	0.8277910
A04	2119761	2120926	A04p03820.2_BraZ1	1542	+	345	1083	1165	0.9296137
A04	2121098	2124574	A04p03830.2_BraZ1	2246.46	-	1338	3122	3476	0.8981588
A04	2129409	2131055	A04p03840.2_BraZ1	8925	+	698	1554	1646	0.9441069
A04	2131260	2131808	A04p03850.2_BraZ1	357	-	276	490	548	0.8941606
A04	2132403	2133064	A04p03860.2_BraZ1	230.4	+	678	661	661	1.0000000
A04	2135940	2136602	A04p03870.2_BraZ1	477	+	480	662	662	1.0000000
A04	2138602	2139304	A04p03880.2_BraZ1	70.2	-	477	702	702	1.0000000
A04	2146311	2148224	A04p03890.2_BraZ1	109.2	+	2522	1913	1913	1.0000000
A04	2149230	2150515	A04p03900.2_BraZ1	785.9	+	1243	1285	1285	1.0000000
A04	2151436	2151997	A04p03910.2_BraZ1	255	+	591	561	561	1.0000000
A04	2153410	2156140	A04p03920.2_BraZ1	258.3	-	3020	2730	2730	1.0000000
A04	2159192	2161142	A04p03930.2_BraZ1	8883	+	1688	1950	1950	1.0000000
A04	2163278	2164445	A04p03940.2_BraZ1	57	+	774	1167	1167	1.0000000
A04	2165208	2166646	A04p03950.2_BraZ1	699	+	525	1228	1438	0.8539639
A04	2183860	2187182	A04p03960.2_BraZ1	1610.18	+	2670	3216	3322	0.9680915
A04	2193962	2194427	A04p03970.2_BraZ1	46.5	+	191	417	465	0.8967742
A04	2196788	2197274	A04p03980.2_BraZ1	48.6	+	467	486	486	1.0000000
A04	2205507	2207930	A04p03990.2_BraZ1	1278.01	+	503	1947	2423	0.8035493
A04	2212290	2213730	A04p04000.2_BraZ1	420	-	70	848	1440	0.5888889
A04	2217461	2221228	A04p04010.2_BraZ1	677.144	+	1305	3137	3767	0.8327582
A04	2221667	2223212	A04p04020.2_BraZ1	920.143	-	1430	1545	1545	1.0000000
A04	2232486	2232897	A04p04030.2_BraZ1	41.1	+	213	385	411	0.9367397
A04	2235385	2236906	A04p04040.2_BraZ1	1317	+	2497	1521	1521	1.0000000
A04	2237115	2238573	A04p04050.2_BraZ1	757.174	-	1231	1458	1458	1.0000000
A04	2247553	2247869	A04p04060.2_BraZ1	138	+	483	316	316	1.0000000
A04	2248445	2248601	A04p04070.2_BraZ1	15.6	+	447	156	156	1.0000000
A04	2259561	2261301	A04p04080.2_BraZ1	991.37	+	60	1085	1740	0.6235632
A04	2262036	2262402	A04p04090.2_BraZ1	36.6	+	136	349	366	0.9535519
A04	2262913	2265228	A04p04100.2_BraZ1	1336.23	-	2750	2315	2315	1.0000000
A04	2267090	2268809	A04p04110.2_BraZ1	579	-	1890	1719	1719	1.0000000
A04	2270450	2270744	A04p04120.2_BraZ1	29.4	+	0	0	294	0.0000000
A04	2275172	2280132	A04p04130.2_BraZ1	1309	+	5055	4960	4960	1.0000000
A04	2288800	2289133	A04p04140.2_BraZ1	33.3	-	433	333	333	1.0000000
A04	2290150	2291341	A04p04150.2_BraZ1	447.429	-	1138	1184	1191	0.9941226
A04	2297632	2298602	A04p04160.2_BraZ1	442.783	+	522	970	970	1.0000000
A04	2308780	2310101	A04p04170.2_BraZ1	858	+	762	1321	1321	1.0000000
A04	2313679	2315228	A04p04180.2_BraZ1	784.808	-	489	1549	1549	1.0000000
A04	2321428	2321930	A04p04190.2_BraZ1	474	+	574	502	502	1.0000000
A04	2322670	2323450	A04p04200.2_BraZ1	358.4	-	416	755	780	0.9679487
A04	2330210	2330600	A04p04210.2_BraZ1	39	-	118	390	390	1.0000000
A04	2334622	2335303	A04p04220.2_BraZ1	68.1	-	495	681	681	1.0000000
A04	2335628	2336826	A04p04230.2_BraZ1	390.964	+	672	1198	1198	1.0000000
A04	2345629	2345825	A04p04240.2_BraZ1	13.2	+	162	196	196	1.0000000
A04	2346207	2348414	A04p04250.2_BraZ1	1329.46	+	582	1975	2207	0.8948799
A04	2362120	2362362	A04p04260.2_BraZ1	159	+	275	242	242	1.0000000
A04	2362626	2363499	A04p04270.2_BraZ1	87.3	-	499	873	873	1.0000000
A04	2364754	2365219	A04p04280.2_BraZ1	4126.5	+	826	465	465	1.0000000
A04	2365642	2366842	A04p04290.2_BraZ1	3520.88	-	727	1200	1200	1.0000000
A04	2369024	2369186	A04p04300.2_BraZ1	16.2	+	154	162	162	1.0000000
A04	2369259	2369963	A04p04310.2_BraZ1	1057	+	479	704	704	1.0000000
A04	2374373	2375015	A04p04320.2_BraZ1	533.52	+	623	642	642	1.0000000
A04	2376478	2377127	A04p04330.2_BraZ1	60.06	+	544	649	649	1.0000000
A04	2377081	2379966	A04p04340.2_BraZ1	222	+	3123	2885	2885	1.0000000
A04	2380582	2381717	A04p04350.2_BraZ1	425.455	-	547	1029	1135	0.9066079
A04	2393436	2393991	A04p04360.2_BraZ1	55.5	+	509	555	555	1.0000000
A04	2396155	2397821	A04p04370.2_BraZ1	783.457	+	1840	1666	1666	1.0000000
A04	2398627	2399236	A04p04380.2_BraZ1	60.9	+	287	609	609	1.0000000
A04	2402739	2403545	A04p04390.2_BraZ1	615	-	559	780	806	0.9677419
A04	2405291	2406164	A04p04400.2_BraZ1	87.3	+	204	873	873	1.0000000
A04	2407104	2407338	A04p04410.2_BraZ1	222	+	841	234	234	1.0000000
A04	2407338	2408661	A04p04420.2_BraZ1	1059	-	1120	1323	1323	1.0000000
A04	2418826	2421245	A04p04430.2_BraZ1	2811.6	+	548	2369	2419	0.9793303
A04	2423576	2424018	A04p04440.2_BraZ1	27	+	428	442	442	1.0000000
A04	2424999	2427348	A04p04450.2_BraZ1	1692.75	+	2147	2349	2349	1.0000000
A04	2428639	2429138	A04p04460.2_BraZ1	192	+	795	499	499	1.0000000
A04	2431294	2433513	A04p04470.2_BraZ1	1101.31	+	1559	2214	2219	0.9977467
A04	2434712	2435426	A04p04480.2_BraZ1	612	-	682	714	714	1.0000000
A04	2435850	2439030	A04p04490.2_BraZ1	2283.54	-	1304	3154	3180	0.9918239
A04	2442433	2444542	A04p04500.2_BraZ1	630	-	1648	2091	2109	0.9914652
A04	2449250	2451763	A04p04510.2_BraZ1	743.388	+	1439	2155	2513	0.8575408
A04	2456439	2457134	A04p04520.2_BraZ1	326.455	+	717	695	695	1.0000000
A04	2460467	2461645	A04p04530.2_BraZ1	55.8	-	1054	1178	1178	1.0000000
A04	2470545	2470853	A04p04540.2_BraZ1	216	+	23	263	308	0.8538961
A04	2472181	2472547	A04p04550.2_BraZ1	252	+	0	0	366	0.0000000
A04	2478515	2482733	A04p04560.2_BraZ1	1101	+	1289	3487	4218	0.8266951
A04	2493270	2494517	A04p04570.2_BraZ1	567.614	-	114	142	1247	0.1138733
A04	2495746	2495935	A04p04580.2_BraZ1	18.9	-	0	0	189	0.0000000
A04	2497328	2498518	A04p04590.2_BraZ1	292.5	+	276	1169	1190	0.9823529
A04	2510580	2513275	A04p04600.2_BraZ1	1154.18	+	1929	2690	2695	0.9981447
A04	2514692	2517969	A04p04610.2_BraZ1	1615.6	+	3374	3243	3277	0.9896247
A04	2518283	2518666	A04p04620.2_BraZ1	88.8	-	316	383	383	1.0000000
A04	2519088	2520991	A04p04630.2_BraZ1	990.738	-	155	1429	1903	0.7509196
A04	2533439	2536602	A04p04640.2_BraZ1	507.382	-	1903	3073	3163	0.9715460
A04	2538326	2540632	A04p04650.2_BraZ1	1226.92	-	1148	2165	2306	0.9388552
A04	2553809	2554256	A04p04660.2_BraZ1	243	+	40	299	447	0.6689038
A04	2554295	2554624	A04p04670.2_BraZ1	243	+	8	31	329	0.0942249
A04	2560171	2560291	A04p04680.2_BraZ1	12	-	3	120	120	1.0000000
A04	2591455	2598480	A04p04690.2_BraZ1	1264.4	-	1131	4528	7025	0.6445552
A04	2607613	2608688	A04p04700.2_BraZ1	6150	-	791	1075	1075	1.0000000
A04	2612142	2612687	A04p04710.2_BraZ1	459	-	966	545	545	1.0000000
A04	2613787	2614300	A04p04720.2_BraZ1	51.3	-	721	513	513	1.0000000
A04	2618563	2618842	A04p04730.2_BraZ1	27.9	-	251	279	279	1.0000000
A04	2621138	2622156	A04p04740.2_BraZ1	396.121	-	666	992	1018	0.9744597
A04	2628618	2630174	A04p04750.2_BraZ1	721.893	-	1360	1525	1556	0.9800771
A04	2634128	2634684	A04p04760.2_BraZ1	321	+	513	556	556	1.0000000
A04	2645194	2649532	A04p04770.2_BraZ1	2103.16	+	2828	4335	4338	0.9993084
A04	2649899	2651470	A04p04780.2_BraZ1	8025.75	-	943	1571	1571	1.0000000
A04	2662392	2665014	A04p04790.2_BraZ1	441.15	-	356	1552	2622	0.5919146
A04	2665709	2666015	A04p04800.2_BraZ1	27.6	+	456	306	306	1.0000000
A04	2671052	2671613	A04p04810.2_BraZ1	123	+	211	553	561	0.9857398
A04	2671696	2672620	A04p04820.2_BraZ1	92.4	+	63	766	924	0.8290043
A04	2681406	2682123	A04p04830.2_BraZ1	71.7	-	9	105	717	0.1464435
A04	2690247	2690663	A04p04840.2_BraZ1	36.6	+	12	416	416	1.0000000
A04	2698215	2700264	A04p04850.2_BraZ1	204.6	+	572	1947	2049	0.9502196
A04	2703376	2703643	A04p04860.2_BraZ1	26.7	-	91	267	267	1.0000000
A04	2713823	2715328	A04p04870.2_BraZ1	928.2	-	1270	1438	1505	0.9554817
A04	2728910	2730245	A04p04880.2_BraZ1	796.05	+	439	1215	1335	0.9101124
A04	2730860	2730962	A04p04890.2_BraZ1	10.2	-	344	102	102	1.0000000
A04	2731736	2733214	A04p04900.2_BraZ1	465	-	1050	1426	1478	0.9648173
A04	2733991	2736049	A04p04910.2_BraZ1	810.833	-	1587	2058	2058	1.0000000
A04	2740111	2741808	A04p04920.2_BraZ1	1029.6	-	742	1627	1697	0.9587507
A04	2744570	2746742	A04p04930.2_BraZ1	805.263	-	1508	2041	2172	0.9396870
A04	2749652	2751499	A04p04940.2_BraZ1	582.604	-	1265	1813	1847	0.9815918
A04	2753130	2755625	A04p04950.2_BraZ1	453	-	4027	2495	2495	1.0000000
A04	2757103	2758994	A04p04960.2_BraZ1	1356	+	1140	1780	1891	0.9413009
A04	2763080	2763746	A04p04970.2_BraZ1	66.6	-	205	666	666	1.0000000
A04	2766346	2766873	A04p04980.2_BraZ1	459	+	849	527	527	1.0000000
A04	2773610	2776506	A04p04990.2_BraZ1	1281.34	+	2700	2896	2896	1.0000000
A04	2776879	2777068	A04p05000.2_BraZ1	18.9	+	293	189	189	1.0000000
A04	2781922	2783023	A04p05010.2_BraZ1	513.45	-	979	1101	1101	1.0000000
A04	2796686	2798392	A04p05020.2_BraZ1	12636	-	47	619	1706	0.3628370
A04	2816393	2816978	A04p05030.2_BraZ1	454.5	-	400	585	585	1.0000000
A04	2820255	2820604	A04p05040.2_BraZ1	19.8	+	47	324	349	0.9283668
A04	2824117	2825686	A04p05050.2_BraZ1	672.398	+	932	1394	1569	0.8884640
A04	2828212	2834173	A04p05060.2_BraZ1	3822.73	+	2503	5586	5961	0.9370911
A04	2834333	2835456	A04p05070.2_BraZ1	2137.5	-	106	990	1123	0.8815672
A04	2838595	2839273	A04p05080.2_BraZ1	67.8	-	244	643	678	0.9483776
A04	2846443	2847551	A04p05090.2_BraZ1	855	-	23	544	1108	0.4909747
A04	2848355	2848514	A04p05100.2_BraZ1	15.9	+	124	151	159	0.9496855
A04	2856525	2857071	A04p05110.2_BraZ1	1050	-	0	0	546	0.0000000
A04	2864835	2865140	A04p05120.2_BraZ1	141	-	87	305	305	1.0000000
A04	2868926	2870306	A04p05130.2_BraZ1	855	-	77	942	1380	0.6826087
A04	2878166	2879281	A04p05140.2_BraZ1	855	-	132	937	1115	0.8403587
A04	2888627	2889147	A04p05150.2_BraZ1	36.9	-	178	520	520	1.0000000
A04	2895942	2898373	A04p05160.2_BraZ1	2133	-	1534	2184	2431	0.8983957
A04	2902167	2905702	A04p05170.2_BraZ1	1664.24	-	1626	3448	3535	0.9753889
A04	2906604	2908075	A04p05180.2_BraZ1	837	-	1113	1458	1471	0.9911625
A04	2916130	2916849	A04p05190.2_BraZ1	288	+	918	719	719	1.0000000
A04	2917815	2918754	A04p05200.2_BraZ1	93.9	-	572	939	939	1.0000000
A04	2923007	2925647	A04p05210.2_BraZ1	930.24	-	1289	2552	2640	0.9666666
A04	2931692	2933594	A04p05220.2_BraZ1	190.2	+	275	1741	1902	0.9153523
A04	2933810	2935314	A04p05230.2_BraZ1	938.538	-	810	1458	1504	0.9694149
A04	2936189	2936399	A04p05240.2_BraZ1	21	+	0	0	210	0.0000000
A04	2937334	2937849	A04p05250.2_BraZ1	213	+	16	245	515	0.4757282
A04	2938389	2938973	A04p05260.2_BraZ1	468	+	14	126	584	0.2157534
A04	2947437	2949849	A04p05270.2_BraZ1	2169	+	339	1077	2412	0.4465174
A04	2969269	2972760	A04p05280.2_BraZ1	832.5	+	568	894	3491	0.2560871
A04	3004196	3005335	A04p05290.2_BraZ1	652.667	+	342	996	1139	0.8744513
A04	3006927	3008113	A04p05300.2_BraZ1	322	+	521	1143	1186	0.9637437
A04	3019979	3020774	A04p05310.2_BraZ1	79.5	-	34	330	795	0.4150943
A04	3023535	3025690	A04p05320.2_BraZ1	151.8	+	290	1559	2155	0.7234339
A04	3037211	3039311	A04p05330.2_BraZ1	210	+	230	967	2100	0.4604762
A04	3058222	3065952	A04p05340.2_BraZ1	3284.4	+	3075	6464	7730	0.8362225
A04	3067590	3069894	A04p05350.2_BraZ1	1117.82	-	1037	2209	2304	0.9587674
A04	3072096	3073331	A04p05360.2_BraZ1	1149	+	75	643	1235	0.5206478
A04	3074289	3075908	A04p05370.2_BraZ1	720.36	-	405	1514	1619	0.9351451
A04	3085331	3087552	A04p05380.2_BraZ1	1256.51	-	210	563	2221	0.2534894
A04	3092832	3093287	A04p05390.2_BraZ1	336	-	0	0	455	0.0000000
A04	3120142	3122316	A04p05400.2_BraZ1	603	-	1	56	2174	0.0257590
A04	3127395	3127850	A04p05410.2_BraZ1	336	-	0	0	455	0.0000000
A04	3161985	3162440	A04p05420.2_BraZ1	336	-	0	0	455	0.0000000
A04	3189315	3196795	A04p05430.2_BraZ1	2380.44	-	2045	5586	7480	0.7467914
A04	3198371	3201726	A04p05440.2_BraZ1	522	-	1459	3096	3355	0.9228018
A04	3203015	3206311	A04p05450.2_BraZ1	1404.24	+	1312	2848	3296	0.8640777
A04	3211843	3214833	A04p05460.2_BraZ1	336	+	981	2990	2990	1.0000000
A04	3214874	3215706	A04p05470.2_BraZ1	5796	-	100	799	832	0.9603366
A04	3217430	3227509	A04p05480.2_BraZ1	486	-	4989	9459	10079	0.9384860
A04	3229505	3230314	A04p05490.2_BraZ1	576	-	302	809	809	1.0000000
A04	3231676	3232790	A04p05500.2_BraZ1	533.333	-	630	1114	1114	1.0000000
A04	3233611	3233995	A04p05510.2_BraZ1	171	+	354	384	384	1.0000000
A04	3238077	3239854	A04p05520.2_BraZ1	12507	-	514	1117	1777	0.6285875
A04	3257062	3260842	A04p05530.2_BraZ1	2076.54	-	623	3299	3780	0.8727513
A04	3271151	3273528	A04p05540.2_BraZ1	2168.8	+	354	1844	2377	0.7757678
A04	3274818	3276996	A04p05550.2_BraZ1	217.8	-	183	1183	2178	0.5431589
A04	3278618	3280513	A04p05560.2_BraZ1	713.175	+	904	1895	1895	1.0000000
A04	3291417	3293829	A04p05570.2_BraZ1	2172	+	304	1324	2412	0.5489221
A04	3301861	3303237	A04p05580.2_BraZ1	1396.5	-	1193	1376	1376	1.0000000
A04	3311046	3312226	A04p05590.2_BraZ1	273	+	845	1180	1180	1.0000000
A04	3313202	3314093	A04p05600.2_BraZ1	89.1	-	21	469	891	0.5263749
A04	3314872	3317827	A04p05610.2_BraZ1	1932.29	+	516	2550	2955	0.8629442
A04	3318315	3320570	A04p05620.2_BraZ1	762.164	-	215	1424	2255	0.6314856
A04	3325329	3328880	A04p05630.2_BraZ1	1492.21	+	550	3133	3551	0.8822867
A04	3329834	3332347	A04p05640.2_BraZ1	1157.61	-	812	2347	2513	0.9339435
A04	3334124	3335738	A04p05650.2_BraZ1	161.4	+	455	1405	1614	0.8705081
A04	3336523	3337721	A04p05660.2_BraZ1	1983.15	-	573	1198	1198	1.0000000
A04	3344282	3348088	A04p05670.2_BraZ1	1512.25	+	1520	3104	3806	0.8155544
A04	3349205	3352845	A04p05680.2_BraZ1	1167.2	+	1092	3305	3640	0.9079670
A04	3365384	3366434	A04p05690.2_BraZ1	252	+	885	1050	1050	1.0000000
A04	3381825	3392641	A04p05700.2_BraZ1	1618.37	+	4117	7823	10816	0.7232803
A04	3399450	3403346	A04p05710.2_BraZ1	1531.71	-	1359	3554	3896	0.9122177
A04	3406755	3407566	A04p05720.2_BraZ1	1728	-	1290	811	811	1.0000000
A04	3414077	3414254	A04p05730.2_BraZ1	17.7	-	122	177	177	1.0000000
A04	3417045	3417207	A04p05740.2_BraZ1	16.2	-	59	162	162	1.0000000
A04	3421417	3423368	A04p05750.2_BraZ1	1562.79	+	1265	1936	1951	0.9923117
A04	3424274	3426065	A04p05760.2_BraZ1	179.1	-	669	1790	1791	0.9994416
A04	3444847	3445836	A04p05770.2_BraZ1	417	+	786	957	989	0.9676441
A04	3445904	3446513	A04p05780.2_BraZ1	396	+	903	609	609	1.0000000
A04	3447656	3449338	A04p05790.2_BraZ1	611.455	-	765	1586	1682	0.9429251
A04	3450389	3452826	A04p05800.2_BraZ1	728.027	+	1051	2393	2437	0.9819450
A04	3453628	3455568	A04p05810.2_BraZ1	1364.55	+	596	1884	1940	0.9711340
A04	3456207	3461525	A04p05820.2_BraZ1	3409.71	+	1188	3218	5318	0.6051147
A04	3470410	3479030	A04p05830.2_BraZ1	3382.47	+	3397	8060	8620	0.9350348
A04	3475052	3475514	A04p05840.2_BraZ1	46.2	-	37	411	462	0.8896104
A04	3479584	3480478	A04p05850.2_BraZ1	309	-	1135	876	894	0.9798658
A04	3482106	3483842	A04p05860.2_BraZ1	1207.5	+	872	1736	1736	1.0000000
A04	3485056	3485763	A04p05870.2_BraZ1	355.091	-	212	650	707	0.9193776
A04	3487132	3497601	A04p05880.2_BraZ1	1261.96	+	1421	4508	10469	0.4306046
A04	3507042	3509227	A04p05890.2_BraZ1	2619	-	305	1295	2185	0.5926774
A04	3509239	3509662	A04p05900.2_BraZ1	451.5	-	22	386	423	0.9125295
A04	3511378	3514457	A04p05910.2_BraZ1	1261.76	+	1499	2725	3079	0.8850276
A04	3515678	3517428	A04p05920.2_BraZ1	628.977	+	1207	1703	1750	0.9731429
A04	3519161	3520937	A04p05930.2_BraZ1	734.062	+	2076	1776	1776	1.0000000
A04	3525678	3526921	A04p05940.2_BraZ1	934.286	+	1595	1228	1243	0.9879324
A04	3527565	3527857	A04p05950.2_BraZ1	228	-	177	292	292	1.0000000
A04	3528640	3529038	A04p05960.2_BraZ1	237	-	330	398	398	1.0000000
A04	3530721	3536227	A04p05970.2_BraZ1	1738.26	+	4687	5494	5506	0.9978206
A04	3540398	3543684	A04p05980.2_BraZ1	1297.25	+	3832	3286	3286	1.0000000
A04	3544201	3545491	A04p05990.2_BraZ1	1041	-	173	834	1290	0.6465116
A04	3551312	3551444	A04p06000.2_BraZ1	13.2	+	80	132	132	1.0000000
A04	3559967	3560569	A04p06010.2_BraZ1	34.2	+	263	524	602	0.8704319
A04	3561011	3566012	A04p06020.2_BraZ1	159	+	2273	4501	5001	0.9000200
A04	3561073	3561504	A04p06030.2_BraZ1	1647	+	42	227	431	0.5266821
A04	3577413	3578331	A04p06040.2_BraZ1	91.8	+	219	881	918	0.9596950
A04	3587076	3588416	A04p06050.2_BraZ1	4872	+	727	1132	1340	0.8447761
A04	3597296	3599283	A04p06060.2_BraZ1	1370.03	+	943	1921	1987	0.9667841
A04	3599746	3602005	A04p06070.2_BraZ1	915	-	1228	2246	2259	0.9942452
A04	3610343	3612058	A04p06080.2_BraZ1	933	+	1077	1715	1715	1.0000000
A04	3613934	3616754	A04p06090.2_BraZ1	1327.5	+	1475	2715	2820	0.9627659
A04	3623814	3624546	A04p06100.2_BraZ1	2867.5	-	500	727	732	0.9931694
A04	3627971	3629104	A04p06110.2_BraZ1	849	+	1172	1133	1133	1.0000000
A04	3629298	3630375	A04p06120.2_BraZ1	202.895	+	397	971	1077	0.9015785
A04	3630580	3633087	A04p06130.2_BraZ1	893.764	-	538	2129	2507	0.8492222
A04	3640430	3642498	A04p06140.2_BraZ1	1298	-	1135	2014	2068	0.9738878
A04	3644591	3646123	A04p06150.2_BraZ1	618.955	+	37	753	1532	0.4915144
A04	3647426	3647655	A04p06160.2_BraZ1	12.6	-	230	229	229	1.0000000
A04	3651495	3653035	A04p06170.2_BraZ1	3939	+	152	1024	1540	0.6649351
A04	3657883	3658650	A04p06180.2_BraZ1	1404	+	219	684	767	0.8917862
A04	3661610	3662777	A04p06190.2_BraZ1	444	+	2675	1167	1167	1.0000000
A04	3663039	3665957	A04p06200.2_BraZ1	1417.3	-	1840	2738	2918	0.9383139
A04	3673687	3680829	A04p06210.2_BraZ1	1875.79	-	4405	6833	7142	0.9567348
A04	3686014	3687317	A04p06220.2_BraZ1	649.031	-	1169	1303	1303	1.0000000
A04	3692988	3693303	A04p06230.2_BraZ1	31.5	-	200	315	315	1.0000000
A04	3696098	3697285	A04p06240.2_BraZ1	4890	+	152	484	1187	0.4077506
A04	3699021	3699639	A04p06250.2_BraZ1	390	+	254	580	618	0.9385113
A04	3715280	3717884	A04p06260.2_BraZ1	1685.27	+	312	1464	2604	0.5622120
A04	3718838	3720928	A04p06270.2_BraZ1	983.926	+	1462	2090	2090	1.0000000
A04	3721430	3729672	A04p06280.2_BraZ1	1958	-	5418	6118	8242	0.7422956
A04	3733567	3733726	A04p06290.2_BraZ1	15.9	+	321	159	159	1.0000000
A04	3737039	3741060	A04p06300.2_BraZ1	889.476	+	2286	3703	4021	0.9209152
A04	3742755	3743388	A04p06310.2_BraZ1	465	+	709	633	633	1.0000000
A04	3743875	3746732	A04p06320.2_BraZ1	1021.91	-	2320	2764	2857	0.9674484
A04	3749262	3749397	A04p06330.2_BraZ1	13.5	-	5	119	135	0.8814815
A04	3752185	3752556	A04p06340.2_BraZ1	141	-	122	370	371	0.9973046
A04	3761981	3762401	A04p06350.2_BraZ1	42	-	11	213	420	0.5071428
A04	3767100	3767421	A04p06360.2_BraZ1	32.1	+	345	321	321	1.0000000
A04	3768751	3769024	A04p06370.2_BraZ1	153	-	373	273	273	1.0000000
A04	3773963	3775784	A04p06380.2_BraZ1	1114.64	+	483	1729	1821	0.9494783
A04	3777653	3778974	A04p06390.2_BraZ1	768	-	63	922	1321	0.6979561
A04	3780039	3780520	A04p06400.2_BraZ1	369	-	30	131	481	0.2723493
A04	3786486	3787725	A04p06410.2_BraZ1	42.9	+	0	0	1239	0.0000000
A04	3787806	3788566	A04p06420.2_BraZ1	36.6	-	1	72	760	0.0947368
A04	3788566	3790739	A04p06430.2_BraZ1	73.5	-	12	521	2173	0.2397607
A04	3790032	3792078	A04p06440.2_BraZ1	89.4	-	0	0	2046	0.0000000
A04	3791913	3792333	A04p06450.2_BraZ1	261	-	0	0	420	0.0000000
A04	3793391	3796190	A04p06460.2_BraZ1	76.2	-	181	1479	2799	0.5284030
A04	3794466	3799190	A04p06470.2_BraZ1	149.4	-	156	1360	4724	0.2878916
A04	3799190	3799490	A04p06480.2_BraZ1	30	-	0	0	300	0.0000000
A04	3800630	3802217	A04p06490.2_BraZ1	142884	-	638	1173	1587	0.7391304
A04	3808072	3811651	A04p06500.2_BraZ1	2318.25	+	1776	3556	3579	0.9935736
A04	3821384	3823568	A04p06510.2_BraZ1	1356	+	1371	2184	2184	1.0000000
A04	3823823	3826091	A04p06520.2_BraZ1	226.8	-	665	2195	2268	0.9678131
A04	3840218	3840635	A04p06530.2_BraZ1	41.7	-	198	408	417	0.9784173
A04	3842194	3845783	A04p06540.2_BraZ1	810.694	-	1558	3163	3589	0.8813040
A04	3849319	3849972	A04p06550.2_BraZ1	249	+	411	653	653	1.0000000
A04	3850201	3851388	A04p06560.2_BraZ1	267.75	+	1592	1187	1187	1.0000000
A04	3864300	3865907	A04p06570.2_BraZ1	607.359	+	498	1607	1607	1.0000000
A04	3866201	3866726	A04p06580.2_BraZ1	52.5	-	691	525	525	1.0000000
A04	3867755	3868477	A04p06590.2_BraZ1	414	+	914	722	722	1.0000000
A04	3868789	3869872	A04p06600.2_BraZ1	108.3	-	1628	1083	1083	1.0000000
A04	3883260	3883632	A04p06610.2_BraZ1	37.2	+	18	308	372	0.8279570
A04	3885295	3887052	A04p06620.2_BraZ1	1617	-	125	1165	1757	0.6630620
A04	3897917	3902228	A04p06630.2_BraZ1	1715.82	+	3160	4269	4311	0.9902575
A04	3903059	3905718	A04p06640.2_BraZ1	1229.26	-	1489	2466	2659	0.9274163
A04	3909516	3917442	A04p06650.2_BraZ1	2270.5	-	4840	7866	7926	0.9924300
A04	3918133	3918331	A04p06660.2_BraZ1	19.8	+	334	198	198	1.0000000
A04	3924033	3925071	A04p06670.2_BraZ1	612.773	-	235	686	1038	0.6608863
A04	3934800	3935900	A04p06680.2_BraZ1	799.167	+	133	1043	1100	0.9481818
A04	3950557	3951109	A04p06690.2_BraZ1	378	+	357	552	552	1.0000000
A04	3958999	3959657	A04p06700.2_BraZ1	1365	+	515	658	658	1.0000000
A04	3966194	3968613	A04p06710.2_BraZ1	705	+	167	1156	2419	0.4778834
A04	3969757	3970258	A04p06720.2_BraZ1	50.1	+	148	501	501	1.0000000
A04	3971817	3973414	A04p06730.2_BraZ1	1428	-	893	1597	1597	1.0000000
A04	3974133	3975045	A04p06740.2_BraZ1	432	-	26	562	912	0.6162280
A04	3978215	3981606	A04p06750.2_BraZ1	1472.96	-	1742	3122	3391	0.9206724
A04	3983738	3986774	A04p06760.2_BraZ1	2174.14	+	959	2834	3036	0.9334651
A04	3987806	3988204	A04p06770.2_BraZ1	168	+	498	398	398	1.0000000
A04	3993829	3995061	A04p06780.2_BraZ1	564	+	1039	1232	1232	1.0000000
A04	3998663	3998951	A04p06790.2_BraZ1	237	-	62	288	288	1.0000000
A04	4001360	4004825	A04p06800.2_BraZ1	2224.44	+	280	2748	3465	0.7930736
A04	4005249	4005452	A04p06810.2_BraZ1	13.2	-	16	196	203	0.9655172
A04	4005796	4006559	A04p06820.2_BraZ1	684	+	109	763	763	1.0000000
A04	4011306	4012770	A04p06830.2_BraZ1	8385	+	8	297	1464	0.2028688
A04	4026053	4026594	A04p06840.2_BraZ1	357	-	9	101	541	0.1866913
A04	4030908	4032426	A04p06850.2_BraZ1	151.5	+	33	206	1518	0.1357049
A04	4037339	4037516	A04p06860.2_BraZ1	17.7	+	303	177	177	1.0000000
A04	4039326	4045158	A04p06870.2_BraZ1	840	-	480	3910	5832	0.6704389
A04	4047736	4048912	A04p06880.2_BraZ1	635.455	+	781	1151	1176	0.9787415
A04	4049135	4051681	A04p06890.2_BraZ1	1491	-	1083	2507	2546	0.9846818
A04	4059021	4060547	A04p06900.2_BraZ1	1056	+	1044	1526	1526	1.0000000
A04	4060992	4065735	A04p06910.2_BraZ1	3229.64	-	2557	4619	4743	0.9738562
A04	4066724	4067471	A04p06920.2_BraZ1	1332	+	1641	747	747	1.0000000
A04	4068008	4068299	A04p06930.2_BraZ1	97.8103	+	219	291	291	1.0000000
A04	4068844	4069266	A04p06940.2_BraZ1	116.379	+	268	422	422	1.0000000
A04	4084813	4085080	A04p06950.2_BraZ1	26.7	+	57	252	267	0.9438202
A04	4089482	4089749	A04p06960.2_BraZ1	26.7	+	96	212	267	0.7940075
A04	4090036	4090585	A04p06970.2_BraZ1	465	-	41	318	549	0.5792350
A04	4093148	4093340	A04p06980.2_BraZ1	19.2	+	196	192	192	1.0000000
A04	4097250	4101723	A04p06990.2_BraZ1	383.5	+	1255	4120	4473	0.9210820
A04	4103819	4104865	A04p07000.2_BraZ1	123	+	860	1046	1046	1.0000000
A04	4109659	4110493	A04p07010.2_BraZ1	83.4	+	751	834	834	1.0000000
A04	4122319	4123374	A04p07020.2_BraZ1	405	+	375	1055	1055	1.0000000
A04	4123553	4125455	A04p07030.2_BraZ1	540.571	-	1421	1445	1902	0.7597266
A04	4126636	4126948	A04p07040.2_BraZ1	31.2	-	154	312	312	1.0000000
A04	4126988	4127129	A04p07050.2_BraZ1	14.1	+	69	141	141	1.0000000
A04	4128053	4129108	A04p07060.2_BraZ1	423	-	106	833	1055	0.7895734
A04	4130793	4132299	A04p07070.2_BraZ1	1316.12	+	398	1379	1506	0.9156706
A04	4132622	4132997	A04p07080.2_BraZ1	37.5	-	221	375	375	1.0000000
A04	4150708	4151745	A04p07090.2_BraZ1	219	-	2	14	1037	0.0135005
A04	4155945	4157566	A04p07100.2_BraZ1	477	+	1300	1621	1621	1.0000000
A04	4165303	4167674	A04p07110.2_BraZ1	486	-	3567	2371	2371	1.0000000
A04	4172825	4173053	A04p07120.2_BraZ1	22.8	+	409	228	228	1.0000000
A04	4174563	4175376	A04p07130.2_BraZ1	479.817	+	249	708	813	0.8708487
A04	4177880	4179492	A04p07140.2_BraZ1	6138	+	441	1387	1612	0.8604218
A04	4180518	4184406	A04p07150.2_BraZ1	1518.25	-	978	3236	3888	0.8323045
A04	4181816	4182401	A04p07160.2_BraZ1	279	+	13	300	585	0.5128205
A04	4186900	4187425	A04p07170.2_BraZ1	456	-	631	525	525	1.0000000
A04	4199209	4199986	A04p07180.2_BraZ1	341.25	+	1312	777	777	1.0000000
A04	4201432	4208103	A04p07190.2_BraZ1	1395.9	+	5022	5739	6671	0.8602908
A04	4208954	4209644	A04p07200.2_BraZ1	69	-	44	264	690	0.3826087
A04	4213252	4214353	A04p07210.2_BraZ1	1002	+	3	21	1101	0.0190736
A04	4215238	4215940	A04p07220.2_BraZ1	70.2	-	4	84	702	0.1196581
A04	4217059	4219785	A04p07230.2_BraZ1	734.312	+	1951	2554	2726	0.9369039
A04	4224473	4225601	A04p07240.2_BraZ1	2130	+	191	1103	1128	0.9778369
A04	4239142	4243781	A04p07250.2_BraZ1	1155.64	+	3585	4126	4639	0.8894158
A04	4244369	4247019	A04p07260.2_BraZ1	13695	-	1546	2589	2650	0.9769811
A04	4275052	4275154	A04p07270.2_BraZ1	10.2	-	0	0	102	0.0000000
A04	4283721	4283982	A04p07280.2_BraZ1	26.1	-	351	261	261	1.0000000
A04	4284045	4284507	A04p07290.2_BraZ1	46.2	-	465	462	462	1.0000000
A04	4291692	4292136	A04p07300.2_BraZ1	720	-	319	444	444	1.0000000
A04	4304102	4306735	A04p07310.2_BraZ1	1371	+	940	2372	2633	0.9008735
A04	4308095	4308490	A04p07320.2_BraZ1	31.5	+	494	395	395	1.0000000
A04	4312418	4313671	A04p07330.2_BraZ1	1107	-	1128	1253	1253	1.0000000
A04	4331359	4337138	A04p07340.2_BraZ1	1938.74	-	1063	4752	5779	0.8222876
A04	4339319	4339805	A04p07350.2_BraZ1	32.4	-	470	486	486	1.0000000
A04	4340370	4340955	A04p07360.2_BraZ1	294	-	793	585	585	1.0000000
A04	4347362	4347854	A04p07370.2_BraZ1	49.2	-	337	492	492	1.0000000
A04	4363441	4363967	A04p07380.2_BraZ1	1161	+	22	408	526	0.7756654
A04	4366449	4366704	A04p07390.2_BraZ1	25.5	+	0	0	255	0.0000000
A04	4368130	4368478	A04p07400.2_BraZ1	34.8	+	98	310	348	0.8908046
A04	4370487	4371234	A04p07410.2_BraZ1	285	+	819	747	747	1.0000000
A04	4383035	4383248	A04p07420.2_BraZ1	21.3	+	34	147	213	0.6901408
A04	4391247	4391667	A04p07430.2_BraZ1	41.4	+	760	420	420	1.0000000
A04	4394924	4395962	A04p07440.2_BraZ1	633	+	1645	1038	1038	1.0000000
A04	4403537	4403840	A04p07450.2_BraZ1	20.1	+	88	303	303	1.0000000
A04	4404487	4405297	A04p07460.2_BraZ1	199.143	+	805	810	810	1.0000000
A04	4407574	4409042	A04p07470.2_BraZ1	1218.33	-	171	417	1468	0.2840599
A04	4414071	4415539	A04p07480.2_BraZ1	931.667	-	25	329	1468	0.2241144
A04	4421281	4422216	A04p07490.2_BraZ1	1308	-	541	935	935	1.0000000
A04	4423907	4425373	A04p07500.2_BraZ1	1218.33	-	75	1108	1466	0.7557981
A04	4430817	4435524	A04p07510.2_BraZ1	1710.68	+	5658	4707	4707	1.0000000
A04	4436146	4439101	A04p07520.2_BraZ1	351	+	1423	2925	2955	0.9898477
A04	4445725	4448313	A04p07530.2_BraZ1	1670.71	+	400	1654	2588	0.6391035
A04	4449175	4449464	A04p07540.2_BraZ1	864	-	273	289	289	1.0000000
A04	4452972	4453191	A04p07550.2_BraZ1	21.9	+	214	219	219	1.0000000
A04	4455778	4456078	A04p07560.2_BraZ1	30	+	49	225	300	0.7500000
A04	4462251	4463158	A04p07570.2_BraZ1	6696	+	891	907	907	1.0000000
A04	4463742	4465063	A04p07580.2_BraZ1	348	+	1351	1321	1321	1.0000000
A04	4467331	4467769	A04p07590.2_BraZ1	43.8	-	174	438	438	1.0000000
A04	4471299	4472721	A04p07600.2_BraZ1	142.2	+	158	1350	1422	0.9493671
A04	4483312	4484304	A04p07610.2_BraZ1	231	-	861	992	992	1.0000000
A04	4500463	4503282	A04p07620.2_BraZ1	2391	+	1212	2527	2819	0.8964171
A04	4526233	4526860	A04p07630.2_BraZ1	62.7	-	142	533	627	0.8500797
A04	4537345	4537591	A04p07640.2_BraZ1	24.6	+	406	246	246	1.0000000
A04	4545259	4546157	A04p07650.2_BraZ1	798	-	4	72	898	0.0801782
A04	4547708	4557857	A04p07660.2_BraZ1	462	+	5524	8507	10149	0.8382106
A04	4559185	4559494	A04p07670.2_BraZ1	30.9	-	803	309	309	1.0000000
A04	4560044	4560762	A04p07680.2_BraZ1	204	-	1773	718	718	1.0000000
A04	4572138	4573297	A04p07690.2_BraZ1	90.3	+	102	830	1159	0.7161346
A04	4583289	4587790	A04p07700.2_BraZ1	3264	-	3056	4168	4501	0.9260164
A04	4600508	4602676	A04p07710.2_BraZ1	642.462	+	506	2115	2168	0.9755535
A04	4603427	4603772	A04p07720.2_BraZ1	243	-	19	262	345	0.7594203
A04	4603919	4605548	A04p07730.2_BraZ1	53.0769	-	56	985	1629	0.6046655
A04	4605712	4606303	A04p07740.2_BraZ1	363	+	226	591	591	1.0000000
A04	4608632	4611292	A04p07750.2_BraZ1	1035	+	200	1662	2660	0.6248120
A04	4612291	4614276	A04p07760.2_BraZ1	1043.73	+	1492	1985	1985	1.0000000
A04	4614462	4615615	A04p07770.2_BraZ1	921.818	-	1087	1153	1153	1.0000000
A04	4617675	4619915	A04p07780.2_BraZ1	1476	-	670	2071	2240	0.9245536
A04	4622793	4623982	A04p07790.2_BraZ1	177	-	790	1189	1189	1.0000000
A04	4644502	4644850	A04p07800.2_BraZ1	267	-	168	348	348	1.0000000
A04	4652635	4662763	A04p07810.2_BraZ1	2605.74	-	8248	9631	10128	0.9509281
A04	4663618	4664893	A04p07820.2_BraZ1	487.195	-	1470	1275	1275	1.0000000
A04	4666342	4668000	A04p07830.2_BraZ1	1338	-	425	1431	1658	0.8630881
A04	4690116	4692353	A04p07840.2_BraZ1	1931.46	+	1871	2237	2237	1.0000000
A04	4694047	4694834	A04p07850.2_BraZ1	288.75	-	824	787	787	1.0000000
A04	4695354	4696536	A04p07860.2_BraZ1	261	+	1330	1182	1182	1.0000000
A04	4697380	4703653	A04p07870.2_BraZ1	1596.25	-	2047	4507	6273	0.7184760
A04	4706456	4706741	A04p07880.2_BraZ1	28.5	+	488	285	285	1.0000000
A04	4712348	4712726	A04p07890.2_BraZ1	207	-	0	0	378	0.0000000
A04	4715489	4716756	A04p07900.2_BraZ1	841	-	155	1193	1267	0.9415943
A04	4716822	4717903	A04p07910.2_BraZ1	617.5	-	198	1044	1081	0.9657724
A04	4719477	4751898	A04p07920.2_BraZ1	2662.8	+	22070	26208	32421	0.8083649
A04	4752602	4753609	A04p07930.2_BraZ1	436.789	-	1526	1007	1007	1.0000000
A04	4755922	4763981	A04p07940.2_BraZ1	3744.43	-	2330	7322	8059	0.9085494
A04	4765878	4766244	A04p07950.2_BraZ1	36.6	+	70	278	366	0.7595628
A04	4766779	4767512	A04p07960.2_BraZ1	332.5	-	309	733	733	1.0000000
A04	4773305	4775385	A04p07970.2_BraZ1	947.929	-	1321	1876	2080	0.9019231
A04	4777099	4778111	A04p07980.2_BraZ1	1620	-	1228	1012	1012	1.0000000
A04	4784253	4785846	A04p07990.2_BraZ1	942.3	+	1591	1593	1593	1.0000000
A04	4786197	4786407	A04p08000.2_BraZ1	21	-	60	210	210	1.0000000
A04	4789750	4790767	A04p08010.2_BraZ1	397.708	+	466	937	1017	0.9213372
A04	4790988	4793617	A04p08020.2_BraZ1	2165.4	-	92	937	2629	0.3564093
A04	4794389	4794521	A04p08030.2_BraZ1	13.2	+	201	132	132	1.0000000
A04	4794712	4795067	A04p08040.2_BraZ1	231	+	337	355	355	1.0000000
A04	4795367	4795694	A04p08050.2_BraZ1	32.7	-	688	327	327	1.0000000
A04	4801567	4802575	A04p08060.2_BraZ1	100.8	+	362	967	1008	0.9593254
A04	4804613	4805696	A04p08070.2_BraZ1	108.3	+	906	1056	1083	0.9750692
A04	4806442	4807812	A04p08080.2_BraZ1	387.692	+	252	1333	1370	0.9729927
A04	4810245	4812268	A04p08090.2_BraZ1	1365.85	+	313	1468	2023	0.7256550
A04	4815654	4820053	A04p08100.2_BraZ1	346.8	-	964	3554	4399	0.8079109
A04	4825817	4827092	A04p08110.2_BraZ1	127.5	-	68	312	1275	0.2447059
A04	4847222	4848073	A04p08120.2_BraZ1	506.667	+	549	851	851	1.0000000
A04	4849515	4851108	A04p08130.2_BraZ1	798	-	769	1568	1593	0.9843063
A04	4871650	4872254	A04p08140.2_BraZ1	309	+	495	604	604	1.0000000
A04	4877515	4878114	A04p08150.2_BraZ1	251.25	+	220	581	599	0.9699499
A04	4878198	4878932	A04p08160.2_BraZ1	468	+	893	734	734	1.0000000
A04	4879419	4880668	A04p08170.2_BraZ1	753.477	+	426	1106	1249	0.8855084
A04	4881316	4881769	A04p08180.2_BraZ1	31.2	+	204	453	453	1.0000000
A04	4881899	4883048	A04p08190.2_BraZ1	114.9	+	580	1149	1149	1.0000000
A04	4885790	4886706	A04p08200.2_BraZ1	1287	-	2513	916	916	1.0000000
A04	4892630	4894934	A04p08210.2_BraZ1	1132.36	-	1245	2185	2304	0.9483507
A04	4901291	4903396	A04p08220.2_BraZ1	7455	+	691	1740	2105	0.8266034
A04	4903372	4904772	A04p08230.2_BraZ1	2948	+	443	1400	1400	1.0000000
A04	4912067	4915023	A04p08240.2_BraZ1	1444.03	-	1231	2956	2956	1.0000000
A04	4930590	4930983	A04p08250.2_BraZ1	336	-	968	393	393	1.0000000
A04	4933728	4936584	A04p08260.2_BraZ1	1222.22	+	1353	2676	2856	0.9369748
A04	4937412	4937574	A04p08270.2_BraZ1	16.2	-	313	162	162	1.0000000
A04	4940062	4940626	A04p08280.2_BraZ1	56.4	+	101	377	564	0.6684397
A04	4941025	4942165	A04p08290.2_BraZ1	318	-	832	1140	1140	1.0000000
A04	4942755	4943145	A04p08300.2_BraZ1	39	-	137	390	390	1.0000000
A04	4951881	4953727	A04p08310.2_BraZ1	981.474	+	839	1825	1846	0.9886240
A04	4968474	4969326	A04p08320.2_BraZ1	85.2	-	93	595	852	0.6983568
A04	4971058	4971163	A04p08330.2_BraZ1	10.5	-	30	105	105	1.0000000
A04	4988517	4988883	A04p08340.2_BraZ1	36.6	-	317	366	366	1.0000000
A04	4997871	4998880	A04p08350.2_BraZ1	2197.8	+	119	654	1009	0.6481665
A04	5008152	5008869	A04p08360.2_BraZ1	71.7	-	122	583	717	0.8131102
A04	5010374	5010537	A04p08370.2_BraZ1	117	-	363	163	163	1.0000000
A04	5011663	5012297	A04p08380.2_BraZ1	177	+	2	131	634	0.2066246
A04	5049542	5050879	A04p08390.2_BraZ1	787.286	-	1759	816	1337	0.6103216
A04	5050849	5051171	A04p08400.2_BraZ1	64.2857	-	1441	322	322	1.0000000
A04	5051536	5052300	A04p08410.2_BraZ1	530.357	-	123	764	764	1.0000000
A04	5055173	5056296	A04p08420.2_BraZ1	471	+	972	1123	1123	1.0000000
A04	5056969	5058272	A04p08430.2_BraZ1	676.875	-	667	1279	1303	0.9815810
A04	5081724	5082960	A04p08440.2_BraZ1	428	+	1163	1236	1236	1.0000000
A04	5083680	5084274	A04p08450.2_BraZ1	59.4	-	80	436	594	0.7340068
A04	5103226	5107196	A04p08460.2_BraZ1	2592.4	+	344	3017	3970	0.7599496
A04	5111171	5111390	A04p08470.2_BraZ1	21.9	+	352	219	219	1.0000000
A04	5113093	5113967	A04p08480.2_BraZ1	291	+	1158	874	874	1.0000000
A04	5113202	5113598	A04p08490.2_BraZ1	39.6	+	668	396	396	1.0000000
A04	5122432	5138063	A04p08500.2_BraZ1	2309.04	+	12897	15616	15631	0.9990404
A04	5129999	5130228	A04p08510.2_BraZ1	192	-	170	229	229	1.0000000
A04	5132246	5132750	A04p08520.2_BraZ1	38.7	-	800	504	504	1.0000000
A04	5138488	5141544	A04p08530.2_BraZ1	2529.55	-	1361	2995	3056	0.9800392
A04	5141790	5142998	A04p08540.2_BraZ1	313.159	+	1108	1208	1208	1.0000000
A04	5144819	5145236	A04p08550.2_BraZ1	41.1	+	166	417	417	1.0000000
A04	5147060	5147978	A04p08560.2_BraZ1	91.8	+	74	909	918	0.9901960
A04	5150406	5150586	A04p08570.2_BraZ1	18	-	103	180	180	1.0000000
A04	5151107	5151842	A04p08580.2_BraZ1	408	+	664	735	735	1.0000000
A04	5151925	5152150	A04p08590.2_BraZ1	22.5	-	72	225	225	1.0000000
A04	5152777	5152957	A04p08600.2_BraZ1	18	-	6	129	180	0.7166666
A04	5162626	5162947	A04p08610.2_BraZ1	32.1	-	153	321	321	1.0000000
A04	5163159	5163433	A04p08620.2_BraZ1	162	-	29	215	274	0.7846715
A04	5176036	5176495	A04p08630.2_BraZ1	186.75	-	77	39	459	0.0849673
A04	5176459	5176756	A04p08640.2_BraZ1	126	+	1	60	297	0.2020202
A04	5179988	5180228	A04p08650.2_BraZ1	24	+	20	124	240	0.5166667
A04	5181661	5182336	A04p08660.2_BraZ1	1782	+	670	652	675	0.9659259
A04	5182336	5182654	A04p08670.2_BraZ1	504	+	330	318	318	1.0000000
A04	5184987	5186380	A04p08680.2_BraZ1	452.432	+	147	1165	1393	0.8363245
A04	5191319	5194657	A04p08690.2_BraZ1	1376.7	+	1566	3202	3338	0.9592571
A04	5200960	5202706	A04p08700.2_BraZ1	1317	-	462	1369	1746	0.7840779
A04	5220873	5225152	A04p08710.2_BraZ1	1436.8	-	774	3907	4279	0.9130638
A04	5233465	5233942	A04p08720.2_BraZ1	417	-	163	418	477	0.8763103
A04	5242534	5242863	A04p08730.2_BraZ1	282	-	2	150	329	0.4559270
A04	5242953	5244124	A04p08740.2_BraZ1	486	+	42	262	1171	0.2237404
A04	5247283	5248151	A04p08750.2_BraZ1	330	+	376	854	868	0.9838710
A04	5249967	5253622	A04p08760.2_BraZ1	2370	+	1628	3287	3655	0.8993160
A04	5277886	5279125	A04p08770.2_BraZ1	123.9	+	923	1239	1239	1.0000000
A04	5286389	5289316	A04p08780.2_BraZ1	1369.64	+	1853	2823	2927	0.9644687
A04	5293419	5304083	A04p08790.2_BraZ1	1603.83	+	2199	7216	10664	0.6766692
A04	5307151	5307448	A04p08800.2_BraZ1	75	+	336	297	297	1.0000000
A04	5307506	5310719	A04p08810.2_BraZ1	2437.5	+	5404	3213	3213	1.0000000
A04	5311459	5312023	A04p08820.2_BraZ1	160	+	1247	564	564	1.0000000
A04	5312562	5314674	A04p08830.2_BraZ1	1194	-	5504	2112	2112	1.0000000
A04	5336224	5339532	A04p08840.2_BraZ1	1763.32	+	2677	3308	3308	1.0000000
A04	5339947	5348338	A04p08850.2_BraZ1	945	-	1958	6711	8391	0.7997855
A04	5357205	5361697	A04p08860.2_BraZ1	2209.01	-	2134	4458	4492	0.9924310
A04	5369239	5371272	A04p08870.2_BraZ1	330	-	835	1085	2033	0.5336940
A04	5374997	5375855	A04p08880.2_BraZ1	664	-	491	858	858	1.0000000
A04	5388658	5390313	A04p08890.2_BraZ1	447.043	+	1100	1529	1655	0.9238670
A04	5392984	5396272	A04p08900.2_BraZ1	2022.34	+	1262	3173	3288	0.9650244
A04	5396811	5405897	A04p08910.2_BraZ1	3011.2	-	2199	4599	9086	0.5061633
A04	5413343	5414806	A04p08920.2_BraZ1	513	+	755	1463	1463	1.0000000
A04	5424684	5426338	A04p08930.2_BraZ1	1443	+	263	975	1654	0.5894800
A04	5427285	5437794	A04p08940.2_BraZ1	1656.78	+	18178	10333	10509	0.9832525
A04	5437591	5438397	A04p08950.2_BraZ1	482.4	+	1574	806	806	1.0000000
A04	5439160	5439563	A04p08960.2_BraZ1	336	-	1425	403	403	1.0000000
A04	5439809	5440058	A04p08970.2_BraZ1	24.9	-	828	249	249	1.0000000
A04	5441660	5447204	A04p08980.2_BraZ1	2552	-	3416	3060	5544	0.5519481
A04	5448483	5448984	A04p08990.2_BraZ1	50.1	+	559	501	501	1.0000000
A04	5449994	5454517	A04p09000.2_BraZ1	2148.45	+	2615	3803	4523	0.8408136
A04	5455213	5455363	A04p09010.2_BraZ1	15	-	3	90	150	0.6000000
A04	5463076	5465038	A04p09020.2_BraZ1	1226.17	+	337	1880	1962	0.9582059
A04	5482294	5482547	A04p09030.2_BraZ1	138	+	338	253	253	1.0000000
A04	5494967	5495134	A04p09040.2_BraZ1	141	+	328	167	167	1.0000000
A04	5501588	5503906	A04p09050.2_BraZ1	1388.33	+	905	2236	2318	0.9646247
A04	5507057	5507417	A04p09060.2_BraZ1	36	+	323	360	360	1.0000000
A04	5507974	5509488	A04p09070.2_BraZ1	840.245	-	486	1343	1514	0.8870541
A04	5509691	5512079	A04p09080.2_BraZ1	573.6	-	2537	2388	2388	1.0000000
A04	5520073	5520190	A04p09090.2_BraZ1	11.7	-	353	117	117	1.0000000
A04	5522597	5523952	A04p09100.2_BraZ1	1020.86	+	1	11	1355	0.0081181
A04	5524143	5525265	A04p09110.2_BraZ1	112.2	+	68	520	1122	0.4634581
A04	5577242	5578756	A04p09120.2_BraZ1	1434	+	337	1184	1514	0.7820343
A04	5586646	5589584	A04p09130.2_BraZ1	2211.66	+	536	2375	2938	0.8083730
A04	5610551	5610758	A04p09140.2_BraZ1	20.7	-	136	207	207	1.0000000
A04	5615836	5616207	A04p09150.2_BraZ1	22.8	-	330	371	371	1.0000000
A04	5625222	5626831	A04p09160.2_BraZ1	71442	-	110	1152	1609	0.7159727
A04	5630256	5630397	A04p09170.2_BraZ1	14.1	-	237	141	141	1.0000000
A04	5638020	5638161	A04p09180.2_BraZ1	14.1	-	195	141	141	1.0000000
A04	5638555	5638765	A04p09190.2_BraZ1	21	-	185	210	210	1.0000000
A04	5641152	5643156	A04p09200.2_BraZ1	1393.52	+	156	1657	2004	0.8268463
A04	5645989	5647770	A04p09210.2_BraZ1	694.479	+	694	1660	1781	0.9320607
A04	5662140	5664628	A04p09220.2_BraZ1	2394	-	1457	2488	2488	1.0000000
A04	5668444	5671008	A04p09230.2_BraZ1	2418	-	875	2202	2564	0.8588144
A04	5687395	5687926	A04p09240.2_BraZ1	388.929	+	1107	531	531	1.0000000
A04	5687947	5688663	A04p09250.2_BraZ1	4320	+	1085	716	716	1.0000000
A04	5690643	5690850	A04p09260.2_BraZ1	20.7	-	129	207	207	1.0000000
A04	5699255	5699567	A04p09270.2_BraZ1	31.2	-	704	276	312	0.8846154
A04	5710202	5716368	A04p09280.2_BraZ1	1284	+	3733	5957	6166	0.9661044
A04	5716978	5718234	A04p09290.2_BraZ1	3015	-	598	1211	1256	0.9641719
A04	5740154	5742738	A04p09300.2_BraZ1	2247	+	280	1380	2584	0.5340557
A04	5743302	5743674	A04p09310.2_BraZ1	37.2	+	412	372	372	1.0000000
A04	5746520	5750819	A04p09320.2_BraZ1	3325	+	2695	3461	4299	0.8050709
A04	5762008	5762248	A04p09330.2_BraZ1	24	+	491	240	240	1.0000000
A04	5768828	5769774	A04p09340.2_BraZ1	639.474	+	257	875	946	0.9249471
A04	5777906	5779845	A04p09350.2_BraZ1	981.874	+	894	1927	1939	0.9938112
A04	5789356	5792058	A04p09360.2_BraZ1	1983.75	+	2198	2702	2702	1.0000000
A04	5793952	5794544	A04p09370.2_BraZ1	438	-	538	592	592	1.0000000
A04	5795559	5797387	A04p09380.2_BraZ1	940.5	-	2920	1828	1828	1.0000000
A04	5798513	5803576	A04p09390.2_BraZ1	1669.55	+	710	3482	5063	0.6877345
A04	5812910	5813096	A04p09400.2_BraZ1	18.6	+	46	186	186	1.0000000
A04	5813564	5814213	A04p09410.2_BraZ1	342	+	1190	649	649	1.0000000
A04	5820948	5822574	A04p09420.2_BraZ1	1506	+	146	813	1626	0.5000000
A04	5833269	5836311	A04p09430.2_BraZ1	1311.85	-	985	2651	3042	0.8714662
A04	5841215	5843006	A04p09440.2_BraZ1	547.13	+	969	1791	1791	1.0000000
A04	5844414	5846566	A04p09450.2_BraZ1	15618	-	348	1730	2152	0.8039033
A04	5849512	5851011	A04p09460.2_BraZ1	1144.5	+	1956	1499	1499	1.0000000
A04	5856509	5856620	A04p09470.2_BraZ1	11.1	+	4	111	111	1.0000000
A04	5862013	5862777	A04p09480.2_BraZ1	378	-	719	764	764	1.0000000
A04	5867615	5868744	A04p09490.2_BraZ1	754.38	+	1134	1129	1129	1.0000000
A04	5869055	5871113	A04p09500.2_BraZ1	976.985	-	1967	2058	2058	1.0000000
A04	5872869	5873255	A04p09510.2_BraZ1	255	+	63	373	386	0.9663212
A04	5879566	5881350	A04p09520.2_BraZ1	323.75	+	1286	1784	1784	1.0000000
A04	5886165	5889429	A04p09530.2_BraZ1	3177	+	555	2886	3264	0.8841912
A04	5898044	5899124	A04p09540.2_BraZ1	105	-	23	279	1080	0.2583333
A04	5906665	5908561	A04p09550.2_BraZ1	530.75	+	1335	1896	1896	1.0000000
A04	5920049	5922470	A04p09560.2_BraZ1	1544.3	-	669	2042	2421	0.8434531
A04	5931114	5932263	A04p09570.2_BraZ1	345	+	37	737	1149	0.6414273
A04	5931226	5931949	A04p09580.2_BraZ1	144	-	17	485	723	0.6708161
A04	5934237	5934486	A04p09590.2_BraZ1	24.9	+	7	151	249	0.6064257
A04	5938720	5939019	A04p09600.2_BraZ1	210	-	110	299	299	1.0000000
A04	5939191	5939437	A04p09610.2_BraZ1	14.7	-	185	246	246	1.0000000
A04	5943069	5943509	A04p09620.2_BraZ1	1660.5	+	256	440	440	1.0000000
A04	5950823	5952468	A04p09630.2_BraZ1	600	+	635	1521	1645	0.9246200
A04	5953333	5954068	A04p09640.2_BraZ1	73.5	-	116	646	735	0.8789116
A04	5956405	5957368	A04p09650.2_BraZ1	96.3	-	377	901	963	0.9356179
A04	5964664	5965202	A04p09660.2_BraZ1	333	+	20	489	538	0.9089220
A04	5985799	5986106	A04p09670.2_BraZ1	207	+	14	138	307	0.4495114
A04	5990871	5995937	A04p09680.2_BraZ1	2206.24	+	1683	4725	5066	0.9326885
A04	6008217	6010627	A04p09690.2_BraZ1	1437.75	+	639	2319	2410	0.9622406
A04	6016093	6017042	A04p09700.2_BraZ1	657	+	170	945	949	0.9957851
A04	6018811	6019715	A04p09710.2_BraZ1	30.6	-	753	904	904	1.0000000
A04	6023431	6023806	A04p09720.2_BraZ1	30.9	+	258	375	375	1.0000000
A04	6027127	6030372	A04p09730.2_BraZ1	1374.09	+	2190	3239	3245	0.9981510
A04	6031015	6031408	A04p09740.2_BraZ1	39.3	+	333	351	393	0.8931298
A04	6041622	6041751	A04p09750.2_BraZ1	12.9	-	50	114	129	0.8837209
A04	6045535	6067067	A04p09760.2_BraZ1	1126.88	+	26062	16486	21532	0.7656511
A04	6076835	6077910	A04p09770.2_BraZ1	702	-	76	971	1075	0.9032558
A04	6078848	6081031	A04p09780.2_BraZ1	1573.71	+	324	2067	2183	0.9468621
A04	6081819	6082341	A04p09790.2_BraZ1	52.2	-	50	320	522	0.6130268
A04	6083316	6086054	A04p09800.2_BraZ1	1025.81	+	1777	2706	2738	0.9883127
A04	6099738	6101965	A04p09810.2_BraZ1	1853.79	+	1140	2204	2227	0.9896722
A04	6102160	6104514	A04p09820.2_BraZ1	1204.7	-	254	1722	2354	0.7315208
A04	6106729	6107143	A04p09830.2_BraZ1	342	-	1	24	414	0.0579710
A04	6109214	6120857	A04p09840.2_BraZ1	1658.8	+	4954	10438	11643	0.8965043
A04	6115536	6117867	A04p09850.2_BraZ1	507	-	792	2049	2331	0.8790219
A04	6137527	6137773	A04p09860.2_BraZ1	24.6	-	12	8	246	0.0325203
A04	6157150	6157462	A04p09870.2_BraZ1	31.2	+	0	0	312	0.0000000
A04	6173939	6174314	A04p09880.2_BraZ1	303	+	143	375	375	1.0000000
A04	6185002	6187339	A04p09890.2_BraZ1	1397.03	+	401	2187	2337	0.9358152
A04	6187889	6192286	A04p09900.2_BraZ1	1199	-	834	3996	4397	0.9088014
A04	6195786	6196657	A04p09910.2_BraZ1	585.391	+	134	731	871	0.8392652
A04	6196857	6197346	A04p09920.2_BraZ1	225	+	439	489	489	1.0000000
A04	6200576	6200783	A04p09930.2_BraZ1	20.7	-	27	197	207	0.9516908
A04	6209632	6211300	A04p09940.2_BraZ1	1102.5	+	163	1458	1668	0.8741007
A04	6217893	6218685	A04p09950.2_BraZ1	79.2	+	43	340	792	0.4292929
A04	6230915	6231344	A04p09960.2_BraZ1	306	-	611	366	429	0.8531469
A04	6232607	6233393	A04p09970.2_BraZ1	78.6	-	81	429	786	0.5458015
A04	6237384	6237616	A04p09980.2_BraZ1	15	+	215	232	232	1.0000000
A04	6243220	6245076	A04p09990.2_BraZ1	1218.42	+	284	1769	1856	0.9531250
A04	6245401	6246556	A04p10000.2_BraZ1	115.5	-	465	1155	1155	1.0000000
A04	6250581	6250971	A04p10010.2_BraZ1	279	-	18	208	390	0.5333334
A04	6255433	6263774	A04p10020.2_BraZ1	4756.68	+	2094	7268	8341	0.8713583
A04	6269871	6270090	A04p10030.2_BraZ1	21.9	+	269	219	219	1.0000000
A04	6272789	6273851	A04p10040.2_BraZ1	106.2	-	178	844	1062	0.7947269
A04	6279271	6279511	A04p10050.2_BraZ1	24	+	5	133	240	0.5541667
A04	6297999	6299017	A04p10060.2_BraZ1	198	+	472	1018	1018	1.0000000
A04	6303511	6305337	A04p10070.2_BraZ1	1003.13	-	662	1803	1826	0.9874042
A04	6306327	6307223	A04p10080.2_BraZ1	162	+	1160	896	896	1.0000000
A04	6306570	6306782	A04p10090.2_BraZ1	129	+	502	212	212	1.0000000
A04	6312390	6313799	A04p10100.2_BraZ1	515.2	-	1359	1366	1409	0.9694819
A04	6327394	6329905	A04p10110.2_BraZ1	697.5	+	3232	2511	2511	1.0000000
A04	6337208	6338342	A04p10120.2_BraZ1	33.6	+	1325	1134	1134	1.0000000
A04	6340313	6340445	A04p10130.2_BraZ1	13.2	-	444	132	132	1.0000000
A04	6343433	6344006	A04p10140.2_BraZ1	294	+	538	573	573	1.0000000
A04	6352439	6353640	A04p10150.2_BraZ1	528.429	-	356	1168	1201	0.9725229
A04	6354377	6354700	A04p10160.2_BraZ1	135	-	198	323	323	1.0000000
A04	6355180	6356130	A04p10170.2_BraZ1	471.273	-	266	950	950	1.0000000
A04	6360944	6367039	A04p10180.2_BraZ1	1093.27	-	1275	5193	6095	0.8520098
A04	6386587	6389923	A04p10190.2_BraZ1	963.179	+	1213	3150	3336	0.9442446
A04	6416814	6418097	A04p10200.2_BraZ1	557.129	-	650	1283	1283	1.0000000
A04	6442303	6442717	A04p10210.2_BraZ1	41.4	-	220	414	414	1.0000000
A04	6443469	6443928	A04p10220.2_BraZ1	45.9	+	44	400	459	0.8714597
A04	6452473	6452629	A04p10230.2_BraZ1	15.6	+	212	156	156	1.0000000
A04	6475400	6477757	A04p10240.2_BraZ1	1126.96	+	654	2221	2357	0.9422995
A04	6478094	6480039	A04p10250.2_BraZ1	1160.51	-	1051	1945	1945	1.0000000
A04	6489289	6489409	A04p10260.2_BraZ1	12	-	205	120	120	1.0000000
A04	6490404	6491081	A04p10270.2_BraZ1	300	+	462	677	677	1.0000000
A04	6497913	6498988	A04p10280.2_BraZ1	660	-	354	945	1075	0.8790697
A04	6510635	6511671	A04p10290.2_BraZ1	556.75	-	561	1036	1036	1.0000000
A04	6512920	6515344	A04p10300.2_BraZ1	688.75	+	932	2262	2424	0.9331683
A04	6533710	6535228	A04p10310.2_BraZ1	782.071	+	1026	1518	1518	1.0000000
A04	6537939	6538152	A04p10320.2_BraZ1	21.3	-	137	213	213	1.0000000
A04	6540754	6542777	A04p10330.2_BraZ1	1357.91	+	1075	2023	2023	1.0000000
A04	6545416	6545969	A04p10340.2_BraZ1	665	-	493	553	553	1.0000000
A04	6547175	6549664	A04p10350.2_BraZ1	2070	+	754	833	2489	0.3346726
A04	6550490	6596277	A04p10360.2_BraZ1	551.25	-	18704	44310	45787	0.9677419
A04	6596685	6598324	A04p10370.2_BraZ1	577.125	-	711	1639	1639	1.0000000
A04	6671978	6672490	A04p10380.2_BraZ1	189	+	388	512	512	1.0000000
A04	6926355	6926550	A04p10390.2_BraZ1	19.5	+	153	195	195	1.0000000
A04	6928450	6928876	A04p10400.2_BraZ1	354	-	148	426	426	1.0000000
A04	6964522	6965141	A04p10410.2_BraZ1	360	-	1088	619	619	1.0000000
A04	6969145	6970874	A04p10420.2_BraZ1	689.633	+	1496	1724	1729	0.9971082
A04	6971537	6972467	A04p10430.2_BraZ1	449.438	-	575	930	930	1.0000000
A04	6975217	6978076	A04p10440.2_BraZ1	1230	+	1750	2859	2859	1.0000000
A04	6978850	6979204	A04p10450.2_BraZ1	285	-	185	354	354	1.0000000
A04	6991360	6994088	A04p10460.2_BraZ1	1977.27	-	1235	2507	2728	0.9189883
A04	6997222	7001179	A04p10470.2_BraZ1	2520	+	2085	3957	3957	1.0000000
A04	6998652	6999284	A04p10480.2_BraZ1	474	+	320	632	632	1.0000000
A04	7073430	7081117	A04p10490.2_BraZ1	1140	-	4062	7587	7687	0.9869910
A04	7094725	7095043	A04p10500.2_BraZ1	120	+	29	318	318	1.0000000
A04	7095043	7095736	A04p10510.2_BraZ1	475.2	+	65	650	693	0.9379509
A04	7099780	7103478	A04p10520.2_BraZ1	2049.86	+	2	22	3698	0.0059492
A04	7106397	7108698	A04p10530.2_BraZ1	57.9	+	3483	2301	2301	1.0000000
A04	7109106	7111425	A04p10540.2_BraZ1	613.2	-	1992	2319	2319	1.0000000
A04	7111425	7120714	A04p10550.2_BraZ1	790.5	-	2526	9289	9289	1.0000000
A04	7121899	7122391	A04p10560.2_BraZ1	1287	+	1526	492	492	1.0000000
A04	7172173	7173621	A04p10570.2_BraZ1	504	-	5546	1448	1448	1.0000000
A04	7199463	7203160	A04p10580.2_BraZ1	2049.86	-	8	218	3697	0.0589667
A04	7214881	7216109	A04p10590.2_BraZ1	647.804	-	1107	1228	1228	1.0000000
A04	7222624	7224495	A04p10600.2_BraZ1	1100.65	-	561	1743	1871	0.9315874
A04	7227882	7231810	A04p10610.2_BraZ1	2089.35	-	1061	3928	3928	1.0000000
A04	7235539	7238236	A04p10620.2_BraZ1	1608.24	-	1105	2551	2697	0.9458658
A04	7244582	7245231	A04p10630.2_BraZ1	2774	+	503	649	649	1.0000000
A04	7246966	7248309	A04p10640.2_BraZ1	606.8	-	2092	1343	1343	1.0000000
A04	7285368	7286981	A04p10650.2_BraZ1	1271	+	19	711	1613	0.4407935
A04	7290887	7291067	A04p10660.2_BraZ1	18	-	263	180	180	1.0000000
A04	7293682	7295001	A04p10670.2_BraZ1	471.429	-	638	1319	1319	1.0000000
A04	7301563	7304629	A04p10680.2_BraZ1	1277.8	+	515	2717	3066	0.8861709
A04	7304747	7304897	A04p10690.2_BraZ1	15	+	216	150	150	1.0000000
A04	7306478	7306832	A04p10700.2_BraZ1	1131	-	339	354	354	1.0000000
A04	7306861	7308036	A04p10710.2_BraZ1	135	+	406	1175	1175	1.0000000
A04	7307175	7308353	A04p10720.2_BraZ1	168.188	+	413	1178	1178	1.0000000
A04	7313295	7314290	A04p10730.2_BraZ1	2028	+	2255	995	995	1.0000000
A04	7314476	7315619	A04p10740.2_BraZ1	1287	+	761	1143	1143	1.0000000
A04	7320340	7324080	A04p10750.2_BraZ1	1548	-	6886	3740	3740	1.0000000
A04	7340661	7343182	A04p10760.2_BraZ1	1611.2	-	1627	2510	2521	0.9956366
A04	7347922	7351459	A04p10770.2_BraZ1	1871.38	-	1209	3228	3537	0.9126378
A04	7354144	7354320	A04p10780.2_BraZ1	17.4	-	195	176	176	1.0000000
A04	7357167	7359882	A04p10790.2_BraZ1	330	+	2569	2715	2715	1.0000000
A04	7372174	7375444	A04p10800.2_BraZ1	1249.83	+	1604	3059	3270	0.9354740
A04	7390823	7391123	A04p10810.2_BraZ1	30	+	26	144	300	0.4800000
A04	7398539	7401257	A04p10820.2_BraZ1	1215	-	692	2101	2718	0.7729949
A04	7408932	7410147	A04p10830.2_BraZ1	121.5	+	1246	1215	1215	1.0000000
A04	7432528	7432786	A04p10840.2_BraZ1	25.8	-	18	233	258	0.9031008
A04	7439031	7439573	A04p10850.2_BraZ1	360	-	239	480	542	0.8856089
A04	7440158	7444674	A04p10860.2_BraZ1	3243	-	1016	3356	4516	0.7431355
A04	7447620	7456293	A04p10870.2_BraZ1	378	+	6758	8479	8673	0.9776317
A04	7448911	7450470	A04p10880.2_BraZ1	114	+	400	1436	1559	0.9211033
A04	7451292	7451875	A04p10890.2_BraZ1	480	+	761	583	583	1.0000000
A04	7452444	7455803	A04p10900.2_BraZ1	1875.24	-	3766	3359	3359	1.0000000
A04	7457323	7459390	A04p10910.2_BraZ1	206.7	-	169	694	2067	0.3357523
A04	7462202	7463672	A04p10920.2_BraZ1	2065.5	+	1703	1470	1470	1.0000000
A04	7466753	7466897	A04p10930.2_BraZ1	14.4	+	392	144	144	1.0000000
A04	7484342	7484864	A04p10940.2_BraZ1	52.2	+	350	522	522	1.0000000
A04	7504550	7509346	A04p10950.2_BraZ1	1374	-	445	3100	4796	0.6463720
A04	7576203	7577071	A04p10960.2_BraZ1	48.3	+	641	868	868	1.0000000
A04	7598915	7599068	A04p10970.2_BraZ1	15.3	+	191	153	153	1.0000000
A04	7605263	7605851	A04p10980.2_BraZ1	58.8	+	866	588	588	1.0000000
A04	7625315	7625774	A04p10990.2_BraZ1	38.4	+	453	459	459	1.0000000
A04	7630171	7632319	A04p11000.2_BraZ1	1158.79	-	415	1831	2148	0.8524209
A04	7634480	7638238	A04p11010.2_BraZ1	2792.7	-	428	2630	3758	0.6998404
A04	7649346	7655619	A04p11020.2_BraZ1	2278.88	+	1779	4465	6273	0.7117807
A04	7656092	7657559	A04p11030.2_BraZ1	915	-	271	1281	1467	0.8732106
A04	7664142	7664622	A04p11040.2_BraZ1	408	-	78	381	480	0.7937500
A04	7667647	7668937	A04p11050.2_BraZ1	129	-	2827	1290	1290	1.0000000
A04	7675566	7675739	A04p11060.2_BraZ1	10.2	-	206	173	173	1.0000000
A04	7679834	7681983	A04p11070.2_BraZ1	1035.48	+	1736	2144	2149	0.9976733
A04	7682347	7683290	A04p11080.2_BraZ1	525	-	111	256	943	0.2714740
A04	7685061	7686110	A04p11090.2_BraZ1	42.6	+	208	1028	1049	0.9799809
A04	7687445	7687772	A04p11100.2_BraZ1	32.7	-	0	0	327	0.0000000
A04	7689580	7691571	A04p11110.2_BraZ1	3518.86	+	1338	1979	1991	0.9939729
A04	7693117	7695426	A04p11120.2_BraZ1	1394.25	-	972	2119	2309	0.9177133
A04	7709602	7711611	A04p11130.2_BraZ1	856.286	+	909	1964	2009	0.9776008
A04	7713675	7714144	A04p11140.2_BraZ1	309	+	467	469	469	1.0000000
A04	7714573	7715161	A04p11150.2_BraZ1	396	-	292	544	588	0.9251701
A04	7724707	7726363	A04p11160.2_BraZ1	165.6	+	350	1521	1656	0.9184783
A04	7727244	7727514	A04p11170.2_BraZ1	27	+	124	270	270	1.0000000
A04	7730025	7730427	A04p11180.2_BraZ1	40.2	+	3	54	402	0.1343284
A04	7738058	7740319	A04p11190.2_BraZ1	483.648	+	1315	2191	2261	0.9690403
A04	7740662	7742813	A04p11200.2_BraZ1	214.5	-	483	2044	2151	0.9502557
A04	7761617	7762822	A04p11210.2_BraZ1	1136.25	+	1026	1099	1205	0.9120332
A04	7763714	7765001	A04p11220.2_BraZ1	678.197	+	1067	1287	1287	1.0000000
A04	7775000	7776056	A04p11230.2_BraZ1	1368	+	755	1056	1056	1.0000000
A04	7784715	7786429	A04p11240.2_BraZ1	1331.91	+	566	1475	1714	0.8605601
A04	7791232	7793147	A04p11250.2_BraZ1	234	-	1035	1915	1915	1.0000000
A04	7791710	7794705	A04p11260.2_BraZ1	743.143	-	2957	2995	2995	1.0000000
A04	7799762	7800435	A04p11270.2_BraZ1	267	-	761	673	673	1.0000000
A04	7808848	7811361	A04p11280.2_BraZ1	1404.21	-	5130	2513	2513	1.0000000
A04	7814300	7815557	A04p11290.2_BraZ1	221.786	+	45	564	1257	0.4486873
A04	7822891	7827326	A04p11300.2_BraZ1	2725.42	+	2150	4212	4435	0.9497182
A04	7830006	7831050	A04p11310.2_BraZ1	698.64	-	380	1044	1044	1.0000000
A04	7835743	7838454	A04p11320.2_BraZ1	972	-	1763	2640	2711	0.9738104
A04	7839084	7839636	A04p11330.2_BraZ1	54.9	-	278	552	552	1.0000000
A04	7845462	7848963	A04p11340.2_BraZ1	1326.49	-	1067	3362	3501	0.9602970
A04	7855593	7860581	A04p11350.2_BraZ1	219	+	2367	4922	4988	0.9867682
A04	7871266	7871653	A04p11360.2_BraZ1	219	+	233	387	387	1.0000000
A04	7879160	7879962	A04p11370.2_BraZ1	726	-	17	122	802	0.1521197
A04	7889147	7892504	A04p11380.2_BraZ1	1785.99	+	568	2875	3357	0.8564194
A04	7893086	7895959	A04p11390.2_BraZ1	1513.23	-	988	2736	2873	0.9523147
A04	7898894	7901032	A04p11400.2_BraZ1	188	-	133	1421	2138	0.6646398
A04	7901532	7904128	A04p11410.2_BraZ1	1200	-	105	986	2596	0.3798151
A04	7907484	7910060	A04p11420.2_BraZ1	1695.8	+	936	2531	2576	0.9825311
A04	7910579	7911925	A04p11430.2_BraZ1	411	+	919	1337	1346	0.9933136
A04	7912275	7913360	A04p11440.2_BraZ1	768	-	223	1012	1085	0.9327189
A04	7923109	7924046	A04p11450.2_BraZ1	177	+	657	937	937	1.0000000
A04	7927280	7929172	A04p11460.2_BraZ1	1602.43	+	962	1892	1892	1.0000000
A04	7929522	7932682	A04p11470.2_BraZ1	1929	-	2251	3117	3160	0.9863924
A04	7933811	7934786	A04p11480.2_BraZ1	576	-	529	975	975	1.0000000
A04	7937076	7937425	A04p11490.2_BraZ1	255	+	424	349	349	1.0000000
A04	7937910	7938801	A04p11500.2_BraZ1	89.1	-	542	814	891	0.9135802
A04	7940203	7942116	A04p11510.2_BraZ1	1806	-	1084	1913	1913	1.0000000
A04	7945745	7949446	A04p11520.2_BraZ1	2163.37	-	718	3485	3701	0.9416374
A04	7960341	7963375	A04p11530.2_BraZ1	21828	+	490	2389	3034	0.7874094
A04	7964685	7965686	A04p11540.2_BraZ1	438	+	428	1001	1001	1.0000000
A04	7966203	7968026	A04p11550.2_BraZ1	837.46	-	726	1803	1823	0.9890290
A04	7968329	7970761	A04p11560.2_BraZ1	1137.08	-	561	1930	2432	0.7935855
A04	7972486	7973090	A04p11570.2_BraZ1	218.833	+	365	543	604	0.8990066
A04	7981808	7988770	A04p11580.2_BraZ1	1998	+	1857	5768	6962	0.8284975
A04	7999193	7999769	A04p11590.2_BraZ1	1093.5	+	600	576	576	1.0000000
A04	8007467	8008035	A04p11600.2_BraZ1	369	-	298	568	568	1.0000000
A04	8009665	8014210	A04p11610.2_BraZ1	2358.3	-	1605	4386	4545	0.9650165
A04	8016110	8017466	A04p11620.2_BraZ1	689.85	-	282	1266	1356	0.9336283
A04	8027276	8029867	A04p11630.2_BraZ1	471.459	+	352	2204	2591	0.8506368
A04	8046366	8054158	A04p11640.2_BraZ1	478.5	-	1128	3740	7792	0.4799795
A04	8080892	8081084	A04p11650.2_BraZ1	19.2	-	304	192	192	1.0000000
A04	8090109	8093850	A04p11660.2_BraZ1	12804	+	2032	3558	3741	0.9510826
A04	8095298	8097834	A04p11670.2_BraZ1	837.857	-	658	2344	2536	0.9242902
A04	8102044	8103070	A04p11680.2_BraZ1	980	-	0	0	1026	0.0000000
A04	8114361	8115663	A04p11690.2_BraZ1	500.077	-	311	1287	1302	0.9884793
A04	8116502	8116688	A04p11700.2_BraZ1	18.6	+	343	186	186	1.0000000
A04	8129568	8130077	A04p11710.2_BraZ1	396	-	13	323	509	0.6345776
A04	8130142	8130399	A04p11720.2_BraZ1	225	+	8	107	257	0.4163424
A04	8130440	8131454	A04p11730.2_BraZ1	1512	+	17	185	1014	0.1824458
A04	8132702	8135219	A04p11740.2_BraZ1	2147.62	+	234	1648	2517	0.6547477
A04	8149686	8152268	A04p11750.2_BraZ1	1101.38	+	962	2549	2582	0.9872192
A04	8157698	8159009	A04p11760.2_BraZ1	130.5	+	185	1128	1311	0.8604119
A04	8176427	8177108	A04p11770.2_BraZ1	68.1	-	187	532	681	0.7812041
A04	8182277	8183921	A04p11780.2_BraZ1	164.4	-	274	1267	1644	0.7706813
A04	8186155	8187316	A04p11790.2_BraZ1	1095	-	410	1069	1161	0.9207579
A04	8187861	8192027	A04p11800.2_BraZ1	1544.85	-	1754	3958	4166	0.9500720
A04	8194283	8196709	A04p11810.2_BraZ1	916.3	-	1034	2148	2426	0.8854081
A04	8216724	8219295	A04p11820.2_BraZ1	865.179	-	1947	2571	2571	1.0000000
A04	8224877	8229455	A04p11830.2_BraZ1	2735.55	+	1214	3456	4578	0.7549148
A04	8242066	8243451	A04p11840.2_BraZ1	996	+	317	1011	1385	0.7299639
A04	8246074	8246328	A04p11850.2_BraZ1	141	-	171	254	254	1.0000000
A04	8249152	8249626	A04p11860.2_BraZ1	261	+	813	474	474	1.0000000
A04	8249999	8250623	A04p11870.2_BraZ1	808.5	-	1104	624	624	1.0000000
A04	8285280	8294390	A04p11880.2_BraZ1	1071.16	-	10177	9036	9110	0.9918771
A04	8295795	8297001	A04p11890.2_BraZ1	271.071	-	745	1034	1206	0.8573798
A04	8296903	8297464	A04p11900.2_BraZ1	285	-	87	521	561	0.9286988
A04	8298414	8299095	A04p11910.2_BraZ1	68.1	+	62	188	681	0.2760646
A04	8300589	8302816	A04p11920.2_BraZ1	1612.5	+	591	2194	2227	0.9851819
A04	8304129	8304716	A04p11930.2_BraZ1	303	+	3	48	587	0.0817717
A04	8305271	8306126	A04p11940.2_BraZ1	420	+	58	583	855	0.6818714
A04	8309928	8310060	A04p11950.2_BraZ1	13.2	+	93	132	132	1.0000000
A04	8310601	8312110	A04p11960.2_BraZ1	577.774	-	602	1193	1509	0.7905898
A04	8315450	8316625	A04p11970.2_BraZ1	559.125	+	4591	1090	1175	0.9276596
A04	8318172	8318362	A04p11980.2_BraZ1	11.4	+	164	190	190	1.0000000
A04	8319861	8321253	A04p11990.2_BraZ1	1127.5	-	145	921	1392	0.6616379
A04	8325378	8328335	A04p12000.2_BraZ1	435.106	-	2328	2957	2957	1.0000000
A04	8330525	8333255	A04p12010.2_BraZ1	1229.31	+	477	1989	2730	0.7285714
A04	8333624	8335618	A04p12020.2_BraZ1	880	-	1519	1967	1994	0.9864594
A04	8351855	8352497	A04p12030.2_BraZ1	429	-	57	442	642	0.6884735
A04	8354225	8354797	A04p12040.2_BraZ1	306	-	435	572	572	1.0000000
A04	8358670	8359584	A04p12050.2_BraZ1	507	+	165	880	914	0.9628009
A04	8379701	8381330	A04p12060.2_BraZ1	6482.25	+	418	1468	1629	0.9011664
A04	8387809	8389442	A04p12070.2_BraZ1	1116	+	1364	1633	1633	1.0000000
A04	8397274	8397698	A04p12080.2_BraZ1	267	-	139	369	424	0.8702830
A04	8399057	8401088	A04p12090.2_BraZ1	1168.48	-	1167	1952	2031	0.9611029
A04	8423750	8423852	A04p12100.2_BraZ1	10.2	-	364	102	102	1.0000000
A04	8434457	8435918	A04p12110.2_BraZ1	852	+	81	701	1461	0.4798084
A04	8445150	8445357	A04p12120.2_BraZ1	20.7	-	617	207	207	1.0000000
A04	8446698	8447232	A04p12130.2_BraZ1	369	+	345	530	534	0.9925094
A04	8457308	8458096	A04p12140.2_BraZ1	642	-	24	326	788	0.4137056
A04	8459258	8459661	A04p12150.2_BraZ1	240	-	0	0	403	0.0000000
A04	8463843	8466658	A04p12160.2_BraZ1	887.75	+	1250	2671	2815	0.9488454
A04	8467453	8468363	A04p12170.2_BraZ1	694.841	-	21	484	910	0.5318682
A04	8471942	8473454	A04p12180.2_BraZ1	2803.5	-	849	1399	1512	0.9252645
A04	8479254	8480445	A04p12190.2_BraZ1	119.1	+	322	1191	1191	1.0000000
A04	8481827	8482832	A04p12200.2_BraZ1	330	+	207	796	1005	0.7920398
A04	8483478	8483913	A04p12210.2_BraZ1	43.5	-	527	435	435	1.0000000
A04	8485753	8490928	A04p12220.2_BraZ1	2880	-	693	2372	5175	0.4583575
A04	8491308	8493096	A04p12230.2_BraZ1	960	-	290	1098	1788	0.6140940
A04	8493176	8493587	A04p12240.2_BraZ1	39.9	+	535	411	411	1.0000000
A04	8499975	8500848	A04p12250.2_BraZ1	546	-	131	674	873	0.7720504
A04	8503475	8503894	A04p12260.2_BraZ1	1236	+	279	419	419	1.0000000
A04	8510701	8511763	A04p12270.2_BraZ1	651	-	226	840	1062	0.7909604
A04	8515489	8517355	A04p12280.2_BraZ1	8393.25	-	321	1692	1866	0.9067524
A04	8521788	8526414	A04p12290.2_BraZ1	1305.25	+	3775	4596	4626	0.9935149
A04	8533206	8534167	A04p12300.2_BraZ1	477	+	189	910	961	0.9469303
A04	8535681	8553895	A04p12310.2_BraZ1	1979.07	+	4864	15658	18214	0.8596684
A04	8560892	8562227	A04p12320.2_BraZ1	132	+	95	776	1335	0.5812734
A04	8562815	8562941	A04p12330.2_BraZ1	11.4	+	7	55	126	0.4365079
A04	8564308	8566139	A04p12340.2_BraZ1	1639	+	620	1809	1831	0.9879847
A04	8573149	8574121	A04p12350.2_BraZ1	801	+	231	825	972	0.8487654
A04	8577847	8578411	A04p12360.2_BraZ1	56.4	-	125	564	564	1.0000000
A04	8592309	8597470	A04p12370.2_BraZ1	222	-	4822	5161	5161	1.0000000
A04	8598590	8599376	A04p12380.2_BraZ1	78.6	-	280	662	786	0.8422392
A04	8608783	8609662	A04p12390.2_BraZ1	1224	-	139	788	879	0.8964733
A04	8610704	8611064	A04p12400.2_BraZ1	36	+	459	360	360	1.0000000
A04	8611380	8612584	A04p12410.2_BraZ1	999	-	973	1128	1204	0.9368771
A04	8615006	8615820	A04p12420.2_BraZ1	20611.5	+	16	507	814	0.6228501
A04	8617791	8618787	A04p12430.2_BraZ1	717	+	1126	996	996	1.0000000
A04	8623263	8624065	A04p12440.2_BraZ1	4538.62	+	41	637	802	0.7942643
A04	8627317	8627647	A04p12450.2_BraZ1	33	+	28	325	330	0.9848485
A04	8628455	8630841	A04p12460.2_BraZ1	1116.38	+	247	1634	2386	0.6848282
A04	8631571	8633144	A04p12470.2_BraZ1	1080	-	165	1377	1573	0.8753973
A04	8634683	8636719	A04p12480.2_BraZ1	270	-	58	1221	2036	0.5997053
A04	8636890	8643747	A04p12490.2_BraZ1	2138.4	-	983	3921	6857	0.5718244
A04	8647424	8649799	A04p12500.2_BraZ1	925.965	-	1662	2322	2375	0.9776842
A04	8658260	8658647	A04p12510.2_BraZ1	38.7	+	2	29	387	0.0749354
A04	8659769	8660574	A04p12520.2_BraZ1	18154.5	-	55	690	805	0.8571429
A04	8661861	8663262	A04p12530.2_BraZ1	140.1	+	765	1401	1401	1.0000000
A04	8680371	8683965	A04p12540.2_BraZ1	1038.4	-	530	2222	3594	0.6182526
A04	8700665	8703087	A04p12550.2_BraZ1	1367.94	-	1100	2379	2422	0.9822461
A04	8704797	8705133	A04p12560.2_BraZ1	261	-	569	336	336	1.0000000
A04	8707953	8710508	A04p12570.2_BraZ1	1030.84	+	994	2548	2555	0.9972603
A04	8718178	8719218	A04p12580.2_BraZ1	744	+	560	943	1040	0.9067308
A04	8721552	8721811	A04p12590.2_BraZ1	17.1	-	64	259	259	1.0000000
A04	8725561	8727300	A04p12600.2_BraZ1	1233.06	-	1027	1633	1739	0.9390454
A04	8734719	8737737	A04p12610.2_BraZ1	1500	-	2635	2989	3018	0.9903910
A04	8756136	8758316	A04p12620.2_BraZ1	1358.6	+	1638	2074	2180	0.9513761
A04	8763238	8765656	A04p12630.2_BraZ1	1869.23	+	1788	2162	2418	0.8941274
A04	8770890	8772559	A04p12640.2_BraZ1	747.67	+	1182	1669	1669	1.0000000
A04	8773134	8774231	A04p12650.2_BraZ1	1463.06	-	462	1097	1097	1.0000000
A04	8774346	8774679	A04p12660.2_BraZ1	33.3	-	405	312	333	0.9369369
A04	8775725	8777063	A04p12670.2_BraZ1	693	+	834	1020	1338	0.7623318
A04	8777611	8780046	A04p12680.2_BraZ1	1635.93	-	1591	2319	2435	0.9523614
A04	8782213	8782455	A04p12690.2_BraZ1	16.8	+	204	242	242	1.0000000
A04	8788730	8790198	A04p12700.2_BraZ1	5841	-	463	1208	1468	0.8228883
A04	8795778	8796663	A04p12710.2_BraZ1	495	-	0	0	885	0.0000000
A04	8802125	8803581	A04p12720.2_BraZ1	5192	+	7454	1456	1456	1.0000000
A04	8810310	8815576	A04p12730.2_BraZ1	348.632	+	4088	4836	5266	0.9183441
A04	8817181	8817412	A04p12740.2_BraZ1	23.1	+	61	231	231	1.0000000
A04	8819782	8821129	A04p12750.2_BraZ1	134.7	-	787	1347	1347	1.0000000
A04	8822078	8822569	A04p12760.2_BraZ1	231	+	122	491	491	1.0000000
A04	8829461	8830643	A04p12770.2_BraZ1	1456.88	-	729	1182	1182	1.0000000
A04	8847497	8850182	A04p12780.2_BraZ1	1099.17	+	811	2154	2685	0.8022346
A04	8852747	8854437	A04p12790.2_BraZ1	647.578	-	1597	1690	1690	1.0000000
A04	8857361	8858715	A04p12800.2_BraZ1	829.98	-	1569	1354	1354	1.0000000
A04	8861613	8863395	A04p12810.2_BraZ1	178.2	+	240	1548	1782	0.8686869
A04	8869733	8870036	A04p12820.2_BraZ1	30.3	+	32	134	303	0.4422442
A04	8896782	8897166	A04p12830.2_BraZ1	38.4	+	46	315	384	0.8203125
A04	8904095	8906371	A04p12840.2_BraZ1	2432.14	+	967	2265	2276	0.9951670
A04	8906685	8909839	A04p12850.2_BraZ1	1481.83	-	2516	3079	3154	0.9762207
A04	8910378	8910699	A04p12860.2_BraZ1	32.1	-	306	321	321	1.0000000
A04	8913845	8914004	A04p12870.2_BraZ1	15.9	+	138	159	159	1.0000000
A04	8923305	8923551	A04p12880.2_BraZ1	24.6	+	176	246	246	1.0000000
A04	8926216	8927800	A04p12890.2_BraZ1	158.4	-	504	1584	1584	1.0000000
A04	8930837	8934111	A04p12900.2_BraZ1	2138.31	+	1754	3183	3274	0.9722053
A04	8934566	8934991	A04p12910.2_BraZ1	83.1818	+	553	425	425	1.0000000
A04	8945637	8947209	A04p12920.2_BraZ1	901.8	+	470	1424	1572	0.9058524
A04	8948214	8949258	A04p12930.2_BraZ1	954	-	241	969	1044	0.9281609
A04	8953489	8954758	A04p12940.2_BraZ1	489	+	1510	1269	1269	1.0000000
A04	8968391	8968772	A04p12950.2_BraZ1	38.1	-	774	381	381	1.0000000
A04	8969509	8971271	A04p12960.2_BraZ1	156	-	1322	1762	1762	1.0000000
A04	8979865	8980427	A04p12970.2_BraZ1	1470	+	61	530	562	0.9430605
A04	8981715	8981913	A04p12980.2_BraZ1	19.8	-	43	198	198	1.0000000
A04	8984158	8985212	A04p12990.2_BraZ1	68.4	+	301	925	1054	0.8776091
A04	8994710	8994977	A04p13000.2_BraZ1	26.7	+	518	267	267	1.0000000
A04	8997079	8997187	A04p13010.2_BraZ1	10.8	+	220	108	108	1.0000000
A04	8999557	9000220	A04p13020.2_BraZ1	522	+	806	663	663	1.0000000
A04	9018341	9020104	A04p13030.2_BraZ1	752.25	-	1556	1763	1763	1.0000000
A04	9023216	9025949	A04p13040.2_BraZ1	273.3	+	1472	2710	2733	0.9915844
A04	9031659	9034158	A04p13050.2_BraZ1	249.9	+	559	1965	2499	0.7863145
A04	9034945	9038221	A04p13060.2_BraZ1	1819.12	+	1103	3191	3276	0.9740537
A04	9055676	9055943	A04p13070.2_BraZ1	165	+	251	267	267	1.0000000
A04	9057775	9058267	A04p13080.2_BraZ1	372	+	18	461	492	0.9369919
A04	9060045	9061449	A04p13090.2_BraZ1	140.1	+	850	1171	1404	0.8340456
A04	9072367	9073142	A04p13100.2_BraZ1	669	-	12	360	775	0.4645161
A04	9077776	9079200	A04p13110.2_BraZ1	462	+	1526	1424	1424	1.0000000
A04	9081512	9083290	A04p13120.2_BraZ1	1434.38	-	699	1778	1778	1.0000000
A04	9084096	9084237	A04p13130.2_BraZ1	14.1	+	430	141	141	1.0000000
A04	9123524	9123890	A04p13140.2_BraZ1	36.6	-	36	344	366	0.9398907
A04	9142628	9144105	A04p13150.2_BraZ1	5115	-	1400	1477	1477	1.0000000
A04	9150591	9152511	A04p13160.2_BraZ1	966	+	869	1285	1920	0.6692708
A04	9155254	9156579	A04p13170.2_BraZ1	819	-	115	618	1325	0.4664151
A04	9166263	9169312	A04p13180.2_BraZ1	797.903	-	4208	3049	3049	1.0000000
A04	9170911	9173887	A04p13190.2_BraZ1	2199	+	619	2610	2976	0.8770161
A04	9175674	9177117	A04p13200.2_BraZ1	144.3	+	23	89	1443	0.0616771
A04	9180131	9180377	A04p13210.2_BraZ1	24.6	+	18	87	246	0.3536585
A04	9193723	9195362	A04p13220.2_BraZ1	414.257	+	354	1135	1639	0.6924954
A04	9195808	9197827	A04p13230.2_BraZ1	201.9	+	263	1697	2019	0.8405151
A04	9198105	9198858	A04p13240.2_BraZ1	75.3	-	54	357	753	0.4741036
A04	9200593	9202096	A04p13250.2_BraZ1	150.3	-	575	1496	1503	0.9953427
A04	9211481	9211664	A04p13260.2_BraZ1	18.3	-	239	183	183	1.0000000
A04	9216368	9216686	A04p13270.2_BraZ1	2311.5	+	23	305	318	0.9591195
A04	9221096	9221527	A04p13280.2_BraZ1	165	-	2	108	431	0.2505800
A04	9224669	9225599	A04p13290.2_BraZ1	441	-	102	454	930	0.4881721
A04	9229817	9230741	A04p13300.2_BraZ1	422.333	-	414	918	924	0.9935065
A04	9243831	9245464	A04p13310.2_BraZ1	351	-	0	0	1633	0.0000000
A04	9248993	9251182	A04p13320.2_BraZ1	1276.5	+	834	1988	2189	0.9081773
A04	9251537	9253182	A04p13330.2_BraZ1	1273.17	-	276	1382	1645	0.8401216
A04	9257734	9261546	A04p13340.2_BraZ1	1575.68	+	1171	2811	3812	0.7374082
A04	9266993	9267896	A04p13350.2_BraZ1	90.3	+	650	903	903	1.0000000
A04	9269140	9271759	A04p13360.2_BraZ1	759.833	+	804	2573	2619	0.9824361
A04	9281856	9282102	A04p13370.2_BraZ1	180	+	267	246	246	1.0000000
A04	9282576	9285486	A04p13380.2_BraZ1	1295.56	-	152	1758	2910	0.6041237
A04	9293017	9293134	A04p13390.2_BraZ1	11.7	+	146	117	117	1.0000000
A04	9300285	9303455	A04p13400.2_BraZ1	1485	+	633	2577	3170	0.8129337
A04	9309473	9310136	A04p13410.2_BraZ1	65.7	-	120	562	663	0.8476622
A04	9316789	9318502	A04p13420.2_BraZ1	171	+	381	1301	1713	0.7594863
A04	9319189	9320707	A04p13430.2_BraZ1	151.5	-	2167	1518	1518	1.0000000
A04	9340425	9344082	A04p13440.2_BraZ1	1285.7	+	2414	3657	3657	1.0000000
A04	9355684	9356018	A04p13450.2_BraZ1	132	-	187	334	334	1.0000000
A04	9358136	9358557	A04p13460.2_BraZ1	198	-	265	421	421	1.0000000
A04	9367062	9371593	A04p13470.2_BraZ1	3441.6	+	476	1625	4531	0.3586405
A04	9375876	9376915	A04p13480.2_BraZ1	575.25	-	119	955	1039	0.9191530
A04	9386752	9387049	A04p13490.2_BraZ1	243	+	19	297	297	1.0000000
A04	9387473	9388169	A04p13500.2_BraZ1	588	-	154	696	696	1.0000000
A04	9392724	9393980	A04p13510.2_BraZ1	649	-	54	703	1256	0.5597134
A04	9394758	9395867	A04p13520.2_BraZ1	615.885	-	486	1091	1109	0.9837692
A04	9397072	9398975	A04p13530.2_BraZ1	2379	+	1910	1852	1903	0.9732002
A04	9399286	9399934	A04p13540.2_BraZ1	953.7	+	213	581	648	0.8966050
A04	9401009	9401398	A04p13550.2_BraZ1	279	+	41	291	389	0.7480720
A04	9405283	9407456	A04p13560.2_BraZ1	1528.41	+	1334	2173	2173	1.0000000
A04	9409070	9409565	A04p13570.2_BraZ1	49.5	-	483	495	495	1.0000000
A04	9410362	9410554	A04p13580.2_BraZ1	10.2	+	191	192	192	1.0000000
A04	9412856	9414086	A04p13590.2_BraZ1	870	-	70	838	1230	0.6813008
A04	9428357	9429092	A04p13600.2_BraZ1	73.5	+	31	522	735	0.7102041
A04	9446997	9448808	A04p13610.2_BraZ1	1338	+	323	1392	1811	0.7686361
A04	9459290	9459890	A04p13620.2_BraZ1	60	+	6	44	600	0.0733333
A04	9461285	9462378	A04p13630.2_BraZ1	795	+	480	1093	1093	1.0000000
A04	9462580	9463762	A04p13640.2_BraZ1	896.318	-	127	758	1182	0.6412860
A04	9472341	9474579	A04p13650.2_BraZ1	223.8	+	141	1432	2238	0.6398570
A04	9478471	9479623	A04p13660.2_BraZ1	115.2	-	437	989	1152	0.8585069
A04	9495167	9496063	A04p13670.2_BraZ1	452.827	+	553	757	896	0.8448661
A04	9512073	9512981	A04p13680.2_BraZ1	488.475	+	110	645	908	0.7103524
A04	9513243	9513734	A04p13690.2_BraZ1	38.1	+	68	437	491	0.8900204
A04	9517956	9519939	A04p13700.2_BraZ1	693	-	4078	1983	1983	1.0000000
A04	9522509	9523469	A04p13710.2_BraZ1	95.7	+	154	845	960	0.8802083
A04	9538813	9543125	A04p13720.2_BraZ1	2497.5	+	696	3585	4312	0.8314008
A04	9543991	9545827	A04p13730.2_BraZ1	868.56	-	978	1836	1836	1.0000000
A04	9547678	9549153	A04p13740.2_BraZ1	633.6	+	152	675	1475	0.4576271
A04	9549550	9550017	A04p13750.2_BraZ1	302.885	+	74	467	467	1.0000000
A04	9552710	9553079	A04p13760.2_BraZ1	36.9	+	105	369	369	1.0000000
A04	9554565	9557257	A04p13770.2_BraZ1	1270.12	+	1836	2692	2692	1.0000000
A04	9580606	9589241	A04p13780.2_BraZ1	2656.67	+	1439	4959	8635	0.5742907
A04	9584028	9584501	A04p13790.2_BraZ1	38.3077	-	3	183	473	0.3868922
A04	9584898	9587727	A04p13800.2_BraZ1	1148.4	-	194	1016	2829	0.3591375
A04	9603589	9610584	A04p13810.2_BraZ1	962.364	+	5631	5011	6995	0.7163689
A04	9611856	9616269	A04p13820.2_BraZ1	2057.59	-	4190	4413	4413	1.0000000
A04	9618518	9619751	A04p13830.2_BraZ1	123.3	-	728	1233	1233	1.0000000
A04	9627800	9629039	A04p13840.2_BraZ1	939	-	230	835	1239	0.6739306
A04	9634943	9636123	A04p13850.2_BraZ1	775.5	+	274	1069	1180	0.9059322
A04	9638975	9639398	A04p13860.2_BraZ1	42.3	+	199	423	423	1.0000000
A04	9643371	9647340	A04p13870.2_BraZ1	303	+	1370	3706	3969	0.9337364
A04	9649659	9652412	A04p13880.2_BraZ1	1175.27	-	493	2318	2753	0.8419905
A04	9654581	9656168	A04p13890.2_BraZ1	990	+	74	1258	1587	0.7926906
A04	9655699	9662012	A04p13900.2_BraZ1	1653	+	1010	4770	6313	0.7555837
A04	9662774	9669533	A04p13910.2_BraZ1	1898.79	+	3278	6093	6759	0.9014647
A04	9670135	9670618	A04p13920.2_BraZ1	246	-	61	483	483	1.0000000
A04	9678193	9679981	A04p13930.2_BraZ1	1287	+	633	1602	1788	0.8959731
A04	9680325	9681729	A04p13940.2_BraZ1	140.4	-	391	1344	1404	0.9572650
A04	9688720	9689046	A04p13950.2_BraZ1	31.2	+	219	326	326	1.0000000
A04	9691289	9691547	A04p13960.2_BraZ1	25.8	+	44	258	258	1.0000000
A04	9693026	9694732	A04p13970.2_BraZ1	336	-	3046	1706	1706	1.0000000
A04	9693168	9693366	A04p13980.2_BraZ1	171	-	587	198	198	1.0000000
A04	9706102	9708829	A04p13990.2_BraZ1	600	-	2023	2727	2727	1.0000000
A04	9710029	9712800	A04p14000.2_BraZ1	886.615	-	5	101	2771	0.0364489
A04	9714810	9717578	A04p14010.2_BraZ1	886.615	-	0	0	2768	0.0000000
A04	9719588	9722357	A04p14020.2_BraZ1	886.615	-	0	0	2769	0.0000000
A04	9727850	9730918	A04p14030.2_BraZ1	246.75	-	3406	3068	3068	1.0000000
A04	9731547	9734910	A04p14040.2_BraZ1	273	-	1637	3363	3363	1.0000000
A04	9746417	9748353	A04p14050.2_BraZ1	1500	-	250	1209	1936	0.6244835
A04	9755205	9757614	A04p14060.2_BraZ1	1125.54	-	3038	2342	2409	0.9721876
A04	9758352	9759615	A04p14070.2_BraZ1	1965.6	-	0	0	1263	0.0000000
A04	9759696	9760759	A04p14080.2_BraZ1	677.167	-	0	0	1063	0.0000000
A04	9763678	9763963	A04p14090.2_BraZ1	28.5	+	250	285	285	1.0000000
A04	9768522	9771091	A04p14100.2_BraZ1	1290.05	-	947	1871	2569	0.7282990
A04	9779124	9779667	A04p14110.2_BraZ1	54.3	-	166	481	543	0.8858195
A04	9780169	9782251	A04p14120.2_BraZ1	746.524	+	1275	1064	2082	0.5110471
A04	9787129	9787686	A04p14130.2_BraZ1	477	+	31	120	557	0.2154399
A04	9789993	9791019	A04p14140.2_BraZ1	417	-	221	904	1026	0.8810916
A04	9801799	9802165	A04p14150.2_BraZ1	237	+	7	73	366	0.1994535
A04	9803853	9804949	A04p14160.2_BraZ1	106.5	+	460	1090	1096	0.9945256
A04	9804865	9807885	A04p14170.2_BraZ1	4746	-	929	2966	3020	0.9821192
A04	9808352	9809732	A04p14180.2_BraZ1	426.714	-	1136	1366	1380	0.9898551
A04	9810070	9813927	A04p14190.2_BraZ1	1901.07	+	2741	3810	3857	0.9878144
A04	9816926	9817133	A04p14200.2_BraZ1	20.7	+	315	207	207	1.0000000
A04	9819818	9820740	A04p14210.2_BraZ1	777	-	1189	922	922	1.0000000
A04	9822054	9825244	A04p14220.2_BraZ1	1274.95	-	2407	3141	3190	0.9846395
A04	9840018	9842250	A04p14230.2_BraZ1	699.793	+	958	2211	2232	0.9905914
A04	9843126	9847474	A04p14240.2_BraZ1	291.196	+	3718	4325	4348	0.9947102
A04	9844992	9845301	A04p14250.2_BraZ1	30.9	-	439	309	309	1.0000000
A04	9848617	9854327	A04p14260.2_BraZ1	1137	-	4024	5710	5710	1.0000000
A04	9850626	9851049	A04p14270.2_BraZ1	42.3	-	142	423	423	1.0000000
A04	9855782	9856236	A04p14280.2_BraZ1	42.3	-	537	454	454	1.0000000
A04	9864797	9866549	A04p14290.2_BraZ1	168.9	+	599	1620	1752	0.9246575
A04	9868351	9868562	A04p14300.2_BraZ1	153	+	3	59	211	0.2796209
A04	9868668	9869343	A04p14310.2_BraZ1	594	+	223	675	675	1.0000000
A04	9873227	9874193	A04p14320.2_BraZ1	96.6	-	374	851	966	0.8809524
A04	9874809	9876372	A04p14330.2_BraZ1	3457.5	-	1690	1563	1563	1.0000000
A04	9877218	9878723	A04p14340.2_BraZ1	906.632	-	679	1505	1505	1.0000000
A04	9885194	9889650	A04p14350.2_BraZ1	1017.29	-	1207	3888	4456	0.8725314
A04	9892878	9895458	A04p14360.2_BraZ1	1452.03	+	1082	2481	2580	0.9616279
A04	9902792	9910015	A04p14370.2_BraZ1	4515.69	-	2731	6392	7223	0.8849509
A04	9910735	9911144	A04p14380.2_BraZ1	228	-	134	409	409	1.0000000
A04	9911276	9912987	A04p14390.2_BraZ1	915.682	-	790	1656	1711	0.9678550
A04	9914321	9919761	A04p14400.2_BraZ1	515.073	-	1055	4072	5440	0.7485294
A04	9920830	9921916	A04p14410.2_BraZ1	108.6	+	150	907	1086	0.8351750
A04	9940051	9940360	A04p14420.2_BraZ1	30.9	+	12	26	309	0.0841424
A04	9948060	9949346	A04p14430.2_BraZ1	689.686	+	822	1286	1286	1.0000000
A04	9950109	9953702	A04p14440.2_BraZ1	1294.18	-	496	2779	3593	0.7734483
A04	9954934	9958027	A04p14450.2_BraZ1	1259.35	+	793	2991	3093	0.9670223
A04	9958570	9960138	A04p14460.2_BraZ1	825	+	1191	1532	1568	0.9770408
A04	9964040	9965816	A04p14470.2_BraZ1	177.6	-	451	1597	1776	0.8992117
A04	9970519	9971163	A04p14480.2_BraZ1	1386	+	0	0	644	0.0000000
A04	9975930	9976655	A04p14490.2_BraZ1	264	+	89	675	725	0.9310345
A04	9984881	9985536	A04p14500.2_BraZ1	171	-	75	455	655	0.6946565
A04	9989797	9990407	A04p14510.2_BraZ1	327	+	470	610	610	1.0000000
A04	9991373	9992716	A04p14520.2_BraZ1	337.5	+	829	1343	1343	1.0000000
A04	10001577	10004337	A04p14530.2_BraZ1	557.176	+	2996	2760	2760	1.0000000
A04	10012743	10013445	A04p14540.2_BraZ1	70.2	-	249	684	702	0.9743590
A04	10016920	10017482	A04p14550.2_BraZ1	15.3	-	984	562	562	1.0000000
A04	10017683	10019519	A04p14560.2_BraZ1	1185	-	1077	1836	1836	1.0000000
A04	10021386	10023031	A04p14570.2_BraZ1	1388.57	-	978	1645	1645	1.0000000
A04	10023703	10025084	A04p14580.2_BraZ1	3304	-	1484	1381	1381	1.0000000
A04	10025556	10026408	A04p14590.2_BraZ1	85.2	+	91	852	852	1.0000000
A04	10027668	10034071	A04p14600.2_BraZ1	915	+	381	4095	6403	0.6395440
A04	10034795	10035470	A04p14610.2_BraZ1	525	-	40	409	675	0.6059259
A04	10038746	10039619	A04p14620.2_BraZ1	87.3	+	97	748	873	0.8568156
A04	10043719	10044466	A04p14630.2_BraZ1	74.7	-	321	461	747	0.6171352
A04	10044991	10045720	A04p14640.2_BraZ1	72.9	-	62	229	729	0.3141289
A04	10045822	10046479	A04p14650.2_BraZ1	65.7	-	35	186	657	0.2831050
A04	10047112	10047982	A04p14660.2_BraZ1	87	+	68	788	870	0.9057471
A04	10057106	10057515	A04p14670.2_BraZ1	20.7	+	651	409	409	1.0000000
A04	10063316	10064195	A04p14680.2_BraZ1	87.9	+	20	546	879	0.6211604
A04	10066970	10069009	A04p14690.2_BraZ1	771	-	774	1892	2039	0.9279059
A04	10072290	10073163	A04p14700.2_BraZ1	87.3	+	6	412	873	0.4719359
A04	10074934	10075144	A04p14710.2_BraZ1	21	-	0	0	210	0.0000000
A04	10076942	10077140	A04p14720.2_BraZ1	19.8	-	57	198	198	1.0000000
A04	10096970	10100327	A04p14730.2_BraZ1	2334	+	741	2971	3357	0.8850164
A04	10101563	10103426	A04p14740.2_BraZ1	186.3	+	1366	1863	1863	1.0000000
A04	10104414	10105617	A04p14750.2_BraZ1	663	-	637	1203	1203	1.0000000
A04	10109081	10111355	A04p14760.2_BraZ1	1518	+	293	1911	2274	0.8403694
A04	10120296	10121654	A04p14770.2_BraZ1	5798.57	-	787	1358	1358	1.0000000
A04	10126368	10127721	A04p14780.2_BraZ1	885.938	-	693	1353	1353	1.0000000
A04	10131826	10132147	A04p14790.2_BraZ1	32.1	+	5	243	321	0.7570093
A04	10141484	10141601	A04p14800.2_BraZ1	11.7	-	330	117	117	1.0000000
A04	10142658	10143348	A04p14810.2_BraZ1	39.9	+	5	4	690	0.0057971
A04	10145831	10147283	A04p14820.2_BraZ1	145.2	-	232	1297	1452	0.8932507
A04	10151198	10152155	A04p14830.2_BraZ1	495	+	356	957	957	1.0000000
A04	10161766	10161986	A04p14840.2_BraZ1	19.2	-	186	218	220	0.9909091
A04	10165511	10167156	A04p14850.2_BraZ1	149.4	+	43	621	1645	0.3775076
A04	10174034	10174588	A04p14860.2_BraZ1	510	+	548	554	554	1.0000000
A04	10176734	10179760	A04p14870.2_BraZ1	1267.25	+	798	2169	3026	0.7167878
A04	10181410	10183336	A04p14880.2_BraZ1	993	+	194	1449	1926	0.7523364
A04	10185653	10193272	A04p14890.2_BraZ1	821.429	+	7025	6999	7619	0.9186245
A04	10200156	10200414	A04p14900.2_BraZ1	192	-	0	0	258	0.0000000
A04	10201640	10202998	A04p14910.2_BraZ1	1018.29	+	869	1358	1358	1.0000000
A04	10208527	10210116	A04p14920.2_BraZ1	969.231	+	190	1036	1589	0.6519824
A04	10210460	10211613	A04p14930.2_BraZ1	2468.67	-	586	1153	1153	1.0000000
A04	10214462	10216040	A04p14940.2_BraZ1	157.8	-	29	82	1578	0.0519645
A04	10217093	10221788	A04p14950.2_BraZ1	1232.41	-	1779	3775	4695	0.8040469
A04	10232022	10232421	A04p14960.2_BraZ1	39.9	+	40	291	399	0.7293233
A04	10233574	10234785	A04p14970.2_BraZ1	381	+	51	517	1211	0.4269199
A04	10253262	10254252	A04p14980.2_BraZ1	489	-	161	732	990	0.7393939
A04	10254667	10255237	A04p14990.2_BraZ1	297	+	176	251	570	0.4403509
A04	10263917	10264451	A04p15000.2_BraZ1	375	-	296	534	534	1.0000000
A04	10284839	10287704	A04p15010.2_BraZ1	1399.01	+	1367	2800	2865	0.9773124
A04	10287921	10288418	A04p15020.2_BraZ1	1683	-	125	486	497	0.9778672
A04	10291284	10293316	A04p15030.2_BraZ1	972	-	1050	1959	2032	0.9640748
A04	10294826	10296345	A04p15040.2_BraZ1	785.126	+	507	1415	1519	0.9315339
A04	10296953	10297634	A04p15050.2_BraZ1	68.1	+	244	534	681	0.7841409
A04	10297953	10299512	A04p15060.2_BraZ1	673.655	-	816	1559	1559	1.0000000
A04	10303329	10303533	A04p15070.2_BraZ1	20.4	+	0	0	204	0.0000000
A04	10304652	10308492	A04p15080.2_BraZ1	1897.2	-	1754	3806	3840	0.9911458
A04	10315930	10317515	A04p15090.2_BraZ1	17931	-	1638	1508	1585	0.9514195
A04	10317973	10318321	A04p15100.2_BraZ1	34.8	-	0	0	348	0.0000000
A04	10321662	10322060	A04p15110.2_BraZ1	325.125	+	115	398	398	1.0000000
A04	10324337	10324824	A04p15120.2_BraZ1	276	-	1945	487	487	1.0000000
A04	10326950	10327052	A04p15130.2_BraZ1	10.2	+	0	0	102	0.0000000
A04	10327251	10327478	A04p15140.2_BraZ1	135	+	0	0	227	0.0000000
A04	10328949	10331333	A04p15150.2_BraZ1	488.212	+	0	0	2384	0.0000000
A04	10336372	10336558	A04p15160.2_BraZ1	18.6	+	326	186	186	1.0000000
A04	10362603	10363016	A04p15170.2_BraZ1	318	-	105	413	413	1.0000000
A04	10366017	10367010	A04p15180.2_BraZ1	534	+	210	993	993	1.0000000
A04	10369263	10369837	A04p15190.2_BraZ1	267	-	84	439	574	0.7648084
A04	10371182	10374444	A04p15200.2_BraZ1	1224.08	+	1099	2552	3262	0.7823421
A04	10375526	10376394	A04p15210.2_BraZ1	936	+	3328	868	868	1.0000000
A04	10382332	10383337	A04p15220.2_BraZ1	271.227	-	264	999	1005	0.9940299
A04	10384738	10384885	A04p15230.2_BraZ1	14.7	+	6	147	147	1.0000000
A04	10386436	10387369	A04p15240.2_BraZ1	93.3	-	38	284	933	0.3043944
A04	10394917	10395751	A04p15250.2_BraZ1	83.4	-	16	89	834	0.1067146
A04	10397628	10397922	A04p15260.2_BraZ1	29.4	+	27	200	294	0.6802721
A04	10402399	10411589	A04p15270.2_BraZ1	1074	+	29666	5134	9190	0.5586507
A04	10413548	10418532	A04p15280.2_BraZ1	1669.69	+	1421	4213	4984	0.8453050
A04	10418830	10422903	A04p15290.2_BraZ1	1765.51	-	3345	4073	4073	1.0000000
A04	10424308	10425810	A04p15300.2_BraZ1	1026.32	+	583	1502	1502	1.0000000
A04	10430268	10431407	A04p15310.2_BraZ1	113.7	-	57	417	1139	0.3661106
A04	10433706	10435975	A04p15320.2_BraZ1	639.955	+	444	1675	2269	0.7382107
A04	10448043	10450750	A04p15330.2_BraZ1	1346.32	+	1174	2706	2707	0.9996306
A04	10451128	10451422	A04p15340.2_BraZ1	270	-	253	294	294	1.0000000
A04	10451798	10453917	A04p15350.2_BraZ1	2340	-	1498	2119	2119	1.0000000
A04	10457297	10462736	A04p15360.2_BraZ1	2034	+	2171	3985	5439	0.7326714
A04	10465477	10470949	A04p15370.2_BraZ1	3015	+	2464	4868	5472	0.8896199
A04	10466132	10468181	A04p15380.2_BraZ1	41.7	+	353	1688	2049	0.8238165
A04	10473732	10475076	A04p15390.2_BraZ1	134.1	+	44	911	1344	0.6778274
A04	10477813	10483121	A04p15400.2_BraZ1	2034	+	764	4073	5308	0.7673323
A04	10485930	10487037	A04p15410.2_BraZ1	903	+	655	1107	1107	1.0000000
A04	10488597	10489737	A04p15420.2_BraZ1	111	-	310	1080	1140	0.9473684
A04	10490395	10491272	A04p15430.2_BraZ1	753.357	+	357	847	877	0.9657925
A04	10492075	10494653	A04p15440.2_BraZ1	247.333	-	510	2328	2578	0.9030256
A04	10496236	10498303	A04p15450.2_BraZ1	206.7	-	2049	2067	2067	1.0000000
A04	10498939	10499605	A04p15460.2_BraZ1	66.3	+	234	666	666	1.0000000
A04	10501676	10503230	A04p15470.2_BraZ1	1312.68	+	158	969	1554	0.6235521
A04	10503585	10504219	A04p15480.2_BraZ1	537	-	217	634	634	1.0000000
A04	10505799	10506175	A04p15490.2_BraZ1	294	+	272	376	376	1.0000000
A04	10507757	10509675	A04p15500.2_BraZ1	1181.18	+	715	1918	1918	1.0000000
A04	10510632	10511903	A04p15510.2_BraZ1	1250.5	+	566	1235	1271	0.9716759
A04	10518733	10520660	A04p15520.2_BraZ1	966.857	+	349	1752	1927	0.9091853
A04	10528039	10528778	A04p15530.2_BraZ1	606	+	36	546	739	0.7388363
A04	10537915	10543791	A04p15540.2_BraZ1	2692.33	+	3035	5691	5876	0.9685160
A04	10546613	10547134	A04p15550.2_BraZ1	1340	-	236	521	521	1.0000000
A04	10549873	10553313	A04p15560.2_BraZ1	1987.57	-	997	2538	3440	0.7377907
A04	10576266	10579786	A04p15570.2_BraZ1	2139.84	+	1530	3403	3520	0.9667614
A04	10580387	10584141	A04p15580.2_BraZ1	2761.12	-	1139	3498	3754	0.9318061
A04	10585675	10587115	A04p15590.2_BraZ1	144	-	50	813	1440	0.5645834
A04	10590141	10591324	A04p15600.2_BraZ1	900	-	1497	1183	1183	1.0000000
A04	10614881	10628456	A04p15610.2_BraZ1	1154.57	-	113	3668	13575	0.2702026
A04	10629613	10630335	A04p15620.2_BraZ1	273	+	40	410	722	0.5678670
A04	10634256	10634759	A04p15630.2_BraZ1	384	-	598	503	503	1.0000000
A04	10640146	10641809	A04p15640.2_BraZ1	378	+	1343	1663	1663	1.0000000
A04	10640160	10644794	A04p15650.2_BraZ1	333	-	4922	4634	4634	1.0000000
A04	10644934	10647000	A04p15660.2_BraZ1	1584.24	-	663	1586	2066	0.7676670
A04	10648767	10650226	A04p15670.2_BraZ1	741	-	755	1153	1459	0.7902673
A04	10650960	10652928	A04p15680.2_BraZ1	1074.07	-	669	1720	1968	0.8739837
A04	10655574	10656529	A04p15690.2_BraZ1	807	+	581	955	955	1.0000000
A04	10657378	10670619	A04p15700.2_BraZ1	2633.61	-	12124	11971	13241	0.9040858
A04	10657465	10657916	A04p15710.2_BraZ1	37.2	+	772	451	451	1.0000000
A04	10699103	10702164	A04p15720.2_BraZ1	1715	+	619	2450	3061	0.8003920
A04	10704506	10705847	A04p15730.2_BraZ1	134.1	+	845	1311	1341	0.9776286
A04	10706790	10708161	A04p15740.2_BraZ1	137.1	-	463	1371	1371	1.0000000
A04	10708654	10710186	A04p15750.2_BraZ1	577.622	-	1172	1511	1532	0.9862924
A04	10711356	10712404	A04p15760.2_BraZ1	573.143	-	294	959	1048	0.9150763
A04	10717406	10721746	A04p15770.2_BraZ1	1953.26	+	748	3230	4340	0.7442396
A04	10723476	10724082	A04p15780.2_BraZ1	282	+	55	277	606	0.4570957
A04	10734290	10735866	A04p15790.2_BraZ1	1101.65	-	768	1576	1576	1.0000000
A04	10737609	10739497	A04p15800.2_BraZ1	1770	+	626	1700	1888	0.9004237
A04	10741895	10743054	A04p15810.2_BraZ1	354.9	+	742	1159	1159	1.0000000
A04	10760310	10763908	A04p15820.2_BraZ1	1722.6	+	2434	3561	3598	0.9897165
A04	10770341	10771021	A04p15830.2_BraZ1	573	-	421	680	680	1.0000000
A04	10771903	10774482	A04p15840.2_BraZ1	1412.47	-	1151	2507	2579	0.9720822
A04	10781740	10785667	A04p15850.2_BraZ1	2588.22	+	1436	3031	3927	0.7718360
A04	10786590	10788030	A04p15860.2_BraZ1	1211.25	+	1515	1440	1440	1.0000000
A04	10788881	10792811	A04p15870.2_BraZ1	2774.37	+	3816	3797	3930	0.9661577
A04	10795300	10796574	A04p15880.2_BraZ1	569.767	-	746	1260	1274	0.9890110
A04	10807625	10809159	A04p15890.2_BraZ1	3870	-	152	831	1534	0.5417210
A04	10812062	10812611	A04p15900.2_BraZ1	267	+	742	549	549	1.0000000
A04	10813188	10816686	A04p15910.2_BraZ1	1990.41	-	2510	3498	3498	1.0000000
A04	10828456	10829423	A04p15920.2_BraZ1	279	-	1077	967	967	1.0000000
A04	10832535	10834062	A04p15930.2_BraZ1	4513.5	+	720	1148	1527	0.7518009
A04	10834581	10838199	A04p15940.2_BraZ1	1973.57	-	1028	3373	3618	0.9322830
A04	10844426	10846788	A04p15950.2_BraZ1	226.5	+	1593	2319	2362	0.9817951
A04	10864737	10867299	A04p15960.2_BraZ1	2160	-	769	2340	2562	0.9133490
A04	10878533	10880942	A04p15970.2_BraZ1	1788	+	535	2083	2409	0.8646742
A04	10899133	10899343	A04p15980.2_BraZ1	21	-	21	194	210	0.9238095
A04	10913327	10915273	A04p15990.2_BraZ1	201	+	106	1361	1946	0.6993834
A04	10916085	10921740	A04p16000.2_BraZ1	13200	+	237	1939	5655	0.3428824
A04	10918559	10920363	A04p16010.2_BraZ1	631.108	-	7	256	1804	0.1419069
A04	10926446	10927910	A04p16020.2_BraZ1	146.4	-	140	1240	1464	0.8469945
A04	10933910	10934102	A04p16030.2_BraZ1	19.2	-	74	192	192	1.0000000
A04	10934499	10934808	A04p16040.2_BraZ1	30.9	+	97	180	309	0.5825243
A04	10936266	10937695	A04p16050.2_BraZ1	393.75	-	345	1119	1429	0.7830651
A04	10939375	10940737	A04p16060.2_BraZ1	136.2	-	388	1224	1362	0.8986784
A04	10943459	10943839	A04p16070.2_BraZ1	1743	+	0	0	380	0.0000000
A04	10947248	10949659	A04p16080.2_BraZ1	784.875	+	2493	2372	2411	0.9838241
A04	10951114	10951300	A04p16090.2_BraZ1	18.6	-	1	28	186	0.1505376
A04	10951732	10953204	A04p16100.2_BraZ1	378	+	349	972	1472	0.6603261
A04	10961750	10961852	A04p16110.2_BraZ1	10.2	-	233	102	102	1.0000000
A04	10963847	10965468	A04p16120.2_BraZ1	1545	-	266	1451	1621	0.8951265
A04	10973471	10974625	A04p16130.2_BraZ1	114	-	436	1154	1154	1.0000000
A04	10976432	10978012	A04p16140.2_BraZ1	516	-	933	1549	1580	0.9803798
A04	10991703	10993926	A04p16150.2_BraZ1	2133	-	331	1707	2223	0.7678812
A04	10994855	10998802	A04p16160.2_BraZ1	2520.53	+	1509	3215	3947	0.8145427
A04	11000523	11002644	A04p16170.2_BraZ1	1016.36	+	193	1669	2121	0.7868930
A04	11008256	11008724	A04p16180.2_BraZ1	46.8	+	129	468	468	1.0000000
A04	11010469	11011727	A04p16190.2_BraZ1	490.629	+	3	22	1258	0.0174881
A04	11012158	11012802	A04p16200.2_BraZ1	34.7143	+	0	0	644	0.0000000
A04	11015187	11015810	A04p16210.2_BraZ1	778.5	-	74	185	623	0.2969503
A04	11021720	11022879	A04p16220.2_BraZ1	843	+	810	1159	1159	1.0000000
A04	11024510	11027604	A04p16230.2_BraZ1	17616.1	+	998	2782	3094	0.8991597
A04	11028960	11029494	A04p16240.2_BraZ1	53.4	-	185	534	534	1.0000000
A04	11034393	11051953	A04p16250.2_BraZ1	4305	+	8508	12868	17560	0.7328018
A04	11037268	11037862	A04p16260.2_BraZ1	59.4	-	452	594	594	1.0000000
A04	11055021	11057332	A04p16270.2_BraZ1	1315.86	+	931	2063	2311	0.8926871
A04	11060109	11066558	A04p16280.2_BraZ1	3115.02	+	629	4045	6449	0.6272290
A04	11068165	11068666	A04p16290.2_BraZ1	50.1	+	0	0	501	0.0000000
A04	11072165	11072666	A04p16300.2_BraZ1	50.1	+	0	0	501	0.0000000
A04	11075261	11075762	A04p16310.2_BraZ1	50.1	+	4	19	501	0.0379242
A04	11125362	11125788	A04p16320.2_BraZ1	42.6	+	12	238	426	0.5586854
A04	11129474	11130053	A04p16330.2_BraZ1	54.9	+	8	140	579	0.2417962
A04	11130548	11133090	A04p16340.2_BraZ1	1316.47	+	1678	2542	2542	1.0000000
A04	11133466	11134153	A04p16350.2_BraZ1	203.5	-	856	687	687	1.0000000
A04	11142235	11145679	A04p16360.2_BraZ1	1368.5	+	418	1903	3444	0.5525551
A04	11157306	11159626	A04p16370.2_BraZ1	658.467	-	484	2126	2320	0.9163793
A04	11159765	11159933	A04p16380.2_BraZ1	16.8	+	224	168	168	1.0000000
A04	11162643	11163858	A04p16390.2_BraZ1	121.5	+	1348	1215	1215	1.0000000
A04	11164844	11178132	A04p16400.2_BraZ1	2594.99	+	8073	12706	13288	0.9562011
A04	11178546	11179793	A04p16410.2_BraZ1	1110	+	831	1247	1247	1.0000000
A04	11180464	11181119	A04p16420.2_BraZ1	459	+	533	655	655	1.0000000
A04	11181859	11183324	A04p16430.2_BraZ1	749.128	-	1286	1465	1465	1.0000000
A04	11185582	11186611	A04p16440.2_BraZ1	102.9	+	396	874	1029	0.8493683
A04	11187460	11187980	A04p16450.2_BraZ1	360	-	258	520	520	1.0000000
A04	11192464	11196129	A04p16460.2_BraZ1	1761.95	-	1256	3631	3665	0.9907231
A04	11198847	11199127	A04p16470.2_BraZ1	186	-	128	280	280	1.0000000
A04	11200818	11202896	A04p16480.2_BraZ1	386.667	+	1452	2031	2078	0.9773821
A04	11203679	11204848	A04p16490.2_BraZ1	377.386	-	447	1169	1169	1.0000000
A04	11206585	11207518	A04p16500.2_BraZ1	93.3	+	267	933	933	1.0000000
A04	11215750	11218341	A04p16510.2_BraZ1	491.148	+	2639	2562	2591	0.9888074
A04	11226576	11227893	A04p16520.2_BraZ1	131.7	+	123	840	1317	0.6378132
A04	11230162	11231761	A04p16530.2_BraZ1	585	+	1145	1599	1599	1.0000000
A04	11235514	11238025	A04p16540.2_BraZ1	1917	-	608	2007	2511	0.7992831
A04	11240046	11240529	A04p16550.2_BraZ1	48.3	-	48	432	483	0.8944100
A04	11244771	11245151	A04p16560.2_BraZ1	1743	-	0	0	380	0.0000000
A04	11246318	11247150	A04p16570.2_BraZ1	1788	-	955	832	832	1.0000000
A04	11252417	11256815	A04p16580.2_BraZ1	877.5	+	385	2507	4398	0.5700318
A04	11263237	11264538	A04p16590.2_BraZ1	1074.68	+	4	46	1301	0.0353574
A04	11270377	11271666	A04p16600.2_BraZ1	1065	+	1	36	1289	0.0279286
A04	11277686	11278753	A04p16610.2_BraZ1	855	-	382	1066	1067	0.9990628
A04	11293235	11295671	A04p16620.2_BraZ1	1304.47	+	277	1845	2436	0.7573892
A04	11310837	11311325	A04p16630.2_BraZ1	243	-	0	0	488	0.0000000
A04	11311401	11311891	A04p16640.2_BraZ1	285	-	0	0	490	0.0000000
A04	11314325	11316436	A04p16650.2_BraZ1	2025	-	370	1904	2111	0.9019422
A04	11321082	11321871	A04p16660.2_BraZ1	17881.5	-	9	161	789	0.2040558
A04	11323334	11323760	A04p16670.2_BraZ1	39.9	+	8	91	426	0.2136150
A04	11336687	11338137	A04p16680.2_BraZ1	1359	-	143	913	1450	0.6296552
A04	11348306	11349078	A04p16690.2_BraZ1	1204.2	+	33	133	772	0.1722798
A04	11352570	11355754	A04p16700.2_BraZ1	1398	-	303	1965	3184	0.6171482
A04	11369878	11372810	A04p16710.2_BraZ1	456	-	2360	2729	2932	0.9307640
A04	11374599	11375103	A04p16720.2_BraZ1	50.4	+	85	419	504	0.8313492
A04	11381739	11383137	A04p16730.2_BraZ1	139.5	+	55	674	1398	0.4821173
A04	11390947	11392354	A04p16740.2_BraZ1	139.8	+	221	1246	1407	0.8855721
A04	11403522	11404302	A04p16750.2_BraZ1	7392	-	0	0	780	0.0000000
A04	11406669	11406822	A04p16760.2_BraZ1	15.3	-	289	153	153	1.0000000
A04	11411093	11411817	A04p16770.2_BraZ1	585	-	191	715	724	0.9875690
A04	11417153	11418137	A04p16780.2_BraZ1	428.182	+	91	937	984	0.9522358
A04	11422284	11422546	A04p16790.2_BraZ1	216	+	159	262	262	1.0000000
A04	11428868	11431131	A04p16800.2_BraZ1	866.496	+	170	1692	2263	0.7476801
A04	11434606	11435876	A04p16810.2_BraZ1	816	-	74	605	1270	0.4763780
A04	11436567	11437057	A04p16820.2_BraZ1	210	+	48	418	490	0.8530612
A04	11437517	11438150	A04p16830.2_BraZ1	492	-	97	584	633	0.9225909
A04	11440080	11441448	A04p16840.2_BraZ1	136.8	+	82	878	1368	0.6418129
A04	11444118	11444341	A04p16850.2_BraZ1	18.6	+	76	223	223	1.0000000
A04	11446526	11448649	A04p16860.2_BraZ1	169.2	+	610	1961	2123	0.9236929
A04	11448832	11449423	A04p16870.2_BraZ1	59.1	-	45	472	591	0.7986464
A04	11451200	11455896	A04p16880.2_BraZ1	1131.08	-	1309	3994	4696	0.8505111
A04	11454524	11455326	A04p16890.2_BraZ1	312	-	75	212	802	0.2643391
A04	11464219	11466363	A04p16900.2_BraZ1	1232.4	+	823	2035	2144	0.9491605
A04	11482562	11483669	A04p16910.2_BraZ1	110.7	+	218	961	1107	0.8681120
A04	11484415	11485106	A04p16920.2_BraZ1	224.113	-	183	593	691	0.8581765
A04	11485009	11486623	A04p16930.2_BraZ1	720.696	-	752	1605	1614	0.9944238
A04	11491673	11492345	A04p16940.2_BraZ1	67.2	-	337	640	672	0.9523810
A04	11506135	11506744	A04p16950.2_BraZ1	303	-	30	228	609	0.3743842
A04	11510712	11511506	A04p16960.2_BraZ1	702	-	224	794	794	1.0000000
A04	11511680	11512049	A04p16970.2_BraZ1	36.9	+	216	369	369	1.0000000
A04	11513079	11515885	A04p16980.2_BraZ1	1722.55	+	1056	2623	2806	0.9347826
A04	11517877	11523115	A04p16990.2_BraZ1	1524.04	-	2053	5083	5238	0.9704086
A04	11524896	11525303	A04p17000.2_BraZ1	288	-	73	407	407	1.0000000
A04	11526041	11529130	A04p17010.2_BraZ1	795.865	+	410	1936	3089	0.6267400
A04	11530884	11534137	A04p17020.2_BraZ1	741.625	-	112	1044	3253	0.3209345
A04	11534300	11534579	A04p17030.2_BraZ1	20.4	-	209	268	279	0.9605735
A04	11538033	11539126	A04p17040.2_BraZ1	429	-	0	0	1093	0.0000000
A04	11539454	11540714	A04p17050.2_BraZ1	648	-	84	373	1260	0.2960317
A04	11544272	11545551	A04p17060.2_BraZ1	462.278	-	76	528	1279	0.4128225
A04	11546283	11547456	A04p17070.2_BraZ1	117.3	-	103	723	1173	0.6163683
A04	11566696	11568231	A04p17080.2_BraZ1	804	+	78	949	1535	0.6182411
A04	11576668	11592790	A04p17090.2_BraZ1	8847.33	+	3879	10979	16122	0.6809949
A04	11594293	11594632	A04p17100.2_BraZ1	33.9	-	352	339	339	1.0000000
A04	11597603	11598221	A04p17110.2_BraZ1	61.8	-	248	574	618	0.9288026
A04	11606326	11608843	A04p17120.2_BraZ1	3000	-	345	1335	2517	0.5303933
A04	11610292	11610677	A04p17130.2_BraZ1	207	-	205	385	385	1.0000000
A04	11610446	11610888	A04p17140.2_BraZ1	1316.25	-	349	442	442	1.0000000
A04	11611591	11613322	A04p17150.2_BraZ1	1290.24	+	944	1661	1731	0.9595609
A04	11613628	11616083	A04p17160.2_BraZ1	2814.39	-	377	1802	2455	0.7340122
A04	11619460	11620811	A04p17170.2_BraZ1	477	-	1693	1351	1351	1.0000000
A04	11622371	11624162	A04p17180.2_BraZ1	179.1	-	687	1791	1791	1.0000000
A04	11625523	11627086	A04p17190.2_BraZ1	931.3	-	1013	1487	1563	0.9513755
A04	11633976	11635393	A04p17200.2_BraZ1	10174.5	-	867	1347	1417	0.9505998
A04	11639894	11656005	A04p17210.2_BraZ1	1008.17	+	6768	12268	16111	0.7614673
A04	11657079	11658856	A04p17220.2_BraZ1	736.636	+	1045	1770	1777	0.9960608
A04	11659533	11661118	A04p17230.2_BraZ1	933.168	-	555	1568	1585	0.9892744
A04	11665476	11668612	A04p17240.2_BraZ1	1371.5	+	601	2487	3136	0.7930484
A04	11671089	11672713	A04p17250.2_BraZ1	865	+	167	986	1624	0.6071429
A04	11675169	11677303	A04p17260.2_BraZ1	974.16	+	930	2076	2134	0.9728210
A04	11684051	11684566	A04p17270.2_BraZ1	2005.33	+	248	515	515	1.0000000
A04	11686180	11730195	A04p17280.2_BraZ1	1725	-	9453	25596	44015	0.5815290
A04	11696193	11697241	A04p17290.2_BraZ1	594	-	871	1048	1048	1.0000000
A04	11698783	11699773	A04p17300.2_BraZ1	323	-	25	673	990	0.6797980
A04	11710837	11711137	A04p17310.2_BraZ1	30	+	47	300	300	1.0000000
A04	11711137	11722297	A04p17320.2_BraZ1	218.7	+	661	3398	11160	0.3044803
A04	11722979	11723845	A04p17330.2_BraZ1	396	-	62	544	866	0.6281755
A04	11725135	11726402	A04p17340.2_BraZ1	602.4	-	2	8	1267	0.0063141
A04	11741670	11742633	A04p17350.2_BraZ1	293.429	-	40	895	963	0.9293873
A04	11742663	11742975	A04p17360.2_BraZ1	31.2	-	8	293	312	0.9391026
A04	11748127	11748711	A04p17370.2_BraZ1	5616	-	13	63	584	0.1078767
A04	11754784	11754958	A04p17380.2_BraZ1	17.4	-	69	157	174	0.9022989
A04	11755186	11756138	A04p17390.2_BraZ1	861	-	209	932	952	0.9789916
A04	11756883	11757839	A04p17400.2_BraZ1	190.5	-	243	904	956	0.9456067
A04	11759042	11760649	A04p17410.2_BraZ1	843.46	+	446	1452	1607	0.9035470
A04	11761073	11763058	A04p17420.2_BraZ1	820.725	-	1519	1985	1985	1.0000000
A04	11763234	11763525	A04p17430.2_BraZ1	29.1	+	144	291	291	1.0000000
A04	11765502	11769000	A04p17440.2_BraZ1	2497.87	-	2334	3140	3498	0.8976558
A04	11770111	11770602	A04p17450.2_BraZ1	255	-	96	417	491	0.8492872
A04	11774225	11775969	A04p17460.2_BraZ1	871.116	-	309	1559	1744	0.8939220
A04	11778623	11779418	A04p17470.2_BraZ1	684	-	704	795	795	1.0000000
A04	11785911	11786949	A04p17480.2_BraZ1	573	+	359	1027	1038	0.9894027
A04	11793467	11798028	A04p17490.2_BraZ1	2315.29	+	385	3046	4561	0.6678360
A04	11799557	11800929	A04p17500.2_BraZ1	1041.65	-	53	1041	1372	0.7587463
A04	11801292	11805850	A04p17510.2_BraZ1	2037.82	-	1634	4405	4558	0.9664326
A04	11815510	11815916	A04p17520.2_BraZ1	312	-	467	406	406	1.0000000
A04	11823692	11826607	A04p17530.2_BraZ1	1666.16	+	679	2787	2915	0.9560892
A04	11827157	11829875	A04p17540.2_BraZ1	2568	-	137	1473	2718	0.5419426
A04	11831596	11833535	A04p17550.2_BraZ1	988.393	+	503	1644	1939	0.8478597
A04	11834224	11836889	A04p17560.2_BraZ1	1439.63	-	787	1821	2665	0.6833020
A04	11840977	11841682	A04p17570.2_BraZ1	70.5	-	271	670	705	0.9503546
A04	11852365	11853115	A04p17580.2_BraZ1	333.945	+	349	750	750	1.0000000
A04	11854963	11855711	A04p17590.2_BraZ1	186	+	192	589	748	0.7874331
A04	11856191	11858878	A04p17600.2_BraZ1	1487.86	+	1106	2626	2687	0.9772981
A04	11860172	11861218	A04p17610.2_BraZ1	10401.8	+	425	1041	1046	0.9952199
A04	11861513	11875967	A04p17620.2_BraZ1	868.207	-	4199	12785	14454	0.8845302
A04	11864624	11867076	A04p17630.2_BraZ1	706.35	+	277	1867	2452	0.7614192
A04	11871921	11875247	A04p17640.2_BraZ1	1909.44	-	366	2331	3326	0.7008418
A04	11885379	11889913	A04p17650.2_BraZ1	1981.54	-	1016	3883	4534	0.8564182
A04	11895329	11895470	A04p17660.2_BraZ1	14.1	+	200	141	141	1.0000000
A04	11897851	11899461	A04p17670.2_BraZ1	435	-	125	996	1610	0.6186336
A04	11906962	11907076	A04p17680.2_BraZ1	11.4	+	237	114	114	1.0000000
A04	11907348	11908024	A04p17690.2_BraZ1	393	-	209	676	676	1.0000000
A04	11909601	11916043	A04p17700.2_BraZ1	1795	+	4538	6403	6442	0.9939460
A04	11917079	11919113	A04p17710.2_BraZ1	1008	+	1033	2034	2034	1.0000000
A04	11919526	11922574	A04p17720.2_BraZ1	1025.32	-	1618	3030	3048	0.9940945
A04	11922722	11925923	A04p17730.2_BraZ1	1592.87	+	238	2490	3201	0.7778819
A04	11927632	11927998	A04p17740.2_BraZ1	138	+	659	366	366	1.0000000
A04	11929557	11929906	A04p17750.2_BraZ1	267	+	248	349	349	1.0000000
A04	11932068	11933415	A04p17760.2_BraZ1	134.7	-	856	1292	1347	0.9591685
A04	11944215	11944599	A04p17770.2_BraZ1	38.4	-	33	295	384	0.7682292
A04	11952066	11952375	A04p17780.2_BraZ1	30.9	+	131	309	309	1.0000000
A04	11959658	11968971	A04p17790.2_BraZ1	1068.86	+	1866	7599	9313	0.8159562
A04	11969114	11970773	A04p17800.2_BraZ1	1578	-	155	1346	1659	0.8113321
A04	11971289	11973020	A04p17810.2_BraZ1	695.614	-	609	1731	1731	1.0000000
A04	11974529	11975839	A04p17820.2_BraZ1	1031.25	+	149	1048	1310	0.8000000
A04	11977936	11979262	A04p17830.2_BraZ1	596.304	-	112	800	1326	0.6033183
A04	11983464	11983967	A04p17840.2_BraZ1	414	-	9	329	503	0.6540756
A04	11987093	11988976	A04p17850.2_BraZ1	591	-	106	941	1883	0.4997345
A04	12000879	12001676	A04p17860.2_BraZ1	306	+	38	641	797	0.8042660
A04	12002872	12003028	A04p17870.2_BraZ1	14.4	-	120	156	156	1.0000000
A04	12007725	12008198	A04p17880.2_BraZ1	180	+	570	473	473	1.0000000
A04	12013145	12013641	A04p17890.2_BraZ1	48	-	40	204	496	0.4112903
A04	12014738	12015899	A04p17900.2_BraZ1	116.1	-	121	1031	1161	0.8880275
A04	12019896	12021554	A04p17910.2_BraZ1	779.72	+	931	1658	1658	1.0000000
A04	12022188	12023298	A04p17920.2_BraZ1	111	-	796	1110	1110	1.0000000
A04	12024699	12027284	A04p17930.2_BraZ1	1283.33	-	307	1552	2585	0.6003869
A04	12027914	12029673	A04p17940.2_BraZ1	832.615	+	1229	1531	1759	0.8703809
A04	12032564	12033329	A04p17950.2_BraZ1	76.5	-	39	603	765	0.7882353
A04	12035088	12038829	A04p17960.2_BraZ1	1635.19	+	3760	3741	3741	1.0000000
A04	12048462	12049575	A04p17970.2_BraZ1	111.3	-	644	1113	1113	1.0000000
A04	12050220	12052036	A04p17980.2_BraZ1	866.077	+	1308	1807	1816	0.9950441
A04	12060834	12061867	A04p17990.2_BraZ1	252	+	154	1033	1033	1.0000000
A04	12066934	12074417	A04p18000.2_BraZ1	5339.89	+	1319	3837	7483	0.5127622
A04	12075692	12076390	A04p18010.2_BraZ1	420	+	437	698	698	1.0000000
A04	12076783	12077485	A04p18020.2_BraZ1	177	+	769	702	702	1.0000000
A04	12082373	12083071	A04p18030.2_BraZ1	549	-	72	518	698	0.7421203
A04	12084159	12084513	A04p18040.2_BraZ1	35.4	-	114	312	354	0.8813559
A04	12085799	12086666	A04p18050.2_BraZ1	86.7	+	50	611	867	0.7047290
A04	12108665	12111487	A04p18060.2_BraZ1	924.179	-	725	2704	2822	0.9581857
A04	12139409	12140334	A04p18070.2_BraZ1	396	+	236	436	925	0.4713514
A04	12141795	12142506	A04p18080.2_BraZ1	71.1	-	201	482	711	0.6779184
A04	12151527	12151916	A04p18090.2_BraZ1	165	+	108	381	389	0.9794344
A04	12151957	12152465	A04p18100.2_BraZ1	6336	+	204	476	508	0.9370078
A04	12163133	12164140	A04p18110.2_BraZ1	661.818	+	573	973	1007	0.9662364
A04	12164398	12166451	A04p18120.2_BraZ1	1485.47	-	329	2046	2053	0.9965904
A04	12171739	12173255	A04p18130.2_BraZ1	1347	+	1489	1516	1516	1.0000000
A04	12175583	12180588	A04p18140.2_BraZ1	1401.23	-	1534	4532	5005	0.9054945
A04	12178075	12179178	A04p18150.2_BraZ1	477	-	64	780	1103	0.7071623
A04	12182708	12183957	A04p18160.2_BraZ1	5002.5	+	717	1168	1249	0.9351481
A04	12188216	12193238	A04p18170.2_BraZ1	2832.7	+	1275	4439	5022	0.8839108
A04	12195972	12196336	A04p18180.2_BraZ1	33.9	+	1	11	364	0.0302198
A04	12200567	12200858	A04p18190.2_BraZ1	29.1	-	142	291	291	1.0000000
A04	12202146	12202390	A04p18200.2_BraZ1	19.2	-	1196	244	244	1.0000000
A04	12206228	12208503	A04p18210.2_BraZ1	1677	+	207	1563	2275	0.6870329
A04	12214973	12217171	A04p18220.2_BraZ1	1259.04	+	1742	2132	2198	0.9699727
A04	12217998	12219098	A04p18230.2_BraZ1	527	+	199	1084	1100	0.9854546
A04	12219652	12220577	A04p18240.2_BraZ1	618.913	-	472	889	925	0.9610811
A04	12222495	12223209	A04p18250.2_BraZ1	71.4	+	855	714	714	1.0000000
A04	12225553	12225792	A04p18260.2_BraZ1	17.1	-	0	0	239	0.0000000
A04	12226908	12230548	A04p18270.2_BraZ1	2313.94	-	1518	3343	3640	0.9184066
A04	12233905	12234820	A04p18280.2_BraZ1	277.629	-	10	372	915	0.4065574
A04	12240193	12241338	A04p18290.2_BraZ1	968.478	+	111	770	1145	0.6724891
A04	12252322	12252604	A04p18300.2_BraZ1	28.2	+	310	282	282	1.0000000
A04	12278543	12279622	A04p18310.2_BraZ1	826.5	-	5	196	1079	0.1816497
A04	12283112	12284181	A04p18320.2_BraZ1	859.091	-	74	896	1069	0.8381665
A04	12288102	12289310	A04p18330.2_BraZ1	77.1	-	604	1208	1208	1.0000000
A04	12294035	12294773	A04p18340.2_BraZ1	73.8	-	156	703	738	0.9525746
A04	12299496	12299869	A04p18350.2_BraZ1	147	+	309	373	373	1.0000000
A04	12313399	12313798	A04p18360.2_BraZ1	39.9	-	194	399	399	1.0000000
A04	12317563	12319261	A04p18370.2_BraZ1	844.333	+	929	1682	1698	0.9905772
A04	12325913	12327588	A04p18380.2_BraZ1	1071	-	114	1391	1675	0.8304477
A04	12340569	12341523	A04p18390.2_BraZ1	95.4	-	75	857	954	0.8983229
A04	12348778	12349165	A04p18400.2_BraZ1	38.7	-	40	335	387	0.8656331
A04	12350135	12361134	A04p18410.2_BraZ1	6629.24	-	3590	10598	10999	0.9635422
A04	12362428	12362703	A04p18420.2_BraZ1	240	+	709	275	275	1.0000000
A04	12362703	12363704	A04p18430.2_BraZ1	405	+	1342	1001	1001	1.0000000
A04	12369227	12371869	A04p18440.2_BraZ1	681.558	+	592	2337	2642	0.8845571
A04	12381262	12384066	A04p18450.2_BraZ1	2700	+	806	2099	2804	0.7485735
A04	12386551	12389557	A04p18460.2_BraZ1	1767.05	+	748	2750	3006	0.9148370
A04	12390228	12391541	A04p18470.2_BraZ1	335	-	168	1009	1313	0.7684692
A04	12394634	12395916	A04p18480.2_BraZ1	1588.6	-	34	979	1282	0.7636505
A04	12399783	12405379	A04p18490.2_BraZ1	1057.89	-	3146	5464	5596	0.9764117
A04	12411879	12414943	A04p18500.2_BraZ1	612.575	+	2095	3040	3064	0.9921671
A04	12416447	12416977	A04p18510.2_BraZ1	261	+	261	530	530	1.0000000
A04	12418105	12421201	A04p18520.2_BraZ1	2358.67	+	784	3018	3096	0.9748062
A04	12425661	12426789	A04p18530.2_BraZ1	708.577	+	335	919	1128	0.8147163
A04	12437707	12439723	A04p18540.2_BraZ1	201.6	+	268	1785	2016	0.8854167
A04	12451302	12451428	A04p18550.2_BraZ1	12.6	-	376	126	126	1.0000000
A04	12452681	12454420	A04p18560.2_BraZ1	1509	-	1440	1739	1739	1.0000000
A04	12458081	12459696	A04p18570.2_BraZ1	1284	-	660	1615	1615	1.0000000
A04	12464123	12470132	A04p18580.2_BraZ1	2257.96	+	7339	5306	6009	0.8830088
A04	12474146	12476505	A04p18590.2_BraZ1	1622.25	-	1235	2359	2359	1.0000000
A04	12477093	12477360	A04p18600.2_BraZ1	150	-	123	258	267	0.9662921
A04	12477532	12477789	A04p18610.2_BraZ1	177	+	34	179	257	0.6964980
A04	12478538	12482454	A04p18620.2_BraZ1	2376	-	1672	3561	3916	0.9093463
A04	12488645	12488798	A04p18630.2_BraZ1	15.3	-	221	153	153	1.0000000
A04	12498474	12500169	A04p18640.2_BraZ1	927.36	+	1723	1695	1695	1.0000000
A04	12500728	12500944	A04p18650.2_BraZ1	21.6	-	0	0	216	0.0000000
A04	12524669	12525843	A04p18660.2_BraZ1	891	+	1310	1174	1174	1.0000000
A04	12536764	12537454	A04p18670.2_BraZ1	135	+	615	690	690	1.0000000
A04	12554266	12555211	A04p18680.2_BraZ1	483	-	24	350	945	0.3703704
A04	12564990	12565708	A04p18690.2_BraZ1	1920	+	158	718	718	1.0000000
A04	12567870	12569384	A04p18700.2_BraZ1	978	+	391	1089	1514	0.7192867
A04	12571072	12573584	A04p18710.2_BraZ1	1075.28	-	2032	2512	2512	1.0000000
A04	12583345	12584311	A04p18720.2_BraZ1	96.6	+	444	963	966	0.9968944
A04	12584617	12588449	A04p18730.2_BraZ1	273	+	3637	3577	3832	0.9334551
A04	12585443	12587328	A04p18740.2_BraZ1	186.9	-	1910	1849	1885	0.9809018
A04	12589961	12590244	A04p18750.2_BraZ1	135	+	685	283	283	1.0000000
A04	12597459	12597766	A04p18760.2_BraZ1	17.1	+	102	307	307	1.0000000
A04	12612843	12613870	A04p18770.2_BraZ1	816.5	-	61	547	1027	0.5326193
A04	12616186	12616940	A04p18780.2_BraZ1	50.4	+	64	437	754	0.5795756
A04	12618664	12618905	A04p18790.2_BraZ1	165	+	2	79	241	0.3278008
A04	12620370	12625111	A04p18800.2_BraZ1	10240.9	-	912	2467	4741	0.5203543
A04	12629994	12630299	A04p18810.2_BraZ1	21	+	673	305	305	1.0000000
A04	12651533	12653263	A04p18820.2_BraZ1	1383.7	-	94	967	1730	0.5589595
A04	12664241	12666876	A04p18830.2_BraZ1	1688.22	-	856	2397	2635	0.9096774
A04	12669407	12669835	A04p18840.2_BraZ1	258	+	304	428	428	1.0000000
A04	12673119	12674229	A04p18850.2_BraZ1	900	+	87	766	1110	0.6900901
A04	12682899	12684259	A04p18860.2_BraZ1	131.7	-	1077	1360	1360	1.0000000
A04	12686186	12687975	A04p18870.2_BraZ1	1491	+	573	1602	1789	0.8954723
A04	12693590	12694768	A04p18880.2_BraZ1	978	-	827	1147	1178	0.9736842
A04	12694894	12695290	A04p18890.2_BraZ1	39.6	+	353	396	396	1.0000000
A04	12697942	12698816	A04p18900.2_BraZ1	726	-	68	731	874	0.8363844
A04	12700889	12701775	A04p18910.2_BraZ1	738	-	4	355	886	0.4006772
A04	12704753	12710303	A04p18920.2_BraZ1	4222.22	-	1795	5391	5550	0.9713513
A04	12713629	12714937	A04p18930.2_BraZ1	130.8	-	25	354	1308	0.2706422
A04	12716941	12718002	A04p18940.2_BraZ1	1965	+	178	739	1061	0.6965127
A04	12725824	12726124	A04p18950.2_BraZ1	30	+	380	300	300	1.0000000
A04	12726678	12732218	A04p18960.2_BraZ1	1021.08	+	6675	4937	5540	0.8911552
A04	12736392	12736616	A04p18970.2_BraZ1	10.5	+	303	224	224	1.0000000
A04	12738451	12741803	A04p18980.2_BraZ1	914.955	-	1456	2717	3352	0.8105609
A04	12742213	12742531	A04p18990.2_BraZ1	31.8	+	614	318	318	1.0000000
A04	12749161	12751042	A04p19000.2_BraZ1	1272	+	651	1823	1881	0.9691653
A04	12759291	12761010	A04p19010.2_BraZ1	1206	-	96	1247	1719	0.7254218
A04	12778196	12778334	A04p19020.2_BraZ1	13.8	+	198	138	138	1.0000000
A04	12791188	12795620	A04p19030.2_BraZ1	1693.91	-	935	3728	4432	0.8411552
A04	12797089	12799431	A04p19040.2_BraZ1	1280.57	+	245	1785	2342	0.7621691
A04	12800052	12800686	A04p19050.2_BraZ1	320	-	206	634	634	1.0000000
A04	12806157	12809825	A04p19060.2_BraZ1	1327.24	+	2349	3645	3668	0.9937295
A04	12812031	12814837	A04p19070.2_BraZ1	1136.32	-	1925	2806	2806	1.0000000
A04	12820326	12821081	A04p19080.2_BraZ1	51	+	231	720	755	0.9536424
A04	12821198	12822005	A04p19090.2_BraZ1	254.211	+	374	747	807	0.9256505
A04	12826237	12828836	A04p19100.2_BraZ1	3859.22	-	1957	2256	2599	0.8680261
A04	12829917	12831300	A04p19110.2_BraZ1	138.3	-	362	1380	1383	0.9978308
A04	12834430	12834661	A04p19120.2_BraZ1	23.1	-	385	231	231	1.0000000
A04	12838828	12839089	A04p19130.2_BraZ1	26.1	+	111	261	261	1.0000000
A04	12840028	12840277	A04p19140.2_BraZ1	24.9	+	355	249	249	1.0000000
A04	12847547	12848553	A04p19150.2_BraZ1	87.9	-	452	950	1006	0.9443340
A04	12866966	12867263	A04p19160.2_BraZ1	150	+	0	0	297	0.0000000
A04	12867323	12868270	A04p19170.2_BraZ1	86.4	+	2	174	947	0.1837381
A04	12868270	12869701	A04p19180.2_BraZ1	1032	+	0	0	1431	0.0000000
A04	12869746	12870010	A04p19190.2_BraZ1	26.4	-	0	0	264	0.0000000
A04	12888927	12889080	A04p19200.2_BraZ1	15.3	-	56	151	153	0.9869281
A04	12889146	12891669	A04p19210.2_BraZ1	2298	+	520	2278	2523	0.9028934
A04	12894834	12896115	A04p19220.2_BraZ1	6837	+	663	1281	1281	1.0000000
A04	12899739	12899997	A04p19230.2_BraZ1	25.8	-	162	258	258	1.0000000
A04	12905224	12906352	A04p19240.2_BraZ1	10320	+	421	1081	1128	0.9583333
A04	12910844	12912219	A04p19250.2_BraZ1	699	+	416	978	1375	0.7112727
A04	12916684	12916942	A04p19260.2_BraZ1	25.8	-	373	258	258	1.0000000
A04	12926451	12926961	A04p19270.2_BraZ1	51	+	97	386	510	0.7568628
A04	12932707	12935493	A04p19280.2_BraZ1	1771.19	+	553	2784	2786	0.9992821
A04	12936653	12939128	A04p19290.2_BraZ1	247.5	-	1974	2475	2475	1.0000000
A04	12947460	12950404	A04p19300.2_BraZ1	2181.03	+	1953	2899	2944	0.9847147
A04	12951236	12951767	A04p19310.2_BraZ1	480	+	1803	531	531	1.0000000
A04	12952640	12957070	A04p19320.2_BraZ1	2533.32	+	2906	3829	4430	0.8643341
A04	12972413	12972665	A04p19330.2_BraZ1	25.2	+	356	252	252	1.0000000
A04	12984630	12984973	A04p19340.2_BraZ1	31.2	+	470	343	343	1.0000000
A04	12999149	13001864	A04p19350.2_BraZ1	1227.6	-	1020	2504	2715	0.9222836
A04	13016194	13019561	A04p19360.2_BraZ1	2310.17	+	931	3180	3367	0.9444609
A04	13019661	13021803	A04p19370.2_BraZ1	1390.91	-	1297	2142	2142	1.0000000
A04	13035796	13038352	A04p19380.2_BraZ1	255.6	-	309	1835	2556	0.7179186
A04	13040997	13043035	A04p19390.2_BraZ1	1243.13	-	761	1795	2038	0.8807654
A04	13044018	13045657	A04p19400.2_BraZ1	1081.37	+	286	1286	1639	0.7846248
A04	13046913	13047842	A04p19410.2_BraZ1	212.368	-	181	905	929	0.9741658
A04	13048172	13052179	A04p19420.2_BraZ1	616.926	-	2775	3966	4007	0.9897679
A04	13054761	13057951	A04p19430.2_BraZ1	442.2	-	1494	2899	3190	0.9087774
A04	13058014	13060333	A04p19440.2_BraZ1	796.167	-	1885	2319	2319	1.0000000
A04	13068332	13071579	A04p19450.2_BraZ1	1278	-	1451	2958	3247	0.9109948
A04	13077375	13077629	A04p19460.2_BraZ1	195	-	0	0	254	0.0000000
A04	13077898	13078057	A04p19470.2_BraZ1	15.9	-	10	159	159	1.0000000
A04	13080821	13081748	A04p19480.2_BraZ1	92.7	-	81	613	927	0.6612729
A04	13087149	13087638	A04p19490.2_BraZ1	48.9	-	186	489	489	1.0000000
A04	13117539	13118031	A04p19500.2_BraZ1	49.2	+	880	492	492	1.0000000
A04	13126286	13127792	A04p19510.2_BraZ1	946.143	-	1063	1506	1506	1.0000000
A04	13131212	13134209	A04p19520.2_BraZ1	2126.95	-	1606	2924	2997	0.9756423
A04	13145728	13150616	A04p19530.2_BraZ1	3824.8	+	1776	4783	4888	0.9785188
A04	13163660	13168316	A04p19540.2_BraZ1	1888.31	-	1049	3304	4656	0.7096220
A04	13181610	13183581	A04p19550.2_BraZ1	197.1	-	660	1739	1971	0.8822932
A04	13184896	13185580	A04p19560.2_BraZ1	68.4	-	85	656	684	0.9590643
A04	13187092	13188839	A04p19570.2_BraZ1	5150.25	-	679	1498	1747	0.8574700
A04	13200103	13202990	A04p19580.2_BraZ1	762	-	1625	2676	2887	0.9269137
A04	13224333	13231372	A04p19590.2_BraZ1	2850	-	1901	5444	7039	0.7734053
A04	13233857	13234166	A04p19600.2_BraZ1	30.9	-	4	105	309	0.3398058
A04	13236209	13237974	A04p19610.2_BraZ1	765.646	+	1623	1765	1765	1.0000000
A04	13238408	13245794	A04p19620.2_BraZ1	2378.65	+	2916	6256	7386	0.8470079
A04	13253670	13255648	A04p19630.2_BraZ1	798	+	415	1610	1978	0.8139535
A04	13257082	13258379	A04p19640.2_BraZ1	612.469	+	985	1297	1297	1.0000000
A04	13258898	13259423	A04p19650.2_BraZ1	244.929	+	166	525	525	1.0000000
A04	13260113	13261472	A04p19660.2_BraZ1	135.9	-	351	1067	1359	0.7851361
A04	13262712	13262838	A04p19670.2_BraZ1	12.6	-	31	126	126	1.0000000
A04	13262908	13263529	A04p19680.2_BraZ1	204	-	0	0	621	0.0000000
A04	13264600	13267309	A04p19690.2_BraZ1	1789.94	-	888	2634	2709	0.9723145
A04	13275770	13278908	A04p19700.2_BraZ1	2030.31	-	553	2343	3138	0.7466539
A04	13281735	13282699	A04p19710.2_BraZ1	6520.5	-	153	834	964	0.8651452
A04	13285795	13287487	A04p19720.2_BraZ1	1098	-	648	1471	1692	0.8693854
A04	13293157	13293607	A04p19730.2_BraZ1	228	+	125	431	450	0.9577778
A04	13294314	13294581	A04p19740.2_BraZ1	26.7	-	551	267	267	1.0000000
A04	13299437	13302873	A04p19750.2_BraZ1	1583.05	-	2468	3436	3436	1.0000000
A04	13319384	13320923	A04p19760.2_BraZ1	781.898	+	1288	1539	1539	1.0000000
A04	13321233	13323238	A04p19770.2_BraZ1	1501.5	-	1200	2005	2005	1.0000000
A04	13327282	13329614	A04p19780.2_BraZ1	483.791	+	10	233	2332	0.0999142
A04	13330572	13331887	A04p19790.2_BraZ1	285.75	+	559	1315	1315	1.0000000
A04	13335059	13336182	A04p19800.2_BraZ1	436.841	+	681	1123	1123	1.0000000
A04	13337881	13338346	A04p19810.2_BraZ1	46.5	-	254	428	465	0.9204301
A04	13338918	13339083	A04p19820.2_BraZ1	16.5	-	132	165	165	1.0000000
A04	13339300	13344162	A04p19830.2_BraZ1	2801.41	-	1844	4381	4862	0.9010695
A04	13354758	13355103	A04p19840.2_BraZ1	34.5	-	784	345	345	1.0000000
A04	13367025	13369424	A04p19850.2_BraZ1	1494.94	-	1516	2399	2399	1.0000000
A04	13370523	13370844	A04p19860.2_BraZ1	198	-	194	321	321	1.0000000
A04	13374825	13376034	A04p19870.2_BraZ1	2173.88	+	1115	1209	1209	1.0000000
A04	13379614	13380013	A04p19880.2_BraZ1	321	+	430	399	399	1.0000000
A04	13380845	13383401	A04p19890.2_BraZ1	255.6	-	379	2115	2556	0.8274648
A04	13393891	13395714	A04p19900.2_BraZ1	1593	+	235	826	1823	0.4530993
A04	13404756	13409725	A04p19910.2_BraZ1	1272	-	1191	2582	4969	0.5196217
A04	13412897	13414016	A04p19920.2_BraZ1	111.9	-	233	1019	1119	0.9106345
A04	13417314	13418511	A04p19930.2_BraZ1	119.7	-	0	0	1197	0.0000000
A04	13420987	13429559	A04p19940.2_BraZ1	946.852	-	1047	5177	8572	0.6039430
A04	13439600	13439843	A04p19950.2_BraZ1	15.9	+	111	243	243	1.0000000
A04	13448135	13450359	A04p19960.2_BraZ1	1376	-	121	1229	2224	0.5526079
A04	13456783	13457482	A04p19970.2_BraZ1	309	+	0	0	699	0.0000000
A04	13458127	13459021	A04p19980.2_BraZ1	81	+	86	669	894	0.7483221
A04	13464514	13464713	A04p19990.2_BraZ1	16.5	+	54	199	199	1.0000000
A04	13466824	13469208	A04p20000.2_BraZ1	1555.13	+	1060	2118	2384	0.8884228
A04	13471130	13475882	A04p20010.2_BraZ1	177	+	878	2610	4752	0.5492424
A04	13476978	13479444	A04p20020.2_BraZ1	1761.06	+	626	2248	2466	0.9115977
A04	13480387	13481179	A04p20030.2_BraZ1	79.2	+	330	790	792	0.9974747
A04	13481367	13482729	A04p20040.2_BraZ1	769.95	-	169	1202	1362	0.8825257
A04	13484861	13486874	A04p20050.2_BraZ1	1112.83	-	1164	1963	2013	0.9751614
A04	13490216	13513532	A04p20060.2_BraZ1	2719.11	-	12056	20602	23316	0.8835992
A04	13496879	13499932	A04p20070.2_BraZ1	265.475	+	1969	3053	3053	1.0000000
A04	13513823	13515124	A04p20080.2_BraZ1	705.864	+	432	1301	1301	1.0000000
A04	13515625	13519188	A04p20090.2_BraZ1	2004.65	-	475	1920	3563	0.5388718
A04	13521251	13522024	A04p20100.2_BraZ1	413.135	+	749	773	773	1.0000000
A04	13522631	13523190	A04p20110.2_BraZ1	39.9	+	311	559	559	1.0000000
A04	13525009	13525540	A04p20120.2_BraZ1	53.1	-	7	207	531	0.3898305
A04	13532303	13535166	A04p20130.2_BraZ1	1302.71	+	1757	2863	2863	1.0000000
A04	13536607	13539365	A04p20140.2_BraZ1	954	-	35	699	2758	0.2534445
A04	13550130	13551691	A04p20150.2_BraZ1	643.619	+	1058	1525	1561	0.9769379
A04	13552173	13553031	A04p20160.2_BraZ1	85.8	-	88	675	858	0.7867133
A04	13553949	13554510	A04p20170.2_BraZ1	56.1	+	320	561	561	1.0000000
A04	13556138	13557053	A04p20180.2_BraZ1	91.5	-	223	756	915	0.8262295
A04	13560995	13562549	A04p20190.2_BraZ1	1200.09	+	789	1554	1554	1.0000000
A04	13563288	13564876	A04p20200.2_BraZ1	767.565	+	1169	1588	1588	1.0000000
A04	13565362	13565992	A04p20210.2_BraZ1	63	-	211	630	630	1.0000000
A04	13567304	13567937	A04p20220.2_BraZ1	63.3	-	40	335	633	0.5292259
A04	13571918	13572877	A04p20230.2_BraZ1	774	-	391	959	959	1.0000000
A04	13576033	13577449	A04p20240.2_BraZ1	978	-	513	1416	1416	1.0000000
A04	13592772	13594014	A04p20250.2_BraZ1	124.2	-	58	975	1242	0.7850242
A04	13599214	13600317	A04p20260.2_BraZ1	474.092	+	819	1103	1103	1.0000000
A04	13601033	13601144	A04p20270.2_BraZ1	11.1	+	9	80	111	0.7207207
A04	13603435	13606436	A04p20280.2_BraZ1	1564.02	+	145	2236	3001	0.7450850
A04	13607686	13611097	A04p20290.2_BraZ1	1792.02	-	1288	3283	3411	0.9624743
A04	13612979	13618037	A04p20300.2_BraZ1	2887.5	-	1999	4421	5058	0.8740609
A04	13619901	13620040	A04p20310.2_BraZ1	13.5	+	151	139	139	1.0000000
A04	13620192	13620309	A04p20320.2_BraZ1	11.7	+	196	117	117	1.0000000
A04	13622163	13632011	A04p20330.2_BraZ1	1276.04	-	6664	8913	9848	0.9050569
A04	13624334	13633716	A04p20340.2_BraZ1	508.75	-	5293	8128	9382	0.8663398
A04	13645843	13654652	A04p20350.2_BraZ1	2834.4	-	4849	8106	8809	0.9201953
A04	13656689	13657790	A04p20360.2_BraZ1	110.1	-	940	1101	1101	1.0000000
A04	13664383	13667440	A04p20370.2_BraZ1	2316.5	-	1658	2971	3057	0.9718679
A04	13668750	13669087	A04p20380.2_BraZ1	237	+	68	337	337	1.0000000
A04	13669374	13670445	A04p20390.2_BraZ1	107.1	-	1338	1071	1071	1.0000000
A04	13671946	13673421	A04p20400.2_BraZ1	1286.72	+	1471	1475	1475	1.0000000
A04	13677044	13677230	A04p20410.2_BraZ1	18.6	-	302	186	186	1.0000000
A04	13685568	13690041	A04p20420.2_BraZ1	1321.34	+	1003	4156	4473	0.9291303
A04	13691529	13692864	A04p20430.2_BraZ1	1188	+	52	713	1335	0.5340824
A04	13700364	13701276	A04p20440.2_BraZ1	91.2	-	846	912	912	1.0000000
A04	13701746	13702085	A04p20450.2_BraZ1	33.9	-	220	339	339	1.0000000
A04	13713844	13715433	A04p20460.2_BraZ1	1182	+	11	472	1589	0.2970422
A04	13722636	13723833	A04p20470.2_BraZ1	119.7	+	5	35	1197	0.0292398
A04	13724341	13725640	A04p20480.2_BraZ1	129.9	-	122	1125	1299	0.8660508
A04	13727248	13734849	A04p20490.2_BraZ1	402.6	+	3747	6721	7601	0.8842258
A04	13736106	13737789	A04p20500.2_BraZ1	541.647	+	809	1655	1683	0.9833630
A04	13739712	13740651	A04p20510.2_BraZ1	870	+	459	939	939	1.0000000
A04	13741540	13742053	A04p20520.2_BraZ1	426	-	138	495	513	0.9649123
A04	13743337	13746333	A04p20530.2_BraZ1	2053.72	-	1052	2676	2996	0.8931909
A04	13756000	13757290	A04p20540.2_BraZ1	129	-	1312	1290	1290	1.0000000
A04	13763225	13763623	A04p20550.2_BraZ1	225	+	2401	398	398	1.0000000
A04	13765157	13768433	A04p20560.2_BraZ1	198	-	3078	3264	3276	0.9963370
A04	13769772	13773467	A04p20570.2_BraZ1	4669.44	-	2869	3195	3695	0.8646820
A04	13785568	13786111	A04p20580.2_BraZ1	54.3	+	65	325	543	0.5985267
A04	13787070	13787776	A04p20590.2_BraZ1	437.688	-	330	691	706	0.9787536
A04	13789589	13789892	A04p20600.2_BraZ1	30.3	+	114	303	303	1.0000000
A04	13791446	13794437	A04p20610.2_BraZ1	1687.66	+	1583	2934	2991	0.9809428
A04	13795764	13795914	A04p20620.2_BraZ1	15	+	38	150	150	1.0000000
A04	13797005	13797146	A04p20630.2_BraZ1	14.1	-	0	0	141	0.0000000
A04	13797430	13797913	A04p20640.2_BraZ1	124.5	+	408	483	483	1.0000000
A04	13798691	13799207	A04p20650.2_BraZ1	51.6	+	1	26	516	0.0503876
A04	13802663	13803182	A04p20660.2_BraZ1	51.9	-	25	332	519	0.6396917
A04	13805461	13806805	A04p20670.2_BraZ1	134.4	-	1279	1344	1344	1.0000000
A04	13814222	13815554	A04p20680.2_BraZ1	133.2	-	1361	1332	1332	1.0000000
A04	13817744	13819070	A04p20690.2_BraZ1	105.6	-	443	1220	1326	0.9200603
A04	13821989	13824634	A04p20700.2_BraZ1	1269	+	834	2471	2645	0.9342155
A04	13824872	13825303	A04p20710.2_BraZ1	348	+	112	425	431	0.9860789
A04	13826538	13827729	A04p20720.2_BraZ1	119.1	+	898	1191	1191	1.0000000
A04	13827987	13828326	A04p20730.2_BraZ1	33.9	+	264	339	339	1.0000000
A04	13829040	13830449	A04p20740.2_BraZ1	1252.56	-	1405	1409	1409	1.0000000
A04	13830964	13831873	A04p20750.2_BraZ1	843	+	1291	909	909	1.0000000
A04	13832338	13834283	A04p20760.2_BraZ1	1466.25	+	946	1916	1945	0.9850900
A04	13834452	13835496	A04p20770.2_BraZ1	74.1	-	1	123	1044	0.1178161
A04	13837556	13841240	A04p20780.2_BraZ1	2550.6	+	169	695	3684	0.1886536
A04	13850844	13854324	A04p20790.2_BraZ1	2407.11	+	2512	2818	3480	0.8097701
A04	13859717	13861292	A04p20800.2_BraZ1	960.109	-	367	1397	1575	0.8869841
A04	13872443	13874838	A04p20810.2_BraZ1	1386	-	1504	1897	2395	0.7920668
A04	13879533	13879992	A04p20820.2_BraZ1	165	-	118	411	459	0.8954248
A04	13887339	13888850	A04p20830.2_BraZ1	862.013	-	482	1445	1511	0.9563203
A04	13890100	13897872	A04p20840.2_BraZ1	2658	-	1180	5563	7772	0.7157746
A04	13901459	13903081	A04p20850.2_BraZ1	618.067	+	994	1471	1622	0.9069051
A04	13908331	13913402	A04p20860.2_BraZ1	2443.92	+	768	3824	5071	0.7540919
A04	13914167	13914756	A04p20870.2_BraZ1	213	+	258	535	589	0.9083192
A04	13920749	13928668	A04p20880.2_BraZ1	2251.5	+	7443	6376	7919	0.8051522
A04	13933465	13936066	A04p20890.2_BraZ1	1606.32	-	514	2018	2601	0.7758554
A04	13941855	13942867	A04p20900.2_BraZ1	75	+	238	894	1012	0.8833992
A04	13944761	13945013	A04p20910.2_BraZ1	2835	+	228	252	252	1.0000000
A04	13946842	13949582	A04p20920.2_BraZ1	1247.75	-	800	2550	2740	0.9306569
A04	13950232	13950777	A04p20930.2_BraZ1	353.571	-	54	545	545	1.0000000
A04	13953442	13955352	A04p20940.2_BraZ1	658.544	+	1428	1910	1910	1.0000000
A04	13956669	13958891	A04p20950.2_BraZ1	1035.04	-	977	2127	2222	0.9572457
A04	13959969	13961551	A04p20960.2_BraZ1	818.87	-	1098	1582	1582	1.0000000
A04	13972805	13973222	A04p20970.2_BraZ1	39	-	9	268	417	0.6426858
A04	13979610	13980108	A04p20980.2_BraZ1	49.8	-	181	474	498	0.9518072
A04	13980563	13980880	A04p20990.2_BraZ1	219	-	366	317	317	1.0000000
A04	13984175	13990112	A04p21000.2_BraZ1	4516.74	-	946	5111	5937	0.8608725
A04	13994874	13995168	A04p21010.2_BraZ1	29.4	+	437	294	294	1.0000000
A04	13995342	13997292	A04p21020.2_BraZ1	195	+	687	1849	1950	0.9482051
A04	14008050	14012189	A04p21030.2_BraZ1	2341.88	+	1844	4095	4139	0.9893694
A04	14012989	14013381	A04p21040.2_BraZ1	300	+	0	0	392	0.0000000
A04	14018069	14019923	A04p21050.2_BraZ1	185.4	-	629	1729	1854	0.9325782
A04	14025495	14026806	A04p21060.2_BraZ1	131.1	-	860	1311	1311	1.0000000
A04	14037450	14038488	A04p21070.2_BraZ1	103.8	+	1197	1038	1038	1.0000000
A04	14052239	14055360	A04p21080.2_BraZ1	2055.47	-	1173	3032	3121	0.9714835
A04	14057449	14059324	A04p21090.2_BraZ1	187.5	+	789	1815	1875	0.9680000
A04	14068299	14068896	A04p21100.2_BraZ1	59.7	-	90	275	597	0.4606365
A04	14070656	14073255	A04p21110.2_BraZ1	2581.75	+	1974	2599	2599	1.0000000
A04	14074825	14075914	A04p21120.2_BraZ1	104	+	1566	1089	1089	1.0000000
A04	14078501	14079584	A04p21130.2_BraZ1	108.3	+	55	688	1083	0.6352724
A04	14087208	14088287	A04p21140.2_BraZ1	103.8	+	16	273	1079	0.2530121
A04	14089082	14090213	A04p21150.2_BraZ1	559.304	+	524	1131	1131	1.0000000
A04	14091247	14091775	A04p21160.2_BraZ1	447	-	115	272	528	0.5151515
A04	14097414	14100581	A04p21170.2_BraZ1	7218.75	+	2905	3165	3167	0.9993685
A04	14101128	14102394	A04p21180.2_BraZ1	126.6	+	433	1266	1266	1.0000000
A04	14102348	14103494	A04p21190.2_BraZ1	1065	+	382	1083	1146	0.9450262
A04	14103942	14113522	A04p21200.2_BraZ1	6071	-	3203	7649	9580	0.7984343
A04	14120244	14120509	A04p21210.2_BraZ1	162	-	164	265	265	1.0000000
A04	14124684	14124952	A04p21220.2_BraZ1	165	-	714	268	268	1.0000000
A04	14126624	14127003	A04p21230.2_BraZ1	276	-	70	379	379	1.0000000
A04	14128697	14129076	A04p21240.2_BraZ1	1380	-	288	379	379	1.0000000
A04	14130777	14131155	A04p21250.2_BraZ1	1380	-	60	378	378	1.0000000
A04	14132854	14133233	A04p21260.2_BraZ1	1242	-	12	273	379	0.7203166
A04	14134925	14135305	A04p21270.2_BraZ1	769.5	-	308	380	380	1.0000000
A04	14136995	14137374	A04p21280.2_BraZ1	276	-	2	176	379	0.4643799
A04	14139063	14139443	A04p21290.2_BraZ1	171	-	12	380	380	1.0000000
A04	14141135	14141514	A04p21300.2_BraZ1	1242	-	174	379	379	1.0000000
A04	14143204	14143583	A04p21310.2_BraZ1	1242	-	0	0	379	0.0000000
A04	14145275	14145654	A04p21320.2_BraZ1	1242	-	107	374	379	0.9868074
A04	14147625	14148003	A04p21330.2_BraZ1	276	-	1112	378	378	1.0000000
A04	14151594	14152536	A04p21340.2_BraZ1	504	-	166	862	942	0.9150743
A04	14153166	14153462	A04p21350.2_BraZ1	162	-	73	296	296	1.0000000
A04	14164180	14166803	A04p21360.2_BraZ1	972.093	+	447	2313	2623	0.8818147
A04	14172464	14176215	A04p21370.2_BraZ1	2985	-	541	3186	3751	0.8493735
A04	14185050	14187653	A04p21380.2_BraZ1	750	+	1269	2508	2603	0.9635037
A04	14187832	14189665	A04p21390.2_BraZ1	183.3	-	549	1720	1833	0.9383524
A04	14192164	14192561	A04p21400.2_BraZ1	174	+	0	0	397	0.0000000
A04	14197071	14197683	A04p21410.2_BraZ1	61.2	+	113	555	612	0.9068627
A04	14202755	14204517	A04p21420.2_BraZ1	994.304	-	572	1718	1762	0.9750284
A04	14205024	14205188	A04p21430.2_BraZ1	11.1	-	113	164	164	1.0000000
A04	14205524	14209315	A04p21440.2_BraZ1	2075.57	-	1055	3566	3791	0.9406489
A04	14216329	14219575	A04p21450.2_BraZ1	1152.95	+	1926	2805	3246	0.8641405
A04	14220217	14223176	A04p21460.2_BraZ1	2023	-	258	2136	2959	0.7218655
A04	14224875	14227897	A04p21470.2_BraZ1	1743.26	+	461	2403	3022	0.7951688
A04	14228968	14229427	A04p21480.2_BraZ1	44.1	+	114	452	459	0.9847494
A04	14231447	14234576	A04p21490.2_BraZ1	1500.61	+	1134	2544	3129	0.8130393
A04	14241322	14241642	A04p21500.2_BraZ1	342	-	480	320	320	1.0000000
A04	14252921	14253248	A04p21510.2_BraZ1	228	-	144	324	327	0.9908257
A04	14256258	14258487	A04p21520.2_BraZ1	972.543	-	443	1915	2229	0.8591297
A04	14260805	14263940	A04p21530.2_BraZ1	1317.82	+	2198	3135	3135	1.0000000
A04	14264785	14267552	A04p21540.2_BraZ1	1732.15	-	245	1972	2767	0.7126852
A04	14272131	14273827	A04p21550.2_BraZ1	532.8	+	1482	1696	1696	1.0000000
A04	14274403	14274514	A04p21560.2_BraZ1	11.1	+	82	111	111	1.0000000
A04	14275626	14279242	A04p21570.2_BraZ1	1667.78	-	991	3035	3616	0.8393252
A04	14286102	14288012	A04p21580.2_BraZ1	1025.53	-	828	1671	1910	0.8748691
A04	14290823	14291800	A04p21590.2_BraZ1	2559.38	+	353	977	977	1.0000000
A04	14294597	14295431	A04p21600.2_BraZ1	83.4	+	459	834	834	1.0000000
A04	14296793	14298216	A04p21610.2_BraZ1	974.455	+	256	1027	1423	0.7217147
A04	14302121	14304904	A04p21620.2_BraZ1	1930.5	-	1071	2744	2783	0.9859864
A04	14307958	14309509	A04p21630.2_BraZ1	1116.13	-	858	1540	1551	0.9929078
A04	14311018	14313057	A04p21640.2_BraZ1	1520.22	-	835	1968	2039	0.9651790
A04	14319120	14322158	A04p21650.2_BraZ1	1329.8	+	1100	2874	3038	0.9460171
A04	14322796	14324429	A04p21660.2_BraZ1	403.965	-	1420	1633	1633	1.0000000
A04	14326582	14328893	A04p21670.2_BraZ1	1650	-	900	2261	2311	0.9783643
A04	14334519	14334971	A04p21680.2_BraZ1	195	+	25	260	452	0.5752212
A04	14349212	14351779	A04p21690.2_BraZ1	1436.47	+	1770	2564	2567	0.9988313
A04	14352117	14353745	A04p21700.2_BraZ1	7938	-	1051	1628	1628	1.0000000
A04	14356623	14359198	A04p21710.2_BraZ1	1183.93	-	376	1487	2575	0.5774757
A04	14372591	14374424	A04p21720.2_BraZ1	1030.41	+	1474	1812	1833	0.9885434
A04	14375314	14376688	A04p21730.2_BraZ1	1048.48	-	841	1365	1374	0.9934498
A04	14378955	14379346	A04p21740.2_BraZ1	264	+	71	391	391	1.0000000
A04	14387030	14389908	A04p21750.2_BraZ1	1260.93	+	635	2351	2878	0.8168867
A04	14394220	14396369	A04p21760.2_BraZ1	1317.42	+	381	1641	2149	0.7636110
A04	14397140	14399387	A04p21770.2_BraZ1	224.7	-	987	2247	2247	1.0000000
A04	14402083	14404062	A04p21780.2_BraZ1	3212.5	-	237	988	1979	0.4992420
A04	14405083	14405311	A04p21790.2_BraZ1	144	-	21	176	228	0.7719298
A04	14408203	14409577	A04p21800.2_BraZ1	135	+	33	923	1374	0.6717613
A04	14410279	14410926	A04p21810.2_BraZ1	327	-	700	647	647	1.0000000
A04	14412085	14413451	A04p21820.2_BraZ1	312.714	+	562	1268	1366	0.9282577
A04	14413707	14413818	A04p21830.2_BraZ1	11.1	+	175	111	111	1.0000000
A04	14420234	14420441	A04p21840.2_BraZ1	20.7	-	95	207	207	1.0000000
A04	14421623	14424400	A04p21850.2_BraZ1	1974	+	799	2419	2777	0.8710839
A04	14428487	14430870	A04p21860.2_BraZ1	1590	+	626	1872	2383	0.7855644
A04	14436928	14439646	A04p21870.2_BraZ1	1560	-	781	1802	2718	0.6629875
A04	14444715	14451085	A04p21880.2_BraZ1	4009.6	+	1561	5372	6370	0.8433281
A04	14451705	14454041	A04p21890.2_BraZ1	1222.34	-	786	2247	2336	0.9619007
A04	14455471	14457071	A04p21900.2_BraZ1	742.969	-	800	1566	1600	0.9787500
A04	14458985	14459549	A04p21910.2_BraZ1	30750	+	307	564	564	1.0000000
A04	14461235	14466844	A04p21920.2_BraZ1	2426.56	-	3382	5281	5609	0.9415225
A04	14468460	14472622	A04p21930.2_BraZ1	693	-	2536	4141	4162	0.9949543
A04	14476219	14478179	A04p21940.2_BraZ1	1128.71	+	665	1950	1960	0.9948980
A04	14491225	14492008	A04p21950.2_BraZ1	78.3	+	323	783	783	1.0000000
A04	14493575	14496796	A04p21960.2_BraZ1	2052.27	-	1230	3119	3221	0.9683328
A04	14498026	14498819	A04p21970.2_BraZ1	696	-	534	793	793	1.0000000
A04	14499391	14500854	A04p21980.2_BraZ1	2067.35	-	2505	1463	1463	1.0000000
A04	14507801	14513089	A04p21990.2_BraZ1	3262.71	+	3319	5181	5288	0.9797655
A04	14519142	14524303	A04p22000.2_BraZ1	2283	+	3254	4889	5161	0.9472970
A04	14525483	14537739	A04p22010.2_BraZ1	3077.07	-	5685	11317	12256	0.9233845
A04	14540028	14540511	A04p22020.2_BraZ1	48.3	+	149	423	483	0.8757764
A04	14540946	14541183	A04p22030.2_BraZ1	13.8	-	589	237	237	1.0000000
A04	14541887	14543316	A04p22040.2_BraZ1	1038	+	31	600	1429	0.4198740
A04	14547863	14548007	A04p22050.2_BraZ1	14.4	-	212	144	144	1.0000000
A04	14548691	14549099	A04p22060.2_BraZ1	40.8	+	191	408	408	1.0000000
A04	14555724	14558227	A04p22070.2_BraZ1	1558.37	+	903	2405	2503	0.9608470
A04	14559403	14565196	A04p22080.2_BraZ1	2425.71	+	3260	5709	5793	0.9854997
A04	14567786	14569775	A04p22090.2_BraZ1	1128	+	1845	1989	1989	1.0000000
A04	14571625	14572798	A04p22100.2_BraZ1	117.3	+	1112	1173	1173	1.0000000
A04	14575130	14577510	A04p22110.2_BraZ1	1275.16	-	614	1789	2380	0.7516807
A04	14587322	14588052	A04p22120.2_BraZ1	891	-	613	730	730	1.0000000
A04	14601033	14604330	A04p22130.2_BraZ1	1629.09	+	592	2617	3297	0.7937519
A04	14611497	14614742	A04p22140.2_BraZ1	1265.37	+	98	1167	3245	0.3596302
A04	14617959	14618500	A04p22150.2_BraZ1	285	-	66	377	541	0.6968577
A04	14627343	14629188	A04p22160.2_BraZ1	897.75	-	66	596	1845	0.3230352
A04	14638273	14638990	A04p22170.2_BraZ1	71.7	+	251	713	717	0.9944212
A04	14639566	14640278	A04p22180.2_BraZ1	603	+	290	680	712	0.9550562
A04	14642007	14643169	A04p22190.2_BraZ1	891.391	-	734	1162	1162	1.0000000
A04	14645007	14651332	A04p22200.2_BraZ1	1082.63	+	710	2068	6325	0.3269565
A04	14653052	14653661	A04p22210.2_BraZ1	295.312	-	350	609	609	1.0000000
A04	14653986	14655560	A04p22220.2_BraZ1	315	+	1252	1574	1574	1.0000000
A04	14656213	14657329	A04p22230.2_BraZ1	111.6	+	551	1116	1116	1.0000000
A04	14659003	14662756	A04p22240.2_BraZ1	652.235	-	1912	3659	3753	0.9749534
A04	14663504	14663777	A04p22250.2_BraZ1	27.3	-	185	273	273	1.0000000
A04	14667665	14670097	A04p22260.2_BraZ1	1138.06	-	2352	2432	2432	1.0000000
A04	14670124	14670930	A04p22270.2_BraZ1	336	-	748	806	806	1.0000000
A04	14671898	14673783	A04p22280.2_BraZ1	651.522	-	287	1460	1885	0.7745358
A04	14684767	14687233	A04p22290.2_BraZ1	246.6	+	789	2457	2466	0.9963503
A04	14691363	14692817	A04p22300.2_BraZ1	900	+	442	984	1454	0.6767538
A04	14693208	14694933	A04p22310.2_BraZ1	668.265	-	2308	1725	1725	1.0000000
A04	14695758	14699760	A04p22320.2_BraZ1	2062.67	+	2031	3897	4002	0.9737631
A04	14700434	14700902	A04p22330.2_BraZ1	46.8	-	484	468	468	1.0000000
A04	14703354	14709465	A04p22340.2_BraZ1	1371.92	-	3005	5733	6111	0.9381443
A04	14706087	14706908	A04p22350.2_BraZ1	681	+	1399	821	821	1.0000000
A04	14720528	14720945	A04p22360.2_BraZ1	41.7	-	71	390	417	0.9352518
A04	14734337	14736062	A04p22370.2_BraZ1	519.2	+	687	1568	1725	0.9089855
A04	14737289	14739262	A04p22380.2_BraZ1	1068.26	-	739	1849	1973	0.9371516
A04	14741386	14743972	A04p22390.2_BraZ1	258.6	-	1060	2572	2586	0.9945862
A04	14745290	14745491	A04p22400.2_BraZ1	20.1	-	277	201	201	1.0000000
A04	14746112	14746416	A04p22410.2_BraZ1	282	-	0	0	304	0.0000000
A04	14747341	14749343	A04p22420.2_BraZ1	3691.07	-	448	1494	2002	0.7462537
A04	14758992	14760914	A04p22430.2_BraZ1	1510.5	+	106	1372	1922	0.7138398
A04	14763344	14764168	A04p22440.2_BraZ1	6925.5	+	517	824	824	1.0000000
A04	14764789	14765819	A04p22450.2_BraZ1	333.703	-	847	1030	1030	1.0000000
A04	14769590	14770349	A04p22460.2_BraZ1	437.5	+	290	759	759	1.0000000
A04	14770920	14774657	A04p22470.2_BraZ1	1039.69	+	1929	3245	3737	0.8683436
A04	14779687	14780665	A04p22480.2_BraZ1	97.8	-	87	735	978	0.7515337
A04	14785233	14785939	A04p22490.2_BraZ1	294	-	848	706	706	1.0000000
A04	14786534	14787717	A04p22500.2_BraZ1	420	-	1522	1183	1183	1.0000000
A04	14788622	14791884	A04p22510.2_BraZ1	1921.22	+	1225	3190	3262	0.9779276
A04	14795577	14796843	A04p22520.2_BraZ1	126.6	+	52	664	1266	0.5244866
A04	14802233	14803443	A04p22530.2_BraZ1	606.04	+	300	1039	1210	0.8586777
A04	14805058	14807062	A04p22540.2_BraZ1	1124.93	-	418	1793	2004	0.8947106
A04	14809666	14816855	A04p22550.2_BraZ1	2927.37	+	3668	6026	7189	0.8382251
A04	14817508	14821572	A04p22560.2_BraZ1	1306.19	-	1678	3703	4064	0.9111713
A04	14826994	14828913	A04p22570.2_BraZ1	1320	+	976	1834	1919	0.9557061
A04	14832037	14833106	A04p22580.2_BraZ1	57.6	+	1188	1069	1069	1.0000000
A04	14835796	14836277	A04p22590.2_BraZ1	240.409	-	467	481	481	1.0000000
A04	14837185	14842995	A04p22600.2_BraZ1	2934.04	-	2809	5342	5810	0.9194492
A04	14845655	14853751	A04p22610.2_BraZ1	3628.59	-	1433	6497	8096	0.8024951
A04	14861285	14861492	A04p22620.2_BraZ1	20.7	-	217	207	207	1.0000000
A04	14866578	14868963	A04p22630.2_BraZ1	1601.73	+	914	2385	2385	1.0000000
A04	14870356	14870656	A04p22640.2_BraZ1	30	+	2	16	300	0.0533333
A04	14874834	14880846	A04p22650.2_BraZ1	1566.61	+	1061	3830	6012	0.6370592
A04	14877468	14878348	A04p22660.2_BraZ1	234	+	2	54	880	0.0613636
A04	14881543	14883808	A04p22670.2_BraZ1	1443	-	234	1255	2265	0.5540839
A04	14886083	14887337	A04p22680.2_BraZ1	969	-	204	1228	1254	0.9792663
A04	14889101	14890691	A04p22690.2_BraZ1	1491	+	144	1260	1590	0.7924528
A04	14891663	14893443	A04p22700.2_BraZ1	1375.65	-	454	1699	1780	0.9544944
A04	14900222	14901968	A04p22710.2_BraZ1	174.6	+	196	1308	1746	0.7491409
A04	14909505	14910969	A04p22720.2_BraZ1	935.15	+	137	1079	1464	0.7370219
A04	14919318	14922136	A04p22730.2_BraZ1	2329.53	-	227	1964	2818	0.6969482
A04	14926968	14928131	A04p22740.2_BraZ1	527.659	+	1112	1163	1163	1.0000000
A04	14936626	14937493	A04p22750.2_BraZ1	86.4	+	45	238	867	0.2745098
A04	14942442	14943624	A04p22760.2_BraZ1	118.2	+	728	1182	1182	1.0000000
A04	14945595	14946903	A04p22770.2_BraZ1	130.8	+	98	1095	1308	0.8371559
A04	14972810	14976553	A04p22780.2_BraZ1	687.905	+	1141	3464	3743	0.9254609
A04	14982871	14983151	A04p22790.2_BraZ1	192	-	408	280	280	1.0000000
A04	14985777	14988104	A04p22800.2_BraZ1	1090.67	+	1347	1983	2327	0.8521702
A04	14990146	14996524	A04p22810.2_BraZ1	1120.09	+	3946	5964	6378	0.9350893
A04	14999573	15000617	A04p22820.2_BraZ1	104.4	-	554	917	1044	0.8783525
A04	15000053	15000870	A04p22830.2_BraZ1	270	-	680	817	817	1.0000000
A04	15004270	15009039	A04p22840.2_BraZ1	2251.64	-	1310	3510	4769	0.7360033
A04	15011174	15012425	A04p22850.2_BraZ1	546	+	1089	1245	1251	0.9952039
A04	15012905	15014394	A04p22860.2_BraZ1	1337.62	-	234	1312	1489	0.8811283
A04	15017427	15017953	A04p22870.2_BraZ1	165	-	448	526	526	1.0000000
A04	15023832	15024027	A04p22880.2_BraZ1	14.4	+	252	195	195	1.0000000
A04	15024661	15025138	A04p22890.2_BraZ1	47.7	-	64	357	477	0.7484277
A04	15031704	15032052	A04p22900.2_BraZ1	34.8	+	36	116	348	0.3333333
A04	15032487	15032736	A04p22910.2_BraZ1	24.9	+	184	249	249	1.0000000
A04	15032840	15032948	A04p22920.2_BraZ1	10.8	+	156	108	108	1.0000000
A04	15033341	15033695	A04p22930.2_BraZ1	902	-	171	354	354	1.0000000
A04	15034997	15035561	A04p22940.2_BraZ1	56.4	+	377	564	564	1.0000000
A04	15036744	15038055	A04p22950.2_BraZ1	131.1	-	44	510	1311	0.3890160
A04	15055607	15057023	A04p22960.2_BraZ1	7339.5	-	175	917	1416	0.6475989
A04	15076336	15077185	A04p22970.2_BraZ1	84.3	-	72	714	849	0.8409894
A04	15088314	15091614	A04p22980.2_BraZ1	3027	-	2528	3276	3300	0.9927273
A04	15092839	15098113	A04p22990.2_BraZ1	2251.02	+	3438	5082	5274	0.9635950
A04	15102530	15106529	A04p23000.2_BraZ1	2478.76	+	658	2311	3999	0.5778944
A04	15107051	15111264	A04p23010.2_BraZ1	1314.41	-	2237	3853	4213	0.9145502
A04	15114959	15115198	A04p23020.2_BraZ1	165	-	39	239	239	1.0000000
A04	15116954	15117218	A04p23030.2_BraZ1	26.4	+	0	0	264	0.0000000
A04	15118668	15119537	A04p23040.2_BraZ1	714	+	112	666	869	0.7663981
A04	15131117	15132206	A04p23050.2_BraZ1	705	+	556	1062	1089	0.9752066
A04	15138580	15143331	A04p23060.2_BraZ1	2705.92	-	788	3216	4751	0.6769101
A04	15154856	15155989	A04p23070.2_BraZ1	720	+	70	737	1133	0.6504855
A04	15158183	15158676	A04p23080.2_BraZ1	282	-	341	452	493	0.9168357
A04	15160895	15161308	A04p23090.2_BraZ1	300	+	178	349	413	0.8450363
A04	15161906	15162281	A04p23100.2_BraZ1	37.5	-	101	350	375	0.9333333
A04	15165419	15167652	A04p23110.2_BraZ1	207	+	1593	1998	2233	0.8947604
A04	15170279	15171773	A04p23120.2_BraZ1	149.4	-	60	642	1494	0.4297189
A04	15180020	15181820	A04p23130.2_BraZ1	174.3	-	255	569	1800	0.3161111
A04	15185368	15186870	A04p23140.2_BraZ1	798	+	235	891	1502	0.5932090
A04	15197674	15198913	A04p23150.2_BraZ1	123.9	-	107	904	1239	0.7296206
A04	15199917	15201199	A04p23160.2_BraZ1	1045.5	-	125	1163	1282	0.9071763
A04	15211163	15211610	A04p23170.2_BraZ1	44.7	+	89	355	447	0.7941834
A04	15224614	15225064	A04p23180.2_BraZ1	45	+	152	415	450	0.9222222
A04	15225827	15226286	A04p23190.2_BraZ1	45.9	+	580	459	459	1.0000000
A04	15227542	15227782	A04p23200.2_BraZ1	24	-	150	240	240	1.0000000
A04	15228873	15230719	A04p23210.2_BraZ1	962.438	-	108	1113	1846	0.6029252
A04	15231603	15231948	A04p23220.2_BraZ1	34.5	+	115	345	345	1.0000000
A04	15235560	15238884	A04p23230.2_BraZ1	2403	-	375	1841	3324	0.5538508
A04	15253492	15254332	A04p23240.2_BraZ1	84	-	117	562	840	0.6690476
A04	15256588	15259249	A04p23250.2_BraZ1	1256.12	-	1043	2576	2661	0.9680571
A04	15265792	15269168	A04p23260.2_BraZ1	4295.2	+	1119	3082	3376	0.9129147
A04	15277891	15279332	A04p23270.2_BraZ1	1035	+	17	360	1441	0.2498265
A04	15280493	15280853	A04p23280.2_BraZ1	36	+	148	360	360	1.0000000
A04	15282808	15283789	A04p23290.2_BraZ1	879	-	0	0	981	0.0000000
A04	15285404	15288194	A04p23300.2_BraZ1	1692.96	-	615	2431	2790	0.8713261
A04	15297705	15299745	A04p23310.2_BraZ1	1294.32	+	902	1949	2040	0.9553922
A04	15304107	15307993	A04p23320.2_BraZ1	2063.44	-	2764	3504	3886	0.9016984
A04	15309555	15310446	A04p23330.2_BraZ1	89.1	-	126	732	891	0.8215488
A04	15311434	15311863	A04p23340.2_BraZ1	42.9	+	126	244	429	0.5687646
A04	15318899	15321133	A04p23350.2_BraZ1	1180.49	+	828	2128	2234	0.9525515
A04	15324299	15326132	A04p23360.2_BraZ1	772.962	-	1171	1833	1833	1.0000000
A04	15336226	15352741	A04p23370.2_BraZ1	482.7	+	14306	14983	16515	0.9072359
A04	15342291	15343332	A04p23380.2_BraZ1	104.1	-	1962	1041	1041	1.0000000
A04	15353607	15354439	A04p23390.2_BraZ1	457.188	+	757	832	832	1.0000000
A04	15355259	15357843	A04p23400.2_BraZ1	2019	-	1368	2481	2584	0.9601393
A04	15359129	15359583	A04p23410.2_BraZ1	183	+	627	454	454	1.0000000
A04	15373104	15375285	A04p23420.2_BraZ1	218.1	+	692	1912	2181	0.8766621
A04	15375294	15376452	A04p23430.2_BraZ1	279	-	676	1158	1158	1.0000000
A04	15376488	15377213	A04p23440.2_BraZ1	28.5	-	248	725	725	1.0000000
A04	15378960	15380511	A04p23450.2_BraZ1	685.3	+	875	1533	1551	0.9883946
A04	15381191	15384436	A04p23460.2_BraZ1	1328.64	-	2067	3239	3245	0.9981510
A04	15394566	15398220	A04p23470.2_BraZ1	1217.93	-	2268	3640	3654	0.9961686
A04	15401735	15406210	A04p23480.2_BraZ1	2734.29	-	1251	3490	4475	0.7798883
A04	15409486	15413552	A04p23490.2_BraZ1	20421.4	-	2087	3905	4066	0.9604033
A04	15417680	15418341	A04p23500.2_BraZ1	240	-	763	661	661	1.0000000
A04	15419247	15424335	A04p23510.2_BraZ1	13195.5	-	3514	2877	5088	0.5654481
A04	15428953	15432885	A04p23520.2_BraZ1	3530.38	-	3892	3836	3932	0.9755849
A04	15446963	15458812	A04p23530.2_BraZ1	6392.25	-	5832	10110	11849	0.8532366
A04	15461768	15462161	A04p23540.2_BraZ1	39.3	+	630	393	393	1.0000000
A04	15478721	15481284	A04p23550.2_BraZ1	540	-	1426	2467	2563	0.9625439
A04	15483200	15488840	A04p23560.2_BraZ1	2417.5	-	1992	5082	5640	0.9010639
A04	15506042	15508729	A04p23570.2_BraZ1	1021.36	+	2559	2687	2687	1.0000000
A04	15509472	15510099	A04p23580.2_BraZ1	1922	+	115	398	627	0.6347687
A04	15511640	15513269	A04p23590.2_BraZ1	821.062	-	51	901	1629	0.5531000
A04	15523061	15527496	A04p23600.2_BraZ1	1094.16	-	1626	4052	4435	0.9136415
A04	15530338	15531474	A04p23610.2_BraZ1	687.386	+	216	1097	1136	0.9656690
A04	15531813	15532206	A04p23620.2_BraZ1	297	-	383	393	393	1.0000000
A04	15540294	15541444	A04p23630.2_BraZ1	585.387	+	416	1150	1150	1.0000000
A04	15556141	15557732	A04p23640.2_BraZ1	740.903	+	48	856	1591	0.5380264
A04	15559440	15562140	A04p23650.2_BraZ1	885.082	-	658	2023	2700	0.7492592
A04	15568867	15570158	A04p23660.2_BraZ1	723.273	+	129	1135	1291	0.8791634
A04	15579029	15580565	A04p23670.2_BraZ1	729	+	438	1506	1536	0.9804688
A04	15581394	15583255	A04p23680.2_BraZ1	764.64	-	644	1788	1861	0.9607738
A04	15586484	15587707	A04p23690.2_BraZ1	1134	+	351	1221	1223	0.9983647
A04	15587951	15588701	A04p23700.2_BraZ1	678	-	231	750	750	1.0000000
A04	15589124	15589250	A04p23710.2_BraZ1	12.6	+	173	126	126	1.0000000
A04	15590889	15591682	A04p23720.2_BraZ1	365.4	-	784	793	793	1.0000000
A04	15592733	15593498	A04p23730.2_BraZ1	2934	-	299	705	765	0.9215686
A04	15593860	15595504	A04p23740.2_BraZ1	675	-	988	1523	1644	0.9263991
A04	15603772	15604861	A04p23750.2_BraZ1	475.435	-	165	812	1089	0.7456382
A04	15610291	15612069	A04p23760.2_BraZ1	634.568	-	257	1177	1778	0.6619797
A04	15612849	15613311	A04p23770.2_BraZ1	46.2	-	221	399	462	0.8636364
A04	15614582	15615901	A04p23780.2_BraZ1	225.861	-	562	1319	1319	1.0000000
A04	15616158	15616663	A04p23790.2_BraZ1	247.909	+	446	505	505	1.0000000
A04	15616977	15618767	A04p23800.2_BraZ1	26437.5	-	386	1664	1790	0.9296089
A04	15619478	15623120	A04p23810.2_BraZ1	1028.57	+	920	3120	3642	0.8566722
A04	15624556	15629366	A04p23820.2_BraZ1	1672.8	+	2990	4533	4810	0.9424117
A04	15635190	15636312	A04p23830.2_BraZ1	112.2	+	264	800	1122	0.7130125
A04	15638095	15640773	A04p23840.2_BraZ1	3409	-	1065	2559	2678	0.9555638
A04	15646454	15649132	A04p23850.2_BraZ1	141	+	2076	2624	2678	0.9798357
A04	15649652	15650006	A04p23860.2_BraZ1	34.5	-	24	346	354	0.9774011
A04	15650878	15652469	A04p23870.2_BraZ1	1422	-	1451	1591	1591	1.0000000
A04	15850157	15862452	A04p23880.2_BraZ1	1885.8	-	1817	7749	12295	0.6302562
A04	15863798	15869886	A04p23890.2_BraZ1	3790.04	+	2502	5535	6088	0.9091656
A04	15871671	15874656	A04p23900.2_BraZ1	1107.73	-	753	2398	2985	0.8033501
A04	15883360	15885164	A04p23910.2_BraZ1	219	-	1473	1804	1804	1.0000000
A04	15885855	15886754	A04p23920.2_BraZ1	405.45	-	401	899	899	1.0000000
A04	15888343	15894650	A04p23930.2_BraZ1	1191.64	+	3638	6100	6307	0.9671793
A04	15898189	15899397	A04p23940.2_BraZ1	1107	+	82	559	1208	0.4627483
A04	15906656	15911948	A04p23950.2_BraZ1	2076	+	1310	4838	5292	0.9142101
A04	15915372	15917832	A04p23960.2_BraZ1	1170	-	118	1463	2460	0.5947155
A04	15922250	15924180	A04p23970.2_BraZ1	1518	+	422	1752	1930	0.9077720
A04	15926545	15928283	A04p23980.2_BraZ1	1073.39	+	543	1630	1738	0.9378596
A04	15929614	15930658	A04p23990.2_BraZ1	104.4	+	1007	1044	1044	1.0000000
A04	15935367	15939324	A04p24000.2_BraZ1	1104	+	3530	3957	3957	1.0000000
A04	15942815	15943838	A04p24010.2_BraZ1	102.3	+	768	1023	1023	1.0000000
A04	15945362	15948907	A04p24020.2_BraZ1	2923.07	-	1348	3401	3545	0.9593794
A04	15961221	15962040	A04p24030.2_BraZ1	573	+	116	685	819	0.8363858
A04	15975189	15977172	A04p24040.2_BraZ1	2522	-	12	550	1983	0.2773575
A04	15983972	15984298	A04p24050.2_BraZ1	711	-	539	326	326	1.0000000
A04	15987605	15988187	A04p24060.2_BraZ1	57.9	+	405	582	582	1.0000000
A04	15988562	15990836	A04p24070.2_BraZ1	227.4	-	1666	2274	2274	1.0000000
A04	15995757	15996813	A04p24080.2_BraZ1	101.4	-	1028	1056	1056	1.0000000
A04	16002111	16002785	A04p24090.2_BraZ1	471	+	632	674	674	1.0000000
A04	16002775	16003110	A04p24100.2_BraZ1	318	-	300	335	335	1.0000000
A04	16005107	16005689	A04p24110.2_BraZ1	57.9	+	182	582	582	1.0000000
A04	16008494	16009564	A04p24120.2_BraZ1	981	+	386	1070	1070	1.0000000
A04	16009879	16010273	A04p24130.2_BraZ1	231	-	259	394	394	1.0000000
A04	16010661	16011501	A04p24140.2_BraZ1	516	-	429	732	840	0.8714285
A04	16014601	16016931	A04p24150.2_BraZ1	1127.47	-	1028	2161	2330	0.9274678
A04	16017310	16019376	A04p24160.2_BraZ1	1514.17	-	533	1585	2066	0.7671829
A04	16020468	16020845	A04p24170.2_BraZ1	252	-	832	377	377	1.0000000
A04	16032725	16033265	A04p24180.2_BraZ1	54	+	232	483	540	0.8944445
A04	16037462	16041348	A04p24190.2_BraZ1	2216	-	1101	3398	3886	0.8744210
A04	16042070	16043462	A04p24200.2_BraZ1	1074	-	514	1330	1392	0.9554598
A04	16044970	16046082	A04p24210.2_BraZ1	298.333	-	1340	1112	1112	1.0000000
A04	16054691	16056516	A04p24220.2_BraZ1	9234	+	181	1240	1825	0.6794521
A04	16061940	16063208	A04p24230.2_BraZ1	1035	+	197	840	1268	0.6624606
A04	16066591	16073046	A04p24240.2_BraZ1	2393.7	-	3023	5168	6455	0.8006197
A04	16073483	16073639	A04p24250.2_BraZ1	15.6	+	142	139	156	0.8910257
A04	16076279	16077593	A04p24260.2_BraZ1	131.4	-	572	1305	1314	0.9931507
A04	16089430	16090938	A04p24270.2_BraZ1	432	-	472	1478	1508	0.9801061
A04	16098127	16098961	A04p24280.2_BraZ1	6669	-	168	690	834	0.8273382
A04	16100768	16101741	A04p24290.2_BraZ1	95.7	+	125	621	973	0.6382323
A04	16103790	16106233	A04p24300.2_BraZ1	963	+	1306	2327	2443	0.9525174
A04	16107338	16110879	A04p24310.2_BraZ1	1907.32	-	1605	3485	3541	0.9841853
A04	16115140	16117465	A04p24320.2_BraZ1	466.974	-	663	1873	2325	0.8055914
A04	16118696	16120606	A04p24330.2_BraZ1	1411.47	-	573	1900	1910	0.9947644
A04	16124090	16125918	A04p24340.2_BraZ1	866.667	-	535	1767	1828	0.9666302
A04	16128528	16129494	A04p24350.2_BraZ1	96.6	-	48	814	966	0.8426501
A04	16130468	16131595	A04p24360.2_BraZ1	576.84	+	886	1127	1127	1.0000000
A04	16135199	16135605	A04p24370.2_BraZ1	30.9	-	502	406	406	1.0000000
A04	16143167	16147100	A04p24380.2_BraZ1	1617	+	1916	3902	3933	0.9921180
A04	16145370	16146403	A04p24390.2_BraZ1	101.4	-	493	1033	1033	1.0000000
A04	16147758	16152117	A04p24400.2_BraZ1	474	+	4703	4077	4359	0.9353063
A04	16150280	16151372	A04p24410.2_BraZ1	728	-	893	1012	1092	0.9267399
A04	16153046	16155605	A04p24420.2_BraZ1	396	-	438	2099	2559	0.8202423
A04	16153794	16155154	A04p24430.2_BraZ1	237.88	-	115	968	1360	0.7117647
A04	16160084	16161192	A04p24440.2_BraZ1	358	-	13	206	1108	0.1859206
A04	16168474	16169204	A04p24450.2_BraZ1	402	-	122	657	730	0.9000000
A04	16169721	16173402	A04p24460.2_BraZ1	1718.18	-	1102	3262	3681	0.8861722
A04	16175910	16179533	A04p24470.2_BraZ1	1087.58	+	1906	3302	3623	0.9113994
A04	16181336	16182473	A04p24480.2_BraZ1	96.6	+	923	1137	1137	1.0000000
A04	16184315	16188135	A04p24490.2_BraZ1	2141.49	+	1674	3772	3820	0.9874346
A04	16193343	16194242	A04p24500.2_BraZ1	9315	+	632	899	899	1.0000000
A04	16194930	16197477	A04p24510.2_BraZ1	1604.22	-	854	2311	2547	0.9073420
A04	16200007	16200955	A04p24520.2_BraZ1	372	+	49	715	948	0.7542194
A04	16201152	16204365	A04p24530.2_BraZ1	2176.36	+	1155	2683	3213	0.8350452
A04	16204889	16206966	A04p24540.2_BraZ1	228.662	-	2041	2077	2077	1.0000000
A04	16207588	16209455	A04p24550.2_BraZ1	1258.02	-	595	1650	1867	0.8837708
A04	16211360	16214251	A04p24560.2_BraZ1	1331.1	-	1336	2785	2891	0.9633345
A04	16214668	16217200	A04p24570.2_BraZ1	1284.39	-	938	2444	2532	0.9652449
A04	16219143	16220034	A04p24580.2_BraZ1	89.1	-	329	891	891	1.0000000
A04	16226138	16227659	A04p24590.2_BraZ1	1033.2	+	746	1382	1521	0.9086127
A04	16231935	16232079	A04p24600.2_BraZ1	14.4	+	110	144	144	1.0000000
A04	16235251	16236937	A04p24610.2_BraZ1	1416	+	914	1686	1686	1.0000000
A04	16238280	16243857	A04p24620.2_BraZ1	2775.7	-	3956	5501	5577	0.9863726
A04	16247359	16248106	A04p24630.2_BraZ1	74.7	-	257	729	747	0.9759036
A04	16249019	16251318	A04p24640.2_BraZ1	758.385	+	1003	1843	2299	0.8016529
A04	16252674	16258838	A04p24650.2_BraZ1	1310.1	-	2557	5267	6164	0.8544776
A04	16262958	16264214	A04p24660.2_BraZ1	1615.5	-	419	1256	1256	1.0000000
A04	16270339	16274461	A04p24670.2_BraZ1	1246	-	343	1548	4122	0.3755459
A04	16282804	16283095	A04p24680.2_BraZ1	29.1	+	167	291	291	1.0000000
A04	16286518	16287058	A04p24690.2_BraZ1	261	+	1269	540	540	1.0000000
A04	16299654	16301101	A04p24700.2_BraZ1	892.071	-	989	1447	1447	1.0000000
A04	16311440	16312298	A04p24710.2_BraZ1	648	+	143	817	858	0.9522145
A04	16313179	16315648	A04p24720.2_BraZ1	1512	-	1263	2360	2469	0.9558526
A04	16317562	16319645	A04p24730.2_BraZ1	351	-	286	1546	2083	0.7421988
A04	16322175	16328615	A04p24740.2_BraZ1	951.552	+	2242	4527	6440	0.7029503
A04	16327176	16328105	A04p24750.2_BraZ1	405	+	186	712	929	0.7664155
A04	16328932	16331072	A04p24760.2_BraZ1	768.116	-	1273	2043	2140	0.9546729
A04	16334319	16335006	A04p24770.2_BraZ1	531.667	+	16	245	687	0.3566230
A04	16336540	16337041	A04p24780.2_BraZ1	354	+	135	467	501	0.9321357
A04	16337237	16340599	A04p24790.2_BraZ1	1412.86	-	1357	3178	3362	0.9452707
A04	16343074	16343481	A04p24800.2_BraZ1	291	+	382	407	407	1.0000000
A04	16346475	16348298	A04p24810.2_BraZ1	916.11	+	225	1341	1823	0.7356007
A04	16349238	16350370	A04p24820.2_BraZ1	1085.5	+	357	1132	1132	1.0000000
A04	16352051	16354602	A04p24830.2_BraZ1	1080.06	+	962	2429	2551	0.9521756
A04	16356737	16357871	A04p24840.2_BraZ1	113.4	+	740	1134	1134	1.0000000
A04	16361401	16362448	A04p24850.2_BraZ1	104.7	+	748	1047	1047	1.0000000
A04	16363854	16366721	A04p24860.2_BraZ1	1130.52	-	1312	2772	2867	0.9668643
A04	16368941	16371098	A04p24870.2_BraZ1	3908.25	-	1174	2099	2157	0.9731108
A04	16376917	16381115	A04p24880.2_BraZ1	2174.67	+	1202	4031	4198	0.9602191
A04	16381742	16383706	A04p24890.2_BraZ1	979.922	-	989	1964	1964	1.0000000
A04	16386761	16387446	A04p24900.2_BraZ1	462	-	482	685	685	1.0000000
A04	16391372	16391699	A04p24910.2_BraZ1	32.7	+	285	327	327	1.0000000
A04	16392372	16393247	A04p24920.2_BraZ1	372.923	-	130	641	875	0.7325714
A04	16393859	16396173	A04p24930.2_BraZ1	183.231	-	761	2078	2314	0.8980121
A04	16398740	16403208	A04p24940.2_BraZ1	1811.36	-	2306	4423	4468	0.9899284
A04	16412009	16412258	A04p24950.2_BraZ1	24.9	+	4	33	249	0.1325301
A04	16421077	16421326	A04p24960.2_BraZ1	24.9	+	10	55	249	0.2208835
A04	16440515	16440761	A04p24970.2_BraZ1	24.6	+	6	102	246	0.4146341
A04	16443543	16444005	A04p24980.2_BraZ1	228	+	383	462	462	1.0000000
A04	16444565	16449508	A04p24990.2_BraZ1	569.636	-	1109	3595	4943	0.7272911
A04	16446447	16447375	A04p25000.2_BraZ1	89.1	-	447	796	928	0.8577586
A04	16450050	16451526	A04p25010.2_BraZ1	1093.33	-	1879	1476	1476	1.0000000
A04	16453636	16454352	A04p25020.2_BraZ1	219	-	1779	716	716	1.0000000
A04	16455769	16465188	A04p25030.2_BraZ1	6276.65	+	2061	5229	9419	0.5551545
A04	16466237	16467387	A04p25040.2_BraZ1	825	+	288	867	1150	0.7539130
A04	16470828	16470981	A04p25050.2_BraZ1	15.3	+	110	153	153	1.0000000
A04	16472393	16473596	A04p25060.2_BraZ1	120.3	+	1666	1203	1203	1.0000000
A04	16474314	16474929	A04p25070.2_BraZ1	61.5	-	0	0	615	0.0000000
A04	16483040	16483506	A04p25080.2_BraZ1	243	+	157	438	466	0.9399142
A04	16484580	16485195	A04p25090.2_BraZ1	61.5	-	0	0	615	0.0000000
A04	16487878	16489694	A04p25100.2_BraZ1	437.5	+	512	1519	1816	0.8364537
A04	16488734	16489020	A04p25110.2_BraZ1	162	-	132	286	286	1.0000000
A04	16492037	16492529	A04p25120.2_BraZ1	258	-	197	492	492	1.0000000
A04	16497888	16498542	A04p25130.2_BraZ1	65.4	+	64	443	654	0.6773700
A04	16499024	16499437	A04p25140.2_BraZ1	264	-	79	184	413	0.4455206
A04	16499850	16499985	A04p25150.2_BraZ1	13.5	+	104	135	135	1.0000000
A04	16503716	16504208	A04p25160.2_BraZ1	49.2	+	0	0	492	0.0000000
A04	16505792	16506683	A04p25170.2_BraZ1	89.1	+	1161	891	891	1.0000000
A04	16508757	16510128	A04p25180.2_BraZ1	753	-	128	875	1371	0.6382203
A04	16516501	16518893	A04p25190.2_BraZ1	1118.21	-	2607	2380	2392	0.9949833
A04	16519705	16521189	A04p25200.2_BraZ1	1311	+	381	1269	1484	0.8551213
A04	16523275	16526012	A04p25210.2_BraZ1	1104.17	+	1141	2737	2737	1.0000000
A04	16529668	16530466	A04p25220.2_BraZ1	79.8	-	60	494	798	0.6190476
A04	16551670	16553593	A04p25230.2_BraZ1	1842	-	608	1854	1923	0.9641185
A04	16554380	16559015	A04p25240.2_BraZ1	2147.5	-	2507	4439	4635	0.9577131
A04	16566029	16566134	A04p25250.2_BraZ1	10.5	+	107	105	105	1.0000000
A04	16566320	16569952	A04p25260.2_BraZ1	1913.37	+	2668	3629	3632	0.9991740
A04	16570519	16570843	A04p25270.2_BraZ1	32.4	-	200	324	324	1.0000000
A04	16573611	16574838	A04p25280.2_BraZ1	122.7	+	200	785	1227	0.6397718
A04	16578898	16580125	A04p25290.2_BraZ1	122.7	+	361	1129	1227	0.9201304
A04	16580472	16582732	A04p25300.2_BraZ1	1475.91	-	1015	1899	2260	0.8402655
A04	16583285	16584605	A04p25310.2_BraZ1	318	+	507	1320	1320	1.0000000
A04	16587358	16594177	A04p25320.2_BraZ1	2990.81	-	1188	6092	6819	0.8933861
A04	16599065	16605186	A04p25330.2_BraZ1	2898	+	1469	4001	6121	0.6536514
A04	16606342	16607846	A04p25340.2_BraZ1	75	-	830	1348	1504	0.8962766
A04	16615818	16622222	A04p25350.2_BraZ1	479.404	-	2238	6143	6404	0.9592443
A04	16619945	16621346	A04p25360.2_BraZ1	1121.68	+	515	1377	1401	0.9828694
A04	16623099	16626852	A04p25370.2_BraZ1	1556.01	+	2442	3753	3753	1.0000000
A04	16627552	16630381	A04p25380.2_BraZ1	691.918	-	1691	2825	2829	0.9985861
A04	16631261	16632056	A04p25390.2_BraZ1	216	-	570	712	795	0.8955975
A04	16632528	16634457	A04p25400.2_BraZ1	2904	+	1233	1929	1929	1.0000000
A04	16635098	16636572	A04p25410.2_BraZ1	731.645	-	731	1240	1474	0.8412483
A04	16636974	16638192	A04p25420.2_BraZ1	121.8	+	1105	1163	1218	0.9548440
A04	16639018	16639645	A04p25430.2_BraZ1	62.7	+	178	620	627	0.9888358
A04	16641400	16641970	A04p25440.2_BraZ1	57	+	121	570	570	1.0000000
A04	16643854	16644804	A04p25450.2_BraZ1	414	+	149	949	950	0.9989474
A04	16645227	16648201	A04p25460.2_BraZ1	21192.5	+	394	2640	2974	0.8876933
A04	16651564	16651825	A04p25470.2_BraZ1	132	+	242	246	261	0.9425287
A04	16652509	16655638	A04p25480.2_BraZ1	944.667	+	1575	3128	3129	0.9996804
A04	16655921	16656877	A04p25490.2_BraZ1	565.714	-	319	956	956	1.0000000
A04	16658912	16660253	A04p25500.2_BraZ1	1048.33	-	753	1341	1341	1.0000000
A04	16664434	16665366	A04p25510.2_BraZ1	860	+	90	245	932	0.2628755
A04	16669186	16670577	A04p25520.2_BraZ1	801.9	+	130	1167	1391	0.8389648
A04	16679078	16680744	A04p25530.2_BraZ1	672	-	542	1292	1666	0.7755102
A04	16688244	16689504	A04p25540.2_BraZ1	126	-	1137	1260	1260	1.0000000
A04	16691303	16691552	A04p25550.2_BraZ1	24.9	+	328	249	249	1.0000000
A04	16692482	16693530	A04p25560.2_BraZ1	22.8	-	29	647	1048	0.6173664
A04	16696485	16700668	A04p25570.2_BraZ1	1371	+	2053	3959	4183	0.9464499
A04	16701920	16703765	A04p25580.2_BraZ1	1839.6	+	500	1079	1845	0.5848238
A04	16705741	16707693	A04p25590.2_BraZ1	1647	+	1406	1807	1952	0.9257172
A04	16708451	16711023	A04p25600.2_BraZ1	1442.81	+	140	945	2572	0.3674183
A04	16717875	16720028	A04p25610.2_BraZ1	1371	+	1312	2153	2153	1.0000000
A04	16720467	16723976	A04p25620.2_BraZ1	1072.84	-	1182	2526	3509	0.7198632
A04	16725116	16729006	A04p25630.2_BraZ1	1135.91	+	2279	3686	3890	0.9475579
A04	16730159	16732897	A04p25640.2_BraZ1	265.8	+	3254	2738	2738	1.0000000
A04	16733383	16734535	A04p25650.2_BraZ1	363	+	617	1152	1152	1.0000000
A04	16742172	16744910	A04p25660.2_BraZ1	265.5	+	1043	2650	2738	0.9678597
A04	16745297	16746121	A04p25670.2_BraZ1	438	+	0	0	824	0.0000000
A04	16750028	16758086	A04p25680.2_BraZ1	4362	+	4847	7891	8058	0.9792752
A04	16760432	16768086	A04p25690.2_BraZ1	3114	+	2114	6459	7654	0.8438725
A04	16768293	16769424	A04p25700.2_BraZ1	1017	+	834	1131	1131	1.0000000
A04	16774404	16774608	A04p25710.2_BraZ1	20.4	+	82	204	204	1.0000000
A04	16775338	16778242	A04p25720.2_BraZ1	2068.85	+	1678	2822	2904	0.9717631
A04	16779041	16780331	A04p25730.2_BraZ1	1272	+	612	1290	1290	1.0000000
A04	16781053	16784231	A04p25740.2_BraZ1	2912.61	-	2328	3156	3178	0.9930774
A04	16786800	16789445	A04p25750.2_BraZ1	1251.1	-	942	2244	2645	0.8483932
A04	16789888	16793264	A04p25760.2_BraZ1	1615.46	-	3441	3287	3376	0.9736375
A04	16793347	16793542	A04p25770.2_BraZ1	19.5	-	257	195	195	1.0000000
A04	16795158	16796074	A04p25780.2_BraZ1	798	+	245	787	916	0.8591703
A04	16796851	16798768	A04p25790.2_BraZ1	191.7	+	352	1635	1917	0.8528951
A04	16810523	16812440	A04p25800.2_BraZ1	191.7	+	604	1702	1917	0.8878456
A04	16813005	16816340	A04p25810.2_BraZ1	2226	+	169	1207	3335	0.3619190
A04	16820291	16823632	A04p25820.2_BraZ1	2359.5	+	325	2076	3341	0.6213709
A04	16832396	16832905	A04p25830.2_BraZ1	429	-	8	110	509	0.2161100
A04	16834744	16836749	A04p25840.2_BraZ1	1069.71	-	864	1948	2005	0.9715711
A04	16837260	16838850	A04p25850.2_BraZ1	412.929	-	233	1177	1590	0.7402516
A04	16844941	16845523	A04p25860.2_BraZ1	189	-	0	0	582	0.0000000
A04	16851148	16853461	A04p25870.2_BraZ1	1581	+	315	1874	2313	0.8102032
A04	16859720	16865099	A04p25880.2_BraZ1	1203	+	1613	4984	5379	0.9265663
A04	16865825	16866907	A04p25890.2_BraZ1	63.3	+	703	1072	1082	0.9907579
A04	16867556	16868846	A04p25900.2_BraZ1	129	+	1218	1290	1290	1.0000000
A04	16869635	16870190	A04p25910.2_BraZ1	55.5	-	50	288	555	0.5189189
A04	16871033	16871422	A04p25920.2_BraZ1	588	+	44	371	389	0.9537275
A04	16872895	16873495	A04p25930.2_BraZ1	60	-	103	355	600	0.5916666
A04	16877961	16879140	A04p25940.2_BraZ1	117.9	+	417	1140	1179	0.9669211
A04	16880736	16881337	A04p25950.2_BraZ1	404.542	-	88	518	601	0.8618968
A04	16881441	16882738	A04p25960.2_BraZ1	561	+	891	1297	1297	1.0000000
A04	16887010	16891563	A04p25970.2_BraZ1	1356.21	+	2523	4468	4553	0.9813310
A04	16894286	16898450	A04p25980.2_BraZ1	266.6	+	2853	3624	4164	0.8703170
A04	16895312	16895635	A04p25990.2_BraZ1	30.9	-	1395	323	323	1.0000000
A04	16899287	16899455	A04p26000.2_BraZ1	16.8	+	6	3	168	0.0178571
A04	16900087	16900714	A04p26010.2_BraZ1	1372.5	-	4	149	627	0.2376395
A04	16903817	16905669	A04p26020.2_BraZ1	1003.28	+	12	627	1852	0.3385529
A04	16910537	16917223	A04p26030.2_BraZ1	1603	-	3609	4856	6686	0.7262937
A04	16919772	16920973	A04p26040.2_BraZ1	3315	-	133	966	1201	0.8043298
A04	16927983	16931967	A04p26050.2_BraZ1	2184	+	254	2149	3984	0.5394076
A04	16932462	16935794	A04p26060.2_BraZ1	1291.33	-	1485	3093	3332	0.9282713
A04	16937550	16938729	A04p26070.2_BraZ1	117.9	-	559	1097	1179	0.9304495
A04	16940016	16941186	A04p26080.2_BraZ1	117	-	463	876	1170	0.7487180
A04	16942796	16943990	A04p26090.2_BraZ1	119.4	-	697	1194	1194	1.0000000
A04	16946552	16947118	A04p26100.2_BraZ1	546	-	154	549	566	0.9699647
A04	16952869	16953231	A04p26110.2_BraZ1	318	-	439	362	362	1.0000000
A04	16962771	16963929	A04p26120.2_BraZ1	115.8	-	216	841	1158	0.7262521
A04	16965286	16965684	A04p26130.2_BraZ1	177	-	0	0	398	0.0000000
A04	16974749	16977391	A04p26140.2_BraZ1	1533	-	1211	2642	2642	1.0000000
A04	16977942	16978086	A04p26150.2_BraZ1	14.4	-	92	80	144	0.5555556
A04	16980887	16984331	A04p26160.2_BraZ1	2211.48	-	1235	3365	3444	0.9770616
A04	16986972	16988882	A04p26170.2_BraZ1	1188.86	-	296	1605	1910	0.8403141
A04	16991499	16992506	A04p26180.2_BraZ1	858.75	-	308	791	1007	0.7855015
A04	17007007	17009190	A04p26190.2_BraZ1	1137.23	+	1094	1499	2183	0.6866697
A04	17011142	17012216	A04p26200.2_BraZ1	107.4	-	239	948	1074	0.8826815
A04	17016449	17017624	A04p26210.2_BraZ1	783.609	-	198	841	1175	0.7157447
A04	17020596	17040194	A04p26220.2_BraZ1	1095.94	+	8012	14894	19598	0.7599755
A04	17043411	17045486	A04p26230.2_BraZ1	371.25	+	53	468	2075	0.2255422
A04	17045683	17045868	A04p26240.2_BraZ1	14.4	+	0	0	185	0.0000000
A04	17047895	17050517	A04p26250.2_BraZ1	262.2	+	662	2427	2622	0.9256293
A04	17052580	17052956	A04p26260.2_BraZ1	30.3	-	9	216	376	0.5744681
A04	17055016	17055482	A04p26270.2_BraZ1	393	-	172	466	466	1.0000000
A04	17059972	17063402	A04p26280.2_BraZ1	1497.39	-	2327	3430	3430	1.0000000
A04	17071146	17077511	A04p26290.2_BraZ1	423	+	3065	6018	6365	0.9454831
A04	17072731	17075047	A04p26300.2_BraZ1	231.6	+	425	2168	2316	0.9360967
A04	17075881	17076393	A04p26310.2_BraZ1	456	+	322	512	512	1.0000000
A04	17077630	17079859	A04p26320.2_BraZ1	222.9	-	742	2160	2229	0.9690444
A04	17084191	17085853	A04p26330.2_BraZ1	542.455	+	1125	1662	1662	1.0000000
A04	17086765	17089423	A04p26340.2_BraZ1	265.8	-	739	2570	2658	0.9668924
A04	17090198	17090988	A04p26350.2_BraZ1	426	+	669	790	790	1.0000000
A04	17092350	17095014	A04p26360.2_BraZ1	266.4	-	936	2364	2664	0.8873874
A04	17098355	17101091	A04p26370.2_BraZ1	265.5	-	1284	2447	2736	0.8943713
A04	17101945	17102698	A04p26380.2_BraZ1	75.3	+	21	274	753	0.3638778
A04	17105083	17105206	A04p26390.2_BraZ1	12.3	-	169	123	123	1.0000000
A04	17108512	17109570	A04p26400.2_BraZ1	184.167	+	0	0	1058	0.0000000
A04	17109698	17111794	A04p26410.2_BraZ1	670.5	+	0	0	2096	0.0000000
A04	17114806	17117590	A04p26420.2_BraZ1	1079.52	+	1628	2784	2784	1.0000000
A04	17119206	17120716	A04p26430.2_BraZ1	2049.3	+	801	1446	1510	0.9576159
A04	17122069	17123474	A04p26440.2_BraZ1	412.788	-	913	1405	1405	1.0000000
A04	17124507	17129101	A04p26450.2_BraZ1	2997.05	+	1422	4495	4594	0.9784502
A04	17130619	17135259	A04p26460.2_BraZ1	2590.89	+	2067	4554	4640	0.9814655
A04	17135952	17136627	A04p26470.2_BraZ1	293.25	+	24	491	675	0.7274074
A04	17137748	17139115	A04p26480.2_BraZ1	115.2	+	584	1146	1367	0.8383321
A04	17140004	17141394	A04p26490.2_BraZ1	1710.8	+	355	1069	1390	0.7690647
A04	17142018	17147345	A04p26500.2_BraZ1	2416.39	-	2103	4784	5327	0.8980665
A04	17149848	17153074	A04p26510.2_BraZ1	1601.67	+	1337	2981	3226	0.9240546
A04	17153834	17154065	A04p26520.2_BraZ1	23.1	-	365	231	231	1.0000000
A04	17155207	17157360	A04p26530.2_BraZ1	1086.5	-	654	1985	2153	0.9219694
A04	17166625	17166754	A04p26540.2_BraZ1	12.9	+	186	129	129	1.0000000
A04	17166893	17168203	A04p26550.2_BraZ1	698.795	+	946	1310	1310	1.0000000
A04	17179898	17182769	A04p26560.2_BraZ1	676.775	+	558	2532	2871	0.8819227
A04	17183222	17184515	A04p26570.2_BraZ1	882	-	1281	1293	1293	1.0000000
A04	17193521	17196445	A04p26580.2_BraZ1	1547.59	+	1198	2120	2924	0.7250342
A04	17217860	17218884	A04p26590.2_BraZ1	255	+	1294	1024	1024	1.0000000
A04	17222603	17223698	A04p26600.2_BraZ1	109.5	+	2219	1095	1095	1.0000000
A04	17226893	17234132	A04p26610.2_BraZ1	2250	-	2760	6130	7239	0.8468021
A04	17234819	17236377	A04p26620.2_BraZ1	426	-	375	1366	1558	0.8767651
A04	17238157	17241063	A04p26630.2_BraZ1	1325.51	-	1418	2720	2906	0.9359945
A04	17244508	17245959	A04p26640.2_BraZ1	1242	+	317	1067	1451	0.7353549
A04	17249975	17253781	A04p26650.2_BraZ1	3339	-	352	1995	3806	0.5241724
A04	17261544	17262167	A04p26660.2_BraZ1	501	+	35	332	623	0.5329053
A04	17263355	17263763	A04p26670.2_BraZ1	40.8	-	800	408	408	1.0000000
A04	17264431	17265541	A04p26680.2_BraZ1	111	+	66	338	1110	0.3045045
A04	17266096	17266504	A04p26690.2_BraZ1	40.8	-	90	386	408	0.9460784
A04	17269203	17269449	A04p26700.2_BraZ1	24.6	+	13	114	246	0.4634146
A04	17269767	17271011	A04p26710.2_BraZ1	375.375	-	401	1133	1244	0.9107717
A04	17272442	17276302	A04p26720.2_BraZ1	999.747	-	533	2724	3860	0.7056995
A04	17277957	17282679	A04p26730.2_BraZ1	1789.65	-	811	3954	4722	0.8373570
A04	17283045	17285439	A04p26740.2_BraZ1	1397.05	+	622	2357	2394	0.9845447
A04	17286301	17292384	A04p26750.2_BraZ1	841.87	+	546	2909	6083	0.4782180
A04	17290945	17291352	A04p26760.2_BraZ1	222	-	78	190	407	0.4668305
A04	17293872	17294563	A04p26770.2_BraZ1	315.333	+	32	249	691	0.3603473
A04	17295014	17296820	A04p26780.2_BraZ1	1611	+	218	1594	1806	0.8826135
A04	17302185	17304105	A04p26790.2_BraZ1	192	+	684	1783	1920	0.9286458
A04	17305336	17308057	A04p26800.2_BraZ1	2127.33	-	489	2462	2721	0.9048144
A04	17314300	17316646	A04p26810.2_BraZ1	234.3	+	1529	2346	2346	1.0000000
A04	17317203	17319039	A04p26820.2_BraZ1	183.6	-	152	1351	1836	0.7358388
A04	17319897	17323902	A04p26830.2_BraZ1	1487.7	-	1583	3706	4005	0.9253433
A04	17329304	17334178	A04p26840.2_BraZ1	3660	+	119	1714	4874	0.3516619
A04	17334810	17335150	A04p26850.2_BraZ1	234	-	214	340	340	1.0000000
A04	17342532	17345386	A04p26860.2_BraZ1	1080.37	+	21	573	2854	0.2007709
A04	17346346	17348123	A04p26870.2_BraZ1	692.571	-	491	1055	1777	0.5936972
A04	17349519	17350398	A04p26880.2_BraZ1	320.25	-	398	869	879	0.9886234
A04	17351318	17352265	A04p26890.2_BraZ1	627	+	142	778	947	0.8215417
A04	17356404	17357383	A04p26900.2_BraZ1	297	+	1099	894	979	0.9131767
A04	17357900	17358921	A04p26910.2_BraZ1	5940	-	1008	1021	1021	1.0000000
A04	17361163	17362361	A04p26920.2_BraZ1	1119	+	335	1198	1198	1.0000000
A04	17363187	17367122	A04p26930.2_BraZ1	3005.69	+	1159	3601	3935	0.9151207
A04	17368073	17369584	A04p26940.2_BraZ1	657.85	+	1566	1511	1511	1.0000000
A04	17370175	17371013	A04p26950.2_BraZ1	429	+	174	792	838	0.9451074
A04	17371187	17372012	A04p26960.2_BraZ1	429	-	360	780	825	0.9454545
A04	17372912	17374383	A04p26970.2_BraZ1	571.034	-	1069	1467	1471	0.9972808
A04	17384447	17385370	A04p26980.2_BraZ1	791.289	+	14	334	923	0.3618635
A04	17389657	17390581	A04p26990.2_BraZ1	92.4	+	704	924	924	1.0000000
A04	17393940	17397883	A04p27000.2_BraZ1	1767.13	+	1649	3554	3943	0.9013442
A04	17400977	17402206	A04p27010.2_BraZ1	5472	+	219	996	1229	0.8104150
A04	17405345	17406672	A04p27020.2_BraZ1	690	-	637	1304	1327	0.9826677
A04	17409357	17410415	A04p27030.2_BraZ1	234	-	395	1036	1058	0.9792060
A04	17410498	17412496	A04p27040.2_BraZ1	199.8	-	1232	1998	1998	1.0000000
A04	17413856	17414230	A04p27050.2_BraZ1	294	-	287	374	374	1.0000000
A04	17414581	17416135	A04p27060.2_BraZ1	918.443	+	664	1318	1554	0.8481339
A04	17417760	17422962	A04p27070.2_BraZ1	1614.26	+	2620	4953	5202	0.9521338
A04	17424430	17426953	A04p27080.2_BraZ1	1632	+	1326	2457	2523	0.9738407
A04	17427572	17430358	A04p27090.2_BraZ1	1486.44	+	884	2646	2786	0.9497488
A04	17440694	17443325	A04p27100.2_BraZ1	263.1	+	2244	2631	2631	1.0000000
A04	17444730	17444958	A04p27110.2_BraZ1	21.9	+	468	228	228	1.0000000
A04	17448375	17450812	A04p27120.2_BraZ1	825.646	+	1421	2392	2437	0.9815347
A04	17451870	17453448	A04p27130.2_BraZ1	6867	-	321	1202	1578	0.7617237
A04	17456805	17458932	A04p27140.2_BraZ1	212.7	-	222	1574	2127	0.7400094
A04	17461782	17463522	A04p27150.2_BraZ1	174	+	1005	1740	1740	1.0000000
A04	17463749	17466878	A04p27160.2_BraZ1	2502.48	-	1803	2837	3129	0.9066795
A04	17474371	17477330	A04p27170.2_BraZ1	1544.06	-	1252	2703	2959	0.9134843
A04	17490085	17490685	A04p27180.2_BraZ1	60	-	340	600	600	1.0000000
A04	17493202	17494461	A04p27190.2_BraZ1	7293	-	1642	1259	1259	1.0000000
A04	17499666	17501723	A04p27200.2_BraZ1	1059	+	1605	1980	2057	0.9625669
A04	17508266	17510675	A04p27210.2_BraZ1	601.383	+	2068	2409	2409	1.0000000
A04	17515013	17515528	A04p27220.2_BraZ1	426	+	171	515	515	1.0000000
A04	17515892	17517500	A04p27230.2_BraZ1	820.886	-	906	1568	1608	0.9751244
A04	17518681	17519380	A04p27240.2_BraZ1	549	+	880	699	699	1.0000000
A04	17520122	17520932	A04p27250.2_BraZ1	81	-	232	810	810	1.0000000
A04	17523527	17523971	A04p27260.2_BraZ1	44.4	-	39	440	444	0.9909910
A04	17524957	17527503	A04p27270.2_BraZ1	1655.32	-	504	2410	2546	0.9465829
A04	17533702	17534814	A04p27280.2_BraZ1	1785	-	739	1112	1112	1.0000000
A04	17535519	17536896	A04p27290.2_BraZ1	137.7	+	219	1377	1377	1.0000000
A04	17538044	17539153	A04p27300.2_BraZ1	731.077	-	162	517	1109	0.4661857
A04	17542770	17543232	A04p27310.2_BraZ1	46.2	+	24	196	462	0.4242424
A04	17545782	17549371	A04p27320.2_BraZ1	1230.06	-	3880	3589	3589	1.0000000
A04	17550924	17552035	A04p27330.2_BraZ1	738	-	657	1111	1111	1.0000000
A04	17553322	17556025	A04p27340.2_BraZ1	1076.25	-	1455	2406	2703	0.8901221
A04	17567019	17569618	A04p27350.2_BraZ1	1376.98	-	1073	2525	2599	0.9715275
A04	17573673	17574930	A04p27360.2_BraZ1	6747	-	511	1169	1257	0.9299920
A04	17577770	17579169	A04p27370.2_BraZ1	1168.5	+	443	1399	1399	1.0000000
A04	17580484	17580991	A04p27380.2_BraZ1	50.7	-	24	100	507	0.1972387
A04	17585038	17586432	A04p27390.2_BraZ1	45.6	-	603	1394	1394	1.0000000
A04	17587167	17588260	A04p27400.2_BraZ1	505.585	+	492	1043	1093	0.9542543
A04	17589472	17591011	A04p27410.2_BraZ1	153.9	-	248	1036	1539	0.6731644
A04	17597948	17598252	A04p27420.2_BraZ1	192	+	171	304	304	1.0000000
A04	17598591	17600410	A04p27430.2_BraZ1	16055.5	+	277	1496	1819	0.8224299
A04	17601820	17603806	A04p27440.2_BraZ1	198.6	+	708	1986	1986	1.0000000
A04	17604315	17608623	A04p27450.2_BraZ1	2071.22	-	1349	3890	4308	0.9029712
A04	17611535	17613772	A04p27460.2_BraZ1	931.222	+	1309	2222	2237	0.9932946
A04	17614526	17615578	A04p27470.2_BraZ1	7524	-	544	1052	1052	1.0000000
A04	17616513	17618301	A04p27480.2_BraZ1	330	+	630	1736	1788	0.9709172
A04	17618565	17620658	A04p27490.2_BraZ1	277.5	-	460	1888	2093	0.9020545
A04	17626549	17628672	A04p27500.2_BraZ1	7685	+	388	1501	2123	0.7070184
A04	17633707	17636135	A04p27510.2_BraZ1	10179	+	1140	2343	2428	0.9649917
A04	17636836	17638090	A04p27520.2_BraZ1	125.4	+	1028	1254	1254	1.0000000
A04	17638670	17644805	A04p27530.2_BraZ1	2693.31	+	3757	6113	6135	0.9964140
A04	17645431	17646235	A04p27540.2_BraZ1	80.4	-	60	804	804	1.0000000
A04	17646857	17647082	A04p27550.2_BraZ1	22.5	-	6	42	225	0.1866667
A04	17649315	17649861	A04p27560.2_BraZ1	54.6	+	183	539	546	0.9871795
A04	17650249	17651586	A04p27570.2_BraZ1	439.418	-	1737	1337	1337	1.0000000
A04	17651806	17652867	A04p27580.2_BraZ1	813.261	+	367	982	1061	0.9255419
A04	17653482	17659161	A04p27590.2_BraZ1	2655	+	1811	4351	5679	0.7661560
A04	17659539	17660911	A04p27600.2_BraZ1	642.563	-	758	1372	1372	1.0000000
A04	17661390	17662424	A04p27610.2_BraZ1	537.985	-	809	1034	1034	1.0000000
A04	17669949	17673504	A04p27620.2_BraZ1	1143	-	1970	3199	3555	0.8998594
A04	17673504	17674014	A04p27630.2_BraZ1	51	-	164	508	510	0.9960784
A04	17676230	17676635	A04p27640.2_BraZ1	40.5	-	288	401	405	0.9901235
A04	17678866	17679322	A04p27650.2_BraZ1	45.6	-	280	456	456	1.0000000
A04	17679871	17680997	A04p27660.2_BraZ1	811.952	-	325	797	1126	0.7078153
A04	17681172	17681826	A04p27670.2_BraZ1	456	-	418	654	654	1.0000000
A04	17682173	17683139	A04p27680.2_BraZ1	277.667	+	409	966	966	1.0000000
A04	17693652	17695521	A04p27690.2_BraZ1	3400	+	673	1660	1869	0.8881755
A04	17701753	17703068	A04p27700.2_BraZ1	578	+	106	973	1315	0.7399240
A04	17711172	17711430	A04p27710.2_BraZ1	25.8	-	42	168	258	0.6511628
A04	17714262	17714713	A04p27720.2_BraZ1	360	+	775	451	451	1.0000000
A04	17720983	17721829	A04p27730.2_BraZ1	84.6	+	608	846	846	1.0000000
A04	17727362	17728589	A04p27740.2_BraZ1	122.7	+	412	1227	1227	1.0000000
A04	17730014	17731617	A04p27750.2_BraZ1	1320	-	96	1177	1603	0.7342483
A04	17742827	17746916	A04p27760.2_BraZ1	2321	-	1319	3972	4089	0.9713867
A04	17759069	17760370	A04p27770.2_BraZ1	272	+	784	1090	1301	0.8378171
A04	17760737	17763973	A04p27780.2_BraZ1	1266.57	-	2105	3178	3236	0.9820766
A04	17766325	17770149	A04p27790.2_BraZ1	1039.5	+	1665	3546	3824	0.9273012
A04	17770498	17773453	A04p27800.2_BraZ1	1590	-	1711	2720	2955	0.9204738
A04	17778202	17780079	A04p27810.2_BraZ1	350	-	2270	1877	1877	1.0000000
A04	17781709	17782669	A04p27820.2_BraZ1	873	+	256	960	960	1.0000000
A04	17786225	17788844	A04p27830.2_BraZ1	1150.91	-	1902	2603	2619	0.9938908
A04	17791107	17791296	A04p27840.2_BraZ1	16.5	+	302	189	189	1.0000000
A04	17794869	17796690	A04p27850.2_BraZ1	844.395	+	601	1669	1821	0.9165294
A04	17797106	17798255	A04p27860.2_BraZ1	543.375	+	305	1139	1149	0.9912968
A04	17799130	17802615	A04p27870.2_BraZ1	2153.31	-	699	3041	3485	0.8725969
A04	17806330	17807179	A04p27880.2_BraZ1	84.9	+	202	738	849	0.8692579
A04	17807813	17815143	A04p27890.2_BraZ1	1763.64	-	5926	6880	7330	0.9386085
A04	17818750	17819008	A04p27900.2_BraZ1	25.8	+	187	258	258	1.0000000
A04	17823433	17826508	A04p27910.2_BraZ1	1737.83	+	1164	2324	3075	0.7557724
A04	17827002	17828715	A04p27920.2_BraZ1	171.3	-	134	1510	1713	0.8814945
A04	17829961	17919207	A04p27930.2_BraZ1	535.218	+	24690	69723	89246	0.7812451
A04	17838429	17843536	A04p27940.2_BraZ1	3450.51	+	699	3312	5107	0.6485217
A04	17843880	17845102	A04p27950.2_BraZ1	2730	-	546	1222	1222	1.0000000
A04	17912422	17912936	A04p27960.2_BraZ1	42.6	-	231	514	514	1.0000000
A04	17914174	17915791	A04p27970.2_BraZ1	774.449	+	643	1617	1617	1.0000000
A04	17920387	17920690	A04p27980.2_BraZ1	30.3	+	85	267	303	0.8811881
A04	17922686	17923721	A04p27990.2_BraZ1	103.5	+	171	858	1035	0.8289855
A04	17924464	17925525	A04p28000.2_BraZ1	661.25	-	160	737	1061	0.6946277
A04	17925848	17927818	A04p28010.2_BraZ1	666.667	-	451	1909	1970	0.9690355
A04	17932732	17934597	A04p28020.2_BraZ1	841.167	-	98	1132	1865	0.6069705
A04	17939750	17941688	A04p28030.2_BraZ1	914.667	-	253	1627	1938	0.8395253
A04	17943545	17943683	A04p28040.2_BraZ1	13.8	+	227	138	138	1.0000000
A04	17946676	17947669	A04p28050.2_BraZ1	429	+	578	925	993	0.9315206
A04	17951177	17952038	A04p28060.2_BraZ1	86.1	+	38	392	861	0.4552846
A04	17955923	17956292	A04p28070.2_BraZ1	36.9	-	95	356	369	0.9647697
A04	17957190	17959647	A04p28080.2_BraZ1	2190	-	661	2385	2457	0.9706960
A04	17963059	17964275	A04p28090.2_BraZ1	921	+	116	1082	1216	0.8898026
A04	17964416	17965427	A04p28100.2_BraZ1	101.1	-	398	634	1011	0.6271019
A04	17967110	17967716	A04p28110.2_BraZ1	627.545	-	282	606	606	1.0000000
A04	17969668	17971918	A04p28120.2_BraZ1	940.083	+	1842	2181	2250	0.9693334
A04	17972146	17974192	A04p28130.2_BraZ1	868.909	-	895	1730	2046	0.8455523
A04	17974252	17975639	A04p28140.2_BraZ1	168.3	-	839	1387	1387	1.0000000
A04	17975823	17977370	A04p28150.2_BraZ1	676.231	-	616	1515	1547	0.9793148
A04	17978700	17980143	A04p28160.2_BraZ1	144.3	+	619	1291	1443	0.8946639
A04	17981416	17983073	A04p28170.2_BraZ1	1259.73	+	9	350	1657	0.2112251
A04	17989178	17989615	A04p28180.2_BraZ1	354	-	6	121	437	0.2768879
A04	17992884	17993388	A04p28190.2_BraZ1	50.4	-	39	504	504	1.0000000
A04	17993867	17995489	A04p28200.2_BraZ1	4781.25	-	654	1514	1622	0.9334155
A04	17996880	17997024	A04p28210.2_BraZ1	14.4	+	0	0	144	0.0000000
A04	18001688	18002908	A04p28220.2_BraZ1	1131	-	593	858	1220	0.7032787
A04	18008006	18009079	A04p28230.2_BraZ1	483	+	559	990	1073	0.9226468
A04	18009247	18011372	A04p28240.2_BraZ1	1008	-	461	2015	2125	0.9482353
A04	18015077	18018393	A04p28250.2_BraZ1	1742.72	-	2761	3259	3316	0.9828106
A04	18022053	18022314	A04p28260.2_BraZ1	26.1	-	69	261	261	1.0000000
A04	18027074	18028412	A04p28270.2_BraZ1	133.8	+	182	1241	1338	0.9275038
A04	18028743	18031793	A04p28280.2_BraZ1	1569.13	-	676	2753	3050	0.9026229
A04	18033818	18039853	A04p28290.2_BraZ1	829.6	-	2844	4683	6035	0.7759735
A04	18043608	18044009	A04p28300.2_BraZ1	306	-	791	401	401	1.0000000
A04	18045798	18049094	A04p28310.2_BraZ1	535.108	+	1937	3287	3296	0.9972694
A04	18051940	18054722	A04p28320.2_BraZ1	1636.68	+	2028	2704	2782	0.9719626
A04	18055165	18056885	A04p28330.2_BraZ1	1154.03	+	617	1432	1720	0.8325582
A04	18057228	18058587	A04p28340.2_BraZ1	760.055	-	1262	1359	1359	1.0000000
A04	18067371	18068787	A04p28350.2_BraZ1	141.6	-	737	1416	1416	1.0000000
A04	18069024	18069609	A04p28360.2_BraZ1	58.5	+	68	208	585	0.3555556
A04	18079678	18082974	A04p28370.2_BraZ1	1423.3	-	534	2529	3296	0.7672937
A04	18085753	18088787	A04p28380.2_BraZ1	1545.82	+	626	2926	3034	0.9644035
A04	18089237	18090109	A04p28390.2_BraZ1	322.857	-	242	782	872	0.8967890
A04	18091949	18092120	A04p28400.2_BraZ1	17.1	-	154	171	171	1.0000000
A04	18092746	18095217	A04p28410.2_BraZ1	17023.5	-	443	2092	2471	0.8466208
A04	18098017	18098161	A04p28420.2_BraZ1	14.4	-	213	144	144	1.0000000
A04	18100708	18101441	A04p28430.2_BraZ1	558	+	219	733	733	1.0000000
A04	18102886	18103290	A04p28440.2_BraZ1	210	+	380	404	404	1.0000000
A04	18103606	18109165	A04p28450.2_BraZ1	1151.5	-	833	2728	5559	0.4907357
A04	18110565	18112660	A04p28460.2_BraZ1	1312	-	724	1880	2095	0.8973747
A04	18113515	18114573	A04p28470.2_BraZ1	747	+	874	1047	1058	0.9896030
A04	18116134	18119271	A04p28480.2_BraZ1	2250.06	+	1955	3137	3137	1.0000000
A04	18119687	18120883	A04p28490.2_BraZ1	654.214	+	1043	1196	1196	1.0000000
A04	18121229	18123389	A04p28500.2_BraZ1	1024.77	-	151	1125	2160	0.5208333
A04	18131820	18136485	A04p28510.2_BraZ1	933.538	-	427	1558	4665	0.3339764
A04	18139210	18141231	A04p28520.2_BraZ1	587.795	-	1078	2019	2021	0.9990104
A04	18143535	18145771	A04p28530.2_BraZ1	1188.43	+	1180	2112	2236	0.9445438
A04	18147171	18148501	A04p28540.2_BraZ1	48.3	-	912	1330	1330	1.0000000
A04	18153121	18153514	A04p28550.2_BraZ1	294	+	614	393	393	1.0000000
A04	18161411	18163626	A04p28560.2_BraZ1	1311	+	924	2041	2215	0.9214447
A04	18166744	18167878	A04p28570.2_BraZ1	113.4	+	1956	1134	1134	1.0000000
A04	18168154	18168414	A04p28580.2_BraZ1	16.8	-	6	219	260	0.8423077
A04	18171911	18173869	A04p28590.2_BraZ1	1685.6	-	2140	1950	1958	0.9959142
A04	18174715	18175521	A04p28600.2_BraZ1	594	-	388	806	806	1.0000000
A04	18179045	18181623	A04p28610.2_BraZ1	1521.43	+	264	1414	2578	0.5484872
A04	18184709	18185312	A04p28620.2_BraZ1	60.3	-	137	570	603	0.9452736
A04	18187454	18187678	A04p28630.2_BraZ1	126	-	0	0	224	0.0000000
A04	18191271	18191584	A04p28640.2_BraZ1	234	+	203	313	313	1.0000000
A04	18198080	18200693	A04p28650.2_BraZ1	79663.5	-	431	2356	2613	0.9016456
A04	18205421	18206660	A04p28660.2_BraZ1	123.9	-	195	1188	1239	0.9588377
A04	18210749	18213408	A04p28670.2_BraZ1	2028	-	440	2356	2659	0.8860474
A04	18217403	18218775	A04p28680.2_BraZ1	252	+	1258	1372	1372	1.0000000
A04	18227093	18227817	A04p28690.2_BraZ1	274	-	2	64	724	0.0883978
A04	18236264	18236894	A04p28700.2_BraZ1	62.7	+	146	373	630	0.5920635
A04	18241710	18243279	A04p28710.2_BraZ1	156.9	+	517	1434	1569	0.9139580
A04	18244791	18245887	A04p28720.2_BraZ1	996	-	742	1096	1096	1.0000000
A04	18256846	18257070	A04p28730.2_BraZ1	126	+	0	0	224	0.0000000
A04	18259247	18259945	A04p28740.2_BraZ1	399	-	8	340	698	0.4871060
A04	18259979	18260473	A04p28750.2_BraZ1	218.4	-	15	190	494	0.3846154
A04	18261674	18261962	A04p28760.2_BraZ1	28.8	+	262	288	288	1.0000000
A04	18262440	18263124	A04p28770.2_BraZ1	68.4	+	496	684	684	1.0000000
A04	18263826	18263943	A04p28780.2_BraZ1	11.7	-	259	117	117	1.0000000
A04	18265921	18267647	A04p28790.2_BraZ1	1451.43	-	127	1355	1726	0.7850521
A04	18274310	18276669	A04p28800.2_BraZ1	491.531	+	1420	2337	2359	0.9906740
A04	18277336	18278513	A04p28810.2_BraZ1	1008	+	123	754	1177	0.6406117
A04	18279544	18282891	A04p28820.2_BraZ1	1332.8	+	1940	3265	3347	0.9755005
A04	18283358	18285037	A04p28830.2_BraZ1	730.364	-	262	1527	1679	0.9094699
A04	18287085	18287646	A04p28840.2_BraZ1	56.1	+	96	258	561	0.4598930
A04	18304761	18305553	A04p28850.2_BraZ1	79.2	-	79	694	792	0.8762626
A04	18313752	18316710	A04p28860.2_BraZ1	7503	-	2035	2654	2958	0.8972279
A04	18332707	18333658	A04p28870.2_BraZ1	95.1	+	677	951	951	1.0000000
A04	18334208	18335072	A04p28880.2_BraZ1	546	-	1189	864	864	1.0000000
A04	18336159	18337120	A04p28890.2_BraZ1	609	-	263	950	961	0.9885536
A04	18337640	18338249	A04p28900.2_BraZ1	375.618	+	915	609	609	1.0000000
A04	18338262	18339759	A04p28910.2_BraZ1	372	+	2289	1497	1497	1.0000000
A04	18338401	18338728	A04p28920.2_BraZ1	32.7	+	732	327	327	1.0000000
A04	18340240	18344130	A04p28930.2_BraZ1	404.119	+	2477	3813	3890	0.9802057
A04	18345206	18348321	A04p28940.2_BraZ1	1484.52	-	1080	2438	3115	0.7826645
A04	18350681	18355744	A04p28950.2_BraZ1	2347.8	-	3231	4664	5063	0.9211929
A04	18356889	18357306	A04p28960.2_BraZ1	37.2	-	217	417	417	1.0000000
A04	18362631	18363003	A04p28970.2_BraZ1	37.2	-	4	15	372	0.0403226
A04	18367227	18367727	A04p28980.2_BraZ1	294	+	62	500	500	1.0000000
A04	18369221	18369377	A04p28990.2_BraZ1	14.4	-	0	0	156	0.0000000
A04	18371008	18371122	A04p29000.2_BraZ1	11.4	-	21	114	114	1.0000000
A04	18371213	18371981	A04p29010.2_BraZ1	76.8	+	47	563	768	0.7330729
A04	18373825	18373996	A04p29020.2_BraZ1	17.1	-	342	171	171	1.0000000
A04	18374891	18376636	A04p29030.2_BraZ1	1407.27	-	655	1724	1745	0.9879656
A04	18378177	18379664	A04p29040.2_BraZ1	6378.75	-	429	1487	1487	1.0000000
A04	18382505	18383354	A04p29050.2_BraZ1	432	+	688	849	849	1.0000000
A04	18383680	18384007	A04p29060.2_BraZ1	32.7	-	218	327	327	1.0000000
A04	18384992	18385275	A04p29070.2_BraZ1	21.6	-	139	266	283	0.9399293
A04	18397955	18399047	A04p29080.2_BraZ1	109.2	-	876	1092	1092	1.0000000
A04	18401668	18407907	A04p29090.2_BraZ1	1184.7	-	4266	6189	6239	0.9919859
A04	18409096	18413239	A04p29100.2_BraZ1	1820.5	-	2802	4143	4143	1.0000000
A04	18416383	18417625	A04p29110.2_BraZ1	116.7	-	678	1242	1242	1.0000000
A04	18421417	18428327	A04p29120.2_BraZ1	1974.61	-	4034	5119	6910	0.7408104
A04	18429012	18431182	A04p29130.2_BraZ1	1205.33	+	2385	2170	2170	1.0000000
A04	18431825	18436655	A04p29140.2_BraZ1	2416	+	1578	3598	4830	0.7449275
A04	18440684	18440867	A04p29150.2_BraZ1	18.3	-	39	165	183	0.9016393
A04	18449793	18465272	A04p29160.2_BraZ1	690	+	8986	14238	15479	0.9198269
A04	18465553	18467739	A04p29170.2_BraZ1	1115.43	-	1677	2186	2186	1.0000000
A04	18473102	18473953	A04p29180.2_BraZ1	487.385	+	376	799	851	0.9388954
A04	18476249	18477318	A04p29190.2_BraZ1	908	+	608	1069	1069	1.0000000
A04	18483935	18486458	A04p29200.2_BraZ1	1210.95	+	500	1903	2523	0.7542608
A04	18487613	18489232	A04p29210.2_BraZ1	1341	+	246	1040	1619	0.6423718
A04	18491323	18491560	A04p29220.2_BraZ1	23.7	+	223	237	237	1.0000000
A04	18491671	18491824	A04p29230.2_BraZ1	15.3	+	311	153	153	1.0000000
A04	18494221	18494767	A04p29240.2_BraZ1	54	-	308	546	546	1.0000000
A04	18497240	18498921	A04p29250.2_BraZ1	1044	-	1201	1681	1681	1.0000000
A04	18501421	18508678	A04p29260.2_BraZ1	2883.2	-	3151	6631	7257	0.9137385
A04	18511330	18512977	A04p29270.2_BraZ1	164.7	+	94	1154	1647	0.7006679
A04	18513774	18516692	A04p29280.2_BraZ1	980.23	-	710	2437	2918	0.8351611
A04	18518228	18519414	A04p29290.2_BraZ1	602.7	+	460	809	1186	0.6821248
A04	18521687	18527859	A04p29300.2_BraZ1	119.7	-	1329	4261	6172	0.6903759
A04	18538140	18540152	A04p29310.2_BraZ1	1238.62	+	537	1849	2012	0.9189861
A04	18543798	18549490	A04p29320.2_BraZ1	2690.75	-	1362	5222	5692	0.9174280
A04	18554552	18554780	A04p29330.2_BraZ1	22.8	-	118	228	228	1.0000000
A04	18557480	18558971	A04p29340.2_BraZ1	149.1	-	136	1069	1491	0.7169685
A04	18559519	18574049	A04p29350.2_BraZ1	4728.31	-	4277	11598	14530	0.7982106
A04	18580046	18581212	A04p29360.2_BraZ1	10584	+	541	878	1166	0.7530017
A04	18585691	18586457	A04p29370.2_BraZ1	311.5	-	271	766	766	1.0000000
A04	18585991	18586291	A04p29380.2_BraZ1	30	-	154	300	300	1.0000000
A04	18588182	18594235	A04p29390.2_BraZ1	1000.57	-	2918	5910	6053	0.9763753
A04	18594589	18596251	A04p29400.2_BraZ1	871.875	-	131	784	1662	0.4717208
A04	18598807	18600043	A04p29410.2_BraZ1	123.6	-	163	831	1236	0.6723301
A04	18610513	18612059	A04p29420.2_BraZ1	975.441	+	207	1267	1546	0.8195343
A04	18613766	18614867	A04p29430.2_BraZ1	572.062	-	276	1101	1101	1.0000000
A04	18615282	18615555	A04p29440.2_BraZ1	189	-	85	213	273	0.7802198
A04	18625223	18630907	A04p29450.2_BraZ1	3213.6	+	1465	4998	5684	0.8793104
A04	18635536	18637097	A04p29460.2_BraZ1	1150	+	372	1426	1561	0.9135170
A04	18642577	18644063	A04p29470.2_BraZ1	968.727	+	1015	1486	1486	1.0000000
A04	18644514	18644955	A04p29480.2_BraZ1	44.1	-	600	441	441	1.0000000
A04	18649667	18650574	A04p29490.2_BraZ1	249	-	239	734	907	0.8092613
A04	18651283	18654291	A04p29500.2_BraZ1	1116.59	-	1312	2878	3008	0.9567819
A04	18654954	18656705	A04p29510.2_BraZ1	5735	-	238	1504	1751	0.8589377
A04	18659904	18660365	A04p29520.2_BraZ1	35.7	+	80	416	461	0.9023861
A04	18669537	18672104	A04p29530.2_BraZ1	2169	-	262	1964	2567	0.7650954
A04	18678360	18679992	A04p29540.2_BraZ1	502.297	+	1804	1632	1632	1.0000000
A04	18681265	18683357	A04p29550.2_BraZ1	1145.45	+	1648	2066	2092	0.9875717
A04	18687411	18689221	A04p29560.2_BraZ1	708	+	398	1502	1810	0.8298343
A04	18690676	18692437	A04p29570.2_BraZ1	858.261	-	455	1488	1761	0.8449745
A04	18695697	18698239	A04p29580.2_BraZ1	1197.24	-	222	1720	2542	0.6766326
A04	18701438	18701939	A04p29590.2_BraZ1	50.1	-	60	375	501	0.7485030
A04	18702885	18707113	A04p29600.2_BraZ1	863.827	-	319	2323	4228	0.5494323
A04	18713396	18714565	A04p29610.2_BraZ1	96.6	-	560	1112	1169	0.9512404
A04	18715607	18716414	A04p29620.2_BraZ1	390	-	37	302	807	0.3742255
A04	18716741	18717994	A04p29630.2_BraZ1	786.632	+	147	1077	1253	0.8595371
A04	18723321	18724829	A04p29640.2_BraZ1	358.494	-	825	1289	1508	0.8547745
A04	18725869	18728711	A04p29650.2_BraZ1	135	+	933	2207	2842	0.7765658
A04	18728549	18736464	A04p29660.2_BraZ1	3429.82	+	2708	6861	7915	0.8668351
A04	18737199	18738128	A04p29670.2_BraZ1	456.462	-	1078	929	929	1.0000000
A04	18740062	18742015	A04p29680.2_BraZ1	195.3	-	964	1933	1953	0.9897593
A04	18742162	18743659	A04p29690.2_BraZ1	149.7	+	673	1497	1497	1.0000000
A04	18744546	18745586	A04p29700.2_BraZ1	822	+	252	975	1040	0.9375000
A04	18745846	18748075	A04p29710.2_BraZ1	222.9	-	110	1437	2229	0.6446837
A04	18751538	18756188	A04p29720.2_BraZ1	1530.69	+	763	3803	4650	0.8178495
A04	18758011	18759187	A04p29730.2_BraZ1	908.864	+	576	1176	1176	1.0000000
A04	18760006	18760987	A04p29740.2_BraZ1	98.1	-	731	969	981	0.9877676
A04	18761431	18767222	A04p29750.2_BraZ1	1133.33	+	2377	5490	5791	0.9480228
A04	18769142	18769685	A04p29760.2_BraZ1	54.3	+	35	317	543	0.5837938
A04	18779430	18779751	A04p29770.2_BraZ1	207	-	63	321	321	1.0000000
A04	18781793	18784557	A04p29780.2_BraZ1	1375.75	+	576	2497	2764	0.9034009
A04	18785798	18787910	A04p29790.2_BraZ1	945	-	1289	2112	2112	1.0000000
A04	18790248	18790650	A04p29800.2_BraZ1	40.2	-	309	402	402	1.0000000
A04	18798023	18800553	A04p29810.2_BraZ1	937.5	-	564	1843	2530	0.7284585
A04	18806153	18807842	A04p29820.2_BraZ1	811.2	-	611	1589	1689	0.9407934
A04	18809428	18810204	A04p29830.2_BraZ1	570	+	273	770	776	0.9922680
A04	18810489	18813049	A04p29840.2_BraZ1	1295.93	-	2033	2560	2560	1.0000000
A04	18814056	18818496	A04p29850.2_BraZ1	2182.21	-	2128	4007	4440	0.9024775
A04	18820092	18822738	A04p29860.2_BraZ1	665.467	-	574	2086	2646	0.7883598
A04	18824356	18826056	A04p29870.2_BraZ1	1152.5	-	1400	1700	1700	1.0000000
A04	18827489	18827801	A04p29880.2_BraZ1	31.2	-	228	312	312	1.0000000
A04	18830613	18831457	A04p29890.2_BraZ1	813	+	171	725	844	0.8590047
A04	18833414	18834605	A04p29900.2_BraZ1	119.1	+	14	82	1191	0.0688497
A04	18835318	18836703	A04p29910.2_BraZ1	611.625	-	1011	1385	1385	1.0000000
A04	18837446	18842045	A04p29920.2_BraZ1	1032	-	2877	4599	4599	1.0000000
A04	18844441	18844963	A04p29930.2_BraZ1	52.2	+	253	522	522	1.0000000
A04	18847693	18850199	A04p29940.2_BraZ1	1308	+	118	631	2506	0.2517957
A04	18851964	18853228	A04p29950.2_BraZ1	930	+	487	892	1264	0.7056962
A04	18859510	18869545	A04p29960.2_BraZ1	343.059	-	2747	8486	10035	0.8456402
A04	18862641	18864216	A04p29970.2_BraZ1	157.5	+	487	1575	1575	1.0000000
A04	18871140	18872495	A04p29980.2_BraZ1	799.8	+	186	485	1355	0.3579336
A04	18873304	18873830	A04p29990.2_BraZ1	321.75	-	0	0	526	0.0000000
A04	18875996	18877528	A04p30000.2_BraZ1	134453	+	501	1402	1532	0.9151436
A04	18880157	18880263	A04p30010.2_BraZ1	10.2	-	150	106	106	1.0000000
A04	18880343	18882223	A04p30020.2_BraZ1	966.429	-	1305	1880	1880	1.0000000
A04	18883199	18886516	A04p30030.2_BraZ1	2596.04	-	1022	3164	3317	0.9538740
A04	18887812	18891657	A04p30040.2_BraZ1	1032.88	-	2064	3806	3845	0.9898570
A04	18892212	18895645	A04p30050.2_BraZ1	1522.11	+	1700	3378	3433	0.9839790
A04	18895968	18901303	A04p30060.2_BraZ1	1623.83	-	2289	4257	5335	0.7979382
A04	18898790	18899183	A04p30070.2_BraZ1	39.3	-	0	0	393	0.0000000
A04	18909229	18919376	A04p30080.2_BraZ1	798.975	-	12188	9789	10147	0.9647186
A04	18933069	18933972	A04p30090.2_BraZ1	90.3	-	853	903	903	1.0000000
A04	18936831	18937345	A04p30100.2_BraZ1	351	+	495	514	514	1.0000000
A04	18939105	18939447	A04p30110.2_BraZ1	34.2	+	278	342	342	1.0000000
A04	18939632	18939892	A04p30120.2_BraZ1	183	+	318	260	260	1.0000000
A04	18940757	18941357	A04p30130.2_BraZ1	510	-	71	553	600	0.9216667
A04	18942163	18942511	A04p30140.2_BraZ1	34.8	+	199	348	348	1.0000000
A04	18944823	18945192	A04p30150.2_BraZ1	36.9	-	263	369	369	1.0000000
A04	18947778	18948467	A04p30160.2_BraZ1	1080	+	550	689	689	1.0000000
A04	18950755	18951508	A04p30170.2_BraZ1	75.3	+	75	650	753	0.8632138
A04	18954574	18954904	A04p30180.2_BraZ1	33	+	643	330	330	1.0000000
A04	18957146	18958561	A04p30190.2_BraZ1	17589	+	874	1240	1415	0.8763251
A04	18960830	18962743	A04p30200.2_BraZ1	822.921	+	1099	1913	1913	1.0000000
A04	18964077	18964463	A04p30210.2_BraZ1	30	+	144	329	386	0.8523316
A04	18969490	18972958	A04p30220.2_BraZ1	1716.07	-	1320	3223	3468	0.9293541
A04	18973716	18974981	A04p30230.2_BraZ1	1182	-	346	1026	1265	0.8110672
A04	18975050	18977688	A04p30240.2_BraZ1	1298.53	-	1056	2537	2638	0.9617134
A04	18979422	18980319	A04p30250.2_BraZ1	89.7	+	216	738	897	0.8227425
A04	18982175	18985093	A04p30260.2_BraZ1	1648.64	-	1304	2611	2918	0.8947909
A04	18990508	18992285	A04p30270.2_BraZ1	868.705	+	874	1721	1777	0.9684862
A04	18993122	18996347	A04p30280.2_BraZ1	2065.25	+	947	2951	3225	0.9150388
A04	18996738	18997612	A04p30290.2_BraZ1	786	-	116	454	874	0.5194508
A04	18998560	19001654	A04p30300.2_BraZ1	1286.65	-	917	2732	3094	0.8829994
A04	19005741	19007541	A04p30310.2_BraZ1	180	+	527	1645	1800	0.9138889
A04	19010746	19013736	A04p30320.2_BraZ1	1741.09	+	1183	2728	2990	0.9123746
A04	19020433	19026960	A04p30330.2_BraZ1	504.545	+	1693	4926	6527	0.7547112
A04	19042199	19044613	A04p30340.2_BraZ1	1506	-	875	1293	2414	0.5356255
A04	19052989	19053226	A04p30350.2_BraZ1	23.7	+	6	74	237	0.3122363
A04	19064850	19068476	A04p30360.2_BraZ1	1407.62	+	985	3083	3626	0.8502482
A04	19071604	19073545	A04p30370.2_BraZ1	970.337	-	1175	1697	1941	0.8742916
A04	19074549	19077965	A04p30380.2_BraZ1	1254.51	-	1262	3288	3416	0.9625293
A04	19083342	19086667	A04p30390.2_BraZ1	1003.83	+	2268	2962	3325	0.8908271
A04	19088128	19090164	A04p30400.2_BraZ1	1040.8	-	1608	2003	2036	0.9837918
A04	19095220	19099883	A04p30410.2_BraZ1	2450.68	-	2115	4646	4663	0.9963543
A04	19101051	19104010	A04p30420.2_BraZ1	1355.38	-	1240	2539	2959	0.8580602
A04	19106722	19107499	A04p30430.2_BraZ1	317.5	+	437	777	777	1.0000000
A04	19108206	19108581	A04p30440.2_BraZ1	37.5	-	76	358	375	0.9546667
A04	19108732	19110601	A04p30450.2_BraZ1	852	-	1134	1869	1869	1.0000000
A04	19116244	19116908	A04p30460.2_BraZ1	61.5	+	212	620	664	0.9337350
A04	19120431	19123025	A04p30470.2_BraZ1	1155.06	+	250	1695	2594	0.6534310
A04	19134869	19135356	A04p30480.2_BraZ1	384	+	467	487	487	1.0000000
A04	19136499	19138208	A04p30490.2_BraZ1	1554	-	1205	1604	1709	0.9385605
A04	19141857	19143697	A04p30500.2_BraZ1	1053	+	172	1389	1840	0.7548913
A04	19147943	19149542	A04p30510.2_BraZ1	1016.05	+	950	1511	1599	0.9449656
A04	19151548	19153732	A04p30520.2_BraZ1	1280	+	812	2127	2184	0.9739011
A04	19154272	19157266	A04p30530.2_BraZ1	1018.57	-	3134	2994	2994	1.0000000
A04	19158631	19160376	A04p30540.2_BraZ1	1103.06	+	951	1745	1745	1.0000000
A04	19160701	19161521	A04p30550.2_BraZ1	570	-	376	791	820	0.9646341
A04	19167792	19173762	A04p30560.2_BraZ1	1608	+	1119	4893	5970	0.8195980
A04	19182124	19182490	A04p30570.2_BraZ1	36.6	+	98	254	366	0.6939891
A04	19184755	19185115	A04p30580.2_BraZ1	36	+	60	347	360	0.9638889
A04	19188531	19188717	A04p30590.2_BraZ1	10.2	+	9	186	186	1.0000000
A04	19189575	19190469	A04p30600.2_BraZ1	292.5	-	341	808	894	0.9038031
A04	19190527	19191424	A04p30610.2_BraZ1	591	-	382	705	897	0.7859532
A04	19193728	19196425	A04p30620.2_BraZ1	1538.26	-	599	2194	2697	0.8134965
A04	19197167	19198548	A04p30630.2_BraZ1	1014.87	+	438	1357	1381	0.9826213
A04	19199834	19203631	A04p30640.2_BraZ1	844.437	+	734	3071	3797	0.8087964
A04	19204113	19205419	A04p30650.2_BraZ1	630.474	-	591	1277	1306	0.9777948
A04	19206824	19210005	A04p30660.2_BraZ1	1418.2	+	1796	3138	3181	0.9864823
A04	19210343	19211874	A04p30670.2_BraZ1	306.526	-	1344	1527	1531	0.9973873
A04	19212534	19214061	A04p30680.2_BraZ1	718.545	-	889	1336	1527	0.8749182
A04	19215132	19217464	A04p30690.2_BraZ1	927.982	-	866	2156	2332	0.9245283
A04	19220187	19221724	A04p30700.2_BraZ1	663.273	+	648	1514	1537	0.9850358
A04	19222614	19225043	A04p30710.2_BraZ1	1116.52	+	1874	2429	2429	1.0000000
A04	19225552	19232023	A04p30720.2_BraZ1	2334.15	-	1319	3780	6471	0.5841447
A04	19233870	19234844	A04p30730.2_BraZ1	903	+	9	312	974	0.3203285
A04	19236298	19238938	A04p30740.2_BraZ1	1192	+	125	2118	2640	0.8022727
A04	19240124	19243695	A04p30750.2_BraZ1	1530.47	+	475	3168	3571	0.8871465
A04	19244715	19245856	A04p30760.2_BraZ1	228	-	19	473	1141	0.4145486
A04	19246604	19246757	A04p30770.2_BraZ1	15.3	-	1	117	153	0.7647059
A04	19247131	19248137	A04p30780.2_BraZ1	240	-	51	701	1006	0.6968191
A04	19249817	19249985	A04p30790.2_BraZ1	16.8	-	30	167	168	0.9940476
A04	19250332	19250783	A04p30800.2_BraZ1	125.625	-	2	24	451	0.0532151
A04	19254319	19256109	A04p30810.2_BraZ1	808.065	-	137	896	1790	0.5005587
A04	19267801	19269406	A04p30820.2_BraZ1	160.5	+	115	1096	1605	0.6828660
A04	19270770	19271169	A04p30830.2_BraZ1	39.9	+	172	399	399	1.0000000
A04	19271748	19272846	A04p30840.2_BraZ1	3638.25	-	208	832	1098	0.7577413
A04	19277411	19278232	A04p30850.2_BraZ1	318	-	138	642	821	0.7819732
A04	19279270	19280534	A04p30860.2_BraZ1	681.353	+	590	1264	1264	1.0000000
A04	19281669	19283107	A04p30870.2_BraZ1	1306.32	+	158	1047	1438	0.7280946
A04	19283838	19285026	A04p30880.2_BraZ1	118.8	+	135	698	1188	0.5875421
A04	19285186	19288670	A04p30890.2_BraZ1	1360.88	-	1753	2680	3484	0.7692308
A04	19290966	19291257	A04p30900.2_BraZ1	29.1	+	34	274	291	0.9415808
A04	19291794	19292184	A04p30910.2_BraZ1	39	+	51	296	390	0.7589744
A04	19304759	19306482	A04p30920.2_BraZ1	737.673	+	528	1723	1723	1.0000000
A04	19308097	19311999	A04p30930.2_BraZ1	1652.19	-	410	2223	3902	0.5697079
A04	19325929	19326238	A04p30940.2_BraZ1	282	-	340	309	309	1.0000000
A04	19335168	19337342	A04p30950.2_BraZ1	1767	-	165	1025	2174	0.4714811
A04	19340233	19345633	A04p30960.2_BraZ1	1753.69	+	542	2551	5400	0.4724074
A04	19346154	19348141	A04p30970.2_BraZ1	1314.71	-	602	1625	1987	0.8178158
A04	19353874	19355201	A04p30980.2_BraZ1	1040	-	1297	1327	1327	1.0000000
A04	19357371	19360028	A04p30990.2_BraZ1	1252.78	-	1614	2657	2657	1.0000000
A04	19362490	19364619	A04p31000.2_BraZ1	1263.47	-	748	1995	2129	0.9370596
A04	19364690	19365272	A04p31010.2_BraZ1	20.6471	-	55	454	582	0.7800688
A04	19367447	19372245	A04p31020.2_BraZ1	2756.67	+	1932	4411	4798	0.9193414
A04	19374337	19375225	A04p31030.2_BraZ1	3990	-	128	427	888	0.4808559
A04	19381119	19382058	A04p31040.2_BraZ1	93.9	-	194	799	939	0.8509052
A04	19385100	19386987	A04p31050.2_BraZ1	188.7	-	388	1309	1887	0.6936937
A04	19388492	19389170	A04p31060.2_BraZ1	841.5	-	746	678	678	1.0000000
A04	19391629	19407159	A04p31070.2_BraZ1	1565.44	+	1192	8411	15530	0.5415969
A04	19412177	19414568	A04p31080.2_BraZ1	901.522	+	872	2391	2391	1.0000000
A04	19415642	19416572	A04p31090.2_BraZ1	93	+	84	741	930	0.7967742
A04	19417056	19418071	A04p31100.2_BraZ1	516	-	64	409	1015	0.4029557
A04	19420957	19422193	A04p31110.2_BraZ1	720.857	+	1477	1236	1236	1.0000000
A04	19428024	19430196	A04p31120.2_BraZ1	592.67	-	1724	2153	2172	0.9912523
A04	19431438	19432141	A04p31130.2_BraZ1	522	-	57	285	703	0.4054054
A04	19433363	19435036	A04p31140.2_BraZ1	718.182	-	680	1512	1673	0.9037657
A04	19435170	19436407	A04p31150.2_BraZ1	17664	+	781	1237	1237	1.0000000
A04	19442704	19443865	A04p31160.2_BraZ1	115.8	-	1224	1161	1161	1.0000000
A04	19444837	19446604	A04p31170.2_BraZ1	701.639	-	33	644	1767	0.3644595
A04	19450036	19452687	A04p31180.2_BraZ1	866.7	-	1675	1946	2651	0.7340626
A04	19454611	19455764	A04p31190.2_BraZ1	451.568	-	142	824	1153	0.7146574
A04	19459841	19460516	A04p31200.2_BraZ1	67.5	-	160	599	675	0.8874074
A04	19463015	19464809	A04p31210.2_BraZ1	1241.35	+	498	1740	1794	0.9698997
A04	19465929	19471795	A04p31220.2_BraZ1	3680.53	+	1350	4350	5866	0.7415615
A04	19474358	19477384	A04p31230.2_BraZ1	933.171	+	464	1841	3026	0.6083939
A04	19478550	19481027	A04p31240.2_BraZ1	1410.5	+	1531	2233	2477	0.9014937
A04	19482256	19483491	A04p31250.2_BraZ1	770.184	-	278	1103	1235	0.8931174
A04	19495459	19495732	A04p31260.2_BraZ1	27.3	+	26	88	273	0.3223443
A04	19501211	19502519	A04p31270.2_BraZ1	130.8	-	137	1098	1308	0.8394495
A04	19507791	19508055	A04p31280.2_BraZ1	26.4	+	230	264	264	1.0000000
A04	19508771	19511331	A04p31290.2_BraZ1	1241.61	-	522	1895	2560	0.7402344
A04	19514125	19516142	A04p31300.2_BraZ1	1465.29	+	2158	2017	2017	1.0000000
A04	19517022	19518946	A04p31310.2_BraZ1	3400	+	705	1849	1924	0.9610187
A04	19520121	19520534	A04p31320.2_BraZ1	249	+	1	20	413	0.0484262
A04	19522325	19522457	A04p31330.2_BraZ1	13.2	+	236	132	132	1.0000000
A04	19525546	19527803	A04p31340.2_BraZ1	14472	+	1137	2257	2257	1.0000000
A04	19528868	19532998	A04p31350.2_BraZ1	1937.36	-	2482	4043	4130	0.9789346
A04	19538459	19540483	A04p31360.2_BraZ1	790.883	-	967	1418	2024	0.7005929
A04	19540770	19545079	A04p31370.2_BraZ1	2585.37	+	4196	4283	4309	0.9939661
A04	19548508	19549399	A04p31380.2_BraZ1	999	+	371	891	891	1.0000000
A04	19557661	19574835	A04p31390.2_BraZ1	1957.53	+	5274	14555	17174	0.8475021
A04	19575360	19577524	A04p31400.2_BraZ1	1459.2	-	151	1879	2164	0.8682994
A04	19578645	19580954	A04p31410.2_BraZ1	1452	-	917	2239	2309	0.9696838
A04	19581812	19583005	A04p31420.2_BraZ1	3048	-	1404	1193	1193	1.0000000
A04	19582839	19583396	A04p31430.2_BraZ1	4160	-	491	557	557	1.0000000
A04	19584064	19586356	A04p31440.2_BraZ1	716.844	-	1897	2257	2292	0.9847295
A04	19587442	19588855	A04p31450.2_BraZ1	141.3	-	455	1413	1413	1.0000000
A04	19597745	19598353	A04p31460.2_BraZ1	204	-	143	501	608	0.8240132
A04	19602007	19603273	A04p31470.2_BraZ1	126.6	-	287	1082	1266	0.8546603
A04	19604496	19604610	A04p31480.2_BraZ1	11.4	+	68	114	114	1.0000000
A04	19608600	19609720	A04p31490.2_BraZ1	681.525	+	663	1120	1120	1.0000000
A04	19612648	19612993	A04p31500.2_BraZ1	34.5	-	150	316	345	0.9159420
A04	19614097	19615445	A04p31510.2_BraZ1	548.27	-	597	1337	1348	0.9918398
A04	19620206	19621777	A04p31520.2_BraZ1	612.75	+	139	1065	1571	0.6779122
A04	19624821	19626078	A04p31530.2_BraZ1	349.333	+	271	462	1257	0.3675418
A04	19627257	19627852	A04p31540.2_BraZ1	504	+	295	437	595	0.7344538
A04	19628756	19631302	A04p31550.2_BraZ1	1371.63	+	809	2229	2546	0.8754910
A04	19636225	19637418	A04p31560.2_BraZ1	1858.5	-	4	66	1193	0.0553227
A04	19644377	19644943	A04p31570.2_BraZ1	555	-	0	0	566	0.0000000
A04	19646721	19648341	A04p31580.2_BraZ1	673.247	-	1151	1620	1620	1.0000000
A04	19650022	19650805	A04p31590.2_BraZ1	78.3	+	251	761	783	0.9719030
A04	19651752	19653815	A04p31600.2_BraZ1	850.95	-	872	1811	2063	0.8778478
A04	19654913	19657318	A04p31610.2_BraZ1	1624.3	-	1289	2405	2405	1.0000000
A04	19658398	19659026	A04p31620.2_BraZ1	908.25	+	0	0	628	0.0000000
A04	19659024	19660560	A04p31630.2_BraZ1	2741.25	+	0	0	1536	0.0000000
A04	19664852	19665008	A04p31640.2_BraZ1	15.3	-	0	0	156	0.0000000
A04	19668622	19668778	A04p31650.2_BraZ1	15.3	-	28	156	156	1.0000000
A04	19668781	19669066	A04p31660.2_BraZ1	186	-	271	285	285	1.0000000
A04	19671474	19674951	A04p31670.2_BraZ1	932.25	+	1758	3407	3477	0.9798677
A04	19679860	19681299	A04p31680.2_BraZ1	762	+	722	1221	1439	0.8485059
A04	19681827	19682122	A04p31690.2_BraZ1	165	-	183	295	295	1.0000000
A04	19691161	19693833	A04p31700.2_BraZ1	1371	-	365	1677	2672	0.6276197
A04	19711320	19713290	A04p31710.2_BraZ1	6750	+	1305	1970	1970	1.0000000
A04	19714601	19716281	A04p31720.2_BraZ1	992.641	-	88	329	1680	0.1958333
A04	19719918	19720578	A04p31730.2_BraZ1	570	+	5	282	660	0.4272727
A04	19728335	19729183	A04p31740.2_BraZ1	936	+	381	848	848	1.0000000
A04	19729523	19732232	A04p31750.2_BraZ1	794.58	-	309	1400	2709	0.5167959
A04	19734110	19737761	A04p31760.2_BraZ1	1029.82	-	1420	3547	3651	0.9715146
A04	19742857	19747115	A04p31770.2_BraZ1	818	+	1109	3357	4258	0.7883983
A04	19747666	19753660	A04p31780.2_BraZ1	2069.94	-	1016	3908	5994	0.6519853
A04	19749186	19749516	A04p31790.2_BraZ1	246	+	93	257	330	0.7787879
A04	19765963	19766457	A04p31800.2_BraZ1	300	+	0	0	494	0.0000000
A04	19768514	19769529	A04p31810.2_BraZ1	534	-	0	0	1015	0.0000000
A04	19773417	19773983	A04p31820.2_BraZ1	273	-	31	456	566	0.8056537
A04	19777143	19777637	A04p31830.2_BraZ1	300	+	0	0	494	0.0000000
A04	19780205	19780772	A04p31840.2_BraZ1	273	-	96	501	567	0.8835979
A04	19782041	19783147	A04p31850.2_BraZ1	146.25	+	398	1008	1106	0.9113924
A04	19782898	19785650	A04p31860.2_BraZ1	411.25	+	1859	2599	2752	0.9444041
A04	19787808	19789717	A04p31870.2_BraZ1	1285.1	+	139	999	1909	0.5233107
A04	19790980	19792854	A04p31880.2_BraZ1	1256.35	+	408	1582	1874	0.8441836
A04	19796242	19796860	A04p31890.2_BraZ1	61.8	-	56	618	618	1.0000000
A04	19802477	19803943	A04p31900.2_BraZ1	808.8	-	1284	1466	1466	1.0000000
A04	19806113	19813166	A04p31910.2_BraZ1	1648.41	-	1654	6223	7053	0.8823196
A04	19817783	19817969	A04p31920.2_BraZ1	18.6	-	410	186	186	1.0000000
A04	19818387	19818546	A04p31930.2_BraZ1	15.9	-	99	159	159	1.0000000
A04	19818835	19818994	A04p31940.2_BraZ1	15.9	-	18	43	159	0.2704403
A04	19825103	19828926	A04p31950.2_BraZ1	2181.27	+	2798	3813	3823	0.9973843
A04	19829443	19831361	A04p31960.2_BraZ1	1752	-	3199	1918	1918	1.0000000
A04	19832191	19833115	A04p31970.2_BraZ1	92.4	-	856	924	924	1.0000000
A04	19833709	19834012	A04p31980.2_BraZ1	30.3	+	41	303	303	1.0000000
A04	19835292	19837344	A04p31990.2_BraZ1	1221.65	+	1116	1612	2052	0.7855750
A04	19837989	19840012	A04p32000.2_BraZ1	914.375	-	1735	2023	2023	1.0000000
A04	19844328	19845559	A04p32010.2_BraZ1	387.864	+	206	888	1231	0.7213647
A04	19847363	19849866	A04p32020.2_BraZ1	639	-	1798	2494	2503	0.9964043
A04	19850472	19851397	A04p32030.2_BraZ1	918.75	+	665	925	925	1.0000000
A04	19851757	19852861	A04p32040.2_BraZ1	474	-	862	1104	1104	1.0000000
A04	19853455	19853938	A04p32050.2_BraZ1	48.3	-	378	483	483	1.0000000
A04	19858406	19859145	A04p32060.2_BraZ1	225.6	+	882	739	739	1.0000000
A04	19866255	19870331	A04p32070.2_BraZ1	222	+	439	1624	4076	0.3984298
A04	19871465	19872335	A04p32080.2_BraZ1	783	+	6	22	870	0.0252874
A04	19873787	19874650	A04p32090.2_BraZ1	777	-	369	616	863	0.7137891
A04	19881280	19881599	A04p32100.2_BraZ1	153	-	130	317	319	0.9937304
A04	19882388	19885397	A04p32110.2_BraZ1	273	+	1933	3009	3009	1.0000000
A04	19888792	19893216	A04p32120.2_BraZ1	1749	+	2738	3792	4424	0.8571429
A04	19895224	19896440	A04p32130.2_BraZ1	714	-	1168	1216	1216	1.0000000
A04	19899497	19900061	A04p32140.2_BraZ1	56.4	-	344	564	564	1.0000000
A04	19902729	19904872	A04p32150.2_BraZ1	6412.5	+	2297	2143	2143	1.0000000
A04	19905884	19907597	A04p32160.2_BraZ1	1173	+	1552	1713	1713	1.0000000
A04	19911345	19913525	A04p32170.2_BraZ1	1410.51	+	263	1345	2180	0.6169725
A04	19916090	19916399	A04p32180.2_BraZ1	30.9	+	13	219	309	0.7087379
A04	19919819	19933910	A04p32190.2_BraZ1	2203.52	+	32552	12766	14091	0.9059684
A04	19934479	19935514	A04p32200.2_BraZ1	103.5	-	111	861	1035	0.8318841
A04	19937491	19940201	A04p32210.2_BraZ1	1426.27	+	1174	2682	2710	0.9896679
A04	19941263	19948994	A04p32220.2_BraZ1	1183.64	-	6320	7729	7731	0.9997413
A04	19951920	19954298	A04p32230.2_BraZ1	996.333	-	1754	2349	2378	0.9878049
A04	19957604	19959343	A04p32240.2_BraZ1	776.184	+	706	1739	1739	1.0000000
A04	19959955	19962102	A04p32250.2_BraZ1	936.862	-	964	2030	2147	0.9455054
A04	19963222	19965304	A04p32260.2_BraZ1	1363.08	+	1044	2080	2082	0.9990394
A04	19965840	19970819	A04p32270.2_BraZ1	2257.23	-	3437	4979	4979	1.0000000
A04	19972445	19974090	A04p32280.2_BraZ1	844.184	+	295	1292	1645	0.7854103
A04	19975969	19977490	A04p32290.2_BraZ1	970.432	-	18	678	1521	0.4457594
A04	19983323	19985772	A04p32300.2_BraZ1	1395	+	1706	2424	2449	0.9897918
A04	19986135	19986707	A04p32310.2_BraZ1	168	+	457	572	572	1.0000000
A04	19987217	19993428	A04p32320.2_BraZ1	4715.18	-	2499	5831	6211	0.9388182
A04	19994031	19995110	A04p32330.2_BraZ1	500.364	+	889	1063	1079	0.9851714
A04	19995629	19997963	A04p32340.2_BraZ1	1370.4	-	1166	2312	2334	0.9905741
A04	20007605	20008065	A04p32350.2_BraZ1	258	+	149	460	460	1.0000000
A04	20011751	20012234	A04p32360.2_BraZ1	1419	+	256	483	483	1.0000000
A04	20012470	20014541	A04p32370.2_BraZ1	591	-	1252	1396	2071	0.6740705
A04	20017263	20026717	A04p32380.2_BraZ1	258	+	2064	4615	9454	0.4881532
A04	20026926	20028127	A04p32390.2_BraZ1	366	-	856	801	1201	0.6669442
A04	20034468	20036262	A04p32400.2_BraZ1	1171.23	+	1472	1744	1794	0.9721293
A04	20036842	20039610	A04p32410.2_BraZ1	1279.57	-	1303	2411	2768	0.8710260
A04	20041949	20043425	A04p32420.2_BraZ1	147.6	+	171	1119	1476	0.7581301
A04	20044053	20044527	A04p32430.2_BraZ1	393	+	349	474	474	1.0000000
A04	20045007	20047352	A04p32440.2_BraZ1	1502.37	-	827	2288	2345	0.9756930
A04	20050487	20052563	A04p32450.2_BraZ1	1032.08	-	949	1756	2076	0.8458574
A04	20056584	20057679	A04p32460.2_BraZ1	109.5	-	289	1095	1095	1.0000000
A04	20058397	20058745	A04p32470.2_BraZ1	34.8	-	125	340	348	0.9770115
A04	20058988	20059560	A04p32480.2_BraZ1	225	-	83	503	572	0.8793706
A04	20060098	20065108	A04p32490.2_BraZ1	2368.42	-	1431	3673	5010	0.7331337
A04	20068312	20069225	A04p32500.2_BraZ1	66.6	+	536	881	913	0.9649507
A04	20069487	20071657	A04p32510.2_BraZ1	2171.05	-	2190	2170	2170	1.0000000
A04	20073540	20075372	A04p32520.2_BraZ1	712.303	-	1514	1832	1832	1.0000000
A04	20076694	20078233	A04p32530.2_BraZ1	531	+	1685	1539	1539	1.0000000
A04	20078797	20079487	A04p32540.2_BraZ1	69	-	501	690	690	1.0000000
A04	20082647	20087715	A04p32550.2_BraZ1	1866.07	+	2744	4979	5068	0.9824388
A04	20089803	20091132	A04p32560.2_BraZ1	132.9	+	245	1286	1329	0.9676449
A04	20093552	20094476	A04p32570.2_BraZ1	825	+	424	669	924	0.7240260
A04	20094674	20095767	A04p32580.2_BraZ1	768.136	-	496	1093	1093	1.0000000
A04	20096685	20098061	A04p32590.2_BraZ1	765	+	965	1376	1376	1.0000000
A04	20101719	20104291	A04p32600.2_BraZ1	748	+	1102	2482	2572	0.9650078
A04	20104574	20107198	A04p32610.2_BraZ1	1441.53	-	1113	2496	2624	0.9512195
A04	20111467	20121043	A04p32620.2_BraZ1	4431.05	+	4075	9375	9576	0.9790100
A04	20123218	20123398	A04p32630.2_BraZ1	18	-	8	78	180	0.4333333
A04	20128896	20129163	A04p32640.2_BraZ1	26.7	-	21	62	267	0.2322097
A04	20133482	20134299	A04p32650.2_BraZ1	717	-	114	739	817	0.9045287
A04	20135539	20137605	A04p32660.2_BraZ1	721.875	-	1751	2066	2066	1.0000000
A04	20141617	20141854	A04p32670.2_BraZ1	23.7	-	154	195	237	0.8227848
A04	20142323	20143068	A04p32680.2_BraZ1	633	+	385	616	745	0.8268456
A04	20145950	20147038	A04p32690.2_BraZ1	603.554	+	195	966	1088	0.8878676
A04	20149998	20152716	A04p32700.2_BraZ1	1121.4	+	3328	2718	2718	1.0000000
A04	20154009	20154207	A04p32710.2_BraZ1	19.2	+	242	198	198	1.0000000
A04	20155325	20156432	A04p32720.2_BraZ1	110.7	+	626	1107	1107	1.0000000
A04	20157392	20158709	A04p32730.2_BraZ1	652.522	+	671	1268	1317	0.9627942
A04	20158988	20159790	A04p32740.2_BraZ1	429	+	1068	802	802	1.0000000
A04	20163284	20165282	A04p32750.2_BraZ1	1464	-	801	1457	1998	0.7292292
A04	20179563	20179674	A04p32760.2_BraZ1	11.1	+	173	111	111	1.0000000
A04	20185659	20186091	A04p32770.2_BraZ1	43.2	+	55	320	432	0.7407407
A04	20188122	20189087	A04p32780.2_BraZ1	807	+	139	884	965	0.9160622
A04	20201183	20203802	A04p32790.2_BraZ1	9455	-	3109	2619	2619	1.0000000
A04	20204295	20204949	A04p32800.2_BraZ1	65.4	-	134	614	654	0.9388379
A04	20205514	20206524	A04p32810.2_BraZ1	3336	+	90	591	1010	0.5851485
A04	20209787	20210604	A04p32820.2_BraZ1	270	-	739	817	817	1.0000000
A04	20213489	20214189	A04p32830.2_BraZ1	627	+	354	700	700	1.0000000
A04	20215535	20218035	A04p32840.2_BraZ1	1360.92	+	858	2316	2500	0.9264000
A04	20218326	20221108	A04p32850.2_BraZ1	1109.9	+	1271	2604	2782	0.9360173
A04	20222276	20223374	A04p32860.2_BraZ1	539.455	-	39	528	1098	0.4808743
A04	20225002	20226618	A04p32870.2_BraZ1	893.8	-	389	1398	1616	0.8650990
A04	20228077	20230630	A04p32880.2_BraZ1	996.667	-	1193	2171	2553	0.8503721
A04	20239477	20242069	A04p32890.2_BraZ1	1330.27	+	996	2466	2592	0.9513889
A04	20242796	20244357	A04p32900.2_BraZ1	1184.04	-	2136	1561	1561	1.0000000
A04	20246443	20251541	A04p32910.2_BraZ1	2877.22	-	1844	4622	5098	0.9066300
A04	20253123	20254281	A04p32920.2_BraZ1	911.25	-	528	1158	1158	1.0000000
A04	20254689	20258995	A04p32930.2_BraZ1	2376.59	-	624	3539	4306	0.8218765
A04	20261391	20262633	A04p32940.2_BraZ1	39.9	-	1176	198	1242	0.1594203
A04	20264294	20265209	A04p32950.2_BraZ1	91.5	+	25	532	915	0.5814208
A04	20272493	20272929	A04p32960.2_BraZ1	360	+	231	436	436	1.0000000
A04	20274856	20279524	A04p32970.2_BraZ1	702.519	+	1229	4303	4668	0.9218081
A04	20280076	20280499	A04p32980.2_BraZ1	315	-	198	423	423	1.0000000
A04	20280593	20281407	A04p32990.2_BraZ1	415.579	-	509	785	814	0.9643735
A04	20282499	20284092	A04p33000.2_BraZ1	1184.21	-	983	1593	1593	1.0000000
A04	20289486	20292388	A04p33010.2_BraZ1	2670	+	1308	2888	2902	0.9951757
A04	20292831	20298573	A04p33020.2_BraZ1	2877.39	-	3437	5711	5742	0.9946012
A04	20299864	20301157	A04p33030.2_BraZ1	762	-	617	1293	1293	1.0000000
A04	20301743	20303361	A04p33040.2_BraZ1	17589	-	308	1387	1618	0.8572311
A04	20304013	20306174	A04p33050.2_BraZ1	1225.71	-	308	1983	2161	0.9176307
A04	20311250	20312850	A04p33060.2_BraZ1	1035.94	+	384	1382	1600	0.8637500
A04	20313330	20315625	A04p33070.2_BraZ1	1308	-	390	1608	2295	0.7006536
A04	20317300	20319120	A04p33080.2_BraZ1	1509	-	285	1145	1820	0.6291209
A04	20326930	20329267	A04p33090.2_BraZ1	1554	+	1772	2337	2337	1.0000000
A04	20332690	20334973	A04p33100.2_BraZ1	228.3	-	1376	2190	2283	0.9592641
A04	20339734	20342687	A04p33110.2_BraZ1	117	+	3317	2953	2953	1.0000000
A04	20343435	20345592	A04p33120.2_BraZ1	215.7	+	362	2018	2157	0.9355586
A04	20348330	20348516	A04p33130.2_BraZ1	18.6	+	0	0	186	0.0000000
A04	20349165	20350269	A04p33140.2_BraZ1	110.4	+	121	805	1104	0.7291667
A04	20354180	20354945	A04p33150.2_BraZ1	76.5	+	77	334	765	0.4366013
A04	20357826	20358959	A04p33160.2_BraZ1	463.2	-	234	1124	1133	0.9920565
A04	20359418	20361351	A04p33170.2_BraZ1	1071.64	-	667	1913	1933	0.9896534
A04	20362296	20363636	A04p33180.2_BraZ1	688.5	-	464	1340	1340	1.0000000
A04	20366368	20367968	A04p33190.2_BraZ1	780	+	1502	1600	1600	1.0000000
A04	20368247	20373312	A04p33200.2_BraZ1	1344.15	-	1615	4404	5065	0.8694965
A04	20375158	20377840	A04p33210.2_BraZ1	439.544	+	418	2257	2682	0.8415362
A04	20377789	20378244	A04p33220.2_BraZ1	134.647	+	73	455	455	1.0000000
A04	20378836	20381295	A04p33230.2_BraZ1	1084.6	-	1698	2432	2459	0.9890199
A04	20382352	20385527	A04p33240.2_BraZ1	1546.07	+	2194	3175	3175	1.0000000
A04	20386119	20386822	A04p33250.2_BraZ1	480	+	967	703	703	1.0000000
A04	20391769	20393868	A04p33260.2_BraZ1	1086	+	180	1782	2099	0.8489757
A04	20395251	20395814	A04p33270.2_BraZ1	486	+	159	563	563	1.0000000
A04	20396291	20397412	A04p33280.2_BraZ1	574.971	+	802	1096	1121	0.9776985
A04	20397859	20399787	A04p33290.2_BraZ1	8755	-	92	1256	1928	0.6514523
A04	20402203	20403806	A04p33300.2_BraZ1	253.2	+	1342	1559	1603	0.9725515
A04	20405219	20405562	A04p33310.2_BraZ1	177	-	238	343	343	1.0000000
A04	20407469	20410114	A04p33320.2_BraZ1	955.957	-	1246	2010	2645	0.7599244
A04	20413051	20415611	A04p33330.2_BraZ1	1929	-	1952	2560	2560	1.0000000
A04	20418246	20419738	A04p33340.2_BraZ1	597	+	942	1365	1492	0.9148794
A04	20422097	20424258	A04p33350.2_BraZ1	1565.7	+	486	1927	2161	0.8917168
A04	20424462	20424915	A04p33360.2_BraZ1	45.3	-	230	343	453	0.7571744
A04	20425746	20426325	A04p33370.2_BraZ1	57.9	+	673	579	579	1.0000000
A04	20427490	20428183	A04p33380.2_BraZ1	69.3	+	533	693	693	1.0000000
A04	20428693	20430496	A04p33390.2_BraZ1	1433.91	-	1102	1800	1803	0.9983361
A04	20432415	20433144	A04p33400.2_BraZ1	72.9	+	442	707	729	0.9698217
A04	20437835	20439250	A04p33410.2_BraZ1	6298.5	+	686	1347	1415	0.9519435
A04	20443234	20443975	A04p33420.2_BraZ1	3400	-	151	534	741	0.7206478
A04	20449179	20454896	A04p33430.2_BraZ1	867	-	1118	3626	5717	0.6342487
A04	20455294	20456373	A04p33440.2_BraZ1	819	+	58	719	1079	0.6663578
A04	20456833	20462116	A04p33450.2_BraZ1	988.167	-	2981	5079	5283	0.9613855
A04	20463086	20466801	A04p33460.2_BraZ1	372.677	-	1197	3493	3715	0.9402423
A04	20469071	20471913	A04p33470.2_BraZ1	847.8	-	1937	2832	2842	0.9964814
A04	20474137	20476550	A04p33480.2_BraZ1	1751.57	+	874	2355	2413	0.9759635
A04	20477124	20479548	A04p33490.2_BraZ1	9256.5	-	474	2333	2424	0.9624587
A04	20480155	20482513	A04p33500.2_BraZ1	1070.78	-	714	2158	2358	0.9151824
A04	20486981	20492175	A04p33510.2_BraZ1	2373.9	-	2109	4805	5194	0.9251059
A04	20501488	20502019	A04p33520.2_BraZ1	53.1	+	90	347	531	0.6534840
A04	20510315	20512732	A04p33530.2_BraZ1	2064	+	954	2250	2417	0.9309061
A04	20513104	20517777	A04p33540.2_BraZ1	1738.47	-	1647	3677	4673	0.7868607
A04	20518379	20519893	A04p33550.2_BraZ1	1242	-	575	1490	1514	0.9841480
A04	20520907	20521962	A04p33560.2_BraZ1	291.6	+	1145	1055	1055	1.0000000
A04	20522170	20522905	A04p33570.2_BraZ1	73.5	-	222	521	735	0.7088435
A04	20525230	20525771	A04p33580.2_BraZ1	50.1	-	100	450	541	0.8317930
A04	20526218	20527771	A04p33590.2_BraZ1	710.182	-	601	1432	1553	0.9220863
A04	20528285	20533213	A04p33600.2_BraZ1	1250.32	-	1973	4297	4928	0.8719562
A04	20534941	20535987	A04p33610.2_BraZ1	844.364	-	36	252	1046	0.2409178
A04	20538220	20538520	A04p33620.2_BraZ1	30	+	95	243	300	0.8100000
A04	20539289	20539622	A04p33630.2_BraZ1	243	-	133	256	333	0.7687688
A04	20544528	20544912	A04p33640.2_BraZ1	38.4	-	6	107	384	0.2786458
A04	20559673	20560418	A04p33650.2_BraZ1	285	-	18	375	745	0.5033557
A04	20562196	20562982	A04p33660.2_BraZ1	78.6	-	106	681	786	0.8664122
A04	20788353	20788491	A04p33670.2_BraZ1	13.8	-	153	138	138	1.0000000
A04	20788697	20790773	A04p33680.2_BraZ1	1285.14	+	955	2076	2076	1.0000000
A04	20790940	20791452	A04p33690.2_BraZ1	489	+	505	512	512	1.0000000
A04	20792343	20793535	A04p33700.2_BraZ1	533	+	988	1192	1192	1.0000000
A04	20794202	20795817	A04p33710.2_BraZ1	401.667	-	473	1510	1615	0.9349845
A04	20805106	20806973	A04p33720.2_BraZ1	1139.6	+	919	1867	1867	1.0000000
A04	20810009	20813520	A04p33730.2_BraZ1	1462.21	+	1890	3472	3511	0.9888921
A04	20815037	20815373	A04p33740.2_BraZ1	33.6	-	266	336	336	1.0000000
A04	20820847	20822954	A04p33750.2_BraZ1	1551	+	671	1838	2107	0.8723303
A04	20828081	20828558	A04p33760.2_BraZ1	47.7	+	1158	477	477	1.0000000
A04	20833215	20835731	A04p33770.2_BraZ1	804.079	-	1726	2504	2516	0.9952305
A04	20837307	20839779	A04p33780.2_BraZ1	792.508	+	276	970	2472	0.3923948
A04	20840263	20840615	A04p33790.2_BraZ1	309	-	226	352	352	1.0000000
A04	20841150	20841709	A04p33800.2_BraZ1	79.3269	+	115	559	559	1.0000000
A04	20842686	20848248	A04p33810.2_BraZ1	780.879	+	826	3843	5562	0.6909385
A04	20856467	20856938	A04p33820.2_BraZ1	246	+	0	0	471	0.0000000
A04	20857427	20864148	A04p33830.2_BraZ1	873.167	-	393	2249	6721	0.3346228
A04	20866306	20874425	A04p33840.2_BraZ1	888.8	-	2933	6291	8119	0.7748491
A04	20888600	20892385	A04p33850.2_BraZ1	1693.8	+	16904	3451	3785	0.9117569
A04	20894894	20902838	A04p33860.2_BraZ1	3519.2	+	3025	7672	7944	0.9657604
A04	20903785	20906054	A04p33870.2_BraZ1	1233	+	347	2090	2269	0.9211106
A04	20907010	20909909	A04p33880.2_BraZ1	1139.18	-	1788	2882	2899	0.9941359
A04	20911963	20913817	A04p33890.2_BraZ1	185.4	+	789	1816	1854	0.9795038
A04	20914749	20915123	A04p33900.2_BraZ1	291	-	414	374	374	1.0000000
A04	20917980	20918325	A04p33910.2_BraZ1	258	-	130	345	345	1.0000000
A04	20920189	20921274	A04p33920.2_BraZ1	411	+	416	962	1085	0.8866360
A04	20921649	20921998	A04p33930.2_BraZ1	264	-	9	230	349	0.6590258
A04	20924975	20932844	A04p33940.2_BraZ1	276	-	7397	7819	7869	0.9936460
A04	20927834	20930493	A04p33950.2_BraZ1	5626.5	+	2949	2644	2659	0.9943588
A04	20932489	20936431	A04p33960.2_BraZ1	546.429	+	2399	3894	3942	0.9878234
A04	20936785	20937146	A04p33970.2_BraZ1	273	-	449	361	361	1.0000000
A04	20939306	20939960	A04p33980.2_BraZ1	63.3	-	394	654	654	1.0000000
A04	20948230	20948884	A04p33990.2_BraZ1	65.4	-	0	0	654	0.0000000
A04	20949399	20949789	A04p34000.2_BraZ1	39	+	86	337	390	0.8641025
A04	20950367	20952147	A04p34010.2_BraZ1	1056	-	942	1763	1780	0.9904494
A04	20953983	20956326	A04p34020.2_BraZ1	1322.49	+	783	2295	2343	0.9795135
A04	20960316	20960924	A04p34030.2_BraZ1	522	+	235	608	608	1.0000000
A04	21023650	21023995	A04p34040.2_BraZ1	34.2	-	209	307	345	0.8898551
A04	21024793	21027058	A04p34050.2_BraZ1	1093.71	-	81	1445	2265	0.6379691
A04	21030505	21032700	A04p34060.2_BraZ1	898.429	-	1791	2195	2195	1.0000000
A04	21034669	21034911	A04p34070.2_BraZ1	13.8	+	10	11	242	0.0454545
A04	21034965	21035454	A04p34080.2_BraZ1	342	-	137	489	489	1.0000000
A04	21037979	21039787	A04p34090.2_BraZ1	954.286	+	212	1311	1808	0.7251106
A04	21040383	21043531	A04p34100.2_BraZ1	1837.35	-	548	2911	3148	0.9247141
A04	21049191	21052505	A04p34110.2_BraZ1	1800	+	640	3182	3314	0.9601690
A04	21055244	21055673	A04p34120.2_BraZ1	291	+	112	376	429	0.8764569
A04	21056657	21057089	A04p34130.2_BraZ1	294	+	353	432	432	1.0000000
A04	21057549	21058398	A04p34140.2_BraZ1	84.9	+	683	849	849	1.0000000
A04	21059493	21059946	A04p34150.2_BraZ1	291	+	506	453	453	1.0000000
A04	21064175	21064636	A04p34160.2_BraZ1	303	+	521	461	461	1.0000000
A04	21065661	21066118	A04p34170.2_BraZ1	306	+	390	457	457	1.0000000
A04	21066458	21066966	A04p34180.2_BraZ1	49.5	+	121	449	508	0.8838583
A04	21068503	21068847	A04p34190.2_BraZ1	270	+	106	253	344	0.7354651
A04	21070007	21071444	A04p34200.2_BraZ1	550.731	-	340	1367	1437	0.9512874
A04	21074758	21079116	A04p34210.2_BraZ1	1605.39	+	4115	4358	4358	1.0000000
A04	21081552	21082807	A04p34220.2_BraZ1	7047	-	1593	1255	1255	1.0000000
A04	21083630	21084851	A04p34230.2_BraZ1	846	-	222	739	1221	0.6052416
A04	21088734	21090252	A04p34240.2_BraZ1	789	+	376	1518	1518	1.0000000
A04	21090427	21091153	A04p34250.2_BraZ1	433.125	-	652	726	726	1.0000000
A04	21091936	21093162	A04p34260.2_BraZ1	683.1	+	512	1188	1226	0.9690049
A04	21095974	21098858	A04p34270.2_BraZ1	456.5	+	2638	2884	2884	1.0000000
A04	21099976	21100592	A04p34280.2_BraZ1	253.8	+	116	589	616	0.9561688
A04	21102630	21103220	A04p34290.2_BraZ1	265.2	+	413	565	590	0.9576271
A04	21103851	21105213	A04p34300.2_BraZ1	15225	+	268	1145	1362	0.8406755
A04	21107380	21108134	A04p34310.2_BraZ1	507.3	-	708	754	754	1.0000000
A04	21110315	21112085	A04p34320.2_BraZ1	1520.87	+	1410	1770	1770	1.0000000
A04	21112655	21114638	A04p34330.2_BraZ1	198.3	+	893	1978	1983	0.9974785
A04	21120482	21127264	A04p34340.2_BraZ1	279	+	2578	5698	6782	0.8401651
A04	21124866	21126622	A04p34350.2_BraZ1	901.333	-	630	1549	1756	0.8821185
A04	21127614	21128085	A04p34360.2_BraZ1	327	+	42	421	471	0.8938429
A04	21128832	21129591	A04p34370.2_BraZ1	585	-	585	756	759	0.9960474
A04	21130488	21133972	A04p34380.2_BraZ1	1081.47	-	1961	3465	3484	0.9945465
A04	21134039	21134364	A04p34390.2_BraZ1	123	+	250	325	325	1.0000000
A04	21134488	21135076	A04p34400.2_BraZ1	58.8	+	148	554	588	0.9421769
A04	21135793	21137278	A04p34410.2_BraZ1	1143.65	-	64	587	1485	0.3952862
A04	21138718	21140197	A04p34420.2_BraZ1	1107.91	-	153	1032	1479	0.6977687
A04	21142498	21144243	A04p34430.2_BraZ1	1028.07	-	483	1512	1745	0.8664756
A04	21149165	21150630	A04p34440.2_BraZ1	1121.38	+	426	1123	1465	0.7665529
A04	21152941	21154411	A04p34450.2_BraZ1	530.538	+	170	838	1470	0.5700680
A04	21155683	21157250	A04p34460.2_BraZ1	619.1	-	74	1064	1567	0.6790045
A04	21159086	21160406	A04p34470.2_BraZ1	670.041	-	1065	1320	1320	1.0000000
A04	21160859	21162793	A04p34480.2_BraZ1	996.313	-	1035	1934	1934	1.0000000
A04	21165573	21166138	A04p34490.2_BraZ1	46.7308	-	791	565	565	1.0000000
A04	21167768	21169248	A04p34500.2_BraZ1	916.865	-	833	1480	1480	1.0000000
A04	21169889	21175140	A04p34510.2_BraZ1	1221.21	+	3488	5202	5251	0.9906684
A04	21177747	21178083	A04p34520.2_BraZ1	33.6	-	15	150	336	0.4464286
A04	21181557	21181959	A04p34530.2_BraZ1	40.2	+	38	245	402	0.6094527
A04	21182764	21186339	A04p34540.2_BraZ1	1937.49	-	1443	3398	3575	0.9504895
A04	21187452	21188962	A04p34550.2_BraZ1	607.807	-	605	1510	1510	1.0000000
A04	21189876	21192795	A04p34560.2_BraZ1	1660.29	+	460	2478	2919	0.8489209
A04	21193024	21194172	A04p34570.2_BraZ1	825.6	-	353	1148	1148	1.0000000
A04	21195258	21205683	A04p34580.2_BraZ1	1984.5	+	2104	8527	10425	0.8179377
A04	21206166	21208891	A04p34590.2_BraZ1	1139.48	-	1429	2436	2725	0.8939450
A04	21213553	21214111	A04p34600.2_BraZ1	55.8	+	7	252	558	0.4516129
A04	21216066	21219971	A04p34610.2_BraZ1	1314.67	+	2990	3905	3905	1.0000000
A04	21220365	21220902	A04p34620.2_BraZ1	399	-	373	537	537	1.0000000
A04	21221602	21222337	A04p34630.2_BraZ1	73.5	-	215	735	735	1.0000000
A04	21223381	21224123	A04p34640.2_BraZ1	38.4	-	463	721	742	0.9716981
A04	21224997	21225756	A04p34650.2_BraZ1	75.9	-	108	472	759	0.6218709
A04	21226406	21227677	A04p34660.2_BraZ1	122.4	+	428	848	1271	0.6671912
A04	21230297	21233714	A04p34670.2_BraZ1	1327.19	+	1474	2939	3417	0.8601112
A04	21235274	21238336	A04p34680.2_BraZ1	30.8077	+	348	1045	3062	0.3412802
A04	21241502	21265968	A04p34690.2_BraZ1	2656.45	+	12360	21281	24466	0.8698193
A04	21244981	21245785	A04p34700.2_BraZ1	80.4	+	132	804	804	1.0000000
A04	21248703	21249426	A04p34710.2_BraZ1	336	+	615	723	723	1.0000000
A04	21267105	21269350	A04p34720.2_BraZ1	1060.63	+	615	2129	2245	0.9483296
A04	21272445	21272856	A04p34730.2_BraZ1	41.1	-	502	411	411	1.0000000
A04	21274810	21278230	A04p34740.2_BraZ1	1772.59	-	1152	2798	3420	0.8181286
A04	21284254	21284995	A04p34750.2_BraZ1	74.1	+	254	741	741	1.0000000
A04	21286138	21287987	A04p34760.2_BraZ1	651	-	1230	1804	1849	0.9756625
A04	21288580	21289490	A04p34770.2_BraZ1	333.531	-	792	910	910	1.0000000
A04	21293352	21293733	A04p34780.2_BraZ1	285	+	307	381	381	1.0000000
A04	21295629	21296486	A04p34790.2_BraZ1	606	-	171	842	857	0.9824971
A04	21299985	21301530	A04p34800.2_BraZ1	600	-	539	1057	1545	0.6841424
A04	21306036	21306498	A04p34810.2_BraZ1	46.2	+	115	412	462	0.8917749
A04	21309912	21312068	A04p34820.2_BraZ1	637.547	+	1293	1829	2156	0.8483303
A04	21312955	21313571	A04p34830.2_BraZ1	359.1	-	1056	616	616	1.0000000
A04	21314905	21316396	A04p34840.2_BraZ1	1071	+	585	1393	1491	0.9342723
A04	21327867	21330514	A04p34850.2_BraZ1	1941	+	1198	2472	2647	0.9338874
A04	21333514	21334213	A04p34860.2_BraZ1	69.9	+	274	677	699	0.9685265
A04	21452019	21453337	A04p34870.2_BraZ1	852.5	+	494	1123	1318	0.8520486
A04	21453579	21457366	A04p34880.2_BraZ1	2281.35	-	1155	3309	3787	0.8737787
A04	21459588	21461414	A04p34890.2_BraZ1	6118	-	168	1618	1826	0.8860898
A04	21466716	21467654	A04p34900.2_BraZ1	513	+	213	857	938	0.9136460
A04	21473327	21474161	A04p34910.2_BraZ1	83.4	+	49	183	834	0.2194245
A04	21478419	21483176	A04p34920.2_BraZ1	2393.6	-	1851	4739	4757	0.9962161
A04	21484870	21487828	A04p34930.2_BraZ1	1371.43	-	444	1690	2958	0.5713320
A04	21490027	21492957	A04p34940.2_BraZ1	1606.96	+	467	2334	2930	0.7965870
A04	21496061	21496617	A04p34950.2_BraZ1	345	+	123	413	556	0.7428058
A04	21496616	21497295	A04p34960.2_BraZ1	201	+	77	436	679	0.6421208
A04	21502777	21503637	A04p34970.2_BraZ1	771	+	220	831	860	0.9662791
A04	21504845	21506164	A04p34980.2_BraZ1	376.25	+	1309	1319	1319	1.0000000
A04	21506569	21509292	A04p34990.2_BraZ1	964.6	-	2622	2714	2723	0.9966948
A04	21511743	21512589	A04p35000.2_BraZ1	84.6	+	103	807	846	0.9539007
A04	21515591	21516904	A04p35010.2_BraZ1	762.6	-	377	1212	1313	0.9230769
A04	21518554	21520862	A04p35020.2_BraZ1	656.327	+	2057	2308	2308	1.0000000
A04	21521805	21522536	A04p35030.2_BraZ1	502.667	+	192	680	731	0.9302326
A04	21523048	21523237	A04p35040.2_BraZ1	18.9	+	240	189	189	1.0000000
A04	21524330	21526700	A04p35050.2_BraZ1	750.833	-	945	2176	2370	0.9181435
A04	21533195	21535161	A04p35060.2_BraZ1	670.371	-	988	1893	1966	0.9628688
A04	21536238	21539966	A04p35070.2_BraZ1	306.6	-	102	1509	3728	0.4047747
A04	21552485	21555205	A04p35080.2_BraZ1	1506.69	+	972	2695	2720	0.9908088
A04	21555609	21556564	A04p35090.2_BraZ1	409.375	+	1310	955	955	1.0000000
A04	21556631	21557030	A04p35100.2_BraZ1	222.75	+	388	399	399	1.0000000
A04	21557319	21558218	A04p35110.2_BraZ1	535.585	-	255	796	899	0.8854282
A04	21563562	21565420	A04p35120.2_BraZ1	1134	+	378	1744	1858	0.9386437
A04	21568307	21569067	A04p35130.2_BraZ1	672	+	256	691	760	0.9092105
A04	21570350	21574727	A04p35140.2_BraZ1	108.3	-	2592	4377	4377	1.0000000
A04	21577228	21577824	A04p35150.2_BraZ1	477	-	90	164	596	0.2751678
A04	21586127	21587950	A04p35160.2_BraZ1	780	+	1621	1823	1823	1.0000000
A04	21635424	21636351	A04p35170.2_BraZ1	92.7	+	184	863	927	0.9309601
A04	21638964	21640512	A04p35180.2_BraZ1	1101	+	504	1480	1548	0.9560723
A04	21640860	21641336	A04p35190.2_BraZ1	279	-	80	476	476	1.0000000
A04	21644879	21646127	A04p35200.2_BraZ1	124.8	-	656	1248	1248	1.0000000
A04	21647411	21649143	A04p35210.2_BraZ1	1207.25	+	509	1568	1732	0.9053118
A04	21649370	21650630	A04p35220.2_BraZ1	840	-	438	1235	1260	0.9801587
A04	21651129	21667520	A04p35230.2_BraZ1	1941.26	-	7245	15528	16391	0.9473491
A04	21667924	21670172	A04p35240.2_BraZ1	150.3	-	703	1792	2248	0.7971530
A04	21671614	21673786	A04p35250.2_BraZ1	217.2	+	341	2112	2172	0.9723757
A04	21674769	21677562	A04p35260.2_BraZ1	2019.65	+	1200	2716	2793	0.9724311
A04	21678773	21681553	A04p35270.2_BraZ1	579.276	-	843	2583	2780	0.9291367
A04	21689266	21692582	A04p35280.2_BraZ1	1511.88	-	3093	3316	3316	1.0000000
A04	21694064	21694447	A04p35290.2_BraZ1	252	+	144	361	383	0.9425588
A04	21695085	21698002	A04p35300.2_BraZ1	2038.94	-	1776	2917	2917	1.0000000
A04	21699089	21699596	A04p35310.2_BraZ1	261	+	462	507	507	1.0000000
A04	21699991	21702109	A04p35320.2_BraZ1	1246.67	-	1721	2087	2118	0.9853635
A04	21702725	21709459	A04p35330.2_BraZ1	1304.05	+	4518	6569	6734	0.9754975
A04	21710489	21711107	A04p35340.2_BraZ1	61.8	-	392	618	618	1.0000000
A04	21711534	21711663	A04p35350.2_BraZ1	12.9	-	259	129	129	1.0000000
A04	21714619	21716669	A04p35360.2_BraZ1	1071.42	+	759	1995	2050	0.9731708
A04	21717217	21718804	A04p35370.2_BraZ1	647.928	+	383	1512	1587	0.9527410
A04	21719076	21720268	A04p35380.2_BraZ1	681.375	-	103	804	1192	0.6744967
A04	21720874	21723248	A04p35390.2_BraZ1	1430.8	+	1144	2374	2374	1.0000000
A04	21724762	21726236	A04p35400.2_BraZ1	588	-	1410	1474	1474	1.0000000
A04	21727886	21729858	A04p35410.2_BraZ1	1467.2	+	1400	1972	1972	1.0000000
A04	21730050	21731727	A04p35420.2_BraZ1	999.75	-	827	1597	1677	0.9522958
A04	21733042	21733496	A04p35430.2_BraZ1	236.757	-	190	454	454	1.0000000
A04	21733613	21735394	A04p35440.2_BraZ1	1157.76	+	987	1781	1781	1.0000000
A04	21735932	21738726	A04p35450.2_BraZ1	1289.34	-	504	2372	2794	0.8489621
A04	21747993	21751639	A04p35460.2_BraZ1	2493	+	929	2997	3646	0.8219967
A04	21752689	21753939	A04p35470.2_BraZ1	793.371	+	702	1250	1250	1.0000000
A04	21756355	21757582	A04p35480.2_BraZ1	114.3	-	875	1227	1227	1.0000000
A04	21759564	21761065	A04p35490.2_BraZ1	47929	+	810	1501	1501	1.0000000
A04	21762176	21762959	A04p35500.2_BraZ1	702	-	787	783	783	1.0000000
A04	21763574	21764078	A04p35510.2_BraZ1	408	+	323	504	504	1.0000000
A04	21764304	21764820	A04p35520.2_BraZ1	435	-	722	516	516	1.0000000
A04	21766128	21766893	A04p35530.2_BraZ1	627	-	1004	765	765	1.0000000
A04	21768173	21776424	A04p35540.2_BraZ1	5056.65	+	3292	7772	8251	0.9419464
A04	21776832	21778033	A04p35550.2_BraZ1	60.6	-	1072	1201	1201	1.0000000
A04	21811054	21812931	A04p35560.2_BraZ1	1548	-	837	1729	1877	0.9211507
A04	21814449	21818254	A04p35570.2_BraZ1	2248.96	-	3480	3790	3805	0.9960578
A04	21818978	21820643	A04p35580.2_BraZ1	115.8	-	1658	1665	1665	1.0000000
A04	21821003	21822032	A04p35590.2_BraZ1	102.9	-	929	1029	1029	1.0000000
A04	21824586	21828420	A04p35600.2_BraZ1	983.415	+	3627	3818	3834	0.9958268
A04	21829882	21830473	A04p35610.2_BraZ1	501	+	622	591	591	1.0000000
A04	21831416	21832049	A04p35620.2_BraZ1	63.3	+	670	633	633	1.0000000
A04	21833467	21834819	A04p35630.2_BraZ1	10350	+	1071	1352	1352	1.0000000
A04	21836568	21837878	A04p35640.2_BraZ1	630.26	-	1068	1310	1310	1.0000000
A04	21838512	21839561	A04p35650.2_BraZ1	609	+	327	948	1049	0.9037178
A04	21846918	21847974	A04p35660.2_BraZ1	105.6	-	370	859	1056	0.8134470
A04	21910557	21912482	A04p35670.2_BraZ1	1452.26	+	1954	1925	1925	1.0000000
A04	21913895	21914693	A04p35680.2_BraZ1	255.563	-	525	711	798	0.8909774
A04	21916704	21918393	A04p35690.2_BraZ1	8370	-	363	1508	1689	0.8928360
A04	21918955	21920413	A04p35700.2_BraZ1	1119	-	240	915	1458	0.6275720
A04	21921309	21923041	A04p35710.2_BraZ1	1656	-	329	1672	1732	0.9653580
A04	21924402	21925782	A04p35720.2_BraZ1	138	-	614	1358	1380	0.9840580
A04	21930096	21930787	A04p35730.2_BraZ1	60.6	+	145	691	691	1.0000000
A04	21931024	21931846	A04p35740.2_BraZ1	207.9	-	212	822	822	1.0000000
A04	21932289	21933312	A04p35750.2_BraZ1	102.3	-	458	993	1023	0.9706745
A04	21935991	21936105	A04p35760.2_BraZ1	11.4	-	41	114	114	1.0000000
A04	21936244	21938309	A04p35770.2_BraZ1	1296	+	895	2057	2065	0.9961259
A04	21938645	21939983	A04p35780.2_BraZ1	571.043	-	1132	1285	1338	0.9603887
A04	21942439	21944302	A04p35790.2_BraZ1	1134	+	237	1410	1863	0.7568438
A04	21947117	21947627	A04p35800.2_BraZ1	51	+	15	400	510	0.7843137
A04	21948322	21950333	A04p35810.2_BraZ1	229.714	-	1190	1997	2011	0.9930383
A04	21952783	21953908	A04p35820.2_BraZ1	112.5	+	148	943	1125	0.8382222
A04	21954904	21955507	A04p35830.2_BraZ1	400.5	+	184	595	603	0.9867330
A04	21957274	21958981	A04p35840.2_BraZ1	1584	-	108	1165	1707	0.6824839
A04	21992593	21993422	A04p35850.2_BraZ1	1517.25	-	48	546	829	0.6586248
A04	21993810	21994198	A04p35860.2_BraZ1	252	+	7	48	388	0.1237113
A04	22009485	22009845	A04p35870.2_BraZ1	36	+	7	75	360	0.2083333
A04	22011571	22014604	A04p35880.2_BraZ1	1666.41	-	815	2980	3033	0.9825255
A04	22020999	22023457	A04p35890.2_BraZ1	1314	+	1009	2458	2458	1.0000000
A04	22024695	22025175	A04p35900.2_BraZ1	48	+	145	393	480	0.8187500
A04	22056633	22058990	A04p35910.2_BraZ1	1095	-	1244	2249	2357	0.9541790
A04	22070635	22072092	A04p35920.2_BraZ1	944.498	+	525	1377	1457	0.9450927
A04	22073932	22084388	A04p35930.2_BraZ1	1262.61	+	2575	5159	10456	0.4934009
A04	22080266	22080754	A04p35940.2_BraZ1	243	-	0	0	488	0.0000000
A04	22085540	22086821	A04p35950.2_BraZ1	194.283	+	1311	1281	1281	1.0000000
A04	22087136	22088440	A04p35960.2_BraZ1	362.674	+	606	1293	1304	0.9915644
A04	22089219	22089849	A04p35970.2_BraZ1	201	+	332	630	630	1.0000000
A04	22094277	22095310	A04p35980.2_BraZ1	594	+	725	1033	1033	1.0000000
A04	22095454	22096249	A04p35990.2_BraZ1	79.5	+	654	795	795	1.0000000
A04	22098596	22100398	A04p36000.2_BraZ1	6576	+	1942	1802	1802	1.0000000
A04	22101605	22102928	A04p36010.2_BraZ1	598.435	+	368	1026	1323	0.7755102
A04	22111504	22112419	A04p36020.2_BraZ1	91.5	+	158	487	915	0.5322405
A04	22115475	22116071	A04p36030.2_BraZ1	435	+	50	343	596	0.5755033
A04	22116264	22119370	A04p36040.2_BraZ1	792.409	-	433	2371	3106	0.7633612
A04	22119450	22119737	A04p36050.2_BraZ1	222	-	214	287	287	1.0000000
A04	22125167	22126029	A04p36060.2_BraZ1	6037.5	+	728	862	862	1.0000000
A04	22128958	22133712	A04p36070.2_BraZ1	3615.94	-	1452	4741	4754	0.9972655
A04	22137134	22139024	A04p36080.2_BraZ1	1791	-	6	77	1890	0.0407407
A04	22140838	22141489	A04p36090.2_BraZ1	65.1	-	51	487	651	0.7480799
A04	22142219	22143536	A04p36100.2_BraZ1	6204	-	165	1139	1317	0.8648443
A04	22309709	22312492	A04p36110.2_BraZ1	1812.42	-	1081	2416	2783	0.8681279
A04	22318704	22318978	A04p36120.2_BraZ1	180	+	232	274	274	1.0000000
A04	22319467	22320784	A04p36130.2_BraZ1	1029	-	376	1266	1317	0.9612756
A04	22326308	22327405	A04p36140.2_BraZ1	687.96	+	28	423	1097	0.3855971
A04	22328051	22328321	A04p36150.2_BraZ1	27	-	78	270	270	1.0000000
A04	22334949	22337848	A04p36160.2_BraZ1	1099.75	+	1034	2742	2899	0.9458434
A04	22339582	22345072	A04p36170.2_BraZ1	1779.95	+	3316	5361	5490	0.9765027
A04	22346175	22347364	A04p36180.2_BraZ1	975	-	576	945	1189	0.7947856
A04	22351614	22351938	A04p36190.2_BraZ1	31.5	-	345	324	324	1.0000000
A04	22353737	22354948	A04p36200.2_BraZ1	573	+	876	1211	1211	1.0000000
A04	22356748	22357123	A04p36210.2_BraZ1	37.5	+	113	375	375	1.0000000
A04	22360887	22368736	A04p36220.2_BraZ1	4074.76	+	1793	6508	7849	0.8291502
A04	22368861	22369349	A04p36230.2_BraZ1	300	-	243	488	488	1.0000000
A04	22372439	22372802	A04p36240.2_BraZ1	36.3	+	386	363	363	1.0000000
A04	22375418	22376231	A04p36250.2_BraZ1	1617	-	0	0	813	0.0000000
A04	22376431	22376878	A04p36260.2_BraZ1	159	-	452	447	447	1.0000000
A04	22385432	22386677	A04p36270.2_BraZ1	239.692	+	1067	1245	1245	1.0000000
A04	22386754	22390334	A04p36280.2_BraZ1	456.734	+	1370	3576	3580	0.9988827
A04	22391147	22391918	A04p36290.2_BraZ1	666	-	477	771	771	1.0000000
A04	22393124	22394066	A04p36300.2_BraZ1	597	+	414	799	942	0.8481953
A04	22398877	22401275	A04p36310.2_BraZ1	1692	+	427	1647	2398	0.6868224
A04	22401646	22402391	A04p36320.2_BraZ1	65.7	-	219	622	745	0.8348993
A04	22445901	22448182	A04p36330.2_BraZ1	988.833	+	492	2040	2281	0.8943446
A04	22448696	22450269	A04p36340.2_BraZ1	547.368	-	991	1317	1573	0.8372536
A04	22451558	22452182	A04p36350.2_BraZ1	61.2	-	11	58	624	0.0929487
A04	22453707	22454657	A04p36360.2_BraZ1	489	-	52	604	950	0.6357895
A04	22456416	22459231	A04p36370.2_BraZ1	996.84	-	305	2151	2815	0.7641208
A04	22460127	22460682	A04p36380.2_BraZ1	240	+	222	82	555	0.1477478
A04	22464157	22464748	A04p36390.2_BraZ1	59.1	+	159	559	591	0.9458545
A04	22465095	22466671	A04p36400.2_BraZ1	1041.67	-	537	1552	1576	0.9847715
A04	22467969	22468392	A04p36410.2_BraZ1	42.3	+	7	122	423	0.2884161
A04	22469355	22469673	A04p36420.2_BraZ1	31.8	+	135	318	318	1.0000000
A04	22472812	22473254	A04p36430.2_BraZ1	351	+	606	442	442	1.0000000
A04	22473579	22475021	A04p36440.2_BraZ1	1173.96	-	865	1419	1442	0.9840499
A04	22477655	22478641	A04p36450.2_BraZ1	8675.25	+	989	986	986	1.0000000
A04	22479528	22479927	A04p36460.2_BraZ1	39.9	-	139	388	399	0.9724311
A04	22480596	22484062	A04p36470.2_BraZ1	1441.01	-	1952	3277	3466	0.9454703
A04	22485313	22485752	A04p36480.2_BraZ1	423	+	267	439	439	1.0000000
A04	22487204	22498545	A04p36490.2_BraZ1	6421.04	-	1635	6059	11341	0.5342562
A04	22498744	22499168	A04p36500.2_BraZ1	258	+	389	424	424	1.0000000
A04	22499963	22500485	A04p36510.2_BraZ1	51.9	-	19	110	522	0.2107280
A04	22503135	22505558	A04p36520.2_BraZ1	905.333	-	139	783	2423	0.3231531
A04	22505982	22506862	A04p36530.2_BraZ1	583.625	+	447	726	880	0.8250000
A04	22506904	22507054	A04p36540.2_BraZ1	15	+	17	100	150	0.6666667
A04	22507496	22508527	A04p36550.2_BraZ1	443.625	-	68	730	1031	0.7080504
A05	5546	6579	A05p00010.2_BraZ1	6942.38	-	728	1033	1033	1.0000000
A05	8523	8999	A05p00020.2_BraZ1	384	-	5	56	476	0.1176471
A05	9385	11126	A05p00030.2_BraZ1	765.574	+	118	1020	1741	0.5858702
A05	11651	13176	A05p00040.2_BraZ1	609.5	-	1079	1058	1525	0.6937705
A05	13620	19673	A05p00050.2_BraZ1	3776.97	-	1458	4961	6053	0.8195936
A05	20016	24020	A05p00060.2_BraZ1	604.917	-	9880	4004	4004	1.0000000
A05	24114	24642	A05p00070.2_BraZ1	52.5	+	1199	528	528	1.0000000
A05	28543	30957	A05p00080.2_BraZ1	1252.8	+	2567	2414	2414	1.0000000
A05	32001	32867	A05p00090.2_BraZ1	78.6	-	810	866	866	1.0000000
A05	33106	43897	A05p00100.2_BraZ1	6671.86	+	8604	10791	10791	1.0000000
A05	45491	47659	A05p00110.2_BraZ1	1248.33	+	2754	2168	2168	1.0000000
A05	78230	86667	A05p00120.2_BraZ1	3689.79	-	2488	5503	8437	0.6522461
A05	87283	88626	A05p00130.2_BraZ1	996	+	595	1256	1343	0.9352196
A05	89065	89734	A05p00140.2_BraZ1	654	-	98	646	669	0.9656203
A05	90575	91854	A05p00150.2_BraZ1	112.2	-	191	1193	1279	0.9327599
A05	92855	94704	A05p00160.2_BraZ1	339	-	131	1163	1849	0.6289886
A05	96975	97284	A05p00170.2_BraZ1	30.9	-	132	309	309	1.0000000
A05	98684	98996	A05p00180.2_BraZ1	31.2	-	39	135	312	0.4326923
A05	101005	102986	A05p00190.2_BraZ1	1178.58	-	414	1815	1981	0.9162039
A05	109257	109911	A05p00200.2_BraZ1	468	+	81	517	654	0.7905199
A05	112076	112829	A05p00210.2_BraZ1	675	-	115	562	753	0.7463480
A05	113373	113910	A05p00220.2_BraZ1	53.7	-	223	537	537	1.0000000
A05	114245	116701	A05p00230.2_BraZ1	1168.01	+	488	2028	2456	0.8257329
A05	116828	117132	A05p00240.2_BraZ1	207	+	1	65	304	0.2138158
A05	119627	122328	A05p00250.2_BraZ1	1586.67	+	677	1976	2701	0.7315809
A05	124082	124887	A05p00260.2_BraZ1	318	+	711	805	805	1.0000000
A05	126048	126865	A05p00270.2_BraZ1	620	-	527	817	817	1.0000000
A05	127247	127370	A05p00280.2_BraZ1	12.3	+	181	123	123	1.0000000
A05	128219	129137	A05p00290.2_BraZ1	480.85	+	244	912	918	0.9934641
A05	129514	131603	A05p00300.2_BraZ1	1234.07	+	1381	2089	2089	1.0000000
A05	132098	132825	A05p00310.2_BraZ1	252	-	499	727	727	1.0000000
A05	133172	138540	A05p00320.2_BraZ1	2738.65	+	1763	4219	5368	0.7859538
A05	140375	140996	A05p00330.2_BraZ1	62.1	+	18	119	621	0.1916264
A05	172496	173578	A05p00340.2_BraZ1	711	-	749	1082	1082	1.0000000
A05	174047	176120	A05p00350.2_BraZ1	1355.79	-	2284	2073	2073	1.0000000
A05	176651	177617	A05p00360.2_BraZ1	733.867	-	514	943	966	0.9761904
A05	180737	182993	A05p00370.2_BraZ1	602.486	+	20	815	2256	0.3612589
A05	187035	189260	A05p00380.2_BraZ1	1540	+	427	948	2225	0.4260674
A05	189742	191354	A05p00390.2_BraZ1	1280.22	-	713	1492	1612	0.9255583
A05	195386	196545	A05p00400.2_BraZ1	720.276	-	1039	1159	1159	1.0000000
A05	199155	200514	A05p00410.2_BraZ1	540	+	411	1111	1359	0.8175129
A05	200971	203476	A05p00420.2_BraZ1	1689	-	227	1469	2505	0.5864272
A05	208347	211766	A05p00430.2_BraZ1	1312.5	-	4361	3353	3419	0.9806961
A05	208845	211128	A05p00440.2_BraZ1	955.2	+	3559	2283	2283	1.0000000
A05	212918	215106	A05p00450.2_BraZ1	1756.33	-	466	2052	2188	0.9378428
A05	216677	224937	A05p00460.2_BraZ1	445.2	-	2889	7681	8260	0.9299031
A05	232585	233746	A05p00470.2_BraZ1	116.1	-	626	1161	1161	1.0000000
A05	234238	234664	A05p00480.2_BraZ1	42.6	-	94	366	426	0.8591549
A05	236386	236737	A05p00490.2_BraZ1	35.1	+	131	275	351	0.7834758
A05	237659	239896	A05p00500.2_BraZ1	940.346	-	2283	2224	2237	0.9941887
A05	258759	262633	A05p00510.2_BraZ1	1149	-	4146	3387	3874	0.8742902
A05	265754	267631	A05p00520.2_BraZ1	1984.5	-	2107	1877	1877	1.0000000
A05	276986	281407	A05p00530.2_BraZ1	2653.25	+	4796	4349	4421	0.9837141
A05	281758	282995	A05p00540.2_BraZ1	1038	-	854	1237	1237	1.0000000
A05	283771	284152	A05p00550.2_BraZ1	38.1	-	309	381	381	1.0000000
A05	284524	288541	A05p00560.2_BraZ1	2709.97	+	4474	4017	4017	1.0000000
A05	289629	290813	A05p00570.2_BraZ1	947.438	+	850	1184	1184	1.0000000
A05	291006	291927	A05p00580.2_BraZ1	92.1	-	854	921	921	1.0000000
A05	292622	294763	A05p00590.2_BraZ1	2043.85	-	2190	2027	2141	0.9467539
A05	295849	298521	A05p00600.2_BraZ1	2006.59	+	814	2519	2672	0.9427395
A05	299499	299640	A05p00610.2_BraZ1	14.1	-	65	127	141	0.9007092
A05	301624	302020	A05p00620.2_BraZ1	39.6	+	228	396	396	1.0000000
A05	307379	308917	A05p00630.2_BraZ1	978.75	+	107	1354	1538	0.8803641
A05	311908	312963	A05p00640.2_BraZ1	483.444	-	382	1055	1055	1.0000000
A05	341321	345342	A05p00650.2_BraZ1	1758.47	-	1748	3623	4021	0.9010196
A05	349169	350872	A05p00660.2_BraZ1	1026.14	-	684	1703	1703	1.0000000
A05	351530	362427	A05p00670.2_BraZ1	1803.42	-	2672	8294	10897	0.7611269
A05	354566	356135	A05p00680.2_BraZ1	994.846	+	540	1433	1569	0.9133206
A05	357503	359084	A05p00690.2_BraZ1	1288	+	593	1506	1581	0.9525617
A05	362870	363529	A05p00700.2_BraZ1	213	+	526	659	659	1.0000000
A05	369215	370250	A05p00710.2_BraZ1	934.08	-	287	1011	1035	0.9768116
A05	376968	378259	A05p00720.2_BraZ1	1017	+	307	1267	1291	0.9814098
A05	378776	379953	A05p00730.2_BraZ1	581.274	-	612	1177	1177	1.0000000
A05	385557	388373	A05p00740.2_BraZ1	1871.9	+	997	2737	2816	0.9719460
A05	391235	392323	A05p00750.2_BraZ1	65.1	+	396	1088	1088	1.0000000
A05	393895	395364	A05p00760.2_BraZ1	40.2	+	768	1400	1469	0.9530293
A05	398115	399240	A05p00770.2_BraZ1	400.862	+	424	939	1125	0.8346667
A05	401314	403979	A05p00780.2_BraZ1	1951.33	+	637	2161	2665	0.8108818
A05	508798	509974	A05p00790.2_BraZ1	117.6	+	27	259	1176	0.2202381
A05	510765	514115	A05p00800.2_BraZ1	2238.97	-	438	2535	3350	0.7567164
A05	518937	520989	A05p00810.2_BraZ1	788.246	+	217	1800	2052	0.8771930
A05	521583	522234	A05p00820.2_BraZ1	65.1	+	292	633	651	0.9723502
A05	524246	526263	A05p00830.2_BraZ1	1779	+	63	747	2017	0.3703520
A05	526701	528745	A05p00840.2_BraZ1	1069.2	+	1768	1975	2044	0.9662427
A05	529586	531569	A05p00850.2_BraZ1	1478.11	-	837	1649	1983	0.8315684
A05	534604	540192	A05p00860.2_BraZ1	3721.74	+	2211	5260	5588	0.9413028
A05	541325	541730	A05p00870.2_BraZ1	40.5	+	350	405	405	1.0000000
A05	548662	552075	A05p00880.2_BraZ1	1746.16	+	1268	3244	3413	0.9504834
A05	553605	555192	A05p00890.2_BraZ1	158.7	-	2175	1587	1587	1.0000000
A05	556643	557951	A05p00900.2_BraZ1	130.8	+	291	1132	1308	0.8654434
A05	582890	584785	A05p00910.2_BraZ1	1167.36	+	71	1299	1895	0.6854881
A05	588032	592348	A05p00920.2_BraZ1	1177	+	1849	4217	4316	0.9770621
A05	595334	595782	A05p00930.2_BraZ1	43.5	+	164	448	448	1.0000000
A05	597309	598026	A05p00940.2_BraZ1	71.7	+	219	610	717	0.8507671
A05	601168	603509	A05p00950.2_BraZ1	1144.8	-	1026	2341	2341	1.0000000
A05	607378	610176	A05p00960.2_BraZ1	2348.76	+	275	1996	2798	0.7133667
A05	611009	614576	A05p00970.2_BraZ1	1938.53	+	2267	3567	3567	1.0000000
A05	614739	616136	A05p00980.2_BraZ1	738.409	-	376	1397	1397	1.0000000
A05	616117	618763	A05p00990.2_BraZ1	1162.97	-	995	2499	2646	0.9444444
A05	619620	623010	A05p01000.2_BraZ1	1753.43	+	447	2669	3390	0.7873156
A05	624876	625770	A05p01010.2_BraZ1	89.4	-	108	434	894	0.4854586
A05	631779	636481	A05p01020.2_BraZ1	1956.76	-	2864	4532	4702	0.9638452
A05	637934	639119	A05p01030.2_BraZ1	481.344	-	958	1140	1185	0.9620253
A05	640658	642038	A05p01040.2_BraZ1	822.381	-	335	1315	1380	0.9528986
A05	643399	644648	A05p01050.2_BraZ1	1173	-	523	1227	1249	0.9823859
A05	644948	645179	A05p01060.2_BraZ1	144	-	334	231	231	1.0000000
A05	646173	647669	A05p01070.2_BraZ1	1311	-	539	1496	1496	1.0000000
A05	652942	654357	A05p01080.2_BraZ1	945	-	199	1345	1415	0.9505301
A05	669436	671362	A05p01090.2_BraZ1	1058.4	+	800	1866	1926	0.9688473
A05	680770	682901	A05p01100.2_BraZ1	1681.28	+	844	1966	2131	0.9225715
A05	688755	695998	A05p01110.2_BraZ1	1511.08	+	1295	4215	7243	0.5819412
A05	696330	698470	A05p01120.2_BraZ1	1914	-	408	1726	2140	0.8065420
A05	712529	715231	A05p01130.2_BraZ1	1310.52	-	1064	2514	2702	0.9304219
A05	720715	721784	A05p01140.2_BraZ1	213	+	44	824	1069	0.7708138
A05	720831	721646	A05p01150.2_BraZ1	204	+	42	584	815	0.7165644
A05	724681	725050	A05p01160.2_BraZ1	36.9	-	0	0	369	0.0000000
A05	726034	741085	A05p01170.2_BraZ1	435	-	2577	9825	15051	0.6527805
A05	745369	746371	A05p01180.2_BraZ1	765	+	27	581	1002	0.5798403
A05	760091	761865	A05p01190.2_BraZ1	1587	+	125	1077	1774	0.6071026
A05	763147	763718	A05p01200.2_BraZ1	400.5	-	15	156	571	0.2732049
A05	764165	764579	A05p01210.2_BraZ1	246	+	292	414	414	1.0000000
A05	766424	767775	A05p01220.2_BraZ1	864.075	-	603	1338	1351	0.9903775
A05	770487	771663	A05p01230.2_BraZ1	117.6	-	153	932	1176	0.7925170
A05	772400	772958	A05p01240.2_BraZ1	55.8	-	15	290	558	0.5197133
A05	778379	780331	A05p01250.2_BraZ1	668	+	1373	1952	1952	1.0000000
A05	780996	781936	A05p01260.2_BraZ1	128.889	+	485	940	940	1.0000000
A05	782119	782549	A05p01270.2_BraZ1	38.1	-	690	430	430	1.0000000
A05	785094	788333	A05p01280.2_BraZ1	772.941	-	2652	2864	3239	0.8842235
A05	789650	790763	A05p01290.2_BraZ1	825	+	146	612	1113	0.5498652
A05	803581	813544	A05p01300.2_BraZ1	7039.27	+	846	5269	9963	0.5288568
A05	815726	816887	A05p01310.2_BraZ1	116.1	+	493	1154	1161	0.9939707
A05	817770	818346	A05p01320.2_BraZ1	284.727	+	408	576	576	1.0000000
A05	819076	819669	A05p01330.2_BraZ1	510	-	193	404	593	0.6812816
A05	821471	823269	A05p01340.2_BraZ1	806.743	-	1588	1798	1798	1.0000000
A05	838127	841034	A05p01350.2_BraZ1	290.7	-	201	1665	2907	0.5727554
A05	845170	846631	A05p01360.2_BraZ1	146.1	+	445	1461	1461	1.0000000
A05	847364	847778	A05p01370.2_BraZ1	41.4	+	251	414	414	1.0000000
A05	848969	849362	A05p01380.2_BraZ1	39.3	-	62	317	393	0.8066158
A05	849972	852791	A05p01390.2_BraZ1	1620	+	1641	2476	2819	0.8783256
A05	854034	855224	A05p01400.2_BraZ1	955.636	+	1885	1190	1190	1.0000000
A05	855672	858646	A05p01410.2_BraZ1	1727.37	-	2059	2481	2974	0.8342300
A05	860568	862319	A05p01420.2_BraZ1	1041.88	-	387	1741	1751	0.9942890
A05	867925	868589	A05p01430.2_BraZ1	241.809	+	23	412	664	0.6204819
A05	872285	873361	A05p01440.2_BraZ1	1164	+	356	1027	1076	0.9544610
A05	874458	874803	A05p01450.2_BraZ1	246	+	297	345	345	1.0000000
A05	875004	877324	A05p01460.2_BraZ1	1697.8	-	879	2317	2320	0.9987069
A05	879083	879272	A05p01470.2_BraZ1	123	-	81	178	189	0.9417989
A05	881394	883767	A05p01480.2_BraZ1	1603.53	-	968	2373	2373	1.0000000
A05	887582	888118	A05p01490.2_BraZ1	277.667	-	2	16	536	0.0298507
A05	898473	902507	A05p01500.2_BraZ1	2788.62	+	1289	3521	4034	0.8728309
A05	909911	910284	A05p01510.2_BraZ1	222	+	79	373	373	1.0000000
A05	911033	912987	A05p01520.2_BraZ1	799.945	-	644	1831	1954	0.9370522
A05	918808	919618	A05p01530.2_BraZ1	81	-	539	776	810	0.9580247
A05	947997	948765	A05p01540.2_BraZ1	76.8	-	79	574	768	0.7473958
A05	949895	950883	A05p01550.2_BraZ1	468	-	476	988	988	1.0000000
A05	953129	957461	A05p01560.2_BraZ1	966.996	-	2981	4201	4332	0.9697599
A05	962019	964332	A05p01570.2_BraZ1	1464.96	-	1057	2313	2313	1.0000000
A05	975317	976807	A05p01580.2_BraZ1	1304.21	-	1094	1490	1490	1.0000000
A05	979685	983120	A05p01590.2_BraZ1	34618.5	-	3163	3435	3435	1.0000000
A05	983818	985109	A05p01600.2_BraZ1	626.394	+	1122	1266	1291	0.9806352
A05	985508	987095	A05p01610.2_BraZ1	782.455	-	1783	1587	1587	1.0000000
A05	987176	988336	A05p01620.2_BraZ1	39.3545	-	1106	1160	1160	1.0000000
A05	988820	989642	A05p01630.2_BraZ1	687	-	1427	822	822	1.0000000
A05	991174	992386	A05p01640.2_BraZ1	381	-	183	617	1212	0.5090759
A05	993493	995066	A05p01650.2_BraZ1	988.393	+	2145	1573	1573	1.0000000
A05	1003608	1005277	A05p01660.2_BraZ1	1320.14	-	1510	1669	1669	1.0000000
A05	1005713	1007177	A05p01670.2_BraZ1	135	-	2495	1464	1464	1.0000000
A05	1008237	1009936	A05p01680.2_BraZ1	958.513	+	4572	1699	1699	1.0000000
A05	1011888	1013439	A05p01690.2_BraZ1	744.545	-	1531	1551	1551	1.0000000
A05	1016718	1017381	A05p01700.2_BraZ1	66.3	-	1203	663	663	1.0000000
A05	1018140	1019235	A05p01710.2_BraZ1	501	-	1518	1095	1095	1.0000000
A05	1019864	1020786	A05p01720.2_BraZ1	85.7143	-	616	922	922	1.0000000
A05	1022950	1024779	A05p01730.2_BraZ1	828.527	-	493	1665	1829	0.9103335
A05	1032326	1033687	A05p01740.2_BraZ1	427.655	+	1034	1361	1361	1.0000000
A05	1034886	1035626	A05p01750.2_BraZ1	606	-	143	566	740	0.7648649
A05	1037920	1038652	A05p01760.2_BraZ1	6709.5	-	139	373	732	0.5095628
A05	1041879	1046121	A05p01770.2_BraZ1	1664.4	+	577	2924	4242	0.6892975
A05	1048833	1049669	A05p01780.2_BraZ1	660	-	21	461	836	0.5514354
A05	1052707	1053298	A05p01790.2_BraZ1	59.1	-	1	45	591	0.0761421
A05	1055061	1056086	A05p01800.2_BraZ1	858	+	979	1025	1025	1.0000000
A05	1061276	1062758	A05p01810.2_BraZ1	148.2	+	423	1195	1482	0.8063428
A05	1065548	1067595	A05p01820.2_BraZ1	1300.98	+	299	1212	2047	0.5920860
A05	1069272	1069578	A05p01830.2_BraZ1	30.6	+	110	304	306	0.9934641
A05	1074269	1075722	A05p01840.2_BraZ1	643.2	+	532	1449	1453	0.9972471
A05	1076004	1077375	A05p01850.2_BraZ1	137.1	-	290	1247	1371	0.9095551
A05	1078035	1079222	A05p01860.2_BraZ1	563.45	-	947	1132	1187	0.9536647
A05	1082025	1083340	A05p01870.2_BraZ1	757.174	-	499	1302	1315	0.9901141
A05	1085365	1087339	A05p01880.2_BraZ1	1071	-	1086	1974	1974	1.0000000
A05	1088430	1090545	A05p01890.2_BraZ1	1034.1	+	1554	2115	2115	1.0000000
A05	1090966	1091469	A05p01900.2_BraZ1	366	-	311	459	503	0.9125249
A05	1092177	1094964	A05p01910.2_BraZ1	1653.67	+	1237	2787	2787	1.0000000
A05	1096098	1096332	A05p01920.2_BraZ1	23.4	-	61	177	234	0.7564102
A05	1098205	1099854	A05p01930.2_BraZ1	1014	-	188	1369	1649	0.8302001
A05	1104311	1105752	A05p01940.2_BraZ1	31.8	+	1138	1196	1441	0.8299792
A05	1106108	1107825	A05p01950.2_BraZ1	2148.39	-	476	1700	1717	0.9900990
A05	1120059	1122883	A05p01960.2_BraZ1	1315.85	-	399	2105	2824	0.7453966
A05	1126637	1127588	A05p01970.2_BraZ1	95.1	+	417	951	951	1.0000000
A05	1128213	1132920	A05p01980.2_BraZ1	2642.83	+	2095	4682	4707	0.9946887
A05	1133482	1136114	A05p01990.2_BraZ1	1483.89	-	1463	2385	2632	0.9061550
A05	1139075	1141079	A05p02000.2_BraZ1	1007.25	-	603	1899	2004	0.9476048
A05	1146263	1147492	A05p02010.2_BraZ1	75	-	965	1229	1229	1.0000000
A05	1151403	1152147	A05p02020.2_BraZ1	74.4	-	485	744	744	1.0000000
A05	1160306	1162373	A05p02030.2_BraZ1	206.7	+	573	1965	2067	0.9506531
A05	1163396	1165331	A05p02040.2_BraZ1	1286.5	-	375	1855	1935	0.9586563
A05	1166645	1168554	A05p02050.2_BraZ1	1097.24	-	618	1835	1909	0.9612362
A05	1171441	1172122	A05p02060.2_BraZ1	159	-	933	681	681	1.0000000
A05	1172597	1173633	A05p02070.2_BraZ1	849	+	69	668	1036	0.6447877
A05	1175264	1177223	A05p02080.2_BraZ1	195.9	+	552	1841	1959	0.9397652
A05	1178304	1179630	A05p02090.2_BraZ1	753	+	316	1169	1326	0.8815988
A05	1186271	1189314	A05p02100.2_BraZ1	1628.45	+	1107	2916	3043	0.9582649
A05	1190181	1191797	A05p02110.2_BraZ1	1133.01	+	817	1538	1616	0.9517327
A05	1192433	1194856	A05p02120.2_BraZ1	787.696	-	2018	2337	2423	0.9645068
A05	1195868	1195988	A05p02130.2_BraZ1	12	+	113	120	120	1.0000000
A05	1196107	1197729	A05p02140.2_BraZ1	926.545	-	509	1293	1622	0.7971640
A05	1202839	1205050	A05p02150.2_BraZ1	441	+	2136	2084	2211	0.9425599
A05	1205642	1208280	A05p02160.2_BraZ1	1486.65	-	797	2334	2638	0.8847612
A05	1209782	1210540	A05p02170.2_BraZ1	264	+	368	758	758	1.0000000
A05	1210472	1214177	A05p02180.2_BraZ1	1712.58	+	990	2969	3705	0.8013495
A05	1219989	1220178	A05p02190.2_BraZ1	18.9	+	523	189	189	1.0000000
A05	1222161	1222429	A05p02200.2_BraZ1	19.2	-	95	180	268	0.6716418
A05	1235886	1236198	A05p02210.2_BraZ1	31.2	+	47	295	312	0.9455128
A05	1239192	1240253	A05p02220.2_BraZ1	732	-	327	881	1061	0.8303487
A05	1245848	1246626	A05p02230.2_BraZ1	206.769	+	206	651	778	0.8367609
A05	1248469	1249427	A05p02240.2_BraZ1	655.385	+	99	355	958	0.3705637
A05	1250086	1252607	A05p02250.2_BraZ1	1101.14	-	351	1606	2521	0.6370488
A05	1256359	1257764	A05p02260.2_BraZ1	561.65	-	132	754	1405	0.5366548
A05	1258015	1258594	A05p02270.2_BraZ1	76.8	-	100	499	579	0.8618308
A05	1263488	1264474	A05p02280.2_BraZ1	627.429	+	193	820	986	0.8316430
A05	1265778	1267434	A05p02290.2_BraZ1	371.25	+	1347	1535	1656	0.9269324
A05	1269169	1271211	A05p02300.2_BraZ1	1455	-	511	1835	2042	0.8986288
A05	1288867	1289530	A05p02310.2_BraZ1	171	+	60	471	663	0.7104073
A05	1291311	1292196	A05p02320.2_BraZ1	330	-	243	684	885	0.7728813
A05	1296779	1297421	A05p02330.2_BraZ1	64.2	-	130	626	642	0.9750779
A05	1300608	1300866	A05p02340.2_BraZ1	25.8	+	389	258	258	1.0000000
A05	1301513	1302300	A05p02350.2_BraZ1	348	-	1033	787	787	1.0000000
A05	1303286	1306080	A05p02360.2_BraZ1	1387.92	+	2135	2754	2794	0.9856836
A05	1306237	1307232	A05p02370.2_BraZ1	521.286	-	324	992	995	0.9969849
A05	1308306	1310915	A05p02380.2_BraZ1	1168.17	+	1978	2609	2609	1.0000000
A05	1311202	1312934	A05p02390.2_BraZ1	1133.12	-	490	1569	1732	0.9058892
A05	1317216	1319300	A05p02400.2_BraZ1	1468.17	+	627	2070	2084	0.9932821
A05	1319858	1323994	A05p02410.2_BraZ1	2656.92	+	1778	4096	4136	0.9903288
A05	1324364	1325803	A05p02420.2_BraZ1	816.136	-	729	1414	1439	0.9826268
A05	1327181	1329271	A05p02430.2_BraZ1	1267.68	+	489	1752	2090	0.8382775
A05	1330129	1331974	A05p02440.2_BraZ1	893.697	-	372	1571	1845	0.8514905
A05	1338546	1340463	A05p02450.2_BraZ1	1403.22	+	730	1917	1917	1.0000000
A05	1343351	1344233	A05p02460.2_BraZ1	88.2	+	596	799	882	0.9058957
A05	1348258	1350118	A05p02470.2_BraZ1	1112.65	+	352	1733	1860	0.9317204
A05	1350295	1353505	A05p02480.2_BraZ1	1538.12	-	1127	2859	3210	0.8906542
A05	1355502	1357211	A05p02490.2_BraZ1	1182.6	+	456	1413	1709	0.8267993
A05	1357477	1359731	A05p02500.2_BraZ1	906.4	-	1378	2228	2254	0.9884650
A05	1360410	1364271	A05p02510.2_BraZ1	2178.13	-	1687	3836	3861	0.9935250
A05	1365603	1366036	A05p02520.2_BraZ1	39.3	+	158	433	433	1.0000000
A05	1367875	1368372	A05p02530.2_BraZ1	261	+	215	497	497	1.0000000
A05	1369281	1369668	A05p02540.2_BraZ1	38.7	+	163	370	387	0.9560723
A05	1371105	1371538	A05p02550.2_BraZ1	39.3	+	341	433	433	1.0000000
A05	1372999	1373389	A05p02560.2_BraZ1	39	+	300	390	390	1.0000000
A05	1375322	1380703	A05p02570.2_BraZ1	2693.55	-	1414	5082	5381	0.9444341
A05	1384674	1385400	A05p02580.2_BraZ1	72	-	140	700	726	0.9641873
A05	1385796	1388674	A05p02590.2_BraZ1	2265	-	462	2390	2878	0.8304378
A05	1415206	1420653	A05p02600.2_BraZ1	2476.05	-	4258	5437	5447	0.9981641
A05	1422302	1424211	A05p02610.2_BraZ1	237.5	-	586	1756	1909	0.9198533
A05	1425038	1427323	A05p02620.2_BraZ1	1008.66	-	1378	2258	2285	0.9881838
A05	1433520	1436266	A05p02630.2_BraZ1	2673	+	402	2377	2746	0.8656227
A05	1436653	1442015	A05p02640.2_BraZ1	2353.73	-	1678	3389	5362	0.6320403
A05	1442468	1443560	A05p02650.2_BraZ1	1801.8	-	277	1092	1092	1.0000000
A05	1444192	1446970	A05p02660.2_BraZ1	965.7	-	758	2582	2778	0.9294456
A05	1452003	1454222	A05p02670.2_BraZ1	1513.34	-	945	2006	2219	0.9040108
A05	1455140	1456479	A05p02680.2_BraZ1	813	-	3	114	1339	0.0851382
A05	1458634	1463678	A05p02690.2_BraZ1	1099.29	+	312	2650	5044	0.5253767
A05	1465491	1466502	A05p02700.2_BraZ1	101.1	+	159	742	1011	0.7339268
A05	1470818	1472238	A05p02710.2_BraZ1	861	+	211	1363	1420	0.9598591
A05	1474339	1475190	A05p02720.2_BraZ1	1696.5	+	741	851	851	1.0000000
A05	1475413	1479651	A05p02730.2_BraZ1	2999.64	-	2193	4018	4238	0.9480887
A05	1479799	1480641	A05p02740.2_BraZ1	192	-	312	793	842	0.9418052
A05	1480812	1484840	A05p02750.2_BraZ1	3208.63	-	206	2484	4028	0.6166832
A05	1487652	1489657	A05p02760.2_BraZ1	1033.23	-	844	1921	2005	0.9581047
A05	1491042	1492185	A05p02770.2_BraZ1	114.3	-	176	1039	1143	0.9090114
A05	1495344	1497010	A05p02780.2_BraZ1	786	+	311	1280	1666	0.7683073
A05	1497958	1499166	A05p02790.2_BraZ1	621.273	-	296	1144	1208	0.9470199
A05	1500094	1501803	A05p02800.2_BraZ1	713.143	-	892	1709	1709	1.0000000
A05	1503051	1503575	A05p02810.2_BraZ1	426	-	132	524	524	1.0000000
A05	1504948	1506574	A05p02820.2_BraZ1	846.435	+	792	1587	1626	0.9760147
A05	1507842	1508334	A05p02830.2_BraZ1	49.2	-	4	170	492	0.3455285
A05	1510222	1510645	A05p02840.2_BraZ1	42.3	+	225	406	423	0.9598109
A05	1514137	1516097	A05p02850.2_BraZ1	1116	+	213	1503	1960	0.7668368
A05	1517701	1518312	A05p02860.2_BraZ1	483	+	580	609	611	0.9967267
A05	1519018	1522562	A05p02870.2_BraZ1	1539.56	-	2796	3189	3544	0.8998307
A05	1523671	1524410	A05p02880.2_BraZ1	7056	-	318	735	739	0.9945873
A05	1530205	1531713	A05p02890.2_BraZ1	981	+	330	1443	1508	0.9568965
A05	1536121	1536460	A05p02900.2_BraZ1	33.9	+	149	339	339	1.0000000
A05	1538907	1541238	A05p02910.2_BraZ1	1620	+	2196	2331	2331	1.0000000
A05	1541920	1542415	A05p02920.2_BraZ1	429	+	160	495	495	1.0000000
A05	1543113	1544136	A05p02930.2_BraZ1	102.3	-	543	1023	1023	1.0000000
A05	1546050	1546701	A05p02940.2_BraZ1	65.1	+	100	630	651	0.9677419
A05	1548105	1548754	A05p02950.2_BraZ1	61.2	+	435	649	649	1.0000000
A05	1549678	1550389	A05p02960.2_BraZ1	71.1	+	146	711	711	1.0000000
A05	1550568	1551425	A05p02970.2_BraZ1	56.4	-	464	834	857	0.9731622
A05	1553408	1559789	A05p02980.2_BraZ1	635.25	-	2946	5776	6381	0.9051872
A05	1561534	1562534	A05p02990.2_BraZ1	549.88	-	265	877	1000	0.8770000
A05	1562994	1565060	A05p03000.2_BraZ1	1404.35	-	640	1904	2066	0.9215876
A05	1566132	1567711	A05p03010.2_BraZ1	810	-	230	1099	1579	0.6960101
A05	1568445	1569069	A05p03020.2_BraZ1	62.4	+	94	513	624	0.8221154
A05	1572997	1574033	A05p03030.2_BraZ1	735	+	287	1015	1036	0.9797297
A05	1576971	1579500	A05p03040.2_BraZ1	1453.46	-	1733	2494	2529	0.9861605
A05	1580888	1582482	A05p03050.2_BraZ1	132.3	-	1029	1594	1594	1.0000000
A05	1583606	1588123	A05p03060.2_BraZ1	1256.6	-	825	2963	4517	0.6559663
A05	1589574	1591185	A05p03070.2_BraZ1	366	-	496	1611	1611	1.0000000
A05	1596789	1599093	A05p03080.2_BraZ1	1588.12	-	153	1215	2304	0.5273438
A05	1600065	1601322	A05p03090.2_BraZ1	637.5	-	111	769	1257	0.6117741
A05	1603658	1605106	A05p03100.2_BraZ1	1633.5	-	787	1448	1448	1.0000000
A05	1608986	1609298	A05p03110.2_BraZ1	31.2	+	30	242	312	0.7756410
A05	1632298	1633349	A05p03120.2_BraZ1	37.2	-	453	1051	1051	1.0000000
A05	1635292	1638008	A05p03130.2_BraZ1	847.8	-	1195	2637	2716	0.9709131
A05	1638430	1641077	A05p03140.2_BraZ1	1635.79	+	2614	2630	2647	0.9935777
A05	1641762	1684919	A05p03150.2_BraZ1	1002	+	17194	36546	43157	0.8468151
A05	1643048	1645999	A05p03160.2_BraZ1	1053.82	-	1366	2704	2951	0.9162996
A05	1660746	1663552	A05p03170.2_BraZ1	1962.14	+	748	2402	2806	0.8560228
A05	1664689	1669280	A05p03180.2_BraZ1	2367.47	-	1462	4321	4591	0.9411893
A05	1681141	1681678	A05p03190.2_BraZ1	53.7	+	2	62	537	0.1154562
A05	1683211	1684399	A05p03200.2_BraZ1	210	+	56	726	1188	0.6111111
A05	1688741	1689092	A05p03210.2_BraZ1	35.1	+	68	164	351	0.4672365
A05	1691041	1691965	A05p03220.2_BraZ1	92.4	+	28	637	924	0.6893939
A05	1692437	1695350	A05p03230.2_BraZ1	1807.82	-	1002	2089	2913	0.7171301
A05	1699446	1700870	A05p03240.2_BraZ1	1233	+	677	1226	1424	0.8609551
A05	1703490	1707530	A05p03250.2_BraZ1	691.297	-	1473	3340	4040	0.8267327
A05	1710005	1710850	A05p03260.2_BraZ1	422.795	+	12	206	845	0.2437870
A05	1712739	1715541	A05p03270.2_BraZ1	1104.87	+	807	2727	2802	0.9732334
A05	1718150	1719515	A05p03280.2_BraZ1	136.5	+	362	1365	1365	1.0000000
A05	1722300	1725128	A05p03290.2_BraZ1	1349.04	+	481	1966	2828	0.6951910
A05	1725569	1726812	A05p03300.2_BraZ1	687	-	75	554	1243	0.4456959
A05	1730610	1733459	A05p03310.2_BraZ1	896.5	+	921	2761	2849	0.9691120
A05	1737957	1739044	A05p03320.2_BraZ1	235.2	+	963	865	1087	0.7957681
A05	1740062	1740699	A05p03330.2_BraZ1	483	+	269	610	637	0.9576138
A05	1752476	1754390	A05p03340.2_BraZ1	191.4	+	35	312	1914	0.1630094
A05	1754788	1754983	A05p03350.2_BraZ1	19.5	-	0	0	195	0.0000000
A05	1756043	1757068	A05p03360.2_BraZ1	429.2	+	34	489	1025	0.4770732
A05	1766019	1767674	A05p03370.2_BraZ1	1014.16	-	632	1213	1655	0.7329305
A05	1768498	1770756	A05p03380.2_BraZ1	1121.62	-	1414	2232	2258	0.9884854
A05	1772494	1775921	A05p03390.2_BraZ1	2420.36	-	1402	3216	3427	0.9384301
A05	1781079	1784065	A05p03400.2_BraZ1	1179	+	463	2481	2986	0.8308774
A05	1784338	1785151	A05p03410.2_BraZ1	406.12	-	605	813	813	1.0000000
A05	1785965	1787628	A05p03420.2_BraZ1	713.963	+	622	1515	1663	0.9110042
A05	1788046	1788580	A05p03430.2_BraZ1	318	-	203	534	534	1.0000000
A05	1788706	1789004	A05p03440.2_BraZ1	18.6	-	116	298	298	1.0000000
A05	1789635	1793168	A05p03450.2_BraZ1	1686.04	-	1614	3416	3533	0.9668837
A05	1796138	1800297	A05p03460.2_BraZ1	2180.75	+	1254	3638	4159	0.8747295
A05	1800446	1801420	A05p03470.2_BraZ1	78.9	+	377	958	974	0.9835729
A05	1802584	1804523	A05p03480.2_BraZ1	968.632	+	450	1455	1939	0.7503868
A05	1805018	1806680	A05p03490.2_BraZ1	166.2	+	576	1528	1662	0.9193742
A05	1806895	1807678	A05p03500.2_BraZ1	78.3	-	138	697	783	0.8901660
A05	1808601	1810584	A05p03510.2_BraZ1	1307.64	-	792	1387	1983	0.6994453
A05	1812953	1814522	A05p03520.2_BraZ1	156.9	-	358	1161	1569	0.7399617
A05	1823214	1824357	A05p03530.2_BraZ1	1053	+	712	1142	1143	0.9991251
A05	1824788	1827844	A05p03540.2_BraZ1	819	-	4503	2786	3056	0.9116492
A05	1834118	1834277	A05p03550.2_BraZ1	15.9	+	158	159	159	1.0000000
A05	1834291	1836791	A05p03560.2_BraZ1	1460.41	+	1392	2483	2500	0.9932000
A05	1837472	1840398	A05p03570.2_BraZ1	1722.39	-	1117	2664	2926	0.9104580
A05	1843431	1845479	A05p03580.2_BraZ1	1578	+	608	1959	2048	0.9565430
A05	1846450	1847361	A05p03590.2_BraZ1	162.75	+	273	889	911	0.9758507
A05	1854066	1854540	A05p03600.2_BraZ1	47.4	+	5	22	474	0.0464135
A05	1856290	1859066	A05p03610.2_BraZ1	1436.69	-	1638	2776	2776	1.0000000
A05	1859949	1864229	A05p03620.2_BraZ1	856.974	+	1896	4085	4280	0.9544392
A05	1865132	1865909	A05p03630.2_BraZ1	77.7	+	433	777	777	1.0000000
A05	1878042	1880198	A05p03640.2_BraZ1	738.833	+	1455	2106	2156	0.9768089
A05	1885513	1887158	A05p03650.2_BraZ1	935	+	620	1624	1645	0.9872341
A05	1889578	1890548	A05p03660.2_BraZ1	7062	-	294	914	970	0.9422680
A05	1891698	1895364	A05p03670.2_BraZ1	941.482	-	837	3187	3666	0.8693399
A05	1907234	1909229	A05p03680.2_BraZ1	786	+	582	1187	1995	0.5949875
A05	1913174	1917559	A05p03690.2_BraZ1	2571.63	+	1026	3762	4385	0.8579248
A05	1918577	1920006	A05p03700.2_BraZ1	813.462	+	718	1424	1429	0.9965010
A05	1920707	1922965	A05p03710.2_BraZ1	1311.58	+	1001	2054	2258	0.9096546
A05	1924101	1928281	A05p03720.2_BraZ1	3315	+	847	3532	4180	0.8449761
A05	1928619	1928794	A05p03730.2_BraZ1	13.5	-	241	175	175	1.0000000
A05	1929148	1930512	A05p03740.2_BraZ1	6375	+	336	899	1364	0.6590909
A05	1934300	1936236	A05p03750.2_BraZ1	1512	+	216	1573	1936	0.8125000
A05	1941241	1941869	A05p03760.2_BraZ1	543	+	300	596	628	0.9490446
A05	1943727	1943919	A05p03770.2_BraZ1	19.2	-	1	36	192	0.1875000
A05	1945793	1947654	A05p03780.2_BraZ1	1032.29	-	392	1842	1861	0.9897904
A05	1953158	1956572	A05p03790.2_BraZ1	1722.58	+	2175	3315	3414	0.9710017
A05	1957070	1960645	A05p03800.2_BraZ1	2418.75	+	1399	3438	3575	0.9616783
A05	1962362	1973858	A05p03810.2_BraZ1	2580.01	-	5134	10989	11496	0.9558977
A05	1974870	1978068	A05p03820.2_BraZ1	1220.4	-	4796	3198	3198	1.0000000
A05	1978515	1979757	A05p03830.2_BraZ1	479.684	-	1137	1242	1242	1.0000000
A05	1981346	1982851	A05p03840.2_BraZ1	816	-	885	1418	1505	0.9421927
A05	1985545	1988581	A05p03850.2_BraZ1	1960.89	-	2284	3036	3036	1.0000000
A05	1991688	1994434	A05p03860.2_BraZ1	2400.62	+	1904	2746	2746	1.0000000
A05	1994773	1995198	A05p03870.2_BraZ1	267	+	342	425	425	1.0000000
A05	1997850	2002923	A05p03880.2_BraZ1	531	+	2791	3334	5073	0.6572048
A05	2003591	2004937	A05p03890.2_BraZ1	4457.25	-	679	1346	1346	1.0000000
A05	2007640	2008120	A05p03900.2_BraZ1	306	+	16	86	480	0.1791667
A05	2009126	2011006	A05p03910.2_BraZ1	849	-	248	911	1880	0.4845745
A05	2013731	2015805	A05p03920.2_BraZ1	828.571	-	1097	2074	2074	1.0000000
A05	2019740	2020859	A05p03930.2_BraZ1	825	-	14	182	1119	0.1626452
A05	2021517	2022062	A05p03940.2_BraZ1	297	+	142	545	545	1.0000000
A05	2022062	2022320	A05p03950.2_BraZ1	516	+	181	258	258	1.0000000
A05	2022487	2023903	A05p03960.2_BraZ1	312.783	-	610	1367	1416	0.9653955
A05	2027532	2029916	A05p03970.2_BraZ1	1350.18	+	1065	2345	2384	0.9836410
A05	2030299	2032279	A05p03980.2_BraZ1	198	+	754	1932	1980	0.9757576
A05	2035202	2035703	A05p03990.2_BraZ1	306	-	5	134	501	0.2674651
A05	2035508	2036659	A05p04000.2_BraZ1	636	-	0	0	1151	0.0000000
A05	2038728	2040938	A05p04010.2_BraZ1	26532	+	1138	2065	2210	0.9343891
A05	2041525	2043311	A05p04020.2_BraZ1	58.5	-	461	1423	1786	0.7967525
A05	2044145	2044800	A05p04030.2_BraZ1	579	-	349	655	655	1.0000000
A05	2045151	2047481	A05p04040.2_BraZ1	1105.37	-	726	2164	2330	0.9287553
A05	2047755	2048732	A05p04050.2_BraZ1	597	+	782	949	977	0.9713408
A05	2048835	2050974	A05p04060.2_BraZ1	848.294	-	1377	2139	2139	1.0000000
A05	2052491	2054490	A05p04070.2_BraZ1	1145.31	+	703	1920	1999	0.9604802
A05	2054821	2056337	A05p04080.2_BraZ1	600	-	553	1340	1516	0.8839050
A05	2059917	2062699	A05p04090.2_BraZ1	2523.39	+	964	2747	2782	0.9874191
A05	2066740	2069785	A05p04100.2_BraZ1	440.1	+	1206	2834	3045	0.9307061
A05	2078604	2080048	A05p04110.2_BraZ1	1000.15	+	141	800	1444	0.5540166
A05	2083054	2089939	A05p04120.2_BraZ1	987.346	+	2544	6139	6885	0.8916485
A05	2091314	2092822	A05p04130.2_BraZ1	1138.53	+	124	794	1508	0.5265252
A05	2093300	2095201	A05p04140.2_BraZ1	510.75	-	1222	1901	1901	1.0000000
A05	2098084	2098929	A05p04150.2_BraZ1	512	-	9	194	845	0.2295858
A05	2098927	2099311	A05p04160.2_BraZ1	126	-	2	79	384	0.2057292
A05	2103074	2104421	A05p04170.2_BraZ1	520.886	-	1799	1347	1347	1.0000000
A05	2105681	2107455	A05p04180.2_BraZ1	858	-	726	1769	1774	0.9971815
A05	2108401	2108524	A05p04190.2_BraZ1	12.3	-	163	123	123	1.0000000
A05	2108690	2111456	A05p04200.2_BraZ1	1460.8	-	1933	2681	2766	0.9692697
A05	2111822	2114455	A05p04210.2_BraZ1	1403.22	-	1712	2629	2633	0.9984808
A05	2114673	2116236	A05p04220.2_BraZ1	156.3	+	1048	1563	1563	1.0000000
A05	2116995	2117604	A05p04230.2_BraZ1	60.9	+	339	609	609	1.0000000
A05	2120085	2120388	A05p04240.2_BraZ1	30.3	+	129	265	303	0.8745875
A05	2121362	2122871	A05p04250.2_BraZ1	150.9	-	379	1305	1509	0.8648111
A05	2123479	2125285	A05p04260.2_BraZ1	8788.5	+	833	1378	1806	0.7630122
A05	2126638	2126773	A05p04270.2_BraZ1	13.5	+	264	135	135	1.0000000
A05	2129659	2130043	A05p04280.2_BraZ1	38.4	+	48	233	384	0.6067708
A05	2130964	2132972	A05p04290.2_BraZ1	1884.81	-	1189	1987	2008	0.9895418
A05	2134414	2137343	A05p04300.2_BraZ1	1143.19	+	1422	2886	2929	0.9853192
A05	2139066	2140147	A05p04310.2_BraZ1	630.5	-	295	1021	1081	0.9444959
A05	2146514	2147804	A05p04320.2_BraZ1	129	+	893	1290	1290	1.0000000
A05	2147997	2149520	A05p04330.2_BraZ1	11196.5	-	509	1437	1523	0.9435325
A05	2150842	2152974	A05p04340.2_BraZ1	871.488	+	830	2101	2132	0.9854597
A05	2153832	2156381	A05p04350.2_BraZ1	1629.69	+	722	2499	2549	0.9803845
A05	2156924	2158757	A05p04360.2_BraZ1	1239.34	+	603	1833	1833	1.0000000
A05	2159236	2160979	A05p04370.2_BraZ1	1282.91	+	302	948	1743	0.5438898
A05	2163827	2173870	A05p04380.2_BraZ1	504.146	+	2846	5248	10043	0.5225530
A05	2174826	2176597	A05p04390.2_BraZ1	849.643	+	779	1693	1771	0.9559571
A05	2176567	2177056	A05p04400.2_BraZ1	363	+	117	408	489	0.8343558
A05	2179112	2189938	A05p04410.2_BraZ1	1077.01	+	2943	6798	10826	0.6279327
A05	2195770	2199291	A05p04420.2_BraZ1	412.976	+	0	0	3521	0.0000000
A05	2205141	2207608	A05p04430.2_BraZ1	597.622	+	433	1721	2467	0.6976084
A05	2208997	2211236	A05p04440.2_BraZ1	853.517	-	1436	2239	2239	1.0000000
A05	2212278	2214778	A05p04450.2_BraZ1	1151.81	-	861	2213	2500	0.8852000
A05	2216142	2217334	A05p04460.2_BraZ1	6090	-	625	1131	1192	0.9488255
A05	2221342	2221900	A05p04470.2_BraZ1	54.3	+	313	558	558	1.0000000
A05	2224680	2225409	A05p04480.2_BraZ1	72.9	-	6	328	729	0.4499314
A05	2228354	2229116	A05p04490.2_BraZ1	76.2	+	689	755	762	0.9908137
A05	2231211	2232411	A05p04500.2_BraZ1	120	+	272	1151	1200	0.9591666
A05	2232471	2234604	A05p04510.2_BraZ1	975.333	+	2101	2133	2133	1.0000000
A05	2236287	2238538	A05p04520.2_BraZ1	1707.36	+	1068	2116	2251	0.9400266
A05	2239092	2240943	A05p04530.2_BraZ1	852.043	-	405	1704	1851	0.9205835
A05	2247900	2262593	A05p04540.2_BraZ1	1836.88	+	4915	11765	14693	0.8007214
A05	2265988	2270978	A05p04550.2_BraZ1	1325.11	+	1391	4546	4990	0.9110221
A05	2276490	2280447	A05p04560.2_BraZ1	1326.09	+	550	2123	3957	0.5365176
A05	2283552	2325402	A05p04570.2_BraZ1	792.9	+	27853	38785	41850	0.9267622
A05	2335393	2337428	A05p04580.2_BraZ1	1519.09	+	681	1996	2035	0.9808354
A05	2338342	2339877	A05p04590.2_BraZ1	734.4	+	1967	1445	1535	0.9413681
A05	2340516	2341771	A05p04600.2_BraZ1	502.313	+	610	1224	1255	0.9752988
A05	2346079	2346262	A05p04610.2_BraZ1	18.3	-	131	183	183	1.0000000
A05	2347206	2348049	A05p04620.2_BraZ1	396	-	1695	843	843	1.0000000
A05	2350264	2361633	A05p04630.2_BraZ1	1218.75	-	965	3647	11369	0.3207846
A05	2354000	2354982	A05p04640.2_BraZ1	257.5	+	0	0	982	0.0000000
A05	2364249	2366240	A05p04650.2_BraZ1	1938.75	-	85	777	1991	0.3902562
A05	2372272	2372710	A05p04660.2_BraZ1	43.8	-	222	438	438	1.0000000
A05	2373675	2375466	A05p04670.2_BraZ1	115.2	-	756	1784	1791	0.9960915
A05	2377508	2378342	A05p04680.2_BraZ1	83.4	+	208	777	834	0.9316547
A05	2380904	2383214	A05p04690.2_BraZ1	627	-	828	2254	2310	0.9757576
A05	2384274	2384827	A05p04700.2_BraZ1	366	+	229	553	553	1.0000000
A05	2385428	2387688	A05p04710.2_BraZ1	1386	+	756	2240	2260	0.9911504
A05	2387885	2388809	A05p04720.2_BraZ1	324.211	-	211	872	924	0.9437230
A05	2389592	2391303	A05p04730.2_BraZ1	1443.27	-	615	1572	1711	0.9187610
A05	2394417	2395399	A05p04740.2_BraZ1	279	+	32	17	982	0.0173116
A05	2396927	2397301	A05p04750.2_BraZ1	276	+	138	374	374	1.0000000
A05	2398442	2399721	A05p04760.2_BraZ1	703.5	-	366	1279	1279	1.0000000
A05	2400895	2402161	A05p04770.2_BraZ1	607.091	+	1820	1264	1266	0.9984202
A05	2403003	2406588	A05p04780.2_BraZ1	2246.23	+	990	3136	3585	0.8747559
A05	2407730	2408639	A05p04790.2_BraZ1	90.9	-	138	763	909	0.8393840
A05	2408773	2409031	A05p04800.2_BraZ1	25.8	-	21	250	258	0.9689922
A05	2409514	2410499	A05p04810.2_BraZ1	750	+	756	985	985	1.0000000
A05	2411908	2412724	A05p04820.2_BraZ1	81.6	+	879	816	816	1.0000000
A05	2413453	2415063	A05p04830.2_BraZ1	1377	+	388	1319	1610	0.8192546
A05	2415562	2428527	A05p04840.2_BraZ1	587.925	-	734	5207	12965	0.4016197
A05	2434587	2434713	A05p04850.2_BraZ1	12.6	+	17	72	126	0.5714286
A05	2435606	2437090	A05p04860.2_BraZ1	636.632	-	229	1221	1484	0.8227763
A05	2439235	2441160	A05p04870.2_BraZ1	1250.89	-	1347	1925	1925	1.0000000
A05	2443058	2444018	A05p04880.2_BraZ1	621	-	320	940	960	0.9791667
A05	2447426	2449036	A05p04890.2_BraZ1	1121.54	+	298	1279	1610	0.7944099
A05	2460762	2461327	A05p04900.2_BraZ1	306	-	66	411	565	0.7274336
A05	2466906	2467492	A05p04910.2_BraZ1	858	-	1238	586	586	1.0000000
A05	2468793	2470134	A05p04920.2_BraZ1	134.1	+	237	1103	1341	0.8225205
A05	2478327	2479748	A05p04930.2_BraZ1	373.597	-	2032	1421	1421	1.0000000
A05	2483696	2484593	A05p04940.2_BraZ1	531.097	+	961	897	897	1.0000000
A05	2491101	2493826	A05p04950.2_BraZ1	2088	+	789	2450	2725	0.8990825
A05	2496052	2496751	A05p04960.2_BraZ1	69.9	+	68	545	699	0.7796853
A05	2498935	2500568	A05p04970.2_BraZ1	5920	-	496	1601	1633	0.9804041
A05	2506598	2508034	A05p04980.2_BraZ1	485.226	+	1259	1436	1436	1.0000000
A05	2508832	2509649	A05p04990.2_BraZ1	396	+	221	572	817	0.7001224
A05	2511230	2520901	A05p05000.2_BraZ1	3118.29	-	3840	9143	9671	0.9454038
A05	2523909	2524758	A05p05010.2_BraZ1	84.9	+	57	471	849	0.5547703
A05	2530484	2535030	A05p05020.2_BraZ1	2435.74	-	2493	4512	4546	0.9925209
A05	2535733	2538460	A05p05030.2_BraZ1	1365.25	-	1065	2303	2727	0.8445178
A05	2538760	2542886	A05p05040.2_BraZ1	2483.45	-	1568	3906	4126	0.9466796
A05	2543202	2546441	A05p05050.2_BraZ1	1985.98	+	1050	3153	3239	0.9734486
A05	2546867	2548381	A05p05060.2_BraZ1	738	+	1066	1514	1514	1.0000000
A05	2549480	2553793	A05p05070.2_BraZ1	2169.39	+	587	2645	4313	0.6132622
A05	2554781	2555819	A05p05080.2_BraZ1	102.9	+	426	1038	1038	1.0000000
A05	2558082	2558476	A05p05090.2_BraZ1	294	-	45	227	394	0.5761421
A05	2566850	2567702	A05p05100.2_BraZ1	777	+	135	836	852	0.9812207
A05	2569739	2569994	A05p05110.2_BraZ1	25.5	-	122	255	255	1.0000000
A05	2575551	2576350	A05p05120.2_BraZ1	669	+	7	276	799	0.3454318
A05	2579626	2582958	A05p05130.2_BraZ1	863.425	+	1523	2880	3332	0.8643457
A05	2583463	2589470	A05p05140.2_BraZ1	2935.91	-	1899	5735	6007	0.9547195
A05	2593036	2596131	A05p05150.2_BraZ1	1079.22	+	1098	3051	3095	0.9857835
A05	2596511	2597804	A05p05160.2_BraZ1	129.3	-	312	1186	1293	0.9172467
A05	2598423	2600957	A05p05170.2_BraZ1	1298.7	+	1545	2507	2534	0.9893449
A05	2601802	2603285	A05p05180.2_BraZ1	1038.67	+	363	1483	1483	1.0000000
A05	2604567	2604910	A05p05190.2_BraZ1	243	+	159	343	343	1.0000000
A05	2606532	2606887	A05p05200.2_BraZ1	140.571	+	24	345	355	0.9718310
A05	2610739	2611606	A05p05210.2_BraZ1	289.714	+	252	867	867	1.0000000
A05	2612785	2615028	A05p05220.2_BraZ1	732.6	+	1525	2243	2243	1.0000000
A05	2615546	2618355	A05p05230.2_BraZ1	1644.98	+	532	2369	2809	0.8433606
A05	2619079	2630732	A05p05240.2_BraZ1	643.933	+	4992	10380	11653	0.8907577
A05	2621211	2623980	A05p05250.2_BraZ1	341.714	-	952	2306	2769	0.8327916
A05	2631663	2636721	A05p05260.2_BraZ1	561	-	2102	4455	5058	0.8807829
A05	2634026	2634381	A05p05270.2_BraZ1	246	+	38	355	355	1.0000000
A05	2640842	2641194	A05p05280.2_BraZ1	243	+	59	352	352	1.0000000
A05	2643903	2645057	A05p05290.2_BraZ1	557.094	-	689	1098	1154	0.9514731
A05	2649787	2652409	A05p05300.2_BraZ1	1890	+	595	2131	2622	0.8127384
A05	2652580	2654413	A05p05310.2_BraZ1	183.3	-	834	1734	1833	0.9459902
A05	2657133	2657886	A05p05320.2_BraZ1	666	+	231	753	753	1.0000000
A05	2658038	2659241	A05p05330.2_BraZ1	811.657	-	750	1203	1203	1.0000000
A05	2659895	2661481	A05p05340.2_BraZ1	832.105	-	589	1520	1586	0.9583859
A05	2663218	2664023	A05p05350.2_BraZ1	28.8	-	27	608	805	0.7552795
A05	2664607	2666670	A05p05360.2_BraZ1	105.9	-	464	1865	2063	0.9040233
A05	2671646	2672307	A05p05370.2_BraZ1	567	-	482	661	661	1.0000000
A05	2678031	2679676	A05p05380.2_BraZ1	762	+	692	1636	1645	0.9945289
A05	2690205	2691141	A05p05390.2_BraZ1	93.6	+	24	116	936	0.1239316
A05	2700949	2702434	A05p05400.2_BraZ1	988.2	+	716	1387	1485	0.9340068
A05	2703082	2703551	A05p05410.2_BraZ1	279	-	107	372	469	0.7931769
A05	2706313	2710473	A05p05420.2_BraZ1	2085.52	-	1355	3924	4160	0.9432693
A05	2716928	2718179	A05p05430.2_BraZ1	125.1	-	102	919	1251	0.7346123
A05	2719123	2723250	A05p05440.2_BraZ1	853.71	-	825	3095	4127	0.7499394
A05	2724102	2726740	A05p05450.2_BraZ1	1271.56	-	2383	2588	2638	0.9810463
A05	2727958	2730340	A05p05460.2_BraZ1	1661.14	+	819	2329	2382	0.9777498
A05	2730646	2731705	A05p05470.2_BraZ1	367.5	-	363	887	1059	0.8375826
A05	2732710	2746251	A05p05480.2_BraZ1	8122.33	-	2923	10280	13541	0.7591758
A05	2747980	2751899	A05p05490.2_BraZ1	153.6	-	1306	3229	3919	0.8239347
A05	2756683	2757479	A05p05500.2_BraZ1	480	-	0	0	796	0.0000000
A05	2757588	2758404	A05p05510.2_BraZ1	409.5	-	0	0	816	0.0000000
A05	2761647	2762685	A05p05520.2_BraZ1	963	-	407	963	1038	0.9277456
A05	2764722	2769018	A05p05530.2_BraZ1	530.58	-	1796	3911	4296	0.9103817
A05	2769792	2771644	A05p05540.2_BraZ1	996	+	781	1398	1852	0.7548596
A05	2772607	2773513	A05p05550.2_BraZ1	603.75	+	224	482	906	0.5320088
A05	2786249	2787224	A05p05560.2_BraZ1	97.5	+	23	313	975	0.3210256
A05	2788037	2789012	A05p05570.2_BraZ1	97.5	+	114	718	975	0.7364103
A05	2794790	2796032	A05p05580.2_BraZ1	323.071	-	1175	1242	1242	1.0000000
A05	2799836	2801699	A05p05590.2_BraZ1	450	+	186	1042	1863	0.5593129
A05	2803953	2806466	A05p05600.2_BraZ1	597.058	-	970	2337	2513	0.9299642
A05	2813490	2814468	A05p05610.2_BraZ1	97.8	-	333	838	978	0.8568507
A05	2815998	2818117	A05p05620.2_BraZ1	1061.68	-	764	2001	2119	0.9443133
A05	2818646	2818913	A05p05630.2_BraZ1	150	+	291	267	267	1.0000000
A05	2821051	2822680	A05p05640.2_BraZ1	162.9	+	779	1523	1629	0.9349294
A05	2823897	2825169	A05p05650.2_BraZ1	415.275	+	896	1272	1272	1.0000000
A05	2826205	2828946	A05p05660.2_BraZ1	902.025	+	998	2552	2741	0.9310471
A05	2830456	2839038	A05p05670.2_BraZ1	1977.34	+	1079	4358	8582	0.5078070
A05	2844883	2845489	A05p05680.2_BraZ1	60.6	-	388	606	606	1.0000000
A05	2849283	2849843	A05p05690.2_BraZ1	720	+	0	0	560	0.0000000
A05	2851635	2853906	A05p05700.2_BraZ1	1067.26	+	1310	2256	2271	0.9933950
A05	2854975	2856822	A05p05710.2_BraZ1	738.775	+	1339	1779	1847	0.9631835
A05	2857186	2857960	A05p05720.2_BraZ1	690	-	408	774	774	1.0000000
A05	2859039	2860567	A05p05730.2_BraZ1	579	-	923	1468	1528	0.9607330
A05	2862036	2864020	A05p05740.2_BraZ1	1407.97	+	740	1617	1984	0.8150201
A05	2864371	2864841	A05p05750.2_BraZ1	210	+	63	415	470	0.8829787
A05	2865381	2865827	A05p05760.2_BraZ1	236.757	-	373	396	446	0.8878924
A05	2866406	2869474	A05p05770.2_BraZ1	1908	-	826	2893	3068	0.9429596
A05	2869864	2870202	A05p05780.2_BraZ1	291	+	96	338	338	1.0000000
A05	2870875	2873254	A05p05790.2_BraZ1	1383	+	1004	2001	2379	0.8411097
A05	2873732	2876171	A05p05800.2_BraZ1	1483.51	-	672	2224	2439	0.9118491
A05	2881036	2884366	A05p05810.2_BraZ1	2260.58	+	1780	2918	3330	0.8762763
A05	2885322	2886578	A05p05820.2_BraZ1	693	+	1076	1256	1256	1.0000000
A05	2887205	2889217	A05p05830.2_BraZ1	904.906	-	1853	2012	2012	1.0000000
A05	2892325	2893779	A05p05840.2_BraZ1	46924.5	+	528	1439	1454	0.9896836
A05	2894449	2896075	A05p05850.2_BraZ1	162.6	-	448	1611	1626	0.9907749
A05	2901121	2901636	A05p05860.2_BraZ1	423	-	485	515	515	1.0000000
A05	2901634	2902001	A05p05870.2_BraZ1	195	+	380	367	367	1.0000000
A05	2903127	2903478	A05p05880.2_BraZ1	216	-	49	272	351	0.7749287
A05	2908855	2909671	A05p05890.2_BraZ1	729	-	988	816	816	1.0000000
A05	2910427	2912003	A05p05900.2_BraZ1	739.904	+	1815	1576	1576	1.0000000
A05	2912099	2912983	A05p05910.2_BraZ1	600.357	-	628	884	884	1.0000000
A05	2913733	2915415	A05p05920.2_BraZ1	1596	-	1014	1620	1682	0.9631391
A05	2918034	2919708	A05p05930.2_BraZ1	167.4	+	1291	1674	1674	1.0000000
A05	2920074	2923395	A05p05940.2_BraZ1	2355.12	-	1933	3264	3321	0.9828365
A05	2924462	2926421	A05p05950.2_BraZ1	1099.11	-	1699	1959	1959	1.0000000
A05	2927000	2928050	A05p05960.2_BraZ1	105	-	381	1050	1050	1.0000000
A05	2928688	2930376	A05p05970.2_BraZ1	880.312	+	7	661	1688	0.3915877
A05	2936095	2938064	A05p05980.2_BraZ1	839.849	+	2034	1969	1969	1.0000000
A05	2938258	2939392	A05p05990.2_BraZ1	378.454	+	2267	1134	1134	1.0000000
A05	2939884	2941338	A05p06000.2_BraZ1	949.263	-	1489	1450	1454	0.9972489
A05	2942463	2944486	A05p06010.2_BraZ1	1491	-	1025	1977	2023	0.9772615
A05	2945832	2946474	A05p06020.2_BraZ1	64.2	+	422	642	642	1.0000000
A05	2951892	2954278	A05p06030.2_BraZ1	1725	+	759	1827	2386	0.7657167
A05	2961423	2962062	A05p06040.2_BraZ1	63.9	+	126	593	639	0.9280125
A05	2964991	2965459	A05p06050.2_BraZ1	1140	-	333	453	468	0.9679487
A05	2966326	2968065	A05p06060.2_BraZ1	1256.84	-	813	1721	1739	0.9896492
A05	2969479	2970603	A05p06070.2_BraZ1	360	-	1278	1124	1124	1.0000000
A05	2971725	2973756	A05p06080.2_BraZ1	754.056	-	1224	1972	2031	0.9709502
A05	2975682	2977716	A05p06090.2_BraZ1	973.677	+	820	1475	2034	0.7251721
A05	2982532	2983270	A05p06100.2_BraZ1	71.1	+	174	738	738	1.0000000
A05	2987183	2987927	A05p06110.2_BraZ1	74.4	+	256	639	744	0.8588710
A05	2990355	2990807	A05p06120.2_BraZ1	24.3	-	35	421	452	0.9314159
A05	2993349	2995002	A05p06130.2_BraZ1	987.545	+	408	1283	1653	0.7761645
A05	2999188	3001015	A05p06140.2_BraZ1	1012.5	-	891	1631	1827	0.8927203
A05	3019124	3020420	A05p06150.2_BraZ1	129.6	+	472	1295	1296	0.9992284
A05	3024931	3025434	A05p06160.2_BraZ1	414	+	430	503	503	1.0000000
A05	3034842	3035796	A05p06170.2_BraZ1	95.4	+	739	946	954	0.9916143
A05	3038180	3040964	A05p06180.2_BraZ1	1226.29	-	1958	2784	2784	1.0000000
A05	3045194	3053060	A05p06190.2_BraZ1	1139.21	-	3616	7042	7866	0.8952454
A05	3046390	3047555	A05p06200.2_BraZ1	186	+	34	648	1165	0.5562232
A05	3047448	3048339	A05p06210.2_BraZ1	469.688	+	615	891	891	1.0000000
A05	3053291	3054396	A05p06220.2_BraZ1	759	+	118	965	1105	0.8733032
A05	3064375	3064730	A05p06230.2_BraZ1	255	+	197	355	355	1.0000000
A05	3065483	3067139	A05p06240.2_BraZ1	165.6	-	795	1614	1656	0.9746377
A05	3070897	3074589	A05p06250.2_BraZ1	2336.54	-	1336	3550	3692	0.9615384
A05	3075485	3075866	A05p06260.2_BraZ1	38.1	+	194	381	381	1.0000000
A05	3081718	3082048	A05p06270.2_BraZ1	33	+	60	294	330	0.8909091
A05	3089742	3092111	A05p06280.2_BraZ1	413.091	+	39	679	2369	0.2866188
A05	3090179	3090710	A05p06290.2_BraZ1	180	+	30	355	531	0.6685499
A05	3093607	3095924	A05p06300.2_BraZ1	1381.47	+	907	1285	2317	0.5545965
A05	3097659	3098804	A05p06310.2_BraZ1	651	-	65	684	1145	0.5973799
A05	3100309	3103145	A05p06320.2_BraZ1	1095.24	+	885	2520	2836	0.8885754
A05	3103456	3106173	A05p06330.2_BraZ1	1715.62	-	364	2257	2717	0.8306956
A05	3107207	3107951	A05p06340.2_BraZ1	513	-	19	237	744	0.3185484
A05	3108512	3109691	A05p06350.2_BraZ1	831	-	1137	1179	1179	1.0000000
A05	3116401	3119138	A05p06360.2_BraZ1	1541.96	+	1289	2587	2737	0.9451955
A05	3123667	3124009	A05p06370.2_BraZ1	34.2	+	126	342	342	1.0000000
A05	3126702	3129308	A05p06380.2_BraZ1	1038.11	+	1697	2601	2606	0.9980813
A05	3129608	3133553	A05p06390.2_BraZ1	1421.54	-	2012	3777	3945	0.9574144
A05	3141624	3142884	A05p06400.2_BraZ1	126	+	819	1260	1260	1.0000000
A05	3144327	3145632	A05p06410.2_BraZ1	870	+	1128	1305	1305	1.0000000
A05	3159491	3160931	A05p06420.2_BraZ1	144	+	829	1440	1440	1.0000000
A05	3162102	3164215	A05p06430.2_BraZ1	910	+	1484	1870	2113	0.8849976
A05	3167470	3168945	A05p06440.2_BraZ1	2269.5	+	1225	1473	1475	0.9986441
A05	3171224	3174554	A05p06450.2_BraZ1	23829	+	3187	3330	3330	1.0000000
A05	3175635	3178667	A05p06460.2_BraZ1	1963	+	1192	2854	3032	0.9412929
A05	3179659	3185110	A05p06470.2_BraZ1	2213.82	-	4383	5404	5451	0.9913777
A05	3187157	3188191	A05p06480.2_BraZ1	934.564	+	279	860	1034	0.8317215
A05	3189259	3194716	A05p06490.2_BraZ1	1109.75	-	1491	4667	5457	0.8552318
A05	3195592	3198163	A05p06500.2_BraZ1	1337.36	-	1007	2306	2571	0.8969272
A05	3207765	3209479	A05p06510.2_BraZ1	1110	+	1084	1672	1714	0.9754959
A05	3213893	3214929	A05p06520.2_BraZ1	960	-	790	1036	1036	1.0000000
A05	3219918	3220852	A05p06530.2_BraZ1	446.25	-	15	296	934	0.3169165
A05	3224635	3226610	A05p06540.2_BraZ1	913.091	-	337	1431	1975	0.7245570
A05	3230272	3234167	A05p06550.2_BraZ1	1553.68	+	2430	3776	3895	0.9694480
A05	3234683	3235846	A05p06560.2_BraZ1	327	-	473	981	1163	0.8435082
A05	3242417	3242580	A05p06570.2_BraZ1	150	+	19	163	163	1.0000000
A05	3249129	3253257	A05p06580.2_BraZ1	1911.67	+	1225	4054	4128	0.9820737
A05	3253671	3255221	A05p06590.2_BraZ1	673.143	-	1257	1474	1550	0.9509677
A05	3256178	3257804	A05p06600.2_BraZ1	1067.9	-	1430	1573	1626	0.9674047
A05	3258883	3259711	A05p06610.2_BraZ1	82.8	+	587	828	828	1.0000000
A05	3260652	3261504	A05p06620.2_BraZ1	85.2	+	1013	852	852	1.0000000
A05	3262494	3263274	A05p06630.2_BraZ1	78	+	500	726	780	0.9307692
A05	3265765	3273094	A05p06640.2_BraZ1	1281.54	+	3629	6672	7329	0.9103561
A05	3274314	3275340	A05p06650.2_BraZ1	102.6	+	494	1005	1026	0.9795322
A05	3281204	3282069	A05p06660.2_BraZ1	618	+	31	482	865	0.5572254
A05	3282822	3284145	A05p06670.2_BraZ1	132.3	+	170	920	1323	0.6953893
A05	3292234	3292525	A05p06680.2_BraZ1	29.1	-	19	85	291	0.2920962
A05	3304999	3305303	A05p06690.2_BraZ1	225	+	0	0	304	0.0000000
A05	3305869	3308134	A05p06700.2_BraZ1	1140.05	-	1046	2188	2265	0.9660044
A05	3310510	3311909	A05p06710.2_BraZ1	559.3	+	1127	804	1399	0.5746962
A05	3312994	3313532	A05p06720.2_BraZ1	23.7	-	478	538	538	1.0000000
A05	3320991	3322237	A05p06730.2_BraZ1	764.237	+	187	1074	1246	0.8619583
A05	3323824	3326360	A05p06740.2_BraZ1	1163.42	-	1123	2045	2536	0.8063880
A05	3327478	3329022	A05p06750.2_BraZ1	1059.63	-	735	1521	1544	0.9851036
A05	3340560	3340764	A05p06760.2_BraZ1	165	+	829	204	204	1.0000000
A05	3341875	3343854	A05p06770.2_BraZ1	12177	+	535	1763	1979	0.8908539
A05	3345749	3348300	A05p06780.2_BraZ1	936.457	+	1530	2539	2551	0.9952959
A05	3349211	3349561	A05p06790.2_BraZ1	246	-	533	350	350	1.0000000
A05	3351001	3351712	A05p06800.2_BraZ1	71.1	+	62	596	711	0.8382560
A05	3353062	3355219	A05p06810.2_BraZ1	1083.13	-	1908	2157	2157	1.0000000
A05	3355610	3355886	A05p06820.2_BraZ1	22.2	-	69	276	276	1.0000000
A05	3357317	3358384	A05p06830.2_BraZ1	528	+	276	982	1067	0.9203374
A05	3362986	3364760	A05p06840.2_BraZ1	1038.09	+	376	1492	1774	0.8410372
A05	3366358	3366636	A05p06850.2_BraZ1	165	-	101	278	278	1.0000000
A05	3367990	3369374	A05p06860.2_BraZ1	1133.36	+	470	1311	1384	0.9472544
A05	3378402	3384858	A05p06870.2_BraZ1	3898.23	+	1639	5754	6456	0.8912640
A05	3385406	3386684	A05p06880.2_BraZ1	202.567	-	1154	1278	1278	1.0000000
A05	3387065	3387609	A05p06890.2_BraZ1	468	-	205	544	544	1.0000000
A05	3388059	3388242	A05p06900.2_BraZ1	18.3	+	79	135	183	0.7377049
A05	3388451	3390547	A05p06910.2_BraZ1	825.702	+	1101	1927	2096	0.9193702
A05	3391532	3391646	A05p06920.2_BraZ1	11.4	+	125	114	114	1.0000000
A05	3392120	3392756	A05p06930.2_BraZ1	519	+	636	636	636	1.0000000
A05	3401030	3402016	A05p06940.2_BraZ1	528.75	+	228	815	986	0.8265720
A05	3402324	3403990	A05p06950.2_BraZ1	439.238	+	821	1666	1666	1.0000000
A05	3404204	3405137	A05p06960.2_BraZ1	93.3	-	410	918	933	0.9839228
A05	3415941	3417870	A05p06970.2_BraZ1	192.9	+	398	1857	1929	0.9626750
A05	3426407	3428345	A05p06980.2_BraZ1	193.2	+	163	1404	1938	0.7244582
A05	3436030	3438037	A05p06990.2_BraZ1	200.7	+	193	1866	2007	0.9297459
A05	3438805	3439498	A05p07000.2_BraZ1	32.6667	+	8	325	693	0.4689755
A05	3439510	3439980	A05p07010.2_BraZ1	1148	+	2	137	470	0.2914894
A05	3448853	3450787	A05p07020.2_BraZ1	102	+	19	503	1934	0.2600827
A05	3459739	3461770	A05p07030.2_BraZ1	203.1	+	432	1941	2031	0.9556869
A05	3463575	3464511	A05p07040.2_BraZ1	93.6	+	237	841	936	0.8985043
A05	3473995	3476239	A05p07050.2_BraZ1	224.4	+	169	1700	2244	0.7575758
A05	3476580	3481607	A05p07060.2_BraZ1	2747.7	-	2035	4877	5027	0.9701611
A05	3483286	3485688	A05p07070.2_BraZ1	333	+	180	1596	2402	0.6644463
A05	3487047	3489795	A05p07080.2_BraZ1	2609.25	+	640	2243	2748	0.8162300
A05	3492220	3493169	A05p07090.2_BraZ1	255	+	240	947	949	0.9978925
A05	3493639	3496744	A05p07100.2_BraZ1	2064.86	+	1001	2507	3105	0.8074074
A05	3497503	3497944	A05p07110.2_BraZ1	44.1	-	331	441	441	1.0000000
A05	3498151	3501108	A05p07120.2_BraZ1	2175	+	1472	2904	2957	0.9820764
A05	3501600	3502755	A05p07130.2_BraZ1	702.333	-	445	1155	1155	1.0000000
A05	3507275	3508956	A05p07140.2_BraZ1	1464	+	357	1372	1681	0.8161808
A05	3513462	3515580	A05p07150.2_BraZ1	1776	+	281	1695	2118	0.8002833
A05	3521302	3521561	A05p07160.2_BraZ1	14.1	-	316	259	259	1.0000000
A05	3529473	3532526	A05p07170.2_BraZ1	1092.91	-	959	2563	3053	0.8395022
A05	3536349	3540183	A05p07180.2_BraZ1	1348.1	+	1216	2921	3834	0.7618675
A05	3540924	3542894	A05p07190.2_BraZ1	793.107	-	650	1729	1970	0.8776650
A05	3544535	3548395	A05p07200.2_BraZ1	1127.21	+	3228	3860	3860	1.0000000
A05	3548762	3550809	A05p07210.2_BraZ1	690.486	+	2616	2009	2047	0.9814363
A05	3552235	3552632	A05p07220.2_BraZ1	279	-	240	397	397	1.0000000
A05	3552913	3553379	A05p07230.2_BraZ1	250	-	416	466	466	1.0000000
A05	3553307	3554556	A05p07240.2_BraZ1	626.5	-	705	1223	1249	0.9791834
A05	3561582	3564225	A05p07250.2_BraZ1	9855	-	1218	2495	2643	0.9440030
A05	3567079	3568134	A05p07260.2_BraZ1	100.8	+	447	1055	1055	1.0000000
A05	3570597	3573205	A05p07270.2_BraZ1	1269.83	-	737	2378	2608	0.9118098
A05	3574073	3576773	A05p07280.2_BraZ1	2071.87	-	1022	2700	2700	1.0000000
A05	3576826	3577105	A05p07290.2_BraZ1	27.9	-	90	279	279	1.0000000
A05	3578492	3580094	A05p07300.2_BraZ1	160.2	-	95	1188	1602	0.7415730
A05	3582245	3582425	A05p07310.2_BraZ1	15.9	+	161	180	180	1.0000000
A05	3582950	3584555	A05p07320.2_BraZ1	160.5	-	7	350	1605	0.2180685
A05	3589686	3591291	A05p07330.2_BraZ1	160.5	-	6	501	1605	0.3121495
A05	3596940	3598547	A05p07340.2_BraZ1	1524	-	48	217	1607	0.1350342
A05	3615551	3615848	A05p07350.2_BraZ1	228	+	10	180	297	0.6060606
A05	3616632	3617749	A05p07360.2_BraZ1	369.6	-	463	1117	1117	1.0000000
A05	3618203	3619037	A05p07370.2_BraZ1	80.4	+	183	673	834	0.8069544
A05	3626328	3633294	A05p07380.2_BraZ1	696.6	+	1710	6788	6966	0.9744473
A05	3634195	3635701	A05p07390.2_BraZ1	150.6	-	695	1465	1506	0.9727756
A05	3637074	3637553	A05p07400.2_BraZ1	408	-	304	479	479	1.0000000
A05	3639838	3640459	A05p07410.2_BraZ1	61.5	+	111	369	621	0.5942029
A05	3641030	3650074	A05p07420.2_BraZ1	1128	-	1510	6998	9044	0.7737727
A05	3650094	3651721	A05p07430.2_BraZ1	714	+	222	885	1627	0.5439459
A05	3652238	3653348	A05p07440.2_BraZ1	111	-	163	959	1110	0.8639640
A05	3654165	3655266	A05p07450.2_BraZ1	978	-	68	671	1101	0.6094459
A05	3665660	3666797	A05p07460.2_BraZ1	113.7	-	20	406	1137	0.3570800
A05	3669366	3675787	A05p07470.2_BraZ1	4047.34	+	1101	4506	6421	0.7017599
A05	3676423	3678798	A05p07480.2_BraZ1	1135.75	-	806	2234	2375	0.9406316
A05	3679361	3681006	A05p07490.2_BraZ1	554.259	+	1563	1588	1645	0.9653496
A05	3683077	3686136	A05p07500.2_BraZ1	1293	-	798	2781	3059	0.9091206
A05	3695585	3698391	A05p07510.2_BraZ1	1634.19	+	1175	2526	2806	0.9002138
A05	3700612	3701355	A05p07520.2_BraZ1	588	+	60	438	743	0.5895020
A05	3706732	3708805	A05p07530.2_BraZ1	856.19	+	1503	2073	2073	1.0000000
A05	3709446	3710366	A05p07540.2_BraZ1	717.5	-	545	920	920	1.0000000
A05	3712153	3713493	A05p07550.2_BraZ1	1008	-	525	1110	1340	0.8283582
A05	3714635	3717900	A05p07560.2_BraZ1	1620.81	+	1092	3021	3265	0.9252680
A05	3718448	3720592	A05p07570.2_BraZ1	920.01	-	2038	2144	2144	1.0000000
A05	3723297	3723862	A05p07580.2_BraZ1	405	-	186	565	565	1.0000000
A05	3727489	3727889	A05p07590.2_BraZ1	36	-	47	400	400	1.0000000
A05	3729522	3730394	A05p07600.2_BraZ1	71.1	+	1520	872	872	1.0000000
A05	3732884	3733503	A05p07610.2_BraZ1	50.7	+	68	438	619	0.7075929
A05	3734056	3735508	A05p07620.2_BraZ1	145.2	-	250	1023	1452	0.7045454
A05	3746491	3747715	A05p07630.2_BraZ1	1068	+	757	1224	1224	1.0000000
A05	3750761	3752045	A05p07640.2_BraZ1	128.4	+	435	1284	1284	1.0000000
A05	3752942	3755080	A05p07650.2_BraZ1	7198	-	1295	2138	2138	1.0000000
A05	3755867	3756545	A05p07660.2_BraZ1	258	+	428	674	678	0.9941003
A05	3756689	3758887	A05p07670.2_BraZ1	1093.74	-	554	1573	2198	0.7156506
A05	3766120	3766506	A05p07680.2_BraZ1	279	+	231	386	386	1.0000000
A05	3766402	3766902	A05p07690.2_BraZ1	195	+	372	500	500	1.0000000
A05	3766545	3769131	A05p07700.2_BraZ1	295.2	+	1825	2492	2586	0.9636504
A05	3770837	3776185	A05p07710.2_BraZ1	4144.54	-	656	2388	5348	0.4465221
A05	3779041	3780944	A05p07720.2_BraZ1	741.524	+	2301	1675	1903	0.8801892
A05	3782431	3783014	A05p07730.2_BraZ1	399	-	416	280	583	0.4802744
A05	3788827	3790192	A05p07740.2_BraZ1	136.5	-	552	1365	1365	1.0000000
A05	3792093	3795843	A05p07750.2_BraZ1	2171.59	+	1058	3051	3750	0.8136000
A05	3796595	3798941	A05p07760.2_BraZ1	1103.57	-	957	2303	2346	0.9816709
A05	3799661	3802135	A05p07770.2_BraZ1	141	+	1557	1990	2474	0.8043654
A05	3803671	3804415	A05p07780.2_BraZ1	74.4	+	108	642	744	0.8629032
A05	3804929	3805127	A05p07790.2_BraZ1	19.8	-	142	198	198	1.0000000
A05	3805422	3805593	A05p07800.2_BraZ1	17.1	+	22	171	171	1.0000000
A05	3818500	3826248	A05p07810.2_BraZ1	585	-	3643	7122	7748	0.9192050
A05	3819621	3820737	A05p07820.2_BraZ1	563.338	-	1523	1116	1116	1.0000000
A05	3827907	3828900	A05p07830.2_BraZ1	6540.75	+	385	845	993	0.8509567
A05	3829501	3830043	A05p07840.2_BraZ1	320	-	343	492	542	0.9077491
A05	3833546	3857594	A05p07850.2_BraZ1	1945.45	+	7290	20782	24048	0.8641883
A05	3859489	3862809	A05p07860.2_BraZ1	2802	-	1141	3151	3320	0.9490964
A05	3868868	3870340	A05p07870.2_BraZ1	1014	+	144	1283	1472	0.8716033
A05	3872734	3875327	A05p07880.2_BraZ1	1390.11	+	558	1998	2593	0.7705361
A05	3877032	3881785	A05p07890.2_BraZ1	2453.85	+	1676	4640	4753	0.9762256
A05	3883098	3883242	A05p07900.2_BraZ1	14.4	-	63	144	144	1.0000000
A05	3883412	3884512	A05p07910.2_BraZ1	888	-	458	1100	1100	1.0000000
A05	3891934	3894177	A05p07920.2_BraZ1	1055	-	1123	2106	2243	0.9389211
A05	3897768	3899635	A05p07930.2_BraZ1	1439.38	-	182	1058	1867	0.5666845
A05	3904133	3906009	A05p07940.2_BraZ1	1326.28	-	412	1300	1876	0.6929638
A05	3921573	3925224	A05p07950.2_BraZ1	1322.69	+	1037	2858	3651	0.7827992
A05	3927313	3928504	A05p07960.2_BraZ1	119.1	+	753	1191	1191	1.0000000
A05	3929175	3930390	A05p07970.2_BraZ1	121.5	+	617	1215	1215	1.0000000
A05	3930600	3931098	A05p07980.2_BraZ1	360	-	271	498	498	1.0000000
A05	3931581	3932690	A05p07990.2_BraZ1	535.68	+	1042	1109	1109	1.0000000
A05	3935946	3940635	A05p08000.2_BraZ1	1387.2	-	229	2279	4689	0.4860311
A05	3944497	3945764	A05p08010.2_BraZ1	639	+	116	823	1267	0.6495659
A05	3945897	3946450	A05p08020.2_BraZ1	360	+	26	213	553	0.3851718
A05	3974290	3974494	A05p08030.2_BraZ1	20.4	-	273	204	204	1.0000000
A05	3982239	3985192	A05p08040.2_BraZ1	1506	+	551	1591	2953	0.5387741
A05	3989528	3991429	A05p08050.2_BraZ1	1615.37	+	213	782	1901	0.4113624
A05	3993891	3995524	A05p08060.2_BraZ1	888	-	361	1033	1633	0.6325781
A05	4001904	4002605	A05p08070.2_BraZ1	360	-	0	0	701	0.0000000
A05	4003099	4003297	A05p08080.2_BraZ1	19.8	+	36	10	198	0.0505050
A05	4005119	4008054	A05p08090.2_BraZ1	1576.38	-	802	2469	2935	0.8412266
A05	4011211	4014438	A05p08100.2_BraZ1	2285.43	-	725	3069	3227	0.9510381
A05	4017778	4018295	A05p08110.2_BraZ1	303	+	781	517	517	1.0000000
A05	4021194	4022241	A05p08120.2_BraZ1	104.7	+	168	843	1047	0.8051576
A05	4022551	4025663	A05p08130.2_BraZ1	1964.16	-	654	2943	3112	0.9456941
A05	4026847	4029067	A05p08140.2_BraZ1	1080.26	+	754	2056	2220	0.9261261
A05	4029825	4031593	A05p08150.2_BraZ1	531.143	-	529	1648	1768	0.9321267
A05	4032309	4032546	A05p08160.2_BraZ1	23.7	+	83	237	237	1.0000000
A05	4032708	4033404	A05p08170.2_BraZ1	69.6	-	185	626	696	0.8994253
A05	4033879	4034067	A05p08180.2_BraZ1	13.5	+	174	188	188	1.0000000
A05	4035152	4036743	A05p08190.2_BraZ1	1133.61	+	1204	1591	1591	1.0000000
A05	4039098	4040090	A05p08200.2_BraZ1	633	+	244	653	992	0.6582661
A05	4040462	4042437	A05p08210.2_BraZ1	800.87	-	1904	1855	1975	0.9392405
A05	4047180	4048083	A05p08220.2_BraZ1	580.5	-	1017	864	903	0.9568107
A05	4051203	4051653	A05p08230.2_BraZ1	45	+	5	123	450	0.2733333
A05	4058161	4065872	A05p08240.2_BraZ1	1184.06	+	1790	5479	7711	0.7105434
A05	4066255	4066528	A05p08250.2_BraZ1	27.3	-	60	234	273	0.8571429
A05	4068263	4068608	A05p08260.2_BraZ1	34.5	-	283	345	345	1.0000000
A05	4069024	4070668	A05p08270.2_BraZ1	1183.51	-	1845	1644	1644	1.0000000
A05	4072845	4073210	A05p08280.2_BraZ1	32.7	+	585	365	365	1.0000000
A05	4074407	4075313	A05p08290.2_BraZ1	90.6	+	34	461	906	0.5088300
A05	4076338	4078647	A05p08300.2_BraZ1	425.25	-	493	1921	2309	0.8319619
A05	4081565	4082955	A05p08310.2_BraZ1	821.6	-	306	1264	1390	0.9093525
A05	4084099	4084765	A05p08320.2_BraZ1	66.6	+	155	666	666	1.0000000
A05	4085603	4087624	A05p08330.2_BraZ1	832.5	-	2168	2021	2021	1.0000000
A05	4092440	4094247	A05p08340.2_BraZ1	884.8	-	1967	1807	1807	1.0000000
A05	4099638	4101235	A05p08350.2_BraZ1	861.222	-	3257	1537	1597	0.9624296
A05	4105469	4105712	A05p08360.2_BraZ1	24.3	-	19	233	243	0.9588478
A05	4107883	4108759	A05p08370.2_BraZ1	87.6	+	25	433	876	0.4942922
A05	4115900	4116392	A05p08380.2_BraZ1	49.2	+	98	492	492	1.0000000
A05	4117395	4117500	A05p08390.2_BraZ1	10.5	-	308	105	105	1.0000000
A05	4120185	4122736	A05p08400.2_BraZ1	1536	+	1019	2061	2551	0.8079185
A05	4128318	4129521	A05p08410.2_BraZ1	120.3	-	106	594	1203	0.4937656
A05	4131229	4133251	A05p08420.2_BraZ1	202.2	+	2573	2022	2022	1.0000000
A05	4137625	4141447	A05p08430.2_BraZ1	1114.63	+	1528	3628	3822	0.9492412
A05	4142172	4142402	A05p08440.2_BraZ1	129	-	312	230	230	1.0000000
A05	4147451	4148070	A05p08450.2_BraZ1	651.6	+	258	619	619	1.0000000
A05	4151596	4153027	A05p08460.2_BraZ1	796.154	+	1022	1396	1431	0.9755416
A05	4154667	4156401	A05p08470.2_BraZ1	573.75	+	1983	1734	1734	1.0000000
A05	4163255	4165052	A05p08480.2_BraZ1	6930	+	890	1748	1797	0.9727323
A05	4174969	4176070	A05p08490.2_BraZ1	110.1	+	612	1101	1101	1.0000000
A05	4176542	4178340	A05p08500.2_BraZ1	120.3	-	318	1361	1798	0.7569522
A05	4180990	4181377	A05p08510.2_BraZ1	37.8	+	32	229	387	0.5917313
A05	4189944	4190513	A05p08520.2_BraZ1	383.226	+	179	569	569	1.0000000
A05	4196063	4197224	A05p08530.2_BraZ1	1886.14	-	116	996	1161	0.8578811
A05	4199512	4201234	A05p08540.2_BraZ1	1133.71	-	870	1622	1722	0.9419280
A05	4202331	4203813	A05p08550.2_BraZ1	148.2	+	490	1482	1482	1.0000000
A05	4204647	4206197	A05p08560.2_BraZ1	1067.18	-	652	1484	1550	0.9574193
A05	4207257	4207577	A05p08570.2_BraZ1	31.2	+	294	320	320	1.0000000
A05	4213158	4215988	A05p08580.2_BraZ1	1490	+	1906	2576	2830	0.9102473
A05	4216991	4219145	A05p08590.2_BraZ1	1313.84	+	1986	2154	2154	1.0000000
A05	4221580	4224477	A05p08600.2_BraZ1	912.974	+	700	2419	2897	0.8350017
A05	4225245	4229025	A05p08610.2_BraZ1	3082.15	+	927	2964	3780	0.7841270
A05	4230905	4231417	A05p08620.2_BraZ1	438	-	65	450	512	0.8789062
A05	4233596	4235857	A05p08630.2_BraZ1	1353.86	-	331	2071	2261	0.9159664
A05	4244731	4246798	A05p08640.2_BraZ1	178.099	+	1833	2067	2067	1.0000000
A05	4245827	4248521	A05p08650.2_BraZ1	1356.82	+	2381	2694	2694	1.0000000
A05	4248787	4249406	A05p08660.2_BraZ1	549	-	789	619	619	1.0000000
A05	4256590	4259411	A05p08670.2_BraZ1	1016.88	+	1086	1996	2821	0.7075505
A05	4260118	4261752	A05p08680.2_BraZ1	1273.82	-	1121	1634	1634	1.0000000
A05	4262861	4265575	A05p08690.2_BraZ1	1439.39	-	599	2420	2714	0.8916728
A05	4280621	4281164	A05p08700.2_BraZ1	54.3	-	58	324	543	0.5966851
A05	4282865	4284600	A05p08710.2_BraZ1	738.701	-	661	1649	1735	0.9504323
A05	4285251	4286228	A05p08720.2_BraZ1	801	+	483	977	977	1.0000000
A05	4287493	4289840	A05p08730.2_BraZ1	2148	+	724	2186	2347	0.9314018
A05	4290074	4292306	A05p08740.2_BraZ1	810	-	368	1855	2232	0.8310932
A05	4300940	4301977	A05p08750.2_BraZ1	91.2	-	365	1037	1037	1.0000000
A05	4305722	4310130	A05p08760.2_BraZ1	1773.53	-	1789	4344	4408	0.9854810
A05	4311837	4313248	A05p08770.2_BraZ1	511	-	295	1311	1411	0.9291283
A05	4314060	4318925	A05p08780.2_BraZ1	1479	-	913	2155	4865	0.4429599
A05	4314811	4316730	A05p08790.2_BraZ1	787.5	-	7	180	1919	0.0937989
A05	4316730	4317314	A05p08800.2_BraZ1	378	-	0	0	584	0.0000000
A05	4320288	4332933	A05p08810.2_BraZ1	2548.03	+	4294	11283	12645	0.8922895
A05	4321792	4322560	A05p08820.2_BraZ1	307.2	+	214	691	768	0.8997396
A05	4333467	4334927	A05p08830.2_BraZ1	646.872	-	573	1329	1460	0.9102740
A05	4334921	4338868	A05p08840.2_BraZ1	1593.86	-	1112	3694	3947	0.9359007
A05	4340256	4346734	A05p08850.2_BraZ1	2788.26	-	2816	5859	6478	0.9044458
A05	4349213	4350307	A05p08860.2_BraZ1	29120	+	610	1094	1094	1.0000000
A05	4350989	4352415	A05p08870.2_BraZ1	1150.65	-	318	1352	1426	0.9481066
A05	4355350	4356749	A05p08880.2_BraZ1	700.071	+	507	1395	1399	0.9971408
A05	4357513	4359353	A05p08890.2_BraZ1	4473	+	1440	1832	1840	0.9956522
A05	4370346	4377702	A05p08900.2_BraZ1	950.576	+	2299	6581	7356	0.8946438
A05	4375353	4376392	A05p08910.2_BraZ1	48.3	-	457	826	1039	0.7949952
A05	4380822	4381758	A05p08920.2_BraZ1	224.1	-	1120	936	936	1.0000000
A05	4381871	4382111	A05p08930.2_BraZ1	24	+	294	240	240	1.0000000
A05	4382978	4384119	A05p08940.2_BraZ1	16159	-	731	1131	1141	0.9912357
A05	4394910	4396041	A05p08950.2_BraZ1	32318	+	110	965	1131	0.8532273
A05	4398100	4398967	A05p08960.2_BraZ1	86.7	-	174	867	867	1.0000000
A05	4400741	4402195	A05p08970.2_BraZ1	1093.71	+	654	1435	1454	0.9869326
A05	4405751	4408129	A05p08980.2_BraZ1	699.438	+	1015	2135	2378	0.8978133
A05	4412214	4416541	A05p08990.2_BraZ1	2549.95	-	524	3490	4327	0.8065634
A05	4418945	4419246	A05p09000.2_BraZ1	207	-	527	301	301	1.0000000
A05	4427606	4430390	A05p09010.2_BraZ1	2160	+	323	2166	2784	0.7780172
A05	4432595	4433960	A05p09020.2_BraZ1	136.5	+	373	1342	1365	0.9831502
A05	4434562	4434940	A05p09030.2_BraZ1	37.8	-	160	318	378	0.8412699
A05	4438311	4442995	A05p09040.2_BraZ1	3064.41	-	1146	3711	4684	0.7922716
A05	4447251	4447413	A05p09050.2_BraZ1	16.2	+	193	162	162	1.0000000
A05	4449805	4451698	A05p09060.2_BraZ1	189.3	-	279	1334	1893	0.7047015
A05	4453184	4454856	A05p09070.2_BraZ1	1452	-	246	1154	1672	0.6901914
A05	4460053	4461751	A05p09080.2_BraZ1	1440	-	342	1651	1698	0.9723204
A05	4463514	4466878	A05p09090.2_BraZ1	2007.6	-	532	2792	3364	0.8299643
A05	4473730	4475176	A05p09100.2_BraZ1	1021.12	-	184	431	1446	0.2980636
A05	4477771	4483129	A05p09110.2_BraZ1	452	-	3816	4151	5358	0.7747294
A05	4483233	4484052	A05p09120.2_BraZ1	166.95	-	36	175	819	0.2136752
A05	4487094	4487745	A05p09130.2_BraZ1	361.354	+	303	632	651	0.9708141
A05	4488919	4489928	A05p09140.2_BraZ1	632.357	+	952	1009	1009	1.0000000
A05	4492622	4494061	A05p09150.2_BraZ1	846.357	-	690	1337	1439	0.9291174
A05	4498668	4499902	A05p09160.2_BraZ1	742.255	+	886	1234	1234	1.0000000
A05	4502131	4503334	A05p09170.2_BraZ1	117.3	+	246	1071	1203	0.8902743
A05	4505582	4507300	A05p09180.2_BraZ1	426.923	-	1871	1718	1718	1.0000000
A05	4511410	4518244	A05p09190.2_BraZ1	120	-	4172	6601	6834	0.9659058
A05	4523219	4524956	A05p09200.2_BraZ1	880	+	146	1346	1737	0.7748992
A05	4529322	4543094	A05p09210.2_BraZ1	5602.43	+	1972	10478	13772	0.7608191
A05	4549051	4550056	A05p09220.2_BraZ1	363.636	+	753	1005	1005	1.0000000
A05	4552245	4552473	A05p09230.2_BraZ1	22.8	+	78	228	228	1.0000000
A05	4555724	4556864	A05p09240.2_BraZ1	113.4	-	446	1140	1140	1.0000000
A05	4559810	4560017	A05p09250.2_BraZ1	20.7	+	37	207	207	1.0000000
A05	4562580	4563720	A05p09260.2_BraZ1	113.1	+	552	1124	1140	0.9859649
A05	4566052	4567219	A05p09270.2_BraZ1	116.7	+	6	263	1167	0.2253642
A05	4570253	4570551	A05p09280.2_BraZ1	192	-	451	298	298	1.0000000
A05	4574372	4576421	A05p09290.2_BraZ1	1059.71	+	418	1631	2049	0.7959980
A05	4578991	4580500	A05p09300.2_BraZ1	150.9	-	721	1509	1509	1.0000000
A05	4581465	4581886	A05p09310.2_BraZ1	330	-	211	421	421	1.0000000
A05	4584216	4586039	A05p09320.2_BraZ1	862.65	-	772	1822	1823	0.9994515
A05	4591567	4594064	A05p09330.2_BraZ1	998.438	-	810	2220	2497	0.8890669
A05	4598128	4601603	A05p09340.2_BraZ1	1316.23	+	2499	3329	3475	0.9579856
A05	4602519	4602660	A05p09350.2_BraZ1	14.1	+	8	141	141	1.0000000
A05	4604824	4605230	A05p09360.2_BraZ1	267	+	22	153	406	0.3768473
A05	4607226	4609052	A05p09370.2_BraZ1	536.714	+	506	1654	1826	0.9058051
A05	4610362	4612672	A05p09380.2_BraZ1	1289.86	+	624	2283	2310	0.9883117
A05	4612940	4614469	A05p09390.2_BraZ1	1215	-	1474	1529	1529	1.0000000
A05	4621808	4624218	A05p09400.2_BraZ1	1241.73	+	752	2128	2410	0.8829876
A05	4626600	4627330	A05p09410.2_BraZ1	432	+	794	730	730	1.0000000
A05	4627670	4638481	A05p09420.2_BraZ1	802.286	-	6378	9668	10811	0.8942744
A05	4640669	4643347	A05p09430.2_BraZ1	988.116	+	668	2084	2678	0.7781927
A05	4649235	4651895	A05p09440.2_BraZ1	1029.68	+	400	2254	2660	0.8473684
A05	4652276	4656230	A05p09450.2_BraZ1	1429.75	-	604	3603	3954	0.9112291
A05	4653305	4653986	A05p09460.2_BraZ1	396	+	117	601	681	0.8825257
A05	4653937	4654256	A05p09470.2_BraZ1	31.5	-	74	319	319	1.0000000
A05	4664991	4675428	A05p09480.2_BraZ1	5389.36	+	3808	9603	10437	0.9200920
A05	4682148	4683084	A05p09490.2_BraZ1	93.6	+	322	936	936	1.0000000
A05	4685178	4685427	A05p09500.2_BraZ1	24.9	-	349	249	249	1.0000000
A05	4687654	4689160	A05p09510.2_BraZ1	136.8	-	96	685	1506	0.4548473
A05	4690261	4692777	A05p09520.2_BraZ1	1262.86	-	792	2450	2516	0.9737679
A05	4695528	4696482	A05p09530.2_BraZ1	95.4	+	327	874	954	0.9161426
A05	4697604	4699259	A05p09540.2_BraZ1	1002	-	118	827	1655	0.4996979
A05	4709112	4709951	A05p09550.2_BraZ1	483	+	103	736	839	0.8772348
A05	4719390	4719832	A05p09560.2_BraZ1	351	-	523	442	442	1.0000000
A05	4725184	4727677	A05p09570.2_BraZ1	1167	+	307	2261	2493	0.9069394
A05	4727981	4732662	A05p09580.2_BraZ1	2293.19	-	1153	4559	4681	0.9739372
A05	4734646	4749201	A05p09590.2_BraZ1	3086.67	+	1953	7312	14555	0.5023703
A05	4752845	4756564	A05p09600.2_BraZ1	728.571	+	109	1360	3719	0.3656897
A05	4758891	4767860	A05p09610.2_BraZ1	2992	+	1461	6165	8969	0.6873676
A05	4769814	4770528	A05p09620.2_BraZ1	71.4	+	4	20	714	0.0280112
A05	4772313	4783958	A05p09630.2_BraZ1	1929.29	+	391	3989	11645	0.3425505
A05	4785156	4805844	A05p09640.2_BraZ1	721.74	+	3952	12638	20688	0.6108856
A05	4792256	4795420	A05p09650.2_BraZ1	21118.5	+	1061	2686	3164	0.8489254
A05	4804082	4804499	A05p09660.2_BraZ1	348	+	14	318	417	0.7625899
A05	4813964	4820297	A05p09670.2_BraZ1	5508	+	2117	3820	6333	0.6031896
A05	4820822	4839151	A05p09680.2_BraZ1	2526.27	+	1032	8180	18329	0.4462873
A05	4839540	4842672	A05p09690.2_BraZ1	27657	-	897	2335	3132	0.7455300
A05	4845290	4846341	A05p09700.2_BraZ1	664.714	-	221	1051	1051	1.0000000
A05	4851647	4851932	A05p09710.2_BraZ1	28.5	+	577	285	285	1.0000000
A05	4858711	4859197	A05p09720.2_BraZ1	48.6	-	284	486	486	1.0000000
A05	4864547	4867115	A05p09730.2_BraZ1	907.371	-	1967	2568	2568	1.0000000
A05	4870992	4872847	A05p09740.2_BraZ1	872.486	+	633	1723	1855	0.9288410
A05	4881425	4881641	A05p09750.2_BraZ1	21.6	+	33	192	216	0.8888889
A05	4884168	4884939	A05p09760.2_BraZ1	77.1	+	240	771	771	1.0000000
A05	4890814	4892669	A05p09770.2_BraZ1	1067.18	+	625	1839	1855	0.9913747
A05	4895083	4896572	A05p09780.2_BraZ1	132.6	+	614	1489	1489	1.0000000
A05	4896993	4897584	A05p09790.2_BraZ1	59.1	-	704	591	591	1.0000000
A05	4902090	4903603	A05p09800.2_BraZ1	149.4	-	876	1511	1513	0.9986781
A05	4904332	4907020	A05p09810.2_BraZ1	784.266	+	881	2352	2688	0.8750000
A05	4905001	4905601	A05p09820.2_BraZ1	60	+	102	546	600	0.9100000
A05	4907977	4914181	A05p09830.2_BraZ1	774	-	367	3266	6204	0.5264345
A05	4924060	4924453	A05p09840.2_BraZ1	39.3	+	21	167	393	0.4249364
A05	4925571	4930809	A05p09850.2_BraZ1	2270.1	+	2154	4309	5238	0.8226422
A05	4932864	4952177	A05p09860.2_BraZ1	524.7	-	9398	15995	19313	0.8281986
A05	4945583	4946211	A05p09870.2_BraZ1	105	+	7	286	628	0.4554140
A05	4953250	4954436	A05p09880.2_BraZ1	485.833	-	1079	1134	1186	0.9561551
A05	4956486	4957402	A05p09890.2_BraZ1	87.6	-	585	916	916	1.0000000
A05	4961560	4962496	A05p09900.2_BraZ1	619.709	+	583	936	936	1.0000000
A05	4964140	4965019	A05p09910.2_BraZ1	261.209	+	922	879	879	1.0000000
A05	4965199	4966141	A05p09920.2_BraZ1	94.2	-	170	845	942	0.8970276
A05	4983993	4986911	A05p09930.2_BraZ1	7470	+	1456	2839	2918	0.9729267
A05	5004363	5005176	A05p09940.2_BraZ1	81.3	+	221	783	813	0.9630997
A05	5009167	5009518	A05p09950.2_BraZ1	35.1	+	762	351	351	1.0000000
A05	5009902	5010432	A05p09960.2_BraZ1	45	+	736	530	530	1.0000000
A05	5015803	5016364	A05p09970.2_BraZ1	56.1	-	339	561	561	1.0000000
A05	5018348	5019791	A05p09980.2_BraZ1	676.571	+	702	1321	1443	0.9154539
A05	5020267	5023184	A05p09990.2_BraZ1	1316.57	-	1527	2800	2917	0.9598903
A05	5028695	5031067	A05p10000.2_BraZ1	1168.7	-	1235	2203	2372	0.9287521
A05	5034910	5035540	A05p10010.2_BraZ1	63	-	82	475	630	0.7539682
A05	5044657	5045878	A05p10020.2_BraZ1	122.1	-	99	788	1221	0.6453726
A05	5046776	5048661	A05p10030.2_BraZ1	711.789	+	26	654	1885	0.3469496
A05	5055287	5055928	A05p10040.2_BraZ1	174	-	797	490	641	0.7644306
A05	5058340	5061026	A05p10050.2_BraZ1	1835.79	-	1295	2600	2686	0.9679821
A05	5079324	5083033	A05p10060.2_BraZ1	1445.92	+	968	3388	3709	0.9134538
A05	5091178	5091793	A05p10070.2_BraZ1	61.5	-	33	366	615	0.5951220
A05	5092800	5094212	A05p10080.2_BraZ1	2256	+	559	713	1412	0.5049575
A05	5101886	5103233	A05p10090.2_BraZ1	939	+	1021	1342	1347	0.9962881
A05	5103599	5105707	A05p10100.2_BraZ1	912.978	-	1450	2009	2108	0.9530361
A05	5114104	5115867	A05p10110.2_BraZ1	1023.59	-	1164	1714	1763	0.9722065
A05	5119898	5120643	A05p10120.2_BraZ1	542.045	-	434	745	745	1.0000000
A05	5121338	5134218	A05p10130.2_BraZ1	5657.44	-	869	5989	12880	0.4649845
A05	5136840	5137376	A05p10140.2_BraZ1	273	+	164	388	536	0.7238806
A05	5138923	5139559	A05p10150.2_BraZ1	219	+	777	636	636	1.0000000
A05	5139858	5140750	A05p10160.2_BraZ1	511.429	+	1235	892	892	1.0000000
A05	5145223	5148530	A05p10170.2_BraZ1	1454.25	+	2033	3275	3307	0.9903235
A05	5148820	5150164	A05p10180.2_BraZ1	134.4	-	1036	1344	1344	1.0000000
A05	5156041	5157923	A05p10190.2_BraZ1	1341.08	-	752	1414	1882	0.7513283
A05	5160582	5160992	A05p10200.2_BraZ1	339	-	5	190	410	0.4634146
A05	5168120	5168381	A05p10210.2_BraZ1	26.1	+	173	261	261	1.0000000
A05	5177154	5180421	A05p10220.2_BraZ1	1573.05	+	1606	3251	3267	0.9951025
A05	5183684	5186221	A05p10230.2_BraZ1	977.455	+	365	1800	2537	0.7094994
A05	5188127	5189732	A05p10240.2_BraZ1	465	-	820	1605	1605	1.0000000
A05	5191153	5192518	A05p10250.2_BraZ1	1137	+	599	1183	1365	0.8666667
A05	5193045	5195874	A05p10260.2_BraZ1	1058.57	+	1779	2713	2829	0.9589961
A05	5198132	5202020	A05p10270.2_BraZ1	7341.75	+	1395	3019	3888	0.7764918
A05	5202215	5203751	A05p10280.2_BraZ1	153.6	-	920	1535	1536	0.9993489
A05	5205156	5208555	A05p10290.2_BraZ1	147.692	+	670	2937	3399	0.8640777
A05	5210606	5213436	A05p10300.2_BraZ1	992.25	+	2085	2830	2830	1.0000000
A05	5215818	5217938	A05p10310.2_BraZ1	1083.71	+	1329	2120	2120	1.0000000
A05	5218979	5220848	A05p10320.2_BraZ1	186.9	+	1292	1684	1869	0.9010166
A05	5225899	5227460	A05p10330.2_BraZ1	1083	+	942	1560	1561	0.9993594
A05	5228060	5228826	A05p10340.2_BraZ1	591	-	1021	766	766	1.0000000
A05	5229963	5230602	A05p10350.2_BraZ1	48.9	+	533	639	639	1.0000000
A05	5233504	5234206	A05p10360.2_BraZ1	70.2	-	197	614	702	0.8746439
A05	5235074	5237110	A05p10370.2_BraZ1	960.536	+	1661	2033	2036	0.9985265
A05	5237879	5238833	A05p10380.2_BraZ1	7666.5	+	312	926	954	0.9706499
A05	5239248	5240088	A05p10390.2_BraZ1	84	+	649	840	840	1.0000000
A05	5241317	5243860	A05p10400.2_BraZ1	1088.89	+	1470	2519	2543	0.9905623
A05	5245338	5246451	A05p10410.2_BraZ1	5940	+	667	1113	1113	1.0000000
A05	5247388	5247568	A05p10420.2_BraZ1	18	+	433	180	180	1.0000000
A05	5250364	5250690	A05p10430.2_BraZ1	234	-	221	326	326	1.0000000
A05	5252891	5254080	A05p10440.2_BraZ1	980.217	-	322	891	1189	0.7493692
A05	5254609	5255373	A05p10450.2_BraZ1	501	-	192	650	764	0.8507853
A05	5257437	5258260	A05p10460.2_BraZ1	280.875	+	64	422	823	0.5127582
A05	5261587	5263170	A05p10470.2_BraZ1	2333.83	-	462	1285	1583	0.8117498
A05	5265127	5266594	A05p10480.2_BraZ1	556.625	+	1063	1354	1467	0.9229720
A05	5268207	5270470	A05p10490.2_BraZ1	19723	+	529	1825	2263	0.8064516
A05	5271558	5273710	A05p10500.2_BraZ1	1825.98	+	799	2129	2152	0.9893123
A05	5275044	5275312	A05p10510.2_BraZ1	14.7	+	267	268	268	1.0000000
A05	5275411	5279906	A05p10520.2_BraZ1	2359.88	+	6145	4481	4495	0.9968854
A05	5284639	5287121	A05p10530.2_BraZ1	2027.57	+	889	2367	2482	0.9536664
A05	5287986	5288808	A05p10540.2_BraZ1	82.2	-	269	822	822	1.0000000
A05	5289549	5290767	A05p10550.2_BraZ1	121.8	+	10	64	1218	0.0525452
A05	5295377	5297249	A05p10560.2_BraZ1	1803	-	403	1731	1872	0.9246795
A05	5298032	5298329	A05p10570.2_BraZ1	29.7	+	44	165	297	0.5555556
A05	5299863	5300232	A05p10580.2_BraZ1	36.9	+	87	350	369	0.9485095
A05	5302233	5303088	A05p10590.2_BraZ1	85.5	-	214	725	855	0.8479532
A05	5307798	5309663	A05p10600.2_BraZ1	1019.53	-	873	1831	1865	0.9817694
A05	5319255	5320354	A05p10610.2_BraZ1	689.839	+	585	1099	1099	1.0000000
A05	5323512	5324670	A05p10620.2_BraZ1	115.8	-	519	1157	1158	0.9991364
A05	5328160	5328481	A05p10630.2_BraZ1	32.1	-	16	89	321	0.2772586
A05	5330568	5331126	A05p10640.2_BraZ1	54.6	-	175	558	558	1.0000000
A05	5335502	5337292	A05p10650.2_BraZ1	756.871	-	1158	1790	1790	1.0000000
A05	5338762	5340859	A05p10660.2_BraZ1	457.2	+	104	980	2097	0.4673343
A05	5344339	5344743	A05p10670.2_BraZ1	294	-	11	150	404	0.3712871
A05	5346763	5348917	A05p10680.2_BraZ1	215.4	-	452	1883	2154	0.8741875
A05	5354159	5356590	A05p10690.2_BraZ1	1623.72	+	1176	2366	2431	0.9732620
A05	5357908	5358874	A05p10700.2_BraZ1	96.6	+	430	966	966	1.0000000
A05	5359300	5362237	A05p10710.2_BraZ1	1361.6	-	469	1616	2937	0.5502213
A05	5363271	5367781	A05p10720.2_BraZ1	883.846	+	1089	4369	4510	0.9687361
A05	5368992	5369370	A05p10730.2_BraZ1	30.3	+	31	375	378	0.9920635
A05	5369370	5369656	A05p10740.2_BraZ1	225	+	84	286	286	1.0000000
A05	5370239	5370368	A05p10750.2_BraZ1	12.9	+	0	0	129	0.0000000
A05	5371626	5379160	A05p10760.2_BraZ1	4125	+	1429	5472	7534	0.7263074
A05	5380299	5381914	A05p10770.2_BraZ1	1353	+	423	1602	1615	0.9919505
A05	5387279	5390950	A05p10780.2_BraZ1	1915.67	+	1013	3106	3671	0.8460910
A05	5392162	5397007	A05p10790.2_BraZ1	2053.66	+	2615	4464	4845	0.9213622
A05	5399688	5401572	A05p10800.2_BraZ1	188.4	+	707	1799	1884	0.9548832
A05	5402020	5405573	A05p10810.2_BraZ1	1445.31	-	1107	3170	3553	0.8922037
A05	5408150	5410547	A05p10820.2_BraZ1	646.5	+	147	561	2397	0.2340426
A05	5411590	5411984	A05p10830.2_BraZ1	330	+	91	201	394	0.5101523
A05	5412950	5413259	A05p10840.2_BraZ1	30.9	-	10	20	309	0.0647249
A05	5414524	5416143	A05p10850.2_BraZ1	784.7	+	126	534	1619	0.3298332
A05	5417649	5419597	A05p10860.2_BraZ1	1174.25	-	7	49	1948	0.0251540
A05	5419789	5420788	A05p10870.2_BraZ1	99.9	-	424	760	999	0.7607608
A05	5421625	5422732	A05p10880.2_BraZ1	110.7	+	182	789	1107	0.7127371
A05	5425709	5426651	A05p10890.2_BraZ1	94.2	+	253	853	942	0.9055201
A05	5427605	5428550	A05p10900.2_BraZ1	94.5	-	579	945	945	1.0000000
A05	5429443	5431621	A05p10910.2_BraZ1	217.8	-	947	2136	2178	0.9807162
A05	5432938	5435653	A05p10920.2_BraZ1	271.5	+	777	2520	2715	0.9281768
A05	5444902	5446152	A05p10930.2_BraZ1	275	-	282	1062	1250	0.8496000
A05	5449661	5452188	A05p10940.2_BraZ1	1702.08	+	701	2399	2527	0.9493471
A05	5452668	5453556	A05p10950.2_BraZ1	88.8	-	427	729	888	0.8209459
A05	5454445	5456686	A05p10960.2_BraZ1	994	+	1065	2206	2241	0.9843820
A05	5461143	5464662	A05p10970.2_BraZ1	1692.93	+	2476	3406	3519	0.9678886
A05	5465451	5465760	A05p10980.2_BraZ1	30.9	-	332	309	309	1.0000000
A05	5467227	5468532	A05p10990.2_BraZ1	525.808	-	927	1305	1305	1.0000000
A05	5470360	5472643	A05p11000.2_BraZ1	1139.24	+	834	2269	2283	0.9938677
A05	5477952	5479019	A05p11010.2_BraZ1	215.161	+	78	556	1067	0.5210872
A05	5481115	5483749	A05p11020.2_BraZ1	1173.79	+	419	2290	2634	0.8694001
A05	5492424	5493373	A05p11030.2_BraZ1	867	-	390	918	949	0.9673340
A05	5500346	5501966	A05p11040.2_BraZ1	162	-	170	1199	1620	0.7401235
A05	5507211	5508717	A05p11050.2_BraZ1	1398	+	2817	1506	1506	1.0000000
A05	5515144	5517731	A05p11060.2_BraZ1	4797	+	732	2423	2587	0.9366061
A05	5518109	5523323	A05p11070.2_BraZ1	2762.74	-	6343	5148	5214	0.9873418
A05	5534554	5536657	A05p11080.2_BraZ1	3578.54	+	1122	2080	2103	0.9890633
A05	5541296	5543210	A05p11090.2_BraZ1	503.28	+	633	1805	1914	0.9430512
A05	5548333	5548495	A05p11100.2_BraZ1	16.2	+	44	162	162	1.0000000
A05	5548667	5549096	A05p11110.2_BraZ1	116.769	+	5	6	429	0.0139860
A05	5553033	5555888	A05p11120.2_BraZ1	1770.21	+	1490	2156	2855	0.7551664
A05	5559908	5564274	A05p11130.2_BraZ1	2493.75	+	1858	3917	4366	0.8971599
A05	5568774	5576243	A05p11140.2_BraZ1	588	+	1268	2595	7469	0.3474361
A05	5584779	5584965	A05p11150.2_BraZ1	18.6	+	0	0	186	0.0000000
A05	5587895	5588287	A05p11160.2_BraZ1	156	-	827	392	392	1.0000000
A05	5588629	5590829	A05p11170.2_BraZ1	1222.86	-	1335	2072	2200	0.9418182
A05	5593853	5595903	A05p11180.2_BraZ1	2793	-	1785	1749	2050	0.8531708
A05	5599560	5607520	A05p11190.2_BraZ1	4396.77	-	4561	7699	7960	0.9672111
A05	5630233	5631852	A05p11200.2_BraZ1	1320	+	206	1502	1619	0.9277332
A05	5635554	5636150	A05p11210.2_BraZ1	55.2	-	0	0	596	0.0000000
A05	5638536	5640666	A05p11220.2_BraZ1	1455.89	+	672	2065	2130	0.9694836
A05	5641106	5646326	A05p11230.2_BraZ1	1575.58	-	5320	5080	5220	0.9731801
A05	5647248	5648073	A05p11240.2_BraZ1	82.5	-	261	825	825	1.0000000
A05	5650663	5651222	A05p11250.2_BraZ1	351	-	44	400	559	0.7155635
A05	5653328	5653582	A05p11260.2_BraZ1	195	-	14	222	254	0.8740157
A05	5653851	5654010	A05p11270.2_BraZ1	15.9	-	15	159	159	1.0000000
A05	5656056	5658519	A05p11280.2_BraZ1	2324.83	+	2177	2463	2463	1.0000000
A05	5658725	5662229	A05p11290.2_BraZ1	1260	-	2593	3504	3504	1.0000000
A05	5662725	5663826	A05p11300.2_BraZ1	110.1	-	1192	1101	1101	1.0000000
A05	5669326	5670406	A05p11310.2_BraZ1	108	-	893	1080	1080	1.0000000
A05	5673337	5673700	A05p11320.2_BraZ1	36.3	+	131	319	363	0.8787879
A05	5673935	5676238	A05p11330.2_BraZ1	999.438	-	1227	2256	2303	0.9795918
A05	5677906	5679606	A05p11340.2_BraZ1	987	-	1112	1700	1700	1.0000000
A05	5686283	5687889	A05p11350.2_BraZ1	840.727	-	633	1564	1606	0.9738480
A05	5688399	5689617	A05p11360.2_BraZ1	561.389	+	117	427	1218	0.3505747
A05	5693024	5693492	A05p11370.2_BraZ1	46.5	+	526	468	468	1.0000000
A05	5694867	5697808	A05p11380.2_BraZ1	1041.06	+	1082	2634	2941	0.8956137
A05	5703956	5705450	A05p11390.2_BraZ1	149.4	+	552	1494	1494	1.0000000
A05	5707896	5709999	A05p11400.2_BraZ1	648	-	1045	2103	2103	1.0000000
A05	5711331	5711805	A05p11410.2_BraZ1	47.4	-	191	474	474	1.0000000
A05	5711896	5713306	A05p11420.2_BraZ1	428.4	-	397	1326	1410	0.9404255
A05	5723080	5723881	A05p11430.2_BraZ1	80.1	-	220	801	801	1.0000000
A05	5724497	5725298	A05p11440.2_BraZ1	80.1	+	84	711	801	0.8876405
A05	5725879	5726191	A05p11450.2_BraZ1	234	-	193	312	312	1.0000000
A05	5726323	5727315	A05p11460.2_BraZ1	619.125	-	918	992	992	1.0000000
A05	5728342	5730282	A05p11470.2_BraZ1	1875	-	605	1940	1940	1.0000000
A05	5731404	5732728	A05p11480.2_BraZ1	884.917	+	291	1318	1324	0.9954683
A05	5733443	5735982	A05p11490.2_BraZ1	1788	+	537	1939	2539	0.7636865
A05	5736916	5737992	A05p11500.2_BraZ1	810.469	+	383	970	1076	0.9014870
A05	5738661	5739503	A05p11510.2_BraZ1	534	+	1108	842	842	1.0000000
A05	5739432	5739831	A05p11520.2_BraZ1	252	+	615	399	399	1.0000000
A05	5739820	5740024	A05p11530.2_BraZ1	12	-	331	204	204	1.0000000
A05	5740479	5741249	A05p11540.2_BraZ1	465	+	78	512	770	0.6649351
A05	5741465	5742009	A05p11550.2_BraZ1	1749	+	17	271	544	0.4981618
A05	5743009	5747643	A05p11560.2_BraZ1	1299.99	-	2501	4499	4634	0.9708675
A05	5749874	5755983	A05p11570.2_BraZ1	3022.75	-	2770	5620	6109	0.9199542
A05	5756380	5756563	A05p11580.2_BraZ1	18.3	-	175	183	183	1.0000000
A05	5758894	5760977	A05p11590.2_BraZ1	9450	-	413	1794	2083	0.8612578
A05	5770345	5770729	A05p11600.2_BraZ1	38.4	+	142	370	384	0.9635417
A05	5774042	5775116	A05p11610.2_BraZ1	719.4	+	1315	1074	1074	1.0000000
A05	5776922	5779649	A05p11620.2_BraZ1	2156.3	+	1197	2601	2727	0.9537954
A05	5779984	5782301	A05p11630.2_BraZ1	1001.48	-	1864	2317	2317	1.0000000
A05	5782836	5784009	A05p11640.2_BraZ1	117.3	+	650	1173	1173	1.0000000
A05	5784706	5786578	A05p11650.2_BraZ1	1428	-	607	1850	1872	0.9882479
A05	5789279	5789516	A05p11660.2_BraZ1	23.7	-	7	204	237	0.8607595
A05	5794545	5796262	A05p11670.2_BraZ1	4986	-	446	1393	1717	0.8112988
A05	5800351	5801551	A05p11680.2_BraZ1	120	+	448	1076	1200	0.8966666
A05	5802132	5802240	A05p11690.2_BraZ1	10.8	-	67	108	108	1.0000000
A05	5803814	5804747	A05p11700.2_BraZ1	786	-	740	933	933	1.0000000
A05	5805938	5808427	A05p11710.2_BraZ1	1475.87	-	2079	2489	2489	1.0000000
A05	5814709	5816170	A05p11720.2_BraZ1	146.1	+	242	886	1461	0.6064339
A05	5823430	5824921	A05p11730.2_BraZ1	147.9	+	301	1367	1491	0.9168344
A05	5825489	5827356	A05p11740.2_BraZ1	1408.96	-	1227	1867	1867	1.0000000
A05	5828489	5829308	A05p11750.2_BraZ1	328.76	-	518	819	819	1.0000000
A05	5835701	5839525	A05p11760.2_BraZ1	2329.1	+	2389	3824	3824	1.0000000
A05	5839846	5840881	A05p11770.2_BraZ1	512.769	-	620	983	1035	0.9497585
A05	5844644	5846752	A05p11780.2_BraZ1	737.28	+	866	2008	2108	0.9525617
A05	5856656	5859235	A05p11790.2_BraZ1	12127.5	+	1240	2353	2579	0.9123691
A05	5863723	5866163	A05p11800.2_BraZ1	1143.52	+	1306	2440	2440	1.0000000
A05	5866701	5866857	A05p11810.2_BraZ1	15.6	-	25	63	156	0.4038461
A05	5868488	5869713	A05p11820.2_BraZ1	1038	+	582	1193	1225	0.9738775
A05	5877955	5880821	A05p11830.2_BraZ1	1146	+	192	1877	2866	0.6549197
A05	5888300	5891651	A05p11840.2_BraZ1	1152	+	1094	3039	3351	0.9068935
A05	5892352	5894545	A05p11850.2_BraZ1	1047	-	1520	1949	2193	0.8887369
A05	5896621	5897950	A05p11860.2_BraZ1	7626	+	1375	1329	1329	1.0000000
A05	5901352	5903619	A05p11870.2_BraZ1	909	-	1726	2267	2267	1.0000000
A05	5907264	5908398	A05p11880.2_BraZ1	700.875	+	38	761	1134	0.6710758
A05	5909847	5911075	A05p11890.2_BraZ1	568.263	+	207	1124	1228	0.9153094
A05	5912290	5917812	A05p11900.2_BraZ1	277.875	-	2411	5275	5522	0.9552698
A05	5913406	5915702	A05p11910.2_BraZ1	162	-	1014	2289	2296	0.9969512
A05	5916586	5918705	A05p11920.2_BraZ1	246	+	1240	1980	2119	0.9344030
A05	5925807	5926318	A05p11930.2_BraZ1	192	-	251	511	511	1.0000000
A05	5940940	5942518	A05p11940.2_BraZ1	1102.62	+	516	1421	1578	0.9005070
A05	5957901	5960479	A05p11950.2_BraZ1	1628.62	+	787	2207	2578	0.8560900
A05	5961446	5961891	A05p11960.2_BraZ1	357	+	354	445	445	1.0000000
A05	5963058	5963783	A05p11970.2_BraZ1	546	-	103	725	725	1.0000000
A05	5969334	5971864	A05p11980.2_BraZ1	1937.25	+	509	2071	2530	0.8185771
A05	5972504	5972636	A05p11990.2_BraZ1	13.2	-	160	132	132	1.0000000
A05	5974168	5974733	A05p12000.2_BraZ1	32.4	+	309	564	565	0.9982301
A05	5976808	5977342	A05p12010.2_BraZ1	447	-	572	534	534	1.0000000
A05	5981488	5982293	A05p12020.2_BraZ1	359.775	-	1797	805	805	1.0000000
A05	5986578	5987181	A05p12030.2_BraZ1	60.3	+	8	540	603	0.8955224
A05	5993534	5993867	A05p12040.2_BraZ1	33.3	-	293	333	333	1.0000000
A05	5995716	5995932	A05p12050.2_BraZ1	21.6	+	283	216	216	1.0000000
A05	5995935	5996043	A05p12060.2_BraZ1	10.8	+	273	108	108	1.0000000
A05	5997416	5997804	A05p12070.2_BraZ1	291	-	4	192	388	0.4948454
A05	6000612	6000981	A05p12080.2_BraZ1	273	-	41	271	369	0.7344173
A05	6001944	6003071	A05p12090.2_BraZ1	11088	+	617	1113	1127	0.9875776
A05	6003337	6004625	A05p12100.2_BraZ1	539.864	-	535	1009	1288	0.7833851
A05	6004882	6005668	A05p12110.2_BraZ1	342.375	+	648	786	786	1.0000000
A05	6006061	6006672	A05p12120.2_BraZ1	582	-	144	567	611	0.9279869
A05	6007192	6007339	A05p12130.2_BraZ1	14.7	-	0	0	147	0.0000000
A05	6007685	6009021	A05p12140.2_BraZ1	553.875	+	0	0	1336	0.0000000
A05	6010774	6017529	A05p12150.2_BraZ1	261.176	+	2150	4949	6755	0.7326425
A05	6017493	6018024	A05p12160.2_BraZ1	267.882	+	294	531	531	1.0000000
A05	6020818	6022110	A05p12170.2_BraZ1	651	+	367	1199	1292	0.9280186
A05	6023439	6024826	A05p12180.2_BraZ1	1109.2	-	420	1298	1387	0.9358327
A05	6028263	6030811	A05p12190.2_BraZ1	1693.44	-	884	2514	2548	0.9866562
A05	6036234	6037814	A05p12200.2_BraZ1	286.125	+	1242	1580	1580	1.0000000
A05	6038191	6039724	A05p12210.2_BraZ1	801.603	+	2085	1533	1533	1.0000000
A05	6040546	6042103	A05p12220.2_BraZ1	1473	-	593	1540	1557	0.9890816
A05	6046153	6048138	A05p12230.2_BraZ1	1295.63	+	2084	1946	1985	0.9803526
A05	6049560	6050970	A05p12240.2_BraZ1	960	+	479	1311	1410	0.9297872
A05	6056707	6061149	A05p12250.2_BraZ1	3486.37	+	798	2762	4442	0.6217920
A05	6061534	6061660	A05p12260.2_BraZ1	12.6	+	49	126	126	1.0000000
A05	6064670	6067081	A05p12270.2_BraZ1	1324.69	+	700	2207	2411	0.9153878
A05	6067353	6068485	A05p12280.2_BraZ1	127.636	-	1143	1132	1132	1.0000000
A05	6069080	6070225	A05p12290.2_BraZ1	4455	-	221	1021	1145	0.8917031
A05	6075491	6079183	A05p12300.2_BraZ1	1572.81	-	1412	3595	3692	0.9737270
A05	6081912	6082581	A05p12310.2_BraZ1	66.9	-	137	669	669	1.0000000
A05	6082581	6084983	A05p12320.2_BraZ1	993	-	1735	2318	2402	0.9650291
A05	6084327	6084983	A05p12330.2_BraZ1	288	-	102	572	656	0.8719512
A05	6087254	6087815	A05p12340.2_BraZ1	56.1	-	37	458	561	0.8163993
A05	6093067	6095897	A05p12350.2_BraZ1	11125.8	-	1102	2707	2830	0.9565371
A05	6097961	6098897	A05p12360.2_BraZ1	762	-	13	322	936	0.3440171
A05	6116547	6119929	A05p12370.2_BraZ1	935.909	+	1731	3331	3382	0.9849201
A05	6120616	6122403	A05p12380.2_BraZ1	692.432	-	1713	1787	1787	1.0000000
A05	6123385	6124677	A05p12390.2_BraZ1	1200	-	421	1245	1292	0.9636223
A05	6125924	6126531	A05p12400.2_BraZ1	1087.5	+	554	607	607	1.0000000
A05	6127561	6128529	A05p12410.2_BraZ1	759	+	543	968	968	1.0000000
A05	6129048	6129868	A05p12420.2_BraZ1	772.286	-	219	814	820	0.9926829
A05	6133960	6136541	A05p12430.2_BraZ1	881.645	+	484	2191	2581	0.8488958
A05	6138397	6139661	A05p12440.2_BraZ1	706.286	+	373	1264	1264	1.0000000
A05	6140413	6142057	A05p12450.2_BraZ1	17259	-	539	1644	1644	1.0000000
A05	6146802	6148416	A05p12460.2_BraZ1	873.4	-	694	1495	1614	0.9262701
A05	6153202	6157355	A05p12470.2_BraZ1	1533.34	+	1673	3510	4153	0.8451722
A05	6158836	6160441	A05p12480.2_BraZ1	861	+	453	1312	1605	0.8174455
A05	6163820	6165506	A05p12490.2_BraZ1	168.6	+	1063	1686	1686	1.0000000
A05	6166105	6166771	A05p12500.2_BraZ1	66.6	+	833	666	666	1.0000000
A05	6174626	6175424	A05p12510.2_BraZ1	612	+	215	758	798	0.9498747
A05	6177133	6182390	A05p12520.2_BraZ1	1797	+	4087	4028	5257	0.7662165
A05	6186392	6188231	A05p12530.2_BraZ1	183.9	-	783	1457	1839	0.7922784
A05	6193777	6195352	A05p12540.2_BraZ1	1470	+	727	1534	1575	0.9739683
A05	6196259	6205763	A05p12550.2_BraZ1	4478.5	+	4750	9477	9504	0.9971591
A05	6208036	6208207	A05p12560.2_BraZ1	17.1	+	476	171	171	1.0000000
A05	6215997	6217694	A05p12570.2_BraZ1	1311	+	1026	1697	1697	1.0000000
A05	6220046	6223398	A05p12580.2_BraZ1	1717.36	+	822	3050	3352	0.9099045
A05	6224611	6225730	A05p12590.2_BraZ1	111.9	-	69	437	1119	0.3905272
A05	6228284	6229526	A05p12600.2_BraZ1	648	-	42	519	1242	0.4178744
A05	6229993	6231332	A05p12610.2_BraZ1	4968.86	-	7	373	1339	0.2785661
A05	6235595	6236182	A05p12620.2_BraZ1	249	-	1002	587	587	1.0000000
A05	6237638	6246101	A05p12630.2_BraZ1	793.181	+	2233	6172	8463	0.7292922
A05	6251936	6255440	A05p12640.2_BraZ1	1362.75	-	1447	2938	3504	0.8384703
A05	6258412	6259931	A05p12650.2_BraZ1	783	-	329	1294	1519	0.8518763
A05	6266419	6268416	A05p12660.2_BraZ1	433.5	-	302	1701	1997	0.8517777
A05	6268957	6271621	A05p12670.2_BraZ1	1756	+	444	2335	2664	0.8765015
A05	6271869	6272316	A05p12680.2_BraZ1	180	+	213	437	447	0.9776286
A05	6272790	6272973	A05p12690.2_BraZ1	18.3	+	5	183	183	1.0000000
A05	6283564	6287762	A05p12700.2_BraZ1	286.125	-	3593	4053	4198	0.9654598
A05	6290683	6290824	A05p12710.2_BraZ1	14.1	+	229	141	141	1.0000000
A05	6291564	6291900	A05p12720.2_BraZ1	33.6	+	523	336	336	1.0000000
A05	6292031	6293845	A05p12730.2_BraZ1	8547	-	1191	1813	1814	0.9994487
A05	6299758	6301526	A05p12740.2_BraZ1	777	-	1573	1768	1768	1.0000000
A05	6309763	6310783	A05p12750.2_BraZ1	74.7	-	29	755	1020	0.7401960
A05	6312951	6316270	A05p12760.2_BraZ1	1711.2	+	2324	3031	3319	0.9132269
A05	6317207	6320034	A05p12770.2_BraZ1	1329.54	+	1785	2827	2827	1.0000000
A05	6321451	6322736	A05p12780.2_BraZ1	23352	+	729	1285	1285	1.0000000
A05	6323449	6327639	A05p12790.2_BraZ1	3108	+	566	3574	4190	0.8529833
A05	6328200	6330639	A05p12800.2_BraZ1	243.9	-	3385	2421	2439	0.9926199
A05	6334334	6336310	A05p12810.2_BraZ1	757.63	-	599	1976	1976	1.0000000
A05	6339172	6345130	A05p12820.2_BraZ1	3405	-	1952	5149	5958	0.8642162
A05	6345647	6347534	A05p12830.2_BraZ1	142.8	-	1120	1834	1887	0.9719131
A05	6347534	6347987	A05p12840.2_BraZ1	45.3	-	531	453	453	1.0000000
A05	6350851	6353257	A05p12850.2_BraZ1	240.6	-	946	2349	2406	0.9763092
A05	6354479	6356088	A05p12860.2_BraZ1	950.373	+	260	1491	1609	0.9266625
A05	6356522	6358016	A05p12870.2_BraZ1	802.588	-	557	1494	1494	1.0000000
A05	6359777	6361351	A05p12880.2_BraZ1	924.706	-	557	1395	1574	0.8862770
A05	6365754	6366171	A05p12890.2_BraZ1	41.7	+	278	417	417	1.0000000
A05	6368651	6372153	A05p12900.2_BraZ1	2430	+	2015	3502	3502	1.0000000
A05	6373434	6375673	A05p12910.2_BraZ1	309.647	-	782	1964	2239	0.8771773
A05	6380149	6381229	A05p12920.2_BraZ1	666	-	68	558	1080	0.5166667
A05	6382314	6385188	A05p12930.2_BraZ1	866.496	-	1349	2695	2874	0.9377174
A05	6385797	6388825	A05p12940.2_BraZ1	1460.79	-	1128	2660	3028	0.8784676
A05	6401052	6403288	A05p12950.2_BraZ1	722.125	+	1952	2231	2236	0.9977639
A05	6403488	6405067	A05p12960.2_BraZ1	56.7	-	990	1469	1579	0.9303356
A05	6413165	6416296	A05p12970.2_BraZ1	1841.91	+	1194	2426	3131	0.7748323
A05	6417198	6420101	A05p12980.2_BraZ1	627.356	-	1831	2408	2903	0.8294867
A05	6433228	6435909	A05p12990.2_BraZ1	990	+	246	1372	2681	0.5117493
A05	6451902	6455329	A05p13000.2_BraZ1	1882.66	-	1516	3129	3427	0.9130435
A05	6456188	6457061	A05p13010.2_BraZ1	448.609	+	660	873	873	1.0000000
A05	6469242	6471613	A05p13020.2_BraZ1	1364.11	+	1756	2371	2371	1.0000000
A05	6473888	6475217	A05p13030.2_BraZ1	132.9	+	696	1329	1329	1.0000000
A05	6477699	6480552	A05p13040.2_BraZ1	1265.02	+	2127	2853	2853	1.0000000
A05	6481182	6484956	A05p13050.2_BraZ1	1851.91	-	1946	3477	3774	0.9213036
A05	6485756	6486077	A05p13060.2_BraZ1	237	+	535	321	321	1.0000000
A05	6486600	6487800	A05p13070.2_BraZ1	513	-	1142	1200	1200	1.0000000
A05	6488721	6496074	A05p13080.2_BraZ1	798	-	2551	6876	7353	0.9351285
A05	6498590	6498971	A05p13090.2_BraZ1	38.1	-	2	239	381	0.6272966
A05	6504776	6504938	A05p13100.2_BraZ1	16.2	+	166	162	162	1.0000000
A05	6506441	6509870	A05p13110.2_BraZ1	1343.66	-	91	1440	3429	0.4199475
A05	6513744	6515879	A05p13120.2_BraZ1	798.6	+	1466	2123	2135	0.9943794
A05	6516226	6517844	A05p13130.2_BraZ1	877.976	+	750	1618	1618	1.0000000
A05	6525239	6530681	A05p13140.2_BraZ1	798.828	-	1433	4959	5442	0.9112459
A05	6545378	6549067	A05p13150.2_BraZ1	1390.34	-	1040	3432	3689	0.9303334
A05	6549929	6550277	A05p13160.2_BraZ1	34.8	-	103	348	348	1.0000000
A05	6552987	6554081	A05p13170.2_BraZ1	30.9	-	32	493	1094	0.4506398
A05	6555003	6555668	A05p13180.2_BraZ1	309	-	254	658	665	0.9894737
A05	6556808	6558320	A05p13190.2_BraZ1	151.2	-	525	1479	1512	0.9781746
A05	6561533	6566398	A05p13200.2_BraZ1	2895.93	-	1914	4589	4865	0.9432682
A05	6567926	6568542	A05p13210.2_BraZ1	237	+	215	54	616	0.0876623
A05	6573795	6576967	A05p13220.2_BraZ1	15450	+	642	2601	3172	0.8199874
A05	6579660	6582838	A05p13230.2_BraZ1	2028	-	989	3146	3178	0.9899307
A05	6589462	6590893	A05p13240.2_BraZ1	444	+	764	1431	1431	1.0000000
A05	6592424	6593939	A05p13250.2_BraZ1	4425	-	1315	1515	1515	1.0000000
A05	6598233	6602179	A05p13260.2_BraZ1	2023.91	-	1566	3920	3946	0.9934111
A05	6607357	6610324	A05p13270.2_BraZ1	296.7	+	4015	2967	2967	1.0000000
A05	6610903	6612555	A05p13280.2_BraZ1	663	-	1321	1575	1652	0.9533898
A05	6613935	6618966	A05p13290.2_BraZ1	1047	-	2273	4623	5031	0.9189028
A05	6616083	6616600	A05p13300.2_BraZ1	41.7	-	150	505	517	0.9767892
A05	6627238	6628152	A05p13310.2_BraZ1	282	-	1946	914	914	1.0000000
A05	6629749	6630301	A05p13320.2_BraZ1	212.727	+	309	552	552	1.0000000
A05	6630717	6632901	A05p13330.2_BraZ1	1701.17	-	1213	2161	2184	0.9894689
A05	6633826	6634873	A05p13340.2_BraZ1	873	-	877	1047	1047	1.0000000
A05	6635271	6640401	A05p13350.2_BraZ1	3699.15	-	1701	4983	5130	0.9713450
A05	6643547	6646537	A05p13360.2_BraZ1	1597.1	-	2344	2979	2990	0.9963211
A05	6647423	6655046	A05p13370.2_BraZ1	1577.95	+	4382	7601	7623	0.9971140
A05	6656466	6656655	A05p13380.2_BraZ1	18.9	+	195	189	189	1.0000000
A05	6662944	6664904	A05p13390.2_BraZ1	1054.72	+	625	1431	1960	0.7301021
A05	6681542	6681821	A05p13400.2_BraZ1	27.9	-	2	150	279	0.5376344
A05	6684998	6685730	A05p13410.2_BraZ1	506.786	+	97	732	732	1.0000000
A05	6686329	6688702	A05p13420.2_BraZ1	1733.35	-	462	2309	2373	0.9730299
A05	6691745	6692379	A05p13430.2_BraZ1	381.333	-	0	0	634	0.0000000
A05	6693498	6694440	A05p13440.2_BraZ1	795	-	372	935	942	0.9925690
A05	6695934	6696677	A05p13450.2_BraZ1	507	+	812	743	743	1.0000000
A05	6699196	6700937	A05p13460.2_BraZ1	888	+	1149	1741	1741	1.0000000
A05	6701904	6702737	A05p13470.2_BraZ1	768	+	133	388	833	0.4657863
A05	6721487	6724989	A05p13480.2_BraZ1	1716.21	+	1708	3202	3502	0.9143347
A05	6725971	6745912	A05p13490.2_BraZ1	4066.91	-	11895	17692	19941	0.8872173
A05	6737854	6739347	A05p13500.2_BraZ1	2580	+	148	828	1493	0.5545881
A05	6758725	6761990	A05p13510.2_BraZ1	1482.67	+	2308	3265	3265	1.0000000
A05	6762424	6772083	A05p13520.2_BraZ1	1438.26	-	3680	7386	9659	0.7646754
A05	6781937	6784436	A05p13530.2_BraZ1	1096.75	+	29685	2499	2499	1.0000000
A05	6785914	6788192	A05p13540.2_BraZ1	1431.82	+	1379	2067	2278	0.9073749
A05	6789142	6789364	A05p13550.2_BraZ1	22.2	+	347	222	222	1.0000000
A05	6799760	6801725	A05p13560.2_BraZ1	1440	-	621	1576	1965	0.8020356
A05	6808805	6810128	A05p13570.2_BraZ1	132.3	-	305	908	1323	0.6863190
A05	6812369	6813497	A05p13580.2_BraZ1	110.4	-	412	1128	1128	1.0000000
A05	6821319	6822405	A05p13590.2_BraZ1	609	-	178	1004	1086	0.9244936
A05	6835799	6837063	A05p13600.2_BraZ1	812.609	-	485	1234	1264	0.9762658
A05	6840554	6843664	A05p13610.2_BraZ1	883.125	+	1646	2860	3110	0.9196141
A05	6846569	6847650	A05p13620.2_BraZ1	704	+	1193	1081	1081	1.0000000
A05	6847916	6851523	A05p13630.2_BraZ1	1677.5	-	1793	3058	3607	0.8477960
A05	6852167	6853903	A05p13640.2_BraZ1	799.523	-	2011	1736	1736	1.0000000
A05	6855127	6855361	A05p13650.2_BraZ1	23.4	+	129	234	234	1.0000000
A05	6857635	6862676	A05p13660.2_BraZ1	900.375	+	3614	4906	5041	0.9732196
A05	6858932	6859145	A05p13670.2_BraZ1	126	-	413	213	213	1.0000000
A05	6860376	6860892	A05p13680.2_BraZ1	51.6	+	205	514	516	0.9961240
A05	6866373	6866680	A05p13690.2_BraZ1	210	+	45	106	307	0.3452769
A05	6870877	6871250	A05p13700.2_BraZ1	222	+	1	68	373	0.1823056
A05	6873925	6875441	A05p13710.2_BraZ1	779.844	-	514	1330	1516	0.8773087
A05	6878416	6878742	A05p13720.2_BraZ1	15.9	+	1641	326	326	1.0000000
A05	6881813	6883508	A05p13730.2_BraZ1	169.5	+	433	1535	1695	0.9056047
A05	6891366	6892080	A05p13740.2_BraZ1	71.4	-	278	714	714	1.0000000
A05	6894220	6895131	A05p13750.2_BraZ1	340.4	-	754	911	911	1.0000000
A05	6895649	6897289	A05p13760.2_BraZ1	856.091	+	701	1640	1640	1.0000000
A05	6898643	6902582	A05p13770.2_BraZ1	714.764	+	1630	3467	3939	0.8801726
A05	6905296	6907639	A05p13780.2_BraZ1	1592.61	-	1089	2343	2343	1.0000000
A05	6924078	6924633	A05p13790.2_BraZ1	55.5	+	139	555	555	1.0000000
A05	6925139	6926129	A05p13800.2_BraZ1	477	-	176	639	990	0.6454545
A05	6927416	6928574	A05p13810.2_BraZ1	115.8	-	750	1158	1158	1.0000000
A05	6935009	6935564	A05p13820.2_BraZ1	55.5	+	12	301	555	0.5423424
A05	6936508	6937644	A05p13830.2_BraZ1	144	-	248	681	1136	0.5994718
A05	6938127	6939237	A05p13840.2_BraZ1	111	-	995	1110	1110	1.0000000
A05	6941086	6942313	A05p13850.2_BraZ1	122.7	-	789	1227	1227	1.0000000
A05	6943557	6945519	A05p13860.2_BraZ1	504	-	927	1763	1962	0.8985729
A05	6947752	6953393	A05p13870.2_BraZ1	1428	+	4206	5162	5641	0.9150860
A05	6953707	6954371	A05p13880.2_BraZ1	216	-	725	664	664	1.0000000
A05	6957893	6958406	A05p13890.2_BraZ1	411	+	593	513	513	1.0000000
A05	6958886	6968848	A05p13900.2_BraZ1	5133.14	-	6959	9886	9962	0.9923710
A05	6973315	6974186	A05p13910.2_BraZ1	435	+	450	871	871	1.0000000
A05	6974582	6974876	A05p13920.2_BraZ1	29.4	-	36	195	294	0.6632653
A05	6985214	6986495	A05p13930.2_BraZ1	621.042	-	1871	1281	1281	1.0000000
A05	6986495	6987695	A05p13940.2_BraZ1	300	+	1545	1200	1200	1.0000000
A05	6996511	6999168	A05p13950.2_BraZ1	1568.22	-	2974	2657	2657	1.0000000
A05	7003555	7005003	A05p13960.2_BraZ1	557.591	+	3398	1448	1448	1.0000000
A05	7004970	7005889	A05p13970.2_BraZ1	712.636	+	1849	919	919	1.0000000
A05	7010494	7012173	A05p13980.2_BraZ1	1975.5	-	4197	1679	1679	1.0000000
A05	7012932	7013394	A05p13990.2_BraZ1	23.1	+	925	462	462	1.0000000
A05	7017018	7017378	A05p14000.2_BraZ1	36	-	419	360	360	1.0000000
A05	7020030	7020462	A05p14010.2_BraZ1	43.2	-	753	432	432	1.0000000
A05	7025110	7025784	A05p14020.2_BraZ1	408	-	383	674	674	1.0000000
A05	7029372	7031477	A05p14030.2_BraZ1	1594.18	+	1731	2105	2105	1.0000000
A05	7035374	7036316	A05p14040.2_BraZ1	94.2	-	398	942	942	1.0000000
A05	7037652	7038352	A05p14050.2_BraZ1	304	+	1178	700	700	1.0000000
A05	7045090	7045392	A05p14060.2_BraZ1	180	+	840	302	302	1.0000000
A05	7046170	7048447	A05p14070.2_BraZ1	1356.39	+	916	2256	2277	0.9907773
A05	7057317	7061889	A05p14080.2_BraZ1	3273.57	+	949	4426	4572	0.9680665
A05	7062227	7064226	A05p14090.2_BraZ1	1810.24	-	391	1823	1999	0.9119560
A05	7068865	7072918	A05p14100.2_BraZ1	617.897	-	2003	3681	4053	0.9082161
A05	7075178	7077686	A05p14110.2_BraZ1	1371	-	1555	2445	2508	0.9748804
A05	7080693	7082672	A05p14120.2_BraZ1	1533	-	1701	1911	1979	0.9656392
A05	7084222	7088032	A05p14130.2_BraZ1	2137.34	+	2143	3528	3810	0.9259843
A05	7091152	7093233	A05p14140.2_BraZ1	432.4	+	1592	2081	2081	1.0000000
A05	7105953	7106286	A05p14150.2_BraZ1	231	+	111	290	333	0.8708709
A05	7108184	7109312	A05p14160.2_BraZ1	112.8	+	1125	1128	1128	1.0000000
A05	7127339	7128183	A05p14170.2_BraZ1	78	+	872	844	844	1.0000000
A05	7128119	7128796	A05p14180.2_BraZ1	480	+	324	604	677	0.8921713
A05	7132555	7133945	A05p14190.2_BraZ1	408	+	1541	1390	1390	1.0000000
A05	7134854	7135142	A05p14200.2_BraZ1	26.7	+	302	288	288	1.0000000
A05	7135828	7142273	A05p14210.2_BraZ1	3036.9	-	3932	6060	6445	0.9402637
A05	7143716	7144823	A05p14220.2_BraZ1	110.7	+	511	1107	1107	1.0000000
A05	7146523	7147360	A05p14230.2_BraZ1	83.7	+	821	837	837	1.0000000
A05	7148069	7152159	A05p14240.2_BraZ1	1499.65	-	4409	4090	4090	1.0000000
A05	7167311	7167614	A05p14250.2_BraZ1	30.3	-	370	303	303	1.0000000
A05	7176903	7178608	A05p14260.2_BraZ1	177	-	1060	1705	1705	1.0000000
A05	7180571	7181088	A05p14270.2_BraZ1	252	-	120	517	517	1.0000000
A05	7183200	7183717	A05p14280.2_BraZ1	249	-	140	517	517	1.0000000
A05	7187767	7188289	A05p14290.2_BraZ1	252	-	180	522	522	1.0000000
A05	7196324	7196785	A05p14300.2_BraZ1	192	-	160	461	461	1.0000000
A05	7197763	7198282	A05p14310.2_BraZ1	252	-	503	519	519	1.0000000
A05	7199945	7200465	A05p14320.2_BraZ1	252	-	444	520	520	1.0000000
A05	7202117	7202637	A05p14330.2_BraZ1	252	-	2	219	520	0.4211538
A05	7204286	7204806	A05p14340.2_BraZ1	252	-	283	447	520	0.8596154
A05	7206481	7207002	A05p14350.2_BraZ1	252	-	19	314	521	0.6026871
A05	7210166	7210687	A05p14360.2_BraZ1	252	-	0	0	521	0.0000000
A05	7212352	7212872	A05p14370.2_BraZ1	45.8182	-	6	264	520	0.5076923
A05	7213849	7214371	A05p14380.2_BraZ1	252	-	390	522	522	1.0000000
A05	7216056	7216576	A05p14390.2_BraZ1	252	-	153	513	520	0.9865385
A05	7219041	7219560	A05p14400.2_BraZ1	252	-	196	519	519	1.0000000
A05	7220375	7221617	A05p14410.2_BraZ1	124.2	-	1911	1242	1242	1.0000000
A05	7222133	7222655	A05p14420.2_BraZ1	252	-	129	522	522	1.0000000
A05	7233256	7234444	A05p14430.2_BraZ1	709.158	+	2	24	1188	0.0202020
A05	7236488	7237784	A05p14440.2_BraZ1	473.077	+	752	1296	1296	1.0000000
A05	7243812	7244853	A05p14450.2_BraZ1	104.1	-	672	1041	1041	1.0000000
A05	7251215	7252717	A05p14460.2_BraZ1	500.049	+	50	868	1502	0.5778961
A05	7265301	7265430	A05p14470.2_BraZ1	12.3	+	1	33	129	0.2558140
A05	7267320	7270883	A05p14480.2_BraZ1	228	-	240	1810	3563	0.5079989
A05	7272124	7272253	A05p14490.2_BraZ1	12.3	+	0	0	129	0.0000000
A05	7277223	7278410	A05p14500.2_BraZ1	733.292	-	29	94	1187	0.0791912
A05	7279598	7281600	A05p14510.2_BraZ1	815.13	+	664	1412	2002	0.7052947
A05	7281791	7281941	A05p14520.2_BraZ1	15	-	11	104	150	0.6933333
A05	7286432	7286582	A05p14530.2_BraZ1	15	-	23	150	150	1.0000000
A05	7287264	7289544	A05p14540.2_BraZ1	1414.04	-	665	2280	2280	1.0000000
A05	7290839	7291439	A05p14550.2_BraZ1	478.957	-	425	562	600	0.9366667
A05	7292291	7292588	A05p14560.2_BraZ1	23.7	-	62	251	297	0.8451179
A05	7293640	7293754	A05p14570.2_BraZ1	11.4	+	39	76	114	0.6666667
A05	7295083	7299474	A05p14580.2_BraZ1	2559	+	937	3441	4391	0.7836484
A05	7299994	7301490	A05p14590.2_BraZ1	2771.62	+	624	1463	1496	0.9779412
A05	7301545	7302785	A05p14600.2_BraZ1	237	-	886	1233	1240	0.9943548
A05	7308759	7309446	A05p14610.2_BraZ1	456	+	380	677	687	0.9854439
A05	7311521	7312769	A05p14620.2_BraZ1	122.4	+	521	1243	1248	0.9959936
A05	7314274	7315748	A05p14630.2_BraZ1	37908	+	263	1375	1474	0.9328358
A05	7317217	7319268	A05p14640.2_BraZ1	1523.2	+	915	1870	2051	0.9117504
A05	7328318	7330902	A05p14650.2_BraZ1	2439	+	1711	2529	2584	0.9787152
A05	7331135	7333878	A05p14660.2_BraZ1	312	-	1447	2605	2743	0.9496901
A05	7334804	7337574	A05p14670.2_BraZ1	2049.31	+	1389	2770	2770	1.0000000
A05	7346601	7349124	A05p14680.2_BraZ1	911.318	+	785	2347	2523	0.9302418
A05	7349340	7350351	A05p14690.2_BraZ1	744.621	-	504	1011	1011	1.0000000
A05	7351270	7352618	A05p14700.2_BraZ1	1091.37	-	710	1290	1348	0.9569733
A05	7359981	7361381	A05p14710.2_BraZ1	905.763	+	434	1225	1400	0.8750000
A05	7368415	7370276	A05p14720.2_BraZ1	926.161	-	1044	1847	1861	0.9924772
A05	7381239	7382491	A05p14730.2_BraZ1	1014	-	614	1252	1252	1.0000000
A05	7386841	7387021	A05p14740.2_BraZ1	18	-	20	180	180	1.0000000
A05	7388260	7388950	A05p14750.2_BraZ1	216	-	193	690	690	1.0000000
A05	7390140	7395206	A05p14760.2_BraZ1	2767.82	+	2376	4940	5066	0.9751283
A05	7395558	7396242	A05p14770.2_BraZ1	5701.5	-	432	593	684	0.8669590
A05	7402827	7403142	A05p14780.2_BraZ1	31.5	+	445	315	315	1.0000000
A05	7404046	7405027	A05p14790.2_BraZ1	96.9	-	188	978	981	0.9969419
A05	7410464	7411112	A05p14800.2_BraZ1	64.8	+	109	539	648	0.8317901
A05	7417489	7420266	A05p14810.2_BraZ1	1516.97	-	1340	2722	2777	0.9801944
A05	7421243	7423275	A05p14820.2_BraZ1	797.296	+	1025	2032	2032	1.0000000
A05	7425035	7425981	A05p14830.2_BraZ1	297	+	176	672	946	0.7103594
A05	7426372	7427446	A05p14840.2_BraZ1	870	-	961	1074	1074	1.0000000
A05	7429967	7430604	A05p14850.2_BraZ1	255	+	300	637	637	1.0000000
A05	7431474	7433037	A05p14860.2_BraZ1	732.692	-	381	1473	1563	0.9424184
A05	7437500	7438182	A05p14870.2_BraZ1	360.818	+	214	682	682	1.0000000
A05	7440339	7441761	A05p14880.2_BraZ1	1021.36	+	672	1251	1422	0.8797469
A05	7449386	7450920	A05p14890.2_BraZ1	1235.89	+	1416	1534	1534	1.0000000
A05	7453837	7454560	A05p14900.2_BraZ1	72.3	-	7	106	723	0.1466113
A05	7487256	7490758	A05p14910.2_BraZ1	1275	-	3546	3502	3502	1.0000000
A05	7495869	7496897	A05p14920.2_BraZ1	1371.86	+	0	0	1028	0.0000000
A05	7499475	7500655	A05p14930.2_BraZ1	1288.71	+	3	266	1180	0.2254237
A05	7503238	7504264	A05p14940.2_BraZ1	1164	+	3	61	1026	0.0594542
A05	7514046	7516594	A05p14950.2_BraZ1	1605.69	+	1613	2538	2548	0.9960753
A05	7518143	7519805	A05p14960.2_BraZ1	166.2	+	1048	1662	1662	1.0000000
A05	7530481	7530714	A05p14970.2_BraZ1	171	+	110	233	233	1.0000000
A05	7530929	7534351	A05p14980.2_BraZ1	1716.74	+	1502	3334	3422	0.9742841
A05	7534890	7535946	A05p14990.2_BraZ1	105.6	+	425	1056	1056	1.0000000
A05	7536526	7536817	A05p15000.2_BraZ1	29.1	-	135	291	291	1.0000000
A05	7539057	7539449	A05p15010.2_BraZ1	141	-	13	246	392	0.6275510
A05	7541468	7542446	A05p15020.2_BraZ1	96.6	+	63	930	978	0.9509202
A05	7543645	7544794	A05p15030.2_BraZ1	98.4	+	222	959	1149	0.8346388
A05	7546269	7547783	A05p15040.2_BraZ1	1060.89	+	994	1514	1514	1.0000000
A05	7550946	7551478	A05p15050.2_BraZ1	243	+	171	489	532	0.9191729
A05	7551988	7553474	A05p15060.2_BraZ1	1227	+	128	853	1486	0.5740242
A05	7557828	7558174	A05p15070.2_BraZ1	24.9	-	55	192	346	0.5549133
A05	7591064	7592111	A05p15080.2_BraZ1	104.7	+	196	1010	1047	0.9646609
A05	7595689	7596342	A05p15090.2_BraZ1	539.156	-	132	545	653	0.8346095
A05	7597978	7598921	A05p15100.2_BraZ1	675	-	704	943	943	1.0000000
A05	7602721	7603327	A05p15110.2_BraZ1	60.3	-	159	588	606	0.9702970
A05	7612630	7613580	A05p15120.2_BraZ1	408	+	717	950	950	1.0000000
A05	7617632	7619056	A05p15130.2_BraZ1	333.75	-	76	554	1424	0.3890449
A05	7619203	7619314	A05p15140.2_BraZ1	11.1	-	50	84	111	0.7567568
A05	7623629	7625063	A05p15150.2_BraZ1	1320	+	595	1326	1434	0.9246862
A05	7625573	7629869	A05p15160.2_BraZ1	513.281	+	5886	4164	4296	0.9692737
A05	7627005	7627377	A05p15170.2_BraZ1	37.2	+	227	372	372	1.0000000
A05	7631118	7633267	A05p15180.2_BraZ1	1037.09	-	1633	2149	2149	1.0000000
A05	7634923	7636018	A05p15190.2_BraZ1	109.5	+	1131	1095	1095	1.0000000
A05	7636459	7638710	A05p15200.2_BraZ1	2023.68	-	277	1914	2251	0.8502887
A05	7643163	7645019	A05p15210.2_BraZ1	1048.74	-	567	1634	1856	0.8803879
A05	7645821	7646169	A05p15220.2_BraZ1	34.8	-	390	348	348	1.0000000
A05	7648084	7649200	A05p15230.2_BraZ1	481.5	+	258	1116	1116	1.0000000
A05	7653522	7653774	A05p15240.2_BraZ1	25.2	-	0	0	252	0.0000000
A05	7656676	7657456	A05p15250.2_BraZ1	576	-	73	436	780	0.5589744
A05	7669874	7670913	A05p15260.2_BraZ1	148.778	+	473	901	1039	0.8671800
A05	7671284	7674212	A05p15270.2_BraZ1	1054.12	-	3184	2926	2928	0.9993169
A05	7676329	7676838	A05p15280.2_BraZ1	405	+	0	0	509	0.0000000
A05	7678140	7678665	A05p15290.2_BraZ1	180	+	10	224	525	0.4266667
A05	7692607	7705281	A05p15300.2_BraZ1	2390.25	+	13728	12674	12674	1.0000000
A05	7705233	7706773	A05p15310.2_BraZ1	482.594	+	1004	1357	1540	0.8811688
A05	7708044	7709750	A05p15320.2_BraZ1	987.349	-	526	1545	1706	0.9056272
A05	7712959	7715760	A05p15330.2_BraZ1	2136	-	1720	2628	2801	0.9382364
A05	7719592	7721088	A05p15340.2_BraZ1	661.418	-	596	1311	1496	0.8763369
A05	7739058	7741269	A05p15350.2_BraZ1	221.1	+	1082	2211	2211	1.0000000
A05	7741667	7744023	A05p15360.2_BraZ1	1559.27	+	436	1912	2356	0.8115450
A05	7744954	7745799	A05p15370.2_BraZ1	9324	-	331	845	845	1.0000000
A05	7752057	7752198	A05p15380.2_BraZ1	14.1	-	117	141	141	1.0000000
A05	7752722	7753888	A05p15390.2_BraZ1	9296.25	-	453	1146	1166	0.9828473
A05	7759290	7762876	A05p15400.2_BraZ1	2036.81	-	2005	3186	3586	0.8884551
A05	7769976	7770670	A05p15410.2_BraZ1	402	+	2	153	694	0.2204611
A05	7772688	7772943	A05p15420.2_BraZ1	25.2	-	141	255	255	1.0000000
A05	7775690	7775999	A05p15430.2_BraZ1	30.9	+	126	309	309	1.0000000
A05	7778265	7780212	A05p15440.2_BraZ1	194.7	-	795	1864	1947	0.9573703
A05	7784308	7787118	A05p15450.2_BraZ1	1600.59	+	688	2655	2810	0.9448398
A05	7787871	7788771	A05p15460.2_BraZ1	90	+	206	796	900	0.8844444
A05	7792031	7792517	A05p15470.2_BraZ1	201	-	296	486	486	1.0000000
A05	7792728	7793007	A05p15480.2_BraZ1	27.9	-	141	277	279	0.9928315
A05	7803867	7805887	A05p15490.2_BraZ1	1476.6	+	238	1596	2020	0.7900990
A05	7806546	7811014	A05p15500.2_BraZ1	384.563	+	1008	3137	4468	0.7021039
A05	7817225	7820264	A05p15510.2_BraZ1	2071.73	+	979	3023	3039	0.9947351
A05	7821956	7823431	A05p15520.2_BraZ1	165	+	1338	1475	1475	1.0000000
A05	7823879	7824535	A05p15530.2_BraZ1	333	-	405	656	656	1.0000000
A05	7829995	7830946	A05p15540.2_BraZ1	95.1	-	428	683	951	0.7181914
A05	7838069	7838898	A05p15550.2_BraZ1	7038	+	468	829	829	1.0000000
A05	7839392	7840634	A05p15560.2_BraZ1	124.2	-	704	1242	1242	1.0000000
A05	7846079	7847411	A05p15570.2_BraZ1	133.2	+	151	963	1332	0.7229730
A05	7858599	7860638	A05p15580.2_BraZ1	807	+	369	1403	2039	0.6880824
A05	7892828	7893763	A05p15590.2_BraZ1	38.4	+	813	933	935	0.9978610
A05	7898162	7898837	A05p15600.2_BraZ1	342	-	332	675	675	1.0000000
A05	7900546	7902371	A05p15610.2_BraZ1	15450	-	138	1420	1825	0.7780822
A05	7906518	7908396	A05p15620.2_BraZ1	1051.48	+	666	1857	1878	0.9888179
A05	7908849	7910370	A05p15630.2_BraZ1	719.278	+	1046	1521	1521	1.0000000
A05	7910742	7912254	A05p15640.2_BraZ1	1041.86	+	573	1301	1512	0.8604497
A05	7917242	7917512	A05p15650.2_BraZ1	27	-	151	270	270	1.0000000
A05	7919870	7920407	A05p15660.2_BraZ1	53.7	-	5	38	537	0.0707635
A05	7932992	7933508	A05p15670.2_BraZ1	357	-	187	516	516	1.0000000
A05	7936077	7938131	A05p15680.2_BraZ1	23848	+	154	1711	2054	0.8330088
A05	7939205	7941338	A05p15690.2_BraZ1	1123.36	+	1474	2095	2133	0.9821847
A05	7943920	7953764	A05p15700.2_BraZ1	2967.2	+	3129	8472	9844	0.8606257
A05	7954054	7955467	A05p15710.2_BraZ1	1002	-	755	1394	1413	0.9865534
A05	7957985	7959595	A05p15720.2_BraZ1	16488	-	527	1421	1610	0.8826087
A05	7964754	7966233	A05p15730.2_BraZ1	2787.75	-	1402	1479	1479	1.0000000
A05	7972946	7973778	A05p15740.2_BraZ1	1520	-	55	614	832	0.7379808
A05	7984337	7984698	A05p15750.2_BraZ1	249	-	316	361	361	1.0000000
A05	7992862	7994220	A05p15760.2_BraZ1	761.885	+	509	1358	1358	1.0000000
A05	7998363	7998861	A05p15770.2_BraZ1	49.8	-	180	477	498	0.9578313
A05	8004764	8009162	A05p15780.2_BraZ1	3291.26	+	586	3494	4398	0.7944520
A05	8014605	8015811	A05p15790.2_BraZ1	120.6	+	305	1199	1206	0.9941957
A05	8016338	8018053	A05p15800.2_BraZ1	403.542	-	118	784	1715	0.4571429
A05	8022350	8022657	A05p15810.2_BraZ1	29.7	+	23	256	307	0.8338762
A05	8023671	8025406	A05p15820.2_BraZ1	1173	+	775	1274	1735	0.7342939
A05	8033266	8035088	A05p15830.2_BraZ1	1020	+	1056	1792	1822	0.9835346
A05	8035291	8038730	A05p15840.2_BraZ1	2331.34	-	1489	3439	3439	1.0000000
A05	8053969	8058678	A05p15850.2_BraZ1	2307	-	2612	4702	4709	0.9985135
A05	8068157	8069406	A05p15860.2_BraZ1	12285	-	1032	1249	1249	1.0000000
A05	8076493	8080753	A05p15870.2_BraZ1	1111.24	-	2026	4001	4260	0.9392019
A05	8082400	8085744	A05p15880.2_BraZ1	219	+	1110	3241	3344	0.9691986
A05	8113194	8117715	A05p15890.2_BraZ1	1143.63	+	1507	3729	4521	0.8248175
A05	8119835	8120238	A05p15900.2_BraZ1	327	-	494	403	403	1.0000000
A05	8123655	8124051	A05p15910.2_BraZ1	39.6	+	86	396	396	1.0000000
A05	8133323	8134117	A05p15920.2_BraZ1	2580	-	105	794	794	1.0000000
A05	8136310	8139800	A05p15930.2_BraZ1	2697.39	-	620	2598	3490	0.7444126
A05	8145691	8145982	A05p15940.2_BraZ1	29.1	-	121	291	291	1.0000000
A05	8152036	8153229	A05p15950.2_BraZ1	582.914	+	790	1054	1193	0.8834870
A05	8156262	8156532	A05p15960.2_BraZ1	27	+	238	270	270	1.0000000
A05	8157012	8158699	A05p15970.2_BraZ1	6144	+	1235	1685	1687	0.9988145
A05	8159133	8160306	A05p15980.2_BraZ1	117.3	-	534	1173	1173	1.0000000
A05	8169965	8171984	A05p15990.2_BraZ1	1620.67	+	1141	2019	2019	1.0000000
A05	8173569	8173985	A05p16000.2_BraZ1	372	-	607	416	416	1.0000000
A05	8174938	8179740	A05p16010.2_BraZ1	2400.78	-	354	2926	4802	0.6093295
A05	8181296	8183516	A05p16020.2_BraZ1	222	-	147	514	2220	0.2315315
A05	8195948	8196122	A05p16030.2_BraZ1	17.4	+	63	174	174	1.0000000
A05	8199389	8200795	A05p16040.2_BraZ1	7626	+	284	1176	1406	0.8364154
A05	8201106	8201887	A05p16050.2_BraZ1	652.891	-	238	781	781	1.0000000
A05	8206724	8214453	A05p16060.2_BraZ1	1534.5	-	4992	7470	7729	0.9664899
A05	8208801	8209308	A05p16070.2_BraZ1	3894	-	1332	507	507	1.0000000
A05	8211232	8212310	A05p16080.2_BraZ1	776.333	+	93	876	1078	0.8126159
A05	8217421	8218555	A05p16090.2_BraZ1	113.4	+	2162	1089	1134	0.9603174
A05	8219062	8220816	A05p16100.2_BraZ1	2326.91	-	1062	1754	1754	1.0000000
A05	8222244	8224882	A05p16110.2_BraZ1	1866	-	848	2572	2638	0.9749811
A05	8225340	8226290	A05p16120.2_BraZ1	275	-	963	950	950	1.0000000
A05	8234723	8234978	A05p16130.2_BraZ1	25.5	+	30	255	255	1.0000000
A05	8235503	8235800	A05p16140.2_BraZ1	243	-	4	256	297	0.8619528
A05	8236436	8237351	A05p16150.2_BraZ1	612	+	8	275	915	0.3005464
A05	8241223	8242084	A05p16160.2_BraZ1	531	-	302	837	861	0.9721254
A05	8245585	8246542	A05p16170.2_BraZ1	95.7	+	23	345	957	0.3605016
A05	8248138	8251980	A05p16180.2_BraZ1	1401	+	1799	3841	3842	0.9997397
A05	8252255	8254318	A05p16190.2_BraZ1	1085.38	-	205	1328	2063	0.6437227
A05	8257983	8266801	A05p16200.2_BraZ1	558	-	471	4546	8818	0.5155364
A05	8269787	8272260	A05p16210.2_BraZ1	1389.38	+	705	2380	2473	0.9623939
A05	8272658	8274919	A05p16220.2_BraZ1	1419	-	1797	2261	2261	1.0000000
A05	8278023	8278470	A05p16230.2_BraZ1	44.7	+	74	447	447	1.0000000
A05	8279710	8280178	A05p16240.2_BraZ1	168	-	85	316	468	0.6752137
A05	8280278	8282768	A05p16250.2_BraZ1	1792.73	-	305	1757	2490	0.7056225
A05	8285881	8288766	A05p16260.2_BraZ1	1890.85	+	2478	2885	2885	1.0000000
A05	8289037	8289205	A05p16270.2_BraZ1	16.8	+	276	168	168	1.0000000
A05	8290536	8291248	A05p16280.2_BraZ1	480	+	501	712	712	1.0000000
A05	8291547	8291781	A05p16290.2_BraZ1	23.4	-	151	234	234	1.0000000
A05	8292126	8293260	A05p16300.2_BraZ1	113.4	-	414	1134	1134	1.0000000
A05	8297177	8298368	A05p16310.2_BraZ1	688.471	+	500	1179	1191	0.9899244
A05	8298719	8301533	A05p16320.2_BraZ1	1431	-	898	2695	2814	0.9577115
A05	8302211	8304145	A05p16330.2_BraZ1	140.7	+	1555	1915	1934	0.9901758
A05	8304929	8305695	A05p16340.2_BraZ1	332.222	-	745	766	766	1.0000000
A05	8306129	8307086	A05p16350.2_BraZ1	286.977	+	541	957	957	1.0000000
A05	8308994	8311500	A05p16360.2_BraZ1	8526	-	1717	2352	2506	0.9385475
A05	8312625	8313096	A05p16370.2_BraZ1	47.1	+	119	471	471	1.0000000
A05	8315437	8315917	A05p16380.2_BraZ1	48	+	183	461	480	0.9604167
A05	8317502	8318268	A05p16390.2_BraZ1	6412.5	+	85	690	766	0.9007833
A05	8321307	8322110	A05p16400.2_BraZ1	8550	+	65	657	803	0.8181818
A05	8333915	8334530	A05p16410.2_BraZ1	61.5	+	0	0	615	0.0000000
A05	8335741	8336010	A05p16420.2_BraZ1	201	-	110	269	269	1.0000000
A05	8336878	8337656	A05p16430.2_BraZ1	76.5	+	184	627	778	0.8059126
A05	8342215	8343553	A05p16440.2_BraZ1	703.239	+	570	1338	1338	1.0000000
A05	8351670	8354917	A05p16450.2_BraZ1	1113	-	481	1971	3247	0.6070219
A05	8359995	8360233	A05p16460.2_BraZ1	19.2	-	110	238	238	1.0000000
A05	8366532	8368036	A05p16470.2_BraZ1	819.346	+	272	967	1504	0.6429521
A05	8368383	8369238	A05p16480.2_BraZ1	423	+	843	855	855	1.0000000
A05	8371390	8375716	A05p16490.2_BraZ1	928.125	-	2134	4326	4326	1.0000000
A05	8378383	8378681	A05p16500.2_BraZ1	192	+	382	298	298	1.0000000
A05	8397735	8399356	A05p16510.2_BraZ1	765.725	+	1336	1621	1621	1.0000000
A05	8400725	8402191	A05p16520.2_BraZ1	937.143	+	443	1420	1466	0.9686221
A05	8403947	8405589	A05p16530.2_BraZ1	1075.98	-	409	1099	1642	0.6693057
A05	8411976	8413114	A05p16540.2_BraZ1	797.966	-	130	853	1138	0.7495607
A05	8414511	8415685	A05p16550.2_BraZ1	654.511	-	366	1149	1174	0.9787053
A05	8419343	8420460	A05p16560.2_BraZ1	463.286	-	430	1094	1117	0.9794092
A05	8422156	8423263	A05p16570.2_BraZ1	6969.5	-	183	686	1107	0.6196929
A05	8424870	8426760	A05p16580.2_BraZ1	189	+	591	1858	1890	0.9830688
A05	8428130	8431467	A05p16590.2_BraZ1	2353.24	-	868	3206	3337	0.9607432
A05	8433141	8434092	A05p16600.2_BraZ1	2189.5	+	575	951	951	1.0000000
A05	8434541	8434715	A05p16610.2_BraZ1	17.4	+	7	174	174	1.0000000
A05	8434916	8435334	A05p16620.2_BraZ1	348	-	0	0	418	0.0000000
A05	8436232	8437615	A05p16630.2_BraZ1	1248	-	127	1183	1383	0.8553869
A05	8444276	8447038	A05p16640.2_BraZ1	8085	-	129	1386	2762	0.5018103
A05	8454492	8456782	A05p16650.2_BraZ1	1304.6	+	511	2013	2290	0.8790393
A05	8470689	8475168	A05p16660.2_BraZ1	2310	+	1774	4191	4479	0.9356999
A05	8476421	8477819	A05p16670.2_BraZ1	483.955	-	188	976	1398	0.6981402
A05	8478316	8480565	A05p16680.2_BraZ1	3385	-	1628	2101	2249	0.9341930
A05	8483567	8484312	A05p16690.2_BraZ1	139.65	+	833	745	745	1.0000000
A05	8486632	8487146	A05p16700.2_BraZ1	59.1667	-	652	514	514	1.0000000
A05	8487486	8492018	A05p16710.2_BraZ1	1039.5	-	2828	4305	4532	0.9499117
A05	8521976	8523526	A05p16720.2_BraZ1	787.286	+	588	1525	1550	0.9838710
A05	8527944	8528325	A05p16730.2_BraZ1	234	+	9	286	381	0.7506562
A05	8530908	8535441	A05p16740.2_BraZ1	2292.74	-	825	3032	4533	0.6688727
A05	8538218	8550031	A05p16750.2_BraZ1	1836.71	+	10215	11661	11813	0.9871328
A05	8559258	8559870	A05p16760.2_BraZ1	231	+	171	612	612	1.0000000
A05	8567473	8568612	A05p16770.2_BraZ1	878.92	+	1079	1139	1139	1.0000000
A05	8588742	8592236	A05p16780.2_BraZ1	1225	+	1161	3055	3494	0.8743560
A05	8611723	8613223	A05p16790.2_BraZ1	150	+	286	1244	1500	0.8293333
A05	8616296	8619906	A05p16800.2_BraZ1	1307.81	+	1124	3050	3610	0.8448753
A05	8624977	8626820	A05p16810.2_BraZ1	1044	-	520	1480	1843	0.8030385
A05	8632013	8634267	A05p16820.2_BraZ1	6965.25	+	779	1675	2254	0.7431234
A05	8641332	8641647	A05p16830.2_BraZ1	31.5	-	255	315	315	1.0000000
A05	8642720	8644724	A05p16840.2_BraZ1	1237.04	+	816	1902	2004	0.9491018
A05	8651982	8653398	A05p16850.2_BraZ1	4590	+	22	528	1416	0.3728814
A05	8671144	8672257	A05p16860.2_BraZ1	111.3	+	185	1083	1113	0.9730458
A05	8682635	8684047	A05p16870.2_BraZ1	4590	+	217	715	1412	0.5063739
A05	8692335	8692500	A05p16880.2_BraZ1	16.5	+	173	165	165	1.0000000
A05	8692762	8694588	A05p16890.2_BraZ1	941.059	+	149	1219	1826	0.6675794
A05	8700361	8700736	A05p16900.2_BraZ1	37.5	+	379	375	375	1.0000000
A05	8703412	8704037	A05p16910.2_BraZ1	534	+	167	545	625	0.8720000
A05	8707232	8713917	A05p16920.2_BraZ1	2540.69	-	1742	5507	6685	0.8237846
A05	8718846	8724317	A05p16930.2_BraZ1	2222.31	+	1374	4580	5471	0.8371413
A05	8726858	8730393	A05p16940.2_BraZ1	3277.77	-	623	2239	3535	0.6333805
A05	8733250	8738970	A05p16950.2_BraZ1	270.161	+	3495	5714	5720	0.9989511
A05	8741470	8741825	A05p16960.2_BraZ1	22.5	+	609	355	355	1.0000000
A05	8743233	8744087	A05p16970.2_BraZ1	636	+	311	772	854	0.9039813
A05	8764485	8767401	A05p16980.2_BraZ1	1551.86	+	966	2495	2916	0.8556241
A05	8777751	8778255	A05p16990.2_BraZ1	50.4	+	145	504	504	1.0000000
A05	8780742	8782497	A05p17000.2_BraZ1	1213.83	-	426	1622	1755	0.9242165
A05	8792628	8793508	A05p17010.2_BraZ1	663	-	124	590	880	0.6704546
A05	8800275	8802477	A05p17020.2_BraZ1	1945.31	+	2250	2202	2202	1.0000000
A05	8818749	8820261	A05p17030.2_BraZ1	151.2	+	604	1398	1512	0.9246032
A05	8829539	8830067	A05p17040.2_BraZ1	306	-	760	528	528	1.0000000
A05	8832764	8834042	A05p17050.2_BraZ1	1496	+	61	480	1278	0.3755869
A05	8846414	8848030	A05p17060.2_BraZ1	8797.5	+	849	1616	1616	1.0000000
A05	8849468	8850185	A05p17070.2_BraZ1	453	+	118	693	717	0.9665272
A05	8856998	8858588	A05p17080.2_BraZ1	159	-	153	1171	1590	0.7364780
A05	8862354	8863738	A05p17090.2_BraZ1	644.318	+	355	1124	1384	0.8121387
A05	8869583	8870969	A05p17100.2_BraZ1	726.64	+	934	1386	1386	1.0000000
A05	8873064	8873863	A05p17110.2_BraZ1	65	-	260	799	799	1.0000000
A05	8876573	8879948	A05p17120.2_BraZ1	741	-	1346	2454	3375	0.7271111
A05	8888538	8893693	A05p17130.2_BraZ1	2653.67	-	1120	4526	5155	0.8779826
A05	8894831	8895109	A05p17140.2_BraZ1	207	+	15	265	278	0.9532374
A05	8897609	8899099	A05p17150.2_BraZ1	315	-	903	1490	1490	1.0000000
A05	8899568	8899721	A05p17160.2_BraZ1	15.3	-	236	153	153	1.0000000
A05	8903007	8903327	A05p17170.2_BraZ1	228	-	305	320	320	1.0000000
A05	8905457	8907998	A05p17180.2_BraZ1	2330.8	-	333	1697	2541	0.6678473
A05	8918316	8922192	A05p17190.2_BraZ1	2037.93	+	852	3308	3876	0.8534572
A05	8923452	8924650	A05p17200.2_BraZ1	390	-	392	978	1198	0.8163606
A05	8926448	8929698	A05p17210.2_BraZ1	1932.95	-	1319	2739	3250	0.8427692
A05	8940249	8941842	A05p17220.2_BraZ1	578.25	+	175	1167	1593	0.7325801
A05	8946966	8948550	A05p17230.2_BraZ1	612.804	+	167	651	1584	0.4109848
A05	8961693	8967364	A05p17240.2_BraZ1	1670.12	+	1693	5193	5671	0.9157115
A05	8967578	8968363	A05p17250.2_BraZ1	659.022	-	231	785	785	1.0000000
A05	8968983	8969374	A05p17260.2_BraZ1	348	-	639	391	391	1.0000000
A05	8970949	8972775	A05p17270.2_BraZ1	1526.32	-	389	1227	1826	0.6719606
A05	8972985	8975129	A05p17280.2_BraZ1	2055	+	149	1243	2144	0.5797575
A05	8985089	8986121	A05p17290.2_BraZ1	103.2	+	9	258	1032	0.2500000
A05	8991320	8992361	A05p17300.2_BraZ1	104.1	+	162	936	1041	0.8991355
A05	8998245	8999277	A05p17310.2_BraZ1	103.2	+	25	370	1032	0.3585271
A05	9003701	9004519	A05p17320.2_BraZ1	1107.75	-	217	814	818	0.9951100
A05	9005145	9005867	A05p17330.2_BraZ1	416.25	-	265	722	722	1.0000000
A05	9005919	9006456	A05p17340.2_BraZ1	255	+	443	537	537	1.0000000
A05	9010282	9013395	A05p17350.2_BraZ1	3036	-	2593	3113	3113	1.0000000
A05	9015752	9017018	A05p17360.2_BraZ1	723	+	101	314	1266	0.2480253
A05	9018783	9020023	A05p17370.2_BraZ1	42.9	+	92	621	1240	0.5008065
A05	9020104	9021162	A05p17380.2_BraZ1	59.7	-	19	460	1058	0.4347826
A05	9021109	9025198	A05p17390.2_BraZ1	197.7	-	32	789	4089	0.1929567
A05	9025697	9026761	A05p17400.2_BraZ1	36.3	-	20	653	1064	0.6137218
A05	9026156	9031488	A05p17410.2_BraZ1	273.6	-	2347	3310	5332	0.6207802
A05	9031488	9031788	A05p17420.2_BraZ1	30	-	11	235	300	0.7833334
A05	9032757	9032994	A05p17430.2_BraZ1	23.7	-	96	237	237	1.0000000
A05	9041704	9043200	A05p17440.2_BraZ1	591	+	1683	1496	1496	1.0000000
A05	9050754	9051786	A05p17450.2_BraZ1	103.2	+	0	0	1032	0.0000000
A05	9056306	9056920	A05p17460.2_BraZ1	258	+	483	614	614	1.0000000
A05	9062397	9063429	A05p17470.2_BraZ1	103.2	+	0	0	1032	0.0000000
A05	9068840	9070694	A05p17480.2_BraZ1	586.15	+	986	1854	1854	1.0000000
A05	9074420	9074903	A05p17490.2_BraZ1	426	-	184	483	483	1.0000000
A05	9075377	9076881	A05p17500.2_BraZ1	252.632	-	920	1504	1504	1.0000000
A05	9079996	9080761	A05p17510.2_BraZ1	477	+	428	765	765	1.0000000
A05	9100966	9101239	A05p17520.2_BraZ1	27.3	+	565	273	273	1.0000000
A05	9103782	9104666	A05p17530.2_BraZ1	240	-	1849	884	884	1.0000000
A05	9118530	9118659	A05p17540.2_BraZ1	12.9	+	228	129	129	1.0000000
A05	9119752	9122790	A05p17550.2_BraZ1	2408.73	+	920	1610	3038	0.5299539
A05	9125859	9127059	A05p17560.2_BraZ1	788.684	+	218	967	1200	0.8058333
A05	9128071	9129096	A05p17570.2_BraZ1	615.868	+	303	1017	1025	0.9921951
A05	9131455	9133115	A05p17580.2_BraZ1	757.059	+	330	1323	1660	0.7969880
A05	9139995	9140565	A05p17590.2_BraZ1	483	-	105	356	570	0.6245614
A05	9160670	9161092	A05p17600.2_BraZ1	258	-	623	422	422	1.0000000
A05	9169432	9170440	A05p17610.2_BraZ1	100.8	+	3791	876	1008	0.8690476
A05	9177339	9179734	A05p17620.2_BraZ1	3071.25	+	1513	2205	2395	0.9206681
A05	9187402	9197519	A05p17630.2_BraZ1	7019.79	+	487	4478	10117	0.4426213
A05	9198047	9200860	A05p17640.2_BraZ1	1993.88	-	723	2399	2813	0.8528262
A05	9204864	9208604	A05p17650.2_BraZ1	147	+	1176	3475	3740	0.9291444
A05	9220494	9220653	A05p17660.2_BraZ1	15.9	-	11	159	159	1.0000000
A05	9231027	9231186	A05p17670.2_BraZ1	15.9	-	63	159	159	1.0000000
A05	9232250	9232913	A05p17680.2_BraZ1	57.6	+	0	0	663	0.0000000
A05	9235862	9236021	A05p17690.2_BraZ1	15.9	-	158	159	159	1.0000000
A05	9240194	9246539	A05p17700.2_BraZ1	3598.04	+	611	3938	6345	0.6206462
A05	9255230	9256016	A05p17710.2_BraZ1	762	-	18	539	786	0.6857507
A05	9268963	9269809	A05p17720.2_BraZ1	6125	-	708	846	846	1.0000000
A05	9278816	9280703	A05p17730.2_BraZ1	188.7	-	128	1029	1887	0.5453100
A05	9285783	9287696	A05p17740.2_BraZ1	1116.36	-	785	1823	1913	0.9529535
A05	9289444	9289702	A05p17750.2_BraZ1	25.8	-	1	8	258	0.0310078
A05	9290269	9292224	A05p17760.2_BraZ1	1356.81	+	481	1902	1955	0.9728900
A05	9293124	9295020	A05p17770.2_BraZ1	1109.44	-	724	1851	1896	0.9762658
A05	9297445	9297574	A05p17780.2_BraZ1	12.9	+	167	129	129	1.0000000
A05	9299194	9300250	A05p17790.2_BraZ1	105.6	-	709	1048	1056	0.9924242
A05	9302422	9304325	A05p17800.2_BraZ1	1039.25	-	415	1903	1903	1.0000000
A05	9305377	9306571	A05p17810.2_BraZ1	119.4	-	138	1081	1194	0.9053602
A05	9307679	9310585	A05p17820.2_BraZ1	845.64	+	1892	2761	2906	0.9501032
A05	9311162	9311767	A05p17830.2_BraZ1	43.8	-	97	582	605	0.9619834
A05	9312440	9313025	A05p17840.2_BraZ1	456	-	91	546	585	0.9333333
A05	9313343	9315838	A05p17850.2_BraZ1	1618.5	-	604	2371	2495	0.9503006
A05	9320050	9320152	A05p17860.2_BraZ1	10.2	+	117	102	102	1.0000000
A05	9326296	9327298	A05p17870.2_BraZ1	597	+	1073	1002	1002	1.0000000
A05	9329915	9330446	A05p17880.2_BraZ1	53.1	+	42	337	531	0.6346516
A05	9337952	9338390	A05p17890.2_BraZ1	43.8	+	184	438	438	1.0000000
A05	9338678	9339161	A05p17900.2_BraZ1	48.3	+	90	483	483	1.0000000
A05	9340001	9340115	A05p17910.2_BraZ1	11.4	-	275	114	114	1.0000000
A05	9354049	9355109	A05p17920.2_BraZ1	386.571	-	974	1060	1060	1.0000000
A05	9364388	9366277	A05p17930.2_BraZ1	1461.38	+	364	1607	1889	0.8507147
A05	9368386	9369929	A05p17940.2_BraZ1	300	+	1093	1543	1543	1.0000000
A05	9377081	9378170	A05p17950.2_BraZ1	412.174	+	832	1089	1089	1.0000000
A05	9379455	9380460	A05p17960.2_BraZ1	100.5	+	425	1005	1005	1.0000000
A05	9380912	9381201	A05p17970.2_BraZ1	195	+	115	289	289	1.0000000
A05	9384547	9384841	A05p17980.2_BraZ1	192	+	278	294	294	1.0000000
A05	9385798	9388786	A05p17990.2_BraZ1	333.804	+	2591	2972	2988	0.9946452
A05	9388780	9391656	A05p18000.2_BraZ1	1138.3	+	3369	2876	2876	1.0000000
A05	9392124	9393666	A05p18010.2_BraZ1	763.125	-	1135	1495	1542	0.9695201
A05	9394885	9396055	A05p18020.2_BraZ1	117	-	471	1170	1170	1.0000000
A05	9400548	9401793	A05p18030.2_BraZ1	854.609	+	164	652	1245	0.5236948
A05	9404184	9404511	A05p18040.2_BraZ1	32.7	+	43	327	327	1.0000000
A05	9415472	9416534	A05p18050.2_BraZ1	528	-	804	1062	1062	1.0000000
A05	9416306	9417598	A05p18060.2_BraZ1	1005	-	1385	1292	1292	1.0000000
A05	9424423	9425891	A05p18070.2_BraZ1	385.987	-	273	1244	1468	0.8474115
A05	9433704	9433884	A05p18080.2_BraZ1	18	+	10	28	180	0.1555556
A05	9435541	9444371	A05p18090.2_BraZ1	4994.88	-	1505	6049	8830	0.6850510
A05	9447880	9451143	A05p18100.2_BraZ1	839.554	-	1059	2705	3263	0.8289917
A05	9452502	9454678	A05p18110.2_BraZ1	602.25	-	1208	2176	2176	1.0000000
A05	9457156	9458662	A05p18120.2_BraZ1	610.393	+	1028	1506	1506	1.0000000
A05	9461477	9461697	A05p18130.2_BraZ1	19.2	-	102	220	220	1.0000000
A05	9463102	9464249	A05p18140.2_BraZ1	468	-	908	1060	1147	0.9241499
A05	9471265	9472739	A05p18150.2_BraZ1	1308	+	404	1474	1474	1.0000000
A05	9473529	9474000	A05p18160.2_BraZ1	47.1	-	95	470	471	0.9978769
A05	9485260	9486758	A05p18170.2_BraZ1	160.5	+	1868	1498	1498	1.0000000
A05	9488162	9489108	A05p18180.2_BraZ1	93.9	-	591	865	946	0.9143763
A05	9503754	9504321	A05p18190.2_BraZ1	56.7	+	259	526	567	0.9276896
A05	9505919	9506489	A05p18200.2_BraZ1	57	-	235	570	570	1.0000000
A05	9508128	9508912	A05p18210.2_BraZ1	582	-	198	780	784	0.9948980
A05	9510227	9510839	A05p18220.2_BraZ1	579	-	312	588	612	0.9607843
A05	9512084	9514122	A05p18230.2_BraZ1	1854.29	-	1571	2019	2038	0.9906771
A05	9517283	9518234	A05p18240.2_BraZ1	370.062	-	1167	951	951	1.0000000
A05	9519177	9523852	A05p18250.2_BraZ1	509.318	+	2905	4675	4675	1.0000000
A05	9523845	9524632	A05p18260.2_BraZ1	256.255	+	337	787	787	1.0000000
A05	9529224	9533691	A05p18270.2_BraZ1	3340.71	+	1594	4133	4467	0.9252295
A05	9534229	9536104	A05p18280.2_BraZ1	135.3	-	1254	1875	1875	1.0000000
A05	9537674	9538167	A05p18290.2_BraZ1	290.813	+	317	493	493	1.0000000
A05	9541377	9556276	A05p18300.2_BraZ1	750	+	8711	13904	14899	0.9332170
A05	9558995	9559807	A05p18310.2_BraZ1	357	-	152	812	812	1.0000000
A05	9560146	9561328	A05p18320.2_BraZ1	1050	-	709	1182	1182	1.0000000
A05	9572549	9573939	A05p18330.2_BraZ1	1047	+	539	1363	1390	0.9805756
A05	9574983	9580308	A05p18340.2_BraZ1	1066.3	-	2882	5161	5325	0.9692019
A05	9584083	9585310	A05p18350.2_BraZ1	240	-	541	1214	1227	0.9894050
A05	9595029	9597671	A05p18360.2_BraZ1	953.333	+	652	2098	2642	0.7940954
A05	9603624	9604290	A05p18370.2_BraZ1	381	+	555	666	666	1.0000000
A05	9608795	9609705	A05p18380.2_BraZ1	603	-	976	910	910	1.0000000
A05	9612774	9616856	A05p18390.2_BraZ1	1158	+	1194	3299	4082	0.8081822
A05	9617923	9621834	A05p18400.2_BraZ1	1021.09	-	486	2010	3911	0.5139350
A05	9636019	9636253	A05p18410.2_BraZ1	174	-	177	234	234	1.0000000
A05	9641404	9655366	A05p18420.2_BraZ1	637.086	+	9819	13312	13962	0.9534451
A05	9655498	9656710	A05p18430.2_BraZ1	525.239	+	621	1171	1212	0.9661716
A05	9657253	9659102	A05p18440.2_BraZ1	1761	-	201	1733	1849	0.9372634
A05	9660141	9662487	A05p18450.2_BraZ1	1593.19	-	525	2032	2346	0.8661551
A05	9665327	9667424	A05p18460.2_BraZ1	1317	+	808	1350	2097	0.6437768
A05	9674755	9675703	A05p18470.2_BraZ1	94.8	-	33	420	948	0.4430380
A05	9676677	9677151	A05p18480.2_BraZ1	31.8	-	617	474	474	1.0000000
A05	9681502	9683618	A05p18490.2_BraZ1	1348.74	-	1082	2098	2116	0.9914934
A05	9694138	9695676	A05p18500.2_BraZ1	709.863	+	1657	1538	1538	1.0000000
A05	9696181	9696892	A05p18510.2_BraZ1	522	+	277	570	711	0.8016878
A05	9697071	9697764	A05p18520.2_BraZ1	68.7	-	58	357	693	0.5151515
A05	9708963	9710442	A05p18530.2_BraZ1	147.9	-	108	953	1479	0.6443543
A05	9738606	9739098	A05p18540.2_BraZ1	198	+	415	492	492	1.0000000
A05	9740561	9742179	A05p18550.2_BraZ1	823.5	+	2488	1618	1618	1.0000000
A05	9742949	9743213	A05p18560.2_BraZ1	26.4	-	292	264	264	1.0000000
A05	9747032	9747795	A05p18570.2_BraZ1	3037.5	+	145	337	763	0.4416776
A05	9753768	9755555	A05p18580.2_BraZ1	876.522	+	1049	1787	1787	1.0000000
A05	9756368	9757218	A05p18590.2_BraZ1	450.5	+	507	850	850	1.0000000
A05	9764799	9777229	A05p18600.2_BraZ1	207	+	7555	11219	12430	0.9025744
A05	9766563	9768004	A05p18610.2_BraZ1	330	+	844	1441	1441	1.0000000
A05	9771448	9773120	A05p18620.2_BraZ1	222	+	3019	1672	1672	1.0000000
A05	9777729	9779373	A05p18630.2_BraZ1	864	-	3436	1642	1644	0.9987835
A05	9782748	9797970	A05p18640.2_BraZ1	261	+	4956	14068	15222	0.9241887
A05	9784796	9786227	A05p18650.2_BraZ1	2661.75	-	566	1374	1431	0.9601677
A05	9793441	9793682	A05p18660.2_BraZ1	207	-	164	241	241	1.0000000
A05	9795019	9795260	A05p18670.2_BraZ1	207	+	56	241	241	1.0000000
A05	9803020	9803320	A05p18680.2_BraZ1	30	+	38	300	300	1.0000000
A05	9803911	9804463	A05p18690.2_BraZ1	426	-	331	552	552	1.0000000
A05	9811653	9812577	A05p18700.2_BraZ1	396	-	528	924	924	1.0000000
A05	9815974	9821039	A05p18710.2_BraZ1	261	+	4120	5065	5065	1.0000000
A05	9821920	9822139	A05p18720.2_BraZ1	21.9	+	46	219	219	1.0000000
A05	9825531	9827481	A05p18730.2_BraZ1	477.75	+	5494	1950	1950	1.0000000
A05	9828168	9828546	A05p18740.2_BraZ1	123	-	916	378	378	1.0000000
A05	9833285	9833651	A05p18750.2_BraZ1	36.6	+	132	366	366	1.0000000
A05	9836093	9836850	A05p18760.2_BraZ1	339	-	184	757	757	1.0000000
A05	9837351	9837486	A05p18770.2_BraZ1	13.5	+	15	135	135	1.0000000
A05	9837927	9838907	A05p18780.2_BraZ1	354.375	+	1673	980	980	1.0000000
A05	9852244	9852719	A05p18790.2_BraZ1	249	-	347	475	475	1.0000000
A05	9855340	9858967	A05p18800.2_BraZ1	2040	-	1438	3257	3627	0.8979873
A05	9879143	9880220	A05p18810.2_BraZ1	733.2	+	4	541	1077	0.5023212
A05	9880130	9882153	A05p18820.2_BraZ1	10861.7	+	87	945	2023	0.4671280
A05	9886934	9889580	A05p18830.2_BraZ1	2760.24	+	834	2459	2646	0.9293273
A05	9891233	9893321	A05p18840.2_BraZ1	2007	+	177	823	2088	0.3941571
A05	9897102	9897930	A05p18850.2_BraZ1	189	-	34	422	828	0.5096619
A05	9898403	9899103	A05p18860.2_BraZ1	296.444	-	74	680	700	0.9714286
A05	9898953	9900063	A05p18870.2_BraZ1	481.259	-	1001	1110	1110	1.0000000
A05	9901123	9901362	A05p18880.2_BraZ1	12	+	182	239	239	1.0000000
A05	9902203	9903085	A05p18890.2_BraZ1	439.87	+	170	575	882	0.6519274
A05	9906289	9912475	A05p18900.2_BraZ1	2737.24	-	1786	5017	6186	0.8110249
A05	9926122	9926233	A05p18910.2_BraZ1	11.1	+	96	111	111	1.0000000
A05	9928251	9930149	A05p18920.2_BraZ1	345	-	1484	1898	1898	1.0000000
A05	9932364	9932970	A05p18930.2_BraZ1	60.6	+	78	374	606	0.6171617
A05	9934859	9935189	A05p18940.2_BraZ1	33	+	364	330	330	1.0000000
A05	9935783	9940616	A05p18950.2_BraZ1	2934.8	-	773	3544	4833	0.7332919
A05	9945219	9946410	A05p18960.2_BraZ1	119.1	+	2380	1191	1191	1.0000000
A05	9953131	9954021	A05p18970.2_BraZ1	597	-	258	890	890	1.0000000
A05	9957254	9957997	A05p18980.2_BraZ1	426	-	210	737	743	0.9919246
A05	9958871	9961028	A05p18990.2_BraZ1	6876	+	1518	2157	2157	1.0000000
A05	9965126	9968165	A05p19000.2_BraZ1	1727.1	-	2320	3039	3039	1.0000000
A05	9972225	9974366	A05p19010.2_BraZ1	1068.26	+	1153	2005	2141	0.9364783
A05	9980851	9981220	A05p19020.2_BraZ1	36.9	+	443	369	369	1.0000000
A05	9997163	9998643	A05p19030.2_BraZ1	1091.5	-	408	1351	1480	0.9128379
A05	9998582	9999522	A05p19040.2_BraZ1	405	-	263	940	940	1.0000000
A05	10003820	10004881	A05p19050.2_BraZ1	414.857	-	320	1055	1061	0.9943449
A05	10004858	10006024	A05p19060.2_BraZ1	153	-	143	1155	1166	0.9905660
A05	10006031	10006259	A05p19070.2_BraZ1	22.8	-	2	41	228	0.1798246
A05	10007556	10007829	A05p19080.2_BraZ1	213	-	7937	273	273	1.0000000
A05	10027722	10028146	A05p19090.2_BraZ1	141	-	290	424	424	1.0000000
A05	10030235	10032400	A05p19100.2_BraZ1	1012.1	-	884	2048	2165	0.9459584
A05	10034536	10035006	A05p19110.2_BraZ1	247.5	+	256	470	470	1.0000000
A05	10037503	10038748	A05p19120.2_BraZ1	124.5	+	586	1245	1245	1.0000000
A05	10041204	10042815	A05p19130.2_BraZ1	5848.2	+	1324	1611	1611	1.0000000
A05	10049625	10052022	A05p19140.2_BraZ1	1686.24	-	377	2076	2397	0.8660826
A05	10053419	10056338	A05p19150.2_BraZ1	1462.5	+	909	2649	2919	0.9075026
A05	10060802	10062672	A05p19160.2_BraZ1	1278.38	-	899	1740	1870	0.9304813
A05	10068840	10069230	A05p19170.2_BraZ1	315	+	147	390	390	1.0000000
A05	10069489	10070248	A05p19180.2_BraZ1	75.9	+	211	336	759	0.4426877
A05	10077949	10078985	A05p19190.2_BraZ1	798	-	162	649	1036	0.6264479
A05	10079958	10081278	A05p19200.2_BraZ1	610.75	-	69	999	1320	0.7568182
A05	10088107	10088710	A05p19210.2_BraZ1	60.3	+	32	372	603	0.6169154
A05	10098591	10104241	A05p19220.2_BraZ1	1452.6	-	2978	4735	5650	0.8380531
A05	10113425	10114457	A05p19230.2_BraZ1	700	-	2	298	1032	0.2887597
A05	10115364	10115987	A05p19240.2_BraZ1	1748	-	141	614	623	0.9855538
A05	10126100	10129116	A05p19250.2_BraZ1	2087.38	-	232	1873	3016	0.6210212
A05	10137311	10150708	A05p19260.2_BraZ1	1618.16	-	7012	12990	13397	0.9696200
A05	10141513	10143116	A05p19270.2_BraZ1	742.5	+	1287	1603	1603	1.0000000
A05	10151637	10154341	A05p19280.2_BraZ1	1965.37	-	1842	2704	2704	1.0000000
A05	10155845	10156128	A05p19290.2_BraZ1	219	-	488	283	283	1.0000000
A05	10162036	10173906	A05p19300.2_BraZ1	396	-	10989	11703	11870	0.9859309
A05	10171857	10172311	A05p19310.2_BraZ1	36.9	+	67	347	454	0.7643172
A05	10183434	10185103	A05p19320.2_BraZ1	741	+	201	1112	1669	0.6662672
A05	10188797	10189699	A05p19330.2_BraZ1	591	+	0	0	902	0.0000000
A05	10189726	10190968	A05p19340.2_BraZ1	569.25	+	83	453	1242	0.3647343
A05	10197264	10197575	A05p19350.2_BraZ1	276	+	0	0	311	0.0000000
A05	10200808	10201789	A05p19360.2_BraZ1	420	+	913	981	981	1.0000000
A05	10203316	10205405	A05p19370.2_BraZ1	1692.8	+	466	1692	2089	0.8099569
A05	10210879	10211566	A05p19380.2_BraZ1	228	+	1083	687	687	1.0000000
A05	10211926	10212096	A05p19390.2_BraZ1	156	+	287	170	170	1.0000000
A05	10216168	10219340	A05p19400.2_BraZ1	3033	+	2313	2478	3172	0.7812106
A05	10223806	10224221	A05p19410.2_BraZ1	130	+	163	399	415	0.9614458
A05	10224109	10226047	A05p19420.2_BraZ1	309.4	+	354	1678	1938	0.8658411
A05	10229511	10231286	A05p19430.2_BraZ1	981	+	778	1752	1775	0.9870422
A05	10234499	10235934	A05p19440.2_BraZ1	765.333	+	1799	1435	1435	1.0000000
A05	10236318	10236671	A05p19450.2_BraZ1	186	+	548	353	353	1.0000000
A05	10237867	10238516	A05p19460.2_BraZ1	456	-	41	398	649	0.6132511
A05	10238758	10238893	A05p19470.2_BraZ1	13.5	-	60	135	135	1.0000000
A05	10239150	10239815	A05p19480.2_BraZ1	297	+	151	614	665	0.9233083
A05	10240353	10241396	A05p19490.2_BraZ1	327	+	2	79	1043	0.0757430
A05	10241283	10244607	A05p19500.2_BraZ1	4333.69	+	173	1193	3324	0.3589049
A05	10247525	10250344	A05p19510.2_BraZ1	507	-	114	743	2819	0.2635686
A05	10253317	10257417	A05p19520.2_BraZ1	1716	-	2601	4100	4100	1.0000000
A05	10282092	10285747	A05p19530.2_BraZ1	498	+	2158	3405	3655	0.9316006
A05	10286139	10286292	A05p19540.2_BraZ1	15.3	-	54	153	153	1.0000000
A05	10289517	10291254	A05p19550.2_BraZ1	657	-	1395	1737	1737	1.0000000
A05	10295898	10297210	A05p19560.2_BraZ1	6392	-	1407	1312	1312	1.0000000
A05	10297591	10299635	A05p19570.2_BraZ1	986.635	-	2453	2037	2044	0.9965754
A05	10301344	10301704	A05p19580.2_BraZ1	36	-	68	270	360	0.7500000
A05	10307771	10308259	A05p19590.2_BraZ1	27	-	517	488	488	1.0000000
A05	10325591	10326363	A05p19600.2_BraZ1	438	+	15	274	772	0.3549223
A05	10328960	10332215	A05p19610.2_BraZ1	724.55	+	821	3227	3255	0.9913979
A05	10338091	10339055	A05p19620.2_BraZ1	375	+	450	964	964	1.0000000
A05	10343932	10344429	A05p19630.2_BraZ1	29.7	-	868	497	497	1.0000000
A05	10345139	10346307	A05p19640.2_BraZ1	509.755	-	1245	1168	1168	1.0000000
A05	10356094	10356652	A05p19650.2_BraZ1	55.8	+	64	433	558	0.7759857
A05	10357419	10358835	A05p19660.2_BraZ1	906.989	-	148	1258	1416	0.8884181
A05	10359814	10362884	A05p19670.2_BraZ1	2607.21	+	671	2701	3070	0.8798046
A05	10365747	10366216	A05p19680.2_BraZ1	4788	+	49	432	469	0.9211087
A05	10371728	10372233	A05p19690.2_BraZ1	333	+	488	505	505	1.0000000
A05	10376597	10377479	A05p19700.2_BraZ1	548	+	1250	882	882	1.0000000
A05	10380363	10381912	A05p19710.2_BraZ1	953.333	+	1203	1549	1549	1.0000000
A05	10382054	10383014	A05p19720.2_BraZ1	96	-	348	960	960	1.0000000
A05	10391572	10393715	A05p19730.2_BraZ1	2001	-	880	2117	2143	0.9878675
A05	10396003	10397862	A05p19740.2_BraZ1	1039.61	+	662	1806	1859	0.9714900
A05	10398019	10400349	A05p19750.2_BraZ1	966.606	-	1311	2240	2330	0.9613734
A05	10401558	10403039	A05p19760.2_BraZ1	355.667	+	225	1216	1481	0.8210669
A05	10403330	10405018	A05p19770.2_BraZ1	335.481	-	540	1446	1688	0.8566351
A05	10406770	10407426	A05p19780.2_BraZ1	576	+	439	656	656	1.0000000
A05	10413771	10416619	A05p19790.2_BraZ1	1375.26	-	1737	2749	2848	0.9652387
A05	10418366	10422397	A05p19800.2_BraZ1	1978.48	-	2406	3524	4031	0.8742248
A05	10425879	10426099	A05p19810.2_BraZ1	11.1	+	200	220	220	1.0000000
A05	10429361	10431966	A05p19820.2_BraZ1	1491.17	-	374	2228	2605	0.8552783
A05	10441384	10445560	A05p19830.2_BraZ1	9468.27	+	849	4160	4176	0.9961686
A05	10446168	10446270	A05p19840.2_BraZ1	10.2	+	87	102	102	1.0000000
A05	10452548	10453838	A05p19850.2_BraZ1	129	-	831	1254	1290	0.9720930
A05	10455164	10460933	A05p19860.2_BraZ1	2504.66	-	6152	5448	5769	0.9443578
A05	10464376	10464541	A05p19870.2_BraZ1	16.5	+	3	81	165	0.4909091
A05	10466371	10466908	A05p19880.2_BraZ1	58.6667	+	5	277	537	0.5158287
A05	10479667	10479944	A05p19890.2_BraZ1	25.8	+	53	277	277	1.0000000
A05	10482407	10483159	A05p19900.2_BraZ1	639	-	134	621	752	0.8257979
A05	10483680	10484862	A05p19910.2_BraZ1	1047	-	602	1171	1182	0.9906937
A05	10488610	10492137	A05p19920.2_BraZ1	1062.96	-	1618	3496	3527	0.9912106
A05	10496246	10511728	A05p19930.2_BraZ1	77.4	+	67203	15190	15482	0.9811394
A05	10515451	10516149	A05p19940.2_BraZ1	268.176	+	604	698	698	1.0000000
A05	10518772	10520229	A05p19950.2_BraZ1	560.009	+	511	1381	1457	0.9478380
A05	10521289	10521666	A05p19960.2_BraZ1	204	+	273	377	377	1.0000000
A05	10536887	10539905	A05p19970.2_BraZ1	1024.54	+	117	1278	3018	0.4234592
A05	10541554	10542172	A05p19980.2_BraZ1	61.8	+	149	458	618	0.7411003
A05	10546333	10547778	A05p19990.2_BraZ1	180	-	1469	1445	1445	1.0000000
A05	10549273	10550029	A05p20000.2_BraZ1	390	-	2961	756	756	1.0000000
A05	10567971	10570332	A05p20010.2_BraZ1	1718.29	-	839	2203	2361	0.9330792
A05	10571343	10571559	A05p20020.2_BraZ1	129	+	176	216	216	1.0000000
A05	10574316	10574833	A05p20030.2_BraZ1	306	+	1130	517	517	1.0000000
A05	10574641	10574999	A05p20040.2_BraZ1	201	+	673	358	358	1.0000000
A05	10580061	10580496	A05p20050.2_BraZ1	43.5	-	1092	435	435	1.0000000
A05	10589264	10592657	A05p20060.2_BraZ1	1872.27	+	319	2479	3393	0.7306219
A05	10594530	10594962	A05p20070.2_BraZ1	43.2	+	124	432	432	1.0000000
A05	10595497	10597513	A05p20080.2_BraZ1	1578.67	-	421	805	2016	0.3993056
A05	10601798	10602886	A05p20090.2_BraZ1	195	-	454	1088	1088	1.0000000
A05	10617398	10617569	A05p20100.2_BraZ1	17.1	+	107	171	171	1.0000000
A05	10617698	10618247	A05p20110.2_BraZ1	240	+	68	443	549	0.8069217
A05	10622525	10623649	A05p20120.2_BraZ1	924	+	604	1100	1124	0.9786477
A05	10636225	10639197	A05p20130.2_BraZ1	1396.37	+	691	2471	2972	0.8314266
A05	10639945	10642623	A05p20140.2_BraZ1	2055	+	624	2376	2678	0.8872293
A05	10643117	10644337	A05p20150.2_BraZ1	843.975	-	503	1220	1220	1.0000000
A05	10647491	10647863	A05p20160.2_BraZ1	37.2	+	274	372	372	1.0000000
A05	10648461	10648964	A05p20170.2_BraZ1	231	-	130	424	503	0.8429424
A05	10650294	10650661	A05p20180.2_BraZ1	285	-	45	297	367	0.8092643
A05	10655017	10655771	A05p20190.2_BraZ1	447	+	772	754	754	1.0000000
A05	10670885	10675290	A05p20200.2_BraZ1	2401.88	+	2194	4187	4405	0.9505108
A05	10705164	10705532	A05p20210.2_BraZ1	35.1	+	140	368	368	1.0000000
A05	10708579	10708991	A05p20220.2_BraZ1	231	+	538	410	412	0.9951456
A05	10713255	10716662	A05p20230.2_BraZ1	13145.2	+	4765	3377	3407	0.9911946
A05	10725129	10730532	A05p20240.2_BraZ1	2109.57	+	3669	5135	5403	0.9503979
A05	10733659	10734653	A05p20250.2_BraZ1	303	+	439	920	994	0.9255533
A05	10744452	10745081	A05p20260.2_BraZ1	393	-	128	535	629	0.8505564
A05	10755537	10755913	A05p20270.2_BraZ1	273	+	284	336	376	0.8936170
A05	10758234	10759570	A05p20280.2_BraZ1	601.418	+	261	1063	1336	0.7956587
A05	10769254	10773070	A05p20290.2_BraZ1	2623.16	+	450	2392	3816	0.6268344
A05	10773393	10777709	A05p20300.2_BraZ1	2510.28	-	992	2930	4316	0.6788693
A05	10792967	10794698	A05p20310.2_BraZ1	507.375	+	740	1486	1731	0.8584633
A05	10795812	10801494	A05p20320.2_BraZ1	2494.51	+	1382	5057	5682	0.8900035
A05	10802002	10803251	A05p20330.2_BraZ1	12870	-	166	943	1249	0.7550040
A05	10804210	10806586	A05p20340.2_BraZ1	1291.09	-	211	1785	2376	0.7512626
A05	10815039	10818040	A05p20350.2_BraZ1	605	-	1853	2483	3001	0.8273908
A05	10817832	10828671	A05p20360.2_BraZ1	410.44	-	2108	6141	10839	0.5665652
A05	10826518	10826738	A05p20370.2_BraZ1	37.8173	-	212	220	220	1.0000000
A05	10833851	10834034	A05p20380.2_BraZ1	18.3	+	10	86	183	0.4699453
A05	10840532	10841093	A05p20390.2_BraZ1	56.1	-	127	544	561	0.9696970
A05	10849230	10852328	A05p20400.2_BraZ1	1369.3	-	2409	3098	3098	1.0000000
A05	10855210	10856523	A05p20410.2_BraZ1	648	+	1067	1313	1313	1.0000000
A05	10862744	10862876	A05p20420.2_BraZ1	13.2	+	297	132	132	1.0000000
A05	10883344	10885952	A05p20430.2_BraZ1	1408.55	+	803	2361	2608	0.9052914
A05	10886509	10887523	A05p20440.2_BraZ1	101.4	-	218	842	1014	0.8303748
A05	10893483	10894152	A05p20450.2_BraZ1	213	-	177	591	669	0.8834081
A05	10908085	10909999	A05p20460.2_BraZ1	191.4	+	796	1776	1914	0.9278997
A05	10915158	10916973	A05p20470.2_BraZ1	1194.8	+	820	1791	1815	0.9867769
A05	10918642	10921348	A05p20480.2_BraZ1	1125.54	-	1522	2706	2706	1.0000000
A05	10923502	10925430	A05p20490.2_BraZ1	1034.25	+	1342	1928	1928	1.0000000
A05	10936681	10937926	A05p20500.2_BraZ1	618.714	+	669	1221	1245	0.9807229
A05	10941302	10944723	A05p20510.2_BraZ1	1914	+	875	3140	3421	0.9178603
A05	10949262	10950433	A05p20520.2_BraZ1	216	+	919	1171	1171	1.0000000
A05	10949401	10954466	A05p20530.2_BraZ1	429	+	4453	5065	5065	1.0000000
A05	10951081	10951540	A05p20540.2_BraZ1	45.9	+	706	459	459	1.0000000
A05	10958046	10958551	A05p20550.2_BraZ1	408	-	187	505	505	1.0000000
A05	10961447	10964279	A05p20560.2_BraZ1	1043.73	-	386	1410	2832	0.4978814
A05	10969307	10970070	A05p20570.2_BraZ1	228	+	368	715	763	0.9370905
A05	10972707	10973102	A05p20580.2_BraZ1	1248	-	122	395	395	1.0000000
A05	10983632	10985980	A05p20590.2_BraZ1	1120.57	+	313	1951	2348	0.8309199
A05	10991371	10992838	A05p20600.2_BraZ1	969.109	-	1045	1467	1467	1.0000000
A05	10996280	10998250	A05p20610.2_BraZ1	1271.74	+	1114	1970	1970	1.0000000
A05	11001790	11010805	A05p20620.2_BraZ1	44.7	-	4027	8982	9015	0.9963394
A05	11010592	11010967	A05p20630.2_BraZ1	37.5	-	658	375	375	1.0000000
A05	11037836	11038288	A05p20640.2_BraZ1	300	+	577	452	452	1.0000000
A05	11038463	11042038	A05p20650.2_BraZ1	1574.22	+	3374	3575	3575	1.0000000
A05	11045644	11048320	A05p20660.2_BraZ1	366	-	3747	2548	2676	0.9521674
A05	11070694	11071891	A05p20670.2_BraZ1	207.857	-	878	1197	1197	1.0000000
A05	11079934	11080294	A05p20680.2_BraZ1	36	+	0	0	360	0.0000000
A05	11087534	11092501	A05p20690.2_BraZ1	195	+	462	2984	4967	0.6007650
A05	11092644	11093004	A05p20700.2_BraZ1	36	-	0	0	360	0.0000000
A05	11098909	11099140	A05p20710.2_BraZ1	23.1	-	0	0	231	0.0000000
A05	11105719	11108247	A05p20720.2_BraZ1	1421.84	-	212	1869	2528	0.7393196
A05	11110373	11111153	A05p20730.2_BraZ1	327.75	-	688	780	780	1.0000000
A05	11111566	11113469	A05p20740.2_BraZ1	900	-	1480	1814	1903	0.9532318
A05	11112439	11112760	A05p20750.2_BraZ1	261	-	599	321	321	1.0000000
A05	11119765	11120642	A05p20760.2_BraZ1	253.75	+	602	877	877	1.0000000
A05	11120396	11124249	A05p20770.2_BraZ1	1573.95	+	1890	3684	3853	0.9561381
A05	11129678	11131745	A05p20780.2_BraZ1	204.3	-	358	1332	2067	0.6444122
A05	11160996	11162909	A05p20790.2_BraZ1	1065	+	834	1842	1913	0.9628855
A05	11171376	11174186	A05p20800.2_BraZ1	1698	-	3772	2810	2810	1.0000000
A05	11177567	11178136	A05p20810.2_BraZ1	52.8	+	1094	569	569	1.0000000
A05	11190110	11190883	A05p20820.2_BraZ1	177.222	-	1	132	773	0.1707633
A05	11190870	11191143	A05p20830.2_BraZ1	55	-	2	158	273	0.5787546
A05	11203807	11203951	A05p20840.2_BraZ1	14.4	+	1972	144	144	1.0000000
A05	11206321	11208212	A05p20850.2_BraZ1	1067	+	1488	1877	1891	0.9925965
A05	11208525	11209572	A05p20860.2_BraZ1	104.7	-	118	843	1047	0.8051576
A05	11212246	11213418	A05p20870.2_BraZ1	647.182	-	1573	1172	1172	1.0000000
A05	11214113	11214588	A05p20880.2_BraZ1	402	-	340	475	475	1.0000000
A05	11217689	11218552	A05p20890.2_BraZ1	310.773	-	24	575	863	0.6662804
A05	11219243	11220021	A05p20900.2_BraZ1	720	-	46	674	778	0.8663239
A05	11227319	11227460	A05p20910.2_BraZ1	14.1	-	135	141	141	1.0000000
A05	11229921	11232016	A05p20920.2_BraZ1	808.714	-	1049	2033	2095	0.9704058
A05	11254960	11255874	A05p20930.2_BraZ1	663	+	273	914	914	1.0000000
A05	11266536	11266732	A05p20940.2_BraZ1	10.8	+	315	196	196	1.0000000
A05	11266793	11268478	A05p20950.2_BraZ1	78.6	+	813	1392	1685	0.8261127
A05	11271371	11274292	A05p20960.2_BraZ1	1213.01	-	2075	2727	2921	0.9335844
A05	11287923	11288586	A05p20970.2_BraZ1	5700	-	118	634	663	0.9562594
A05	11294469	11296146	A05p20980.2_BraZ1	394.818	+	1627	1677	1677	1.0000000
A05	11296446	11297065	A05p20990.2_BraZ1	5841	-	83	547	619	0.8836834
A05	11299482	11300965	A05p21000.2_BraZ1	600	-	616	1483	1483	1.0000000
A05	11301298	11303191	A05p21010.2_BraZ1	189.3	+	772	1893	1893	1.0000000
A05	11308173	11311595	A05p21020.2_BraZ1	2053.57	+	1315	3198	3422	0.9345412
A05	11317186	11318441	A05p21030.2_BraZ1	1569.75	-	528	1246	1255	0.9928287
A05	11319639	11319873	A05p21040.2_BraZ1	23.4	-	8	68	234	0.2905983
A05	11320570	11327120	A05p21050.2_BraZ1	2376.79	+	1358	5085	6550	0.7763359
A05	11330970	11331167	A05p21060.2_BraZ1	10.2	-	1384	197	197	1.0000000
A05	11352601	11355442	A05p21070.2_BraZ1	1277.71	+	780	2412	2841	0.8489968
A05	11356360	11357412	A05p21080.2_BraZ1	249.75	-	3478	1052	1052	1.0000000
A05	11359809	11359973	A05p21090.2_BraZ1	13.2	+	275	164	164	1.0000000
A05	11373755	11374393	A05p21100.2_BraZ1	287.5	-	616	638	638	1.0000000
A05	11374427	11374760	A05p21110.2_BraZ1	216	-	355	333	333	1.0000000
A05	11375711	11376042	A05p21120.2_BraZ1	246	-	227	331	331	1.0000000
A05	11376292	11379033	A05p21130.2_BraZ1	1005.08	+	1631	2741	2741	1.0000000
A05	11381066	11382044	A05p21140.2_BraZ1	97.8	+	172	831	978	0.8496932
A05	11384502	11384844	A05p21150.2_BraZ1	34.2	+	297	342	342	1.0000000
A05	11402511	11407149	A05p21160.2_BraZ1	1984.88	+	471	3108	4638	0.6701164
A05	11409015	11409316	A05p21170.2_BraZ1	273	+	320	301	301	1.0000000
A05	11410458	11411847	A05p21180.2_BraZ1	948	+	1491	1389	1389	1.0000000
A05	11447957	11450359	A05p21190.2_BraZ1	1774.31	-	886	1935	2402	0.8055787
A05	11464660	11467100	A05p21200.2_BraZ1	2061	-	87	802	2440	0.3286885
A05	11471728	11472062	A05p21210.2_BraZ1	135	-	221	334	334	1.0000000
A05	11480448	11480610	A05p21220.2_BraZ1	16.2	+	225	162	162	1.0000000
A05	11482402	11483879	A05p21230.2_BraZ1	1173	+	145	1266	1477	0.8571429
A05	11501720	11504078	A05p21240.2_BraZ1	129	-	1199	2316	2358	0.9821883
A05	11504393	11506590	A05p21250.2_BraZ1	893.326	-	797	2103	2197	0.9572144
A05	11506661	11514603	A05p21260.2_BraZ1	2137.12	+	4141	5879	7942	0.7402418
A05	11524780	11525080	A05p21270.2_BraZ1	30	+	142	300	300	1.0000000
A05	11527969	11528269	A05p21280.2_BraZ1	30	+	67	300	300	1.0000000
A05	11542206	11542506	A05p21290.2_BraZ1	30	+	106	300	300	1.0000000
A05	11546907	11547996	A05p21300.2_BraZ1	506.259	+	288	987	1089	0.9063361
A05	11548277	11550457	A05p21310.2_BraZ1	2173.65	-	268	1300	2180	0.5963303
A05	11553295	11555784	A05p21320.2_BraZ1	312	+	1240	1898	2489	0.7625552
A05	11558916	11562000	A05p21330.2_BraZ1	1450.22	-	1409	2990	3084	0.9695201
A05	11569737	11570047	A05p21340.2_BraZ1	210	-	13	275	310	0.8870968
A05	11576954	11578204	A05p21350.2_BraZ1	655.2	-	827	1250	1250	1.0000000
A05	11578971	11582363	A05p21360.2_BraZ1	840.875	+	1338	3352	3392	0.9882075
A05	11588530	11588833	A05p21370.2_BraZ1	30.3	-	277	303	303	1.0000000
A05	11589724	11590745	A05p21380.2_BraZ1	663	-	1716	1021	1021	1.0000000
A05	11622088	11627159	A05p21390.2_BraZ1	314.053	+	2609	4934	5071	0.9729837
A05	11634390	11634738	A05p21400.2_BraZ1	34.8	-	31	291	348	0.8362069
A05	11654578	11655275	A05p21410.2_BraZ1	468	+	898	697	697	1.0000000
A05	11655784	11657855	A05p21420.2_BraZ1	558	-	3853	2071	2071	1.0000000
A05	11662161	11668079	A05p21430.2_BraZ1	3048.17	-	2010	5372	5918	0.9077391
A05	11669568	11670354	A05p21440.2_BraZ1	477.714	-	0	0	786	0.0000000
A05	11677843	11680041	A05p21450.2_BraZ1	1536.64	-	144	1417	2198	0.6446770
A05	11681331	11682433	A05p21460.2_BraZ1	165	+	92	803	1102	0.7286751
A05	11685251	11688428	A05p21470.2_BraZ1	660.356	-	2486	3118	3177	0.9814290
A05	11688832	11695123	A05p21480.2_BraZ1	1740.61	+	3749	6264	6291	0.9957082
A05	11704092	11708560	A05p21490.2_BraZ1	977.891	-	1383	3952	4468	0.8845121
A05	11724580	11724782	A05p21500.2_BraZ1	13.8	-	324	202	202	1.0000000
A05	11728423	11730534	A05p21510.2_BraZ1	648	-	1609	2111	2111	1.0000000
A05	11747874	11750663	A05p21520.2_BraZ1	918	+	994	2787	2789	0.9992829
A05	11754146	11771377	A05p21530.2_BraZ1	6551.52	+	2257	10792	17231	0.6263130
A05	11774887	11776789	A05p21540.2_BraZ1	31419.7	-	805	1902	1902	1.0000000
A05	11778409	11779046	A05p21550.2_BraZ1	399	+	290	637	637	1.0000000
A05	11779450	11782143	A05p21560.2_BraZ1	1293	-	1303	2693	2693	1.0000000
A05	11784367	11784630	A05p21570.2_BraZ1	153	-	471	263	263	1.0000000
A05	11788472	11789530	A05p21580.2_BraZ1	87.9	-	283	1058	1058	1.0000000
A05	11790455	11790818	A05p21590.2_BraZ1	21	-	159	363	363	1.0000000
A05	11794387	11795972	A05p21600.2_BraZ1	858.052	+	1993	1585	1585	1.0000000
A05	11797853	11798858	A05p21610.2_BraZ1	498	-	677	1005	1005	1.0000000
A05	11812706	11813584	A05p21620.2_BraZ1	703.636	+	461	878	878	1.0000000
A05	11820217	11824559	A05p21630.2_BraZ1	2035.25	-	1060	3796	4342	0.8742515
A05	11825710	11826418	A05p21640.2_BraZ1	294	+	184	708	708	1.0000000
A05	11827164	11829259	A05p21650.2_BraZ1	2113.36	-	1531	2095	2095	1.0000000
A05	11829502	11831413	A05p21660.2_BraZ1	827.143	-	1190	1911	1911	1.0000000
A05	11832240	11832498	A05p21670.2_BraZ1	25.8	+	3	67	258	0.2596899
A05	11874038	11875868	A05p21680.2_BraZ1	16860	-	493	1520	1830	0.8306011
A05	11881866	11882420	A05p21690.2_BraZ1	297	+	851	554	554	1.0000000
A05	11889627	11891510	A05p21700.2_BraZ1	942	+	104	865	1883	0.4593734
A05	11898365	11899856	A05p21710.2_BraZ1	4275	-	535	1395	1491	0.9356137
A05	11903951	11904234	A05p21720.2_BraZ1	198	-	9	283	283	1.0000000
A05	11904668	11905064	A05p21730.2_BraZ1	39.6	+	579	396	396	1.0000000
A05	11906262	11909006	A05p21740.2_BraZ1	232	+	1875	2744	2744	1.0000000
A05	11914403	11915435	A05p21750.2_BraZ1	103.2	+	148	1026	1032	0.9941860
A05	11916481	11925706	A05p21760.2_BraZ1	10044	-	19323	8755	9225	0.9490515
A05	11933152	11935398	A05p21770.2_BraZ1	1237.09	+	1094	2246	2246	1.0000000
A05	11936820	11937606	A05p21780.2_BraZ1	609	-	475	786	786	1.0000000
A05	11950801	11951168	A05p21790.2_BraZ1	204	+	226	367	367	1.0000000
A05	11957404	11959113	A05p21800.2_BraZ1	618	+	1496	1709	1709	1.0000000
A05	11959667	11960631	A05p21810.2_BraZ1	739.286	-	259	835	964	0.8661826
A05	11982959	11989847	A05p21820.2_BraZ1	198	-	5846	6888	6888	1.0000000
A05	11992161	11992521	A05p21830.2_BraZ1	297	+	226	358	360	0.9944444
A05	11998787	11999245	A05p21840.2_BraZ1	327	+	428	458	458	1.0000000
A05	12002648	12002912	A05p21850.2_BraZ1	16.2	+	561	264	264	1.0000000
A05	12004797	12005615	A05p21860.2_BraZ1	666	+	190	743	818	0.9083130
A05	12008543	12008645	A05p21870.2_BraZ1	10.2	-	9	61	102	0.5980392
A05	12008819	12010497	A05p21880.2_BraZ1	396	+	1322	1580	1678	0.9415972
A05	12018501	12023151	A05p21890.2_BraZ1	1855.86	-	1179	4204	4650	0.9040860
A05	12030271	12032066	A05p21900.2_BraZ1	1031.25	-	172	1247	1795	0.6947075
A05	12032757	12033159	A05p21910.2_BraZ1	40.2	-	283	402	402	1.0000000
A05	12034583	12045688	A05p21920.2_BraZ1	5939.33	-	1017	4782	11105	0.4306168
A05	12049701	12061736	A05p21930.2_BraZ1	1197	-	6358	10114	12035	0.8403822
A05	12054249	12055096	A05p21940.2_BraZ1	321	-	1	65	847	0.0767414
A05	12072998	12074111	A05p21950.2_BraZ1	111.3	+	45	439	1113	0.3944295
A05	12097176	12097784	A05p21960.2_BraZ1	537	+	2	26	608	0.0427632
A05	12116092	12117991	A05p21970.2_BraZ1	1463.79	-	748	1628	1899	0.8572933
A05	12120200	12120404	A05p21980.2_BraZ1	20.4	+	648	204	204	1.0000000
A05	12131182	12131813	A05p21990.2_BraZ1	390	+	60	427	631	0.6767036
A05	12133530	12134127	A05p22000.2_BraZ1	525	-	0	0	597	0.0000000
A05	12145782	12146930	A05p22010.2_BraZ1	6854	-	1020	1148	1148	1.0000000
A05	12151038	12151473	A05p22020.2_BraZ1	282	+	556	435	435	1.0000000
A05	12162265	12163338	A05p22030.2_BraZ1	945	+	244	605	1073	0.5638397
A05	12183298	12185621	A05p22040.2_BraZ1	1459.4	-	556	1880	2323	0.8092983
A05	12189788	12198515	A05p22050.2_BraZ1	652.5	+	2262	8125	8727	0.9310187
A05	12199138	12202201	A05p22060.2_BraZ1	1271.51	+	56	1174	3063	0.3832844
A05	12202543	12205144	A05p22070.2_BraZ1	1248.55	-	817	2601	2601	1.0000000
A05	12207409	12207767	A05p22080.2_BraZ1	31.2	+	677	358	358	1.0000000
A05	12208582	12208842	A05p22090.2_BraZ1	177	-	253	260	260	1.0000000
A05	12214790	12217425	A05p22100.2_BraZ1	1222.31	+	945	2525	2635	0.9582543
A05	12217544	12220263	A05p22110.2_BraZ1	2035.69	-	596	2570	2719	0.9452004
A05	12229872	12230028	A05p22120.2_BraZ1	15.6	-	2237	156	156	1.0000000
A05	12231464	12232438	A05p22130.2_BraZ1	270	-	15	47	974	0.0482546
A05	12235041	12238728	A05p22140.2_BraZ1	1379.25	+	209	2501	3687	0.6783293
A05	12243487	12246046	A05p22150.2_BraZ1	255.3	+	3072	2559	2559	1.0000000
A05	12248519	12248813	A05p22160.2_BraZ1	29.4	-	7	99	294	0.3367347
A05	12249952	12252306	A05p22170.2_BraZ1	732.433	+	32	916	2354	0.3891249
A05	12253036	12254855	A05p22180.2_BraZ1	320.075	+	110	1017	1819	0.5590984
A05	12271597	12271819	A05p22190.2_BraZ1	22.2	+	58	222	222	1.0000000
A05	12272321	12273637	A05p22200.2_BraZ1	2164.8	+	232	1158	1316	0.8799392
A05	12279785	12284461	A05p22210.2_BraZ1	719.577	-	3677	4671	4676	0.9989307
A05	12282781	12283609	A05p22220.2_BraZ1	82.8	-	757	828	828	1.0000000
A05	12292791	12298512	A05p22230.2_BraZ1	1301.05	+	1339	4826	5721	0.8435588
A05	12299315	12299417	A05p22240.2_BraZ1	10.2	-	34	102	102	1.0000000
A05	12310659	12319341	A05p22250.2_BraZ1	346.242	-	2507	5764	8682	0.6639023
A05	12313963	12314227	A05p22260.2_BraZ1	156	-	15	117	264	0.4431818
A05	12315708	12316716	A05p22270.2_BraZ1	930	+	0	0	1008	0.0000000
A05	12344040	12345429	A05p22280.2_BraZ1	1198.5	+	447	1386	1389	0.9978402
A05	12347072	12347249	A05p22290.2_BraZ1	16.2	+	17	129	177	0.7288136
A05	12397145	12398221	A05p22300.2_BraZ1	753	-	412	1048	1076	0.9739777
A05	12399169	12403331	A05p22310.2_BraZ1	236.5	+	1202	3819	4162	0.9175877
A05	12402136	12402658	A05p22320.2_BraZ1	52.2	-	242	522	522	1.0000000
A05	12404816	12410474	A05p22330.2_BraZ1	3015.37	+	203	1026	5658	0.1813362
A05	12411712	12412164	A05p22340.2_BraZ1	345	+	463	452	452	1.0000000
A05	12427060	12427755	A05p22350.2_BraZ1	288	+	143	669	695	0.9625899
A05	12440913	12441275	A05p22360.2_BraZ1	213	+	42	360	362	0.9944751
A05	12446643	12446970	A05p22370.2_BraZ1	32.7	-	93	193	327	0.5902141
A05	12468771	12469338	A05p22380.2_BraZ1	468	+	41	468	567	0.8253968
A05	12482074	12483384	A05p22390.2_BraZ1	1242	+	54	603	1310	0.4603053
A05	12483355	12487244	A05p22400.2_BraZ1	2611.58	+	136	2005	3889	0.5155567
A05	12489577	12489736	A05p22410.2_BraZ1	13.5	-	72	159	159	1.0000000
A05	12495488	12500309	A05p22420.2_BraZ1	1518.17	+	403	1417	4821	0.2939224
A05	12500854	12501698	A05p22430.2_BraZ1	187.5	+	345	777	844	0.9206161
A05	12502243	12502354	A05p22440.2_BraZ1	11.1	-	101	111	111	1.0000000
A05	12513650	12513981	A05p22450.2_BraZ1	129	-	417	331	331	1.0000000
A05	12515714	12520127	A05p22460.2_BraZ1	1107.52	+	1913	3382	4413	0.7663721
A05	12522790	12523036	A05p22470.2_BraZ1	159	-	477	246	246	1.0000000
A05	12527240	12528422	A05p22480.2_BraZ1	888	-	1167	1182	1182	1.0000000
A05	12531440	12531752	A05p22490.2_BraZ1	31.2	-	380	312	312	1.0000000
A05	12532715	12533681	A05p22500.2_BraZ1	980.5	+	116	850	966	0.8799172
A05	12551981	12552716	A05p22510.2_BraZ1	32.1	+	323	728	735	0.9904762
A05	12557538	12557658	A05p22520.2_BraZ1	12	-	66	120	120	1.0000000
A05	12559930	12560271	A05p22530.2_BraZ1	261	+	509	341	341	1.0000000
A05	12568904	12569138	A05p22540.2_BraZ1	23.4	-	422	234	234	1.0000000
A05	12574707	12575308	A05p22550.2_BraZ1	26.4	-	366	601	601	1.0000000
A05	12579012	12580414	A05p22560.2_BraZ1	4599	+	189	895	1402	0.6383737
A05	12580773	12581798	A05p22570.2_BraZ1	731.37	-	72	537	1025	0.5239024
A05	12584101	12584317	A05p22580.2_BraZ1	17.7	-	172	216	216	1.0000000
A05	12587792	12588173	A05p22590.2_BraZ1	297	-	1036	381	381	1.0000000
A05	12591912	12592307	A05p22600.2_BraZ1	22.2	-	11	251	395	0.6354430
A05	12594158	12595104	A05p22610.2_BraZ1	306	+	86	768	946	0.8118393
A05	12601082	12602165	A05p22620.2_BraZ1	525	-	1714	1083	1083	1.0000000
A05	12605125	12605659	A05p22630.2_BraZ1	53.4	+	0	0	534	0.0000000
A05	12618616	12620651	A05p22640.2_BraZ1	955.773	-	29	124	2035	0.0609337
A05	12623087	12623849	A05p22650.2_BraZ1	180	+	929	762	762	1.0000000
A05	12634348	12634681	A05p22660.2_BraZ1	33.3	-	206	333	333	1.0000000
A05	12634694	12635903	A05p22670.2_BraZ1	369.288	-	669	1209	1209	1.0000000
A05	12637204	12645954	A05p22680.2_BraZ1	4481.72	-	26110	8750	8750	1.0000000
A05	12638519	12639077	A05p22690.2_BraZ1	55.8	-	4254	558	558	1.0000000
A05	12646818	12647445	A05p22700.2_BraZ1	62.7	+	840	627	627	1.0000000
A05	12651677	12652031	A05p22710.2_BraZ1	35.4	-	185	354	354	1.0000000
A05	12653564	12653966	A05p22720.2_BraZ1	261	-	158	402	402	1.0000000
A05	12655127	12657420	A05p22730.2_BraZ1	878.167	-	1078	2262	2293	0.9864806
A05	12687936	12688086	A05p22740.2_BraZ1	15	+	0	0	150	0.0000000
A05	12708200	12709038	A05p22750.2_BraZ1	747	+	6141	692	838	0.8257757
A05	12709429	12710827	A05p22760.2_BraZ1	1176	-	81	585	1398	0.4184549
A05	12716165	12716909	A05p22770.2_BraZ1	630	-	738	744	744	1.0000000
A05	12723896	12724075	A05p22780.2_BraZ1	10.8	+	307	179	179	1.0000000
A05	12763554	12766050	A05p22790.2_BraZ1	1557	-	143	1146	2496	0.4591346
A05	12770292	12771712	A05p22800.2_BraZ1	207	+	1668	1420	1420	1.0000000
A05	12787197	12788362	A05p22810.2_BraZ1	684.174	+	62	205	1165	0.1759657
A05	12788830	12789511	A05p22820.2_BraZ1	68.1	-	41	533	681	0.7826725
A05	12795770	12795959	A05p22830.2_BraZ1	18.9	+	205	189	189	1.0000000
A05	12797621	12799193	A05p22840.2_BraZ1	910.625	-	24	528	1572	0.3358779
A05	12800255	12827184	A05p22850.2_BraZ1	367.5	+	22325	24959	26929	0.9268447
A05	12838188	12840512	A05p22860.2_BraZ1	1203	+	66390	2324	2324	1.0000000
A05	12840970	12844002	A05p22870.2_BraZ1	75.9	-	53566	2869	3032	0.9462401
A05	12845056	12845236	A05p22880.2_BraZ1	18	+	295	180	180	1.0000000
A05	12845582	12846481	A05p22890.2_BraZ1	153.3	-	84	786	899	0.8743048
A05	12847123	12847932	A05p22900.2_BraZ1	231	-	19	277	809	0.3423980
A05	12850509	12852107	A05p22910.2_BraZ1	102.6	-	713	1598	1598	1.0000000
A05	12853597	12855315	A05p22920.2_BraZ1	1025.18	+	72	517	1718	0.3009313
A05	12860754	12862644	A05p22930.2_BraZ1	1020	+	4227	1890	1890	1.0000000
A05	12863935	12864153	A05p22940.2_BraZ1	204	-	1409	218	218	1.0000000
A05	12864343	12865388	A05p22950.2_BraZ1	768	-	7921	1045	1045	1.0000000
A05	12878957	12879140	A05p22960.2_BraZ1	18.3	+	0	0	183	0.0000000
A05	12880410	12881875	A05p22970.2_BraZ1	159	-	644	881	1465	0.6013652
A05	12882087	12882393	A05p22980.2_BraZ1	30.6	-	0	0	306	0.0000000
A05	12883223	12884438	A05p22990.2_BraZ1	1540	-	35	460	1215	0.3786008
A05	12889063	12901381	A05p23000.2_BraZ1	2544.75	-	2984	8737	12318	0.7092872
A05	12913672	12917474	A05p23010.2_BraZ1	861	+	2745	3800	3802	0.9994740
A05	12916241	12917356	A05p23020.2_BraZ1	1404	+	788	1113	1115	0.9982063
A05	12918137	12919682	A05p23030.2_BraZ1	1326	-	655	1545	1545	1.0000000
A05	12931187	12932647	A05p23040.2_BraZ1	827.05	-	651	1041	1460	0.7130137
A05	12932910	12933715	A05p23050.2_BraZ1	28.2	+	483	805	805	1.0000000
A05	12933943	12934510	A05p23060.2_BraZ1	55.2	+	201	540	567	0.9523810
A05	12935328	12937960	A05p23070.2_BraZ1	1539.11	+	305	1845	2632	0.7009878
A05	12941390	12942606	A05p23080.2_BraZ1	453	+	1018	1216	1216	1.0000000
A05	12949332	12949719	A05p23090.2_BraZ1	38.7	+	437	387	387	1.0000000
A05	12983146	12983263	A05p23100.2_BraZ1	11.7	-	219	117	117	1.0000000
A05	12992849	12995749	A05p23110.2_BraZ1	2134.29	+	16363	2900	2900	1.0000000
A05	13018430	13020346	A05p23120.2_BraZ1	1160.77	-	173	1270	1916	0.6628392
A05	13022542	13022998	A05p23130.2_BraZ1	45.6	+	305	456	456	1.0000000
A05	13028044	13029589	A05p23140.2_BraZ1	154.5	+	24	341	1545	0.2207120
A05	13030947	13031923	A05p23150.2_BraZ1	579	+	520	976	976	1.0000000
A05	13056891	13057965	A05p23160.2_BraZ1	864	+	71	840	1074	0.7821229
A05	13066499	13066860	A05p23170.2_BraZ1	1029	-	215	361	361	1.0000000
A05	13075628	13076187	A05p23180.2_BraZ1	222	+	490	559	559	1.0000000
A05	13076187	13076714	A05p23190.2_BraZ1	351	-	223	527	527	1.0000000
A05	13078775	13080394	A05p23200.2_BraZ1	462.843	-	110	677	1619	0.4181594
A05	13080582	13081651	A05p23210.2_BraZ1	1113	+	16	366	1069	0.3423761
A05	13091891	13092299	A05p23220.2_BraZ1	40.8	+	20	238	408	0.5833333
A05	13100302	13100446	A05p23230.2_BraZ1	14.4	+	88	144	144	1.0000000
A05	13113761	13116529	A05p23240.2_BraZ1	1399.46	+	644	2121	2768	0.7662572
A05	13116768	13118162	A05p23250.2_BraZ1	1030.66	-	1045	1103	1394	0.7912482
A05	13131045	13137851	A05p23260.2_BraZ1	3725.64	-	26	400	6806	0.0587717
A05	13139482	13142095	A05p23270.2_BraZ1	952.75	+	768	2473	2613	0.9464217
A05	13182404	13182770	A05p23280.2_BraZ1	36.6	+	345	366	366	1.0000000
A05	13185977	13186603	A05p23290.2_BraZ1	54.6	+	453	626	626	1.0000000
A05	13188355	13188610	A05p23300.2_BraZ1	25.5	+	276	255	255	1.0000000
A05	13196874	13199198	A05p23310.2_BraZ1	1314.27	+	1510	2324	2324	1.0000000
A05	13208623	13210176	A05p23320.2_BraZ1	1345.5	+	774	1399	1553	0.9008371
A05	13214400	13216061	A05p23330.2_BraZ1	587.527	-	1278	1596	1661	0.9608669
A05	13246110	13246857	A05p23340.2_BraZ1	74.7	+	1146	747	747	1.0000000
A05	13249212	13249335	A05p23350.2_BraZ1	12.3	+	276	123	123	1.0000000
A05	13251537	13252233	A05p23360.2_BraZ1	69.6	-	1869	696	696	1.0000000
A05	13254154	13255291	A05p23370.2_BraZ1	1281	-	911	1137	1137	1.0000000
A05	13255478	13256473	A05p23380.2_BraZ1	903	-	4163	995	995	1.0000000
A05	13284007	13285005	A05p23390.2_BraZ1	900	-	442	998	998	1.0000000
A05	13296070	13296691	A05p23400.2_BraZ1	62.1	+	643	621	621	1.0000000
A05	13298928	13299660	A05p23410.2_BraZ1	390.4	+	46	467	732	0.6379781
A05	13307002	13308612	A05p23420.2_BraZ1	982.843	+	1190	1610	1610	1.0000000
A05	13309585	13310227	A05p23430.2_BraZ1	42.6	-	134	640	642	0.9968848
A05	13311592	13312170	A05p23440.2_BraZ1	468	-	1509	578	578	1.0000000
A05	13325048	13326470	A05p23450.2_BraZ1	1031.45	+	521	981	1422	0.6898734
A05	13326958	13330140	A05p23460.2_BraZ1	2325	-	3995	2989	3182	0.9393463
A05	13342029	13343507	A05p23470.2_BraZ1	962.909	+	191	1235	1478	0.8355886
A05	13343895	13345566	A05p23480.2_BraZ1	1322.25	-	43	564	1671	0.3375224
A05	13350350	13351232	A05p23490.2_BraZ1	261	-	667	834	882	0.9455782
A05	13398150	13398643	A05p23500.2_BraZ1	198	-	49	493	493	1.0000000
A05	13398930	13399080	A05p23510.2_BraZ1	15	+	20	150	150	1.0000000
A05	13424734	13425230	A05p23520.2_BraZ1	183	+	13	428	496	0.8629032
A05	13745924	13746074	A05p23530.2_BraZ1	15	+	0	0	150	0.0000000
A05	13819602	13822988	A05p23540.2_BraZ1	378	-	15	450	3386	0.1329002
A05	13823279	13846017	A05p23550.2_BraZ1	1365	-	646	7838	22738	0.3447093
A05	13831511	13834217	A05p23560.2_BraZ1	198	-	14	383	2706	0.1415373
A05	13860514	13864212	A05p23570.2_BraZ1	627	-	763	3587	3698	0.9699838
A05	13864752	13868407	A05p23580.2_BraZ1	705	-	239	2939	3655	0.8041040
A05	13867878	13868247	A05p23590.2_BraZ1	88.5	-	8	225	369	0.6097561
A05	13878294	13880209	A05p23600.2_BraZ1	352.333	+	146	1568	1915	0.8187990
A05	13881124	13882997	A05p23610.2_BraZ1	363	-	27	942	1873	0.5029365
A05	13886556	13887922	A05p23620.2_BraZ1	300	-	310	1363	1366	0.9978038
A05	13887890	13900962	A05p23630.2_BraZ1	970.286	-	1510	11240	13072	0.8598531
A05	13907021	13909983	A05p23640.2_BraZ1	330	-	136	1505	2962	0.5081027
A05	13907223	13909815	A05p23650.2_BraZ1	390	-	90	1206	2592	0.4652778
A05	13925938	13939640	A05p23660.2_BraZ1	903	-	940	9352	13702	0.6825281
A05	13940303	13947307	A05p23670.2_BraZ1	606	-	173	2208	7004	0.3152484
A05	13955482	13957877	A05p23680.2_BraZ1	261	-	58	1169	2395	0.4881002
A05	13973347	13973966	A05p23690.2_BraZ1	507	-	17	495	619	0.7996769
A05	13984003	13984293	A05p23700.2_BraZ1	270	-	5	149	290	0.5137931
A05	14003462	14004238	A05p23710.2_BraZ1	408	+	2	178	776	0.2293814
A05	14008042	14008969	A05p23720.2_BraZ1	162	-	2	107	927	0.1154261
A05	14192598	14194431	A05p23730.2_BraZ1	462	+	401	1715	1833	0.9356247
A05	14201663	14207320	A05p23740.2_BraZ1	696	+	549	4977	5657	0.8797950
A05	14220244	14221343	A05p23750.2_BraZ1	660	+	89	705	1099	0.6414922
A05	14253070	14258338	A05p23760.2_BraZ1	606	+	119	1625	5268	0.3084662
A05	14261086	14262477	A05p23770.2_BraZ1	672	+	83	687	1391	0.4938893
A05	14273076	14273937	A05p23780.2_BraZ1	774	+	52	787	861	0.9140534
A05	14426248	14426972	A05p23790.2_BraZ1	144	-	20	404	724	0.5580111
A05	14609678	14666551	A05p23800.2_BraZ1	471	-	5001	35982	56873	0.6326728
A05	14650087	14651017	A05p23810.2_BraZ1	546	-	9	360	930	0.3870968
A05	14796912	14797323	A05p23820.2_BraZ1	282	+	60	390	411	0.9489051
A05	14982661	14986816	A05p23830.2_BraZ1	489	-	451	2963	4155	0.7131167
A05	15104552	15105698	A05p23840.2_BraZ1	189	-	263	898	1146	0.7835951
A05	15117055	15117649	A05p23850.2_BraZ1	186	-	50	503	594	0.8468013
A05	15117701	15117917	A05p23860.2_BraZ1	21.6	-	12	105	216	0.4861111
A05	15156388	15160795	A05p23870.2_BraZ1	504	+	32	1290	4407	0.2927161
A05	15195499	15196722	A05p23880.2_BraZ1	435	+	5	166	1223	0.1357318
A05	15220918	15224889	A05p23890.2_BraZ1	815.5	+	189	1839	3971	0.4631075
A05	15226767	15227511	A05p23900.2_BraZ1	414	+	30	383	744	0.5147849
A05	15232283	15233703	A05p23910.2_BraZ1	780	+	82	1196	1420	0.8422535
A05	15237947	15238808	A05p23920.2_BraZ1	531	+	27	738	861	0.8571429
A05	15242790	15243704	A05p23930.2_BraZ1	721.35	-	16	350	914	0.3829322
A05	15244389	15244686	A05p23940.2_BraZ1	243	+	2	78	297	0.2626263
A05	15245124	15245819	A05p23950.2_BraZ1	483	-	2	55	695	0.0791367
A05	15256410	15261993	A05p23960.2_BraZ1	929.143	+	465	4910	5583	0.8794555
A05	15284538	15285719	A05p23970.2_BraZ1	999	-	136	1015	1181	0.8594412
A05	15285899	15289136	A05p23980.2_BraZ1	204	+	32	1244	3237	0.3843065
A05	15288315	15289992	A05p23990.2_BraZ1	264	+	38	633	1677	0.3774597
A05	15329823	15333032	A05p24000.2_BraZ1	510	+	9	641	3209	0.1997507
A05	15343651	15343802	A05p24010.2_BraZ1	132	+	2	69	151	0.4569536
A05	15402902	15403985	A05p24020.2_BraZ1	354	-	6	330	1083	0.3047091
A05	15411071	15411500	A05p24030.2_BraZ1	42.9	+	16	91	429	0.2121212
A05	15420210	15424311	A05p24040.2_BraZ1	465	+	53	1325	4101	0.3230919
A05	15428516	15435276	A05p24050.2_BraZ1	702	+	289	3391	6760	0.5016272
A05	15445895	15446959	A05p24060.2_BraZ1	177.5	+	96	828	1064	0.7781955
A05	15456949	15459685	A05p24070.2_BraZ1	681	+	41	1646	2736	0.6016082
A05	15460433	15461726	A05p24080.2_BraZ1	75.9	+	68	1066	1293	0.8244393
A05	15490747	15491645	A05p24090.2_BraZ1	288	-	89	771	898	0.8585746
A05	15561252	15565026	A05p24100.2_BraZ1	912	+	824	596	3774	0.1579226
A05	15777683	15784564	A05p24110.2_BraZ1	633	+	603	5141	6881	0.7471298
A05	15803869	15804356	A05p24120.2_BraZ1	243	-	17	444	487	0.9117043
A05	15904836	15904959	A05p24130.2_BraZ1	12.3	+	5	123	123	1.0000000
A05	15931998	15932612	A05p24140.2_BraZ1	408	+	0	0	614	0.0000000
A05	15990073	15990694	A05p24150.2_BraZ1	219	+	0	0	621	0.0000000
A05	16026215	16038313	A05p24160.2_BraZ1	234	+	353	5820	12098	0.4810713
A05	16027722	16037835	A05p24170.2_BraZ1	294	-	293	5184	10113	0.5126075
A05	16038382	16064915	A05p24180.2_BraZ1	255	+	2334	14970	26533	0.5642031
A05	16065171	16067499	A05p24190.2_BraZ1	312	-	4	232	2328	0.0996564
A05	16502815	16503863	A05p24200.2_BraZ1	1863	-	234	914	1048	0.8721374
A05	16506064	16507676	A05p24210.2_BraZ1	318	-	17	365	1612	0.2264268
A05	16531207	16531557	A05p24220.2_BraZ1	246	+	0	0	350	0.0000000
A05	16555221	16555398	A05p24230.2_BraZ1	17.7	-	45	177	177	1.0000000
A05	16564496	16564812	A05p24240.2_BraZ1	222	+	0	0	316	0.0000000
A05	16565935	16570619	A05p24250.2_BraZ1	297	-	345	3443	4684	0.7350555
A05	16570420	16570856	A05p24260.2_BraZ1	270	+	1	46	436	0.1055046
A05	16583099	16586937	A05p24270.2_BraZ1	243	+	41	920	3838	0.2397082
A05	16583942	16591679	A05p24280.2_BraZ1	516	-	52	1541	7737	0.1991728
A05	16585851	16588627	A05p24290.2_BraZ1	294	+	10	572	2776	0.2060519
A05	16621150	16623089	A05p24300.2_BraZ1	522	-	10	495	1939	0.2552862
A05	16636242	16637185	A05p24310.2_BraZ1	369	-	7	437	943	0.4634146
A05	16636946	16644268	A05p24320.2_BraZ1	492	-	270	3113	7322	0.4251571
A05	16656697	16660101	A05p24330.2_BraZ1	495	-	551	3158	3404	0.9277321
A05	16970770	16971668	A05p24340.2_BraZ1	345	-	12	197	898	0.2193764
A05	17012756	17013630	A05p24350.2_BraZ1	345	-	4	184	874	0.2105263
A05	17542537	17543514	A05p24360.2_BraZ1	364	+	65	551	977	0.5639713
A05	17712948	17734346	A05p24370.2_BraZ1	240	-	756	10027	21398	0.4685952
A05	17788266	17791313	A05p24380.2_BraZ1	249	-	115	1891	3047	0.6206104
A05	17823852	17824759	A05p24390.2_BraZ1	330	+	61	878	907	0.9680265
A05	17848966	17854992	A05p24400.2_BraZ1	426	-	14	808	6026	0.1340856
A05	17855360	17857908	A05p24410.2_BraZ1	282	-	4	203	2548	0.0796703
A05	17859213	17860179	A05p24420.2_BraZ1	438	-	5	320	966	0.3312629
A05	17873304	17876580	A05p24430.2_BraZ1	282	-	48	834	3276	0.2545788
A05	17875104	17878347	A05p24440.2_BraZ1	630	-	48	1133	3243	0.3493679
A05	17887145	17888164	A05p24450.2_BraZ1	621	-	2	78	1019	0.0765456
A05	17905899	17906272	A05p24460.2_BraZ1	228	+	638	373	373	1.0000000
A05	17906302	17906750	A05p24470.2_BraZ1	261	-	690	448	448	1.0000000
A05	17917496	17917986	A05p24480.2_BraZ1	285	+	40	348	490	0.7102041
A05	17917756	17922844	A05p24490.2_BraZ1	447	-	79	1894	5088	0.3722484
A05	17934380	17935352	A05p24500.2_BraZ1	363	+	17	756	972	0.7777778
A05	18014480	18015379	A05p24510.2_BraZ1	534	+	8	380	899	0.4226919
A05	18067101	18072401	A05p24520.2_BraZ1	327	-	379	3723	5300	0.7024528
A05	18067240	18072915	A05p24530.2_BraZ1	267	-	391	3870	5675	0.6819384
A05	18071695	18072829	A05p24540.2_BraZ1	210	+	55	409	1134	0.3606702
A05	18072359	18072565	A05p24550.2_BraZ1	162	-	52	206	206	1.0000000
A05	18251364	18251734	A05p24560.2_BraZ1	156	+	77	267	370	0.7216216
A05	18261632	18262594	A05p24570.2_BraZ1	186	+	13	295	962	0.3066528
A05	18352628	18352829	A05p24580.2_BraZ1	20.1	+	57	201	201	1.0000000
A05	18355886	18356087	A05p24590.2_BraZ1	20.1	+	55	201	201	1.0000000
A05	18416876	18417891	A05p24600.2_BraZ1	288	+	11	454	1015	0.4472906
A05	18488907	18523753	A05p24610.2_BraZ1	1290	-	3128	27261	34846	0.7823280
A05	18548111	18549908	A05p24620.2_BraZ1	453	-	20	402	1797	0.2237062
A05	18580688	18581622	A05p24630.2_BraZ1	402	-	68	792	934	0.8479657
A05	18724061	18724926	A05p24640.2_BraZ1	240	-	83	674	865	0.7791908
A05	18727076	18727964	A05p24650.2_BraZ1	570	+	29	686	888	0.7725225
A05	18730287	18731613	A05p24660.2_BraZ1	85.2	+	138	1165	1326	0.8785822
A05	18732673	18734062	A05p24670.2_BraZ1	264	-	141	1252	1389	0.9013679
A05	18737157	18756586	A05p24680.2_BraZ1	690	-	1524	11225	19429	0.5777446
A05	18737847	18775454	A05p24690.2_BraZ1	354	-	3455	26697	37607	0.7098944
A05	18738553	18739205	A05p24700.2_BraZ1	207	-	184	640	652	0.9815951
A05	18757347	18779689	A05p24710.2_BraZ1	397.5	-	3037	18469	22342	0.8266494
A05	18800151	18801443	A05p24720.2_BraZ1	642	-	20	674	1292	0.5216718
A05	18800786	18801137	A05p24730.2_BraZ1	390	+	11	252	351	0.7179487
A05	18933178	18972207	A05p24740.2_BraZ1	444.075	+	1825	24941	39029	0.6390376
A05	19063052	19063745	A05p24750.2_BraZ1	462	+	0	0	693	0.0000000
A05	19064129	19064426	A05p24760.2_BraZ1	243	-	2	170	297	0.5723906
A05	19064976	19065892	A05p24770.2_BraZ1	695.4	+	24	700	916	0.7641922
A05	19098367	19189418	A05p24780.2_BraZ1	873	+	17839	69146	91051	0.7594206
A05	19189258	19191764	A05p24790.2_BraZ1	272	+	39	1748	2506	0.6975259
A05	19190621	19191003	A05p24800.2_BraZ1	300	+	3	198	382	0.5183246
A05	19242454	19242935	A05p24810.2_BraZ1	339	+	528	481	481	1.0000000
A05	19242935	19243539	A05p24820.2_BraZ1	50.7	+	980	604	604	1.0000000
A05	19506226	19531114	A05p24830.2_BraZ1	276	-	2683	15750	24888	0.6328351
A05	19551284	19552078	A05p24840.2_BraZ1	186	-	177	711	794	0.8954660
A05	19551685	19559960	A05p24850.2_BraZ1	159	+	20824	7236	8275	0.8744411
A05	19560049	19560199	A05p24860.2_BraZ1	15	-	10	58	150	0.3866667
A05	19579670	19580300	A05p24870.2_BraZ1	567	+	0	0	630	0.0000000
A05	19580300	19592905	A05p24880.2_BraZ1	1260	+	2510	9076	12605	0.7200317
A05	19614110	19619155	A05p24890.2_BraZ1	1122	+	79	1745	5045	0.3458870
A05	19633561	19644084	A05p24900.2_BraZ1	510	+	1364	7918	10523	0.7524470
A05	19643792	19644866	A05p24910.2_BraZ1	594	-	51	489	1074	0.4553073
A05	19659125	19672738	A05p24920.2_BraZ1	728.333	-	1005	7321	13613	0.5377948
A05	19661694	19673262	A05p24930.2_BraZ1	264	+	1010	7374	11568	0.6374481
A05	19692976	19693572	A05p24940.2_BraZ1	426	-	84	448	596	0.7516779
A05	19702852	19709054	A05p24950.2_BraZ1	315	-	41	1048	6202	0.1689778
A05	19710437	19711396	A05p24960.2_BraZ1	315	-	6	278	959	0.2898853
A05	19712731	19713190	A05p24970.2_BraZ1	44.4	+	19	227	459	0.4945534
A05	19739970	19792639	A05p24980.2_BraZ1	726	+	5801	32902	52669	0.6246939
A05	19801583	19828556	A05p24990.2_BraZ1	162	+	2495	17738	26973	0.6576206
A05	19996195	19996489	A05p25000.2_BraZ1	29.4	+	26	126	294	0.4285714
A05	20015263	20019031	A05p25010.2_BraZ1	1107	+	43	1797	3768	0.4769108
A05	20028022	20028197	A05p25020.2_BraZ1	156	-	0	0	175	0.0000000
A05	20036946	20038689	A05p25030.2_BraZ1	356.25	+	40	930	1743	0.5335628
A05	20059803	20067746	A05p25040.2_BraZ1	552	+	470	5205	7943	0.6552939
A05	20067785	20074374	A05p25050.2_BraZ1	925.2	-	693	4877	6589	0.7401730
A05	20077840	20079840	A05p25060.2_BraZ1	204	-	55	990	2000	0.4950000
A05	20079203	20081074	A05p25070.2_BraZ1	681	+	45	829	1871	0.4430786
A05	20081347	20082433	A05p25080.2_BraZ1	153	+	14	545	1086	0.5018416
A05	20083281	20083911	A05p25090.2_BraZ1	237	+	0	0	630	0.0000000
A05	20103070	20114408	A05p25100.2_BraZ1	875	+	177	2795	11338	0.2465161
A05	20117874	20122385	A05p25110.2_BraZ1	1218	+	593	3351	4511	0.7428508
A05	20138457	20141515	A05p25120.2_BraZ1	1083	+	22	1226	3058	0.4009156
A05	20157927	20161446	A05p25130.2_BraZ1	510	-	37	689	3519	0.1957943
A05	20170751	20171557	A05p25140.2_BraZ1	344.25	+	21600	806	806	1.0000000
A05	20172562	20185202	A05p25150.2_BraZ1	537	-	24974	12296	12640	0.9727848
A05	20174053	20177127	A05p25160.2_BraZ1	108	-	2861	3066	3074	0.9973975
A05	20185156	20185964	A05p25170.2_BraZ1	462	+	7014	807	808	0.9987624
A05	20186972	20198114	A05p25180.2_BraZ1	54.6	-	9748	10862	11142	0.9748698
A05	20186972	20201893	A05p25190.2_BraZ1	73.2	-	13691	14535	14921	0.9741304
A05	20193962	20194352	A05p25200.2_BraZ1	267	-	4134	390	390	1.0000000
A05	20202163	20202469	A05p25210.2_BraZ1	30.6	+	73	306	306	1.0000000
A05	20209451	20209757	A05p25220.2_BraZ1	30.6	+	42	305	306	0.9967320
A05	20227599	20227931	A05p25230.2_BraZ1	27.6	+	5	102	332	0.3072289
A05	20229078	20229213	A05p25240.2_BraZ1	13.5	+	0	0	135	0.0000000
A05	20509589	20510384	A05p25250.2_BraZ1	264	-	2050	755	795	0.9496855
A05	20510382	20550569	A05p25260.2_BraZ1	684	+	3917	27603	40187	0.6868639
A05	20597940	20662179	A05p25270.2_BraZ1	1227	+	15239	40992	64239	0.6381170
A05	20625934	20627225	A05p25280.2_BraZ1	116.4	-	2853	1039	1291	0.8048025
A05	20632476	20633593	A05p25290.2_BraZ1	612	+	225	995	1117	0.8907789
A05	20633513	20635075	A05p25300.2_BraZ1	66.3	+	121	1355	1562	0.8674776
A05	20639231	20639954	A05p25310.2_BraZ1	214.667	-	47	591	723	0.8174274
A05	20640994	20641487	A05p25320.2_BraZ1	37.2	+	16	205	493	0.4158215
A05	20643475	20644198	A05p25330.2_BraZ1	214.667	-	67	700	723	0.9681881
A05	20645238	20645732	A05p25340.2_BraZ1	38.1	+	20	356	494	0.7206478
A05	20671085	20671409	A05p25350.2_BraZ1	32.4	-	9	107	324	0.3302469
A05	20671409	20671911	A05p25360.2_BraZ1	468	-	0	0	502	0.0000000
A05	20671940	20672199	A05p25370.2_BraZ1	174	-	0	0	259	0.0000000
A05	20672078	20672857	A05p25380.2_BraZ1	453.6	+	59	474	779	0.6084724
A05	20696069	20722218	A05p25390.2_BraZ1	198	-	1207	12277	26149	0.4695017
A05	20756938	20785715	A05p25400.2_BraZ1	847.875	+	1691	18903	28777	0.6568788
A05	20781993	20782386	A05p25410.2_BraZ1	39.3	+	10	350	393	0.8905852
A05	20785288	20786833	A05p25420.2_BraZ1	474	+	138	1464	1545	0.9475728
A05	20787567	20790125	A05p25430.2_BraZ1	204	-	220	2366	2558	0.9249414
A05	20791737	20794213	A05p25440.2_BraZ1	928	-	62	1225	2476	0.4947496
A05	20792536	20817757	A05p25450.2_BraZ1	1494.64	+	2191	17320	25221	0.6867293
A05	20797926	20798375	A05p25460.2_BraZ1	321	+	13	201	449	0.4476615
A05	20818419	20818693	A05p25470.2_BraZ1	231	+	43	274	274	1.0000000
A05	20828754	20829735	A05p25480.2_BraZ1	11261.5	+	25	699	981	0.7125382
A05	20829337	20902397	A05p25490.2_BraZ1	535.714	+	9932	44283	73060	0.6061183
A05	20829337	20991489	A05p25500.2_BraZ1	339.429	-	11285	78565	162152	0.4845145
A05	20851488	20855623	A05p25510.2_BraZ1	1337	-	487	2763	4135	0.6681983
A05	20862315	20875914	A05p25520.2_BraZ1	432	-	6765	11672	13599	0.8582984
A05	20876073	20878326	A05p25530.2_BraZ1	741	+	10	541	2253	0.2401243
A05	20886843	20887588	A05p25540.2_BraZ1	273	+	52	563	745	0.7557047
A05	20906036	20913318	A05p25550.2_BraZ1	918.857	+	123	3345	7282	0.4593518
A05	20918904	20919970	A05p25560.2_BraZ1	654	-	10	262	1066	0.2457786
A05	20921498	20932605	A05p25570.2_BraZ1	273	-	163	3990	11107	0.3592329
A05	20930213	20933538	A05p25580.2_BraZ1	471	-	24	909	3325	0.2733835
A05	20931367	20939410	A05p25590.2_BraZ1	975	+	141	3069	8043	0.3815740
A05	20939819	20951505	A05p25600.2_BraZ1	436.667	+	102	3246	11686	0.2777683
A05	20952436	20956777	A05p25610.2_BraZ1	1035	+	28	1076	4341	0.2478691
A05	20953722	20957466	A05p25620.2_BraZ1	225	+	27	712	3744	0.1901709
A05	20957630	20959001	A05p25630.2_BraZ1	450	+	60	745	1371	0.5433990
A05	20990958	21067142	A05p25640.2_BraZ1	408	+	4141	40836	76184	0.5360181
A05	21094197	21119458	A05p25650.2_BraZ1	1208.31	-	848	11595	25261	0.4590079
A05	21096346	21097099	A05p25660.2_BraZ1	474	+	12	570	753	0.7569721
A05	21097369	21098400	A05p25670.2_BraZ1	813	+	270	981	1031	0.9515034
A05	21100545	21101485	A05p25680.2_BraZ1	312	-	34	567	940	0.6031915
A05	21102141	21107648	A05p25690.2_BraZ1	428.625	-	239	3083	5507	0.5598329
A05	21103944	21104396	A05p25700.2_BraZ1	37.2	+	3	48	452	0.1061947
A05	21106384	21107106	A05p25710.2_BraZ1	214.667	-	108	605	722	0.8379501
A05	21108146	21108640	A05p25720.2_BraZ1	38.1	+	6	146	494	0.2955466
A05	21137626	21138292	A05p25730.2_BraZ1	378	-	0	0	666	0.0000000
A05	21138138	21140017	A05p25740.2_BraZ1	696	+	0	0	1879	0.0000000
A05	21140771	21149274	A05p25750.2_BraZ1	1683	-	23	1569	8503	0.1845231
A05	21147083	21148104	A05p25760.2_BraZ1	822	+	1	9	1021	0.0088149
A05	21149621	21150263	A05p25770.2_BraZ1	201	-	0	0	642	0.0000000
A05	21160107	21161167	A05p25780.2_BraZ1	633	-	18	130	1060	0.1226415
A05	21161700	21166037	A05p25790.2_BraZ1	423	-	30	1463	4337	0.3373300
A05	21163857	21170340	A05p25800.2_BraZ1	528	-	39	1938	6483	0.2989357
A05	21171023	21172811	A05p25810.2_BraZ1	930	+	2	199	1788	0.1112975
A05	21174378	21175088	A05p25820.2_BraZ1	309	-	13	473	710	0.6661972
A05	21196560	21220403	A05p25830.2_BraZ1	1530	-	333	7472	23843	0.3133834
A05	21232998	21250247	A05p25840.2_BraZ1	462	+	229	5844	17249	0.3388022
A05	21264080	21265120	A05p25850.2_BraZ1	1020	+	10	533	1040	0.5125000
A05	21272108	21273159	A05p25860.2_BraZ1	1863	+	2	255	1051	0.2426261
A05	21339928	21341518	A05p25870.2_BraZ1	546	-	14	700	1590	0.4402516
A05	21559744	21566507	A05p25880.2_BraZ1	1326	+	42	2259	6763	0.3340234
A05	21575090	21589220	A05p25890.2_BraZ1	598.6	+	61	2262	14130	0.1600849
A05	21588807	21590069	A05p25900.2_BraZ1	35.7	-	61	791	1262	0.6267829
A05	21590085	21601220	A05p25910.2_BraZ1	516	+	117	2716	11135	0.2439156
A05	21590303	21638320	A05p25920.2_BraZ1	1432.8	+	682	15782	48017	0.3286753
A05	21601041	21601474	A05p25930.2_BraZ1	288	+	41	433	433	1.0000000
A05	21642884	21646152	A05p25940.2_BraZ1	458.769	+	51	1568	3268	0.4798042
A05	21651609	21654597	A05p25950.2_BraZ1	1019.2	+	118	1089	2988	0.3644578
A05	21751340	21753531	A05p25960.2_BraZ1	487.5	+	3	198	2191	0.0903697
A05	21761210	21766294	A05p25970.2_BraZ1	721.636	+	92	1367	5084	0.2688828
A05	21766272	21767684	A05p25980.2_BraZ1	357	+	137	858	1412	0.6076487
A05	21779341	21781841	A05p25990.2_BraZ1	1172.06	+	71	1750	2500	0.7000000
A05	21796155	21797201	A05p26000.2_BraZ1	642	+	21	747	1046	0.7141491
A05	21797950	21813519	A05p26010.2_BraZ1	642	+	224	3929	15569	0.2523605
A05	21798761	21807602	A05p26020.2_BraZ1	411	+	136	1523	8841	0.1722656
A05	21809168	21812712	A05p26030.2_BraZ1	294	-	73	1470	3544	0.4147856
A05	21813921	21815703	A05p26040.2_BraZ1	318	+	5	411	1782	0.2306397
A05	21814533	21822049	A05p26050.2_BraZ1	1615.38	-	92	1678	7516	0.2232570
A05	21821822	21822444	A05p26060.2_BraZ1	427.5	-	58	549	622	0.8826367
A05	21830937	21831314	A05p26070.2_BraZ1	33	-	136	248	377	0.6578249
A05	21840065	21842626	A05p26080.2_BraZ1	743.4	+	13	949	2561	0.3705584
A05	21856390	21856696	A05p26090.2_BraZ1	17.1	+	2	136	306	0.4444444
A05	21868691	21870042	A05p26100.2_BraZ1	1026	-	57	1037	1351	0.7675796
A05	21925840	21926542	A05p26110.2_BraZ1	171	-	200	639	702	0.9102564
A05	21927224	21927856	A05p26120.2_BraZ1	306	+	85	621	632	0.9825949
A05	21928031	21928311	A05p26130.2_BraZ1	180	-	31	252	280	0.9000000
A05	21928610	21936872	A05p26140.2_BraZ1	1701.9	+	860	6177	8262	0.7476398
A05	21946405	21948270	A05p26150.2_BraZ1	977.143	+	233	1848	1865	0.9908847
A05	21968430	21969089	A05p26160.2_BraZ1	231	+	17	616	659	0.9347496
A05	21969004	21973715	A05p26170.2_BraZ1	1126.67	+	34	1903	4711	0.4039482
A05	21982281	22002837	A05p26180.2_BraZ1	2953.33	+	858	10422	20556	0.5070053
A05	22012086	22020764	A05p26190.2_BraZ1	526.393	+	362	5860	8678	0.6752708
A05	22029319	22030219	A05p26200.2_BraZ1	838.125	+	75	854	900	0.9488889
A05	22037973	22039076	A05p26210.2_BraZ1	669	+	46	985	1103	0.8930190
A05	22156269	22159977	A05p26220.2_BraZ1	759.5	-	7	697	3708	0.1879719
A05	22167507	22168489	A05p26230.2_BraZ1	69.6	-	6	343	982	0.3492872
A05	22175576	22208864	A05p26240.2_BraZ1	1365	-	396	9340	33288	0.2805816
A05	22177562	22178950	A05p26250.2_BraZ1	162	+	9	386	1388	0.2780980
A05	22213428	22214398	A05p26260.2_BraZ1	417.375	+	2	141	970	0.1453608
A05	22214514	22215554	A05p26270.2_BraZ1	480	+	32	884	1040	0.8500000
A05	22224309	22225545	A05p26280.2_BraZ1	789	-	13	581	1236	0.4700647
A05	22275960	22278831	A05p26290.2_BraZ1	789	+	172	2111	2871	0.7352839
A05	22280476	22283825	A05p26300.2_BraZ1	300	+	263	1932	3349	0.5768886
A05	22281905	22282205	A05p26310.2_BraZ1	30	-	3	140	300	0.4666667
A05	22284087	22302158	A05p26320.2_BraZ1	1083	+	345	5030	18071	0.2783465
A05	22303043	22323326	A05p26330.2_BraZ1	1200	-	431	6869	20283	0.3386580
A05	22335575	22336465	A05p26340.2_BraZ1	525	-	1	128	890	0.1438202
A05	22430542	22459971	A05p26350.2_BraZ1	684	-	567	12474	29429	0.4238676
A05	22450436	22451490	A05p26360.2_BraZ1	351	+	18	436	1054	0.4136622
A05	22451965	22462736	A05p26370.2_BraZ1	309	+	399	4912	10771	0.4560394
A05	22460779	22465913	A05p26380.2_BraZ1	1032	-	132	1564	5134	0.3046358
A05	22466040	22466190	A05p26390.2_BraZ1	15	+	0	0	150	0.0000000
A05	22480696	22481203	A05p26400.2_BraZ1	50.1	-	0	0	507	0.0000000
A05	22495115	22497114	A05p26410.2_BraZ1	333	+	8	587	1999	0.2936468
A05	22497962	22522958	A05p26420.2_BraZ1	939	-	1366	11243	24996	0.4497920
A05	22528275	22534681	A05p26430.2_BraZ1	651	-	68	1869	6406	0.2917577
A05	22541736	22542497	A05p26440.2_BraZ1	195	-	65	319	761	0.4191853
A05	22542394	22559517	A05p26450.2_BraZ1	153	-	241	4771	17123	0.2786311
A05	22542748	22543661	A05p26460.2_BraZ1	432	+	3	252	913	0.2760131
A05	22556328	22559319	A05p26470.2_BraZ1	537	+	20	985	2991	0.3293213
A05	22559019	22559328	A05p26480.2_BraZ1	126	+	1	100	309	0.3236246
A05	22559407	22560013	A05p26490.2_BraZ1	534	-	0	0	606	0.0000000
A05	22561247	22571932	A05p26500.2_BraZ1	636	-	122	2241	10685	0.2097333
A05	22561993	22571633	A05p26510.2_BraZ1	339	-	112	1998	9640	0.2072614
A05	22571633	22572394	A05p26520.2_BraZ1	195	-	32	415	761	0.5453351
A05	22572645	22573558	A05p26530.2_BraZ1	432	+	0	0	913	0.0000000
A05	22586111	22597893	A05p26540.2_BraZ1	1116	+	133	3029	11782	0.2570871
A05	22588141	22589176	A05p26550.2_BraZ1	124.5	-	66	892	1035	0.8618358
A05	22599943	22600493	A05p26560.2_BraZ1	345	-	5	184	550	0.3345455
A05	22606956	22629380	A05p26570.2_BraZ1	556.667	+	848	10618	22424	0.4735105
A05	22628369	22648158	A05p26580.2_BraZ1	351	+	7912	9658	19789	0.4880489
A05	22632652	22633079	A05p26590.2_BraZ1	29.4	-	0	0	427	0.0000000
A05	22667407	22667668	A05p26600.2_BraZ1	26.1	+	7	261	261	1.0000000
A05	22698805	22727986	A05p26610.2_BraZ1	438	-	1101	16514	29181	0.5659162
A05	22708066	22729444	A05p26620.2_BraZ1	501	-	976	12721	21378	0.5950510
A05	22831971	22834884	A05p26630.2_BraZ1	394.5	+	14	942	2913	0.3233780
A05	22871175	22871708	A05p26640.2_BraZ1	234	+	0	0	533	0.0000000
A05	22871638	22876692	A05p26650.2_BraZ1	1194	-	49	1291	5054	0.2554412
A05	22902977	22904865	A05p26660.2_BraZ1	489	-	63	1114	1888	0.5900424
A05	22913620	22914543	A05p26670.2_BraZ1	537	-	35	615	923	0.6663055
A05	22913828	23027210	A05p26680.2_BraZ1	432	+	3190	47319	113382	0.4173414
A05	22913835	22914122	A05p26690.2_BraZ1	171	+	26	237	287	0.8257840
A05	22938770	22953837	A05p26700.2_BraZ1	492	-	233	6889	15067	0.4572244
A05	23069265	23069388	A05p26710.2_BraZ1	12.3	+	8	123	123	1.0000000
A05	23124898	23125151	A05p26720.2_BraZ1	14.4	-	47	240	253	0.9486166
A05	23128059	23129679	A05p26730.2_BraZ1	177	+	28	827	1620	0.5104938
A05	23130117	23130267	A05p26740.2_BraZ1	15	-	0	0	150	0.0000000
A05	23130280	23131519	A05p26750.2_BraZ1	369	+	0	0	1239	0.0000000
A05	23133172	23135114	A05p26760.2_BraZ1	13612.5	+	160	1574	1942	0.8105046
A05	23136582	23139999	A05p26770.2_BraZ1	1176	+	0	0	3417	0.0000000
A05	23140470	23146208	A05p26780.2_BraZ1	267	+	7	344	5738	0.0599512
A05	23143414	23147024	A05p26790.2_BraZ1	258	+	6	417	3610	0.1155125
A05	23144083	23150594	A05p26800.2_BraZ1	1218.38	+	28	588	6511	0.0903087
A05	23154823	23156691	A05p26810.2_BraZ1	3168	+	13	721	1868	0.3859743
A05	23166838	23167324	A05p26820.2_BraZ1	282	+	4	278	486	0.5720165
A05	23167665	23175692	A05p26830.2_BraZ1	276	+	47	1873	8027	0.2333375
A05	23176961	23177092	A05p26840.2_BraZ1	114	+	0	0	131	0.0000000
A05	23177092	23187657	A05p26850.2_BraZ1	666	-	55	2732	10565	0.2585897
A05	23187651	23190577	A05p26860.2_BraZ1	552.5	+	24	652	2926	0.2228298
A05	23191496	23194153	A05p26870.2_BraZ1	398	+	19	921	2657	0.3466315
A05	23201249	23201546	A05p26880.2_BraZ1	29.7	+	0	0	297	0.0000000
A05	23206004	23207703	A05p26890.2_BraZ1	472.8	+	2	126	1699	0.0741613
A05	23211239	23215076	A05p26900.2_BraZ1	564	+	7	502	3837	0.1308314
A05	23213103	23215599	A05p26910.2_BraZ1	584	+	8	572	2496	0.2291667
A05	23217888	23219168	A05p26920.2_BraZ1	270	-	4	391	1280	0.3054687
A05	23279171	23279860	A05p26930.2_BraZ1	171	-	0	0	689	0.0000000
A05	23382661	23382823	A05p26940.2_BraZ1	13.5	-	0	0	162	0.0000000
A05	23833401	23834411	A05p26950.2_BraZ1	372	+	11	247	1010	0.2445545
A05	23912239	23912727	A05p26960.2_BraZ1	369	-	18	338	488	0.6926230
A05	23946695	23946827	A05p26970.2_BraZ1	13.2	-	4	40	132	0.3030303
A05	23948276	23951761	A05p26980.2_BraZ1	333	-	119	1532	3485	0.4395983
A05	23952189	23952872	A05p26990.2_BraZ1	492	+	111	427	683	0.6251830
A05	23971308	23976081	A05p27000.2_BraZ1	744	+	19	790	4773	0.1655143
A05	23972424	23974297	A05p27010.2_BraZ1	291	-	10	144	1873	0.0768820
A05	24062242	24189023	A05p27020.2_BraZ1	165	+	3847	36695	126781	0.2894361
A05	24289590	24289896	A05p27030.2_BraZ1	17.1	-	4	197	306	0.6437908
A05	24312273	24322502	A05p27040.2_BraZ1	387	-	130	4142	10229	0.4049272
A05	24313777	24315663	A05p27050.2_BraZ1	162	-	14	603	1886	0.3197243
A05	24314168	24314918	A05p27060.2_BraZ1	216	+	6	253	750	0.3373333
A05	24315328	24321968	A05p27070.2_BraZ1	1053	+	37	1954	6640	0.2942771
A05	24321367	24322315	A05p27080.2_BraZ1	219	-	22	831	948	0.8765823
A05	24321968	24334069	A05p27090.2_BraZ1	774	-	85	3694	12101	0.3052640
A05	24322925	24323754	A05p27100.2_BraZ1	180	-	8	184	829	0.2219542
A05	24354704	24363338	A05p27110.2_BraZ1	474	-	3459	7215	8634	0.8356497
A05	24371574	24373363	A05p27120.2_BraZ1	1068	+	36	961	1789	0.5371716
A05	24380005	24384333	A05p27130.2_BraZ1	1095	+	182	2524	4328	0.5831793
A05	24384115	24394592	A05p27140.2_BraZ1	558	-	95	2400	10477	0.2290732
A05	24394770	24394893	A05p27150.2_BraZ1	12.3	-	10	106	123	0.8617886
A05	24411299	24411872	A05p27160.2_BraZ1	363	+	1	39	573	0.0680628
A05	24412089	24412295	A05p27170.2_BraZ1	177	+	1	34	206	0.1650485
A05	24423465	24424208	A05p27180.2_BraZ1	351	+	0	0	743	0.0000000
A05	24430877	24431251	A05p27190.2_BraZ1	204	+	13	314	374	0.8395722
A05	24431879	24432353	A05p27200.2_BraZ1	333	-	61	404	474	0.8523207
A05	24432030	24486455	A05p27210.2_BraZ1	22.8	+	4918	26412	54425	0.4852917
A05	24438635	24439472	A05p27220.2_BraZ1	81.9	+	9	423	837	0.5053763
A05	24440981	24445434	A05p27230.2_BraZ1	393	+	34	1589	4453	0.3568381
A05	24448718	24449197	A05p27240.2_BraZ1	294	-	11	273	479	0.5699373
A05	24462197	24462877	A05p27250.2_BraZ1	435.75	+	35	425	680	0.6250000
A05	24486455	24487733	A05p27260.2_BraZ1	726.75	-	16	363	1278	0.2840376
A05	24500263	24500740	A05p27270.2_BraZ1	288	+	33	423	477	0.8867925
A05	24500962	24619556	A05p27280.2_BraZ1	495	-	2183	50397	118594	0.4249541
A05	24557590	24558501	A05p27290.2_BraZ1	330	-	0	0	911	0.0000000
A05	24558657	24559758	A05p27300.2_BraZ1	484	+	46	413	1101	0.3751135
A05	24616224	24616855	A05p27310.2_BraZ1	153	-	2	117	631	0.1854200
A05	24616525	24619665	A05p27320.2_BraZ1	129	+	44	1142	3140	0.3636943
A05	24618110	24618760	A05p27330.2_BraZ1	213	+	32	431	650	0.6630769
A05	24619556	24620230	A05p27340.2_BraZ1	414	+	25	259	674	0.3842730
A05	24628344	24629516	A05p27350.2_BraZ1	32.4	+	68	909	1172	0.7755973
A05	24655509	24656583	A05p27360.2_BraZ1	243	-	63	822	1074	0.7653632
A05	24655613	24657051	A05p27370.2_BraZ1	339	+	113	1186	1438	0.8247566
A05	24656494	24657176	A05p27380.2_BraZ1	291	+	97	682	682	1.0000000
A05	24665683	24665986	A05p27390.2_BraZ1	30.3	+	116	303	303	1.0000000
A05	24790003	24791593	A05p27400.2_BraZ1	1125	+	0	0	1590	0.0000000
A05	25005464	25007813	A05p27410.2_BraZ1	1221	+	6	103	2349	0.0438484
A05	25007306	25007451	A05p27420.2_BraZ1	123	-	0	0	145	0.0000000
A05	25027799	25032182	A05p27430.2_BraZ1	1158	+	22	653	4383	0.1489847
A05	25031027	25032094	A05p27440.2_BraZ1	414	-	14	234	1067	0.2193065
A05	25059176	25060376	A05p27450.2_BraZ1	270	-	0	0	1200	0.0000000
A05	25059342	25062752	A05p27460.2_BraZ1	609	-	18	685	3410	0.2008798
A05	25062370	25065804	A05p27470.2_BraZ1	792	+	35	623	3434	0.1814211
A05	25067486	25068920	A05p27480.2_BraZ1	8287.5	-	32	868	1434	0.6052999
A05	25072756	25073959	A05p27490.2_BraZ1	462	-	7	244	1203	0.2028263
A05	25074184	25079426	A05p27500.2_BraZ1	1281	+	25	1540	5242	0.2937810
A05	25079643	25222622	A05p27510.2_BraZ1	699	-	7484	73733	142979	0.5156911
A05	25163520	25164216	A05p27520.2_BraZ1	588	+	5	202	696	0.2902299
A05	25170331	25171188	A05p27530.2_BraZ1	519	-	52	844	857	0.9848308
A05	25222635	25222785	A05p27540.2_BraZ1	15	+	0	0	150	0.0000000
A05	25340593	25341608	A05p27550.2_BraZ1	288	+	6	412	1015	0.4059113
A05	25436374	25441168	A05p27560.2_BraZ1	735	+	109	1471	4794	0.3068419
A05	25538856	25539770	A05p27570.2_BraZ1	432	-	14	269	914	0.2943107
A05	25580757	25581619	A05p27580.2_BraZ1	396	-	2	20	862	0.0232019
A05	25745217	25746232	A05p27590.2_BraZ1	288	+	21	644	1015	0.6344827
A05	25861157	25864386	A05p27600.2_BraZ1	849	+	40	1118	3229	0.3462372
A05	26069191	26085061	A05p27610.2_BraZ1	312	-	365	7104	15870	0.4476371
A05	26085068	26101535	A05p27620.2_BraZ1	636	-	1863	12894	16467	0.7830206
A05	26085514	26086666	A05p27630.2_BraZ1	285	+	70	833	1152	0.7230903
A05	26090997	26092361	A05p27640.2_BraZ1	1125	+	298	1056	1364	0.7741935
A05	26118994	26125020	A05p27650.2_BraZ1	1604.62	-	346	3573	6026	0.5929306
A05	26141166	26142567	A05p27660.2_BraZ1	627	-	6	207	1401	0.1477516
A05	26150455	26155508	A05p27670.2_BraZ1	527.25	-	7	151	5053	0.0298832
A05	26158983	26161529	A05p27680.2_BraZ1	617.464	-	6	348	2546	0.1366850
A05	26160503	26165237	A05p27690.2_BraZ1	300	-	29	857	4734	0.1810308
A05	26165555	26166287	A05p27700.2_BraZ1	201	-	8	395	732	0.5396175
A05	26260943	26264729	A05p27710.2_BraZ1	1437	+	59	823	3786	0.2173798
A05	26264202	26287425	A05p27720.2_BraZ1	252	-	1955	14307	23223	0.6160703
A05	26281114	26284178	A05p27730.2_BraZ1	715.5	-	48	1100	3064	0.3590078
A05	26287153	26288633	A05p27740.2_BraZ1	201	-	32	702	1480	0.4743243
A05	26294917	26295975	A05p27750.2_BraZ1	192	-	7	248	1058	0.2344045
A05	26295053	26296186	A05p27760.2_BraZ1	947.143	-	6	307	1133	0.2709621
A05	26296427	26304687	A05p27770.2_BraZ1	794.5	-	260	3662	8260	0.4433414
A05	26305255	26317076	A05p27780.2_BraZ1	330	-	654	7345	11821	0.6213518
A05	26316785	26317078	A05p27790.2_BraZ1	252	+	1	3	293	0.0102389
A05	26363250	26366180	A05p27800.2_BraZ1	1080	-	43	789	2930	0.2692833
A05	26364228	26365640	A05p27810.2_BraZ1	162	+	30	432	1412	0.3059490
A05	26367957	26373529	A05p27820.2_BraZ1	330	-	946	4613	5572	0.8278894
A05	26383729	26384113	A05p27830.2_BraZ1	144	+	6	135	384	0.3515625
A05	26384595	26391224	A05p27840.2_BraZ1	515.667	-	147	3190	6629	0.4812189
A05	26385142	26386762	A05p27850.2_BraZ1	405	-	59	881	1620	0.5438272
A05	26391237	26391387	A05p27860.2_BraZ1	15	+	1	49	150	0.3266667
A05	27660073	27660445	A05p27870.2_BraZ1	37.2	+	15	372	372	1.0000000
A05	27782254	27782834	A05p27880.2_BraZ1	213	+	1	128	580	0.2206897
A05	27785691	27786271	A05p27890.2_BraZ1	213	+	6	235	580	0.4051724
A05	27882364	27882736	A05p27900.2_BraZ1	37.2	+	6	315	372	0.8467742
A05	28873387	28873865	A05p27910.2_BraZ1	201	+	1203	478	478	1.0000000
A05	28891771	28892054	A05p27920.2_BraZ1	198	-	160	283	283	1.0000000
A05	28932207	28934916	A05p27930.2_BraZ1	1587.91	+	110	1173	2709	0.4330011
A05	28935934	28936120	A05p27940.2_BraZ1	18.6	+	274	186	186	1.0000000
A05	28937945	28942561	A05p27950.2_BraZ1	418.229	-	1412	3722	4616	0.8063259
A05	28950514	28950685	A05p27960.2_BraZ1	17.1	+	121	171	171	1.0000000
A05	28953838	28958194	A05p27970.2_BraZ1	1185	-	172	1534	4356	0.3521580
A05	28963506	28971629	A05p27980.2_BraZ1	1101.06	+	49478	7856	8123	0.9671304
A05	28987959	28988283	A05p27990.2_BraZ1	32.4	-	1	95	324	0.2932099
A05	28989151	28989475	A05p28000.2_BraZ1	32.4	-	43	150	324	0.4629630
A05	29006525	29007047	A05p28010.2_BraZ1	52.2	+	22	294	522	0.5632184
A05	29009903	29011207	A05p28020.2_BraZ1	345	+	0	0	1304	0.0000000
A05	29012741	29063624	A05p28030.2_BraZ1	1648.78	+	5125	22568	50883	0.4435273
A05	29029439	29030063	A05p28040.2_BraZ1	62.4	-	317	621	624	0.9951923
A05	29030622	29031246	A05p28050.2_BraZ1	62.4	-	13	402	624	0.6442308
A05	29037827	29038151	A05p28060.2_BraZ1	32.4	-	7	78	324	0.2407407
A05	29039000	29039324	A05p28070.2_BraZ1	32.4	-	2	30	324	0.0925926
A05	29055804	29056326	A05p28080.2_BraZ1	52.2	+	0	0	522	0.0000000
A05	29059781	29060484	A05p28090.2_BraZ1	32.7	+	0	0	703	0.0000000
A05	29064648	29064871	A05p28100.2_BraZ1	22.2	+	0	0	223	0.0000000
A05	29074738	29074954	A05p28110.2_BraZ1	21.6	+	94	216	216	1.0000000
A05	29120622	29126163	A05p28120.2_BraZ1	152.222	-	2303	4898	5541	0.8839560
A05	29121033	29128623	A05p28130.2_BraZ1	297.917	-	3563	7074	7590	0.9320158
A05	29123347	29123806	A05p28140.2_BraZ1	45.9	-	75	403	459	0.8779957
A05	29227721	29230469	A05p28150.2_BraZ1	1240.71	+	1028	2748	2748	1.0000000
A05	29231476	29232124	A05p28160.2_BraZ1	330	-	312	648	648	1.0000000
A05	29236124	29237090	A05p28170.2_BraZ1	96.6	-	7	204	966	0.2111801
A05	29283006	29283201	A05p28180.2_BraZ1	19.5	+	106	195	195	1.0000000
A05	29298060	29299853	A05p28190.2_BraZ1	1064	+	887	1793	1793	1.0000000
A05	29304480	29305449	A05p28200.2_BraZ1	237	-	34	532	969	0.5490196
A05	29305072	29305393	A05p28210.2_BraZ1	32.1	-	1	28	321	0.0872274
A05	29309973	29310341	A05p28220.2_BraZ1	31.2	+	580	368	368	1.0000000
A05	29315387	29320136	A05p28230.2_BraZ1	990	-	1159	4458	4749	0.9387239
A05	29322502	29323426	A05p28240.2_BraZ1	675	-	515	924	924	1.0000000
A05	29336304	29336857	A05p28250.2_BraZ1	43.8	-	1274	553	553	1.0000000
A05	29336857	29337427	A05p28260.2_BraZ1	501	-	1377	570	570	1.0000000
A05	29338300	29350616	A05p28270.2_BraZ1	369	-	6934	12216	12316	0.9918805
A05	29338669	29392210	A05p28280.2_BraZ1	1071	-	10856	41495	53541	0.7750136
A05	29395889	29396315	A05p28290.2_BraZ1	342	+	339	426	426	1.0000000
A05	29493976	29514150	A05p28300.2_BraZ1	3600	+	4792	19408	20174	0.9620304
A05	29514719	29519439	A05p28310.2_BraZ1	6108.14	-	3128	4720	4720	1.0000000
A05	29567469	29568012	A05p28320.2_BraZ1	54.3	+	464	543	543	1.0000000
A05	29574050	29574201	A05p28330.2_BraZ1	10.8	-	361	151	151	1.0000000
A05	29633886	29634036	A05p28340.2_BraZ1	15	+	57	150	150	1.0000000
A05	29655061	29655229	A05p28350.2_BraZ1	16.8	-	29	168	168	1.0000000
A05	29806543	29806840	A05p28360.2_BraZ1	246	-	131	297	297	1.0000000
A05	29821679	29822084	A05p28370.2_BraZ1	213	-	471	405	405	1.0000000
A05	29825615	29827060	A05p28380.2_BraZ1	2133	+	403	1037	1445	0.7176471
A05	29830182	29831416	A05p28390.2_BraZ1	105.3	+	1681	1234	1234	1.0000000
A05	29892509	29894329	A05p28400.2_BraZ1	80.1	+	62746	1820	1820	1.0000000
A05	29894760	29895625	A05p28410.2_BraZ1	51.6	+	47706	865	865	1.0000000
A05	29922211	29922346	A05p28420.2_BraZ1	13.5	-	910	135	135	1.0000000
A05	29924473	29924737	A05p28430.2_BraZ1	26.4	-	1583	264	264	1.0000000
A05	29954611	29954947	A05p28440.2_BraZ1	270	+	68	330	336	0.9821429
A05	29956831	29958284	A05p28450.2_BraZ1	662.167	+	21	517	1453	0.3558156
A05	29960538	29960745	A05p28460.2_BraZ1	20.7	+	230	194	207	0.9371980
A05	29960751	29962534	A05p28470.2_BraZ1	1104.36	-	161	1130	1783	0.6337633
A05	29969425	29969962	A05p28480.2_BraZ1	279	-	28	366	537	0.6815643
A05	29970611	29975357	A05p28490.2_BraZ1	4151.14	+	1260	4018	4746	0.8466077
A05	29976874	29977529	A05p28500.2_BraZ1	579	-	349	637	655	0.9725191
A05	29978840	29979596	A05p28510.2_BraZ1	75.6	-	122	624	756	0.8253968
A05	29981692	29981922	A05p28520.2_BraZ1	129	-	224	230	230	1.0000000
A05	29981783	29982177	A05p28530.2_BraZ1	249	-	473	394	394	1.0000000
A05	29986570	29989728	A05p28540.2_BraZ1	3075	-	164	1279	3158	0.4050032
A05	30004631	30005942	A05p28550.2_BraZ1	131.1	-	445	1306	1311	0.9961861
A05	30013829	30014786	A05p28560.2_BraZ1	286.222	-	285	957	957	1.0000000
A05	30021829	30023685	A05p28570.2_BraZ1	285.469	-	860	1856	1856	1.0000000
A05	30027800	30028782	A05p28580.2_BraZ1	1715.5	-	140	934	982	0.9511201
A05	30031170	30043147	A05p28590.2_BraZ1	969.735	+	6540	8758	11977	0.7312348
A05	30053916	30055998	A05p28600.2_BraZ1	1319.7	-	245	1573	2082	0.7555236
A05	30057442	30058470	A05p28610.2_BraZ1	306	+	971	1028	1028	1.0000000
A05	30063112	30063435	A05p28620.2_BraZ1	276	+	91	323	323	1.0000000
A05	30067786	30069723	A05p28630.2_BraZ1	1183.97	-	235	756	1937	0.3902943
A05	30086479	30090051	A05p28640.2_BraZ1	1545.75	+	623	2629	3572	0.7360023
A05	30091530	30091797	A05p28650.2_BraZ1	213	+	0	0	267	0.0000000
A05	30094396	30097971	A05p28660.2_BraZ1	726	-	134	1752	3575	0.4900699
A05	30098069	30099351	A05p28670.2_BraZ1	922.5	+	8825	1282	1282	1.0000000
A05	30100651	30100966	A05p28680.2_BraZ1	147	+	7900	315	315	1.0000000
A05	30101335	30101983	A05p28690.2_BraZ1	297	-	4204	648	648	1.0000000
A05	30101983	30103945	A05p28700.2_BraZ1	139.5	-	10785	1962	1962	1.0000000
A05	30128838	30148417	A05p28710.2_BraZ1	162	-	5046	16118	19579	0.8232290
A05	30149921	30150293	A05p28720.2_BraZ1	37.2	+	327	372	372	1.0000000
A05	30155797	30156173	A05p28730.2_BraZ1	248.571	-	782	376	376	1.0000000
A05	30188878	30190936	A05p28740.2_BraZ1	1570.65	+	26	276	2058	0.1341108
A05	30205188	30206304	A05p28750.2_BraZ1	107.47	+	519	1098	1116	0.9838710
A05	30206259	30207190	A05p28760.2_BraZ1	241.455	+	532	864	931	0.9280344
A05	30210118	30210488	A05p28770.2_BraZ1	288	+	64	370	370	1.0000000
A05	30213030	30219603	A05p28780.2_BraZ1	3678.44	+	1336	3494	6573	0.5315685
A05	30226499	30226900	A05p28790.2_BraZ1	160.714	-	7	143	401	0.3566085
A05	30231586	30232888	A05p28800.2_BraZ1	153	+	453	1278	1302	0.9815668
A05	30245333	30260393	A05p28810.2_BraZ1	2284.04	+	11926	9391	15060	0.6235723
A05	30278704	30279198	A05p28820.2_BraZ1	39.3	+	7	184	494	0.3724696
A05	30287536	30287957	A05p28830.2_BraZ1	339	-	262	324	421	0.7695962
A05	30296877	30297435	A05p28840.2_BraZ1	330	+	299	558	558	1.0000000
A05	30298994	30300390	A05p28850.2_BraZ1	514.25	-	1052	1396	1396	1.0000000
A05	30303313	30305839	A05p28860.2_BraZ1	1380	+	112	1081	2526	0.4279493
A05	30306363	30307872	A05p28870.2_BraZ1	8601	-	72	831	1509	0.5506958
A05	30311019	30311406	A05p28880.2_BraZ1	594	+	160	387	387	1.0000000
A05	30311168	30396069	A05p28890.2_BraZ1	135	+	84892	82272	84901	0.9690345
A05	30313190	30314178	A05p28900.2_BraZ1	285.583	-	188	988	988	1.0000000
A05	30315707	30316546	A05p28910.2_BraZ1	1200	-	332	839	839	1.0000000
A05	30327628	30327988	A05p28920.2_BraZ1	36	+	567	360	360	1.0000000
A05	30334383	30334857	A05p28930.2_BraZ1	47.4	+	21	303	474	0.6392405
A05	30358175	30360237	A05p28940.2_BraZ1	821.438	-	714	2036	2062	0.9873909
A05	30368462	30371902	A05p28950.2_BraZ1	1615.18	-	2019	3360	3440	0.9767442
A05	30372499	30372815	A05p28960.2_BraZ1	261	+	11	230	316	0.7278481
A05	30372815	30373651	A05p28970.2_BraZ1	76.5	+	489	836	836	1.0000000
A05	30387349	30388099	A05p28980.2_BraZ1	525	+	738	750	750	1.0000000
A05	30397357	30398571	A05p28990.2_BraZ1	516.375	+	1016	1214	1214	1.0000000
A05	30409010	30409267	A05p29000.2_BraZ1	19.5	-	167	257	257	1.0000000
A05	30434785	30436142	A05p29010.2_BraZ1	5568	+	140	1156	1357	0.8518791
A05	30444434	30445492	A05p29020.2_BraZ1	4257	-	636	1058	1058	1.0000000
A05	30449591	30450758	A05p29030.2_BraZ1	661.143	+	460	1167	1167	1.0000000
A05	30452545	30453877	A05p29040.2_BraZ1	730.179	-	111	969	1332	0.7274775
A05	30460621	30461660	A05p29050.2_BraZ1	441	-	275	1039	1039	1.0000000
A05	30474376	30475123	A05p29060.2_BraZ1	333	+	39	505	747	0.6760375
A05	30497427	30498630	A05p29070.2_BraZ1	70.5	-	43	409	1203	0.3399834
A05	30500590	30502801	A05p29080.2_BraZ1	904.203	-	501	1474	2211	0.6666667
A05	30505047	30505542	A05p29090.2_BraZ1	171	-	341	495	495	1.0000000
A05	30523129	30523417	A05p29100.2_BraZ1	28.8	+	341	288	288	1.0000000
A05	30524696	30525008	A05p29110.2_BraZ1	31.2	+	161	312	312	1.0000000
A05	30530083	30532677	A05p29120.2_BraZ1	1547.29	-	355	1935	2594	0.7459522
A05	30536998	30537896	A05p29130.2_BraZ1	645	+	1007	898	898	1.0000000
A05	30540064	30540229	A05p29140.2_BraZ1	16.5	-	135	165	165	1.0000000
A05	30542426	30553740	A05p29150.2_BraZ1	687	+	6881	7862	11314	0.6948913
A05	30564127	30566578	A05p29160.2_BraZ1	1667.52	-	719	1811	2451	0.7388821
A05	30571140	30571822	A05p29170.2_BraZ1	414	+	65	634	682	0.9296188
A05	30585566	30586538	A05p29180.2_BraZ1	218.25	-	630	972	972	1.0000000
A05	30586594	30594499	A05p29190.2_BraZ1	1817	-	6740	7893	7905	0.9984820
A05	30603637	30615577	A05p29200.2_BraZ1	270	-	13463	11940	11940	1.0000000
A05	30611306	30613314	A05p29210.2_BraZ1	706.909	+	2579	2008	2008	1.0000000
A05	30620487	30621207	A05p29220.2_BraZ1	32.1	+	796	720	720	1.0000000
A05	30624650	30627045	A05p29230.2_BraZ1	1168.32	-	1014	2258	2395	0.9427975
A05	30634993	30635482	A05p29240.2_BraZ1	384	-	506	489	489	1.0000000
A05	30636628	30637795	A05p29250.2_BraZ1	208.286	-	622	1167	1167	1.0000000
A05	30650568	30653949	A05p29260.2_BraZ1	3288	+	544	2638	3381	0.7802425
A05	30654491	30654671	A05p29270.2_BraZ1	18	-	43	180	180	1.0000000
A05	30656079	30661020	A05p29280.2_BraZ1	424.884	+	3007	4314	4941	0.8731026
A05	30661469	30663460	A05p29290.2_BraZ1	762.811	-	191	1385	1991	0.6956303
A05	30670736	30671205	A05p29300.2_BraZ1	258	+	114	469	469	1.0000000
A05	30671329	30672140	A05p29310.2_BraZ1	360	+	388	811	811	1.0000000
A05	30675830	30676981	A05p29320.2_BraZ1	1511.4	+	94	867	1151	0.7532580
A05	30677671	30689123	A05p29330.2_BraZ1	329.6	+	10958	10759	11452	0.9394866
A05	30681646	30682456	A05p29340.2_BraZ1	738	+	691	810	810	1.0000000
A05	30692520	30693302	A05p29350.2_BraZ1	564	-	539	782	782	1.0000000
A05	30703894	30705288	A05p29360.2_BraZ1	558	-	1540	1394	1394	1.0000000
A05	30705293	30705541	A05p29370.2_BraZ1	165	-	295	248	248	1.0000000
A05	30707693	30720739	A05p29380.2_BraZ1	1256.79	+	2033	12888	13046	0.9878890
A05	30723484	30727052	A05p29390.2_BraZ1	336	-	2645	3311	3568	0.9279708
A05	30762096	30763058	A05p29400.2_BraZ1	3456	-	638	962	962	1.0000000
A05	30775410	30775776	A05p29410.2_BraZ1	36.6	-	468	366	366	1.0000000
A05	30778896	30779729	A05p29420.2_BraZ1	285.353	-	1387	833	833	1.0000000
A05	30788946	30791145	A05p29430.2_BraZ1	1327.04	-	315	1281	2199	0.5825375
A05	30813797	30815619	A05p29440.2_BraZ1	658.308	+	276	1261	1822	0.6920966
A05	30816269	30817823	A05p29450.2_BraZ1	1072.53	-	64	464	1554	0.2985843
A05	30824418	30825380	A05p29460.2_BraZ1	894	-	27	300	962	0.3118503
A05	30859447	30860687	A05p29470.2_BraZ1	262.6	+	668	1182	1240	0.9532258
A05	30861182	30863811	A05p29480.2_BraZ1	1556.3	-	35	744	2629	0.2829973
A05	30870507	30872632	A05p29490.2_BraZ1	218.4	+	10	703	2125	0.3308235
A05	30873556	30873853	A05p29500.2_BraZ1	210	-	12	119	297	0.4006734
A05	30891637	30892503	A05p29510.2_BraZ1	1617	+	514	692	866	0.7990762
A05	30894252	30894796	A05p29520.2_BraZ1	294	+	773	544	544	1.0000000
A05	30896993	30897573	A05p29530.2_BraZ1	55.8	-	188	580	580	1.0000000
A05	30936621	30938058	A05p29540.2_BraZ1	143.7	-	7	430	1437	0.2992345
A05	30943394	30949638	A05p29550.2_BraZ1	380.114	-	2047	5411	6244	0.8665919
A05	30951375	30953133	A05p29560.2_BraZ1	5208.75	+	683	1687	1758	0.9596132
A05	30954868	30955276	A05p29570.2_BraZ1	40.8	+	36	384	408	0.9411765
A05	30957960	30959899	A05p29580.2_BraZ1	2386.8	-	705	1939	1939	1.0000000
A05	30959705	30961029	A05p29590.2_BraZ1	231.429	-	634	1312	1324	0.9909366
A05	30961214	30961784	A05p29600.2_BraZ1	315	-	66	486	570	0.8526316
A05	30963037	30964351	A05p29610.2_BraZ1	131.4	+	978	1022	1314	0.7777778
A05	30965517	30967438	A05p29620.2_BraZ1	683.696	-	673	1282	1921	0.6673607
A05	30976184	30977135	A05p29630.2_BraZ1	95.1	-	319	951	951	1.0000000
A05	30985570	30987567	A05p29640.2_BraZ1	39.9	-	9763	1997	1997	1.0000000
A05	30986183	30990879	A05p29650.2_BraZ1	168.9	-	30958	4696	4696	1.0000000
A05	30991045	30991339	A05p29660.2_BraZ1	171	-	3659	294	294	1.0000000
A05	31000467	31002822	A05p29670.2_BraZ1	870	+	1003	2355	2355	1.0000000
A05	31005274	31006681	A05p29680.2_BraZ1	606.273	-	30	487	1407	0.3461265
A05	31015556	31015794	A05p29690.2_BraZ1	16.2	-	139	238	238	1.0000000
A05	31023000	31023698	A05p29700.2_BraZ1	121.875	+	325	698	698	1.0000000
A05	31023533	31025066	A05p29710.2_BraZ1	769.5	+	420	1533	1533	1.0000000
A05	31034527	31035204	A05p29720.2_BraZ1	45.9	-	110	648	677	0.9571639
A05	31054925	31055275	A05p29730.2_BraZ1	20.4	+	2	161	350	0.4600000
A05	31056698	31058285	A05p29740.2_BraZ1	1102.46	+	8	137	1587	0.0863264
A05	31081890	31090169	A05p29750.2_BraZ1	2788.14	+	2982	5349	8279	0.6460925
A05	31093355	31098603	A05p29760.2_BraZ1	1988.84	+	1915	4302	5248	0.8197408
A05	31109623	31110561	A05p29770.2_BraZ1	726	-	709	938	938	1.0000000
A05	31115024	31115129	A05p29780.2_BraZ1	10.5	+	1	61	105	0.5809524
A05	31116454	31116718	A05p29790.2_BraZ1	26.4	-	14	156	264	0.5909091
A05	31118022	31118309	A05p29800.2_BraZ1	14.7	-	12	119	287	0.4146341
A05	31129121	31131562	A05p29810.2_BraZ1	1745.85	+	218	1613	2441	0.6607947
A05	31140042	31140246	A05p29820.2_BraZ1	20.4	+	25	203	204	0.9950981
A05	31154572	31154770	A05p29830.2_BraZ1	19.8	+	75	127	198	0.6414142
A05	31155088	31155325	A05p29840.2_BraZ1	23.7	-	4	19	237	0.0801688
A05	31156824	31157438	A05p29850.2_BraZ1	582	-	428	614	614	1.0000000
A05	31158719	31159688	A05p29860.2_BraZ1	96.9	+	0	0	969	0.0000000
A05	31175293	31176262	A05p29870.2_BraZ1	96.9	+	0	0	969	0.0000000
A05	31191890	31198113	A05p29880.2_BraZ1	993	+	6272	5426	6223	0.8719267
A05	31205801	31207163	A05p29890.2_BraZ1	136.2	+	271	585	1362	0.4295154
A05	31213274	31213683	A05p29900.2_BraZ1	141	+	385	409	409	1.0000000
A05	31219569	31222990	A05p29910.2_BraZ1	1814.17	+	326	2003	3421	0.5855013
A05	31226395	31226731	A05p29920.2_BraZ1	33.6	+	229	336	336	1.0000000
A05	31227377	31230728	A05p29930.2_BraZ1	2342.84	-	763	2750	3351	0.8206506
A05	31235873	31237560	A05p29940.2_BraZ1	390	-	576	1066	1687	0.6318910
A05	31273108	31280763	A05p29950.2_BraZ1	578.957	+	984	5071	7655	0.6624429
A05	31289293	31289739	A05p29960.2_BraZ1	297	+	544	446	446	1.0000000
A05	31296561	31299156	A05p29970.2_BraZ1	987	+	10	548	2595	0.2111753
A05	31308876	31310692	A05p29980.2_BraZ1	3113	+	381	1500	1816	0.8259912
A05	31315745	31317162	A05p29990.2_BraZ1	346.286	+	440	1417	1417	1.0000000
A05	31323594	31323914	A05p30000.2_BraZ1	141	+	52	320	320	1.0000000
A05	31324693	31326197	A05p30010.2_BraZ1	893.69	-	943	1478	1504	0.9827127
A05	31334631	31335207	A05p30020.2_BraZ1	57.6	+	15	204	576	0.3541667
A05	31354126	31355545	A05p30030.2_BraZ1	486	-	727	1419	1419	1.0000000
A05	31402454	31407368	A05p30040.2_BraZ1	90	+	1698	4901	4914	0.9973545
A05	31421862	31423680	A05p30050.2_BraZ1	181.8	+	776	1743	1818	0.9587459
A05	31425931	31426381	A05p30060.2_BraZ1	45	-	247	450	450	1.0000000
A05	31427448	31428798	A05p30070.2_BraZ1	534	+	405	1350	1350	1.0000000
A05	31431997	31433397	A05p30080.2_BraZ1	399.882	-	100	508	1400	0.3628571
A05	31434138	31435804	A05p30090.2_BraZ1	459.2	+	212	1488	1666	0.8931572
A05	31436449	31437447	A05p30100.2_BraZ1	573.913	-	254	946	998	0.9478958
A05	31437806	31437962	A05p30110.2_BraZ1	15.6	-	171	156	156	1.0000000
A05	31442873	31486804	A05p30120.2_BraZ1	389.274	-	36192	37911	43931	0.8629670
A05	31480054	31481538	A05p30130.2_BraZ1	1197	-	455	1426	1484	0.9609165
A05	31512370	31513612	A05p30140.2_BraZ1	333.2	+	668	1239	1242	0.9975845
A05	31514288	31514516	A05p30150.2_BraZ1	12.3	-	64	228	228	1.0000000
A05	31514515	31515451	A05p30160.2_BraZ1	858	-	750	936	936	1.0000000
A05	31516418	31518155	A05p30170.2_BraZ1	1422	+	186	1411	1737	0.8123201
A05	31518749	31525488	A05p30180.2_BraZ1	2220.74	+	1575	4859	6739	0.7210268
A05	31530011	31530768	A05p30190.2_BraZ1	488.78	+	23	556	757	0.7344782
A05	31531021	31531321	A05p30200.2_BraZ1	30	-	21	219	300	0.7300000
A05	31560189	31561150	A05p30210.2_BraZ1	495	+	4011	961	961	1.0000000
A05	31585838	31586163	A05p30220.2_BraZ1	138	-	99	325	325	1.0000000
A05	31595406	31595571	A05p30230.2_BraZ1	16.5	-	115	165	165	1.0000000
A05	31596241	31597406	A05p30240.2_BraZ1	906	-	440	1165	1165	1.0000000
A05	31612864	31613365	A05p30250.2_BraZ1	33	+	660	501	501	1.0000000
A05	31615055	31615392	A05p30260.2_BraZ1	252	-	334	337	337	1.0000000
A05	31615350	31616151	A05p30270.2_BraZ1	249	-	625	801	801	1.0000000
A05	31618059	31622512	A05p30280.2_BraZ1	1864.95	+	277	2600	4453	0.5838760
A05	31622757	31625326	A05p30290.2_BraZ1	1673.45	-	1528	2479	2569	0.9649669
A05	31637552	31638022	A05p30300.2_BraZ1	354	+	764	470	470	1.0000000
A05	31650583	31658304	A05p30310.2_BraZ1	541.2	-	5744	7721	7721	1.0000000
A05	31659093	31660948	A05p30320.2_BraZ1	840	+	856	1674	1855	0.9024259
A05	31668064	31669177	A05p30330.2_BraZ1	111	+	736	1113	1113	1.0000000
A05	31670635	31672613	A05p30340.2_BraZ1	880.52	-	1143	1978	1978	1.0000000
A05	31677560	31678785	A05p30350.2_BraZ1	425	+	1196	1225	1225	1.0000000
A05	31679314	31680501	A05p30360.2_BraZ1	1005	-	1098	1187	1187	1.0000000
A05	31691296	31692922	A05p30370.2_BraZ1	930.909	+	513	1609	1626	0.9895449
A05	31694338	31694596	A05p30380.2_BraZ1	25.8	-	101	227	258	0.8798450
A05	31701000	31703431	A05p30390.2_BraZ1	576	-	1240	2078	2431	0.8547922
A05	31709031	31709613	A05p30400.2_BraZ1	453	-	117	582	582	1.0000000
A05	31711551	31714051	A05p30410.2_BraZ1	1642.53	+	1091	2412	2500	0.9648000
A05	31722972	31726909	A05p30420.2_BraZ1	1543.86	-	360	3169	3937	0.8049276
A05	31755715	31758590	A05p30430.2_BraZ1	247.5	-	178	1941	2875	0.6751304
A05	31756111	31759331	A05p30440.2_BraZ1	333.818	-	187	2231	3220	0.6928571
A05	31764430	31768352	A05p30450.2_BraZ1	2191.26	-	198	2423	3922	0.6177970
A05	31769183	31770073	A05p30460.2_BraZ1	690	-	265	418	890	0.4696629
A05	31772350	31772743	A05p30470.2_BraZ1	39.3	-	83	297	393	0.7557252
A05	31773068	31773964	A05p30480.2_BraZ1	678	-	614	798	896	0.8906250
A05	31819959	31820579	A05p30490.2_BraZ1	330	-	228	609	620	0.9822581
A05	31830221	31830722	A05p30500.2_BraZ1	50.1	-	31	235	501	0.4690619
A05	31834279	31835248	A05p30510.2_BraZ1	405	-	1017	969	969	1.0000000
A05	31836467	31837228	A05p30520.2_BraZ1	4870.5	-	28	362	761	0.4756899
A05	31839316	31839499	A05p30530.2_BraZ1	144	+	48	183	183	1.0000000
A05	31856567	31857338	A05p30540.2_BraZ1	408	+	30	636	771	0.8249027
A05	31871586	31872015	A05p30550.2_BraZ1	297	+	308	429	429	1.0000000
A05	31913946	31918593	A05p30560.2_BraZ1	1013.07	+	2647	4362	4647	0.9386701
A05	31958311	31958488	A05p30570.2_BraZ1	17.7	+	231	177	177	1.0000000
A05	31958644	31960201	A05p30580.2_BraZ1	303	+	3415	1557	1557	1.0000000
A05	31969358	31969640	A05p30590.2_BraZ1	171	+	22	246	282	0.8723404
A05	31973285	31973999	A05p30600.2_BraZ1	186	-	254	714	714	1.0000000
A05	31980439	31981677	A05p30610.2_BraZ1	338.333	+	1122	1238	1238	1.0000000
A05	31982719	31984991	A05p30620.2_BraZ1	1282.91	+	1017	2265	2272	0.9969190
A05	32007382	32007487	A05p30630.2_BraZ1	10.5	-	280	105	105	1.0000000
A05	32010207	32012519	A05p30640.2_BraZ1	1195.67	+	456	1498	2312	0.6479239
A05	32013544	32020163	A05p30650.2_BraZ1	241.92	+	56211	6543	6619	0.9885179
A05	32026378	32029508	A05p30660.2_BraZ1	2826.27	+	277	2383	3130	0.7613419
A05	32043786	32044980	A05p30670.2_BraZ1	119.4	+	210	1106	1194	0.9262981
A05	32047465	32050241	A05p30680.2_BraZ1	1032	-	493	2491	2776	0.8973343
A05	32052526	32056083	A05p30690.2_BraZ1	408	+	2795	3557	3557	1.0000000
A05	32070415	32071823	A05p30700.2_BraZ1	1209	-	219	1061	1408	0.7535511
A05	32077332	32080418	A05p30710.2_BraZ1	815.4	+	1018	2126	3086	0.6889177
A05	32081294	32088103	A05p30720.2_BraZ1	112.5	+	2815	6666	6809	0.9789984
A05	32089475	32090380	A05p30730.2_BraZ1	834	-	226	887	905	0.9801105
A05	32103828	32103948	A05p30740.2_BraZ1	12	+	180	120	120	1.0000000
A05	32106886	32107453	A05p30750.2_BraZ1	399	+	7	423	567	0.7460318
A05	32107386	32109724	A05p30760.2_BraZ1	297	-	618	2259	2338	0.9662104
A05	32113000	32119720	A05p30770.2_BraZ1	852	-	2031	6440	6720	0.9583333
A05	32117481	32117958	A05p30780.2_BraZ1	47.7	-	102	477	477	1.0000000
A05	32121882	32123131	A05p30790.2_BraZ1	317.333	-	1294	1249	1249	1.0000000
A05	32137587	32139035	A05p30800.2_BraZ1	856.154	+	681	1413	1448	0.9758287
A05	32142193	32145003	A05p30810.2_BraZ1	327	+	783	1197	2810	0.4259787
A05	32165614	32166574	A05p30820.2_BraZ1	864	+	587	960	960	1.0000000
A05	32167607	32175422	A05p30830.2_BraZ1	247.95	+	3074	5823	7815	0.7451056
A05	32170349	32170715	A05p30840.2_BraZ1	276	+	21	366	366	1.0000000
A05	32182523	32186499	A05p30850.2_BraZ1	2167.86	+	1074	3823	3976	0.9615191
A05	32187966	32188193	A05p30860.2_BraZ1	13.5	-	228	227	227	1.0000000
A05	32194611	32198418	A05p30870.2_BraZ1	1628.94	+	1850	3807	3807	1.0000000
A05	32198828	32200500	A05p30880.2_BraZ1	1150.88	-	205	1125	1672	0.6728469
A05	32202381	32204825	A05p30890.2_BraZ1	436.596	-	1406	2408	2444	0.9852700
A05	32209239	32210051	A05p30900.2_BraZ1	459	+	256	812	812	1.0000000
A05	32210644	32211044	A05p30910.2_BraZ1	207	-	335	400	400	1.0000000
A05	32212681	32215800	A05p30920.2_BraZ1	2446.96	-	922	2947	3119	0.9448541
A05	32216415	32216664	A05p30930.2_BraZ1	24.9	+	364	249	249	1.0000000
A05	32218814	32219444	A05p30940.2_BraZ1	63	-	704	630	630	1.0000000
A05	32220073	32221897	A05p30950.2_BraZ1	182.4	+	382	1698	1824	0.9309211
A05	32226543	32228488	A05p30960.2_BraZ1	976.889	-	257	1904	1945	0.9789203
A05	32262211	32263848	A05p30970.2_BraZ1	627.714	-	582	1597	1637	0.9755651
A05	32265204	32266194	A05p30980.2_BraZ1	2430	+	331	976	990	0.9858586
A05	32271752	32272657	A05p30990.2_BraZ1	567	-	857	905	905	1.0000000
A05	32272661	32273265	A05p31000.2_BraZ1	410	-	525	604	604	1.0000000
A05	32274502	32275003	A05p31010.2_BraZ1	41.4	+	457	501	501	1.0000000
A05	32279168	32279502	A05p31020.2_BraZ1	135	+	187	334	334	1.0000000
A05	32283547	32285525	A05p31030.2_BraZ1	952.615	-	559	1942	1978	0.9817998
A05	32294972	32297335	A05p31040.2_BraZ1	1620.28	-	562	1874	2363	0.7930596
A05	32297964	32299670	A05p31050.2_BraZ1	717.904	+	772	1651	1706	0.9677609
A05	32304673	32307350	A05p31060.2_BraZ1	1719.79	-	603	2271	2677	0.8483377
A05	32314574	32315468	A05p31070.2_BraZ1	89.4	+	52	426	894	0.4765101
A05	32316462	32316904	A05p31080.2_BraZ1	201	+	129	442	442	1.0000000
A05	32316851	32317592	A05p31090.2_BraZ1	389.25	+	478	741	741	1.0000000
A05	32325731	32327985	A05p31100.2_BraZ1	465	+	1469	2254	2254	1.0000000
A05	32331106	32331555	A05p31110.2_BraZ1	255.557	+	254	426	449	0.9487751
A05	32332063	32333305	A05p31120.2_BraZ1	124.2	+	179	902	1242	0.7262480
A05	32338337	32338812	A05p31130.2_BraZ1	366	+	1625	475	475	1.0000000
A05	32340511	32341768	A05p31140.2_BraZ1	125.7	+	163	1133	1257	0.9013524
A05	32342884	32344664	A05p31150.2_BraZ1	750	+	452	1683	1780	0.9455056
A05	32349852	32350182	A05p31160.2_BraZ1	189	-	401	330	330	1.0000000
A05	32351022	32351253	A05p31170.2_BraZ1	23.1	+	177	231	231	1.0000000
A05	32381085	32381930	A05p31180.2_BraZ1	1323	-	572	845	845	1.0000000
A05	32388539	32390910	A05p31190.2_BraZ1	1926	+	861	2173	2371	0.9164909
A05	32395440	32396477	A05p31200.2_BraZ1	351	+	1055	1037	1037	1.0000000
A05	32403380	32403632	A05p31210.2_BraZ1	25.2	+	1199	252	252	1.0000000
A05	32408704	32410117	A05p31220.2_BraZ1	845.5	+	30	485	1413	0.3432413
A05	32412504	32414368	A05p31230.2_BraZ1	919.714	+	1704	1864	1864	1.0000000
A05	32414712	32418097	A05p31240.2_BraZ1	2516.79	-	1288	3079	3385	0.9096012
A05	32430701	32431143	A05p31250.2_BraZ1	614.25	-	228	442	442	1.0000000
A05	32434888	32436832	A05p31260.2_BraZ1	563.318	-	691	1855	1944	0.9542181
A05	32452242	32452739	A05p31270.2_BraZ1	192	+	938	497	497	1.0000000
A05	32473334	32474218	A05p31280.2_BraZ1	417.391	+	89	564	884	0.6380091
A05	32475500	32476146	A05p31290.2_BraZ1	433.125	-	770	646	646	1.0000000
A05	32484102	32486655	A05p31300.2_BraZ1	255.3	+	575	2274	2553	0.8907168
A05	32486931	32488203	A05p31310.2_BraZ1	127.2	-	6	361	1272	0.2838050
A05	32488792	32489059	A05p31320.2_BraZ1	26.7	+	143	267	267	1.0000000
A05	32491188	32492220	A05p31330.2_BraZ1	103.2	+	45	146	1032	0.1414729
A05	32504963	32505392	A05p31340.2_BraZ1	42.9	+	158	429	429	1.0000000
A05	32505965	32508138	A05p31350.2_BraZ1	1075.84	-	2615	2166	2173	0.9967787
A05	32508713	32511752	A05p31360.2_BraZ1	303.9	+	344	1230	3039	0.4047384
A05	32534541	32534925	A05p31370.2_BraZ1	38.4	+	47	384	384	1.0000000
A05	32543275	32544521	A05p31380.2_BraZ1	1083.56	-	208	1030	1246	0.8266453
A05	32554488	32554842	A05p31390.2_BraZ1	35.4	-	0	0	354	0.0000000
A05	32556588	32557146	A05p31400.2_BraZ1	363	+	78	539	558	0.9659498
A05	32557855	32559897	A05p31410.2_BraZ1	679.25	-	174	1606	2042	0.7864838
A05	32572992	32573997	A05p31420.2_BraZ1	100.5	-	139	911	1005	0.9064677
A05	32578690	32579145	A05p31430.2_BraZ1	339	+	77	399	455	0.8769231
A05	32583966	32589967	A05p31440.2_BraZ1	231	+	14471	5666	6001	0.9441760
A05	32594344	32594650	A05p31450.2_BraZ1	30.6	-	262	306	306	1.0000000
A05	32610053	32613101	A05p31460.2_BraZ1	304.8	+	510	2909	3048	0.9543963
A05	32614236	32616294	A05p31470.2_BraZ1	1273.85	-	334	1418	2058	0.6890185
A05	32637424	32637667	A05p31480.2_BraZ1	24.3	-	10	243	243	1.0000000
A05	32649121	32650088	A05p31490.2_BraZ1	2720	-	204	954	967	0.9865564
A05	32650939	32653613	A05p31500.2_BraZ1	238	-	1071	2434	2674	0.9102468
A05	32662255	32664717	A05p31510.2_BraZ1	775.2	-	103	919	2462	0.3732738
A05	32667084	32668049	A05p31520.2_BraZ1	537	-	306	965	965	1.0000000
A05	32679430	32680477	A05p31530.2_BraZ1	76.5	-	573	744	1047	0.7106017
A05	32680540	32681491	A05p31540.2_BraZ1	95.1	-	789	951	951	1.0000000
A05	32702141	32702650	A05p31550.2_BraZ1	231	+	546	509	509	1.0000000
A05	32707192	32708353	A05p31560.2_BraZ1	116.1	+	174	1142	1161	0.9836348
A05	32708920	32710187	A05p31570.2_BraZ1	654	-	721	1248	1267	0.9850039
A05	32730410	32732050	A05p31580.2_BraZ1	880	+	244	1209	1640	0.7371951
A05	32738745	32739351	A05p31590.2_BraZ1	228	-	222	606	606	1.0000000
A05	32745285	32746431	A05p31600.2_BraZ1	525.333	+	488	954	1146	0.8324608
A05	32752455	32754371	A05p31610.2_BraZ1	1218	-	181	730	1916	0.3810021
A05	32766606	32768052	A05p31620.2_BraZ1	144.6	+	453	834	1446	0.5767635
A05	32768882	32769221	A05p31630.2_BraZ1	33.9	-	152	336	339	0.9911504
A05	32775363	32777462	A05p31640.2_BraZ1	777	-	129	1121	2099	0.5340638
A05	32790954	32796214	A05p31650.2_BraZ1	5399.17	+	788	4078	5260	0.7752852
A05	32803811	32804470	A05p31660.2_BraZ1	255	-	500	659	659	1.0000000
A05	32804660	32807451	A05p31670.2_BraZ1	1966.55	-	1641	2779	2791	0.9957005
A05	32812991	32815598	A05p31680.2_BraZ1	1379.36	-	1119	2347	2607	0.9002685
A05	32819381	32819651	A05p31690.2_BraZ1	27	-	172	270	270	1.0000000
A05	32838593	32844768	A05p31700.2_BraZ1	1284.33	+	2281	5967	6175	0.9663158
A05	32853923	32856455	A05p31710.2_BraZ1	253.2	+	706	2225	2532	0.8787520
A05	32856537	32857125	A05p31720.2_BraZ1	58.8	-	295	588	588	1.0000000
A05	32857572	32857677	A05p31730.2_BraZ1	10.5	+	124	105	105	1.0000000
A05	32857806	32858691	A05p31740.2_BraZ1	88.5	+	105	740	885	0.8361582
A05	32859882	32861169	A05p31750.2_BraZ1	1373.4	+	830	1222	1287	0.9494950
A05	32861365	32862175	A05p31760.2_BraZ1	2511.75	-	205	792	810	0.9777778
A05	32863120	32863818	A05p31770.2_BraZ1	511.77	+	278	698	698	1.0000000
A05	32864687	32866112	A05p31780.2_BraZ1	1236	-	516	1279	1425	0.8975438
A05	32866678	32867116	A05p31790.2_BraZ1	144	+	52	438	438	1.0000000
A05	32868191	32868734	A05p31800.2_BraZ1	54.3	+	184	447	543	0.8232044
A05	32877981	32878546	A05p31810.2_BraZ1	297	+	20	240	565	0.4247788
A05	32885981	32887622	A05p31820.2_BraZ1	450.417	+	935	1641	1641	1.0000000
A05	32892315	32893245	A05p31830.2_BraZ1	807	+	261	869	930	0.9344086
A05	32933344	32933591	A05p31840.2_BraZ1	228	+	305	247	247	1.0000000
A05	32938342	32938669	A05p31850.2_BraZ1	32.7	+	102	311	327	0.9510703
A05	32947861	32948862	A05p31860.2_BraZ1	1143	-	510	1001	1001	1.0000000
A05	32949781	32950108	A05p31870.2_BraZ1	32.7	+	319	327	327	1.0000000
A05	32952878	32953205	A05p31880.2_BraZ1	32.7	+	423	327	327	1.0000000
A05	32955795	32956438	A05p31890.2_BraZ1	58.8	+	488	643	643	1.0000000
A05	32957241	32959586	A05p31900.2_BraZ1	1722.83	-	1298	2286	2345	0.9748401
A05	32961856	32962402	A05p31910.2_BraZ1	1161	-	464	546	546	1.0000000
A05	32963034	32963988	A05p31920.2_BraZ1	714.365	+	375	940	954	0.9853249
A05	32964258	32964708	A05p31930.2_BraZ1	45	-	406	450	450	1.0000000
A05	32970197	32977333	A05p31940.2_BraZ1	585	-	1316	4770	7136	0.6684417
A05	32979904	32982034	A05p31950.2_BraZ1	492	-	1195	2096	2130	0.9840376
A05	32985141	32988819	A05p31960.2_BraZ1	1530	-	816	3000	3678	0.8156607
A05	32995112	32996827	A05p31970.2_BraZ1	816.333	-	1969	1715	1715	1.0000000
A05	32997379	32997598	A05p31980.2_BraZ1	21.9	+	1194	219	219	1.0000000
A05	32997725	32997929	A05p31990.2_BraZ1	20.4	+	688	204	204	1.0000000
A05	33002524	33003917	A05p32000.2_BraZ1	629	-	139	23	1393	0.0165111
A05	33007351	33010065	A05p32010.2_BraZ1	1308.19	-	1722	2608	2714	0.9609433
A05	33012596	33013218	A05p32020.2_BraZ1	360	-	1090	622	622	1.0000000
A05	33020966	33022039	A05p32030.2_BraZ1	12903	+	148	1073	1073	1.0000000
A05	33027322	33032507	A05p32040.2_BraZ1	189	-	4710	5151	5185	0.9934426
A05	33041529	33044890	A05p32050.2_BraZ1	1281.43	+	1058	2608	3361	0.7759596
A05	33055441	33056499	A05p32060.2_BraZ1	184.167	+	2	108	1058	0.1020794
A05	33056627	33058720	A05p32070.2_BraZ1	670.5	+	0	0	2093	0.0000000
A05	33060161	33065908	A05p32080.2_BraZ1	2495.66	-	1197	5364	5747	0.9333565
A05	33084504	33084773	A05p32090.2_BraZ1	207	-	363	269	269	1.0000000
A05	33102334	33102971	A05p32100.2_BraZ1	197.077	-	517	637	637	1.0000000
A05	33112466	33118250	A05p32110.2_BraZ1	3886.23	-	986	4677	5784	0.8086100
A05	33127635	33129300	A05p32120.2_BraZ1	1117.09	-	564	1581	1665	0.9495496
A05	33131466	33132395	A05p32130.2_BraZ1	621	+	447	929	929	1.0000000
A05	33132922	33135241	A05p32140.2_BraZ1	1809	-	1560	2319	2319	1.0000000
A05	33136194	33136975	A05p32150.2_BraZ1	720	-	480	706	781	0.9039693
A05	33137740	33140202	A05p32160.2_BraZ1	1020.6	-	2367	2462	2462	1.0000000
A05	33144136	33144855	A05p32170.2_BraZ1	591.429	-	70	203	719	0.2823366
A05	33149192	33149741	A05p32180.2_BraZ1	37.2	+	72	473	549	0.8615665
A05	33150816	33153953	A05p32190.2_BraZ1	2287.26	-	1114	2710	3137	0.8638827
A05	33159355	33159893	A05p32200.2_BraZ1	450	-	212	341	538	0.6338290
A05	33164877	33165203	A05p32210.2_BraZ1	255	-	288	326	326	1.0000000
A05	33168370	33173492	A05p32220.2_BraZ1	1270.37	-	2665	4686	5122	0.9148770
A05	33179515	33179923	A05p32230.2_BraZ1	40.8	+	36	237	408	0.5808824
A05	33181355	33184191	A05p32240.2_BraZ1	747	+	12	156	2836	0.0550071
A05	33186234	33186568	A05p32250.2_BraZ1	135	-	214	334	334	1.0000000
A05	33186855	33187163	A05p32260.2_BraZ1	141	-	3	159	308	0.5162337
A05	33194027	33202046	A05p32270.2_BraZ1	1548.25	+	437	2461	8019	0.3068961
A05	33204230	33204564	A05p32280.2_BraZ1	135	-	33	334	334	1.0000000
A05	33204859	33205167	A05p32290.2_BraZ1	141	-	2	145	308	0.4707792
A05	33212036	33214895	A05p32300.2_BraZ1	2700	+	63	652	2859	0.2280518
A05	33221189	33222515	A05p32310.2_BraZ1	593.25	-	168	493	1326	0.3717949
A05	33226380	33236358	A05p32320.2_BraZ1	1931.09	+	2120	7185	9978	0.7200842
A05	33236879	33237193	A05p32330.2_BraZ1	216	+	49	314	314	1.0000000
A05	33237749	33245605	A05p32340.2_BraZ1	1463.27	-	5873	7749	7856	0.9863799
A05	33252298	33253836	A05p32350.2_BraZ1	441.102	-	473	1538	1538	1.0000000
A05	33257477	33259194	A05p32360.2_BraZ1	1263.32	+	1162	1700	1717	0.9900990
A05	33268086	33271544	A05p32370.2_BraZ1	1196.33	-	2463	3418	3458	0.9884326
A05	33274846	33278801	A05p32380.2_BraZ1	273	-	1856	3883	3955	0.9817952
A05	33280251	33282215	A05p32390.2_BraZ1	919.341	+	999	1903	1964	0.9689409
A05	33284321	33287390	A05p32400.2_BraZ1	2137.54	+	305	1722	3069	0.5610948
A05	33294050	33296159	A05p32410.2_BraZ1	767.25	+	2363	2109	2109	1.0000000
A05	33307652	33308237	A05p32420.2_BraZ1	58.5	+	29	104	585	0.1777778
A05	33316946	33319415	A05p32430.2_BraZ1	246.9	-	34	295	2469	0.1194816
A05	33321900	33323164	A05p32440.2_BraZ1	66.3	+	51	860	1264	0.6803797
A05	33323534	33325691	A05p32450.2_BraZ1	43.8	+	290	1674	2157	0.7760779
A05	33325772	33326139	A05p32460.2_BraZ1	216	-	1	104	367	0.2833788
A05	33327052	33330512	A05p32470.2_BraZ1	229.2	-	951	3313	3460	0.9575145
A05	33331011	33331518	A05p32480.2_BraZ1	36.3	-	3	128	507	0.2524655
A05	33331470	33337164	A05p32490.2_BraZ1	314.4	-	541	2917	5694	0.5122936
A05	33355121	33355889	A05p32500.2_BraZ1	75.3	-	551	768	768	1.0000000
A05	33380283	33381513	A05p32510.2_BraZ1	631.8	+	819	1230	1230	1.0000000
A05	33383577	33383956	A05p32520.2_BraZ1	297	-	0	0	379	0.0000000
A05	33387143	33387706	A05p32530.2_BraZ1	1551	+	485	563	563	1.0000000
A05	33388300	33388634	A05p32540.2_BraZ1	135	+	208	334	334	1.0000000
A05	33392066	33392452	A05p32550.2_BraZ1	300	+	279	386	386	1.0000000
A05	33395521	33397903	A05p32560.2_BraZ1	1257.5	-	785	2182	2382	0.9160370
A05	33401711	33402533	A05p32570.2_BraZ1	82.2	+	1008	822	822	1.0000000
A05	33402753	33403214	A05p32580.2_BraZ1	4422	-	267	435	461	0.9436009
A05	33403636	33404922	A05p32590.2_BraZ1	933	-	1814	1286	1286	1.0000000
A05	33413545	33413755	A05p32600.2_BraZ1	21	+	0	0	210	0.0000000
A05	33418037	33419247	A05p32610.2_BraZ1	7680	-	564	1210	1210	1.0000000
A05	33425459	33426376	A05p32620.2_BraZ1	774	-	148	758	917	0.8266085
A05	33431744	33432047	A05p32630.2_BraZ1	30.3	+	233	303	303	1.0000000
A05	33432938	33433071	A05p32640.2_BraZ1	12.6	+	0	0	133	0.0000000
A05	33436079	33437965	A05p32650.2_BraZ1	851	+	2	163	1886	0.0864263
A05	33449184	33450078	A05p32660.2_BraZ1	306	-	913	850	894	0.9507830
A05	33457216	33458574	A05p32670.2_BraZ1	297	+	382	1319	1358	0.9712813
A05	33458559	33458836	A05p32680.2_BraZ1	258.643	+	263	277	277	1.0000000
A05	33460035	33460987	A05p32690.2_BraZ1	789	-	68	808	952	0.8487395
A05	33477078	33477975	A05p32700.2_BraZ1	1117.4	+	76	849	897	0.9464883
A05	33482646	33483545	A05p32710.2_BraZ1	786	-	220	767	899	0.8531702
A05	33490883	33491069	A05p32720.2_BraZ1	18.6	-	0	0	186	0.0000000
A05	33496315	33496501	A05p32730.2_BraZ1	18.6	-	16	136	186	0.7311828
A05	33499690	33500095	A05p32740.2_BraZ1	40.5	-	313	405	405	1.0000000
A05	33500353	33500545	A05p32750.2_BraZ1	19.2	-	163	192	192	1.0000000
A05	33500696	33502508	A05p32760.2_BraZ1	180.9	-	784	1786	1812	0.9856512
A05	33503277	33504210	A05p32770.2_BraZ1	762	-	47	509	933	0.5455520
A05	33519691	33520642	A05p32780.2_BraZ1	765	-	70	559	951	0.5878023
A05	33533226	33534108	A05p32790.2_BraZ1	633	+	89	548	882	0.6213152
A05	33534681	33536624	A05p32800.2_BraZ1	733.371	+	1707	1943	1943	1.0000000
A05	33537335	33539950	A05p32810.2_BraZ1	1132.23	+	2271	2612	2615	0.9988528
A05	33545419	33545957	A05p32820.2_BraZ1	166.737	-	364	538	538	1.0000000
A05	33553882	33554113	A05p32830.2_BraZ1	23.1	+	289	231	231	1.0000000
A05	33566725	33573788	A05p32840.2_BraZ1	649.5	+	2146	5596	7063	0.7922979
A05	33574187	33575637	A05p32850.2_BraZ1	932.381	-	164	930	1450	0.6413793
A05	33587308	33588772	A05p32860.2_BraZ1	146.4	-	163	796	1464	0.5437158
A05	33610507	33611591	A05p32870.2_BraZ1	533.95	+	6	298	1084	0.2749077
A05	33612465	33613986	A05p32880.2_BraZ1	152.1	-	246	1342	1521	0.8823143
A05	33616228	33617292	A05p32890.2_BraZ1	996	+	345	997	1064	0.9370301
A05	33617722	33619162	A05p32900.2_BraZ1	144	-	504	1172	1440	0.8138889
A05	33620589	33622026	A05p32910.2_BraZ1	143.7	-	306	969	1437	0.6743215
A05	33623296	33623956	A05p32920.2_BraZ1	63	-	326	640	660	0.9696970
A05	33632976	33636197	A05p32930.2_BraZ1	1641.62	+	293	1862	3221	0.5780814
A05	33643780	33644008	A05p32940.2_BraZ1	22.8	-	128	228	228	1.0000000
A05	33644226	33645033	A05p32950.2_BraZ1	453	-	389	807	807	1.0000000
A05	33647936	33648518	A05p32960.2_BraZ1	58.2	-	21	182	582	0.3127148
A05	33651299	33652434	A05p32970.2_BraZ1	624	-	121	766	1135	0.6748899
A05	33654113	33655778	A05p32980.2_BraZ1	774.9	-	145	1150	1665	0.6906907
A05	33670775	33675511	A05p32990.2_BraZ1	406.35	-	2345	4527	4736	0.9558699
A05	33678098	33684425	A05p33000.2_BraZ1	1463.23	-	2554	5230	6327	0.8266161
A05	33697168	33697297	A05p33010.2_BraZ1	12.3	-	117	73	129	0.5658914
A05	33702733	33703650	A05p33020.2_BraZ1	300	-	1086	917	917	1.0000000
A05	33703677	33707472	A05p33030.2_BraZ1	316	+	2514	3716	3795	0.9791831
A05	33715815	33718055	A05p33040.2_BraZ1	954.75	+	253	1727	2240	0.7709821
A05	33727824	33729434	A05p33050.2_BraZ1	1530	+	240	1476	1610	0.9167702
A05	33735012	33738016	A05p33060.2_BraZ1	1496.87	+	1039	2627	3004	0.8745007
A05	33739293	33740688	A05p33070.2_BraZ1	500.786	+	691	1395	1395	1.0000000
A05	33742287	33744408	A05p33080.2_BraZ1	1143	+	739	1994	2121	0.9401226
A05	33769511	33770574	A05p33090.2_BraZ1	930	-	291	749	1063	0.7046096
A05	33772139	33773633	A05p33100.2_BraZ1	149.4	-	26	475	1494	0.3179384
A05	33780320	33780878	A05p33110.2_BraZ1	55.8	+	47	500	558	0.8960574
A05	33787607	33791749	A05p33120.2_BraZ1	1275.75	+	556	3371	4142	0.8138580
A05	33796881	33797496	A05p33130.2_BraZ1	61.5	-	7	165	615	0.2682927
A05	33801130	33801706	A05p33140.2_BraZ1	510	-	773	576	576	1.0000000
A05	33806352	33810318	A05p33150.2_BraZ1	2768.45	-	1277	3748	3966	0.9450328
A05	33811266	33812811	A05p33160.2_BraZ1	154.5	-	596	1421	1545	0.9197411
A05	33817019	33818754	A05p33170.2_BraZ1	1500.88	+	661	1649	1735	0.9504323
A05	33819257	33821461	A05p33180.2_BraZ1	1082.25	-	1369	2184	2204	0.9909256
A05	33823433	33830959	A05p33190.2_BraZ1	2908.64	+	1332	4480	7526	0.5952697
A05	33833580	33835278	A05p33200.2_BraZ1	970.667	-	86	1057	1698	0.6224971
A05	33844374	33845363	A05p33210.2_BraZ1	51.3	-	495	989	989	1.0000000
A05	33849764	33849985	A05p33220.2_BraZ1	17.1	+	414	221	221	1.0000000
A05	33865387	33866565	A05p33230.2_BraZ1	4972.5	+	1186	1178	1178	1.0000000
A05	33866755	33867886	A05p33240.2_BraZ1	953.804	-	550	1099	1131	0.9717064
A05	33877506	33877822	A05p33250.2_BraZ1	225	-	48	162	316	0.5126582
A05	33878293	33879566	A05p33260.2_BraZ1	720	-	778	1239	1273	0.9732915
A05	33881667	33882467	A05p33270.2_BraZ1	693	+	300	675	800	0.8437500
A05	33885805	33886510	A05p33280.2_BraZ1	495	+	54	542	705	0.7687943
A05	33914362	33914681	A05p33290.2_BraZ1	135	-	0	0	319	0.0000000
A05	33919126	33920125	A05p33300.2_BraZ1	99.9	-	112	671	999	0.6716717
A05	33933099	33935201	A05p33310.2_BraZ1	1406.43	+	697	1899	2102	0.9034253
A05	33935651	33936886	A05p33320.2_BraZ1	12033	-	131	772	1235	0.6251012
A05	33940725	33943398	A05p33330.2_BraZ1	1578.67	+	1422	2551	2673	0.9543584
A05	33943685	33943910	A05p33340.2_BraZ1	22.5	-	340	225	225	1.0000000
A05	33944763	33947149	A05p33350.2_BraZ1	1690.31	-	1456	2374	2386	0.9949707
A05	33950369	33956237	A05p33360.2_BraZ1	2901.82	-	1625	3932	5868	0.6700750
A05	33967593	33968178	A05p33370.2_BraZ1	58.5	-	181	585	585	1.0000000
A05	33975871	33982679	A05p33380.2_BraZ1	588	-	1848	6501	6808	0.9549060
A05	33986730	33987054	A05p33390.2_BraZ1	25.5	-	266	324	324	1.0000000
A05	33990463	33992240	A05p33400.2_BraZ1	1466.67	+	4	36	1777	0.0202589
A05	34015295	34016884	A05p33410.2_BraZ1	643.903	+	36	538	1589	0.3385777
A05	34018649	34018862	A05p33420.2_BraZ1	105	+	530	213	213	1.0000000
A05	34024786	34030411	A05p33430.2_BraZ1	3515.63	+	1302	3804	5625	0.6762667
A05	34030479	34036919	A05p33440.2_BraZ1	345	-	3839	6339	6440	0.9843168
A05	34037462	34040306	A05p33450.2_BraZ1	1817	+	762	2418	2844	0.8502110
A05	34052126	34052285	A05p33460.2_BraZ1	15.9	+	293	159	159	1.0000000
A05	34052842	34053091	A05p33470.2_BraZ1	24.9	-	699	249	249	1.0000000
A05	34059132	34069810	A05p33480.2_BraZ1	1512	+	2897	6792	10678	0.6360742
A05	34087055	34098922	A05p33490.2_BraZ1	1567.57	+	2334	7896	11867	0.6653746
A05	34100155	34105466	A05p33500.2_BraZ1	1695	+	4350	5283	5311	0.9947279
A05	34101620	34102028	A05p33510.2_BraZ1	40.8	+	166	408	408	1.0000000
A05	34108641	34110254	A05p33520.2_BraZ1	890.591	-	1231	1499	1613	0.9293243
A05	34111747	34112866	A05p33530.2_BraZ1	234	+	452	1101	1119	0.9839142
A05	34114346	34116407	A05p33540.2_BraZ1	1165.17	+	347	1761	2061	0.8544396
A05	34117022	34125263	A05p33550.2_BraZ1	3402.97	-	2216	7442	8241	0.9030458
A05	34134398	34135470	A05p33560.2_BraZ1	876	+	110	1016	1072	0.9477612
A05	34136888	34137517	A05p33570.2_BraZ1	204	+	109	629	629	1.0000000
A05	34138683	34142244	A05p33580.2_BraZ1	1614.52	+	1453	3317	3561	0.9314799
A05	34143323	34143659	A05p33590.2_BraZ1	33.6	+	127	336	336	1.0000000
A05	34144778	34145444	A05p33600.2_BraZ1	66.6	+	134	525	666	0.7882883
A05	34158740	34161170	A05p33610.2_BraZ1	1098.9	+	471	2199	2430	0.9049383
A05	34163927	34164691	A05p33620.2_BraZ1	606.789	+	383	764	764	1.0000000
A05	34165786	34166814	A05p33630.2_BraZ1	942	-	903	1015	1028	0.9873541
A05	34173389	34174541	A05p33640.2_BraZ1	115.2	-	1667	1152	1152	1.0000000
A05	34178986	34180639	A05p33650.2_BraZ1	55.8	-	895	762	1653	0.4609800
A05	34180633	34181074	A05p33660.2_BraZ1	426	-	473	441	441	1.0000000
A05	34183847	34186405	A05p33670.2_BraZ1	1379.56	-	919	2434	2558	0.9515246
A05	34201836	34202647	A05p33680.2_BraZ1	264	+	118	811	811	1.0000000
A05	34204579	34207879	A05p33690.2_BraZ1	69.9	-	758	3117	3300	0.9445454
A05	34205535	34209479	A05p33700.2_BraZ1	99.9	-	917	3915	3944	0.9926471
A05	34209974	34212279	A05p33710.2_BraZ1	42	-	1123	2150	2305	0.9327549
A05	34210490	34215820	A05p33720.2_BraZ1	173.1	-	1300	5145	5330	0.9652908
A05	34217691	34221374	A05p33730.2_BraZ1	1995.12	+	530	2844	3683	0.7721966
A05	34227940	34231011	A05p33740.2_BraZ1	1439.1	+	1384	3019	3071	0.9830674
A05	34234527	34234842	A05p33750.2_BraZ1	31.5	+	146	308	315	0.9777778
A05	34235069	34236314	A05p33760.2_BraZ1	124.5	-	59	692	1245	0.5558233
A05	34237330	34238578	A05p33770.2_BraZ1	1200	-	835	1248	1248	1.0000000
A05	34242596	34247546	A05p33780.2_BraZ1	1074.67	-	2521	4779	4950	0.9654545
A05	34251748	34252213	A05p33790.2_BraZ1	297	-	20	465	465	1.0000000
A05	34259623	34261063	A05p33800.2_BraZ1	10575	-	1032	1376	1440	0.9555556
A05	34261336	34263282	A05p33810.2_BraZ1	1036.85	-	1858	1946	1946	1.0000000
A05	34263815	34265510	A05p33820.2_BraZ1	1079.5	+	615	1654	1695	0.9758112
A05	34265823	34267270	A05p33830.2_BraZ1	723.24	-	462	1064	1447	0.7353144
A05	34270968	34271391	A05p33840.2_BraZ1	42.3	-	8	206	423	0.4869976
A05	34277107	34277941	A05p33850.2_BraZ1	83.4	-	421	834	834	1.0000000
A05	34283173	34285333	A05p33860.2_BraZ1	13455	+	617	1480	2160	0.6851852
A05	34301855	34304508	A05p33870.2_BraZ1	736.364	+	656	2107	2653	0.7941952
A05	34304969	34305164	A05p33880.2_BraZ1	19.5	+	7	109	195	0.5589744
A05	34305436	34307783	A05p33890.2_BraZ1	1196.91	-	656	1909	2347	0.8133788
A05	34314495	34314738	A05p33900.2_BraZ1	24.3	-	17	149	243	0.6131687
A05	34315816	34318435	A05p33910.2_BraZ1	1636.24	-	147	1505	2619	0.5746468
A05	34328361	34330894	A05p33920.2_BraZ1	349.263	-	382	2476	2533	0.9774970
A05	34331599	34333955	A05p33930.2_BraZ1	887.526	-	183	2037	2356	0.8646010
A05	34355224	34357170	A05p33940.2_BraZ1	198	-	560	1946	1946	1.0000000
A05	34367262	34367436	A05p33950.2_BraZ1	17.4	+	480	174	174	1.0000000
A05	34381411	34382731	A05p33960.2_BraZ1	132	+	247	1291	1320	0.9780303
A05	34390717	34391893	A05p33970.2_BraZ1	117.6	-	33	581	1176	0.4940476
A05	34394166	34396119	A05p33980.2_BraZ1	858.796	-	1126	1823	1953	0.9334357
A05	34418463	34420420	A05p33990.2_BraZ1	925.57	+	603	1883	1957	0.9621870
A05	34420803	34423179	A05p34000.2_BraZ1	252.061	-	1367	2123	2376	0.8935185
A05	34423523	34427852	A05p34010.2_BraZ1	1854.4	+	2488	3957	4329	0.9140679
A05	34429240	34437738	A05p34020.2_BraZ1	2016	+	2111	6584	8498	0.7747706
A05	34431692	34432060	A05p34030.2_BraZ1	30	+	15	254	368	0.6902174
A05	34444378	34446869	A05p34040.2_BraZ1	829.5	+	2678	2491	2491	1.0000000
A05	34446932	34447735	A05p34050.2_BraZ1	276	+	952	803	803	1.0000000
A05	34469188	34472246	A05p34060.2_BraZ1	520	+	489	1983	3058	0.6484631
A05	34476786	34479407	A05p34070.2_BraZ1	939.8	+	2231	2621	2621	1.0000000
A05	34479688	34482525	A05p34080.2_BraZ1	8463	-	1697	2759	2837	0.9725062
A05	34486350	34487663	A05p34090.2_BraZ1	495.545	+	806	1313	1313	1.0000000
A05	34488049	34493090	A05p34100.2_BraZ1	991.237	-	2997	5041	5041	1.0000000
A05	34498123	34499230	A05p34110.2_BraZ1	110.7	+	1145	1107	1107	1.0000000
A05	34499820	34500306	A05p34120.2_BraZ1	402	-	192	486	486	1.0000000
A05	34501279	34510617	A05p34130.2_BraZ1	1563	+	8814	8811	9338	0.9435639
A05	34503456	34504098	A05p34140.2_BraZ1	64.2	+	534	642	642	1.0000000
A05	34518783	34522133	A05p34150.2_BraZ1	314.167	-	732	3103	3350	0.9262686
A05	34533107	34535544	A05p34160.2_BraZ1	972.908	+	874	2350	2437	0.9643004
A05	34553663	34556207	A05p34170.2_BraZ1	1318.63	+	258	1725	2544	0.6780660
A05	34559481	34559847	A05p34180.2_BraZ1	36.6	+	0	0	366	0.0000000
A05	34561063	34566147	A05p34190.2_BraZ1	2258.31	+	659	3748	5084	0.7372148
A05	34569334	34571008	A05p34200.2_BraZ1	1664	+	268	1619	1674	0.9671445
A05	34573434	34574658	A05p34210.2_BraZ1	122.4	+	0	0	1224	0.0000000
A05	34588816	34590034	A05p34220.2_BraZ1	121.8	+	11	360	1218	0.2955665
A05	34594424	34596177	A05p34230.2_BraZ1	9768	+	38	1228	1753	0.7005134
A05	34597913	34598321	A05p34240.2_BraZ1	38.1	+	3	137	408	0.3357843
A05	34601031	34606336	A05p34250.2_BraZ1	1329.39	-	1273	3157	5305	0.5950990
A05	34612266	34614246	A05p34260.2_BraZ1	961.875	+	1514	1980	1980	1.0000000
A05	34614723	34615413	A05p34270.2_BraZ1	618	+	907	690	690	1.0000000
A05	34615689	34619536	A05p34280.2_BraZ1	1420.71	-	4270	3845	3847	0.9994801
A05	34621032	34621697	A05p34290.2_BraZ1	393	-	34	444	665	0.6676692
A05	34623448	34623849	A05p34300.2_BraZ1	209.864	+	462	401	401	1.0000000
A05	34624043	34624664	A05p34310.2_BraZ1	534	-	126	588	621	0.9468599
A05	34625911	34630304	A05p34320.2_BraZ1	2848.16	-	2582	4162	4393	0.9474164
A05	34633022	34639789	A05p34330.2_BraZ1	2614.84	-	2414	5740	6767	0.8482341
A05	34642407	34645606	A05p34340.2_BraZ1	1182.75	+	693	2817	3199	0.8805877
A05	34651338	34652732	A05p34350.2_BraZ1	327	+	851	1066	1394	0.7647059
A05	34660263	34670248	A05p34360.2_BraZ1	2735.79	-	1425	7208	9985	0.7218828
A05	34680929	34681505	A05p34370.2_BraZ1	57.6	+	210	451	576	0.7829861
A05	34688053	34692269	A05p34380.2_BraZ1	1233.27	-	180	2460	4216	0.5834914
A05	34695246	34696077	A05p34390.2_BraZ1	83.1	-	35	96	831	0.1155235
A05	34707155	34712205	A05p34400.2_BraZ1	1261.11	-	2410	4899	5050	0.9700990
A05	34713978	34717662	A05p34410.2_BraZ1	414	+	3552	3645	3684	0.9894137
A05	34719801	34725430	A05p34420.2_BraZ1	2414.48	+	3623	5542	5629	0.9845443
A05	34725884	34727503	A05p34430.2_BraZ1	792.833	-	464	1212	1619	0.7486103
A05	34728910	34729117	A05p34440.2_BraZ1	186	+	298	207	207	1.0000000
A05	34737833	34739442	A05p34450.2_BraZ1	1020.57	+	483	1607	1609	0.9987570
A05	34744834	34746944	A05p34460.2_BraZ1	619.75	+	730	1895	2110	0.8981043
A05	34747319	34749067	A05p34470.2_BraZ1	560.7	+	1526	1748	1748	1.0000000
A05	34755487	34755655	A05p34480.2_BraZ1	16.8	+	294	168	168	1.0000000
A05	34755684	34756096	A05p34490.2_BraZ1	300	+	61	261	412	0.6334952
A05	34758490	34762109	A05p34500.2_BraZ1	192	-	267	2893	3619	0.7993921
A05	34762272	34770055	A05p34510.2_BraZ1	223.5	-	1207	6936	7783	0.8911731
A05	34770110	34770484	A05p34520.2_BraZ1	309	-	76	373	374	0.9973262
A05	34771895	34773611	A05p34530.2_BraZ1	558.6	-	1503	1716	1716	1.0000000
A05	34775278	34777769	A05p34540.2_BraZ1	1905.39	-	588	2314	2491	0.9289442
A05	34778336	34778492	A05p34550.2_BraZ1	15.6	-	199	156	156	1.0000000
A05	34778617	34779567	A05p34560.2_BraZ1	939	+	324	939	950	0.9884210
A05	34783280	34783622	A05p34570.2_BraZ1	34.2	+	264	342	342	1.0000000
A05	34784334	34790098	A05p34580.2_BraZ1	2125.2	+	3464	5514	5764	0.9566274
A05	34794187	34795897	A05p34590.2_BraZ1	1359	+	59	928	1710	0.5426900
A05	34801942	34805267	A05p34600.2_BraZ1	1480.36	+	1161	2983	3325	0.8971428
A05	34805918	34808588	A05p34610.2_BraZ1	1862.61	-	772	2492	2670	0.9333333
A05	34809548	34811607	A05p34620.2_BraZ1	960.84	-	653	1939	2059	0.9417193
A05	34811644	34812627	A05p34630.2_BraZ1	672	-	860	983	983	1.0000000
A05	34815367	34816891	A05p34640.2_BraZ1	1789.71	+	546	1524	1524	1.0000000
A05	34818357	34819834	A05p34650.2_BraZ1	1290	+	89	868	1477	0.5876777
A05	34821041	34821797	A05p34660.2_BraZ1	75.6	-	14	234	756	0.3095238
A05	34823870	34824059	A05p34670.2_BraZ1	18.9	+	206	189	189	1.0000000
A05	34826238	34826376	A05p34680.2_BraZ1	13.8	+	3	59	138	0.4275362
A05	34833717	34833858	A05p34690.2_BraZ1	14.1	+	4	124	141	0.8794326
A05	34835389	34837356	A05p34700.2_BraZ1	270.6	-	1481	1967	1967	1.0000000
A05	34837504	34838034	A05p34710.2_BraZ1	441	-	169	530	530	1.0000000
A05	34849108	34851898	A05p34720.2_BraZ1	648.058	-	695	2260	2790	0.8100358
A05	34853828	34857305	A05p34730.2_BraZ1	2480.62	+	967	2998	3477	0.8622376
A05	34857790	34859146	A05p34740.2_BraZ1	978.717	-	658	1213	1356	0.8945428
A05	34859563	34860635	A05p34750.2_BraZ1	615	+	770	1072	1072	1.0000000
A05	34860769	34861123	A05p34760.2_BraZ1	35.4	-	101	315	354	0.8898305
A05	34861639	34863700	A05p34770.2_BraZ1	1253.53	-	194	1623	2061	0.7874818
A05	34864614	34868291	A05p34780.2_BraZ1	2183.93	-	1306	3210	3677	0.8729943
A05	34869564	34870110	A05p34790.2_BraZ1	1110	+	651	546	546	1.0000000
A05	34870286	34871664	A05p34800.2_BraZ1	76.5	-	884	1301	1378	0.9441219
A05	34876597	34877650	A05p34810.2_BraZ1	105.3	-	100	734	1053	0.6970561
A05	34878507	34894909	A05p34820.2_BraZ1	1969.48	-	16091	15955	16402	0.9727472
A05	34896298	34897916	A05p34830.2_BraZ1	1536	-	158	923	1618	0.5704573
A05	34906752	34907352	A05p34840.2_BraZ1	423	-	13	101	600	0.1683333
A05	34909764	34916234	A05p34850.2_BraZ1	1540.5	-	1984	5148	6470	0.7956724
A05	34916699	34917030	A05p34860.2_BraZ1	159	-	92	331	331	1.0000000
A05	34917017	34920606	A05p34870.2_BraZ1	13500.8	-	322	1419	3589	0.3953747
A05	34925561	34926469	A05p34880.2_BraZ1	773.5	-	9	456	908	0.5022026
A05	34927376	34929032	A05p34890.2_BraZ1	5832	-	2	276	1656	0.1666667
A05	34936476	34938173	A05p34900.2_BraZ1	894	-	3	148	1697	0.0872127
A05	34940104	34941164	A05p34910.2_BraZ1	105.3	-	0	0	1060	0.0000000
A05	34941746	34967459	A05p34920.2_BraZ1	1997.81	-	669	7471	25713	0.2905534
A05	34947444	34948581	A05p34930.2_BraZ1	113.7	+	21	248	1137	0.2181178
A05	34950630	34951870	A05p34940.2_BraZ1	42.9	+	32	636	1240	0.5129032
A05	34951951	34952459	A05p34950.2_BraZ1	26.4	-	0	0	508	0.0000000
A05	34952583	34956715	A05p34960.2_BraZ1	136.5	-	2	278	4132	0.0672798
A05	34957538	34960945	A05p34970.2_BraZ1	199.8	-	148	1341	3407	0.3936014
A05	34961700	34963137	A05p34980.2_BraZ1	79.8	-	7	385	1437	0.2679193
A05	34963331	34963631	A05p34990.2_BraZ1	30	-	0	0	300	0.0000000
A05	34980241	34981497	A05p35000.2_BraZ1	159	+	0	0	1256	0.0000000
A05	34982931	34984577	A05p35010.2_BraZ1	1542	-	0	0	1646	0.0000000
A05	34987816	34989454	A05p35020.2_BraZ1	491.111	-	0	0	1638	0.0000000
A05	34989913	34993982	A05p35030.2_BraZ1	1257.5	-	12	226	4069	0.0555419
A05	34996710	34997617	A05p35040.2_BraZ1	773.5	-	0	0	907	0.0000000
A05	34998525	35000181	A05p35050.2_BraZ1	7128	-	0	0	1656	0.0000000
A05	35007679	35009413	A05p35060.2_BraZ1	936	-	0	0	1734	0.0000000
A05	35011343	35012403	A05p35070.2_BraZ1	105.3	-	0	0	1060	0.0000000
A05	35012985	35020350	A05p35080.2_BraZ1	2001.3	-	82	2526	7365	0.3429735
A05	35033128	35034384	A05p35090.2_BraZ1	159	+	0	0	1256	0.0000000
A05	35035815	35037461	A05p35100.2_BraZ1	1542	-	2	165	1646	0.1002430
A05	35040699	35042337	A05p35110.2_BraZ1	561.6	-	0	0	1638	0.0000000
A05	35042796	35046888	A05p35120.2_BraZ1	1252.47	-	111	447	4092	0.1092375
A05	35049613	35050521	A05p35130.2_BraZ1	773.5	-	10	374	908	0.4118943
A05	35051429	35053085	A05p35140.2_BraZ1	5832	-	0	0	1656	0.0000000
A05	35060485	35062234	A05p35150.2_BraZ1	1014	-	16	199	1749	0.1137793
A05	35064165	35065225	A05p35160.2_BraZ1	105.3	-	0	0	1060	0.0000000
A05	35065807	35074219	A05p35170.2_BraZ1	1804.41	-	600	6159	8412	0.7321683
A05	35074349	35087846	A05p35180.2_BraZ1	375	+	2343	9631	13497	0.7135660
A05	35077100	35077544	A05p35190.2_BraZ1	261	+	21	372	444	0.8378378
A05	35080570	35080906	A05p35200.2_BraZ1	282	+	113	323	336	0.9613096
A05	35090483	35092129	A05p35210.2_BraZ1	1542	-	100	881	1646	0.5352370
A05	35102913	35111090	A05p35220.2_BraZ1	1210	-	532	4440	8177	0.5429865
A05	35112248	35114211	A05p35230.2_BraZ1	1593	-	149	1017	1963	0.5180846
A05	35115655	35116366	A05p35240.2_BraZ1	186	-	700	711	711	1.0000000
A05	35120802	35122317	A05p35250.2_BraZ1	2989	-	149	1193	1515	0.7874587
A05	35124877	35126325	A05p35260.2_BraZ1	639.113	+	71	1205	1448	0.8321823
A05	35128673	35130086	A05p35270.2_BraZ1	719.174	+	839	1413	1413	1.0000000
A05	35130615	35132228	A05p35280.2_BraZ1	1542	-	576	1342	1613	0.8319901
A05	35132398	35132833	A05p35290.2_BraZ1	31.8	+	68	392	435	0.9011495
A05	35150454	35151641	A05p35300.2_BraZ1	198	-	492	1187	1187	1.0000000
A05	35153917	35154259	A05p35310.2_BraZ1	34.2	+	683	342	342	1.0000000
A05	35155261	35179083	A05p35320.2_BraZ1	2272.59	+	14300	23090	23822	0.9692721
A05	35160762	35163451	A05p35330.2_BraZ1	1398.53	-	340	2100	2689	0.7809595
A05	35168760	35169866	A05p35340.2_BraZ1	212.625	+	1249	1106	1106	1.0000000
A05	35185162	35186566	A05p35350.2_BraZ1	140.4	+	75	1160	1404	0.8262108
A05	35188821	35193239	A05p35360.2_BraZ1	3254.96	-	3216	4049	4418	0.9164780
A05	35195992	35197566	A05p35370.2_BraZ1	720	-	617	1244	1574	0.7903430
A05	35196617	35200563	A05p35380.2_BraZ1	859.825	-	1722	3638	3946	0.9219463
A05	35201417	35203436	A05p35390.2_BraZ1	2097.6	-	639	2019	2019	1.0000000
A05	35204015	35226546	A05p35400.2_BraZ1	1795.85	-	15095	21438	22531	0.9514890
A05	35209969	35210536	A05p35410.2_BraZ1	396	-	541	567	567	1.0000000
A05	35217218	35218098	A05p35420.2_BraZ1	396	-	411	880	880	1.0000000
A05	35222890	35223316	A05p35430.2_BraZ1	42.6	-	493	426	426	1.0000000
A05	35233696	35239616	A05p35440.2_BraZ1	2923.11	-	2386	5686	5920	0.9604730
A05	35244209	35245205	A05p35450.2_BraZ1	99.6	-	441	996	996	1.0000000
A05	35248950	35250734	A05p35460.2_BraZ1	19698.8	-	94	1529	1784	0.8570628
A05	35263342	35271530	A05p35470.2_BraZ1	1228.5	+	863	4456	8188	0.5442110
A05	35271979	35274489	A05p35480.2_BraZ1	827.192	-	310	1872	2510	0.7458167
A05	35276290	35280862	A05p35490.2_BraZ1	530.4	+	3256	4564	4572	0.9982502
A05	35281620	35296447	A05p35500.2_BraZ1	1173	+	4260	12570	14827	0.8477777
A05	35286980	35288599	A05p35510.2_BraZ1	1038	-	509	1532	1619	0.9462631
A05	35289282	35294682	A05p35520.2_BraZ1	2176.7	-	680	3518	5400	0.6514815
A05	35296304	35299937	A05p35530.2_BraZ1	1910.84	+	570	3252	3633	0.8951280
A05	35303694	35305470	A05p35540.2_BraZ1	1686	+	148	1376	1776	0.7747748
A05	35314534	35325173	A05p35550.2_BraZ1	1399.87	+	3076	5192	10639	0.4880158
A05	35326244	35326805	A05p35560.2_BraZ1	56.1	-	0	0	561	0.0000000
A05	35332169	35332781	A05p35570.2_BraZ1	61.2	-	30	403	612	0.6584967
A05	35333553	35335964	A05p35580.2_BraZ1	1535.62	-	179	1393	2411	0.5777686
A05	35337315	35338365	A05p35590.2_BraZ1	105	+	66	743	1050	0.7076191
A05	35341118	35341799	A05p35600.2_BraZ1	68.1	-	32	611	681	0.8972100
A05	35358936	35359509	A05p35610.2_BraZ1	495	+	116	573	573	1.0000000
A05	35377280	35383190	A05p35620.2_BraZ1	354	-	8022	5910	5910	1.0000000
A05	35384384	35393574	A05p35630.2_BraZ1	324	-	2806	8458	9190	0.9203482
A05	35409952	35410445	A05p35640.2_BraZ1	291	+	373	493	493	1.0000000
A05	35416474	35417035	A05p35650.2_BraZ1	56.1	+	0	0	561	0.0000000
A05	35418100	35422480	A05p35660.2_BraZ1	1556.25	-	94	1313	4380	0.2997717
A05	35460263	35460837	A05p35670.2_BraZ1	342	-	122	547	574	0.9529617
A05	35461750	35462816	A05p35680.2_BraZ1	984	+	11	274	1066	0.2570356
A05	35463587	35464254	A05p35690.2_BraZ1	66.6	-	355	667	667	1.0000000
A05	35465673	35466327	A05p35700.2_BraZ1	429	-	117	534	654	0.8165138
A05	35469278	35470392	A05p35710.2_BraZ1	376.8	+	1140	1096	1114	0.9838420
A05	35472053	35473226	A05p35720.2_BraZ1	117.3	-	478	1173	1173	1.0000000
A05	35476690	35480364	A05p35730.2_BraZ1	2164.91	-	489	2345	3674	0.6382689
A05	35480394	35481809	A05p35740.2_BraZ1	212.864	-	484	1356	1415	0.9583039
A05	35484417	35484696	A05p35750.2_BraZ1	27.9	-	149	279	279	1.0000000
A05	35485032	35486082	A05p35760.2_BraZ1	105	+	47	347	1050	0.3304762
A05	35487430	35495684	A05p35770.2_BraZ1	1353	+	4111	8224	8254	0.9963654
A05	35496481	35498386	A05p35780.2_BraZ1	1246.89	-	323	1636	1905	0.8587927
A05	35499011	35501261	A05p35790.2_BraZ1	1185.46	-	365	2056	2250	0.9137778
A05	35504675	35507154	A05p35800.2_BraZ1	933.811	+	463	1625	2479	0.6555063
A05	35510137	35511657	A05p35810.2_BraZ1	1416	-	645	1520	1520	1.0000000
A05	35527149	35528471	A05p35820.2_BraZ1	852	-	480	1115	1322	0.8434191
A05	35541192	35551264	A05p35830.2_BraZ1	2811.86	+	2074	6790	10072	0.6741462
A05	35552363	35553503	A05p35840.2_BraZ1	114	-	161	826	1140	0.7245614
A05	35556634	35556832	A05p35850.2_BraZ1	19.8	+	67	186	198	0.9393939
A05	35559398	35561403	A05p35860.2_BraZ1	1272.86	-	518	1768	2005	0.8817955
A05	35564601	35567579	A05p35870.2_BraZ1	1343.28	+	463	2632	2978	0.8838146
A05	35569256	35571491	A05p35880.2_BraZ1	672.75	-	881	2235	2235	1.0000000
A05	35573073	35573653	A05p35890.2_BraZ1	270	+	153	507	580	0.8741379
A05	35594388	35598920	A05p35900.2_BraZ1	275.625	+	3340	4532	4532	1.0000000
A05	35599320	35600434	A05p35910.2_BraZ1	108.9	-	1520	1114	1114	1.0000000
A05	35608305	35616277	A05p35920.2_BraZ1	924	+	1691	6385	7972	0.8009282
A05	35618823	35619630	A05p35930.2_BraZ1	80.7	+	324	807	807	1.0000000
A05	35622506	35624004	A05p35940.2_BraZ1	7659	-	3098	1475	1498	0.9846462
A05	35629904	35631229	A05p35950.2_BraZ1	4260	+	625	1325	1325	1.0000000
A05	35632731	35634661	A05p35960.2_BraZ1	9360	+	584	1556	1930	0.8062176
A05	35637303	35638453	A05p35970.2_BraZ1	333	+	766	1010	1150	0.8782609
A05	35644237	35645824	A05p35980.2_BraZ1	1321.88	-	385	1526	1587	0.9615627
A05	35657794	35660431	A05p35990.2_BraZ1	2002.57	+	1211	2547	2637	0.9658703
A05	35667456	35669105	A05p36000.2_BraZ1	687.211	+	1065	1649	1649	1.0000000
A05	35670120	35672854	A05p36010.2_BraZ1	1630.65	+	841	2632	2734	0.9626920
A05	35673728	35674920	A05p36020.2_BraZ1	640.721	-	591	1192	1192	1.0000000
A05	35678853	35680684	A05p36030.2_BraZ1	917.614	-	337	1674	1831	0.9142545
A05	35682627	35684854	A05p36040.2_BraZ1	1395.31	-	902	2141	2227	0.9613830
A05	35686242	35687427	A05p36050.2_BraZ1	118.5	+	1110	1185	1185	1.0000000
A05	35697087	35698917	A05p36060.2_BraZ1	1615.63	+	464	1165	1830	0.6366120
A05	35705578	35708709	A05p36070.2_BraZ1	2817	-	3005	3131	3131	1.0000000
A05	35709576	35710231	A05p36080.2_BraZ1	21	-	22	104	655	0.1587786
A05	35710608	35711314	A05p36090.2_BraZ1	26.1	-	87	59	706	0.0835694
A05	35711825	35714988	A05p36100.2_BraZ1	1259.25	-	1932	3140	3163	0.9927284
A05	35720263	35721933	A05p36110.2_BraZ1	669.667	-	1775	1670	1670	1.0000000
A05	35724025	35725828	A05p36120.2_BraZ1	1228.98	-	596	1501	1803	0.8325014
A05	35735726	35736241	A05p36130.2_BraZ1	336	+	25	385	515	0.7475728
A05	35737828	35737996	A05p36140.2_BraZ1	16.8	+	457	168	168	1.0000000
A05	35741556	35742825	A05p36150.2_BraZ1	126.9	+	443	1269	1269	1.0000000
A05	35743456	35746058	A05p36160.2_BraZ1	1579.64	-	1189	2445	2602	0.9396618
A05	35754624	35756311	A05p36170.2_BraZ1	1384.67	-	420	930	1687	0.5512745
A05	35759544	35759778	A05p36180.2_BraZ1	23.4	-	202	234	234	1.0000000
A05	35761250	35763909	A05p36190.2_BraZ1	1380	+	699	1859	2659	0.6991350
A05	35764109	35766345	A05p36200.2_BraZ1	1176.31	-	683	2016	2236	0.9016100
A05	35774475	35777048	A05p36210.2_BraZ1	1841.17	+	1172	2440	2573	0.9483094
A05	35777406	35779028	A05p36220.2_BraZ1	1184.17	-	1209	1576	1622	0.9716399
A05	35783307	35786217	A05p36230.2_BraZ1	1472.71	+	1252	2888	2910	0.9924399
A05	35795486	35797993	A05p36240.2_BraZ1	1230.03	+	155	1307	2507	0.5213403
A05	35809872	35811445	A05p36250.2_BraZ1	770.837	+	234	1481	1573	0.9415131
A05	35813643	35814552	A05p36260.2_BraZ1	90.9	-	611	909	909	1.0000000
A05	35816084	35816615	A05p36270.2_BraZ1	402	+	487	531	531	1.0000000
A05	35816819	35818805	A05p36280.2_BraZ1	1224	-	201	1139	1986	0.5735146
A05	35826269	35828529	A05p36290.2_BraZ1	886.286	-	632	2157	2260	0.9544248
A05	35833685	35834055	A05p36300.2_BraZ1	21.9	-	4	23	370	0.0621622
A05	35844725	35846743	A05p36310.2_BraZ1	1908	-	786	1959	2018	0.9707631
A05	35850271	35852644	A05p36320.2_BraZ1	1335.78	+	1084	1799	2373	0.7581121
A05	35853197	35854495	A05p36330.2_BraZ1	558	-	516	1298	1298	1.0000000
A05	35857493	35864568	A05p36340.2_BraZ1	2623.6	+	1817	4739	7075	0.6698233
A05	35868935	35870160	A05p36350.2_BraZ1	397.688	-	0	0	1225	0.0000000
A05	35871398	35871954	A05p36360.2_BraZ1	447	+	19	296	556	0.5323741
A05	35874523	35882026	A05p36370.2_BraZ1	5575.31	-	1004	4005	7503	0.5337865
A05	35882990	35887323	A05p36380.2_BraZ1	2279.92	-	438	3121	4333	0.7202862
A05	35890744	35891553	A05p36390.2_BraZ1	575.25	+	287	809	809	1.0000000
A05	35894217	35895000	A05p36400.2_BraZ1	552	+	53	506	783	0.6462324
A05	35896426	35898822	A05p36410.2_BraZ1	1180.75	+	613	2357	2396	0.9837229
A05	35899634	35902731	A05p36420.2_BraZ1	1708.53	-	969	2870	3097	0.9267033
A05	35912739	35915202	A05p36430.2_BraZ1	1190.94	-	1026	2454	2463	0.9963459
A05	35918363	35919572	A05p36440.2_BraZ1	1075.71	-	1023	1209	1209	1.0000000
A05	35921804	35924166	A05p36450.2_BraZ1	1234.43	-	1800	2325	2362	0.9843353
A05	35931206	35932301	A05p36460.2_BraZ1	1322.1	-	712	1025	1095	0.9360731
A05	35934602	35937191	A05p36470.2_BraZ1	216	+	681	1977	2589	0.7636153
A05	35937442	35938116	A05p36480.2_BraZ1	222	+	20	515	674	0.7640949
A05	35941233	35945565	A05p36490.2_BraZ1	223.25	-	1633	3509	4332	0.8100185
A05	35948855	35960305	A05p36500.2_BraZ1	6900.31	-	2982	8572	11450	0.7486463
A05	35971399	35973527	A05p36510.2_BraZ1	1838.25	+	993	2072	2128	0.9736842
A05	35988061	35988244	A05p36520.2_BraZ1	18.3	+	324	183	183	1.0000000
A05	35989091	35990159	A05p36530.2_BraZ1	867	-	352	831	1068	0.7780899
A05	35995137	35996774	A05p36540.2_BraZ1	12862.5	+	364	899	1637	0.5491753
A05	36005823	36006595	A05p36550.2_BraZ1	315	+	330	772	772	1.0000000
A05	36007953	36014755	A05p36560.2_BraZ1	1143.52	+	3610	6435	6802	0.9460453
A05	36015633	36017049	A05p36570.2_BraZ1	141.6	+	725	1416	1416	1.0000000
A05	36017136	36018074	A05p36580.2_BraZ1	63.9	-	818	900	938	0.9594883
A05	36018756	36020416	A05p36590.2_BraZ1	1263	-	851	1639	1660	0.9873494
A05	36022773	36024150	A05p36600.2_BraZ1	137.7	-	740	1377	1377	1.0000000
A05	36043797	36045510	A05p36610.2_BraZ1	383.273	+	916	1713	1713	1.0000000
A05	36046974	36048300	A05p36620.2_BraZ1	132.6	+	756	1326	1326	1.0000000
A05	36049295	36052556	A05p36630.2_BraZ1	1701.35	-	1613	2914	3261	0.8935909
A05	36053876	36054392	A05p36640.2_BraZ1	333	-	200	516	516	1.0000000
A05	36054595	36055414	A05p36650.2_BraZ1	81.9	+	203	790	819	0.9645910
A05	36055552	36060320	A05p36660.2_BraZ1	2191.68	-	1923	4267	4768	0.8949245
A05	36088406	36089681	A05p36670.2_BraZ1	1086.75	+	297	787	1275	0.6172549
A05	36090490	36090796	A05p36680.2_BraZ1	30.6	+	372	306	306	1.0000000
A05	36091446	36093474	A05p36690.2_BraZ1	202.8	-	767	1964	2028	0.9684418
A05	36096186	36097434	A05p36700.2_BraZ1	1180.67	+	731	1248	1248	1.0000000
A05	36100134	36100461	A05p36710.2_BraZ1	32.7	+	101	327	327	1.0000000
A05	36100699	36102441	A05p36720.2_BraZ1	734.16	+	597	1617	1742	0.9282434
A05	36103127	36105120	A05p36730.2_BraZ1	551.461	-	819	1928	1993	0.9673858
A05	36106486	36109422	A05p36740.2_BraZ1	1987.3	+	1415	2446	2936	0.8331063
A05	36109879	36110491	A05p36750.2_BraZ1	61.2	-	70	603	612	0.9852941
A05	36111341	36112235	A05p36760.2_BraZ1	89.4	-	219	840	894	0.9395973
A05	36113541	36114196	A05p36770.2_BraZ1	423	-	76	219	655	0.3343512
A05	36117396	36117566	A05p36780.2_BraZ1	14.7	-	67	145	170	0.8529412
A05	36120090	36121571	A05p36790.2_BraZ1	312	+	5	248	1481	0.1674544
A05	36122449	36123633	A05p36800.2_BraZ1	2541	+	1918	1184	1184	1.0000000
A05	36125802	36127177	A05p36810.2_BraZ1	41580	-	241	1140	1375	0.8290909
A05	36134187	36134835	A05p36820.2_BraZ1	64.8	-	160	513	648	0.7916667
A05	36137467	36138109	A05p36830.2_BraZ1	64.2	-	77	325	642	0.5062305
A05	36145256	36152657	A05p36840.2_BraZ1	767.641	+	2069	3553	7401	0.4800703
A05	36152999	36154141	A05p36850.2_BraZ1	417	+	746	1101	1142	0.9640981
A05	36155480	36155909	A05p36860.2_BraZ1	339	-	289	429	429	1.0000000
A05	36156266	36162953	A05p36870.2_BraZ1	3835.71	+	1824	4077	6687	0.6096904
A05	36163906	36164188	A05p36880.2_BraZ1	28.2	-	173	282	282	1.0000000
A05	36176207	36176712	A05p36890.2_BraZ1	324	+	557	505	505	1.0000000
A05	36180905	36182186	A05p36900.2_BraZ1	128.1	+	454	1241	1281	0.9687744
A05	36184892	36185540	A05p36910.2_BraZ1	64.8	+	300	631	648	0.9737654
A05	36185732	36187589	A05p36920.2_BraZ1	945.068	-	812	1831	1857	0.9859989
A05	36189082	36191552	A05p36930.2_BraZ1	1814.41	+	389	2099	2470	0.8497975
A05	36196915	36202233	A05p36940.2_BraZ1	1043.2	+	1316	3453	5318	0.6493043
A05	36203205	36204312	A05p36950.2_BraZ1	110.7	+	416	985	1107	0.8897922
A05	36207548	36209073	A05p36960.2_BraZ1	773.81	+	1093	1525	1525	1.0000000
A05	36209594	36210835	A05p36970.2_BraZ1	816.577	-	776	1241	1241	1.0000000
A05	36212070	36213703	A05p36980.2_BraZ1	719.292	+	1861	1633	1633	1.0000000
A05	36215505	36231890	A05p36990.2_BraZ1	2378.03	+	14767	16148	16385	0.9855356
A05	36233439	36234099	A05p37000.2_BraZ1	576	-	262	488	660	0.7393939
A05	36234435	36235702	A05p37010.2_BraZ1	603.75	+	758	1249	1267	0.9857932
A05	36235914	36236518	A05p37020.2_BraZ1	49.8	+	448	588	604	0.9735099
A05	36238833	36239308	A05p37030.2_BraZ1	39.9	-	525	475	475	1.0000000
A05	36243195	36245656	A05p37040.2_BraZ1	559.125	+	1728	2461	2461	1.0000000
A05	36261085	36261594	A05p37050.2_BraZ1	450	-	140	509	509	1.0000000
A05	36261740	36261917	A05p37060.2_BraZ1	17.7	+	146	177	177	1.0000000
A05	36265708	36267221	A05p37070.2_BraZ1	10890	+	1877	1513	1513	1.0000000
A05	36271192	36274657	A05p37080.2_BraZ1	1312.59	-	3809	3465	3465	1.0000000
A05	36280760	36280904	A05p37090.2_BraZ1	14.4	-	50	144	144	1.0000000
A05	36283394	36284485	A05p37100.2_BraZ1	87.3	-	46	843	1091	0.7726856
A05	36286593	36286950	A05p37110.2_BraZ1	273	-	682	357	357	1.0000000
A05	36287279	36290036	A05p37120.2_BraZ1	1034.66	-	2395	2721	2757	0.9869424
A05	36291189	36292301	A05p37130.2_BraZ1	358.375	+	465	1112	1112	1.0000000
A05	36292092	36293537	A05p37140.2_BraZ1	68.2	+	341	1371	1445	0.9487889
A05	36294536	36296101	A05p37150.2_BraZ1	1476	+	348	1338	1565	0.8549521
A05	36313141	36317595	A05p37160.2_BraZ1	1983.75	-	3881	4433	4454	0.9952852
A05	36318777	36319575	A05p37170.2_BraZ1	395.619	+	455	798	798	1.0000000
A05	36321795	36322736	A05p37180.2_BraZ1	500.909	+	504	941	941	1.0000000
A05	36323348	36324308	A05p37190.2_BraZ1	96	+	682	960	960	1.0000000
A05	36328590	36329000	A05p37200.2_BraZ1	321	-	133	410	410	1.0000000
A05	36335453	36336841	A05p37210.2_BraZ1	1284	-	1872	1388	1388	1.0000000
A05	36337604	36339468	A05p37220.2_BraZ1	930	+	46	1060	1864	0.5686696
A05	36340483	36341740	A05p37230.2_BraZ1	125.7	-	59	801	1257	0.6372315
A05	36342594	36342852	A05p37240.2_BraZ1	25.8	-	45	258	258	1.0000000
A05	36343224	36345285	A05p37250.2_BraZ1	833.899	+	354	949	2061	0.4604561
A05	36347379	36347560	A05p37260.2_BraZ1	13.2	+	373	181	181	1.0000000
A05	36350006	36353865	A05p37270.2_BraZ1	2289.26	-	2055	3711	3859	0.9616481
A05	36356728	36361450	A05p37280.2_BraZ1	1504.15	+	1853	4502	4722	0.9534096
A05	36368189	36368366	A05p37290.2_BraZ1	17.7	+	306	177	177	1.0000000
A05	36372598	36375139	A05p37300.2_BraZ1	253.2	+	199	1826	2541	0.7186147
A05	36375608	36377478	A05p37310.2_BraZ1	816	-	310	1500	1870	0.8021390
A05	36377651	36378345	A05p37320.2_BraZ1	612	-	63	622	694	0.8962536
A05	36379837	36385464	A05p37330.2_BraZ1	3447.69	-	1874	4845	5627	0.8610272
A05	36387785	36387902	A05p37340.2_BraZ1	11.7	-	107	117	117	1.0000000
A05	36400043	36402620	A05p37350.2_BraZ1	257.7	+	1211	2316	2577	0.8987194
A05	36402971	36403307	A05p37360.2_BraZ1	33.6	-	83	336	336	1.0000000
A05	36408354	36410111	A05p37370.2_BraZ1	1210.91	-	710	1757	1757	1.0000000
A05	36419149	36420780	A05p37380.2_BraZ1	1282.03	+	476	1570	1631	0.9625996
A05	36423855	36424157	A05p37390.2_BraZ1	22.5	+	239	302	302	1.0000000
A05	36428358	36429977	A05p37400.2_BraZ1	1395	+	497	1608	1619	0.9932057
A05	36431161	36431841	A05p37410.2_BraZ1	29.7	-	753	680	680	1.0000000
A05	36431841	36434067	A05p37420.2_BraZ1	2108	+	1676	2200	2226	0.9883199
A05	36434515	36436348	A05p37430.2_BraZ1	1356.52	-	622	1633	1833	0.8908892
A05	36449292	36451505	A05p37440.2_BraZ1	2431	-	2020	2213	2213	1.0000000
A05	36453191	36453828	A05p37450.2_BraZ1	269.5	+	0	0	637	0.0000000
A05	36457872	36459511	A05p37460.2_BraZ1	892.964	-	913	1608	1639	0.9810860
A05	36461082	36462129	A05p37470.2_BraZ1	735	-	590	1047	1047	1.0000000
A05	36463450	36463621	A05p37480.2_BraZ1	17.1	+	31	115	171	0.6725146
A05	36465653	36466134	A05p37490.2_BraZ1	138	-	1579	481	481	1.0000000
A05	36466434	36467078	A05p37500.2_BraZ1	159	-	693	644	644	1.0000000
A05	36473607	36475607	A05p37510.2_BraZ1	1054.58	+	782	1963	2000	0.9815000
A05	36476729	36478508	A05p37520.2_BraZ1	1764	-	199	1421	1779	0.7987633
A05	36478875	36479728	A05p37530.2_BraZ1	2592	+	333	811	853	0.9507620
A05	36485695	36487491	A05p37540.2_BraZ1	1449	-	502	1751	1796	0.9749443
A05	36492464	36493229	A05p37550.2_BraZ1	417.5	-	2779	765	765	1.0000000
A05	36494933	36496663	A05p37560.2_BraZ1	1482.86	-	254	1214	1730	0.7017341
A05	36503745	36504206	A05p37570.2_BraZ1	255	-	301	461	461	1.0000000
A05	36507161	36508883	A05p37580.2_BraZ1	698.5	-	632	1397	1722	0.8112659
A05	36512663	36514321	A05p37590.2_BraZ1	958.375	-	360	1371	1658	0.8268999
A05	36517223	36517400	A05p37600.2_BraZ1	17.7	-	17	130	177	0.7344633
A05	36517648	36519336	A05p37610.2_BraZ1	4861.5	-	291	882	1688	0.5225118
A05	36523419	36524500	A05p37620.2_BraZ1	660	+	224	1063	1081	0.9833487
A05	36526038	36526275	A05p37630.2_BraZ1	23.7	+	4	209	237	0.8818566
A05	36530820	36531517	A05p37640.2_BraZ1	600	-	34	558	697	0.8005739
A05	36536228	36536970	A05p37650.2_BraZ1	1911	-	71	405	742	0.5458221
A05	36536618	36540587	A05p37660.2_BraZ1	5500	-	368	1818	3969	0.4580499
A05	36542389	36544013	A05p37670.2_BraZ1	949.023	-	98	697	1624	0.4291872
A05	36547881	36549689	A05p37680.2_BraZ1	586.25	+	59	743	1808	0.4109513
A05	36550248	36564993	A05p37690.2_BraZ1	1008	+	3610	9595	14745	0.6507291
A05	36551873	36556631	A05p37700.2_BraZ1	3221.87	+	1138	2907	4758	0.6109710
A05	36556920	36560418	A05p37710.2_BraZ1	2300.31	-	1630	2681	3498	0.7664379
A05	36561083	36566357	A05p37720.2_BraZ1	3271.67	-	580	3340	5274	0.6332954
A05	36567477	36570740	A05p37730.2_BraZ1	1830	-	1178	3263	3263	1.0000000
A05	36574502	36574843	A05p37740.2_BraZ1	183	-	359	341	341	1.0000000
A05	36576563	36578451	A05p37750.2_BraZ1	6346	-	399	1333	1888	0.7060381
A05	36580489	36583692	A05p37760.2_BraZ1	1740.38	-	1384	3080	3203	0.9615985
A05	36586106	36586867	A05p37770.2_BraZ1	3724.5	+	0	0	761	0.0000000
A05	36610751	36613558	A05p37780.2_BraZ1	864	+	805	2241	2807	0.7983612
A05	36620205	36622319	A05p37790.2_BraZ1	1713.6	+	500	2015	2114	0.9531693
A05	36627212	36627909	A05p37800.2_BraZ1	1449	+	263	692	697	0.9928264
A05	36640734	36641376	A05p37810.2_BraZ1	64.2	-	106	424	642	0.6604362
A05	36643025	36643534	A05p37820.2_BraZ1	267	+	880	509	509	1.0000000
A05	36644184	36647478	A05p37830.2_BraZ1	1267.12	-	9164	3294	3294	1.0000000
A05	36647788	36653454	A05p37840.2_BraZ1	1146.63	-	2353	4691	5666	0.8279209
A05	36657590	36659517	A05p37850.2_BraZ1	1025.38	+	661	1853	1927	0.9615983
A05	36666225	36668974	A05p37860.2_BraZ1	1134.76	-	925	2616	2749	0.9516188
A05	36675279	36677429	A05p37870.2_BraZ1	1023.35	+	6	54	2150	0.0251163
A05	36677979	36682910	A05p37880.2_BraZ1	1819.78	-	3413	4611	4931	0.9351044
A05	36686115	36687840	A05p37890.2_BraZ1	998.036	+	951	1618	1725	0.9379710
A05	36692847	36694542	A05p37900.2_BraZ1	900.835	+	779	1668	1695	0.9840708
A05	36695228	36696195	A05p37910.2_BraZ1	545.737	+	165	882	967	0.9120993
A05	36696545	36701732	A05p37920.2_BraZ1	2258.47	-	625	3439	5187	0.6630037
A05	36703357	36705647	A05p37930.2_BraZ1	968	-	1508	2290	2290	1.0000000
A05	36711367	36711949	A05p37940.2_BraZ1	492	-	92	489	582	0.8402062
A05	36712422	36714951	A05p37950.2_BraZ1	1044.31	-	1284	2529	2529	1.0000000
A05	36715910	36716111	A05p37960.2_BraZ1	20.1	-	17	197	201	0.9800995
A05	36716860	36719422	A05p37970.2_BraZ1	867.463	-	919	2505	2562	0.9777517
A05	36725060	36725769	A05p37980.2_BraZ1	252	-	671	709	709	1.0000000
A05	36731870	36732933	A05p37990.2_BraZ1	467.906	+	1004	1063	1063	1.0000000
A05	36733509	36739618	A05p38000.2_BraZ1	3435.73	+	3151	5249	6109	0.8592241
A05	36748661	36751230	A05p38010.2_BraZ1	599.211	-	1115	2334	2569	0.9085247
A05	36756270	36758108	A05p38020.2_BraZ1	1054.32	-	684	1772	1838	0.9640914
A05	36765623	36766245	A05p38030.2_BraZ1	360.769	+	234	622	622	1.0000000
A05	36767029	36769012	A05p38040.2_BraZ1	1364.11	-	1531	1983	1983	1.0000000
A05	36770223	36771852	A05p38050.2_BraZ1	1216.8	+	716	1629	1629	1.0000000
A05	36772304	36773503	A05p38060.2_BraZ1	1014	-	238	793	1199	0.6613845
A05	36774713	36776494	A05p38070.2_BraZ1	390	-	829	1571	1781	0.8820887
A05	36777874	36781779	A05p38080.2_BraZ1	1696.94	+	779	2564	3905	0.6565941
A05	36782708	36784611	A05p38090.2_BraZ1	1426.48	+	579	1724	1903	0.9059380
A05	36785034	36789010	A05p38100.2_BraZ1	2741.82	-	2286	3140	3976	0.7897384
A05	36791218	36793636	A05p38110.2_BraZ1	1738.04	-	1980	2418	2418	1.0000000
A05	36793982	36794385	A05p38120.2_BraZ1	348	+	720	403	403	1.0000000
A05	36794457	36798563	A05p38130.2_BraZ1	2692.08	+	2363	4072	4106	0.9917194
A05	36799699	36800821	A05p38140.2_BraZ1	112.2	+	389	975	1122	0.8689840
A05	36802928	36804681	A05p38150.2_BraZ1	635.5	-	205	1503	1753	0.8573874
A05	36812431	36815673	A05p38160.2_BraZ1	1908.79	-	1171	3032	3242	0.9352252
A05	36817610	36820750	A05p38170.2_BraZ1	1895.04	-	662	2225	3140	0.7085987
A05	36823760	36827100	A05p38180.2_BraZ1	2181.6	-	1288	3232	3340	0.9676647
A05	36828671	36830644	A05p38190.2_BraZ1	881.6	+	1001	1805	1973	0.9148505
A05	36830962	36832008	A05p38200.2_BraZ1	729.711	-	609	1023	1046	0.9780115
A05	36833216	36834703	A05p38210.2_BraZ1	823.846	-	1054	1419	1487	0.9542704
A05	36836043	36836397	A05p38220.2_BraZ1	35.4	-	114	354	354	1.0000000
A05	36837112	36838300	A05p38230.2_BraZ1	118.8	-	127	972	1188	0.8181818
A05	36839366	36840584	A05p38240.2_BraZ1	1188	-	279	906	1218	0.7438424
A05	36841152	36842238	A05p38250.2_BraZ1	999	-	497	1086	1086	1.0000000
A05	36843798	36844434	A05p38260.2_BraZ1	474.571	-	105	610	636	0.9591195
A05	36847863	36848890	A05p38270.2_BraZ1	980	-	5	79	1027	0.0769231
A05	36853027	36853765	A05p38280.2_BraZ1	414.783	+	761	738	738	1.0000000
A05	36854320	36856306	A05p38290.2_BraZ1	682.56	+	1369	1971	1986	0.9924471
A05	36858205	36858454	A05p38300.2_BraZ1	24.9	-	142	249	249	1.0000000
A05	36864247	36864490	A05p38310.2_BraZ1	24.3	-	53	243	243	1.0000000
A05	36869099	36869993	A05p38320.2_BraZ1	89.4	+	169	739	894	0.8266219
A05	36873250	36874507	A05p38330.2_BraZ1	125.7	+	93	934	1257	0.7430390
A05	36887532	36890934	A05p38340.2_BraZ1	1209.71	+	575	2885	3402	0.8480306
A05	36892108	36892543	A05p38350.2_BraZ1	41.1	-	821	435	435	1.0000000
A05	36896831	36898131	A05p38360.2_BraZ1	840	+	843	1278	1300	0.9830769
A05	36899704	36901850	A05p38370.2_BraZ1	765.227	+	1328	2146	2146	1.0000000
A05	36913789	36915527	A05p38380.2_BraZ1	1298.88	+	385	1711	1738	0.9844649
A05	36916458	36919363	A05p38390.2_BraZ1	993.029	-	928	2823	2905	0.9717728
A05	36922455	36925442	A05p38400.2_BraZ1	794.99	-	2956	2952	2987	0.9882826
A05	36927560	36937527	A05p38410.2_BraZ1	5231.74	-	779	4024	9967	0.4037323
A05	36938339	36939578	A05p38420.2_BraZ1	885	-	142	1077	1239	0.8692494
A05	36942115	36943379	A05p38430.2_BraZ1	1017.23	-	326	1256	1264	0.9936709
A05	36945167	36951540	A05p38440.2_BraZ1	3261.76	+	1880	5638	6373	0.8846697
A05	36952933	36953689	A05p38450.2_BraZ1	164.077	+	548	756	756	1.0000000
A05	36955628	36958768	A05p38460.2_BraZ1	1935.18	+	609	2747	3140	0.8748407
A05	36959242	36959722	A05p38470.2_BraZ1	48	+	363	480	480	1.0000000
A05	36959975	36963031	A05p38480.2_BraZ1	1306.8	+	1414	2527	3056	0.8268979
A05	36967715	36969826	A05p38490.2_BraZ1	1917	+	1755	2111	2111	1.0000000
A05	36970738	36972616	A05p38500.2_BraZ1	1731	+	878	1867	1878	0.9941427
A05	36973673	36975109	A05p38510.2_BraZ1	1263	+	922	1436	1436	1.0000000
A05	36975997	36978343	A05p38520.2_BraZ1	1515	+	1005	2049	2346	0.8734015
A05	36979271	36979835	A05p38530.2_BraZ1	56.4	+	86	532	564	0.9432624
A05	36985380	36985755	A05p38540.2_BraZ1	288	-	31	221	375	0.5893334
A05	36988080	36988405	A05p38550.2_BraZ1	267	+	135	325	325	1.0000000
A05	36993610	36993974	A05p38560.2_BraZ1	279	-	62	294	364	0.8076923
A05	36999989	37000550	A05p38570.2_BraZ1	56.1	+	22	66	561	0.1176471
A05	37002489	37009087	A05p38580.2_BraZ1	3068.16	-	2187	4650	6598	0.7047590
A05	37009293	37009513	A05p38590.2_BraZ1	11.4	-	142	220	220	1.0000000
A05	37016562	37017317	A05p38600.2_BraZ1	1020	-	210	680	755	0.9006622
A05	37021684	37022202	A05p38610.2_BraZ1	316.2	+	701	518	518	1.0000000
A05	37023355	37023907	A05p38620.2_BraZ1	55.2	+	12	61	552	0.1105072
A05	37024747	37025599	A05p38630.2_BraZ1	653.192	-	80	837	852	0.9823943
A05	37029051	37029585	A05p38640.2_BraZ1	53.4	-	176	534	534	1.0000000
A05	37045783	37046664	A05p38650.2_BraZ1	747	-	333	881	881	1.0000000
A05	37049160	37051229	A05p38660.2_BraZ1	878.318	-	1243	1998	2069	0.9656839
A05	37056366	37057836	A05p38670.2_BraZ1	1012.17	+	270	1201	1470	0.8170068
A05	37061588	37062017	A05p38680.2_BraZ1	1440	-	7	125	429	0.2913753
A05	37062026	37062451	A05p38690.2_BraZ1	360	-	3	50	425	0.1176471
A05	37062475	37062781	A05p38700.2_BraZ1	30.6	-	34	190	306	0.6209151
A05	37063327	37067232	A05p38710.2_BraZ1	357.9	-	1858	3714	3905	0.9510884
A05	37069876	37072578	A05p38720.2_BraZ1	1794.66	+	847	2554	2702	0.9452258
A05	37072816	37074161	A05p38730.2_BraZ1	453.783	+	1083	1345	1345	1.0000000
A05	37074586	37076304	A05p38740.2_BraZ1	887.6	-	1186	1718	1718	1.0000000
A05	37078731	37082872	A05p38750.2_BraZ1	2239.24	-	1247	3931	4141	0.9492876
A05	37088640	37089031	A05p38760.2_BraZ1	276	+	33	271	391	0.6930946
A05	37089851	37092101	A05p38770.2_BraZ1	644.4	+	2159	2250	2250	1.0000000
A05	37102282	37103117	A05p38780.2_BraZ1	399.96	+	6	20	835	0.0239521
A05	37103107	37105161	A05p38790.2_BraZ1	594.533	+	2	210	2054	0.1022395
A05	37108353	37109646	A05p38800.2_BraZ1	279	+	756	1293	1293	1.0000000
A05	37109824	37112215	A05p38810.2_BraZ1	1710	+	786	2275	2391	0.9514847
A05	37113009	37114113	A05p38820.2_BraZ1	267	+	144	436	1104	0.3949275
A05	37114444	37115036	A05p38830.2_BraZ1	498	+	698	592	592	1.0000000
A05	37115419	37118955	A05p38840.2_BraZ1	2013.26	-	1496	3460	3536	0.9785068
A05	37124729	37126384	A05p38850.2_BraZ1	1362	-	460	1655	1655	1.0000000
A05	37140472	37145771	A05p38860.2_BraZ1	3196.96	-	2667	5235	5299	0.9879223
A05	37150537	37154123	A05p38870.2_BraZ1	1787	+	1645	3451	3586	0.9623536
A05	37154385	37155903	A05p38880.2_BraZ1	986.526	-	609	1463	1518	0.9637681
A05	37159707	37166827	A05p38890.2_BraZ1	3043.61	-	2357	6002	7120	0.8429775
A05	37168212	37174106	A05p38900.2_BraZ1	672	-	35132	5753	5894	0.9760774
A05	37177725	37178665	A05p38910.2_BraZ1	720	-	397	940	940	1.0000000
A05	37180741	37182123	A05p38920.2_BraZ1	524.25	+	32	25	1382	0.0180897
A05	37185958	37189119	A05p38930.2_BraZ1	1983	+	1958	3161	3161	1.0000000
A05	37191064	37191928	A05p38940.2_BraZ1	86.4	-	179	806	864	0.9328704
A05	37192303	37193431	A05p38950.2_BraZ1	112.8	+	228	808	1128	0.7163121
A05	37193981	37196941	A05p38960.2_BraZ1	1427.05	+	0	0	2960	0.0000000
A05	37196154	37197595	A05p38970.2_BraZ1	475.636	+	0	0	1441	0.0000000
A05	37202516	37205090	A05p38980.2_BraZ1	1006.2	-	4	44	2574	0.0170940
A05	37207601	37208674	A05p38990.2_BraZ1	547.238	+	475	1051	1073	0.9794967
A05	37209945	37220019	A05p39000.2_BraZ1	3898.74	+	2330	7848	10074	0.7790352
A05	37220870	37221277	A05p39010.2_BraZ1	267	+	366	407	407	1.0000000
A05	37222608	37225647	A05p39020.2_BraZ1	303.9	+	196	1550	3039	0.5100362
A05	37229729	37232404	A05p39030.2_BraZ1	1236	+	2753	2675	2675	1.0000000
A05	37234082	37234806	A05p39040.2_BraZ1	489	+	216	724	724	1.0000000
A05	37236933	37237353	A05p39050.2_BraZ1	42	-	249	420	420	1.0000000
A05	37253154	37254798	A05p39060.2_BraZ1	1458.59	+	968	1492	1644	0.9075426
A05	37256483	37258917	A05p39070.2_BraZ1	14647.5	+	1538	2434	2434	1.0000000
A05	37261422	37262781	A05p39080.2_BraZ1	546	+	312	1284	1359	0.9448124
A05	37266474	37266690	A05p39090.2_BraZ1	21.6	+	87	216	216	1.0000000
A05	37277516	37278961	A05p39100.2_BraZ1	1136.29	+	173	891	1445	0.6166090
A05	37280783	37283709	A05p39110.2_BraZ1	1396.15	-	2081	2926	2926	1.0000000
A05	37285735	37285963	A05p39120.2_BraZ1	22.8	+	90	228	228	1.0000000
A05	37288690	37290449	A05p39130.2_BraZ1	1392.22	+	526	1433	1759	0.8146674
A05	37291598	37294045	A05p39140.2_BraZ1	1928.21	-	2342	2447	2447	1.0000000
A05	37306569	37313730	A05p39150.2_BraZ1	1001.86	-	4336	7127	7161	0.9952521
A05	37331478	37331826	A05p39160.2_BraZ1	34.8	+	63	347	348	0.9971265
A05	37334452	37335091	A05p39170.2_BraZ1	219	-	608	639	639	1.0000000
A05	37336962	37339312	A05p39180.2_BraZ1	1611	-	1631	2122	2350	0.9029787
A05	37350966	37351341	A05p39190.2_BraZ1	243	-	230	375	375	1.0000000
A05	37351341	37352865	A05p39200.2_BraZ1	949.263	-	189	1129	1524	0.7408137
A05	37359163	37359946	A05p39210.2_BraZ1	294	-	115	702	783	0.8965517
A05	37360489	37361440	A05p39220.2_BraZ1	95.1	-	1106	951	951	1.0000000
A05	37363612	37363825	A05p39230.2_BraZ1	21.3	-	742	213	213	1.0000000
A05	37369985	37372272	A05p39240.2_BraZ1	1464.74	+	585	1829	2287	0.7997376
A05	37372583	37374030	A05p39250.2_BraZ1	1023.15	-	767	1301	1447	0.8991016
A05	37376548	37377690	A05p39260.2_BraZ1	339.286	-	557	1050	1142	0.9194396
A05	37389772	37391598	A05p39270.2_BraZ1	979.125	-	1121	1826	1826	1.0000000
A05	37392620	37403533	A05p39280.2_BraZ1	3919.51	-	1537	8305	10913	0.7610190
A05	37416915	37417167	A05p39290.2_BraZ1	25.2	+	586	252	252	1.0000000
A05	37420946	37421339	A05p39300.2_BraZ1	39.3	+	21	118	393	0.3002545
A05	37423609	37424041	A05p39310.2_BraZ1	276	-	50	400	432	0.9259259
A05	37429764	37429926	A05p39320.2_BraZ1	16.2	-	0	0	162	0.0000000
A05	37431266	37431890	A05p39330.2_BraZ1	62.4	-	329	624	624	1.0000000
A05	37432671	37437103	A05p39340.2_BraZ1	1854.96	-	1621	3636	4432	0.8203971
A05	37437418	37440390	A05p39350.2_BraZ1	770.264	+	1755	2847	2972	0.9579408
A05	37440921	37444706	A05p39360.2_BraZ1	2586.25	+	2902	3700	3785	0.9775429
A05	37446755	37447565	A05p39370.2_BraZ1	81	-	80	340	810	0.4197531
A05	37449290	37452345	A05p39380.2_BraZ1	2088	-	610	2045	3055	0.6693944
A05	37453112	37457352	A05p39390.2_BraZ1	2662.25	-	1776	4076	4240	0.9613208
A05	37458299	37459528	A05p39400.2_BraZ1	582.913	+	1599	1229	1229	1.0000000
A05	37459803	37461404	A05p39410.2_BraZ1	831	-	678	1551	1601	0.9687695
A05	37465632	37473004	A05p39420.2_BraZ1	540	+	3138	6189	7372	0.8395280
A05	37475430	37477564	A05p39430.2_BraZ1	1328.03	+	741	2123	2134	0.9948454
A05	37478340	37479580	A05p39440.2_BraZ1	558.36	+	470	1076	1240	0.8677419
A05	37488328	37492346	A05p39450.2_BraZ1	1512	+	1075	3230	4018	0.8038825
A05	37493043	37496908	A05p39460.2_BraZ1	1743.08	-	1121	3465	3865	0.8965071
A05	37497981	37499477	A05p39470.2_BraZ1	430.667	-	1	150	1496	0.1002674
A05	37502506	37503743	A05p39480.2_BraZ1	975	-	546	1196	1237	0.9668553
A05	37510996	37511914	A05p39490.2_BraZ1	3441.43	+	452	918	918	1.0000000
A05	37512067	37514196	A05p39500.2_BraZ1	1334.82	-	734	2000	2129	0.9394082
A05	37514908	37515281	A05p39510.2_BraZ1	282	-	7	108	373	0.2895442
A05	37517955	37521218	A05p39520.2_BraZ1	1459.2	+	1782	2623	3263	0.8038615
A05	37521903	37522617	A05p39530.2_BraZ1	272.589	-	412	714	714	1.0000000
A05	37524054	37524513	A05p39540.2_BraZ1	45.9	+	155	459	459	1.0000000
A05	37525051	37528620	A05p39550.2_BraZ1	1916.92	-	1414	3337	3569	0.9349958
A05	37529638	37532826	A05p39560.2_BraZ1	2024.16	-	2290	3132	3188	0.9824342
A05	37533831	37536437	A05p39570.2_BraZ1	5345.11	+	1007	2245	2606	0.8614735
A05	37536770	37540857	A05p39580.2_BraZ1	1846.17	-	881	3380	4087	0.8270125
A05	37554299	37559468	A05p39590.2_BraZ1	1800.09	+	2070	4608	5169	0.8914683
A05	37562074	37562587	A05p39600.2_BraZ1	51.3	+	161	393	513	0.7660819
A05	37562665	37562803	A05p39610.2_BraZ1	13.8	+	239	138	138	1.0000000
A05	37565034	37567328	A05p39620.2_BraZ1	2046	+	682	2128	2294	0.9276373
A05	37568227	37569679	A05p39630.2_BraZ1	1073.48	-	1471	1437	1452	0.9896694
A05	37572340	37572841	A05p39640.2_BraZ1	50.1	+	9	135	501	0.2694611
A05	37583505	37584006	A05p39650.2_BraZ1	50.1	+	0	0	501	0.0000000
A05	37596565	37610853	A05p39660.2_BraZ1	594.947	-	9786	13503	14288	0.9450588
A05	37598289	37598844	A05p39670.2_BraZ1	55.5	-	402	555	555	1.0000000
A05	37612020	37613890	A05p39680.2_BraZ1	958.333	-	961	1870	1870	1.0000000
A05	37614542	37616058	A05p39690.2_BraZ1	752.129	+	302	876	1516	0.5778364
A05	37616902	37619342	A05p39700.2_BraZ1	784.313	-	596	1692	2440	0.6934426
A05	37621980	37622925	A05p39710.2_BraZ1	660	+	42	402	945	0.4253968
A05	37623839	37629138	A05p39720.2_BraZ1	843.278	-	1907	4414	5299	0.8329874
A05	37629905	37630392	A05p39730.2_BraZ1	402	-	77	487	487	1.0000000
A05	37632133	37635121	A05p39740.2_BraZ1	2411.5	-	565	2536	2988	0.8487282
A05	37639654	37641796	A05p39750.2_BraZ1	1335.09	+	46	1081	2142	0.5046685
A05	37642815	37643343	A05p39760.2_BraZ1	381	-	210	460	528	0.8712121
A05	37647258	37649944	A05p39770.2_BraZ1	1302.37	+	107	1574	2686	0.5860015
A05	37650346	37651471	A05p39780.2_BraZ1	111.9	-	331	1113	1125	0.9893333
A05	37655192	37656081	A05p39790.2_BraZ1	279	-	282	889	889	1.0000000
A05	37658919	37662090	A05p39800.2_BraZ1	1140	-	825	1825	3171	0.5755282
A05	37662376	37663628	A05p39810.2_BraZ1	515.622	+	1164	1252	1252	1.0000000
A05	37663873	37668252	A05p39820.2_BraZ1	1381.21	-	2863	4359	4379	0.9954327
A05	37669490	37670040	A05p39830.2_BraZ1	33.6	-	75	472	550	0.8581818
A05	37670827	37671028	A05p39840.2_BraZ1	20.1	+	101	201	201	1.0000000
A05	37671311	37672864	A05p39850.2_BraZ1	738	-	682	1534	1553	0.9877656
A05	37676904	37678036	A05p39860.2_BraZ1	460.431	+	311	1105	1132	0.9761484
A05	37678327	37679883	A05p39870.2_BraZ1	756.441	-	781	1538	1556	0.9884319
A05	37684358	37704614	A05p39880.2_BraZ1	1306.51	-	11238	18266	20256	0.9017575
A05	37705846	37707760	A05p39890.2_BraZ1	1809	+	344	1558	1914	0.8140021
A05	37708299	37709033	A05p39900.2_BraZ1	339.3	+	598	734	734	1.0000000
A05	37711084	37712955	A05p39910.2_BraZ1	1320	+	532	1859	1871	0.9935863
A05	37713756	37716498	A05p39920.2_BraZ1	2061	-	1458	2742	2742	1.0000000
A05	37718883	37720685	A05p39930.2_BraZ1	975	+	366	841	1802	0.4667037
A05	37725938	37735899	A05p39940.2_BraZ1	909	+	3442	9027	9961	0.9062343
A05	37737461	37738724	A05p39950.2_BraZ1	555.75	-	180	1054	1263	0.8345210
A05	37746832	37748223	A05p39960.2_BraZ1	210	-	1195	1332	1391	0.9575845
A05	37755239	37756184	A05p39970.2_BraZ1	867	+	257	890	945	0.9417989
A05	37757005	37759944	A05p39980.2_BraZ1	1162.87	+	1459	2665	2939	0.9067710
A05	37760119	37760440	A05p39990.2_BraZ1	32.1	-	33	316	321	0.9844237
A05	37768862	37770283	A05p40000.2_BraZ1	1056	-	539	1129	1421	0.7945109
A05	37791393	37792595	A05p40010.2_BraZ1	983.444	-	147	983	1202	0.8178037
A05	37798682	37799784	A05p40020.2_BraZ1	753.455	-	161	966	1102	0.8765880
A05	37801215	37802152	A05p40030.2_BraZ1	243.048	+	416	889	937	0.9487727
A05	37806329	37806500	A05p40040.2_BraZ1	17.1	+	119	171	171	1.0000000
A05	37813186	37818267	A05p40050.2_BraZ1	2770.4	+	1981	4241	5081	0.8346782
A05	37818849	37819709	A05p40060.2_BraZ1	762	-	347	853	860	0.9918604
A05	37822392	37824218	A05p40070.2_BraZ1	1418.44	-	366	1723	1826	0.9435925
A05	37824766	37829059	A05p40080.2_BraZ1	1619.48	-	1099	3027	4293	0.7051013
A05	37829603	37830683	A05p40090.2_BraZ1	108	-	681	1080	1080	1.0000000
A05	37832993	37836645	A05p40100.2_BraZ1	1328.35	+	1840	3652	3652	1.0000000
A05	37836875	37839881	A05p40110.2_BraZ1	1971.56	-	1623	2778	3006	0.9241517
A05	37840499	37842028	A05p40120.2_BraZ1	2460	+	17	296	1529	0.1935906
A05	37845016	37846095	A05p40130.2_BraZ1	696.316	-	211	947	1079	0.8776645
A05	37847377	37848618	A05p40140.2_BraZ1	579	-	543	1216	1241	0.9798549
A05	37849344	37849797	A05p40150.2_BraZ1	45.3	-	594	453	453	1.0000000
A05	37850213	37852792	A05p40160.2_BraZ1	1322.4	-	917	2515	2579	0.9751842
A05	37855121	37855539	A05p40170.2_BraZ1	204	+	646	418	418	1.0000000
A05	37856193	37856898	A05p40180.2_BraZ1	63	+	359	663	705	0.9404255
A05	37857051	37857486	A05p40190.2_BraZ1	43.5	-	34	352	435	0.8091954
A05	37859515	37860346	A05p40200.2_BraZ1	83.1	+	103	716	831	0.8616125
A05	37861289	37861785	A05p40210.2_BraZ1	408	-	118	496	496	1.0000000
A05	37863935	37866833	A05p40220.2_BraZ1	1984.61	+	651	2674	2898	0.9227053
A05	37867210	37868734	A05p40230.2_BraZ1	1271.27	-	333	1469	1524	0.9639108
A05	37869508	37891421	A05p40240.2_BraZ1	1217.2	+	9747	20559	21913	0.9382102
A05	37873348	37875205	A05p40250.2_BraZ1	808.734	-	615	1612	1857	0.8680668
A05	37885129	37886912	A05p40260.2_BraZ1	257.25	-	1170	1706	1783	0.9568143
A05	37898875	37899544	A05p40270.2_BraZ1	66.9	+	184	653	669	0.9760837
A05	37900507	37901750	A05p40280.2_BraZ1	838.174	-	594	1176	1243	0.9460981
A05	37902074	37902664	A05p40290.2_BraZ1	462	+	184	590	590	1.0000000
A05	37905369	37905980	A05p40300.2_BraZ1	540	+	155	484	611	0.7921440
A05	37906261	37907734	A05p40310.2_BraZ1	840.341	-	1192	1473	1473	1.0000000
A05	37908700	37909420	A05p40320.2_BraZ1	72	+	400	681	720	0.9458333
A05	37909911	37912160	A05p40330.2_BraZ1	1031.1	-	845	1911	2249	0.8497110
A05	37916833	37922184	A05p40340.2_BraZ1	1769.87	+	2320	5216	5351	0.9747711
A05	37936470	37937097	A05p40350.2_BraZ1	62.7	-	181	627	627	1.0000000
A05	37937494	37937951	A05p40360.2_BraZ1	984	+	22	396	457	0.8665208
A05	37943406	37944993	A05p40370.2_BraZ1	158.7	+	975	1587	1587	1.0000000
A05	37945089	37946193	A05p40380.2_BraZ1	603.286	-	486	1084	1104	0.9818841
A05	37946588	37950026	A05p40390.2_BraZ1	1566.41	-	3550	3438	3438	1.0000000
A05	37951786	37953338	A05p40400.2_BraZ1	727.273	+	577	1552	1552	1.0000000
A05	37953674	37955371	A05p40410.2_BraZ1	966.136	+	712	1578	1697	0.9298763
A05	37956495	37957615	A05p40420.2_BraZ1	9376.5	+	88	874	1120	0.7803571
A05	37958113	37959590	A05p40430.2_BraZ1	84.6	+	1544	1477	1477	1.0000000
A05	37960617	37962597	A05p40440.2_BraZ1	195.3	-	1871	1972	1980	0.9959596
A05	37966481	37970758	A05p40450.2_BraZ1	1654.16	-	2249	4068	4277	0.9511340
A05	37972938	37973122	A05p40460.2_BraZ1	168	-	70	180	184	0.9782609
A05	37974580	37976344	A05p40470.2_BraZ1	1319.76	+	656	1733	1764	0.9824263
A05	37979394	37980042	A05p40480.2_BraZ1	64.8	+	310	648	648	1.0000000
A05	37981969	37983199	A05p40490.2_BraZ1	123	-	694	1213	1230	0.9861789
A05	37995023	37996790	A05p40500.2_BraZ1	1029.89	-	443	1623	1767	0.9185060
A05	37998271	38000235	A05p40510.2_BraZ1	1145.31	-	582	1782	1964	0.9073320
A05	38003779	38006035	A05p40520.2_BraZ1	573	-	1220	1818	2256	0.8058510
A05	38009220	38010367	A05p40530.2_BraZ1	903	-	806	1147	1147	1.0000000
A05	38016628	38018613	A05p40540.2_BraZ1	312	-	1083	1934	1985	0.9743073
A05	38020586	38021135	A05p40550.2_BraZ1	54.9	+	601	549	549	1.0000000
A05	38022791	38026850	A05p40560.2_BraZ1	3175.96	+	2351	3851	4059	0.9487559
A05	38027322	38037337	A05p40570.2_BraZ1	2208.75	+	4926	9769	10015	0.9754369
A05	38038110	38042717	A05p40580.2_BraZ1	2581.33	-	1654	4526	4607	0.9824181
A05	38046521	38050755	A05p40590.2_BraZ1	1750.56	-	1434	4234	4234	1.0000000
A05	38051143	38052955	A05p40600.2_BraZ1	181.2	+	75	1097	1812	0.6054084
A05	38053353	38057629	A05p40610.2_BraZ1	1716.7	-	1201	4149	4276	0.9702994
A05	38059040	38061203	A05p40620.2_BraZ1	4760	-	996	2130	2163	0.9847434
A05	38062270	38063575	A05p40630.2_BraZ1	129.3	-	326	1111	1305	0.8513410
A05	38067521	38068531	A05p40640.2_BraZ1	3654	+	32	795	1010	0.7871287
A05	38070818	38071060	A05p40650.2_BraZ1	165	+	440	242	242	1.0000000
A05	38072152	38073630	A05p40660.2_BraZ1	878.952	-	240	859	1478	0.5811908
A05	38074814	38075243	A05p40670.2_BraZ1	42.9	-	51	329	429	0.7668998
A05	38075955	38076237	A05p40680.2_BraZ1	222	-	0	0	282	0.0000000
A05	38077747	38078821	A05p40690.2_BraZ1	107.4	+	770	1074	1074	1.0000000
A05	38079693	38087029	A05p40700.2_BraZ1	306.3	-	4859	7050	7336	0.9610142
A05	38091421	38103777	A05p40710.2_BraZ1	2446.7	-	4849	10093	12356	0.8168501
A05	38107894	38109774	A05p40720.2_BraZ1	1163.33	-	897	1880	1880	1.0000000
A05	38111896	38113009	A05p40730.2_BraZ1	111.3	+	133	719	1113	0.6460018
A05	38113387	38115520	A05p40740.2_BraZ1	2043	-	166	1308	2133	0.6132208
A05	38122219	38123656	A05p40750.2_BraZ1	550.252	+	852	1437	1437	1.0000000
A05	38130227	38131810	A05p40760.2_BraZ1	962.476	+	523	1583	1583	1.0000000
A05	38132302	38133393	A05p40770.2_BraZ1	15075	+	488	1091	1091	1.0000000
A05	38135472	38137841	A05p40780.2_BraZ1	1952.28	-	674	2292	2369	0.9674968
A05	38141230	38141866	A05p40790.2_BraZ1	63.6	-	343	636	636	1.0000000
A05	38144789	38146656	A05p40800.2_BraZ1	730.125	-	898	1867	1867	1.0000000
A05	38147590	38149598	A05p40810.2_BraZ1	1389.38	-	651	1977	2008	0.9845617
A05	38150404	38152849	A05p40820.2_BraZ1	1395.36	-	389	1988	2445	0.8130879
A05	38153905	38170592	A05p40830.2_BraZ1	3348.83	-	7194	14908	16687	0.8933901
A05	38170966	38174616	A05p40840.2_BraZ1	490.754	-	1295	3357	3650	0.9197260
A05	38176895	38179952	A05p40850.2_BraZ1	1892.89	+	790	2903	3057	0.9496238
A05	38180328	38181525	A05p40860.2_BraZ1	119.7	-	412	1197	1197	1.0000000
A05	38184051	38184547	A05p40870.2_BraZ1	237	+	437	496	496	1.0000000
A05	38185932	38196200	A05p40880.2_BraZ1	5379.18	-	3824	9749	10268	0.9494546
A05	38198919	38199384	A05p40890.2_BraZ1	46.5	-	123	396	465	0.8516129
A05	38209444	38217282	A05p40900.2_BraZ1	1115.22	+	1581	3797	7838	0.4844348
A05	38217965	38219492	A05p40910.2_BraZ1	1040.73	-	1423	1527	1527	1.0000000
A05	38220034	38220502	A05p40920.2_BraZ1	46.8	+	153	468	468	1.0000000
A05	38221540	38221930	A05p40930.2_BraZ1	39	-	493	390	390	1.0000000
A05	38222355	38225484	A05p40940.2_BraZ1	312.9	-	737	2661	3129	0.8504314
A05	38226536	38226807	A05p40950.2_BraZ1	129	-	352	271	271	1.0000000
A05	38227086	38231307	A05p40960.2_BraZ1	422.1	+	463	1998	4221	0.4733475
A05	38231597	38233719	A05p40970.2_BraZ1	897.184	-	1537	2122	2122	1.0000000
A05	38249944	38254807	A05p40980.2_BraZ1	436.8	-	6758	4863	4863	1.0000000
A05	38264127	38265921	A05p40990.2_BraZ1	179.4	+	38	1319	1794	0.7352285
A05	38274849	38275176	A05p41000.2_BraZ1	231	+	275	327	327	1.0000000
A05	38276048	38278131	A05p41010.2_BraZ1	985.279	-	596	1891	2083	0.9078252
A05	38279083	38282265	A05p41020.2_BraZ1	908.727	-	1741	3071	3182	0.9651163
A05	38284589	38286659	A05p41030.2_BraZ1	831.333	+	1240	2001	2070	0.9666666
A05	38287369	38290221	A05p41040.2_BraZ1	1822.27	+	1386	2502	2852	0.8772791
A05	38290893	38291124	A05p41050.2_BraZ1	23.1	-	63	169	231	0.7316017
A05	38296399	38296997	A05p41060.2_BraZ1	519	+	4	133	598	0.2224080
A05	38315286	38316726	A05p41070.2_BraZ1	144	+	112	1207	1440	0.8381944
A05	38319021	38319171	A05p41080.2_BraZ1	14.7	+	4	87	150	0.5800000
A05	38319193	38319547	A05p41090.2_BraZ1	35.4	-	137	315	354	0.8898305
A05	38319870	38321756	A05p41100.2_BraZ1	1418.22	-	466	1677	1886	0.8891835
A05	38326215	38330450	A05p41110.2_BraZ1	2009.82	+	1474	4143	4235	0.9782763
A05	38331334	38333320	A05p41120.2_BraZ1	384.3	+	1120	1986	1986	1.0000000
A05	38337921	38340977	A05p41130.2_BraZ1	1799.36	+	1285	2890	3056	0.9456806
A05	38343315	38343957	A05p41140.2_BraZ1	422.609	+	422	642	642	1.0000000
A05	38345246	38346301	A05p41150.2_BraZ1	7056	+	1030	1055	1055	1.0000000
A05	38348634	38350953	A05p41160.2_BraZ1	231.3	+	137	1455	2319	0.6274256
A05	38352538	38353046	A05p41170.2_BraZ1	309	-	192	404	508	0.7952756
A05	38357733	38359442	A05p41180.2_BraZ1	15960	+	349	1410	1709	0.8250439
A05	38361557	38363441	A05p41190.2_BraZ1	1110.94	+	1418	1875	1884	0.9952229
A05	38364710	38366147	A05p41200.2_BraZ1	1122	+	797	1419	1437	0.9874739
A05	38367111	38369098	A05p41210.2_BraZ1	965.019	-	1210	1977	1987	0.9949673
A05	38370992	38371607	A05p41220.2_BraZ1	61.5	-	583	615	615	1.0000000
A05	38380686	38382934	A05p41230.2_BraZ1	1015.88	-	276	1668	2248	0.7419929
A05	38385044	38386087	A05p41240.2_BraZ1	2445.33	-	429	1043	1043	1.0000000
A05	38409408	38409865	A05p41250.2_BraZ1	222	+	106	418	457	0.9146608
A05	38410059	38410474	A05p41260.2_BraZ1	273	+	82	315	415	0.7590361
A05	38413047	38413608	A05p41270.2_BraZ1	1270.5	-	85	561	561	1.0000000
A05	38423388	38427565	A05p41280.2_BraZ1	2110.06	+	2241	4174	4177	0.9992818
A05	38428593	38429976	A05p41290.2_BraZ1	642.884	+	976	1383	1383	1.0000000
A05	38431123	38432431	A05p41300.2_BraZ1	1179	+	426	1127	1308	0.8616208
A05	38433346	38433779	A05p41310.2_BraZ1	303	+	112	411	433	0.9491917
A05	38436044	38441422	A05p41320.2_BraZ1	2773.73	+	1734	4881	5378	0.9075865
A05	38442160	38443932	A05p41330.2_BraZ1	1161.36	+	989	1772	1772	1.0000000
A05	38444171	38445847	A05p41340.2_BraZ1	1343.33	-	887	1617	1676	0.9647971
A05	38445996	38450893	A05p41350.2_BraZ1	1154.25	+	2441	4632	4897	0.9458852
A05	38451124	38458638	A05p41360.2_BraZ1	2759.14	-	2477	6593	7514	0.8774288
A05	38459077	38460597	A05p41370.2_BraZ1	890.542	+	1107	1520	1520	1.0000000
A05	38462092	38464111	A05p41380.2_BraZ1	1857	+	804	1961	2019	0.9712729
A05	38464487	38465619	A05p41390.2_BraZ1	12384	-	983	1132	1132	1.0000000
A05	38468560	38470489	A05p41400.2_BraZ1	192.9	+	591	1888	1929	0.9787455
A05	38471046	38473377	A05p41410.2_BraZ1	233.1	+	498	2193	2331	0.9407979
A05	38477051	38479521	A05p41420.2_BraZ1	2001.39	+	938	2074	2470	0.8396761
A05	38480890	38482421	A05p41430.2_BraZ1	153	-	122	999	1531	0.6525147
A05	38487605	38489842	A05p41440.2_BraZ1	1033.77	+	862	2160	2237	0.9655789
A05	38493120	38497656	A05p41450.2_BraZ1	1956.45	+	1449	3999	4536	0.8816137
A05	38503528	38504629	A05p41460.2_BraZ1	110.1	+	504	904	1101	0.8210717
A05	38510719	38512123	A05p41470.2_BraZ1	1163.25	+	1397	1404	1404	1.0000000
A05	38512936	38513485	A05p41480.2_BraZ1	54.9	+	486	549	549	1.0000000
A05	38515384	38516912	A05p41490.2_BraZ1	1196.17	-	117	1075	1528	0.7035340
A05	38521265	38522336	A05p41500.2_BraZ1	657	-	264	932	1071	0.8702148
A05	38524552	38527996	A05p41510.2_BraZ1	1595.17	-	3000	3444	3444	1.0000000
A05	38529758	38531188	A05p41520.2_BraZ1	19762.5	+	291	1417	1430	0.9909091
A05	38537936	38538209	A05p41530.2_BraZ1	27.3	+	79	273	273	1.0000000
A05	38549382	38550752	A05p41540.2_BraZ1	859.737	+	1417	1370	1370	1.0000000
A05	38551652	38552569	A05p41550.2_BraZ1	1176	-	1025	917	917	1.0000000
A05	38555296	38559753	A05p41560.2_BraZ1	1440	+	1164	3894	4457	0.8736818
A05	38561433	38562207	A05p41570.2_BraZ1	77.4	-	12	59	774	0.0762274
A05	38568311	38568521	A05p41580.2_BraZ1	21	+	30	178	210	0.8476191
A05	38570500	38579099	A05p41590.2_BraZ1	8365.5	-	3581	5495	8599	0.6390278
A05	38581599	38582276	A05p41600.2_BraZ1	411	-	322	677	677	1.0000000
A05	38585930	38588170	A05p41610.2_BraZ1	366.709	-	1575	2213	2240	0.9879465
A05	38594258	38598460	A05p41620.2_BraZ1	1531.73	+	812	3578	4202	0.8514993
A05	38600781	38602877	A05p41630.2_BraZ1	1414.44	+	899	2029	2096	0.9680343
A05	38603011	38604727	A05p41640.2_BraZ1	770.079	-	1511	1716	1716	1.0000000
A05	38605138	38606408	A05p41650.2_BraZ1	894	-	777	1270	1270	1.0000000
A05	38607395	38610296	A05p41660.2_BraZ1	1879.02	+	1727	2678	2901	0.9231300
A05	38610451	38612329	A05p41670.2_BraZ1	187.8	-	553	1722	1878	0.9169329
A05	38613617	38617982	A05p41680.2_BraZ1	2297.99	-	1295	4217	4365	0.9660940
A05	38629300	38630813	A05p41690.2_BraZ1	666	-	900	1513	1513	1.0000000
A05	38634030	38636718	A05p41700.2_BraZ1	1440.86	+	305	1738	2688	0.6465774
A05	38638654	38639200	A05p41710.2_BraZ1	54.6	+	327	546	546	1.0000000
A05	38640315	38642002	A05p41720.2_BraZ1	662.893	+	1791	1687	1687	1.0000000
A05	38642881	38645793	A05p41730.2_BraZ1	2093.73	-	1199	2755	2912	0.9460852
A05	38659040	38662682	A05p41740.2_BraZ1	1949.3	-	938	3097	3642	0.8503569
A05	38663931	38664492	A05p41750.2_BraZ1	56.1	-	439	561	561	1.0000000
A05	38666207	38666580	A05p41760.2_BraZ1	342	+	679	373	373	1.0000000
A05	38667871	38669433	A05p41770.2_BraZ1	1434	+	172	1106	1562	0.7080666
A05	38669730	38671267	A05p41780.2_BraZ1	3029.37	-	635	1491	1537	0.9700716
A05	38674647	38674767	A05p41790.2_BraZ1	12	+	137	120	120	1.0000000
A05	38676223	38678369	A05p41800.2_BraZ1	1694.97	-	660	2060	2146	0.9599254
A05	38687370	38688852	A05p41810.2_BraZ1	148.2	+	27	775	1482	0.5229419
A05	38689928	38691413	A05p41820.2_BraZ1	148.5	+	590	1172	1485	0.7892256
A05	38695531	38696998	A05p41830.2_BraZ1	92.4	+	184	614	1467	0.4185413
A05	38698733	38699975	A05p41840.2_BraZ1	124.2	+	1222	1242	1242	1.0000000
A05	38700634	38701138	A05p41850.2_BraZ1	1003	-	294	504	504	1.0000000
A05	38702750	38703127	A05p41860.2_BraZ1	234	+	1061	377	377	1.0000000
A05	38703949	38705407	A05p41870.2_BraZ1	145.8	+	1104	1458	1458	1.0000000
A05	38706755	38707541	A05p41880.2_BraZ1	366	+	796	786	786	1.0000000
A05	38709267	38711011	A05p41890.2_BraZ1	1437.55	+	971	1725	1744	0.9891055
A05	38711720	38712934	A05p41900.2_BraZ1	535.273	+	781	1081	1214	0.8904448
A05	38716755	38718045	A05p41910.2_BraZ1	768	-	730	1290	1290	1.0000000
A05	38719780	38720176	A05p41920.2_BraZ1	39.6	-	241	396	396	1.0000000
A05	38721709	38722337	A05p41930.2_BraZ1	549	+	1016	628	628	1.0000000
A05	38724760	38725214	A05p41940.2_BraZ1	156	-	497	410	454	0.9030837
A05	38729819	38731831	A05p41950.2_BraZ1	1355.27	-	957	1950	2012	0.9691849
A05	38739817	38740599	A05p41960.2_BraZ1	221	-	237	766	782	0.9795396
A05	38741618	38742931	A05p41970.2_BraZ1	380.25	-	171	776	1313	0.5910130
A05	38742938	38743166	A05p41980.2_BraZ1	22.8	-	19	228	228	1.0000000
A05	38744167	38744422	A05p41990.2_BraZ1	25.5	-	415	255	255	1.0000000
A05	38747498	38748050	A05p42000.2_BraZ1	513	-	44	411	552	0.7445652
A05	38748996	38749548	A05p42010.2_BraZ1	513	-	91	552	552	1.0000000
A05	38753437	38754004	A05p42020.2_BraZ1	528	-	188	567	567	1.0000000
A05	38754945	38756989	A05p42030.2_BraZ1	615.6	-	483	2033	2044	0.9946184
A05	38759398	38759950	A05p42040.2_BraZ1	513	-	114	552	552	1.0000000
A05	38761057	38766385	A05p42050.2_BraZ1	1780.11	+	2459	4761	5328	0.8935811
A05	38766490	38766817	A05p42060.2_BraZ1	32.7	+	309	327	327	1.0000000
A05	38767256	38769768	A05p42070.2_BraZ1	1188	-	3457	2512	2512	1.0000000
A05	38771386	38773974	A05p42080.2_BraZ1	1657.74	+	1105	2258	2588	0.8724884
A05	38776242	38776915	A05p42090.2_BraZ1	198	-	948	673	673	1.0000000
A05	38778093	38778680	A05p42100.2_BraZ1	303	-	16	190	587	0.3236797
A05	38780903	38784114	A05p42110.2_BraZ1	1104.95	-	2378	3211	3211	1.0000000
A05	38785039	38788508	A05p42120.2_BraZ1	1598.44	-	1787	3216	3469	0.9270683
A05	38788875	38789976	A05p42130.2_BraZ1	1015.88	-	505	1049	1101	0.9527702
A05	38790439	38792322	A05p42140.2_BraZ1	864.23	+	776	1470	1883	0.7806692
A05	38808997	38811390	A05p42150.2_BraZ1	1659	-	472	2089	2393	0.8729628
A05	38814241	38816156	A05p42160.2_BraZ1	1688.34	+	118	1308	1915	0.6830287
A05	38816507	38819774	A05p42170.2_BraZ1	326.7	-	1387	3215	3267	0.9840832
A05	38837816	38838700	A05p42180.2_BraZ1	229.5	-	405	884	884	1.0000000
A05	38839938	38841175	A05p42190.2_BraZ1	490	+	701	1152	1237	0.9312854
A05	38845159	38847053	A05p42200.2_BraZ1	842.842	+	378	1545	1894	0.8157339
A05	38858879	38859289	A05p42210.2_BraZ1	52.6667	-	154	398	410	0.9707317
A05	38862261	38863096	A05p42220.2_BraZ1	2047	+	0	0	835	0.0000000
A05	38864167	38866103	A05p42230.2_BraZ1	466	-	364	1787	1936	0.9230372
A05	38867474	38873061	A05p42240.2_BraZ1	501.75	+	352	3332	5587	0.5963845
A05	38869033	38872126	A05p42250.2_BraZ1	406.72	-	226	2338	3093	0.7559004
A05	38874133	38876188	A05p42260.2_BraZ1	1095.69	-	1133	1921	2055	0.9347932
A05	38878010	38880052	A05p42270.2_BraZ1	1113.98	-	833	2029	2042	0.9936337
A05	38887389	38887869	A05p42280.2_BraZ1	48	+	49	242	480	0.5041667
A05	38888476	38894138	A05p42290.2_BraZ1	3859.17	-	1128	4222	5662	0.7456729
A05	38896626	38901864	A05p42300.2_BraZ1	3377.11	-	734	3390	5238	0.6471936
A05	38902365	38902638	A05p42310.2_BraZ1	27.3	+	125	273	273	1.0000000
A05	38903188	38903380	A05p42320.2_BraZ1	19.2	+	9	190	192	0.9895833
A05	38904981	38907361	A05p42330.2_BraZ1	840	-	935	2062	2380	0.8663865
A05	38908973	38909417	A05p42340.2_BraZ1	186	+	685	444	444	1.0000000
A05	38910505	38920847	A05p42350.2_BraZ1	659.748	-	7181	9504	10342	0.9189712
A05	38923227	38924810	A05p42360.2_BraZ1	693.769	-	969	1464	1583	0.9248263
A05	38925307	38927044	A05p42370.2_BraZ1	9840	-	805	1014	1737	0.5837651
A05	38928752	38929070	A05p42380.2_BraZ1	31.8	+	132	318	318	1.0000000
A05	38932833	38933551	A05p42390.2_BraZ1	621	+	242	674	718	0.9387187
A05	38937226	38937820	A05p42400.2_BraZ1	59.4	-	298	542	594	0.9124579
A05	38939343	38940289	A05p42410.2_BraZ1	556.731	+	409	861	946	0.9101480
A05	38943505	38951233	A05p42420.2_BraZ1	4566.49	+	4033	7511	7728	0.9719203
A05	38955723	38957712	A05p42430.2_BraZ1	198.9	+	1	25	1989	0.0125691
A05	38958891	38959445	A05p42440.2_BraZ1	375	+	1	30	554	0.0541516
A05	38962045	38964034	A05p42450.2_BraZ1	198.9	+	2	75	1989	0.0377074
A05	38967180	38970684	A05p42460.2_BraZ1	1866	+	635	1979	3504	0.5647831
A05	38971522	38975133	A05p42470.2_BraZ1	1845.45	+	2410	3531	3611	0.9778455
A05	38976073	38979313	A05p42480.2_BraZ1	1777.87	-	909	2796	3240	0.8629630
A05	38980715	38983700	A05p42490.2_BraZ1	1543.48	-	1697	2965	2985	0.9932998
A05	38984890	38989108	A05p42500.2_BraZ1	368	+	1980	4218	4218	1.0000000
A05	38986069	38987980	A05p42510.2_BraZ1	8154	+	439	1911	1911	1.0000000
A05	38989993	38992377	A05p42520.2_BraZ1	1519.97	+	1088	2204	2384	0.9244967
A05	38993957	38994742	A05p42530.2_BraZ1	476.308	-	383	742	785	0.9452229
A05	38996271	38998223	A05p42540.2_BraZ1	807.3	-	989	1832	1952	0.9385246
A05	38999775	39000879	A05p42550.2_BraZ1	110.4	+	172	969	1104	0.8777174
A05	39003715	39004360	A05p42560.2_BraZ1	234	+	409	645	645	1.0000000
A05	39005993	39008055	A05p42570.2_BraZ1	15345	+	636	1937	2062	0.9393792
A05	39008685	39009893	A05p42580.2_BraZ1	526.575	-	612	1091	1208	0.9031457
A05	39010998	39012091	A05p42590.2_BraZ1	813.714	-	419	1093	1093	1.0000000
A05	39024307	39030386	A05p42600.2_BraZ1	687.789	+	640	4081	6079	0.6713275
A05	39038407	39039805	A05p42610.2_BraZ1	984	-	315	1010	1398	0.7224607
A05	39042138	39042435	A05p42620.2_BraZ1	29.7	-	387	297	297	1.0000000
A05	39045342	39048696	A05p42630.2_BraZ1	855	+	16	553	3354	0.1648778
A05	39059702	39061311	A05p42640.2_BraZ1	1036.32	-	17	257	1609	0.1597265
A05	39067634	39068666	A05p42650.2_BraZ1	692.391	-	7	129	1032	0.1250000
A05	39070280	39071285	A05p42660.2_BraZ1	487.667	+	460	999	1005	0.9940299
A05	39075583	39076129	A05p42670.2_BraZ1	54.6	-	457	546	546	1.0000000
A05	39076984	39079805	A05p42680.2_BraZ1	528	+	368	2365	2821	0.8383552
A05	39082547	39083342	A05p42690.2_BraZ1	288.4	-	0	0	795	0.0000000
A05	39083434	39085126	A05p42700.2_BraZ1	6885	-	96	838	1692	0.4952719
A05	39085211	39086868	A05p42710.2_BraZ1	1257.6	-	383	1098	1657	0.6626433
A05	39087738	39088350	A05p42720.2_BraZ1	61.2	+	308	612	612	1.0000000
A05	39105505	39105904	A05p42730.2_BraZ1	39.9	+	230	383	399	0.9598997
A05	39107755	39107926	A05p42740.2_BraZ1	17.1	+	303	171	171	1.0000000
A05	39109741	39117990	A05p42750.2_BraZ1	5562.55	-	1214	4301	8249	0.5213965
A05	39119548	39124285	A05p42760.2_BraZ1	1466.72	+	2375	4581	4737	0.9670678
A05	39124849	39126001	A05p42770.2_BraZ1	115.2	-	501	1152	1152	1.0000000
A05	39128067	39129623	A05p42780.2_BraZ1	714	+	1300	1437	1556	0.9235219
A05	39132000	39134178	A05p42790.2_BraZ1	2085	+	336	2080	2178	0.9550046
A05	39134340	39136187	A05p42800.2_BraZ1	609.412	-	562	1682	1847	0.9106659
A05	39138774	39139907	A05p42810.2_BraZ1	1062	+	329	1129	1133	0.9964696
A05	39140289	39141939	A05p42820.2_BraZ1	998.493	-	774	1633	1650	0.9896970
A05	39143408	39144623	A05p42830.2_BraZ1	702	+	105	528	1215	0.4345679
A05	39152765	39153822	A05p42840.2_BraZ1	7965	+	90	808	1057	0.7644276
A05	39155586	39156888	A05p42850.2_BraZ1	942	+	300	888	1302	0.6820276
A05	39158165	39160225	A05p42860.2_BraZ1	1350	-	427	1650	2060	0.8009709
A05	39161696	39163630	A05p42870.2_BraZ1	1329	-	545	1508	1934	0.7797312
A05	39173679	39175940	A05p42880.2_BraZ1	1716	+	566	2079	2261	0.9195046
A05	39176910	39180498	A05p42890.2_BraZ1	1426.27	+	1240	3205	3588	0.8932553
A05	39181610	39185176	A05p42900.2_BraZ1	1667.37	+	1550	3529	3566	0.9896242
A05	39186115	39186928	A05p42910.2_BraZ1	81.3	-	141	499	813	0.6137761
A05	39187622	39188330	A05p42920.2_BraZ1	70.8	+	587	708	708	1.0000000
A05	39191078	39191558	A05p42930.2_BraZ1	48	-	57	440	480	0.9166667
A05	39192650	39194211	A05p42940.2_BraZ1	1071.62	+	432	1514	1561	0.9698911
A05	39195439	39196411	A05p42950.2_BraZ1	498.273	-	483	972	972	1.0000000
A05	39200715	39203143	A05p42960.2_BraZ1	1613.65	+	1315	2370	2428	0.9761120
A05	39203808	39206214	A05p42970.2_BraZ1	1789.17	-	853	2358	2406	0.9800498
A05	39208292	39208574	A05p42980.2_BraZ1	28.2	+	27	102	282	0.3617021
A05	39209120	39213544	A05p42990.2_BraZ1	1701.81	-	868	3234	4424	0.7310126
A05	39213606	39214444	A05p43000.2_BraZ1	172.8	-	164	838	838	1.0000000
A05	39214087	39214326	A05p43010.2_BraZ1	147	+	75	239	239	1.0000000
A05	39216007	39217378	A05p43020.2_BraZ1	8236.5	+	301	1127	1371	0.8220277
A05	39219373	39220355	A05p43030.2_BraZ1	498.947	+	476	979	982	0.9969450
A05	39220604	39221938	A05p43040.2_BraZ1	330	-	919	1301	1334	0.9752623
A05	39223499	39224567	A05p43050.2_BraZ1	536.905	-	376	1062	1068	0.9943820
A05	39224887	39228092	A05p43060.2_BraZ1	2032.79	+	825	3174	3205	0.9903276
A05	39228626	39229139	A05p43070.2_BraZ1	51.3	+	89	339	513	0.6608187
A05	39230198	39233474	A05p43080.2_BraZ1	889.434	-	1165	3100	3276	0.9462759
A05	39234114	39234657	A05p43090.2_BraZ1	54.3	+	236	543	543	1.0000000
A05	39235806	39236989	A05p43100.2_BraZ1	699.079	-	960	1183	1183	1.0000000
A05	39238570	39240227	A05p43110.2_BraZ1	838.5	-	380	1645	1657	0.9927580
A05	39241180	39245851	A05p43120.2_BraZ1	2829.72	+	195	2919	4671	0.6249197
A05	39246265	39248815	A05p43130.2_BraZ1	1312.2	-	1075	2413	2550	0.9462745
A05	39249196	39250427	A05p43140.2_BraZ1	429	+	917	1175	1231	0.9545085
A05	39250952	39252846	A05p43150.2_BraZ1	922.404	-	667	1863	1894	0.9836325
A05	39254587	39260667	A05p43160.2_BraZ1	1052.26	-	3128	5845	6080	0.9613487
A05	39256515	39256934	A05p43170.2_BraZ1	231	+	366	419	419	1.0000000
A05	39261307	39262845	A05p43180.2_BraZ1	669	+	595	913	1538	0.5936281
A05	39264928	39266844	A05p43190.2_BraZ1	1020.52	+	892	1916	1916	1.0000000
A05	39267671	39269078	A05p43200.2_BraZ1	972	+	376	1357	1407	0.9644634
A05	39270147	39271518	A05p43210.2_BraZ1	902	+	120	794	1371	0.5791393
A05	39272737	39274099	A05p43220.2_BraZ1	972	+	168	947	1362	0.6953011
A05	39279064	39280417	A05p43230.2_BraZ1	135.3	+	322	1353	1353	1.0000000
A05	39286377	39286572	A05p43240.2_BraZ1	19.5	-	6	188	195	0.9641026
A05	39288360	39288555	A05p43250.2_BraZ1	19.5	-	0	0	195	0.0000000
A05	39290372	39290567	A05p43260.2_BraZ1	19.5	-	0	0	195	0.0000000
A05	39292351	39292546	A05p43270.2_BraZ1	19.5	-	82	195	195	1.0000000
A05	39294124	39294316	A05p43280.2_BraZ1	19.2	-	43	192	192	1.0000000
A05	39295701	39297292	A05p43290.2_BraZ1	716.625	+	892	1591	1591	1.0000000
A05	39298452	39300944	A05p43300.2_BraZ1	1374	+	1274	2238	2492	0.8980739
A05	39301709	39303430	A05p43310.2_BraZ1	105084	-	622	1573	1721	0.9140035
A05	39304848	39307831	A05p43320.2_BraZ1	1143.38	+	1232	2584	2983	0.8662421
A05	39309473	39310790	A05p43330.2_BraZ1	849	+	370	1155	1317	0.8769932
A05	39311057	39314413	A05p43340.2_BraZ1	1898.86	-	834	3165	3356	0.9430870
A05	39315496	39320429	A05p43350.2_BraZ1	1422.32	-	4638	4601	4933	0.9326981
A05	39322555	39324255	A05p43360.2_BraZ1	2829.94	-	833	1691	1700	0.9947059
A05	39325309	39326658	A05p43370.2_BraZ1	609.6	+	3182	1349	1349	1.0000000
A05	39327239	39333782	A05p43380.2_BraZ1	2163.02	-	4593	6215	6543	0.9498701
A05	39335689	39336481	A05p43390.2_BraZ1	591	-	355	792	792	1.0000000
A05	39338611	39339145	A05p43400.2_BraZ1	53.4	-	164	534	534	1.0000000
A05	39340469	39340967	A05p43410.2_BraZ1	49.8	-	78	498	498	1.0000000
A05	39342288	39342786	A05p43420.2_BraZ1	49.8	-	30	330	498	0.6626506
A05	39344726	39349520	A05p43430.2_BraZ1	1431	-	2463	4584	4794	0.9561952
A05	39349893	39352455	A05p43440.2_BraZ1	1710.43	-	1253	2358	2562	0.9203747
A05	39355426	39367966	A05p43450.2_BraZ1	5604.53	+	3301	10014	12540	0.7985646
A05	39368177	39370685	A05p43460.2_BraZ1	1425	-	1767	2296	2508	0.9154705
A05	39378042	39379384	A05p43470.2_BraZ1	93.8	-	997	1259	1342	0.9381520
A05	39379541	39386613	A05p43480.2_BraZ1	3812.25	-	1825	6078	7072	0.8594457
A05	39388666	39393416	A05p43490.2_BraZ1	2626.78	+	1967	4676	4750	0.9844211
A05	39394236	39395399	A05p43500.2_BraZ1	29432	+	729	1163	1163	1.0000000
A05	39395952	39397257	A05p43510.2_BraZ1	550.565	-	397	1305	1305	1.0000000
A05	39406157	39414943	A05p43520.2_BraZ1	3237.76	+	1147	5013	8786	0.5705668
A05	39418838	39419720	A05p43530.2_BraZ1	88.2	-	831	882	882	1.0000000
A05	39421527	39421915	A05p43540.2_BraZ1	204	+	359	388	388	1.0000000
A05	39427046	39429368	A05p43550.2_BraZ1	1284	-	1267	2002	2322	0.8621877
A05	39430792	39432850	A05p43560.2_BraZ1	203.4	-	1014	1823	2058	0.8858114
A05	39435352	39437235	A05p43570.2_BraZ1	1362	+	377	1697	1883	0.9012215
A05	39445036	39445708	A05p43580.2_BraZ1	220.5	+	137	583	672	0.8675596
A05	39449457	39451243	A05p43590.2_BraZ1	1404	+	402	1560	1786	0.8734602
A05	39451521	39454900	A05p43600.2_BraZ1	1016.08	-	2353	3379	3379	1.0000000
A05	39461186	39462517	A05p43610.2_BraZ1	1014	+	532	1331	1331	1.0000000
A05	39464824	39465889	A05p43620.2_BraZ1	106.5	+	549	1020	1065	0.9577465
A05	39469298	39470686	A05p43630.2_BraZ1	709.615	-	742	1321	1388	0.9517291
A05	39471408	39472526	A05p43640.2_BraZ1	379.273	+	2467	1118	1118	1.0000000
A05	39473536	39474148	A05p43650.2_BraZ1	60.3	+	323	612	612	1.0000000
A05	39477262	39478159	A05p43660.2_BraZ1	816	-	23	610	897	0.6800446
A05	39479349	39480427	A05p43670.2_BraZ1	485.357	+	411	991	1078	0.9192950
A05	39483890	39485004	A05p43680.2_BraZ1	257.143	+	943	1114	1114	1.0000000
A05	39487029	39489659	A05p43690.2_BraZ1	1158.12	+	1043	2268	2630	0.8623574
A05	39490182	39490602	A05p43700.2_BraZ1	258.333	+	333	420	420	1.0000000
A05	39491945	39492345	A05p43710.2_BraZ1	273	+	275	400	400	1.0000000
A05	39493817	39495657	A05p43720.2_BraZ1	1371	-	87	1167	1840	0.6342391
A05	39501380	39502004	A05p43730.2_BraZ1	62.4	-	76	624	624	1.0000000
A05	39510263	39512285	A05p43740.2_BraZ1	1451.4	+	78	1093	2022	0.5405539
A05	39515006	39518367	A05p43750.2_BraZ1	2278.12	-	543	2852	3361	0.8485570
A05	39528268	39528907	A05p43760.2_BraZ1	63.9	+	0	0	639	0.0000000
A05	39535711	39536638	A05p43770.2_BraZ1	92.7	+	545	927	927	1.0000000
A05	39536879	39538246	A05p43780.2_BraZ1	760.508	-	651	1346	1367	0.9846379
A05	39539105	39541331	A05p43790.2_BraZ1	817.521	+	1614	2201	2226	0.9887691
A05	39542387	39542744	A05p43800.2_BraZ1	35.7	-	12	219	357	0.6134454
A05	39548759	39551614	A05p43810.2_BraZ1	1724.8	-	1137	2850	2855	0.9982487
A05	39563922	39566082	A05p43820.2_BraZ1	768	+	907	2114	2160	0.9787037
A05	39567376	39569005	A05p43830.2_BraZ1	1314.38	+	650	1580	1629	0.9699202
A05	39569026	39574806	A05p43840.2_BraZ1	2400.18	-	3931	5402	5780	0.9346021
A05	39575367	39576137	A05p43850.2_BraZ1	592.826	-	258	683	770	0.8870130
A05	39576854	39581254	A05p43860.2_BraZ1	2621.42	-	1386	4110	4400	0.9340909
A05	39583785	39585527	A05p43870.2_BraZ1	578.16	+	0	0	1742	0.0000000
A05	39587980	39589267	A05p43880.2_BraZ1	378.4	+	1350	1287	1287	1.0000000
A05	39590421	39590774	A05p43890.2_BraZ1	21	-	544	353	353	1.0000000
A05	39591803	39592516	A05p43900.2_BraZ1	460.5	+	624	713	713	1.0000000
A05	39593177	39593988	A05p43910.2_BraZ1	240	+	932	811	811	1.0000000
A05	39596603	39598095	A05p43920.2_BraZ1	725	+	308	1451	1492	0.9725201
A05	39599510	39601929	A05p43930.2_BraZ1	866.25	-	680	1577	2419	0.6519223
A05	39602892	39603400	A05p43940.2_BraZ1	714	+	17	401	508	0.7893701
A05	39606758	39608914	A05p43950.2_BraZ1	6443	-	548	1742	2156	0.8079777
A05	39611588	39612484	A05p43960.2_BraZ1	630	+	281	583	896	0.6506696
A05	39613909	39615472	A05p43970.2_BraZ1	608.521	+	998	1537	1563	0.9833653
A05	39615553	39617410	A05p43980.2_BraZ1	185.7	-	726	1708	1857	0.9197631
A05	39618517	39620440	A05p43990.2_BraZ1	192.3	+	1024	1923	1923	1.0000000
A05	39620823	39622551	A05p44000.2_BraZ1	1347.32	-	237	1352	1728	0.7824074
A05	39622890	39623219	A05p44010.2_BraZ1	26.4	+	387	329	329	1.0000000
A05	39623998	39624759	A05p44020.2_BraZ1	504	+	186	736	761	0.9671485
A05	39629316	39632590	A05p44030.2_BraZ1	1430.86	+	2255	3178	3274	0.9706781
A05	39633559	39635490	A05p44040.2_BraZ1	8642.25	-	378	1816	1931	0.9404454
A05	39637486	39639921	A05p44050.2_BraZ1	1530	-	994	2397	2435	0.9843943
A05	39646233	39647091	A05p44060.2_BraZ1	243	+	774	858	858	1.0000000
A05	39647492	39648785	A05p44070.2_BraZ1	1206	+	420	1201	1293	0.9288477
A05	39653232	39654883	A05p44080.2_BraZ1	7497	-	817	1650	1651	0.9993943
A05	39655521	39656911	A05p44090.2_BraZ1	563.5	-	1031	1390	1390	1.0000000
A05	39657610	39664354	A05p44100.2_BraZ1	2717.67	-	2029	6132	6744	0.9092526
A05	39666562	39669425	A05p44110.2_BraZ1	1460.05	+	1403	2798	2863	0.9772965
A05	39671792	39677555	A05p44120.2_BraZ1	1040.27	+	2240	5238	5763	0.9089016
A05	39679386	39680270	A05p44130.2_BraZ1	586.154	+	339	881	884	0.9966063
A05	39687189	39687925	A05p44140.2_BraZ1	576	-	249	736	736	1.0000000
A05	39691984	39694320	A05p44150.2_BraZ1	1664.64	+	1444	2336	2336	1.0000000
A05	39694795	39696188	A05p44160.2_BraZ1	386.065	-	1031	1393	1393	1.0000000
A05	39697974	39699886	A05p44170.2_BraZ1	994.154	+	674	1697	1912	0.8875523
A05	39700782	39702776	A05p44180.2_BraZ1	771	+	834	1827	1994	0.9162487
A05	39703894	39705905	A05p44190.2_BraZ1	636.316	+	1667	2011	2011	1.0000000
A05	39709784	39712486	A05p44200.2_BraZ1	1145.5	-	914	2641	2702	0.9774241
A05	39716335	39717927	A05p44210.2_BraZ1	250.962	-	547	1592	1592	1.0000000
A05	39719133	39719670	A05p44220.2_BraZ1	255	+	584	537	537	1.0000000
A05	39722996	39723922	A05p44230.2_BraZ1	657	-	322	897	926	0.9686825
A05	39729109	39737605	A05p44240.2_BraZ1	4792.46	+	2283	6397	8496	0.7529426
A05	39738300	39738804	A05p44250.2_BraZ1	50.4	-	205	461	504	0.9146826
A05	39741618	39742398	A05p44260.2_BraZ1	78	+	328	780	780	1.0000000
A05	39743446	39744144	A05p44270.2_BraZ1	61.8	-	153	645	698	0.9240687
A05	39744957	39747273	A05p44280.2_BraZ1	1663.88	-	1779	2316	2316	1.0000000
A05	39747958	39750511	A05p44290.2_BraZ1	780.938	-	2349	2553	2553	1.0000000
A05	39751050	39752532	A05p44300.2_BraZ1	763.013	-	1602	1482	1482	1.0000000
A05	39753852	39755699	A05p44310.2_BraZ1	1183.85	+	486	1847	1847	1.0000000
A05	39756362	39761597	A05p44320.2_BraZ1	1421.39	-	1072	4214	5235	0.8049666
A05	39766584	39767699	A05p44330.2_BraZ1	554.875	-	494	1022	1115	0.9165919
A05	39768768	39770358	A05p44340.2_BraZ1	159	-	2062	1590	1590	1.0000000
A05	39773316	39776117	A05p44350.2_BraZ1	1063.68	+	954	2489	2801	0.8886112
A05	39788638	39788821	A05p44360.2_BraZ1	18.3	+	58	183	183	1.0000000
A05	39789771	39791075	A05p44370.2_BraZ1	861	+	756	1214	1304	0.9309816
A05	39792566	39792860	A05p44380.2_BraZ1	29.4	+	90	294	294	1.0000000
A05	39793873	39795171	A05p44390.2_BraZ1	671.435	-	1055	1298	1298	1.0000000
A05	39795696	39796908	A05p44400.2_BraZ1	746.576	+	346	1156	1212	0.9537954
A05	39802670	39803692	A05p44410.2_BraZ1	10591.5	-	665	811	1022	0.7935421
A05	39806854	39807968	A05p44420.2_BraZ1	802.909	+	340	1017	1114	0.9129264
A05	39808335	39813148	A05p44430.2_BraZ1	2086.01	+	4300	4813	4813	1.0000000
A05	39813454	39813898	A05p44440.2_BraZ1	219	-	432	444	444	1.0000000
A05	39814101	39815532	A05p44450.2_BraZ1	672.167	+	908	1431	1431	1.0000000
A05	39815935	39817836	A05p44460.2_BraZ1	1131.31	+	447	1771	1901	0.9316149
A05	39818096	39820235	A05p44470.2_BraZ1	508.8	-	1729	2137	2139	0.9990650
A05	39822409	39823006	A05p44480.2_BraZ1	59.7	+	293	597	597	1.0000000
A05	39825341	39826731	A05p44490.2_BraZ1	633	-	218	991	1390	0.7129496
A05	39829713	39831379	A05p44500.2_BraZ1	110.4	+	562	1648	1666	0.9891957
A05	39833291	39834146	A05p44510.2_BraZ1	85.5	-	265	855	855	1.0000000
A05	39837508	39838770	A05p44520.2_BraZ1	666	-	428	1262	1262	1.0000000
A05	39841738	39843349	A05p44530.2_BraZ1	1290	-	928	1611	1611	1.0000000
A05	39844366	39847614	A05p44540.2_BraZ1	376.5	-	445	2254	3248	0.6939655
A05	39847985	39849940	A05p44550.2_BraZ1	918	-	135	593	1955	0.3033248
A05	39856433	39862954	A05p44560.2_BraZ1	1813.64	+	2480	5752	6521	0.8820733
A05	39863640	39865261	A05p44570.2_BraZ1	16797	-	1737	1621	1621	1.0000000
A05	39865744	39871339	A05p44580.2_BraZ1	1975	+	1875	4928	5595	0.8807864
A05	39871734	39873123	A05p44590.2_BraZ1	1305	-	642	1342	1389	0.9661627
A05	39873747	39875647	A05p44600.2_BraZ1	973.762	-	1647	1900	1900	1.0000000
A05	39877069	39878138	A05p44610.2_BraZ1	501	+	432	1010	1069	0.9448082
A05	39878637	39878946	A05p44620.2_BraZ1	207	-	0	0	309	0.0000000
A05	39880152	39881001	A05p44630.2_BraZ1	84.9	-	39	232	849	0.2732626
A05	39881566	39883476	A05p44640.2_BraZ1	70.2857	+	1176	1910	1910	1.0000000
A05	39883919	39885642	A05p44650.2_BraZ1	935.712	-	711	1659	1723	0.9628555
A05	39886194	39887745	A05p44660.2_BraZ1	155.1	-	703	1551	1551	1.0000000
A05	39889031	39890276	A05p44670.2_BraZ1	124.5	-	699	1245	1245	1.0000000
A05	39891113	39892241	A05p44680.2_BraZ1	112.8	-	388	998	1128	0.8847518
A05	39893500	39899109	A05p44690.2_BraZ1	2284.89	-	2994	5607	5609	0.9996434
A05	39901885	39902231	A05p44700.2_BraZ1	129	-	450	346	346	1.0000000
A05	39903041	39903560	A05p44710.2_BraZ1	50.4	+	254	519	519	1.0000000
A05	39905741	39906950	A05p44720.2_BraZ1	515.455	+	1257	1209	1209	1.0000000
A05	39907373	39910729	A05p44730.2_BraZ1	2202.63	-	929	3015	3356	0.8983909
A05	39912380	39912668	A05p44740.2_BraZ1	28.8	-	0	0	288	0.0000000
A05	39913785	39916386	A05p44750.2_BraZ1	864.545	+	1860	2551	2601	0.9807766
A05	39917089	39919420	A05p44760.2_BraZ1	1268.87	-	1481	2104	2331	0.9026169
A05	39924817	39925972	A05p44770.2_BraZ1	115.5	-	340	1123	1155	0.9722944
A05	39928029	39928359	A05p44780.2_BraZ1	21.3	-	480	330	330	1.0000000
A05	39934419	39936959	A05p44790.2_BraZ1	1107.15	-	1602	2443	2540	0.9618110
A05	39940411	39941216	A05p44800.2_BraZ1	162	+	233	805	805	1.0000000
A05	39943012	39943674	A05p44810.2_BraZ1	153	-	167	662	662	1.0000000
A05	39945096	39946355	A05p44820.2_BraZ1	1320	+	578	1259	1259	1.0000000
A05	39949732	39952481	A05p44830.2_BraZ1	1640.8	-	3017	2749	2749	1.0000000
A05	39953647	39956374	A05p44840.2_BraZ1	1203.75	+	970	2408	2727	0.8830217
A05	39957158	39957959	A05p44850.2_BraZ1	80.1	-	855	801	801	1.0000000
A05	39958827	39966934	A05p44860.2_BraZ1	1573.36	+	1191	5754	8107	0.7097570
A05	39967812	39970851	A05p44870.2_BraZ1	1807.52	-	378	2214	3039	0.7285291
A05	39971493	39971939	A05p44880.2_BraZ1	405	+	498	446	446	1.0000000
A05	39971952	39974039	A05p44890.2_BraZ1	1108.84	-	2368	2087	2087	1.0000000
A05	39975124	39978562	A05p44900.2_BraZ1	2169.2	-	1461	3040	3438	0.8842350
A05	39992475	39994127	A05p44910.2_BraZ1	1421.16	+	136	946	1652	0.5726392
A05	39994455	39999217	A05p44920.2_BraZ1	2608.52	-	2656	4730	4762	0.9932801
A05	40003803	40012794	A05p44930.2_BraZ1	2536.98	+	3896	8353	8991	0.9290401
A05	40012871	40013495	A05p44940.2_BraZ1	306	+	205	485	624	0.7772436
A05	40014781	40015998	A05p44950.2_BraZ1	908.182	+	676	1217	1217	1.0000000
A05	40016900	40018862	A05p44960.2_BraZ1	980.379	+	1094	1962	1962	1.0000000
A05	40020104	40021586	A05p44970.2_BraZ1	148.2	+	751	1236	1482	0.8340081
A05	40021813	40023510	A05p44980.2_BraZ1	765	-	491	1492	1697	0.8791986
A05	40023916	40025011	A05p44990.2_BraZ1	671.16	+	486	1095	1095	1.0000000
A05	40025300	40027793	A05p45000.2_BraZ1	1691.41	-	1563	2493	2493	1.0000000
A05	40127430	40138475	A05p45010.2_BraZ1	768	-	2122	5083	11045	0.4602082
A05	40136566	40137304	A05p45020.2_BraZ1	73.8	-	168	703	738	0.9525746
A05	40144086	40145542	A05p45030.2_BraZ1	1100	+	444	1448	1456	0.9945055
A05	40147143	40148810	A05p45040.2_BraZ1	836.804	+	590	1635	1667	0.9808038
A05	40149231	40149729	A05p45050.2_BraZ1	49.8	-	105	435	498	0.8734940
A05	40158161	40160894	A05p45060.2_BraZ1	1553.14	+	2381	2733	2733	1.0000000
A05	40161309	40162801	A05p45070.2_BraZ1	580.227	-	948	1465	1492	0.9819035
A05	40163108	40165937	A05p45080.2_BraZ1	1630.27	+	937	2660	2829	0.9402616
A05	40166898	40168170	A05p45090.2_BraZ1	127.2	+	1065	1272	1272	1.0000000
A05	40169304	40172776	A05p45100.2_BraZ1	1660.43	+	1427	3398	3472	0.9786866
A05	40181251	40181934	A05p45110.2_BraZ1	573	-	329	617	683	0.9033675
A05	40183841	40184965	A05p45120.2_BraZ1	450.667	-	521	1056	1124	0.9395018
A05	40189223	40190691	A05p45130.2_BraZ1	896.786	-	1124	1404	1468	0.9564033
A05	40195452	40197415	A05p45140.2_BraZ1	2030.16	-	1379	1829	1963	0.9317371
A05	40198890	40199608	A05p45150.2_BraZ1	516	+	202	634	718	0.8830084
A05	40201335	40201476	A05p45160.2_BraZ1	14.1	-	65	141	141	1.0000000
A05	40207122	40207287	A05p45170.2_BraZ1	16.5	+	0	0	165	0.0000000
A05	40208036	40208193	A05p45180.2_BraZ1	14.1	+	6	83	157	0.5286624
A05	40213787	40217413	A05p45190.2_BraZ1	2275	+	1232	3473	3626	0.9578047
A05	40218022	40219392	A05p45200.2_BraZ1	574	+	838	1328	1370	0.9693431
A05	40219629	40222440	A05p45210.2_BraZ1	567.612	-	1540	2712	2811	0.9647812
A05	40223219	40224274	A05p45220.2_BraZ1	588	-	117	922	1055	0.8739337
A05	40225831	40228332	A05p45230.2_BraZ1	1581.43	+	1278	1826	2501	0.7301080
A05	40236678	40238393	A05p45240.2_BraZ1	76.5	+	1946	1715	1715	1.0000000
A05	40239493	40239835	A05p45250.2_BraZ1	34.2	+	355	342	342	1.0000000
A05	40240475	40241467	A05p45260.2_BraZ1	290.25	-	490	762	992	0.7681451
A05	40241767	40243978	A05p45270.2_BraZ1	221.1	+	1142	2138	2211	0.9669833
A05	40244360	40247501	A05p45280.2_BraZ1	2256.48	-	2132	2981	3141	0.9490608
A05	40248421	40250580	A05p45290.2_BraZ1	1195.28	-	212	1015	2159	0.4701250
A05	40255384	40256450	A05p45300.2_BraZ1	618	+	676	1066	1066	1.0000000
A05	40259535	40260786	A05p45310.2_BraZ1	125.1	-	401	1249	1251	0.9984013
A05	40262226	40264218	A05p45320.2_BraZ1	775.705	-	751	1865	1992	0.9362450
A05	40265654	40266674	A05p45330.2_BraZ1	522.15	+	902	1020	1020	1.0000000
A05	40267508	40269803	A05p45340.2_BraZ1	229.5	+	947	2182	2295	0.9507625
A05	40272403	40273805	A05p45350.2_BraZ1	1200.57	+	670	1361	1402	0.9707561
A05	40276090	40278596	A05p45360.2_BraZ1	941.444	+	1659	2471	2506	0.9860335
A05	40281661	40283856	A05p45370.2_BraZ1	1316.75	+	970	2049	2195	0.9334852
A05	40284621	40286189	A05p45380.2_BraZ1	702.099	-	916	1568	1568	1.0000000
A05	40286590	40287528	A05p45390.2_BraZ1	222	+	639	938	938	1.0000000
A05	40289156	40293687	A05p45400.2_BraZ1	2848.32	-	2329	4422	4531	0.9759435
A05	40294061	40298795	A05p45410.2_BraZ1	2307.93	+	1886	4369	4734	0.9228982
A05	40299059	40301399	A05p45420.2_BraZ1	234	-	992	2185	2340	0.9337607
A05	40301952	40303532	A05p45430.2_BraZ1	1221	-	497	1541	1580	0.9753165
A05	40303903	40306579	A05p45440.2_BraZ1	267	+	2505	2676	2676	1.0000000
A05	40307488	40309411	A05p45450.2_BraZ1	807.628	-	781	1923	1923	1.0000000
A05	40310358	40311026	A05p45460.2_BraZ1	1023	-	158	607	668	0.9086826
A05	40311999	40313681	A05p45470.2_BraZ1	757.76	-	793	1682	1682	1.0000000
A05	40314291	40315713	A05p45480.2_BraZ1	142.2	+	907	1422	1422	1.0000000
A05	40316257	40317580	A05p45490.2_BraZ1	132.3	-	367	1181	1323	0.8926682
A05	40319875	40323197	A05p45500.2_BraZ1	2095.64	+	1824	3322	3322	1.0000000
A05	40323999	40326040	A05p45510.2_BraZ1	15330	+	695	1995	2041	0.9774621
A05	40327161	40329006	A05p45520.2_BraZ1	184.5	-	812	1834	1845	0.9940379
A05	40331566	40332231	A05p45530.2_BraZ1	1734.38	-	594	665	665	1.0000000
A05	40332787	40335476	A05p45540.2_BraZ1	1208.84	+	999	2531	2689	0.9412421
A05	40335722	40338496	A05p45550.2_BraZ1	2219.39	-	760	2537	2774	0.9145638
A05	40340029	40341898	A05p45560.2_BraZ1	965.25	-	1345	1869	1869	1.0000000
A05	40342126	40344736	A05p45570.2_BraZ1	1211.74	+	1058	2523	2610	0.9666666
A05	40348188	40350542	A05p45580.2_BraZ1	1476.6	+	901	2201	2354	0.9350042
A05	40351223	40351950	A05p45590.2_BraZ1	344.85	-	234	290	727	0.3988996
A05	40353880	40354226	A05p45600.2_BraZ1	243	+	180	346	346	1.0000000
A05	40354705	40355553	A05p45610.2_BraZ1	385.333	+	925	848	848	1.0000000
A05	40355634	40356244	A05p45620.2_BraZ1	82.5	+	932	610	610	1.0000000
A05	40356743	40357501	A05p45630.2_BraZ1	480	-	506	758	758	1.0000000
A05	40358451	40365509	A05p45640.2_BraZ1	1203.65	-	3940	6757	7058	0.9573534
A05	40369344	40370967	A05p45650.2_BraZ1	642.63	+	1018	1593	1623	0.9815157
A05	40371421	40371957	A05p45660.2_BraZ1	354	-	404	536	536	1.0000000
A05	40372333	40373003	A05p45670.2_BraZ1	507	+	379	670	670	1.0000000
A05	40373126	40375400	A05p45680.2_BraZ1	1293.16	-	942	2274	2274	1.0000000
A05	40385714	40401526	A05p45690.2_BraZ1	2387.61	+	3508	11332	15812	0.7166709
A05	40406202	40406403	A05p45700.2_BraZ1	20.1	-	289	201	201	1.0000000
A05	40409274	40413242	A05p45710.2_BraZ1	1576.2	+	2734	3951	3968	0.9957157
A05	40413949	40415394	A05p45720.2_BraZ1	966.717	+	1243	1445	1445	1.0000000
A05	40416038	40416773	A05p45730.2_BraZ1	73.5	+	124	664	735	0.9034014
A05	40417549	40419423	A05p45740.2_BraZ1	829.179	-	1274	1874	1874	1.0000000
A05	40419589	40421696	A05p45750.2_BraZ1	905.625	+	1444	2012	2107	0.9549122
A05	40424139	40427306	A05p45760.2_BraZ1	1116	+	1001	2953	3167	0.9324282
A05	40428622	40430433	A05p45770.2_BraZ1	1911	+	900	1738	1811	0.9596907
A05	40431673	40441412	A05p45780.2_BraZ1	3503.86	+	2993	7858	9739	0.8068590
A05	40441612	40442537	A05p45790.2_BraZ1	780	-	217	925	925	1.0000000
A05	40447262	40449891	A05p45800.2_BraZ1	1157.92	+	1200	2629	2629	1.0000000
A05	40450287	40451352	A05p45810.2_BraZ1	106.5	-	785	1065	1065	1.0000000
A05	40451887	40452289	A05p45820.2_BraZ1	40.2	+	145	402	402	1.0000000
A05	40453662	40455051	A05p45830.2_BraZ1	138.9	-	472	1386	1389	0.9978402
A05	40455959	40457180	A05p45840.2_BraZ1	122.1	-	120	749	1221	0.6134316
A05	40460448	40462642	A05p45850.2_BraZ1	1327.5	-	517	2057	2194	0.9375570
A05	40463658	40466899	A05p45860.2_BraZ1	701.859	-	2997	3241	3241	1.0000000
A05	40467888	40470238	A05p45870.2_BraZ1	1688.24	-	1094	2350	2350	1.0000000
A05	40471046	40477340	A05p45880.2_BraZ1	2947.66	+	962	4092	6294	0.6501430
A05	40478299	40480210	A05p45890.2_BraZ1	932.4	-	778	1905	1911	0.9968603
A05	40481334	40484043	A05p45900.2_BraZ1	2622	+	488	1314	2709	0.4850498
A05	40484548	40485493	A05p45910.2_BraZ1	867	-	190	818	945	0.8656085
A05	40490445	40493646	A05p45920.2_BraZ1	1521.12	-	1815	3100	3201	0.9684474
A05	40494057	40494830	A05p45930.2_BraZ1	651	-	32	461	773	0.5963777
A05	40495297	40497062	A05p45940.2_BraZ1	7402.5	+	554	1746	1765	0.9892351
A05	40498075	40499443	A05p45950.2_BraZ1	1046.76	+	1135	1368	1368	1.0000000
A05	40499634	40500607	A05p45960.2_BraZ1	504.984	-	851	973	973	1.0000000
A05	40502097	40509163	A05p45970.2_BraZ1	3584.96	+	769	4707	7066	0.6661478
A05	40509620	40510705	A05p45980.2_BraZ1	999	-	236	972	1085	0.8958525
A05	40514510	40515698	A05p45990.2_BraZ1	118.8	+	4172	1188	1188	1.0000000
A05	40516207	40516657	A05p46000.2_BraZ1	45	-	330	450	450	1.0000000
A05	40579785	40581840	A05p46010.2_BraZ1	205.5	+	374	1624	2055	0.7902676
A05	40581927	40585671	A05p46020.2_BraZ1	2489	-	956	3342	3744	0.8926282
A05	40586715	40587774	A05p46030.2_BraZ1	948	+	132	1000	1059	0.9442871
A05	40589140	40589476	A05p46040.2_BraZ1	33.6	+	54	272	336	0.8095238
A05	40590567	40591764	A05p46050.2_BraZ1	119.7	-	52	500	1197	0.4177109
A05	40595539	40596761	A05p46060.2_BraZ1	624	+	0	0	1222	0.0000000
A05	40600282	40601467	A05p46070.2_BraZ1	118.5	-	0	0	1185	0.0000000
A05	40602762	40603988	A05p46080.2_BraZ1	624	+	4	38	1226	0.0309951
A05	40607509	40608690	A05p46090.2_BraZ1	73.5	-	0	0	1181	0.0000000
A05	40612357	40614566	A05p46100.2_BraZ1	1686	+	660	2190	2209	0.9913988
A05	40616063	40617395	A05p46110.2_BraZ1	679.905	+	872	1332	1332	1.0000000
A05	40617462	40618003	A05p46120.2_BraZ1	141	+	306	541	541	1.0000000
A05	40618455	40620157	A05p46130.2_BraZ1	1231.16	+	356	1612	1702	0.9471210
A05	40621558	40623392	A05p46140.2_BraZ1	1283.5	+	372	1739	1834	0.9482006
A05	40624175	40626075	A05p46150.2_BraZ1	222.805	-	1021	1853	1900	0.9752632
A05	40625080	40626258	A05p46160.2_BraZ1	291	-	426	1136	1178	0.9643463
A05	40626455	40630968	A05p46170.2_BraZ1	889.024	-	2654	4406	4513	0.9762907
A05	40631765	40631954	A05p46180.2_BraZ1	18.9	-	29	189	189	1.0000000
A05	40634803	40638013	A05p46190.2_BraZ1	1343.63	-	1237	3188	3210	0.9931464
A05	40640400	40642955	A05p46200.2_BraZ1	1682.45	+	1412	2555	2555	1.0000000
A05	40643688	40644012	A05p46210.2_BraZ1	32.4	-	553	324	324	1.0000000
A05	40645411	40646209	A05p46220.2_BraZ1	68.8636	+	492	798	798	1.0000000
A05	40646953	40647928	A05p46230.2_BraZ1	97.5	-	122	955	975	0.9794872
A05	40648710	40650862	A05p46240.2_BraZ1	810.75	-	1160	2148	2152	0.9981413
A05	40651278	40651595	A05p46250.2_BraZ1	198	+	63	317	317	1.0000000
A05	40654137	40655082	A05p46260.2_BraZ1	94.5	-	311	926	945	0.9798942
A05	40656397	40659185	A05p46270.2_BraZ1	1666.97	+	1242	2788	2788	1.0000000
A05	40659916	40662597	A05p46280.2_BraZ1	1320.61	-	1242	2679	2681	0.9992540
A05	40666018	40674536	A05p46290.2_BraZ1	4484.57	+	1975	7148	8518	0.8391641
A05	40675573	40678419	A05p46300.2_BraZ1	1509.43	+	699	2630	2846	0.9241040
A05	40681188	40682426	A05p46310.2_BraZ1	1008	+	189	1183	1238	0.9555735
A05	40684161	40685372	A05p46320.2_BraZ1	822	+	19	294	1211	0.2427746
A05	40688528	40692036	A05p46330.2_BraZ1	1385.64	+	844	2952	3508	0.8415051
A05	40692868	40694454	A05p46340.2_BraZ1	1155.79	-	340	1537	1586	0.9691046
A05	40696485	40697243	A05p46350.2_BraZ1	418.286	+	731	758	758	1.0000000
A05	40697514	40699434	A05p46360.2_BraZ1	1330.71	-	261	1679	1920	0.8744792
A05	40700210	40702772	A05p46370.2_BraZ1	1251.15	-	212	1195	2562	0.4664325
A05	40705160	40707746	A05p46380.2_BraZ1	687.655	-	2709	2586	2586	1.0000000
A05	40708431	40710409	A05p46390.2_BraZ1	1208.28	-	1141	1976	1978	0.9989889
A05	40711875	40712745	A05p46400.2_BraZ1	216.955	+	742	870	870	1.0000000
A05	40713042	40715307	A05p46410.2_BraZ1	1240.08	-	1202	2102	2265	0.9280353
A05	40718629	40720620	A05p46420.2_BraZ1	1220.02	+	698	1976	1991	0.9924661
A05	40721797	40723092	A05p46430.2_BraZ1	698.283	-	429	1276	1295	0.9853282
A05	40784122	40785991	A05p46440.2_BraZ1	1514.15	+	146	1012	1869	0.5414660
A05	40788249	40797603	A05p46450.2_BraZ1	798	+	924	5668	9354	0.6059440
A05	40792519	40793170	A05p46460.2_BraZ1	333	-	34	514	651	0.7895545
A05	40795030	40795438	A05p46470.2_BraZ1	405	-	153	396	408	0.9705882
A05	40799738	40800047	A05p46480.2_BraZ1	30.9	+	118	309	309	1.0000000
A05	40800418	40802100	A05p46490.2_BraZ1	1518	-	355	1558	1682	0.9262782
A05	40804677	40805794	A05p46500.2_BraZ1	850.944	+	739	1117	1117	1.0000000
A05	40806241	40807690	A05p46510.2_BraZ1	144.9	-	1338	1449	1449	1.0000000
A05	40808555	40810139	A05p46520.2_BraZ1	1095	-	1069	1584	1584	1.0000000
A05	40811115	40815479	A05p46530.2_BraZ1	2248.4	-	1590	4259	4364	0.9759395
A05	40816447	40817553	A05p46540.2_BraZ1	285.42	-	656	1106	1106	1.0000000
A05	40821017	40822497	A05p46550.2_BraZ1	745.043	-	251	1338	1480	0.9040540
A05	40822820	40825588	A05p46560.2_BraZ1	1558.33	+	340	1886	2768	0.6813584
A05	40825973	40827344	A05p46570.2_BraZ1	137.1	-	691	1371	1371	1.0000000
A05	40828568	40828799	A05p46580.2_BraZ1	23.1	-	322	24	231	0.1038961
A05	40832232	40833843	A05p46590.2_BraZ1	7380	-	298	1169	1611	0.7256362
A05	40835504	40838739	A05p46600.2_BraZ1	2027.89	+	1097	3199	3235	0.9888717
A05	40838994	40841260	A05p46610.2_BraZ1	1338	-	505	1856	2266	0.8190644
A05	40843929	40844349	A05p46620.2_BraZ1	42	+	204	420	420	1.0000000
A05	40846837	40847876	A05p46630.2_BraZ1	635.36	-	537	1015	1039	0.9769009
A05	40850491	40854771	A05p46640.2_BraZ1	2324.36	+	2374	4131	4280	0.9651869
A05	40856052	40857581	A05p46650.2_BraZ1	1055.19	-	1341	1529	1529	1.0000000
A05	40876161	40878217	A05p46660.2_BraZ1	1085.48	-	1081	2056	2056	1.0000000
A05	40878666	40885862	A05p46670.2_BraZ1	2592.4	-	4392	7001	7196	0.9729016
A05	40891597	40892296	A05p46680.2_BraZ1	606	+	1004	699	699	1.0000000
A05	40892582	40893167	A05p46690.2_BraZ1	319.846	-	332	585	585	1.0000000
A05	40893718	40895141	A05p46700.2_BraZ1	334.33	+	919	1423	1423	1.0000000
A05	40896631	40898700	A05p46710.2_BraZ1	1039.52	+	226	1733	2069	0.8376027
A05	40899176	40899507	A05p46720.2_BraZ1	240	+	158	319	331	0.9637462
A05	40900677	40902189	A05p46730.2_BraZ1	747.5	-	662	1299	1512	0.8591270
A05	40902731	40903941	A05p46740.2_BraZ1	754.286	+	705	1132	1210	0.9355372
A05	40904282	40905470	A05p46750.2_BraZ1	118.8	-	518	1188	1188	1.0000000
A05	40907662	40910064	A05p46760.2_BraZ1	2108.87	+	1271	2388	2402	0.9941715
A05	40910620	40913479	A05p46770.2_BraZ1	1805.63	-	2335	2859	2859	1.0000000
A05	40914090	40915401	A05p46780.2_BraZ1	577.92	+	1158	1194	1311	0.9107552
A05	40916321	40916891	A05p46790.2_BraZ1	57	+	343	570	570	1.0000000
A05	40917144	40918143	A05p46800.2_BraZ1	639	-	624	726	999	0.7267267
A05	40919217	40919472	A05p46810.2_BraZ1	25.5	-	131	237	255	0.9294118
A05	40922093	40922558	A05p46820.2_BraZ1	46.5	-	106	461	465	0.9913979
A05	40923680	40924396	A05p46830.2_BraZ1	516	+	532	716	716	1.0000000
A05	40926057	40926381	A05p46840.2_BraZ1	31.5	+	177	324	324	1.0000000
A05	40926795	40927092	A05p46850.2_BraZ1	29.7	-	190	297	297	1.0000000
A05	40928592	40930986	A05p46860.2_BraZ1	1766.96	+	825	2286	2394	0.9548872
A05	40931281	40935752	A05p46870.2_BraZ1	3015	-	1711	4311	4471	0.9642138
A05	40936432	40944936	A05p46880.2_BraZ1	36463.5	-	1847	6220	8504	0.7314205
A05	40948634	40949376	A05p46890.2_BraZ1	293.029	+	616	742	742	1.0000000
A05	40950130	40951873	A05p46900.2_BraZ1	709.878	+	1617	1743	1743	1.0000000
A05	40953408	40955163	A05p46910.2_BraZ1	10186	-	312	1552	1755	0.8843305
A05	40962473	40963376	A05p46920.2_BraZ1	90.3	-	304	865	903	0.9579180
A05	40968823	40970768	A05p46930.2_BraZ1	1064.56	+	469	1693	1945	0.8704370
A05	41032911	41034906	A05p46940.2_BraZ1	1301.14	+	463	1446	1995	0.7248120
A05	41036724	41038700	A05p46950.2_BraZ1	1122	+	883	1894	1976	0.9585020
A05	41042938	41046792	A05p46960.2_BraZ1	1713.8	+	2558	3854	3854	1.0000000
A05	41048264	41049587	A05p46970.2_BraZ1	1161	+	560	1323	1323	1.0000000
A05	41049859	41050072	A05p46980.2_BraZ1	21.3	+	45	191	213	0.8967136
A05	41057178	41057292	A05p46990.2_BraZ1	11.4	+	48	114	114	1.0000000
A05	41058612	41062366	A05p47000.2_BraZ1	1247.4	+	1185	1396	3754	0.3718700
A05	41063381	41064054	A05p47010.2_BraZ1	349.714	-	373	673	673	1.0000000
A05	41087484	41088059	A05p47020.2_BraZ1	303	-	143	575	575	1.0000000
A05	41091260	41093964	A05p47030.2_BraZ1	274.038	+	1557	1496	2704	0.5532544
A05	41094332	41094770	A05p47040.2_BraZ1	43.8	-	215	438	438	1.0000000
A05	41096321	41097139	A05p47050.2_BraZ1	417	+	370	517	818	0.6320294
A05	41097469	41098905	A05p47060.2_BraZ1	1356	-	880	1338	1436	0.9317549
A05	41103048	41103150	A05p47070.2_BraZ1	10.2	-	209	102	102	1.0000000
A05	41103550	41105026	A05p47080.2_BraZ1	1438.37	-	787	1421	1476	0.9627371
A05	41106257	41108938	A05p47090.2_BraZ1	1641	+	761	2553	2681	0.9522566
A05	41109676	41112338	A05p47100.2_BraZ1	886.267	-	1590	2662	2662	1.0000000
A05	41115295	41118258	A05p47110.2_BraZ1	1736.5	+	3057	2963	2963	1.0000000
A05	41118681	41119910	A05p47120.2_BraZ1	437.75	-	610	1200	1229	0.9764036
A05	41120862	41133827	A05p47130.2_BraZ1	5157	+	4197	10874	12965	0.8387196
A05	41134893	41136474	A05p47140.2_BraZ1	1328.91	+	254	1396	1581	0.8829855
A05	41136978	41137836	A05p47150.2_BraZ1	538.667	+	165	772	858	0.8997669
A05	41137999	41140855	A05p47160.2_BraZ1	1854.49	-	1506	2856	2856	1.0000000
A05	41141986	41144313	A05p47170.2_BraZ1	1464.23	+	333	2020	2327	0.8680705
A05	41144415	41145057	A05p47180.2_BraZ1	64.2	-	325	642	642	1.0000000
A05	41146622	41151239	A05p47190.2_BraZ1	2970.51	+	1462	4536	4617	0.9824561
A05	41151710	41153674	A05p47200.2_BraZ1	273.023	+	599	1790	1964	0.9114053
A05	41153911	41155495	A05p47210.2_BraZ1	303.429	-	883	1584	1584	1.0000000
A05	41156541	41156877	A05p47220.2_BraZ1	243	+	31	76	336	0.2261905
A05	41159705	41166135	A05p47230.2_BraZ1	3227.36	-	2056	5519	6430	0.8583204
A05	41166493	41169238	A05p47240.2_BraZ1	1617.19	+	984	2679	2745	0.9759563
A05	41169996	41170140	A05p47250.2_BraZ1	14.4	-	172	144	144	1.0000000
A05	41172564	41176120	A05p47260.2_BraZ1	1850.5	+	1442	3529	3556	0.9924072
A05	41177357	41181170	A05p47270.2_BraZ1	417	+	1519	3622	3813	0.9499082
A05	41182432	41182799	A05p47280.2_BraZ1	264	-	146	367	367	1.0000000
A05	41182978	41183358	A05p47290.2_BraZ1	219	-	355	356	380	0.9368421
A05	41313842	41316759	A05p47300.2_BraZ1	2187.11	-	1673	2798	2917	0.9592047
A05	41317058	41319136	A05p47310.2_BraZ1	976.25	+	548	2068	2078	0.9951877
A05	41322606	41322816	A05p47320.2_BraZ1	21	-	45	116	210	0.5523810
A05	41323881	41326781	A05p47330.2_BraZ1	1580	+	706	2629	2900	0.9065517
A05	41327492	41327870	A05p47340.2_BraZ1	37.8	-	24	295	378	0.7804233
A05	41330882	41331959	A05p47350.2_BraZ1	107.7	-	1450	1077	1077	1.0000000
A05	41334785	41338895	A05p47360.2_BraZ1	1940.45	-	1450	3959	4110	0.9632604
A05	41340385	41342597	A05p47370.2_BraZ1	18382.5	-	1751	2009	2212	0.9082279
A05	41348837	41353080	A05p47380.2_BraZ1	2303.78	-	1979	4183	4243	0.9858590
A05	41354032	41354620	A05p47390.2_BraZ1	58.8	-	631	588	588	1.0000000
A05	41355897	41357258	A05p47400.2_BraZ1	2076.75	-	874	1361	1361	1.0000000
A05	41359561	41363599	A05p47410.2_BraZ1	651.618	+	3350	3950	4038	0.9782071
A05	41360908	41361592	A05p47420.2_BraZ1	129	+	1013	684	684	1.0000000
A05	41361663	41362909	A05p47430.2_BraZ1	552	-	868	1158	1246	0.9293740
A05	41365008	41371120	A05p47440.2_BraZ1	2253.91	+	2183	5021	6112	0.8214987
A05	41372381	41372660	A05p47450.2_BraZ1	27.9	+	14	174	279	0.6236559
A05	41380290	41380674	A05p47460.2_BraZ1	216	+	38	384	384	1.0000000
A05	41381481	41382438	A05p47470.2_BraZ1	57.6	+	56	485	957	0.5067921
A05	41382980	41383662	A05p47480.2_BraZ1	240	+	88	546	682	0.8005865
A05	41386768	41390236	A05p47490.2_BraZ1	2598.75	+	1798	3462	3468	0.9982699
A05	41390764	41393982	A05p47500.2_BraZ1	1678.9	+	1374	3153	3218	0.9798011
A05	41394750	41396189	A05p47510.2_BraZ1	678.295	-	1097	1419	1439	0.9861014
A05	41399582	41409782	A05p47520.2_BraZ1	1189.55	+	13112	9691	10200	0.9500980
A05	41411403	41416070	A05p47530.2_BraZ1	1898.33	+	1427	3886	4667	0.8326548
A05	41416987	41417888	A05p47540.2_BraZ1	348	-	471	901	901	1.0000000
A05	41418181	41418875	A05p47550.2_BraZ1	518.932	+	528	694	694	1.0000000
A05	41452642	41453350	A05p47560.2_BraZ1	70.8	+	502	708	708	1.0000000
A05	41456233	41458947	A05p47570.2_BraZ1	1351.22	+	1740	2676	2714	0.9859985
A05	41459289	41461757	A05p47580.2_BraZ1	1242.72	-	1688	2468	2468	1.0000000
A05	41463839	41472705	A05p47590.2_BraZ1	2185.73	+	3875	8018	8866	0.9043537
A05	41469928	41470631	A05p47600.2_BraZ1	354	+	806	703	703	1.0000000
A05	41473081	41484121	A05p47610.2_BraZ1	6234.87	-	6209	10951	11040	0.9919384
A05	41485623	41488544	A05p47620.2_BraZ1	1606.43	-	580	2387	2921	0.8171859
A05	41489652	41493226	A05p47630.2_BraZ1	1907.9	-	1263	3229	3574	0.9034695
A05	41503593	41505694	A05p47640.2_BraZ1	931.731	-	26	531	2101	0.2527368
A05	41520621	41523009	A05p47650.2_BraZ1	1065.67	+	1554	2388	2388	1.0000000
A05	41523626	41524479	A05p47660.2_BraZ1	82.2	-	377	821	853	0.9624854
A05	41525192	41525714	A05p47670.2_BraZ1	408	+	300	522	522	1.0000000
A05	41527336	41528060	A05p47680.2_BraZ1	645	+	33	321	724	0.4433702
A05	41617938	41619907	A05p47690.2_BraZ1	1049.93	-	1444	1969	1969	1.0000000
A05	41623778	41626735	A05p47700.2_BraZ1	1551.23	+	638	2598	2957	0.8785931
A05	41635429	41639429	A05p47710.2_BraZ1	1378.29	+	1792	3812	4000	0.9530000
A05	41640917	41642959	A05p47720.2_BraZ1	197.7	+	1050	2016	2042	0.9872674
A05	41643900	41646473	A05p47730.2_BraZ1	1168.91	-	1635	2573	2573	1.0000000
A05	41654765	41656405	A05p47740.2_BraZ1	730.8	-	1054	1639	1640	0.9993902
A05	41660232	41661991	A05p47750.2_BraZ1	863.162	-	474	1509	1759	0.8578738
A05	41662439	41670209	A05p47760.2_BraZ1	4057.81	+	5065	7321	7770	0.9422137
A05	41672998	41674045	A05p47770.2_BraZ1	104.7	+	52	491	1047	0.4689589
A05	41675429	41675865	A05p47780.2_BraZ1	267	-	58	423	436	0.9701835
A05	41677981	41679822	A05p47790.2_BraZ1	1097.22	+	1234	1800	1841	0.9777295
A05	41680357	41682179	A05p47800.2_BraZ1	981.143	-	1338	1797	1822	0.9862788
A05	41682986	41683820	A05p47810.2_BraZ1	83.4	+	517	834	834	1.0000000
A05	41686744	41687242	A05p47820.2_BraZ1	49.8	+	686	498	498	1.0000000
A05	41689268	41693706	A05p47830.2_BraZ1	2170.88	+	2891	4384	4438	0.9878324
A05	41694428	41695382	A05p47840.2_BraZ1	95.4	+	259	879	954	0.9213836
A05	41698414	41700265	A05p47850.2_BraZ1	185.1	+	633	1829	1851	0.9881145
A05	41702182	41702698	A05p47860.2_BraZ1	51.6	+	138	446	516	0.8643411
A05	41703257	41703492	A05p47870.2_BraZ1	102	-	0	0	235	0.0000000
A05	41705345	41706888	A05p47880.2_BraZ1	1067.18	+	783	1452	1543	0.9410240
A05	41709555	41711203	A05p47890.2_BraZ1	1403.48	+	234	1588	1648	0.9635922
A05	41716534	41722905	A05p47900.2_BraZ1	833.477	-	2372	4597	6371	0.7215508
A05	41794588	41796207	A05p47910.2_BraZ1	776.344	+	562	1454	1619	0.8980852
A05	41796362	41796837	A05p47920.2_BraZ1	216	-	450	475	475	1.0000000
A05	41799685	41799886	A05p47930.2_BraZ1	20.1	-	163	201	201	1.0000000
A05	41800157	41802683	A05p47940.2_BraZ1	1325.86	+	960	2453	2526	0.9711006
A05	41806090	41806625	A05p47950.2_BraZ1	462	+	185	535	535	1.0000000
A05	41808040	41809828	A05p47960.2_BraZ1	1096.88	+	578	1549	1788	0.8663311
A05	41810375	41811595	A05p47970.2_BraZ1	606	+	549	1073	1220	0.8795082
A05	41813040	41813610	A05p47980.2_BraZ1	57	+	325	570	570	1.0000000
A05	41813998	41814797	A05p47990.2_BraZ1	600	+	188	799	799	1.0000000
A05	41817758	41821635	A05p48000.2_BraZ1	1881.49	+	1718	3603	3877	0.9293268
A05	41826399	41826891	A05p48010.2_BraZ1	405	+	199	467	492	0.9491870
A05	41828865	41829762	A05p48020.2_BraZ1	89.7	-	457	782	897	0.8717949
A05	41837730	41838112	A05p48030.2_BraZ1	306	+	269	382	382	1.0000000
A05	41841613	41842341	A05p48040.2_BraZ1	71.1	-	343	584	728	0.8021978
A05	41842950	41843115	A05p48050.2_BraZ1	16.5	-	213	165	165	1.0000000
A05	41848900	41851907	A05p48060.2_BraZ1	1112.56	+	1843	2962	3007	0.9850349
A05	41852710	41853421	A05p48070.2_BraZ1	71.1	-	122	711	711	1.0000000
A05	41855235	41855808	A05p48080.2_BraZ1	57.3	+	0	0	573	0.0000000
A05	41856955	41862114	A05p48090.2_BraZ1	1172.73	+	1052	4383	5159	0.8495833
A05	41863330	41865382	A05p48100.2_BraZ1	1408.68	+	423	1785	2052	0.8698831
A05	41867496	41869695	A05p48110.2_BraZ1	1073.52	+	984	2160	2199	0.9822646
A05	41872874	41873168	A05p48120.2_BraZ1	29.4	+	97	294	294	1.0000000
A05	41874074	41874820	A05p48130.2_BraZ1	654	-	155	701	746	0.9396783
A05	41875764	41876287	A05p48140.2_BraZ1	402	+	25	132	523	0.2523901
A05	41877928	41880161	A05p48150.2_BraZ1	1044.66	+	656	2101	2233	0.9408867
A05	41881586	41883731	A05p48160.2_BraZ1	1551	+	923	2078	2145	0.9687645
A05	41889771	41890090	A05p48170.2_BraZ1	187.5	+	31	143	319	0.4482759
A05	41890112	41890560	A05p48180.2_BraZ1	114	+	278	448	448	1.0000000
A05	41896218	41897217	A05p48190.2_BraZ1	99.9	+	538	991	999	0.9919920
A05	41985525	41986434	A05p48200.2_BraZ1	90.9	+	61	585	909	0.6435643
A05	41990675	41990912	A05p48210.2_BraZ1	23.7	-	205	237	237	1.0000000
A05	41994780	41998247	A05p48220.2_BraZ1	1441.85	+	1069	3330	3467	0.9604846
A05	41998842	42001581	A05p48230.2_BraZ1	1088.71	-	1930	2729	2739	0.9963490
A05	42002792	42004193	A05p48240.2_BraZ1	878.196	-	642	1394	1401	0.9950036
A05	42009589	42010195	A05p48250.2_BraZ1	60.6	-	26	461	606	0.7607261
A05	42012627	42016295	A05p48260.2_BraZ1	1420.26	+	1986	3589	3668	0.9784624
A05	42017181	42019101	A05p48270.2_BraZ1	555	-	2473	1920	1920	1.0000000
A05	42019751	42022410	A05p48280.2_BraZ1	2869.57	-	1195	2659	2659	1.0000000
A05	42024369	42028091	A05p48290.2_BraZ1	1732.75	-	2747	3722	3722	1.0000000
A05	42030304	42031888	A05p48300.2_BraZ1	457.875	-	920	1468	1584	0.9267676
A05	42033133	42036303	A05p48310.2_BraZ1	1560.05	+	1607	3123	3170	0.9851735
A05	42037127	42038629	A05p48320.2_BraZ1	824.529	-	1314	1502	1502	1.0000000
A05	42040299	42043069	A05p48330.2_BraZ1	2463	-	1248	2770	2770	1.0000000
A05	42044617	42047318	A05p48340.2_BraZ1	1626	+	135	1904	2701	0.7049241
A05	42047849	42050128	A05p48350.2_BraZ1	1312.5	+	362	1993	2279	0.8745064
A05	42050848	42052856	A05p48360.2_BraZ1	1851	+	346	1326	2008	0.6603585
A05	42054603	42055803	A05p48370.2_BraZ1	1023	+	159	969	1200	0.8075000
A05	42059502	42059924	A05p48380.2_BraZ1	264	+	107	318	422	0.7535545
A05	42062795	42063964	A05p48390.2_BraZ1	1050	+	154	1066	1169	0.9118905
A05	42064864	42065995	A05p48400.2_BraZ1	504.364	-	772	1131	1131	1.0000000
A05	42066411	42067719	A05p48410.2_BraZ1	130.8	-	1095	1308	1308	1.0000000
A05	42068000	42068928	A05p48420.2_BraZ1	145.914	+	762	928	928	1.0000000
A05	42069377	42069833	A05p48430.2_BraZ1	312	-	420	456	456	1.0000000
A05	42425006	42425831	A05p48440.2_BraZ1	1622.89	-	200	825	825	1.0000000
A05	42427923	42429234	A05p48450.2_BraZ1	808.338	+	893	1311	1311	1.0000000
A05	42429735	42430185	A05p48460.2_BraZ1	45	-	179	450	450	1.0000000
A05	42431456	42432500	A05p48470.2_BraZ1	912	-	930	1039	1044	0.9952107
A05	42434656	42435299	A05p48480.2_BraZ1	1417.5	+	442	643	643	1.0000000
A05	42437968	42446116	A05p48490.2_BraZ1	708.1	-	999	4196	8148	0.5149730
A05	42450449	42453978	A05p48500.2_BraZ1	288	+	1796	3465	3529	0.9818646
A05	42454747	42461282	A05p48510.2_BraZ1	4866.07	+	1736	5994	6535	0.9172150
A05	42461592	42463566	A05p48520.2_BraZ1	195.6	-	208	1928	1974	0.9766971
A05	42464240	42465959	A05p48530.2_BraZ1	171.9	-	327	1670	1719	0.9714950
A05	42471242	42472512	A05p48540.2_BraZ1	525.768	-	639	1155	1270	0.9094488
A05	42473379	42488993	A05p48550.2_BraZ1	890.71	+	3841	13576	15614	0.8694761
A05	42479749	42482630	A05p48560.2_BraZ1	1529.94	+	728	2849	2881	0.9888927
A05	42483116	42485713	A05p48570.2_BraZ1	890.286	+	743	2162	2597	0.8324990
A05	42490969	42491836	A05p48580.2_BraZ1	86.7	-	288	867	867	1.0000000
A05	42493463	42496319	A05p48590.2_BraZ1	1683	+	815	2460	2856	0.8613445
A05	42496423	42497487	A05p48600.2_BraZ1	927	-	129	1043	1064	0.9802632
A05	42497802	42499134	A05p48610.2_BraZ1	618.762	+	750	1219	1332	0.9151652
A05	42503192	42506013	A05p48620.2_BraZ1	1792.29	+	1071	2650	2821	0.9393832
A05	42508555	42509767	A05p48630.2_BraZ1	370.652	+	679	1166	1212	0.9620462
A05	42510922	42512215	A05p48640.2_BraZ1	129.3	+	778	1293	1293	1.0000000
A05	42512273	42597084	A05p48650.2_BraZ1	566.945	+	12456	56124	84811	0.6617538
A05	42582411	42582774	A05p48660.2_BraZ1	1825.2	-	9	151	363	0.4159780
A05	42586276	42586639	A05p48670.2_BraZ1	4797	-	0	0	363	0.0000000
A05	42591546	42591909	A05p48680.2_BraZ1	1918.8	-	12	279	363	0.7685950
A05	42597805	42599644	A05p48690.2_BraZ1	287.478	+	897	1839	1839	1.0000000
A05	42600691	42602669	A05p48700.2_BraZ1	1108.45	+	1310	1965	1978	0.9934277
A05	42603056	42611293	A05p48710.2_BraZ1	2983.5	-	4026	7977	8237	0.9684351
A05	42612181	42613597	A05p48720.2_BraZ1	521.64	-	416	1249	1416	0.8820621
A05	42614042	42618457	A05p48730.2_BraZ1	1974.26	-	1461	4275	4415	0.9682899
A05	42621454	42622885	A05p48740.2_BraZ1	1185	-	1002	1431	1431	1.0000000
A05	42625977	42629023	A05p48750.2_BraZ1	1512.63	-	2281	2948	3046	0.9678267
A05	42631546	42632216	A05p48760.2_BraZ1	90	-	591	670	670	1.0000000
A05	42632998	42634072	A05p48770.2_BraZ1	107.4	-	141	961	1074	0.8947858
A05	42638707	42641376	A05p48780.2_BraZ1	1726.61	-	1308	2470	2669	0.9254403
A05	42643327	42644468	A05p48790.2_BraZ1	418.88	+	1205	1141	1141	1.0000000
A05	42645339	42649218	A05p48800.2_BraZ1	1992.93	-	2312	3787	3879	0.9762825
A05	42650104	42651962	A05p48810.2_BraZ1	981	+	1925	1858	1858	1.0000000
A05	42652911	42655645	A05p48820.2_BraZ1	1406.11	-	1400	2611	2734	0.9550110
A05	42656630	42658484	A05p48830.2_BraZ1	8355	-	903	1854	1854	1.0000000
A05	42661830	42663388	A05p48840.2_BraZ1	4565.5	+	968	1558	1558	1.0000000
A05	42664191	42665730	A05p48850.2_BraZ1	153.9	-	1730	1539	1539	1.0000000
A05	42666413	42668987	A05p48860.2_BraZ1	1450.21	-	1298	2379	2574	0.9242424
A05	42682862	42686822	A05p48870.2_BraZ1	914.94	+	1077	3395	3960	0.8573232
A05	42688759	42692672	A05p48880.2_BraZ1	1241.6	-	1602	3411	3913	0.8717097
A05	42697449	42698686	A05p48890.2_BraZ1	945	+	229	1237	1237	1.0000000
A05	42698960	42700477	A05p48900.2_BraZ1	1102.18	-	516	1220	1517	0.8042188
A05	42762576	42763737	A05p48910.2_BraZ1	116.1	+	440	1020	1161	0.8785530
A05	42765383	42767477	A05p48920.2_BraZ1	1026.07	+	1830	2094	2094	1.0000000
A05	42769008	42769447	A05p48930.2_BraZ1	288	-	0	0	439	0.0000000
A05	42775928	42778271	A05p48940.2_BraZ1	1408.95	+	1704	2336	2343	0.9970124
A05	42779504	42780587	A05p48950.2_BraZ1	487.742	+	794	1083	1083	1.0000000
A05	42780715	42782404	A05p48960.2_BraZ1	168.6	-	521	1629	1689	0.9644760
A05	42783123	42784682	A05p48970.2_BraZ1	797.455	+	845	1559	1559	1.0000000
A05	42785364	42790337	A05p48980.2_BraZ1	2228.41	-	2805	4959	4973	0.9971848
A05	42791398	42791856	A05p48990.2_BraZ1	251.862	-	129	458	458	1.0000000
A05	42791802	42795307	A05p49000.2_BraZ1	1138.55	-	1366	3097	3505	0.8835949
A05	42798042	42798897	A05p49010.2_BraZ1	639	-	1127	815	855	0.9532164
A05	42799375	42801265	A05p49020.2_BraZ1	1316.7	-	1541	1890	1890	1.0000000
A05	42801969	42803913	A05p49030.2_BraZ1	194.4	-	608	1897	1944	0.9758230
A05	42804249	42808418	A05p49040.2_BraZ1	1951.6	-	1337	3606	4169	0.8649556
A05	42809550	42815072	A05p49050.2_BraZ1	2675.65	+	2626	5446	5522	0.9862369
A05	42815422	42816817	A05p49060.2_BraZ1	139.5	-	473	1354	1395	0.9706093
A05	42818785	42824451	A05p49070.2_BraZ1	1262.14	+	2277	4517	5666	0.7972114
A05	42825977	42830591	A05p49080.2_BraZ1	1459.89	+	1795	4446	4614	0.9635891
A05	42832996	42833449	A05p49090.2_BraZ1	204	+	72	232	453	0.5121413
A05	42835557	42836284	A05p49100.2_BraZ1	630	-	79	461	727	0.6341128
A05	42837635	42838215	A05p49110.2_BraZ1	306	+	451	580	580	1.0000000
A05	42839552	42842492	A05p49120.2_BraZ1	2380.9	-	1269	2932	2940	0.9972789
A05	42846007	42848738	A05p49130.2_BraZ1	1251.96	+	2737	2731	2731	1.0000000
A05	42850381	42850741	A05p49140.2_BraZ1	36	+	199	360	360	1.0000000
A05	42852752	42854048	A05p49150.2_BraZ1	792.056	+	502	1150	1296	0.8873457
A05	42854726	42855593	A05p49160.2_BraZ1	250.667	+	1068	867	867	1.0000000
A05	42856317	42863458	A05p49170.2_BraZ1	1491.12	+	4624	6931	7141	0.9705924
A05	43014261	43015206	A05p49180.2_BraZ1	94.5	-	198	922	945	0.9756614
A05	43018131	43020059	A05p49190.2_BraZ1	915.75	+	1072	1880	1928	0.9751037
A05	43020762	43021678	A05p49200.2_BraZ1	849	-	305	884	916	0.9650655
A05	43024110	43030590	A05p49210.2_BraZ1	1007.79	+	691	3477	6480	0.5365741
A05	43038073	43038667	A05p49220.2_BraZ1	59.4	+	1	35	594	0.0589226
A05	43046691	43048411	A05p49230.2_BraZ1	792.54	+	575	1567	1720	0.9110465
A05	43051877	43060378	A05p49240.2_BraZ1	2916.88	-	3070	6993	8501	0.8226091
A05	43061332	43066577	A05p49250.2_BraZ1	2601.3	+	2297	3845	5245	0.7330791
A05	43064493	43064829	A05p49260.2_BraZ1	33.6	+	87	67	336	0.1994048
A05	43068207	43070701	A05p49270.2_BraZ1	1317.5	+	880	2441	2494	0.9787490
A05	43071534	43071826	A05p49280.2_BraZ1	166.909	+	197	292	292	1.0000000
A05	43072610	43077554	A05p49290.2_BraZ1	360.155	-	3562	4944	4944	1.0000000
A05	43079638	43080207	A05p49300.2_BraZ1	361.397	-	493	569	569	1.0000000
A05	43081369	43086325	A05p49310.2_BraZ1	782.182	-	2884	4916	4956	0.9919290
A05	43088013	43089174	A05p49320.2_BraZ1	116.1	+	188	1146	1161	0.9870801
A05	43089296	43094118	A05p49330.2_BraZ1	2944.27	-	708	3784	4822	0.7847366
A05	43094607	43100884	A05p49340.2_BraZ1	3663.6	+	1400	5389	6277	0.8585311
A05	43103982	43104383	A05p49350.2_BraZ1	288	-	295	401	401	1.0000000
A05	43107364	43110228	A05p49360.2_BraZ1	832.865	+	1117	2685	2864	0.9375000
A05	43114494	43115016	A05p49370.2_BraZ1	411	+	130	423	522	0.8103448
A05	43117104	43119544	A05p49380.2_BraZ1	38.7	+	631	1698	2440	0.6959016
A05	43120153	43122221	A05p49390.2_BraZ1	725.2	-	8	376	2068	0.1818182
A05	43123405	43123846	A05p49400.2_BraZ1	44.1	+	51	441	441	1.0000000
A05	43125643	43129699	A05p49410.2_BraZ1	2757.38	+	912	3460	4056	0.8530572
A05	43130136	43130964	A05p49420.2_BraZ1	408	+	21	353	828	0.4263285
A05	43131462	43131758	A05p49430.2_BraZ1	20.4	-	6	59	296	0.1993243
A05	43132724	43136764	A05p49440.2_BraZ1	2605.83	+	154	2342	4040	0.5797030
A05	43141409	43145463	A05p49450.2_BraZ1	1556.46	+	283	2786	4054	0.6872225
A05	43146185	43148344	A05p49460.2_BraZ1	229.45	+	332	1095	2159	0.5071793
A05	43148466	43150541	A05p49470.2_BraZ1	1992	-	69	1474	2075	0.7103614
A05	43151798	43153289	A05p49480.2_BraZ1	149.1	-	745	1491	1491	1.0000000
A05	43154507	43156576	A05p49490.2_BraZ1	895.912	-	860	1976	2069	0.9550508
A05	43411909	43412491	A05p49500.2_BraZ1	58.2	-	908	582	582	1.0000000
A05	43413542	43420748	A05p49510.2_BraZ1	1744.62	+	5524	7206	7206	1.0000000
A05	43430141	43431494	A05p49520.2_BraZ1	1035.53	+	456	1205	1353	0.8906134
A05	43433944	43435322	A05p49530.2_BraZ1	1032	+	1399	1368	1378	0.9927431
A05	43436779	43438497	A05p49540.2_BraZ1	1508.07	-	505	1446	1718	0.8416764
A05	43444309	43446073	A05p49550.2_BraZ1	1103.97	+	1002	1588	1764	0.9002268
A05	43446359	43448142	A05p49560.2_BraZ1	808.893	-	632	1783	1783	1.0000000
A05	43449849	43452280	A05p49570.2_BraZ1	9613.5	+	1084	2358	2431	0.9699712
A05	43452623	43453477	A05p49580.2_BraZ1	693	+	59	283	854	0.3313817
A05	43453741	43454711	A05p49590.2_BraZ1	2388	-	559	970	970	1.0000000
A05	43455376	43455812	A05p49600.2_BraZ1	177	+	605	436	436	1.0000000
A05	43457411	43458351	A05p49610.2_BraZ1	80.4	-	22	192	940	0.2042553
A05	43461591	43463274	A05p49620.2_BraZ1	1614	+	758	1681	1683	0.9988117
A05	43463622	43466977	A05p49630.2_BraZ1	1647.62	-	989	3085	3355	0.9195231
A05	43467638	43469507	A05p49640.2_BraZ1	1038.39	-	1289	1869	1869	1.0000000
A05	43471196	43474518	A05p49650.2_BraZ1	1863.82	+	1548	3287	3322	0.9894642
A05	43478016	43480279	A05p49660.2_BraZ1	1899	-	795	2208	2263	0.9756960
A05	43482446	43483337	A05p49670.2_BraZ1	462.222	-	634	891	891	1.0000000
A05	43484082	43487552	A05p49680.2_BraZ1	1457.45	-	1360	2662	3470	0.7671469
A05	43488633	43489781	A05p49690.2_BraZ1	352.286	+	888	1148	1148	1.0000000
A05	43490030	43490939	A05p49700.2_BraZ1	90.9	+	401	633	909	0.6963696
A05	43494490	43494700	A05p49710.2_BraZ1	21	+	327	210	210	1.0000000
A05	43495126	43497289	A05p49720.2_BraZ1	967.349	+	1928	2163	2163	1.0000000
A05	43497920	43498722	A05p49730.2_BraZ1	480.789	-	328	802	802	1.0000000
A05	43499915	43501265	A05p49740.2_BraZ1	768	-	427	1198	1350	0.8874074
A05	43502189	43503414	A05p49750.2_BraZ1	435.562	+	0	0	1225	0.0000000
A05	43507456	43509032	A05p49760.2_BraZ1	909	-	544	1435	1576	0.9105330
A05	43605726	43606056	A05p49770.2_BraZ1	234	-	0	0	330	0.0000000
A05	43608485	43608800	A05p49780.2_BraZ1	228	-	10	69	315	0.2190476
A05	43610669	43610995	A05p49790.2_BraZ1	240	-	188	326	326	1.0000000
A05	43612056	43612450	A05p49800.2_BraZ1	312	-	450	305	394	0.7741117
A05	43612636	43612973	A05p49810.2_BraZ1	246	-	0	0	337	0.0000000
A05	43616592	43618724	A05p49820.2_BraZ1	576.789	-	92	774	2132	0.3630394
A05	43619599	43619878	A05p49830.2_BraZ1	27.9	+	55	227	279	0.8136201
A05	43620865	43625226	A05p49840.2_BraZ1	3170.52	-	1417	4195	4361	0.9619353
A05	43626325	43629768	A05p49850.2_BraZ1	319.8	-	2657	3443	3443	1.0000000
A05	43632031	43634959	A05p49860.2_BraZ1	3011.3	+	1037	2743	2928	0.9368169
A05	43635232	43637265	A05p49870.2_BraZ1	1011	-	879	2033	2033	1.0000000
A05	43638101	43641361	A05p49880.2_BraZ1	1789.52	+	1583	3260	3260	1.0000000
A05	43641978	43649510	A05p49890.2_BraZ1	3144.43	-	3341	7456	7532	0.9899097
A05	43660238	43661842	A05p49900.2_BraZ1	796.571	+	428	1276	1604	0.7955112
A05	43667076	43668952	A05p49910.2_BraZ1	1446.12	+	506	1510	1876	0.8049040
A05	43671407	43673647	A05p49920.2_BraZ1	1460.32	+	1655	2240	2240	1.0000000
A05	43673868	43675578	A05p49930.2_BraZ1	930.886	-	1378	1644	1710	0.9614035
A05	43677030	43677654	A05p49940.2_BraZ1	62.4	+	107	624	624	1.0000000
A05	43678482	43679432	A05p49950.2_BraZ1	462	+	608	950	950	1.0000000
A05	43680249	43682901	A05p49960.2_BraZ1	265.2	+	307	2112	2652	0.7963801
A05	43683699	43685263	A05p49970.2_BraZ1	1579.5	-	102	1021	1564	0.6528133
A05	43688883	43689257	A05p49980.2_BraZ1	396	+	346	374	374	1.0000000
A05	43690312	43692926	A05p49990.2_BraZ1	1439.71	+	678	1906	2614	0.7291507
A05	43827555	43829102	A05p50000.2_BraZ1	789	+	1009	1369	1547	0.8849386
A05	43829441	43830548	A05p50010.2_BraZ1	110.7	-	281	1026	1107	0.9268293
A05	43833712	43840779	A05p50020.2_BraZ1	832.396	+	1455	5408	7067	0.7652469
A05	43841350	43842205	A05p50030.2_BraZ1	633	-	355	852	855	0.9964913
A05	43843118	43843663	A05p50040.2_BraZ1	456	-	192	545	545	1.0000000
A05	43844998	43845502	A05p50050.2_BraZ1	50.4	-	99	453	504	0.8988096
A05	43845814	43847421	A05p50060.2_BraZ1	360	+	851	1607	1607	1.0000000
A05	43847955	43850606	A05p50070.2_BraZ1	2156.44	-	355	2144	2651	0.8087514
A05	43851669	43860293	A05p50080.2_BraZ1	871.451	-	2477	7585	8624	0.8795223
A05	43861804	43862899	A05p50090.2_BraZ1	470.27	+	531	1078	1095	0.9844749
A05	43863747	43866777	A05p50100.2_BraZ1	943.824	+	911	2871	3030	0.9475247
A05	43867406	43869085	A05p50110.2_BraZ1	918.145	+	761	1650	1679	0.9827278
A05	43869441	43870148	A05p50120.2_BraZ1	331.295	+	420	707	707	1.0000000
A05	43870594	43873507	A05p50130.2_BraZ1	1483.71	-	1639	2855	2913	0.9800892
A05	43874421	43878459	A05p50140.2_BraZ1	3403	-	845	3349	4038	0.8293710
A05	43880308	43882656	A05p50150.2_BraZ1	921	-	867	2283	2348	0.9723169
A05	43881558	43882656	A05p50160.2_BraZ1	204	-	632	1098	1098	1.0000000
A05	43883064	43883234	A05p50170.2_BraZ1	102	+	118	170	170	1.0000000
A05	43883334	43886002	A05p50180.2_BraZ1	946.286	+	2360	2668	2668	1.0000000
A05	43886508	43888127	A05p50190.2_BraZ1	875.357	+	858	1346	1619	0.8313774
A05	43888820	43889614	A05p50200.2_BraZ1	8176.5	+	222	751	794	0.9458438
A05	43890481	43892235	A05p50210.2_BraZ1	11143.5	-	7	141	1754	0.0803877
A05	44032589	44034909	A05p50220.2_BraZ1	17856	-	1206	2007	2320	0.8650862
A05	44039444	44040023	A05p50230.2_BraZ1	57.9	-	152	524	579	0.9050086
A05	44046195	44048264	A05p50240.2_BraZ1	1785.37	-	766	1846	2069	0.8922185
A05	44049132	44051257	A05p50250.2_BraZ1	1094.14	-	364	1929	2125	0.9077647
A05	44052389	44056578	A05p50260.2_BraZ1	1487.5	+	2430	3784	4189	0.9033182
A05	44057490	44061464	A05p50270.2_BraZ1	2111.89	+	1365	3592	3974	0.9038752
A05	44061541	44062669	A05p50280.2_BraZ1	112.8	-	210	973	1128	0.8625886
A05	44064843	44065008	A05p50290.2_BraZ1	16.5	+	215	165	165	1.0000000
A05	44065760	44067580	A05p50300.2_BraZ1	1042.96	-	410	1493	1820	0.8203297
A05	44068151	44069916	A05p50310.2_BraZ1	811.952	-	693	1503	1765	0.8515581
A05	44070843	44072949	A05p50320.2_BraZ1	1596.86	+	513	1885	2106	0.8950617
A05	44074615	44075658	A05p50330.2_BraZ1	546.429	+	623	982	1043	0.9415148
A05	44076627	44076944	A05p50340.2_BraZ1	24.6	-	271	317	317	1.0000000
A05	44077287	44079289	A05p50350.2_BraZ1	855	+	1129	1714	2002	0.8561438
A05	44080076	44083518	A05p50360.2_BraZ1	1081.2	+	1845	3374	3442	0.9802440
A05	44083967	44086235	A05p50370.2_BraZ1	1286.25	-	1148	2137	2268	0.9422399
A05	44087269	44088130	A05p50380.2_BraZ1	533	+	760	861	861	1.0000000
A05	44089011	44090643	A05p50390.2_BraZ1	163.2	+	481	874	1632	0.5355392
A05	44090923	44091787	A05p50400.2_BraZ1	186	-	108	802	864	0.9282407
A05	44093119	44094680	A05p50410.2_BraZ1	498.058	-	525	1016	1561	0.6508648
A05	44095552	44098325	A05p50420.2_BraZ1	1542.89	-	2285	2773	2773	1.0000000
A05	44103488	44106805	A05p50430.2_BraZ1	1645.9	-	3276	3248	3317	0.9791981
A05	44198928	44199246	A05p50440.2_BraZ1	207	+	2	21	318	0.0660377
A05	44200493	44201081	A05p50450.2_BraZ1	492	-	0	0	588	0.0000000
A05	44209423	44210173	A05p50460.2_BraZ1	233.909	-	21	399	750	0.5320000
A05	44210751	44213749	A05p50470.2_BraZ1	882.214	-	520	1738	2998	0.5797198
A05	44214493	44216778	A05p50480.2_BraZ1	1488.56	+	796	2042	2285	0.8936543
A05	44218182	44218864	A05p50490.2_BraZ1	546	+	415	601	682	0.8812317
A05	44219671	44227974	A05p50500.2_BraZ1	3720.56	+	794	5156	8303	0.6209804
A05	44231036	44320042	A05p50510.2_BraZ1	1573.15	+	18672	68521	89006	0.7698470
A05	44320915	44321289	A05p50520.2_BraZ1	213	+	119	347	374	0.9278075
A05	44327355	44328294	A05p50530.2_BraZ1	93.9	-	592	868	939	0.9243876
A05	44330798	44332398	A05p50540.2_BraZ1	1073.1	-	826	1554	1600	0.9712500
A05	44334467	44336189	A05p50550.2_BraZ1	1162.05	+	754	1506	1722	0.8745645
A05	44337012	44337969	A05p50560.2_BraZ1	95.7	-	556	957	957	1.0000000
A05	44340400	44342683	A05p50570.2_BraZ1	1002.69	+	1270	2227	2283	0.9754709
A05	44345339	44345525	A05p50580.2_BraZ1	18.6	+	173	186	186	1.0000000
A05	44346849	44347038	A05p50590.2_BraZ1	18.9	-	79	125	189	0.6613756
A05	44349733	44350870	A05p50600.2_BraZ1	435	-	983	1136	1137	0.9991205
A05	44351301	44353066	A05p50610.2_BraZ1	1147.5	+	1842	1765	1765	1.0000000
A05	44360546	44361157	A05p50620.2_BraZ1	326.4	-	249	611	611	1.0000000
A05	44361670	44363441	A05p50630.2_BraZ1	1251.76	+	609	1642	1771	0.9271598
A05	44364120	44366693	A05p50640.2_BraZ1	1870.13	-	1092	2109	2573	0.8196658
A05	44368168	44368832	A05p50650.2_BraZ1	265.714	+	272	664	664	1.0000000
A05	44368832	44385887	A05p50660.2_BraZ1	7604.08	+	6218	12982	17055	0.7611844
A05	44379102	44379727	A05p50670.2_BraZ1	297	+	0	0	625	0.0000000
A05	44386577	44386919	A05p50680.2_BraZ1	34.2	-	199	342	342	1.0000000
A05	44387481	44389611	A05p50690.2_BraZ1	916.317	-	1058	2069	2130	0.9713615
A05	44392301	44394289	A05p50700.2_BraZ1	1108.46	+	1748	1988	1988	1.0000000
A05	44486968	44488031	A05p50710.2_BraZ1	8892.75	-	1067	1063	1063	1.0000000
A05	44488813	44489856	A05p50720.2_BraZ1	11364.4	+	542	1043	1043	1.0000000
A05	44490129	44492173	A05p50730.2_BraZ1	1302	-	735	1713	2044	0.8380626
A05	44493156	44498114	A05p50740.2_BraZ1	1144.61	+	2351	4676	4958	0.9431222
A05	44499500	44501897	A05p50750.2_BraZ1	9225	+	960	1891	2397	0.7889028
A05	44503871	44505379	A05p50760.2_BraZ1	317.8	-	190	1410	1508	0.9350132
A05	44507524	44511835	A05p50770.2_BraZ1	2013.12	+	1957	4009	4311	0.9299467
A05	44511725	44515619	A05p50780.2_BraZ1	1062.18	+	1685	3839	3894	0.9858757
A05	44515881	44517123	A05p50790.2_BraZ1	124.2	-	798	1242	1242	1.0000000
A05	44518040	44519600	A05p50800.2_BraZ1	1467	-	149	1155	1560	0.7403846
A05	44521727	44522610	A05p50810.2_BraZ1	138	-	169	475	883	0.5379388
A05	44524577	44526687	A05p50820.2_BraZ1	685.768	+	1509	2075	2110	0.9834123
A05	44527361	44531324	A05p50830.2_BraZ1	1525.98	-	1374	3769	3963	0.9510472
A05	44532916	44549896	A05p50840.2_BraZ1	13671.5	+	1453	4402	16980	0.2592462
A05	44554830	44557254	A05p50850.2_BraZ1	1441.52	+	921	1925	2424	0.7941419
A05	44557737	44558915	A05p50860.2_BraZ1	2779.5	-	477	1048	1178	0.8896435
A05	44560616	44562433	A05p50870.2_BraZ1	1054.65	-	526	1709	1817	0.9405614
A05	44564312	44565577	A05p50880.2_BraZ1	629.227	+	636	1265	1265	1.0000000
A05	44566260	44568285	A05p50890.2_BraZ1	977.67	+	960	1983	2025	0.9792593
A05	44568647	44570782	A05p50900.2_BraZ1	1010.33	-	1443	2135	2135	1.0000000
A05	44571236	44571475	A05p50910.2_BraZ1	153	+	158	239	239	1.0000000
A05	44579479	44582270	A05p50920.2_BraZ1	2947.38	+	1186	2676	2791	0.9587961
A05	44585781	44587492	A05p50930.2_BraZ1	1179.9	-	578	1626	1711	0.9503214
A05	44589807	44590792	A05p50940.2_BraZ1	273	-	303	957	985	0.9715736
A05	44590792	44592811	A05p50950.2_BraZ1	873	-	743	2014	2019	0.9975235
A05	44595470	44596031	A05p50960.2_BraZ1	56.1	-	0	0	561	0.0000000
A05	44601461	44604180	A05p50970.2_BraZ1	11457.2	-	1347	2719	2719	1.0000000
A05	44614150	44616677	A05p50980.2_BraZ1	4640.88	-	3915	2527	2527	1.0000000
A05	44619373	44620204	A05p50990.2_BraZ1	83.1	+	383	590	831	0.7099879
A05	44620835	44622708	A05p51000.2_BraZ1	584.182	-	190	1018	1873	0.5435131
A05	44777396	44779952	A05p51010.2_BraZ1	1193.46	+	475	2266	2556	0.8865415
A05	44780263	44780824	A05p51020.2_BraZ1	56.1	+	101	481	561	0.8573975
A05	44782276	44783575	A05p51030.2_BraZ1	1227	-	235	1267	1299	0.9753656
A05	44784574	44786102	A05p51040.2_BraZ1	8950.5	+	139	1044	1528	0.6832461
A05	44786931	44789424	A05p51050.2_BraZ1	1477.88	-	664	2259	2493	0.9061372
A05	44789742	44790791	A05p51060.2_BraZ1	425.739	+	678	1049	1049	1.0000000
A05	44791388	44793654	A05p51070.2_BraZ1	1441.8	+	782	2152	2266	0.9496911
A05	44794670	44795521	A05p51080.2_BraZ1	534	+	401	851	851	1.0000000
A05	44800542	44806010	A05p51090.2_BraZ1	3440.13	+	2154	5096	5468	0.9319678
A05	44806722	44815181	A05p51100.2_BraZ1	2374.81	-	3569	7809	8459	0.9231588
A05	44816028	44816381	A05p51110.2_BraZ1	153	+	318	353	353	1.0000000
A05	44816904	44819449	A05p51120.2_BraZ1	1400.51	-	949	2545	2545	1.0000000
A05	44822438	44822715	A05p51130.2_BraZ1	19.8	-	91	266	277	0.9602888
A05	44826261	44827242	A05p51140.2_BraZ1	508.607	-	65	694	981	0.7074414
A05	44830642	44831017	A05p51150.2_BraZ1	273	-	14	182	375	0.4853333
A05	44834189	44836826	A05p51160.2_BraZ1	973.447	+	530	2339	2637	0.8869928
A05	44837338	44840089	A05p51170.2_BraZ1	2168.43	-	1545	2693	2751	0.9789168
A05	44840659	44841301	A05p51180.2_BraZ1	64.2	+	619	642	642	1.0000000
A05	44842196	44845328	A05p51190.2_BraZ1	2049.63	-	1245	3082	3132	0.9840357
A05	44846072	44847295	A05p51200.2_BraZ1	900.465	-	196	943	1223	0.7710548
A05	44848865	44851133	A05p51210.2_BraZ1	556.744	-	447	2046	2268	0.9021164
A05	44851914	44862271	A05p51220.2_BraZ1	831.6	+	3540	8271	10357	0.7985903
A05	44852268	44853543	A05p51230.2_BraZ1	309	+	128	1112	1275	0.8721569
A05	44856258	44856636	A05p51240.2_BraZ1	37.8	-	0	0	378	0.0000000
A05	44858463	44858856	A05p51250.2_BraZ1	39.3	-	30	287	393	0.7302799
A05	44859278	44859761	A05p51260.2_BraZ1	48.3	+	15	247	483	0.5113872
A05	44973667	44974057	A05p51270.2_BraZ1	270	+	957	390	390	1.0000000
A05	44976334	44978453	A05p51280.2_BraZ1	1421.15	-	795	2119	2119	1.0000000
A05	44981212	44982344	A05p51290.2_BraZ1	942.857	-	320	1095	1132	0.9673145
A05	44985137	44987320	A05p51300.2_BraZ1	600	-	586	1646	2183	0.7540082
A05	44988681	44990781	A05p51310.2_BraZ1	988.882	-	603	2100	2100	1.0000000
A05	44991214	44992123	A05p51320.2_BraZ1	90.9	-	135	785	909	0.8635864
A05	44996707	44998931	A05p51330.2_BraZ1	528	+	2980	2196	2224	0.9874101
A05	44999962	45000668	A05p51340.2_BraZ1	314.667	-	115	263	706	0.3725213
A05	45005173	45007703	A05p51350.2_BraZ1	1604.24	+	1035	2261	2530	0.8936759
A05	45007935	45008937	A05p51360.2_BraZ1	100.2	-	318	942	1002	0.9401197
A05	45009224	45013520	A05p51370.2_BraZ1	2356	+	810	3651	4296	0.8498603
A05	45013847	45018928	A05p51380.2_BraZ1	2658.07	-	1848	4890	5081	0.9624090
A05	45019324	45019910	A05p51390.2_BraZ1	10822.5	-	641	586	586	1.0000000
A05	45021179	45025554	A05p51400.2_BraZ1	1631.16	-	2313	4158	4375	0.9504000
A05	45033246	45034428	A05p51410.2_BraZ1	339.714	-	875	1182	1182	1.0000000
A05	45034671	45035523	A05p51420.2_BraZ1	672	+	331	712	852	0.8356807
A05	45036128	45036424	A05p51430.2_BraZ1	234	+	0	0	296	0.0000000
A05	45037562	45046370	A05p51440.2_BraZ1	6363.94	+	1476	6547	8808	0.7433016
A05	45046996	45048202	A05p51450.2_BraZ1	715.821	-	501	1147	1206	0.9510779
A05	45054372	45056168	A05p51460.2_BraZ1	1167.67	+	1398	1796	1796	1.0000000
A05	45056572	45058643	A05p51470.2_BraZ1	929.014	-	741	1938	2071	0.9357798
A05	45062233	45066181	A05p51480.2_BraZ1	1068.21	-	975	3421	3948	0.8665147
A05	45073748	45074314	A05p51490.2_BraZ1	54.9	+	555	566	566	1.0000000
A05	45074807	45075775	A05p51500.2_BraZ1	496.435	+	888	968	968	1.0000000
A05	45077254	45078731	A05p51510.2_BraZ1	603.955	-	1015	1477	1477	1.0000000
A05	45081499	45082745	A05p51520.2_BraZ1	8550	-	1370	1246	1246	1.0000000
A05	45083021	45084692	A05p51530.2_BraZ1	167.1	+	2009	1671	1671	1.0000000
A05	45085957	45088618	A05p51540.2_BraZ1	1285.37	+	3135	2661	2661	1.0000000
A05	45198884	45199798	A05p51550.2_BraZ1	837	+	1003	914	914	1.0000000
A05	45200511	45203558	A05p51560.2_BraZ1	2374.4	+	2972	3047	3047	1.0000000
A05	45206018	45209075	A05p51570.2_BraZ1	2085.45	+	2288	3057	3057	1.0000000
A05	45210876	45212274	A05p51580.2_BraZ1	400	+	1230	1398	1398	1.0000000
A05	45212979	45213144	A05p51590.2_BraZ1	16.5	+	245	165	165	1.0000000
A05	45213546	45213963	A05p51600.2_BraZ1	41.7	+	611	417	417	1.0000000
A05	45215040	45215417	A05p51610.2_BraZ1	273	+	0	0	377	0.0000000
A05	45217477	45220895	A05p51620.2_BraZ1	834.505	+	3509	3418	3418	1.0000000
A05	45220322	45220511	A05p51630.2_BraZ1	108	-	270	189	189	1.0000000
A05	45222628	45224512	A05p51640.2_BraZ1	20631	-	2062	1884	1884	1.0000000
A05	45227567	45229340	A05p51650.2_BraZ1	177.3	+	1897	1773	1773	1.0000000
A05	45231428	45232935	A05p51660.2_BraZ1	147.9	-	1478	1507	1507	1.0000000
A05	45235466	45236517	A05p51670.2_BraZ1	588	-	891	1051	1051	1.0000000
A05	45237075	45237872	A05p51680.2_BraZ1	55.5	-	364	797	797	1.0000000
A05	45238358	45238571	A05p51690.2_BraZ1	21.3	-	321	213	213	1.0000000
A05	45240068	45240281	A05p51700.2_BraZ1	21.3	+	371	213	213	1.0000000
A05	45243752	45244534	A05p51710.2_BraZ1	273	-	675	782	782	1.0000000
A05	45253494	45254573	A05p51720.2_BraZ1	471	-	110	763	1079	0.7071362
A05	45254638	45255103	A05p51730.2_BraZ1	252	+	248	465	465	1.0000000
A05	45255509	45256032	A05p51740.2_BraZ1	435	-	444	523	523	1.0000000
A05	45257832	45258000	A05p51750.2_BraZ1	16.8	-	135	168	168	1.0000000
A05	45258603	45261231	A05p51760.2_BraZ1	1029.63	+	850	2538	2628	0.9657534
A05	45262049	45262496	A05p51770.2_BraZ1	562.5	+	8	143	447	0.3199105
A05	45263754	45264236	A05p51780.2_BraZ1	342	+	0	0	482	0.0000000
A06	10124	12354	A06p00010.2_BraZ1	13284	-	5	271	2230	0.1215247
A06	12669	13095	A06p00020.2_BraZ1	42.6	-	70	384	426	0.9014084
A06	174588	177027	A06p00030.2_BraZ1	1082.48	-	45	980	2439	0.4018040
A06	182971	185415	A06p00040.2_BraZ1	1082.48	-	189	1766	2444	0.7225859
A06	189151	191165	A06p00050.2_BraZ1	1194.58	+	1092	1923	2014	0.9548163
A06	202077	203886	A06p00060.2_BraZ1	1076.21	-	422	1623	1809	0.8971807
A06	212611	213881	A06p00070.2_BraZ1	1032	-	243	1225	1270	0.9645669
A06	226600	228847	A06p00080.2_BraZ1	1297.04	+	1558	2247	2247	1.0000000
A06	229294	232068	A06p00090.2_BraZ1	1158.16	-	2513	2774	2774	1.0000000
A06	235976	236417	A06p00100.2_BraZ1	44.1	+	59	441	441	1.0000000
A06	242600	243890	A06p00110.2_BraZ1	693	-	1681	1290	1290	1.0000000
A06	248239	248614	A06p00120.2_BraZ1	37.5	+	185	375	375	1.0000000
A06	252784	255774	A06p00130.2_BraZ1	1998.27	+	4027	2990	2990	1.0000000
A06	256068	256412	A06p00140.2_BraZ1	273	-	494	344	344	1.0000000
A06	256725	258798	A06p00150.2_BraZ1	1068.56	+	1030	2073	2073	1.0000000
A06	259032	260145	A06p00160.2_BraZ1	733.652	-	533	1020	1113	0.9164420
A06	263432	265467	A06p00170.2_BraZ1	788.716	-	309	1614	2035	0.7931204
A06	265031	266746	A06p00180.2_BraZ1	459.667	-	863	1632	1715	0.9516035
A06	268796	270875	A06p00190.2_BraZ1	974.55	+	999	2037	2079	0.9797980
A06	271694	310600	A06p00200.2_BraZ1	813	-	7302	30018	38906	0.7715520
A06	319962	320949	A06p00210.2_BraZ1	98.7	+	632	987	987	1.0000000
A06	329194	329892	A06p00220.2_BraZ1	4563	+	733	698	698	1.0000000
A06	332829	333341	A06p00230.2_BraZ1	258	-	542	512	512	1.0000000
A06	334331	334754	A06p00240.2_BraZ1	42.3	+	583	423	423	1.0000000
A06	335704	339487	A06p00250.2_BraZ1	1522.96	-	3057	3649	3783	0.9645784
A06	339793	340663	A06p00260.2_BraZ1	399	+	246	303	870	0.3482759
A06	346361	348052	A06p00270.2_BraZ1	1133.1	+	1731	1682	1691	0.9946777
A06	349174	352301	A06p00280.2_BraZ1	2169.29	+	708	2620	3127	0.8378637
A06	354481	354835	A06p00290.2_BraZ1	246	+	53	354	354	1.0000000
A06	371397	373817	A06p00300.2_BraZ1	1590.36	+	387	1679	2420	0.6938016
A06	374951	376033	A06p00310.2_BraZ1	819	+	444	1076	1082	0.9944547
A06	379551	381976	A06p00320.2_BraZ1	2277	-	1926	2425	2425	1.0000000
A06	383501	384065	A06p00330.2_BraZ1	56.4	+	295	564	564	1.0000000
A06	384699	385375	A06p00340.2_BraZ1	2628	+	682	676	676	1.0000000
A06	387628	388195	A06p00350.2_BraZ1	56.7	-	223	567	567	1.0000000
A06	397894	399213	A06p00360.2_BraZ1	564.136	+	597	1258	1319	0.9537528
A06	406023	407473	A06p00370.2_BraZ1	1308	-	800	1450	1450	1.0000000
A06	409866	411092	A06p00380.2_BraZ1	608.4	-	718	1226	1226	1.0000000
A06	412980	413985	A06p00390.2_BraZ1	488.25	+	677	1005	1005	1.0000000
A06	415779	429304	A06p00400.2_BraZ1	5850.41	+	6653	12287	13525	0.9084658
A06	430402	430582	A06p00410.2_BraZ1	18	-	113	180	180	1.0000000
A06	433389	434272	A06p00420.2_BraZ1	488.704	+	826	883	883	1.0000000
A06	503806	513184	A06p00430.2_BraZ1	4552.74	-	3378	8880	9378	0.9468970
A06	517879	518288	A06p00440.2_BraZ1	39	-	348	409	409	1.0000000
A06	519362	520601	A06p00450.2_BraZ1	942.375	+	668	1239	1239	1.0000000
A06	522777	523946	A06p00460.2_BraZ1	5032.5	-	962	1169	1169	1.0000000
A06	525201	526189	A06p00470.2_BraZ1	918	-	1883	988	988	1.0000000
A06	530188	533541	A06p00480.2_BraZ1	2382	+	1314	3110	3353	0.9275276
A06	535984	538156	A06p00490.2_BraZ1	2602.08	+	668	1690	2172	0.7780847
A06	544470	545829	A06p00500.2_BraZ1	135.9	+	51	437	1359	0.3215600
A06	552420	552999	A06p00510.2_BraZ1	432	+	233	579	579	1.0000000
A06	554926	557417	A06p00520.2_BraZ1	1932.8	-	549	1553	2491	0.6234444
A06	558463	561261	A06p00530.2_BraZ1	1502.17	-	949	2424	2798	0.8663331
A06	565695	565803	A06p00540.2_BraZ1	10.8	+	91	108	108	1.0000000
A06	565831	568587	A06p00550.2_BraZ1	697	+	520	2211	2756	0.8022496
A06	569924	573457	A06p00560.2_BraZ1	2252.19	-	1071	3166	3533	0.8961223
A06	574004	575414	A06p00570.2_BraZ1	141	-	228	1149	1410	0.8148936
A06	576231	576792	A06p00580.2_BraZ1	56.1	+	65	295	561	0.5258467
A06	580386	581867	A06p00590.2_BraZ1	975	+	330	1399	1481	0.9446320
A06	584673	585159	A06p00600.2_BraZ1	48.6	-	159	470	486	0.9670782
A06	585832	591752	A06p00610.2_BraZ1	1973.88	-	4451	5920	5920	1.0000000
A06	592224	593542	A06p00620.2_BraZ1	47.4457	-	773	1318	1318	1.0000000
A06	604737	605265	A06p00630.2_BraZ1	52.8	-	342	528	528	1.0000000
A06	606158	607741	A06p00640.2_BraZ1	132.6	-	980	1583	1583	1.0000000
A06	609188	612356	A06p00650.2_BraZ1	2214.88	+	1625	2983	3168	0.9416035
A06	612792	613829	A06p00660.2_BraZ1	722.25	-	169	828	1037	0.7984571
A06	619091	619610	A06p00670.2_BraZ1	51.9	-	2	19	519	0.0366089
A06	623191	624394	A06p00680.2_BraZ1	120.3	+	0	0	1203	0.0000000
A06	631658	631881	A06p00690.2_BraZ1	189	-	0	0	223	0.0000000
A06	713958	719530	A06p00700.2_BraZ1	765.385	+	3260	4795	5572	0.8605528
A06	720176	720608	A06p00710.2_BraZ1	43.2	-	711	432	432	1.0000000
A06	726713	729292	A06p00720.2_BraZ1	1448.77	-	1318	2577	2579	0.9992245
A06	730799	731036	A06p00730.2_BraZ1	180	+	371	237	237	1.0000000
A06	732234	732495	A06p00740.2_BraZ1	26.1	+	209	261	261	1.0000000
A06	734177	734663	A06p00750.2_BraZ1	48.6	+	169	399	486	0.8209876
A06	736586	737062	A06p00760.2_BraZ1	378	-	721	476	476	1.0000000
A06	738219	742207	A06p00770.2_BraZ1	1449.78	-	2180	3775	3988	0.9465898
A06	743476	744091	A06p00780.2_BraZ1	60.6	-	54	528	615	0.8585366
A06	745377	745992	A06p00790.2_BraZ1	60.6	-	136	615	615	1.0000000
A06	751042	758908	A06p00800.2_BraZ1	1245.83	+	2999	5887	7866	0.7484109
A06	759504	762069	A06p00810.2_BraZ1	1755	-	696	2305	2565	0.8986355
A06	764034	766236	A06p00820.2_BraZ1	1032.75	-	1411	2200	2202	0.9990917
A06	767129	769658	A06p00830.2_BraZ1	1373.88	-	1502	2501	2529	0.9889284
A06	770644	772460	A06p00840.2_BraZ1	165.3	+	805	1816	1816	1.0000000
A06	773870	775408	A06p00850.2_BraZ1	784.025	+	1492	1538	1538	1.0000000
A06	776177	776507	A06p00860.2_BraZ1	33	+	411	330	330	1.0000000
A06	782392	784937	A06p00870.2_BraZ1	1146.26	+	1901	2461	2545	0.9669941
A06	785191	788401	A06p00880.2_BraZ1	2140.36	-	1520	3012	3210	0.9383178
A06	791756	793584	A06p00890.2_BraZ1	357.333	-	233	1023	1828	0.5596280
A06	796533	796758	A06p00900.2_BraZ1	22.5	-	288	225	225	1.0000000
A06	801824	804098	A06p00910.2_BraZ1	2373	-	1792	2274	2274	1.0000000
A06	805055	808226	A06p00920.2_BraZ1	313.5	+	2462	3171	3171	1.0000000
A06	809983	810650	A06p00930.2_BraZ1	204	-	1092	667	667	1.0000000
A06	811315	811435	A06p00940.2_BraZ1	12	+	93	120	120	1.0000000
A06	822248	823572	A06p00950.2_BraZ1	655.109	+	486	1243	1324	0.9388217
A06	898827	903221	A06p00960.2_BraZ1	1310.08	+	2555	4372	4394	0.9949932
A06	908380	908662	A06p00970.2_BraZ1	28.2	+	123	207	282	0.7340425
A06	914894	915053	A06p00980.2_BraZ1	15.9	+	97	159	159	1.0000000
A06	917673	919872	A06p00990.2_BraZ1	219.9	-	853	2119	2199	0.9636198
A06	922684	924319	A06p01000.2_BraZ1	594.971	+	819	1635	1635	1.0000000
A06	924674	925652	A06p01010.2_BraZ1	169.684	+	683	956	978	0.9775051
A06	928819	932029	A06p01020.2_BraZ1	2413.55	+	723	2676	3210	0.8336449
A06	932709	934187	A06p01030.2_BraZ1	847.295	+	1206	1478	1478	1.0000000
A06	936344	942550	A06p01040.2_BraZ1	2329.43	+	4582	5717	6206	0.9212053
A06	943418	945053	A06p01050.2_BraZ1	752.875	-	564	1344	1635	0.8220183
A06	946460	948285	A06p01060.2_BraZ1	635.789	-	969	1666	1825	0.9128767
A06	948261	950057	A06p01070.2_BraZ1	1539.47	-	462	1637	1796	0.9114699
A06	951697	953802	A06p01080.2_BraZ1	1157.04	+	801	2012	2105	0.9558195
A06	954936	956457	A06p01090.2_BraZ1	1203	+	161	1303	1521	0.8566732
A06	956678	958487	A06p01100.2_BraZ1	276	-	1161	1809	1809	1.0000000
A06	959549	966181	A06p01110.2_BraZ1	2617.74	-	1419	4444	6632	0.6700844
A06	966971	972053	A06p01120.2_BraZ1	2796.76	-	2357	4769	5082	0.9384101
A06	976064	977423	A06p01130.2_BraZ1	135.9	+	233	1183	1359	0.8704930
A06	991766	994230	A06p01140.2_BraZ1	1030.5	+	2288	2464	2464	1.0000000
A06	996099	998831	A06p01150.2_BraZ1	1314.86	+	1177	2718	2732	0.9948756
A06	999193	1000751	A06p01160.2_BraZ1	882	-	1148	1558	1558	1.0000000
A06	1001171	1002413	A06p01170.2_BraZ1	124.2	+	616	1242	1242	1.0000000
A06	1004310	1005818	A06p01180.2_BraZ1	5848.15	+	1146	1508	1508	1.0000000
A06	1007702	1010615	A06p01190.2_BraZ1	1600.2	-	1258	2844	2913	0.9763131
A06	1012964	1014269	A06p01200.2_BraZ1	601.35	+	1648	1305	1305	1.0000000
A06	1015344	1017378	A06p01210.2_BraZ1	1262.62	-	1923	2034	2034	1.0000000
A06	1026042	1026573	A06p01220.2_BraZ1	53.1	+	49	531	531	1.0000000
A06	1051343	1052162	A06p01230.2_BraZ1	81.9	-	296	819	819	1.0000000
A06	1055566	1056560	A06p01240.2_BraZ1	3620	-	116	695	994	0.6991951
A06	1063740	1064966	A06p01250.2_BraZ1	591.346	-	1087	1226	1226	1.0000000
A06	1067904	1068408	A06p01260.2_BraZ1	50.4	+	6	228	504	0.4523810
A06	1070797	1072627	A06p01270.2_BraZ1	1008.65	-	844	1755	1830	0.9590164
A06	1074286	1075887	A06p01280.2_BraZ1	1000	+	234	1404	1601	0.8769519
A06	1076643	1077489	A06p01290.2_BraZ1	84.6	-	639	846	846	1.0000000
A06	1079936	1080767	A06p01300.2_BraZ1	83.1	-	137	470	831	0.5655836
A06	1084073	1084898	A06p01310.2_BraZ1	82.5	-	244	825	825	1.0000000
A06	1087240	1087678	A06p01320.2_BraZ1	43.8	+	65	360	438	0.8219178
A06	1093939	1096701	A06p01330.2_BraZ1	1519.27	+	609	2686	2762	0.9724837
A06	1097947	1098499	A06p01340.2_BraZ1	55.2	+	45	504	552	0.9130435
A06	1100798	1101017	A06p01350.2_BraZ1	21.9	+	413	219	219	1.0000000
A06	1101740	1103886	A06p01360.2_BraZ1	1230.35	+	1057	2146	2146	1.0000000
A06	1104860	1105391	A06p01370.2_BraZ1	53.1	-	35	139	531	0.2617702
A06	1106128	1108980	A06p01380.2_BraZ1	486	-	1296	2810	2852	0.9852735
A06	1114657	1115275	A06p01390.2_BraZ1	459	+	443	618	618	1.0000000
A06	1170237	1170561	A06p01400.2_BraZ1	32.4	-	9	98	324	0.3024691
A06	1171347	1171707	A06p01410.2_BraZ1	36	+	283	360	360	1.0000000
A06	1171972	1172805	A06p01420.2_BraZ1	360	-	520	833	833	1.0000000
A06	1173150	1176369	A06p01430.2_BraZ1	1753.6	-	2543	3155	3219	0.9801180
A06	1177986	1179105	A06p01440.2_BraZ1	852.714	+	129	964	1119	0.8614835
A06	1179976	1184183	A06p01450.2_BraZ1	1174.09	+	1992	3806	4207	0.9046827
A06	1181801	1182153	A06p01460.2_BraZ1	33.6	+	140	326	352	0.9261364
A06	1182192	1182834	A06p01470.2_BraZ1	734.5	+	234	564	642	0.8785047
A06	1182402	1183089	A06p01480.2_BraZ1	186	+	350	609	687	0.8864629
A06	1184336	1185272	A06p01490.2_BraZ1	7656	-	710	936	936	1.0000000
A06	1199692	1200386	A06p01500.2_BraZ1	6331.5	+	56	546	694	0.7867435
A06	1205523	1206954	A06p01510.2_BraZ1	7821	+	207	1041	1431	0.7274633
A06	1207305	1207847	A06p01520.2_BraZ1	834	+	564	542	542	1.0000000
A06	1214467	1215762	A06p01530.2_BraZ1	990.9	+	142	1051	1295	0.8115830
A06	1218950	1219274	A06p01540.2_BraZ1	32.4	+	401	324	324	1.0000000
A06	1219845	1221456	A06p01550.2_BraZ1	1098.63	-	821	1490	1611	0.9248914
A06	1224995	1225548	A06p01560.2_BraZ1	362.917	-	79	527	553	0.9529837
A06	1228750	1228957	A06p01570.2_BraZ1	20.7	+	15	110	207	0.5314010
A06	1229033	1229138	A06p01580.2_BraZ1	10.5	+	12	105	105	1.0000000
A06	1230710	1231048	A06p01590.2_BraZ1	246	+	124	338	338	1.0000000
A06	1235077	1236115	A06p01600.2_BraZ1	612	+	290	848	1038	0.8169557
A06	1236706	1237744	A06p01610.2_BraZ1	231	+	446	1038	1038	1.0000000
A06	1237289	1238560	A06p01620.2_BraZ1	954	-	140	1060	1271	0.8339890
A06	1240857	1241952	A06p01630.2_BraZ1	6762	-	212	1034	1095	0.9442922
A06	1243630	1245356	A06p01640.2_BraZ1	904.909	-	747	1426	1726	0.8261877
A06	1246239	1247332	A06p01650.2_BraZ1	933	+	130	961	1093	0.8792315
A06	1247751	1250919	A06p01660.2_BraZ1	316.8	-	1676	3168	3168	1.0000000
A06	1258906	1259215	A06p01670.2_BraZ1	225	-	14	277	309	0.8964401
A06	1261894	1262203	A06p01680.2_BraZ1	225	-	19	183	309	0.5922330
A06	1267385	1269224	A06p01690.2_BraZ1	1356	-	417	1477	1839	0.8031539
A06	1272449	1272712	A06p01700.2_BraZ1	16.5	-	64	263	263	1.0000000
A06	1274057	1274972	A06p01710.2_BraZ1	580	+	602	915	915	1.0000000
A06	1276489	1278330	A06p01720.2_BraZ1	1078.79	-	186	1137	1841	0.6175991
A06	1280417	1282882	A06p01730.2_BraZ1	1762.86	+	1631	2465	2465	1.0000000
A06	1283317	1284558	A06p01740.2_BraZ1	408	-	1497	1241	1241	1.0000000
A06	1285003	1286481	A06p01750.2_BraZ1	974.235	-	1395	1478	1478	1.0000000
A06	1289000	1291235	A06p01760.2_BraZ1	660.214	+	1773	2235	2235	1.0000000
A06	1292885	1293589	A06p01770.2_BraZ1	317.864	+	93	340	704	0.4829545
A06	1294556	1295780	A06p01780.2_BraZ1	7351.5	-	293	1089	1224	0.8897059
A06	1297686	1299270	A06p01790.2_BraZ1	158.4	+	1405	1584	1584	1.0000000
A06	1299752	1301668	A06p01800.2_BraZ1	1253.97	+	924	1914	1916	0.9989561
A06	1302594	1305102	A06p01810.2_BraZ1	240.9	-	1159	2280	2508	0.9090909
A06	1306708	1306866	A06p01820.2_BraZ1	11.1	+	13	158	158	1.0000000
A06	1308664	1309899	A06p01830.2_BraZ1	519.494	-	853	1235	1235	1.0000000
A06	1314249	1315762	A06p01840.2_BraZ1	948	-	203	1057	1513	0.6986120
A06	1320348	1320815	A06p01850.2_BraZ1	396	+	211	445	467	0.9528908
A06	1324148	1325239	A06p01860.2_BraZ1	699	+	123	745	1091	0.6828598
A06	1326770	1330000	A06p01870.2_BraZ1	338	-	1024	2314	3230	0.7164087
A06	1331534	1332944	A06p01880.2_BraZ1	1017	+	618	1402	1410	0.9943262
A06	1333994	1339975	A06p01890.2_BraZ1	1784.18	-	757	3565	5981	0.5960542
A06	1408634	1411798	A06p01900.2_BraZ1	1353.02	-	438	2415	3164	0.7632743
A06	1419423	1420067	A06p01910.2_BraZ1	513	-	168	452	644	0.7018633
A06	1420236	1425267	A06p01920.2_BraZ1	1558.86	+	1796	4873	5031	0.9685947
A06	1428688	1429897	A06p01930.2_BraZ1	119.4	-	1451	1209	1209	1.0000000
A06	1431810	1433176	A06p01940.2_BraZ1	741	+	550	1054	1366	0.7715959
A06	1434641	1435957	A06p01950.2_BraZ1	855	+	760	1316	1316	1.0000000
A06	1436730	1440033	A06p01960.2_BraZ1	2275.57	-	1504	3045	3303	0.9218892
A06	1441188	1442625	A06p01970.2_BraZ1	753.946	-	894	1384	1437	0.9631176
A06	1442733	1443174	A06p01980.2_BraZ1	147	-	318	441	441	1.0000000
A06	1443675	1445491	A06p01990.2_BraZ1	1092	-	692	1816	1816	1.0000000
A06	1447330	1449813	A06p02000.2_BraZ1	498.167	+	650	1691	2483	0.6810310
A06	1450707	1452026	A06p02010.2_BraZ1	553.255	+	881	1319	1319	1.0000000
A06	1452228	1455236	A06p02020.2_BraZ1	1257.55	-	2957	2865	3008	0.9524601
A06	1457699	1462145	A06p02030.2_BraZ1	1756.86	+	1162	3582	4446	0.8056680
A06	1462372	1462964	A06p02040.2_BraZ1	438	-	141	514	592	0.8682432
A06	1463261	1464224	A06p02050.2_BraZ1	438	+	199	827	963	0.8587747
A06	1465048	1466100	A06p02060.2_BraZ1	547.105	+	102	989	1052	0.9401141
A06	1467230	1471350	A06p02070.2_BraZ1	1669.25	-	844	2927	4120	0.7104369
A06	1486813	1490515	A06p02080.2_BraZ1	2260.25	+	2126	3473	3702	0.9381415
A06	1491075	1492570	A06p02090.2_BraZ1	816.896	-	761	1495	1495	1.0000000
A06	1496915	1500937	A06p02100.2_BraZ1	2389.15	+	1999	3897	4022	0.9689209
A06	1502282	1503258	A06p02110.2_BraZ1	320.64	+	114	422	976	0.4323770
A06	1506042	1506823	A06p02120.2_BraZ1	835.714	+	480	781	781	1.0000000
A06	1507362	1509496	A06p02130.2_BraZ1	6655	+	1371	1937	2134	0.9076851
A06	1511823	1515668	A06p02140.2_BraZ1	2114.67	+	1599	3251	3845	0.8455136
A06	1530576	1531387	A06p02150.2_BraZ1	219	-	88	673	811	0.8298397
A06	1531815	1539610	A06p02160.2_BraZ1	1203	+	8747	7685	7795	0.9858884
A06	1540991	1542819	A06p02170.2_BraZ1	390	+	2470	1828	1828	1.0000000
A06	1545867	1548461	A06p02180.2_BraZ1	1224	+	1390	2476	2594	0.9545104
A06	1553339	1553510	A06p02190.2_BraZ1	17.1	+	254	171	171	1.0000000
A06	1558792	1562626	A06p02200.2_BraZ1	20320	+	679	3347	3834	0.8729786
A06	1563783	1567018	A06p02210.2_BraZ1	1301.35	+	1417	3235	3235	1.0000000
A06	1568708	1570030	A06p02220.2_BraZ1	9906	-	880	1322	1322	1.0000000
A06	1577088	1577673	A06p02230.2_BraZ1	58.5	-	896	585	585	1.0000000
A06	1580699	1583771	A06p02240.2_BraZ1	1365.94	+	1376	2920	3072	0.9505208
A06	1585270	1595989	A06p02250.2_BraZ1	2468.27	+	4571	9319	10719	0.8693908
A06	1601766	1611913	A06p02260.2_BraZ1	464.4	+	6111	9686	10147	0.9545678
A06	1613249	1617329	A06p02270.2_BraZ1	262.2	+	1662	3581	4080	0.8776961
A06	1617790	1618003	A06p02280.2_BraZ1	21.3	-	10	134	213	0.6291080
A06	1618795	1621091	A06p02290.2_BraZ1	1240.31	-	373	2191	2296	0.9542683
A06	1622777	1627847	A06p02300.2_BraZ1	2579.97	-	1435	4648	5070	0.9167653
A06	1628178	1629518	A06p02310.2_BraZ1	456	+	164	1036	1340	0.7731344
A06	1630020	1633508	A06p02320.2_BraZ1	1807.03	-	928	3111	3488	0.8919151
A06	1636129	1643479	A06p02330.2_BraZ1	1971.18	+	3547	7034	7350	0.9570068
A06	1644635	1647635	A06p02340.2_BraZ1	1208.06	-	1591	2896	3000	0.9653333
A06	1651674	1657037	A06p02350.2_BraZ1	3690.73	-	234	2188	5363	0.4079806
A06	1658203	1658633	A06p02360.2_BraZ1	192	-	598	430	430	1.0000000
A06	1661091	1661895	A06p02370.2_BraZ1	35.4194	-	549	804	804	1.0000000
A06	1663855	1665715	A06p02380.2_BraZ1	186	+	1024	1860	1860	1.0000000
A06	1666695	1668404	A06p02390.2_BraZ1	1083.88	+	736	1647	1709	0.9637215
A06	1668951	1670296	A06p02400.2_BraZ1	733.2	-	78	447	1345	0.3323420
A06	1671036	1674109	A06p02410.2_BraZ1	1264.37	-	1218	2834	3073	0.9222258
A06	1676946	1680954	A06p02420.2_BraZ1	1556.31	+	2203	3954	4008	0.9865270
A06	1681526	1682546	A06p02430.2_BraZ1	102	+	974	1020	1020	1.0000000
A06	1684322	1686754	A06p02440.2_BraZ1	205.5	-	1562	2412	2432	0.9917763
A06	1688516	1694936	A06p02450.2_BraZ1	3042	-	3469	6395	6420	0.9961059
A06	1695682	1699185	A06p02460.2_BraZ1	9166.5	-	2648	3503	3503	1.0000000
A06	1698977	1700921	A06p02470.2_BraZ1	4422.86	-	1454	1944	1944	1.0000000
A06	1702099	1703567	A06p02480.2_BraZ1	600	+	465	1430	1468	0.9741144
A06	1707646	1712157	A06p02490.2_BraZ1	1999.5	+	3542	4496	4511	0.9966748
A06	1712933	1715015	A06p02500.2_BraZ1	1350	-	1190	2078	2082	0.9980788
A06	1723280	1724831	A06p02510.2_BraZ1	155.1	-	499	1374	1551	0.8858801
A06	1728482	1731689	A06p02520.2_BraZ1	1125	-	1206	2713	3207	0.8459620
A06	1732165	1733853	A06p02530.2_BraZ1	880.312	+	6	350	1688	0.2073460
A06	1734415	1735023	A06p02540.2_BraZ1	348	-	80	608	608	1.0000000
A06	1740897	1741206	A06p02550.2_BraZ1	30.9	+	150	309	309	1.0000000
A06	1741603	1743553	A06p02560.2_BraZ1	747.9	-	868	1741	1950	0.8928205
A06	1744953	1745495	A06p02570.2_BraZ1	351	+	101	287	542	0.5295203
A06	1747729	1747945	A06p02580.2_BraZ1	21.6	-	180	216	216	1.0000000
A06	1750033	1750387	A06p02590.2_BraZ1	35.4	-	35	354	354	1.0000000
A06	1751101	1751308	A06p02600.2_BraZ1	20.7	+	164	207	207	1.0000000
A06	1756061	1756493	A06p02610.2_BraZ1	2124	-	53	432	432	1.0000000
A06	1758391	1758967	A06p02620.2_BraZ1	102	-	224	576	576	1.0000000
A06	1760386	1763466	A06p02630.2_BraZ1	1835.82	-	1923	2907	3080	0.9438311
A06	1771389	1773485	A06p02640.2_BraZ1	1047	+	119	831	2096	0.3964695
A06	1774481	1775867	A06p02650.2_BraZ1	138.6	-	1449	1386	1386	1.0000000
A06	1777120	1777627	A06p02660.2_BraZ1	50.7	-	506	507	507	1.0000000
A06	1780840	1783513	A06p02670.2_BraZ1	1680	-	256	1874	2673	0.7010849
A06	1799226	1800459	A06p02680.2_BraZ1	123.3	+	105	888	1233	0.7201946
A06	1808354	1809848	A06p02690.2_BraZ1	490	-	850	1494	1494	1.0000000
A06	1819069	1819651	A06p02700.2_BraZ1	58.2	-	317	395	582	0.6786941
A06	1821139	1822692	A06p02710.2_BraZ1	1066.25	+	285	1516	1553	0.9761751
A06	1826957	1828938	A06p02720.2_BraZ1	1061.33	+	637	1870	1981	0.9439677
A06	1829245	1833584	A06p02730.2_BraZ1	1844.83	-	2044	4204	4339	0.9688869
A06	1834434	1835070	A06p02740.2_BraZ1	63.6	-	196	572	636	0.8993711
A06	1836458	1837304	A06p02750.2_BraZ1	84.6	+	371	846	846	1.0000000
A06	1837672	1838916	A06p02760.2_BraZ1	761.583	-	1502	1244	1244	1.0000000
A06	1840099	1840312	A06p02770.2_BraZ1	21.3	-	340	178	213	0.8356807
A06	1841391	1861293	A06p02780.2_BraZ1	542.4	-	12292	19448	19902	0.9771882
A06	1862999	1872642	A06p02790.2_BraZ1	5613.32	-	2740	7615	9643	0.7896920
A06	1875365	1876610	A06p02800.2_BraZ1	124.5	+	110	744	1245	0.5975904
A06	1879710	1880544	A06p02810.2_BraZ1	83.4	+	41	147	834	0.1762590
A06	1884274	1884934	A06p02820.2_BraZ1	576	+	75	584	660	0.8848485
A06	1885220	1889126	A06p02830.2_BraZ1	1326.45	-	1453	3851	3906	0.9859191
A06	1891624	1893982	A06p02840.2_BraZ1	235.8	-	2473	2358	2358	1.0000000
A06	1895620	1896359	A06p02850.2_BraZ1	521.286	-	24	427	739	0.5778078
A06	1901215	1904032	A06p02860.2_BraZ1	1405.87	+	1851	2670	2817	0.9478168
A06	1904080	1904697	A06p02870.2_BraZ1	531	-	781	617	617	1.0000000
A06	1906680	1911096	A06p02880.2_BraZ1	5720	-	1872	4201	4416	0.9513134
A06	1912947	1913208	A06p02890.2_BraZ1	26.1	+	23	259	261	0.9923372
A06	1915237	1917355	A06p02900.2_BraZ1	211.8	+	1635	2035	2118	0.9608121
A06	1919155	1919701	A06p02910.2_BraZ1	363.913	-	95	482	546	0.8827839
A06	1920469	1920910	A06p02920.2_BraZ1	317.739	-	261	408	441	0.9251701
A06	1921388	1927540	A06p02930.2_BraZ1	2512.17	-	2112	5122	6152	0.8325748
A06	1931638	1932091	A06p02940.2_BraZ1	45.3	+	163	397	453	0.8763797
A06	1939703	1942923	A06p02950.2_BraZ1	1186.5	+	1462	3068	3220	0.9527950
A06	1943474	1944509	A06p02960.2_BraZ1	103.5	+	549	1001	1035	0.9671497
A06	1946174	1947194	A06p02970.2_BraZ1	102	+	532	1020	1020	1.0000000
A06	1947453	1948668	A06p02980.2_BraZ1	1032	-	211	922	1215	0.7588477
A06	1949870	1951272	A06p02990.2_BraZ1	609.429	+	496	1349	1402	0.9621969
A06	1951999	1954678	A06p03000.2_BraZ1	2022	-	1226	2679	2679	1.0000000
A06	1963836	1964373	A06p03010.2_BraZ1	53.7	+	0	0	537	0.0000000
A06	1972779	1973391	A06p03020.2_BraZ1	61.2	+	200	595	612	0.9722222
A06	1983584	1985669	A06p03030.2_BraZ1	89.7	-	242	1523	2085	0.7304556
A06	1987290	1987626	A06p03040.2_BraZ1	33.6	+	0	0	336	0.0000000
A06	1990651	1993180	A06p03050.2_BraZ1	252.9	-	0	0	2529	0.0000000
A06	1994140	1994479	A06p03060.2_BraZ1	33.9	+	0	0	339	0.0000000
A06	2004853	2007550	A06p03070.2_BraZ1	1862.5	-	708	2341	2697	0.8680015
A06	2009210	2009546	A06p03080.2_BraZ1	33.6	+	2	163	336	0.4851190
A06	2019534	2022063	A06p03090.2_BraZ1	252.9	-	4	219	2529	0.0865955
A06	2023022	2023361	A06p03100.2_BraZ1	33.9	+	0	0	339	0.0000000
A06	2028387	2028660	A06p03110.2_BraZ1	162	-	75	273	273	1.0000000
A06	2029857	2036930	A06p03120.2_BraZ1	2586	-	2530	6975	7073	0.9861445
A06	2033373	2033648	A06p03130.2_BraZ1	162	-	118	275	275	1.0000000
A06	2042262	2042370	A06p03140.2_BraZ1	10.8	+	300	108	108	1.0000000
A06	2048012	2048274	A06p03150.2_BraZ1	216	-	23	192	262	0.7328244
A06	2053570	2054419	A06p03160.2_BraZ1	557.5	-	28	358	849	0.4216726
A06	2057516	2060228	A06p03170.2_BraZ1	1238.26	+	853	2497	2712	0.9207227
A06	2060841	2061078	A06p03180.2_BraZ1	23.7	-	246	237	237	1.0000000
A06	2066801	2068379	A06p03190.2_BraZ1	157.8	+	227	832	1578	0.5272497
A06	2074045	2075567	A06p03200.2_BraZ1	729	+	325	1081	1522	0.7102497
A06	2077190	2078446	A06p03210.2_BraZ1	875.636	+	493	1218	1256	0.9697452
A06	2079913	2082251	A06p03220.2_BraZ1	1215	+	969	2206	2338	0.9435415
A06	2082950	2088898	A06p03230.2_BraZ1	1938.61	-	3274	5570	5948	0.9364492
A06	2090310	2091407	A06p03240.2_BraZ1	102.3	-	483	1097	1097	1.0000000
A06	2093392	2095431	A06p03250.2_BraZ1	1815	+	642	2010	2039	0.9857773
A06	2096340	2097551	A06p03260.2_BraZ1	569.497	+	846	1211	1211	1.0000000
A06	2098107	2101288	A06p03270.2_BraZ1	2142.48	-	1369	2722	3181	0.8557057
A06	2103344	2106401	A06p03280.2_BraZ1	986.659	-	2294	3020	3057	0.9878966
A06	2110947	2113757	A06p03290.2_BraZ1	964.364	+	1222	2810	2810	1.0000000
A06	2117540	2118875	A06p03300.2_BraZ1	133.5	+	398	1335	1335	1.0000000
A06	2119514	2123548	A06p03310.2_BraZ1	2304.86	-	1035	3664	4034	0.9082796
A06	2129040	2131234	A06p03320.2_BraZ1	946.006	-	1125	2179	2194	0.9931632
A06	2132266	2136992	A06p03330.2_BraZ1	2318.86	-	1323	3958	4726	0.8374947
A06	2258710	2259056	A06p03340.2_BraZ1	237	-	184	326	346	0.9421965
A06	2259993	2265893	A06p03350.2_BraZ1	2735.75	-	2108	5159	5900	0.8744068
A06	2268566	2269164	A06p03360.2_BraZ1	273	-	280	585	598	0.9782609
A06	2270098	2270774	A06p03370.2_BraZ1	549	+	285	671	676	0.9926035
A06	2271574	2273694	A06p03380.2_BraZ1	1536.64	-	354	1494	2120	0.7047170
A06	2276213	2278427	A06p03390.2_BraZ1	221.4	-	811	2097	2214	0.9471545
A06	2280642	2283279	A06p03400.2_BraZ1	903	+	1478	2563	2637	0.9719378
A06	2286291	2288204	A06p03410.2_BraZ1	1686	+	800	1897	1913	0.9916362
A06	2288426	2290171	A06p03420.2_BraZ1	567	-	2206	1698	1745	0.9730659
A06	2290766	2291047	A06p03430.2_BraZ1	24.3	+	384	281	281	1.0000000
A06	2291827	2291956	A06p03440.2_BraZ1	12.9	-	141	129	129	1.0000000
A06	2293617	2300447	A06p03450.2_BraZ1	2500.97	+	1593	5404	6830	0.7912152
A06	2302032	2308368	A06p03460.2_BraZ1	2586	+	2287	6007	6336	0.9480745
A06	2309814	2310207	A06p03470.2_BraZ1	39.3	+	0	0	393	0.0000000
A06	2311439	2315338	A06p03480.2_BraZ1	1558.2	-	555	2581	3899	0.6619646
A06	2317225	2318980	A06p03490.2_BraZ1	1095.58	+	555	1755	1755	1.0000000
A06	2320384	2320968	A06p03500.2_BraZ1	489	-	161	584	584	1.0000000
A06	2323554	2324155	A06p03510.2_BraZ1	1141	-	354	601	601	1.0000000
A06	2329504	2346495	A06p03520.2_BraZ1	6724.18	+	3648	13617	16991	0.8014243
A06	2349732	2350017	A06p03530.2_BraZ1	28.5	-	9	108	285	0.3789474
A06	2351901	2352944	A06p03540.2_BraZ1	639	+	636	1043	1043	1.0000000
A06	2353543	2355670	A06p03550.2_BraZ1	31269.3	-	715	2016	2127	0.9478138
A06	2356107	2357806	A06p03560.2_BraZ1	799.476	+	542	1282	1699	0.7545615
A06	2358086	2359316	A06p03570.2_BraZ1	123	-	378	1230	1230	1.0000000
A06	2359776	2360534	A06p03580.2_BraZ1	657	-	66	468	758	0.6174142
A06	2360634	2364024	A06p03590.2_BraZ1	1824.66	-	626	2906	3390	0.8572271
A06	2365260	2365822	A06p03600.2_BraZ1	393	+	290	536	562	0.9537367
A06	2372273	2373796	A06p03610.2_BraZ1	958.529	+	476	1322	1523	0.8680236
A06	2377406	2378531	A06p03620.2_BraZ1	112.5	+	640	1099	1125	0.9768889
A06	2379735	2382615	A06p03630.2_BraZ1	1736.5	-	810	2832	2880	0.9833333
A06	2387114	2387456	A06p03640.2_BraZ1	180	-	5	127	342	0.3713450
A06	2387554	2388523	A06p03650.2_BraZ1	207	-	292	461	969	0.4757482
A06	2389471	2394007	A06p03660.2_BraZ1	2092.17	-	406	2277	4536	0.5019841
A06	2394899	2396106	A06p03670.2_BraZ1	687.636	+	591	1207	1207	1.0000000
A06	2396724	2400029	A06p03680.2_BraZ1	1222.47	-	1037	2951	3305	0.8928896
A06	2403718	2404599	A06p03690.2_BraZ1	463.077	-	477	881	881	1.0000000
A06	2407742	2413435	A06p03700.2_BraZ1	2680.68	-	1786	5168	5693	0.9077815
A06	2416918	2417311	A06p03710.2_BraZ1	29.4	-	1	29	393	0.0737913
A06	2418232	2420714	A06p03720.2_BraZ1	643.125	+	33	966	2482	0.3892023
A06	2421503	2421896	A06p03730.2_BraZ1	39.3	-	0	0	393	0.0000000
A06	2426000	2426507	A06p03740.2_BraZ1	50.7	-	182	507	507	1.0000000
A06	2426830	2428659	A06p03750.2_BraZ1	1044	-	716	1757	1829	0.9606342
A06	2429079	2430042	A06p03760.2_BraZ1	96.3	-	407	957	963	0.9937695
A06	2430981	2432166	A06p03770.2_BraZ1	118.5	-	264	1052	1185	0.8877637
A06	2434059	2435040	A06p03780.2_BraZ1	98.1	-	669	981	981	1.0000000
A06	2436594	2438794	A06p03790.2_BraZ1	1611.3	-	556	1840	2200	0.8363636
A06	2440285	2442696	A06p03800.2_BraZ1	1196.84	+	293	1250	2411	0.5184571
A06	2446191	2447193	A06p03810.2_BraZ1	100.2	+	22	361	1002	0.3602794
A06	2448927	2451636	A06p03820.2_BraZ1	1242.21	-	1683	2639	2709	0.9741602
A06	2452769	2456669	A06p03830.2_BraZ1	1781.65	-	1648	3740	3900	0.9589744
A06	2459223	2464308	A06p03840.2_BraZ1	1943.1	-	2267	4690	5085	0.9223205
A06	2470084	2471454	A06p03850.2_BraZ1	818.217	+	721	1237	1370	0.9029197
A06	2471665	2475117	A06p03860.2_BraZ1	1951.06	-	1433	3221	3452	0.9330823
A06	2477386	2479444	A06p03870.2_BraZ1	985.714	+	454	1364	2058	0.6627794
A06	2481524	2485112	A06p03880.2_BraZ1	1782.78	+	1501	3187	3588	0.8882385
A06	2494086	2496122	A06p03890.2_BraZ1	903	+	541	1190	2036	0.5844794
A06	2498142	2500366	A06p03900.2_BraZ1	1185.17	+	1075	2224	2224	1.0000000
A06	2503374	2504601	A06p03910.2_BraZ1	797.674	-	1800	1227	1227	1.0000000
A06	2510104	2515972	A06p03920.2_BraZ1	1341	-	3761	5625	5868	0.9585890
A06	2516727	2517066	A06p03930.2_BraZ1	33.9	+	2814	339	339	1.0000000
A06	2518992	2519331	A06p03940.2_BraZ1	33.9	+	591	339	339	1.0000000
A06	2521605	2521944	A06p03950.2_BraZ1	33.9	+	158	339	339	1.0000000
A06	2522834	2526184	A06p03960.2_BraZ1	2377.93	+	1586	3273	3350	0.9770149
A06	2526643	2528836	A06p03970.2_BraZ1	10469	-	1834	2173	2193	0.9908801
A06	2530270	2531785	A06p03980.2_BraZ1	151.5	-	1378	1515	1515	1.0000000
A06	2537492	2539484	A06p03990.2_BraZ1	199.2	+	985	1572	1992	0.7891566
A06	2540866	2541735	A06p04000.2_BraZ1	621	+	145	797	869	0.9171461
A06	2559352	2559754	A06p04010.2_BraZ1	40.2	-	128	312	402	0.7761194
A06	2561369	2562290	A06p04020.2_BraZ1	297	-	75	234	921	0.2540717
A06	2562610	2562721	A06p04030.2_BraZ1	11.1	-	11	98	111	0.8828829
A06	2562984	2574661	A06p04040.2_BraZ1	5906.83	-	3956	9724	11677	0.8327481
A06	2578427	2579669	A06p04050.2_BraZ1	840	-	294	754	1242	0.6070853
A06	2591827	2592164	A06p04060.2_BraZ1	246	+	46	337	337	1.0000000
A06	2596711	2597056	A06p04070.2_BraZ1	34.5	-	407	345	345	1.0000000
A06	2600279	2601515	A06p04080.2_BraZ1	123.6	+	585	1204	1236	0.9741100
A06	2603188	2606343	A06p04090.2_BraZ1	1869.19	+	766	2201	3155	0.6976228
A06	2612617	2613262	A06p04100.2_BraZ1	64.5	-	27	250	645	0.3875969
A06	2617499	2617916	A06p04110.2_BraZ1	41.7	+	21	140	417	0.3357314
A06	2617985	2618255	A06p04120.2_BraZ1	27	+	20	140	270	0.5185185
A06	2620529	2624399	A06p04130.2_BraZ1	1071	-	1221	2858	3870	0.7385013
A06	2629577	2630255	A06p04140.2_BraZ1	67.8	-	22	373	678	0.5501475
A06	2642667	2643000	A06p04150.2_BraZ1	33.3	+	32	66	333	0.1981982
A06	2643522	2652822	A06p04160.2_BraZ1	2659.02	+	808	4006	9300	0.4307527
A06	2653474	2654543	A06p04170.2_BraZ1	626.207	-	7	376	1069	0.3517306
A06	2656706	2657119	A06p04180.2_BraZ1	24.6207	-	253	413	413	1.0000000
A06	2658475	2659514	A06p04190.2_BraZ1	897	-	36	785	1039	0.7555342
A06	2663167	2663458	A06p04200.2_BraZ1	29.1	+	91	291	291	1.0000000
A06	2667476	2667896	A06p04210.2_BraZ1	42	+	13	186	420	0.4428571
A06	2670529	2673190	A06p04220.2_BraZ1	880.696	-	677	2254	2661	0.8470500
A06	2677277	2678264	A06p04230.2_BraZ1	651	-	85	753	987	0.7629179
A06	2683974	2685105	A06p04240.2_BraZ1	330	-	442	1019	1131	0.9009726
A06	2686383	2687535	A06p04250.2_BraZ1	303	-	30	545	1152	0.4730903
A06	2689415	2690566	A06p04260.2_BraZ1	429	-	11	436	1151	0.3788010
A06	2689732	2690454	A06p04270.2_BraZ1	144	+	8	257	722	0.3559557
A06	2701567	2704258	A06p04280.2_BraZ1	1302.9	-	463	2405	2691	0.8937198
A06	2712423	2722832	A06p04290.2_BraZ1	2007.5	-	1861	8346	10409	0.8018062
A06	2736206	2738156	A06p04300.2_BraZ1	195	-	1380	1950	1950	1.0000000
A06	2747319	2749380	A06p04310.2_BraZ1	1697.4	+	674	2045	2061	0.9922368
A06	2751164	2754326	A06p04320.2_BraZ1	519	+	2554	3162	3162	1.0000000
A06	2755636	2756794	A06p04330.2_BraZ1	800	-	551	1158	1158	1.0000000
A06	2758340	2761807	A06p04340.2_BraZ1	1456.36	+	1410	3343	3467	0.9642342
A06	2762747	2764454	A06p04350.2_BraZ1	690	-	1069	1644	1707	0.9630932
A06	2764652	2765244	A06p04360.2_BraZ1	498	-	624	592	592	1.0000000
A06	2767308	2772213	A06p04370.2_BraZ1	1675.96	-	1573	3773	4905	0.7692151
A06	2777296	2781071	A06p04380.2_BraZ1	1740	-	2457	3775	3775	1.0000000
A06	2784866	2788556	A06p04390.2_BraZ1	1740	-	2865	3690	3690	1.0000000
A06	2793660	2795577	A06p04400.2_BraZ1	996.36	+	616	1838	1917	0.9587898
A06	2796992	2802172	A06p04410.2_BraZ1	3417.74	+	1671	4670	5180	0.9015444
A06	2803862	2810163	A06p04420.2_BraZ1	989.556	-	956	2853	6301	0.4527853
A06	2811797	2811925	A06p04430.2_BraZ1	10.2	-	9	128	128	1.0000000
A06	2814479	2815590	A06p04440.2_BraZ1	897	+	759	1111	1111	1.0000000
A06	2818621	2820447	A06p04450.2_BraZ1	1182.24	+	1733	1808	1826	0.9901424
A06	2823904	2825205	A06p04460.2_BraZ1	561	+	1211	1301	1301	1.0000000
A06	2826413	2828744	A06p04470.2_BraZ1	233.1	+	511	2177	2331	0.9339339
A06	2829456	2830270	A06p04480.2_BraZ1	80.1	+	190	762	814	0.9361179
A06	2830712	2833576	A06p04490.2_BraZ1	1269.36	-	1471	2528	2864	0.8826815
A06	2835558	2837894	A06p04500.2_BraZ1	1110.2	+	1769	2336	2336	1.0000000
A06	2838215	2841145	A06p04510.2_BraZ1	1734.33	-	3097	2930	2930	1.0000000
A06	2842035	2844532	A06p04520.2_BraZ1	1254	+	849	2462	2497	0.9859832
A06	2844853	2846996	A06p04530.2_BraZ1	1962	-	1091	2086	2143	0.9734018
A06	2848647	2850328	A06p04540.2_BraZ1	516	-	104	1244	1681	0.7400357
A06	2850213	2850612	A06p04550.2_BraZ1	132.48	-	16	122	399	0.3057644
A06	2853099	2853774	A06p04560.2_BraZ1	67.5	+	288	675	675	1.0000000
A06	2856321	2857017	A06p04570.2_BraZ1	69.6	+	344	696	696	1.0000000
A06	2858211	2859998	A06p04580.2_BraZ1	936.622	+	1206	1787	1787	1.0000000
A06	2860398	2865462	A06p04590.2_BraZ1	2795.31	-	1040	4087	5064	0.8070695
A06	2869257	2874984	A06p04600.2_BraZ1	2566.07	+	2983	5516	5727	0.9631570
A06	2878246	2882089	A06p04610.2_BraZ1	946.968	-	654	3667	3843	0.9542025
A06	2883229	2883364	A06p04620.2_BraZ1	13.5	+	116	135	135	1.0000000
A06	2883600	2898705	A06p04630.2_BraZ1	328.5	+	3653	11679	15105	0.7731877
A06	2899571	2900312	A06p04640.2_BraZ1	74.1	-	986	741	741	1.0000000
A06	2900816	2903099	A06p04650.2_BraZ1	1096.07	+	1775	2283	2283	1.0000000
A06	2904025	2905139	A06p04660.2_BraZ1	1038	-	417	1114	1114	1.0000000
A06	2908548	2909388	A06p04670.2_BraZ1	82.5	+	367	738	840	0.8785715
A06	2909840	2910184	A06p04680.2_BraZ1	198	-	346	344	344	1.0000000
A06	2912644	2912878	A06p04690.2_BraZ1	23.4	-	64	135	234	0.5769231
A06	2927180	2927741	A06p04700.2_BraZ1	3100.5	+	88	299	561	0.5329768
A06	2928262	2928382	A06p04710.2_BraZ1	12	+	0	0	120	0.0000000
A06	2928870	2929032	A06p04720.2_BraZ1	16.2	+	0	0	162	0.0000000
A06	2937735	2943135	A06p04730.2_BraZ1	4081.95	+	2144	5169	5400	0.9572222
A06	2944957	2948847	A06p04740.2_BraZ1	1696.5	-	3009	3890	3890	1.0000000
A06	2957075	2959416	A06p04750.2_BraZ1	1522.22	-	775	2251	2341	0.9615549
A06	2964247	2966295	A06p04760.2_BraZ1	930.6	+	1819	1987	2048	0.9702148
A06	2967359	2969965	A06p04770.2_BraZ1	1564.75	-	1066	2547	2606	0.9773600
A06	2975276	2979075	A06p04780.2_BraZ1	1161.15	+	2002	3771	3799	0.9926296
A06	2981651	2985251	A06p04790.2_BraZ1	1196.67	+	887	3256	3600	0.9044445
A06	2986978	2992870	A06p04800.2_BraZ1	295.5	-	2515	5752	5892	0.9762390
A06	2994220	2994521	A06p04810.2_BraZ1	2484	+	1272	301	301	1.0000000
A06	2997091	2999076	A06p04820.2_BraZ1	1055.71	-	1402	1985	1985	1.0000000
A06	3001390	3002092	A06p04830.2_BraZ1	357	+	743	702	702	1.0000000
A06	3002824	3003632	A06p04840.2_BraZ1	439.286	-	764	808	808	1.0000000
A06	3005303	3006137	A06p04850.2_BraZ1	83.4	+	285	834	834	1.0000000
A06	3007523	3007668	A06p04860.2_BraZ1	132	+	272	145	145	1.0000000
A06	3008806	3009659	A06p04870.2_BraZ1	1155	-	302	853	853	1.0000000
A06	3012228	3017497	A06p04880.2_BraZ1	3486.24	+	2093	4900	5269	0.9299678
A06	3020354	3022644	A06p04890.2_BraZ1	1915.1	+	2073	2290	2290	1.0000000
A06	3023785	3026509	A06p04900.2_BraZ1	1310.71	-	1213	2644	2724	0.9706314
A06	3044721	3046833	A06p04910.2_BraZ1	211.2	-	1559	2112	2112	1.0000000
A06	3049562	3074407	A06p04920.2_BraZ1	11061.7	+	4464	17183	24845	0.6916080
A06	3057473	3058051	A06p04930.2_BraZ1	273	+	9	13	578	0.0224913
A06	3075397	3085655	A06p04940.2_BraZ1	6070.8	+	4721	10131	10258	0.9876194
A06	3086723	3088395	A06p04950.2_BraZ1	1128	+	943	1668	1672	0.9976076
A06	3089234	3091269	A06p04960.2_BraZ1	1524	+	590	1519	2035	0.7464374
A06	3098549	3100618	A06p04970.2_BraZ1	170.075	-	1320	1972	2069	0.9531174
A06	3102528	3104701	A06p04980.2_BraZ1	727.218	-	2879	2173	2173	1.0000000
A06	3120336	3121837	A06p04990.2_BraZ1	930	+	363	1313	1501	0.8747501
A06	3125182	3126102	A06p05000.2_BraZ1	585	-	1003	920	920	1.0000000
A06	3131370	3132107	A06p05010.2_BraZ1	489	+	96	721	737	0.9782904
A06	3134170	3135169	A06p05020.2_BraZ1	99.9	+	1221	999	999	1.0000000
A06	3136704	3143667	A06p05030.2_BraZ1	2647.01	-	2654	6284	6963	0.9024845
A06	3146649	3147346	A06p05040.2_BraZ1	1216.25	-	361	606	697	0.8694404
A06	3147855	3148092	A06p05050.2_BraZ1	23.7	+	66	237	237	1.0000000
A06	3148525	3150027	A06p05060.2_BraZ1	599.4	-	1150	1502	1502	1.0000000
A06	3151668	3152219	A06p05070.2_BraZ1	393	+	428	551	551	1.0000000
A06	3154686	3156001	A06p05080.2_BraZ1	1168.36	+	582	1309	1315	0.9954373
A06	3156549	3156699	A06p05090.2_BraZ1	15	+	1	10	150	0.0666667
A06	3157301	3158158	A06p05100.2_BraZ1	321	-	215	508	857	0.5927655
A06	3161460	3162469	A06p05110.2_BraZ1	346.275	+	1014	799	1009	0.7918732
A06	3172386	3172686	A06p05120.2_BraZ1	30	-	18	272	300	0.9066667
A06	3172747	3175621	A06p05130.2_BraZ1	1435.71	+	1661	2815	2874	0.9794711
A06	3175924	3177664	A06p05140.2_BraZ1	174	+	880	1740	1740	1.0000000
A06	3180416	3181835	A06p05150.2_BraZ1	141.9	+	305	1276	1419	0.8992248
A06	3185910	3187618	A06p05160.2_BraZ1	1620	+	794	1708	1708	1.0000000
A06	3187871	3194824	A06p05170.2_BraZ1	1792.95	-	5207	6953	6953	1.0000000
A06	3197210	3197450	A06p05180.2_BraZ1	24	-	43	240	240	1.0000000
A06	3198100	3202015	A06p05190.2_BraZ1	776.25	+	2844	3783	3915	0.9662835
A06	3198235	3198904	A06p05200.2_BraZ1	243	+	515	669	669	1.0000000
A06	3202374	3205148	A06p05210.2_BraZ1	1352.76	+	1246	2717	2774	0.9794521
A06	3205576	3209357	A06p05220.2_BraZ1	1219.39	-	1181	3210	3781	0.8489817
A06	3217098	3218895	A06p05230.2_BraZ1	630.418	+	1496	1797	1797	1.0000000
A06	3223752	3224920	A06p05240.2_BraZ1	7953	+	542	1073	1168	0.9186644
A06	3226085	3233835	A06p05250.2_BraZ1	3044.91	+	4989	7480	7750	0.9651613
A06	3234528	3237290	A06p05260.2_BraZ1	2058	+	1082	2685	2762	0.9721217
A06	3237923	3238786	A06p05270.2_BraZ1	435	-	847	863	863	1.0000000
A06	3239780	3241002	A06p05280.2_BraZ1	747	+	600	1222	1222	1.0000000
A06	3242519	3243999	A06p05290.2_BraZ1	37047	+	906	1416	1480	0.9567568
A06	3244848	3246010	A06p05300.2_BraZ1	501.636	-	1379	1095	1162	0.9423408
A06	3248348	3253351	A06p05310.2_BraZ1	2353.74	+	2576	4506	5003	0.9006596
A06	3253749	3265061	A06p05320.2_BraZ1	1686.28	-	7281	11227	11312	0.9924859
A06	3267271	3270273	A06p05330.2_BraZ1	1034.47	-	2164	3002	3002	1.0000000
A06	3270968	3273017	A06p05340.2_BraZ1	17631	-	2163	2049	2049	1.0000000
A06	3274394	3283263	A06p05350.2_BraZ1	5572.66	-	1170	5826	8869	0.6568948
A06	3284340	3285960	A06p05360.2_BraZ1	726.786	-	939	1488	1620	0.9185185
A06	3290128	3292351	A06p05370.2_BraZ1	222.3	-	1333	2040	2223	0.9176788
A06	3292667	3301223	A06p05380.2_BraZ1	1370	-	6608	8322	8556	0.9726508
A06	3303726	3304365	A06p05390.2_BraZ1	63.3	-	490	639	639	1.0000000
A06	3319900	3326230	A06p05400.2_BraZ1	503.247	+	4481	5887	6330	0.9300158
A06	3326652	3328756	A06p05410.2_BraZ1	723.672	-	2048	2104	2104	1.0000000
A06	3329359	3333215	A06p05420.2_BraZ1	2210.3	-	1451	3705	3856	0.9608402
A06	3333752	3336415	A06p05430.2_BraZ1	2252.39	-	343	1855	2663	0.6965828
A06	3337779	3340565	A06p05440.2_BraZ1	2341.57	-	195	1893	2786	0.6794688
A06	3341375	3342014	A06p05450.2_BraZ1	62.4	-	294	632	639	0.9890454
A06	3342595	3343432	A06p05460.2_BraZ1	83.7	-	434	826	837	0.9868578
A06	3344443	3344767	A06p05470.2_BraZ1	32.4	-	338	324	324	1.0000000
A06	3346036	3351372	A06p05480.2_BraZ1	2862.67	+	1622	5064	5336	0.9490255
A06	3352049	3354402	A06p05490.2_BraZ1	1142.47	-	1250	2269	2353	0.9643009
A06	3355758	3356040	A06p05500.2_BraZ1	159	-	350	282	282	1.0000000
A06	3356536	3357013	A06p05510.2_BraZ1	47.7	+	218	477	477	1.0000000
A06	3357584	3372521	A06p05520.2_BraZ1	5942.23	+	1668	10028	14937	0.6713530
A06	3372967	3375046	A06p05530.2_BraZ1	1259.78	-	731	2010	2079	0.9668109
A06	3376963	3378175	A06p05540.2_BraZ1	121.2	+	647	1212	1212	1.0000000
A06	3379190	3381282	A06p05550.2_BraZ1	1014	-	282	1698	2092	0.8116635
A06	3383338	3386818	A06p05560.2_BraZ1	1995.25	+	1200	3194	3480	0.9178161
A06	3386889	3388890	A06p05570.2_BraZ1	1080.68	+	154	1572	2001	0.7856072
A06	3390137	3390542	A06p05580.2_BraZ1	40.5	+	20	99	405	0.2444444
A06	3390695	3391667	A06p05590.2_BraZ1	97.2	-	163	693	972	0.7129630
A06	3392433	3397424	A06p05600.2_BraZ1	1300.06	-	1007	3827	4991	0.7667802
A06	3411391	3412965	A06p05610.2_BraZ1	1512	+	184	1432	1574	0.9097840
A06	3413250	3416021	A06p05620.2_BraZ1	1736.78	-	1289	2755	2771	0.9942259
A06	3416185	3417651	A06p05630.2_BraZ1	211.714	+	941	1466	1466	1.0000000
A06	3418376	3420671	A06p05640.2_BraZ1	641.143	+	1401	2147	2295	0.9355120
A06	3421037	3421648	A06p05650.2_BraZ1	43.5	-	207	611	611	1.0000000
A06	3422136	3423277	A06p05660.2_BraZ1	411	+	984	1141	1141	1.0000000
A06	3423583	3426190	A06p05670.2_BraZ1	2361	-	1487	2607	2607	1.0000000
A06	3426518	3427703	A06p05680.2_BraZ1	551.25	+	1310	1185	1185	1.0000000
A06	3429495	3432220	A06p05690.2_BraZ1	1362.55	+	579	2275	2725	0.8348624
A06	3434802	3435096	A06p05700.2_BraZ1	29.4	+	2	184	294	0.6258503
A06	3438787	3442525	A06p05710.2_BraZ1	562.582	+	2989	3487	3738	0.9328518
A06	3446188	3448503	A06p05720.2_BraZ1	1071.68	-	1328	2279	2315	0.9844493
A06	3448784	3449588	A06p05730.2_BraZ1	417	+	747	652	804	0.8109453
A06	3449917	3452693	A06p05740.2_BraZ1	1372.86	-	1303	2758	2776	0.9935158
A06	3453903	3456219	A06p05750.2_BraZ1	977.261	-	1615	2316	2316	1.0000000
A06	3457909	3461706	A06p05760.2_BraZ1	2245.05	+	2177	3797	3797	1.0000000
A06	3462009	3463467	A06p05770.2_BraZ1	736	+	1112	1384	1458	0.9492455
A06	3463908	3466793	A06p05780.2_BraZ1	1345.3	+	1685	2648	2885	0.9178510
A06	3467586	3469891	A06p05790.2_BraZ1	1259.8	+	563	2263	2305	0.9817787
A06	3469969	3471224	A06p05800.2_BraZ1	924	-	231	1140	1255	0.9083666
A06	3476735	3477839	A06p05810.2_BraZ1	8364	+	755	1104	1104	1.0000000
A06	3478653	3479557	A06p05820.2_BraZ1	404.913	-	390	708	904	0.7831858
A06	3481244	3496742	A06p05830.2_BraZ1	5587.16	+	8613	14703	15498	0.9487031
A06	3497662	3499419	A06p05840.2_BraZ1	541.797	-	1494	1757	1757	1.0000000
A06	3502106	3504340	A06p05850.2_BraZ1	604.229	-	1559	2234	2234	1.0000000
A06	3506012	3507068	A06p05860.2_BraZ1	924	+	856	1056	1056	1.0000000
A06	3517714	3523419	A06p05870.2_BraZ1	245.893	-	5854	5695	5705	0.9982471
A06	3525746	3529795	A06p05880.2_BraZ1	1426.93	+	2474	3916	4049	0.9671524
A06	3530233	3531754	A06p05890.2_BraZ1	1305	-	495	1460	1521	0.9598948
A06	3532810	3542490	A06p05900.2_BraZ1	3647.34	+	6080	9559	9680	0.9875000
A06	3543997	3550452	A06p05910.2_BraZ1	2041.85	+	3108	6268	6455	0.9710302
A06	3547795	3548608	A06p05920.2_BraZ1	345	+	345	795	813	0.9778598
A06	3550589	3551216	A06p05930.2_BraZ1	62.7	+	234	627	627	1.0000000
A06	3551435	3552131	A06p05940.2_BraZ1	357	-	411	689	696	0.9899426
A06	3553430	3554089	A06p05950.2_BraZ1	576	+	155	531	659	0.8057663
A06	3555100	3558090	A06p05960.2_BraZ1	2940	-	2903	2990	2990	1.0000000
A06	3560274	3564849	A06p05970.2_BraZ1	1234.77	-	2029	4297	4575	0.9392350
A06	3567539	3572406	A06p05980.2_BraZ1	623.02	+	3195	4413	4867	0.9067187
A06	3574523	3575027	A06p05990.2_BraZ1	429	-	361	504	504	1.0000000
A06	3575643	3578866	A06p06000.2_BraZ1	1291.25	+	1475	3146	3223	0.9761092
A06	3579914	3580067	A06p06010.2_BraZ1	15.3	+	149	153	153	1.0000000
A06	3580421	3583508	A06p06020.2_BraZ1	1064.68	+	2582	2921	3087	0.9462261
A06	3588318	3591266	A06p06030.2_BraZ1	1349.3	+	384	2279	2948	0.7730665
A06	3596831	3600567	A06p06040.2_BraZ1	1377.18	+	2572	3736	3736	1.0000000
A06	3602894	3604456	A06p06050.2_BraZ1	843	+	487	1370	1562	0.8770807
A06	3606279	3607647	A06p06060.2_BraZ1	951	+	823	1240	1368	0.9064327
A06	3608436	3612367	A06p06070.2_BraZ1	1980.68	+	2854	3544	3931	0.9015518
A06	3612683	3616876	A06p06080.2_BraZ1	2260.44	-	1449	3923	4193	0.9356070
A06	3618396	3623102	A06p06090.2_BraZ1	1423.71	-	895	3911	4706	0.8310667
A06	3630552	3631927	A06p06100.2_BraZ1	225	-	938	1371	1375	0.9970909
A06	3631928	3632327	A06p06110.2_BraZ1	39.9	-	54	257	399	0.6441103
A06	3637896	3638745	A06p06120.2_BraZ1	762	-	206	709	849	0.8351001
A06	3643372	3646223	A06p06130.2_BraZ1	2646	+	1084	2553	2851	0.8954753
A06	3646577	3647407	A06p06140.2_BraZ1	471	-	773	830	830	1.0000000
A06	3647699	3648656	A06p06150.2_BraZ1	95.7	+	531	957	957	1.0000000
A06	3654946	3660853	A06p06160.2_BraZ1	1014.58	-	4803	5856	5907	0.9913661
A06	3657010	3659018	A06p06170.2_BraZ1	437.25	+	1447	1966	2008	0.9790837
A06	3664335	3666662	A06p06180.2_BraZ1	776.6	-	887	2106	2327	0.9050279
A06	3667117	3668572	A06p06190.2_BraZ1	145.5	+	562	1404	1455	0.9649485
A06	3668788	3673491	A06p06200.2_BraZ1	688.905	-	1437	4653	4703	0.9893685
A06	3674538	3677187	A06p06210.2_BraZ1	1242.82	-	1153	2603	2649	0.9826350
A06	3682505	3683477	A06p06220.2_BraZ1	97.2	+	10	224	972	0.2304527
A06	3689899	3690517	A06p06230.2_BraZ1	61.8	+	81	618	618	1.0000000
A06	3696206	3696943	A06p06240.2_BraZ1	381	-	101	651	737	0.8833107
A06	3700068	3700581	A06p06250.2_BraZ1	51.3	+	315	513	513	1.0000000
A06	3701489	3704136	A06p06260.2_BraZ1	1545.28	+	814	2549	2647	0.9629769
A06	3704476	3706963	A06p06270.2_BraZ1	1688.57	-	1192	2470	2487	0.9931645
A06	3707956	3708511	A06p06280.2_BraZ1	55.5	+	116	420	555	0.7567568
A06	3709329	3711419	A06p06290.2_BraZ1	13387.5	-	977	2090	2090	1.0000000
A06	3711932	3713132	A06p06300.2_BraZ1	497.75	-	992	1197	1200	0.9975000
A06	3713941	3716180	A06p06310.2_BraZ1	1217.85	+	2451	2239	2239	1.0000000
A06	3719685	3719859	A06p06320.2_BraZ1	17.4	+	66	174	174	1.0000000
A06	3721585	3732776	A06p06330.2_BraZ1	548.1	+	9833	10560	11191	0.9436154
A06	3732107	3732563	A06p06340.2_BraZ1	158.143	-	257	280	456	0.6140351
A06	3732664	3733469	A06p06350.2_BraZ1	334.8	+	370	805	805	1.0000000
A06	3739965	3740595	A06p06360.2_BraZ1	63	+	640	630	630	1.0000000
A06	3741513	3742104	A06p06370.2_BraZ1	59.1	+	864	591	591	1.0000000
A06	3745473	3745974	A06p06380.2_BraZ1	50.1	+	225	501	501	1.0000000
A06	3746528	3749480	A06p06390.2_BraZ1	1139.62	-	1259	2936	2952	0.9945800
A06	3751306	3753556	A06p06400.2_BraZ1	1055.35	+	471	1976	2250	0.8782222
A06	3757075	3758147	A06p06410.2_BraZ1	325	-	0	0	1072	0.0000000
A06	3758332	3759664	A06p06420.2_BraZ1	459	-	1	36	1332	0.0270270
A06	3760312	3761143	A06p06430.2_BraZ1	735	+	289	831	831	1.0000000
A06	3761721	3763471	A06p06440.2_BraZ1	1329.1	-	426	1571	1750	0.8977143
A06	3765503	3766599	A06p06450.2_BraZ1	906	+	721	1096	1096	1.0000000
A06	3766853	3768053	A06p06460.2_BraZ1	9234	-	744	1200	1200	1.0000000
A06	3770001	3775649	A06p06470.2_BraZ1	9860.4	+	4714	5163	5648	0.9141289
A06	3776243	3776963	A06p06480.2_BraZ1	72	-	328	720	720	1.0000000
A06	3780823	3783449	A06p06490.2_BraZ1	1332.64	+	2282	2573	2626	0.9798172
A06	3793220	3794374	A06p06500.2_BraZ1	996	+	281	1022	1154	0.8856152
A06	3795828	3797540	A06p06510.2_BraZ1	315	-	1180	1664	1712	0.9719626
A06	3800019	3800770	A06p06520.2_BraZ1	675	+	192	710	751	0.9454061
A06	3801623	3806215	A06p06530.2_BraZ1	2266.7	-	1984	4275	4592	0.9309669
A06	3814035	3815016	A06p06540.2_BraZ1	700	+	0	0	981	0.0000000
A06	3822968	3823939	A06p06550.2_BraZ1	891	-	470	946	971	0.9742534
A06	3825801	3827254	A06p06560.2_BraZ1	596.739	+	1083	1415	1453	0.9738472
A06	3827777	3828714	A06p06570.2_BraZ1	495	+	310	937	937	1.0000000
A06	3833072	3834346	A06p06580.2_BraZ1	654	-	618	1274	1274	1.0000000
A06	3835044	3837066	A06p06590.2_BraZ1	1015.2	+	756	1878	2022	0.9287834
A06	3837797	3838905	A06p06600.2_BraZ1	41.1	+	514	1019	1108	0.9196751
A06	3839467	3841306	A06p06610.2_BraZ1	781.714	-	1927	1839	1839	1.0000000
A06	3842096	3843091	A06p06620.2_BraZ1	609	+	1685	995	995	1.0000000
A06	3844014	3845853	A06p06630.2_BraZ1	183.9	-	857	1746	1839	0.9494290
A06	3846208	3846953	A06p06640.2_BraZ1	495	-	180	646	745	0.8671141
A06	3847436	3848452	A06p06650.2_BraZ1	819	-	607	1016	1016	1.0000000
A06	3849856	3852476	A06p06660.2_BraZ1	1658.7	+	1488	2372	2620	0.9053435
A06	3852670	3855450	A06p06670.2_BraZ1	2622	-	1031	2636	2780	0.9482014
A06	3856061	3862858	A06p06680.2_BraZ1	2631.65	-	3748	6567	6797	0.9661615
A06	3863942	3864863	A06p06690.2_BraZ1	500.364	+	452	857	921	0.9305103
A06	3866307	3868099	A06p06700.2_BraZ1	880.706	-	1476	1792	1792	1.0000000
A06	3868315	3871573	A06p06710.2_BraZ1	2516.31	+	2046	3258	3258	1.0000000
A06	3872427	3874852	A06p06720.2_BraZ1	1166.4	-	1687	2425	2425	1.0000000
A06	3875917	3878240	A06p06730.2_BraZ1	192	+	799	1619	2323	0.6969436
A06	3879051	3881501	A06p06740.2_BraZ1	1177.37	+	2720	2450	2450	1.0000000
A06	3881997	3886479	A06p06750.2_BraZ1	1872	-	3644	4446	4482	0.9919679
A06	3886781	3888150	A06p06760.2_BraZ1	1098	+	701	1369	1369	1.0000000
A06	3888482	3891196	A06p06770.2_BraZ1	1299.82	-	1738	2684	2714	0.9889462
A06	3892765	3893602	A06p06780.2_BraZ1	189	+	43	496	837	0.5925926
A06	3902193	3902980	A06p06790.2_BraZ1	3168	+	577	689	787	0.8754765
A06	3903491	3904045	A06p06800.2_BraZ1	2812.5	+	623	554	554	1.0000000
A06	3904510	3906358	A06p06810.2_BraZ1	183.6	-	1120	1778	1848	0.9621212
A06	3906916	3912676	A06p06820.2_BraZ1	2029.57	-	3203	5735	5760	0.9956597
A06	3916147	3916399	A06p06830.2_BraZ1	25.2	+	163	252	252	1.0000000
A06	3918604	3919768	A06p06840.2_BraZ1	116.4	-	1865	1164	1164	1.0000000
A06	3921161	3921461	A06p06850.2_BraZ1	30	+	12	299	300	0.9966667
A06	3921461	3927206	A06p06860.2_BraZ1	70.5	+	8	535	5745	0.0931245
A06	3924631	3928963	A06p06870.2_BraZ1	171	+	2	89	4332	0.0205448
A06	3927206	3927723	A06p06880.2_BraZ1	246	+	0	0	517	0.0000000
A06	3929020	3931484	A06p06890.2_BraZ1	83.7	+	14	404	2464	0.1639610
A06	3931984	3935005	A06p06900.2_BraZ1	56.4	+	24	883	3021	0.2922873
A06	3933108	3936836	A06p06910.2_BraZ1	94.2	+	18	495	3728	0.1327790
A06	3937140	3938379	A06p06920.2_BraZ1	42.9	-	6	242	1239	0.1953188
A06	3939669	3941579	A06p06930.2_BraZ1	1381.8	-	22	903	1910	0.4727749
A06	3941560	3941942	A06p06940.2_BraZ1	178	-	2	65	382	0.1701571
A06	3943140	3945660	A06p06950.2_BraZ1	1418.1	+	1230	2370	2520	0.9404762
A06	3945992	3950349	A06p06960.2_BraZ1	1235.29	-	1899	4183	4357	0.9600643
A06	3952390	3955998	A06p06970.2_BraZ1	1728.56	-	1367	3249	3608	0.9004989
A06	3956089	3957871	A06p06980.2_BraZ1	178.2	+	403	1739	1782	0.9758698
A06	3958047	3961728	A06p06990.2_BraZ1	1848	-	2032	3640	3681	0.9888617
A06	3962230	3974103	A06p07000.2_BraZ1	964.364	-	4675	5762	11873	0.4853028
A06	3968504	3970028	A06p07010.2_BraZ1	152.4	-	0	0	1524	0.0000000
A06	3975097	3976979	A06p07020.2_BraZ1	534.019	-	510	1694	1882	0.9001063
A06	3980941	3981280	A06p07030.2_BraZ1	33.9	-	72	310	339	0.9144543
A06	3981902	3982595	A06p07040.2_BraZ1	69.3	-	195	681	693	0.9826840
A06	3991538	3994636	A06p07050.2_BraZ1	1260.31	+	877	2882	3098	0.9302776
A06	3998151	4001144	A06p07060.2_BraZ1	7566	+	764	2491	2993	0.8322753
A06	4002476	4006236	A06p07070.2_BraZ1	1788.15	-	2130	3730	3760	0.9920213
A06	4007681	4010224	A06p07080.2_BraZ1	994.232	+	1531	2453	2543	0.9646087
A06	4011952	4014175	A06p07090.2_BraZ1	1283.02	+	352	1215	2223	0.5465587
A06	4024860	4027847	A06p07100.2_BraZ1	1352.78	+	126	1956	2987	0.6548376
A06	4028939	4030601	A06p07110.2_BraZ1	1356	-	200	1437	1662	0.8646209
A06	4033452	4035502	A06p07120.2_BraZ1	380.714	+	1343	1805	2050	0.8804878
A06	4037629	4042344	A06p07130.2_BraZ1	1001.22	+	3049	4326	4715	0.9174973
A06	4047121	4050029	A06p07140.2_BraZ1	1198.99	+	1377	2790	2908	0.9594223
A06	4050081	4050533	A06p07150.2_BraZ1	264	-	5	121	452	0.2676991
A06	4050582	4052103	A06p07160.2_BraZ1	757.02	-	496	1042	1521	0.6850756
A06	4058501	4058861	A06p07170.2_BraZ1	231	-	0	0	360	0.0000000
A06	4059025	4059627	A06p07180.2_BraZ1	264	-	2	39	602	0.0647840
A06	4059652	4059952	A06p07190.2_BraZ1	30	-	67	300	300	1.0000000
A06	4062421	4062610	A06p07200.2_BraZ1	18.9	+	1789	189	189	1.0000000
A06	4063123	4063949	A06p07210.2_BraZ1	130	+	7051	826	826	1.0000000
A06	4064567	4078252	A06p07220.2_BraZ1	2870.59	+	4121	11484	13685	0.8391670
A06	4075353	4075866	A06p07230.2_BraZ1	51.3	-	39	267	513	0.5204678
A06	4078755	4079492	A06p07240.2_BraZ1	554.114	-	352	737	737	1.0000000
A06	4080665	4084151	A06p07250.2_BraZ1	335.4	-	612	2778	3486	0.7969019
A06	4087144	4087345	A06p07260.2_BraZ1	20.1	-	2	124	201	0.6169154
A06	4088596	4088962	A06p07270.2_BraZ1	36.6	+	34	345	366	0.9426230
A06	4089737	4090220	A06p07280.2_BraZ1	48.3	-	71	466	483	0.9648033
A06	4091373	4092406	A06p07290.2_BraZ1	624.61	-	274	1033	1033	1.0000000
A06	4094413	4096084	A06p07300.2_BraZ1	1131	+	505	1580	1671	0.9455416
A06	4097435	4105294	A06p07310.2_BraZ1	2099.3	+	2805	7024	7859	0.8937524
A06	4106021	4108266	A06p07320.2_BraZ1	1863	-	442	1549	2245	0.6899777
A06	4109280	4109589	A06p07330.2_BraZ1	267	-	108	279	309	0.9029126
A06	4109866	4112293	A06p07340.2_BraZ1	2286	+	536	2092	2427	0.8619695
A06	4112738	4114901	A06p07350.2_BraZ1	1248	-	845	2076	2163	0.9597781
A06	4118633	4125217	A06p07360.2_BraZ1	2163.67	+	975	4051	6584	0.6152794
A06	4126048	4132938	A06p07370.2_BraZ1	6279	+	4254	6793	6890	0.9859216
A06	4134921	4135389	A06p07380.2_BraZ1	46.8	-	42	274	468	0.5854701
A06	4138384	4139092	A06p07390.2_BraZ1	70.8	-	9	308	708	0.4350283
A06	4143109	4143625	A06p07400.2_BraZ1	225	-	196	509	516	0.9864341
A06	4144183	4144777	A06p07410.2_BraZ1	34.2	-	424	594	594	1.0000000
A06	4145466	4146446	A06p07420.2_BraZ1	225	-	955	972	980	0.9918367
A06	4146874	4148266	A06p07430.2_BraZ1	139.2	+	611	1392	1392	1.0000000
A06	4148641	4153248	A06p07440.2_BraZ1	2184	-	1260	2253	4607	0.4890384
A06	4155159	4156539	A06p07450.2_BraZ1	823.636	+	1066	1380	1380	1.0000000
A06	4156595	4157308	A06p07460.2_BraZ1	94.0909	+	243	559	713	0.7840112
A06	4157844	4158626	A06p07470.2_BraZ1	684	-	295	779	782	0.9961637
A06	4161160	4162433	A06p07480.2_BraZ1	921	+	127	1091	1273	0.8570306
A06	4162804	4171799	A06p07490.2_BraZ1	3201.69	-	4443	8616	8995	0.9578655
A06	4185180	4185467	A06p07500.2_BraZ1	19.8	+	29	235	287	0.8188154
A06	4187943	4190833	A06p07510.2_BraZ1	902.616	-	2243	2890	2890	1.0000000
A06	4193741	4195246	A06p07520.2_BraZ1	2126.13	+	852	1505	1505	1.0000000
A06	4195866	4197342	A06p07530.2_BraZ1	890.3	-	470	1404	1476	0.9512195
A06	4198875	4203621	A06p07540.2_BraZ1	2665.18	+	1812	4400	4746	0.9270965
A06	4205453	4206572	A06p07550.2_BraZ1	703.385	-	419	1119	1119	1.0000000
A06	4216223	4216565	A06p07560.2_BraZ1	34.2	+	196	342	342	1.0000000
A06	4219276	4226073	A06p07570.2_BraZ1	1018.27	+	2372	5053	6797	0.7434162
A06	4233075	4233652	A06p07580.2_BraZ1	408	+	578	577	577	1.0000000
A06	4235054	4235421	A06p07590.2_BraZ1	258	-	111	326	367	0.8882834
A06	4237772	4238857	A06p07600.2_BraZ1	79.2	-	886	1085	1085	1.0000000
A06	4239071	4239503	A06p07610.2_BraZ1	309	+	314	432	432	1.0000000
A06	4241243	4241543	A06p07620.2_BraZ1	264	+	36	300	300	1.0000000
A06	4241784	4242151	A06p07630.2_BraZ1	303	-	131	367	367	1.0000000
A06	4246429	4247657	A06p07640.2_BraZ1	524.795	-	467	1228	1228	1.0000000
A06	4247974	4251238	A06p07650.2_BraZ1	1714.85	+	1622	3203	3264	0.9813113
A06	4251566	4251698	A06p07660.2_BraZ1	13.2	+	233	132	132	1.0000000
A06	4252149	4253393	A06p07670.2_BraZ1	546	+	1075	1244	1244	1.0000000
A06	4254800	4256891	A06p07680.2_BraZ1	209.1	+	581	2030	2091	0.9708273
A06	4258937	4261872	A06p07690.2_BraZ1	1420.49	+	1088	2918	2935	0.9942079
A06	4264739	4266676	A06p07700.2_BraZ1	1719	-	1176	1937	1937	1.0000000
A06	4267296	4269311	A06p07710.2_BraZ1	1722	-	1241	2015	2015	1.0000000
A06	4281961	4283620	A06p07720.2_BraZ1	165.9	-	361	1467	1659	0.8842676
A06	4286808	4288793	A06p07730.2_BraZ1	1353.75	-	686	1865	1985	0.9395466
A06	4289857	4291555	A06p07740.2_BraZ1	169.8	-	472	1512	1698	0.8904594
A06	4292597	4293401	A06p07750.2_BraZ1	518.932	-	373	804	804	1.0000000
A06	4298286	4298600	A06p07760.2_BraZ1	210	-	8	136	314	0.4331210
A06	4298600	4301422	A06p07770.2_BraZ1	56.8421	+	764	1655	2822	0.5864635
A06	4302300	4302889	A06p07780.2_BraZ1	12655.5	-	477	589	589	1.0000000
A06	4303768	4304923	A06p07790.2_BraZ1	467.694	+	808	1155	1155	1.0000000
A06	4305811	4307891	A06p07800.2_BraZ1	953.383	+	1394	2080	2080	1.0000000
A06	4308122	4311184	A06p07810.2_BraZ1	1943.43	-	837	2967	3062	0.9689745
A06	4312423	4314878	A06p07820.2_BraZ1	1543.75	-	333	1630	2455	0.6639511
A06	4324734	4326671	A06p07830.2_BraZ1	654	+	2116	1913	1937	0.9876097
A06	4326981	4328151	A06p07840.2_BraZ1	1011	-	445	1170	1170	1.0000000
A06	4335681	4336451	A06p07850.2_BraZ1	231.818	+	261	770	770	1.0000000
A06	4342269	4343824	A06p07860.2_BraZ1	838.615	+	1188	1555	1555	1.0000000
A06	4344636	4351742	A06p07870.2_BraZ1	2725	-	3036	6527	7106	0.9185196
A06	4354161	4354365	A06p07880.2_BraZ1	18.6	-	209	204	204	1.0000000
A06	4359189	4359522	A06p07890.2_BraZ1	33.3	-	205	333	333	1.0000000
A06	4362101	4362275	A06p07900.2_BraZ1	17.4	+	2	2	174	0.0114943
A06	4363703	4365813	A06p07910.2_BraZ1	1007.17	+	1814	2091	2110	0.9909953
A06	4366107	4367057	A06p07920.2_BraZ1	129.783	+	1101	950	950	1.0000000
A06	4368398	4369823	A06p07930.2_BraZ1	268.2	-	80	1001	1425	0.7024561
A06	4370441	4372968	A06p07940.2_BraZ1	1201.2	+	1322	2277	2527	0.9010684
A06	4373857	4374201	A06p07950.2_BraZ1	243	+	289	344	344	1.0000000
A06	4375852	4376359	A06p07960.2_BraZ1	50.7	-	12	71	507	0.1400394
A06	4378768	4380346	A06p07970.2_BraZ1	1075.25	+	553	1567	1578	0.9930292
A06	4380726	4381428	A06p07980.2_BraZ1	70.2	-	334	702	702	1.0000000
A06	4382000	4385273	A06p07990.2_BraZ1	719.333	-	1788	3165	3273	0.9670027
A06	4386662	4388232	A06p08000.2_BraZ1	1003	-	899	1570	1570	1.0000000
A06	4388614	4390654	A06p08010.2_BraZ1	913.6	-	1038	1943	2040	0.9524510
A06	4392821	4394869	A06p08020.2_BraZ1	24712.5	+	919	2013	2048	0.9829102
A06	4395296	4400054	A06p08030.2_BraZ1	2119.88	-	2076	4659	4758	0.9791929
A06	4400998	4402449	A06p08040.2_BraZ1	2190	-	639	1393	1451	0.9600276
A06	4403260	4404476	A06p08050.2_BraZ1	3221.5	-	548	1216	1216	1.0000000
A06	4406109	4408338	A06p08060.2_BraZ1	632.188	+	1005	2226	2229	0.9986541
A06	4414769	4417898	A06p08070.2_BraZ1	2126.34	-	1014	2824	3129	0.9025248
A06	4423413	4426597	A06p08080.2_BraZ1	1788.09	+	1916	3146	3184	0.9880653
A06	4427080	4428858	A06p08090.2_BraZ1	642.156	-	1804	1663	1778	0.9353206
A06	4429316	4431227	A06p08100.2_BraZ1	863.411	-	1470	1911	1911	1.0000000
A06	4439476	4442702	A06p08110.2_BraZ1	1355.61	+	1451	3158	3226	0.9789213
A06	4443215	4443662	A06p08120.2_BraZ1	44.7	+	838	447	447	1.0000000
A06	4444362	4444653	A06p08130.2_BraZ1	29.1	-	104	136	291	0.4673539
A06	4445621	4445847	A06p08140.2_BraZ1	18.9	-	1	60	226	0.2654867
A06	4448727	4450400	A06p08150.2_BraZ1	1302	-	542	1672	1673	0.9994023
A06	4451669	4455769	A06p08160.2_BraZ1	2352.1	+	1637	3996	4100	0.9746342
A06	4456456	4460096	A06p08170.2_BraZ1	2396.86	-	1009	3349	3640	0.9200550
A06	4462191	4465043	A06p08180.2_BraZ1	1361.23	-	571	1955	2852	0.6854839
A06	4472584	4472977	A06p08190.2_BraZ1	261	+	568	393	393	1.0000000
A06	4474113	4474347	A06p08200.2_BraZ1	23.4	-	30	227	234	0.9700854
A06	4476554	4478503	A06p08210.2_BraZ1	736.714	+	1236	1949	1949	1.0000000
A06	4479973	4480804	A06p08220.2_BraZ1	83.1	+	485	831	831	1.0000000
A06	4484493	4488236	A06p08230.2_BraZ1	1990.74	+	2682	3672	3743	0.9810312
A06	4490804	4493482	A06p08240.2_BraZ1	1149.58	+	2028	2547	2678	0.9510829
A06	4494251	4496521	A06p08250.2_BraZ1	822.909	+	1739	2270	2270	1.0000000
A06	4497910	4498943	A06p08260.2_BraZ1	891	-	216	798	1033	0.7725073
A06	4504218	4505106	A06p08270.2_BraZ1	88.8	-	798	888	888	1.0000000
A06	4510637	4511670	A06p08280.2_BraZ1	606.045	-	730	1033	1033	1.0000000
A06	4512125	4513095	A06p08290.2_BraZ1	897	+	196	970	970	1.0000000
A06	4515213	4516164	A06p08300.2_BraZ1	574	+	616	951	951	1.0000000
A06	4523916	4527496	A06p08310.2_BraZ1	1362.97	+	1076	3130	3580	0.8743017
A06	4527805	4531087	A06p08320.2_BraZ1	1592.28	-	2683	3120	3282	0.9506398
A06	4533605	4535186	A06p08330.2_BraZ1	1571.54	+	1389	1581	1581	1.0000000
A06	4536320	4539311	A06p08340.2_BraZ1	1885.5	+	1060	2991	2991	1.0000000
A06	4539547	4543425	A06p08350.2_BraZ1	1895.52	+	1253	3823	3878	0.9858174
A06	4544144	4544785	A06p08360.2_BraZ1	405	-	330	641	641	1.0000000
A06	4546142	4547646	A06p08370.2_BraZ1	1428	+	548	1504	1504	1.0000000
A06	4553593	4556509	A06p08380.2_BraZ1	1334	-	1721	2834	2916	0.9718793
A06	4556961	4557838	A06p08390.2_BraZ1	762	-	290	809	877	0.9224629
A06	4558593	4559676	A06p08400.2_BraZ1	664.2	+	482	1083	1083	1.0000000
A06	4560492	4563038	A06p08410.2_BraZ1	1508.93	-	906	2526	2546	0.9921445
A06	4564113	4565182	A06p08420.2_BraZ1	664.174	+	585	1014	1069	0.9485500
A06	4565211	4565510	A06p08430.2_BraZ1	17.7	-	63	299	299	1.0000000
A06	4565642	4570035	A06p08440.2_BraZ1	2124.21	-	2424	4006	4393	0.9119053
A06	4576429	4579083	A06p08450.2_BraZ1	678.031	+	91	893	2654	0.3364733
A06	4580865	4581376	A06p08460.2_BraZ1	342	+	1	114	511	0.2230920
A06	4583255	4587034	A06p08470.2_BraZ1	2862	-	529	2555	3779	0.6761048
A06	4603788	4605301	A06p08480.2_BraZ1	606.857	+	1436	1144	1513	0.7561137
A06	4615184	4616297	A06p08490.2_BraZ1	111.3	+	675	1038	1113	0.9326146
A06	4616801	4617638	A06p08500.2_BraZ1	186.346	+	579	629	837	0.7514935
A06	4619106	4621676	A06p08510.2_BraZ1	1626.9	-	1428	2472	2570	0.9618677
A06	4622474	4623624	A06p08520.2_BraZ1	1077	-	329	912	1150	0.7930435
A06	4624345	4625082	A06p08530.2_BraZ1	2898.5	+	219	575	737	0.7801899
A06	4625288	4626359	A06p08540.2_BraZ1	107.1	-	373	941	1071	0.8786181
A06	4627171	4627476	A06p08550.2_BraZ1	288	-	1	10	305	0.0327869
A06	4630784	4632017	A06p08560.2_BraZ1	872.727	-	178	1188	1233	0.9635037
A06	4633851	4634121	A06p08570.2_BraZ1	237	+	467	270	270	1.0000000
A06	4642571	4643048	A06p08580.2_BraZ1	47.7	+	0	0	477	0.0000000
A06	4645869	4650710	A06p08590.2_BraZ1	2714.22	+	488	3956	4841	0.8171865
A06	4650982	4652625	A06p08600.2_BraZ1	957	-	296	1351	1643	0.8222763
A06	4656307	4657329	A06p08610.2_BraZ1	714	-	17	542	1022	0.5303327
A06	4666091	4667989	A06p08620.2_BraZ1	868.937	-	1732	1898	1898	1.0000000
A06	4667710	4669066	A06p08630.2_BraZ1	653.38	-	1138	1356	1356	1.0000000
A06	4670751	4671960	A06p08640.2_BraZ1	120.6	-	975	1209	1209	1.0000000
A06	4673251	4673653	A06p08650.2_BraZ1	40.2	+	111	387	402	0.9626865
A06	4674596	4677922	A06p08660.2_BraZ1	2114.55	+	766	2831	3326	0.8511726
A06	4679463	4681296	A06p08670.2_BraZ1	1467	+	437	1578	1833	0.8608838
A06	4683096	4683836	A06p08680.2_BraZ1	41.1	+	233	706	740	0.9540541
A06	4694047	4694665	A06p08690.2_BraZ1	61.8	+	442	597	618	0.9660194
A06	4697897	4699829	A06p08700.2_BraZ1	193.2	+	833	1925	1932	0.9963768
A06	4700421	4708283	A06p08710.2_BraZ1	3834.52	+	4326	7789	7862	0.9907148
A06	4709017	4709143	A06p08720.2_BraZ1	12.6	-	93	126	126	1.0000000
A06	4712786	4717442	A06p08730.2_BraZ1	1395.91	-	4096	4485	4656	0.9632732
A06	4718816	4719845	A06p08740.2_BraZ1	255	-	471	543	1029	0.5276968
A06	4722533	4724129	A06p08750.2_BraZ1	159.6	+	0	0	1596	0.0000000
A06	4725869	4727465	A06p08760.2_BraZ1	159.6	+	3	215	1596	0.1347118
A06	4728821	4736902	A06p08770.2_BraZ1	2255.54	+	5278	7993	8081	0.9891102
A06	4739232	4740646	A06p08780.2_BraZ1	424	-	915	1405	1414	0.9936351
A06	4742739	4743415	A06p08790.2_BraZ1	489	+	312	676	676	1.0000000
A06	4744931	4746181	A06p08800.2_BraZ1	420	+	217	1165	1250	0.9320000
A06	4759020	4759578	A06p08810.2_BraZ1	55.8	+	247	558	558	1.0000000
A06	4760426	4761330	A06p08820.2_BraZ1	519	+	1232	904	904	1.0000000
A06	4762684	4764348	A06p08830.2_BraZ1	5324.4	+	21	349	1664	0.2097356
A06	4764524	4765698	A06p08840.2_BraZ1	669.65	-	608	1174	1174	1.0000000
A06	4768528	4770039	A06p08850.2_BraZ1	1003.33	-	372	1342	1511	0.8881536
A06	4779105	4779243	A06p08860.2_BraZ1	13.8	+	147	138	138	1.0000000
A06	4782181	4782715	A06p08870.2_BraZ1	372	-	484	534	534	1.0000000
A06	4803984	4805392	A06p08880.2_BraZ1	927	+	489	1288	1408	0.9147727
A06	4809083	4810109	A06p08890.2_BraZ1	102.6	-	31	579	1026	0.5643275
A06	4820367	4821052	A06p08900.2_BraZ1	252	+	6564	685	685	1.0000000
A06	4834689	4836514	A06p08910.2_BraZ1	456	+	2694	1825	1825	1.0000000
A06	4837310	4838348	A06p08920.2_BraZ1	102.9	+	143	638	1038	0.6146436
A06	4840415	4840559	A06p08930.2_BraZ1	14.4	+	42	144	144	1.0000000
A06	4844174	4845891	A06p08940.2_BraZ1	606.24	-	321	1384	1717	0.8060571
A06	4846538	4851041	A06p08950.2_BraZ1	2903.31	-	790	3663	4503	0.8134577
A06	4853145	4858027	A06p08960.2_BraZ1	3011.43	+	917	4128	4882	0.8455551
A06	4859479	4859794	A06p08970.2_BraZ1	147	+	107	315	315	1.0000000
A06	4860837	4862571	A06p08980.2_BraZ1	173.4	-	567	1720	1734	0.9919262
A06	4863003	4863153	A06p08990.2_BraZ1	15	-	221	150	150	1.0000000
A06	4863653	4865848	A06p09000.2_BraZ1	1126.27	-	1361	2158	2195	0.9831435
A06	4868382	4871565	A06p09010.2_BraZ1	1737.29	+	1987	3183	3183	1.0000000
A06	4873288	4874630	A06p09020.2_BraZ1	494.812	-	578	1035	1342	0.7712370
A06	4876244	4877293	A06p09030.2_BraZ1	787.5	-	120	1016	1049	0.9685414
A06	4879095	4880700	A06p09040.2_BraZ1	160.5	+	430	1548	1605	0.9644860
A06	4880992	4885485	A06p09050.2_BraZ1	1578.5	-	3335	4493	4493	1.0000000
A06	4887276	4897947	A06p09060.2_BraZ1	285	+	3933	9226	10671	0.8645862
A06	4887642	4887882	A06p09070.2_BraZ1	153	+	261	240	240	1.0000000
A06	4887849	4888480	A06p09080.2_BraZ1	117	+	450	604	631	0.9572108
A06	4896577	4896934	A06p09090.2_BraZ1	35.7	+	308	357	357	1.0000000
A06	4900011	4901697	A06p09100.2_BraZ1	1524	-	480	1614	1686	0.9572954
A06	4904230	4906082	A06p09110.2_BraZ1	1506	-	487	1657	1852	0.8947084
A06	4907147	4909127	A06p09120.2_BraZ1	752.632	-	820	1712	1980	0.8646465
A06	4912441	4915810	A06p09130.2_BraZ1	2574	-	1132	3119	3369	0.9257940
A06	4916103	4926644	A06p09140.2_BraZ1	2561.04	+	7510	9714	10541	0.9215444
A06	4919904	4920599	A06p09150.2_BraZ1	189	+	132	523	695	0.7525180
A06	4921755	4922148	A06p09160.2_BraZ1	39.3	-	9	176	393	0.4478371
A06	4927405	4928835	A06p09170.2_BraZ1	1179	-	836	1430	1430	1.0000000
A06	4938885	4939860	A06p09180.2_BraZ1	97.5	-	647	975	975	1.0000000
A06	4948340	4952123	A06p09190.2_BraZ1	627.74	+	3752	3780	3783	0.9992070
A06	4952088	4952761	A06p09200.2_BraZ1	155.273	+	254	673	673	1.0000000
A06	4953322	4954609	A06p09210.2_BraZ1	128.7	-	491	1287	1287	1.0000000
A06	4958132	4958876	A06p09220.2_BraZ1	338.4	+	598	744	744	1.0000000
A06	4959681	4959885	A06p09230.2_BraZ1	132	+	152	204	204	1.0000000
A06	4963539	4965250	A06p09240.2_BraZ1	1308.73	+	300	1414	1711	0.8264173
A06	4965731	4966757	A06p09250.2_BraZ1	363.058	-	1120	1026	1026	1.0000000
A06	4968401	4969923	A06p09260.2_BraZ1	467.215	-	61	827	1522	0.5433640
A06	4970877	4972400	A06p09270.2_BraZ1	426	+	117	454	1523	0.2980959
A06	4975979	4977556	A06p09280.2_BraZ1	1279.47	-	328	1051	1577	0.6664553
A06	4978571	4979850	A06p09290.2_BraZ1	339.75	+	725	1261	1279	0.9859265
A06	4980380	4982656	A06p09300.2_BraZ1	1072.44	-	1084	2202	2276	0.9674868
A06	4984575	4984800	A06p09310.2_BraZ1	22.5	-	24	225	225	1.0000000
A06	4992217	4993393	A06p09320.2_BraZ1	117.6	+	303	938	1176	0.7976190
A06	4995930	4997840	A06p09330.2_BraZ1	1625.23	+	67	954	1910	0.4994764
A06	4999091	5002292	A06p09340.2_BraZ1	2157.07	+	1235	2853	3201	0.8912840
A06	5003376	5003640	A06p09350.2_BraZ1	26.4	+	22	130	264	0.4924242
A06	5005408	5010018	A06p09360.2_BraZ1	1515.67	+	4085	4610	4610	1.0000000
A06	5015413	5015604	A06p09370.2_BraZ1	12.6	-	554	191	191	1.0000000
A06	5015720	5017570	A06p09380.2_BraZ1	934.65	-	932	1715	1850	0.9270270
A06	5018276	5019773	A06p09390.2_BraZ1	777.75	+	688	1497	1497	1.0000000
A06	5020216	5022413	A06p09400.2_BraZ1	1312.89	-	1366	2186	2197	0.9949932
A06	5039636	5040656	A06p09410.2_BraZ1	882	+	1268	1020	1020	1.0000000
A06	5041661	5043279	A06p09420.2_BraZ1	1372.87	+	651	1618	1618	1.0000000
A06	5044369	5045070	A06p09430.2_BraZ1	531	-	662	701	701	1.0000000
A06	5050230	5050717	A06p09440.2_BraZ1	339	-	143	482	487	0.9897330
A06	5052891	5054836	A06p09450.2_BraZ1	1328.95	+	1162	1898	1945	0.9758355
A06	5058095	5058716	A06p09460.2_BraZ1	62.1	+	143	619	621	0.9967794
A06	5060805	5061496	A06p09470.2_BraZ1	408	+	130	657	691	0.9507959
A06	5069008	5070108	A06p09480.2_BraZ1	966	-	389	1085	1100	0.9863636
A06	5071873	5073038	A06p09490.2_BraZ1	792	-	133	906	1165	0.7776824
A06	5075905	5077219	A06p09500.2_BraZ1	15988.5	-	337	1306	1314	0.9939117
A06	5078988	5080051	A06p09510.2_BraZ1	753.136	-	1541	1063	1063	1.0000000
A06	5081284	5083101	A06p09520.2_BraZ1	3157	+	0	0	1817	0.0000000
A06	5094068	5094251	A06p09530.2_BraZ1	18.3	-	1	2	183	0.0109290
A06	5097281	5098574	A06p09540.2_BraZ1	1086	+	566	1201	1293	0.9288477
A06	5103918	5104940	A06p09550.2_BraZ1	507.429	-	439	1022	1022	1.0000000
A06	5104533	5106124	A06p09560.2_BraZ1	651.81	-	268	703	1591	0.4418605
A06	5107967	5109888	A06p09570.2_BraZ1	1439.78	+	324	1806	1921	0.9401354
A06	5110079	5116124	A06p09580.2_BraZ1	2799.25	-	1230	5359	6045	0.8865178
A06	5120401	5134697	A06p09590.2_BraZ1	267.6	-	634	3514	14296	0.2458030
A06	5136329	5137795	A06p09600.2_BraZ1	937.406	-	880	1466	1466	1.0000000
A06	5142868	5147283	A06p09610.2_BraZ1	2646.56	+	1904	4065	4415	0.9207248
A06	5151170	5152078	A06p09620.2_BraZ1	219	+	239	848	908	0.9339207
A06	5154571	5156810	A06p09630.2_BraZ1	1266.5	+	338	2147	2239	0.9589102
A06	5158642	5163263	A06p09640.2_BraZ1	949.808	-	2103	4601	4621	0.9956719
A06	5166633	5168907	A06p09650.2_BraZ1	227.4	+	519	1967	2274	0.8649956
A06	5176707	5181435	A06p09660.2_BraZ1	1955.21	-	2436	4530	4728	0.9581218
A06	5182335	5184356	A06p09670.2_BraZ1	9369.6	-	996	2021	2021	1.0000000
A06	5187457	5188252	A06p09680.2_BraZ1	6961.5	-	534	795	795	1.0000000
A06	5192001	5192448	A06p09690.2_BraZ1	44.7	+	97	447	447	1.0000000
A06	5194379	5195813	A06p09700.2_BraZ1	143.4	+	1180	1434	1434	1.0000000
A06	5197667	5198023	A06p09710.2_BraZ1	324	+	148	356	356	1.0000000
A06	5198537	5201195	A06p09720.2_BraZ1	264.6	+	1684	2618	2658	0.9849511
A06	5201940	5203639	A06p09730.2_BraZ1	173.4	+	402	1121	1699	0.6597999
A06	5211431	5215733	A06p09740.2_BraZ1	883.65	+	942	3705	4302	0.8612273
A06	5219071	5223197	A06p09750.2_BraZ1	2067	-	1754	3818	4126	0.9253514
A06	5226341	5228903	A06p09760.2_BraZ1	1176.95	-	1144	2260	2562	0.8821234
A06	5232632	5235020	A06p09770.2_BraZ1	1312.5	-	105	887	2388	0.3714405
A06	5235372	5235630	A06p09780.2_BraZ1	25.8	-	44	258	258	1.0000000
A06	5242457	5243796	A06p09790.2_BraZ1	1251	+	229	1030	1339	0.7692308
A06	5251707	5251854	A06p09800.2_BraZ1	14.7	-	225	147	147	1.0000000
A06	5255803	5256217	A06p09810.2_BraZ1	41.4	+	8	50	414	0.1207730
A06	5263272	5263844	A06p09820.2_BraZ1	34.2	-	36	291	572	0.5087413
A06	5268715	5270469	A06p09830.2_BraZ1	623.641	+	526	883	1754	0.5034208
A06	5271601	5271940	A06p09840.2_BraZ1	33.9	+	2	137	339	0.4041298
A06	5272474	5275268	A06p09850.2_BraZ1	1215.69	-	1392	2792	2794	0.9992842
A06	5276820	5280099	A06p09860.2_BraZ1	2052	-	1364	3105	3279	0.9469351
A06	5281239	5282765	A06p09870.2_BraZ1	882	+	1618	1526	1526	1.0000000
A06	5283580	5283835	A06p09880.2_BraZ1	25.5	-	326	255	255	1.0000000
A06	5286070	5286734	A06p09890.2_BraZ1	58.2	+	231	621	664	0.9352410
A06	5289224	5290623	A06p09900.2_BraZ1	987.075	-	85	956	1399	0.6833453
A06	5295050	5309945	A06p09910.2_BraZ1	2074.89	+	4255	11965	14895	0.8032897
A06	5313417	5313840	A06p09920.2_BraZ1	42.3	+	22	162	423	0.3829787
A06	5316203	5317850	A06p09930.2_BraZ1	1121.24	+	112	1042	1647	0.6326655
A06	5319250	5320657	A06p09940.2_BraZ1	1042.33	+	232	928	1407	0.6595594
A06	5321090	5322364	A06p09950.2_BraZ1	825	-	791	1274	1274	1.0000000
A06	5326329	5330134	A06p09960.2_BraZ1	1862	+	1089	2802	3805	0.7363995
A06	5330387	5332328	A06p09970.2_BraZ1	1029.21	-	229	1488	1941	0.7666152
A06	5333522	5335589	A06p09980.2_BraZ1	206.7	-	520	1814	2067	0.8776004
A06	5336366	5337617	A06p09990.2_BraZ1	1068	+	489	1246	1251	0.9960032
A06	5337924	5339160	A06p10000.2_BraZ1	597.762	-	413	1100	1236	0.8899676
A06	5340302	5342048	A06p10010.2_BraZ1	1030.94	-	676	1646	1746	0.9427263
A06	5344754	5346457	A06p10020.2_BraZ1	1104.55	-	395	1407	1703	0.8261891
A06	5348023	5349621	A06p10030.2_BraZ1	15561	+	450	1333	1598	0.8341677
A06	5349927	5351213	A06p10040.2_BraZ1	114.6	-	624	1286	1286	1.0000000
A06	5351747	5356655	A06p10050.2_BraZ1	1654.33	-	2627	4564	4908	0.9299104
A06	5357670	5358371	A06p10060.2_BraZ1	306	-	296	647	701	0.9229672
A06	5360928	5361413	A06p10070.2_BraZ1	273	+	19	339	485	0.6989691
A06	5363193	5363808	A06p10080.2_BraZ1	375	-	18	499	615	0.8113821
A06	5367402	5367984	A06p10090.2_BraZ1	58.2	-	19	254	582	0.4364261
A06	5381183	5386840	A06p10100.2_BraZ1	326.667	+	729	4498	5657	0.7951211
A06	5389547	5391679	A06p10110.2_BraZ1	301.026	-	1353	2114	2132	0.9915572
A06	5395156	5397863	A06p10120.2_BraZ1	1325.08	-	1583	2707	2707	1.0000000
A06	5404451	5406652	A06p10130.2_BraZ1	1028.35	-	188	1472	2201	0.6687869
A06	5408546	5409576	A06p10140.2_BraZ1	204	-	126	919	1030	0.8922330
A06	5416441	5417217	A06p10150.2_BraZ1	309.273	+	448	776	776	1.0000000
A06	5417675	5418244	A06p10160.2_BraZ1	117	-	474	569	569	1.0000000
A06	5418391	5420984	A06p10170.2_BraZ1	5656	-	900	2481	2593	0.9568068
A06	5422035	5423451	A06p10180.2_BraZ1	945.929	+	491	1030	1416	0.7274011
A06	5429822	5430715	A06p10190.2_BraZ1	825	-	408	887	893	0.9932811
A06	5435237	5441297	A06p10200.2_BraZ1	1378.33	+	2104	5318	6060	0.8775578
A06	5441182	5442485	A06p10210.2_BraZ1	715	-	863	1303	1303	1.0000000
A06	5442997	5443354	A06p10220.2_BraZ1	288	-	0	0	357	0.0000000
A06	5451541	5453194	A06p10230.2_BraZ1	1551	-	198	1304	1653	0.7888687
A06	5472773	5472968	A06p10240.2_BraZ1	153	-	212	195	195	1.0000000
A06	5473439	5474446	A06p10250.2_BraZ1	171	-	107	816	1007	0.8103277
A06	5477338	5479091	A06p10260.2_BraZ1	1195.98	+	830	1726	1753	0.9845979
A06	5480803	5481831	A06p10270.2_BraZ1	960	+	905	1028	1028	1.0000000
A06	5482080	5484574	A06p10280.2_BraZ1	1774.29	-	1099	2417	2494	0.9691259
A06	5485627	5488234	A06p10290.2_BraZ1	1223.1	+	2263	2599	2607	0.9969313
A06	5489924	5491481	A06p10300.2_BraZ1	1258.78	+	848	1424	1557	0.9145793
A06	5491644	5496399	A06p10310.2_BraZ1	338.25	+	1067	3386	4755	0.7120925
A06	5491704	5491918	A06p10320.2_BraZ1	132	+	9	109	214	0.5093458
A06	5498887	5499603	A06p10330.2_BraZ1	1815	-	356	618	716	0.8631285
A06	5502590	5504067	A06p10340.2_BraZ1	1254	+	903	1477	1477	1.0000000
A06	5504537	5507132	A06p10350.2_BraZ1	259.5	-	1383	2595	2595	1.0000000
A06	5507544	5509224	A06p10360.2_BraZ1	870.8	+	1755	1680	1680	1.0000000
A06	5509653	5510497	A06p10370.2_BraZ1	594	-	344	844	844	1.0000000
A06	5514694	5517293	A06p10380.2_BraZ1	2040	-	1132	2572	2599	0.9896114
A06	5518169	5519844	A06p10390.2_BraZ1	1131.74	+	1409	1652	1675	0.9862686
A06	5523322	5525487	A06p10400.2_BraZ1	1442.91	+	814	2152	2165	0.9939954
A06	5526067	5528198	A06p10410.2_BraZ1	1382.63	-	782	2127	2131	0.9981229
A06	5533605	5538307	A06p10420.2_BraZ1	4347	+	167	1454	4702	0.3092301
A06	5538730	5540179	A06p10430.2_BraZ1	90	+	544	1423	1449	0.9820566
A06	5541544	5541718	A06p10440.2_BraZ1	17.4	-	1	84	174	0.4827586
A06	5543302	5545517	A06p10450.2_BraZ1	1241.27	+	823	2215	2215	1.0000000
A06	5546259	5546901	A06p10460.2_BraZ1	549	+	295	640	642	0.9968848
A06	5553261	5557117	A06p10470.2_BraZ1	2185.22	+	981	3545	3856	0.9193465
A06	5567234	5567447	A06p10480.2_BraZ1	21.3	+	206	213	213	1.0000000
A06	5571276	5575223	A06p10490.2_BraZ1	1720.89	+	2005	3906	3947	0.9896123
A06	5589697	5596081	A06p10500.2_BraZ1	1837.51	+	3113	5665	6384	0.8873747
A06	5599889	5601598	A06p10510.2_BraZ1	19584	+	408	1484	1709	0.8683441
A06	5605761	5606160	A06p10520.2_BraZ1	222	-	0	0	399	0.0000000
A06	5608597	5611138	A06p10530.2_BraZ1	1716	+	1236	2309	2541	0.9086974
A06	5611936	5613514	A06p10540.2_BraZ1	1512	+	760	1578	1578	1.0000000
A06	5617036	5618168	A06p10550.2_BraZ1	1812	+	533	1132	1132	1.0000000
A06	5618814	5620426	A06p10560.2_BraZ1	1539	+	920	1354	1612	0.8399504
A06	5621142	5625331	A06p10570.2_BraZ1	1400.17	+	2924	3963	4189	0.9460492
A06	5627169	5630231	A06p10580.2_BraZ1	881.6	-	926	2373	3062	0.7749836
A06	5636763	5636895	A06p10590.2_BraZ1	13.2	+	0	0	132	0.0000000
A06	5639825	5640083	A06p10600.2_BraZ1	213.75	-	11	53	258	0.2054264
A06	5640579	5641385	A06p10610.2_BraZ1	357	-	0	0	806	0.0000000
A06	5643599	5645080	A06p10620.2_BraZ1	955.241	-	13	166	1481	0.1120864
A06	5645562	5645799	A06p10630.2_BraZ1	23.7	+	8	82	237	0.3459916
A06	5647608	5648679	A06p10640.2_BraZ1	4575	-	16	281	1071	0.2623716
A06	5649673	5650492	A06p10650.2_BraZ1	1701	+	65	143	819	0.1746032
A06	5653313	5655050	A06p10660.2_BraZ1	1134.75	-	180	1186	1737	0.6827864
A06	5655414	5655648	A06p10670.2_BraZ1	168	-	27	234	234	1.0000000
A06	5659195	5660296	A06p10680.2_BraZ1	7650	+	658	1101	1101	1.0000000
A06	5661278	5661567	A06p10690.2_BraZ1	270	+	132	217	289	0.7508650
A06	5661772	5663372	A06p10700.2_BraZ1	609	-	740	1414	1600	0.8837500
A06	5663684	5664490	A06p10710.2_BraZ1	42	-	733	800	806	0.9925559
A06	5667403	5670060	A06p10720.2_BraZ1	1332.71	+	880	2489	2657	0.9367708
A06	5671021	5673346	A06p10730.2_BraZ1	701.429	+	953	2232	2325	0.9600000
A06	5674580	5676899	A06p10740.2_BraZ1	706.783	+	699	2173	2319	0.9370418
A06	5677509	5679333	A06p10750.2_BraZ1	989.88	-	915	1824	1824	1.0000000
A06	5680814	5682122	A06p10760.2_BraZ1	130.8	+	784	1139	1308	0.8707951
A06	5683429	5684565	A06p10770.2_BraZ1	786	-	847	1136	1136	1.0000000
A06	5685344	5688197	A06p10780.2_BraZ1	995.201	-	1230	2465	2853	0.8640028
A06	5688503	5689963	A06p10790.2_BraZ1	708.264	+	1011	1460	1460	1.0000000
A06	5690976	5691489	A06p10800.2_BraZ1	51.3	+	136	513	513	1.0000000
A06	5693464	5694739	A06p10810.2_BraZ1	127.5	-	204	943	1275	0.7396079
A06	5700810	5701768	A06p10820.2_BraZ1	738	+	540	932	958	0.9728601
A06	5701944	5702597	A06p10830.2_BraZ1	64.5	+	87	596	653	0.9127105
A06	5721234	5723500	A06p10840.2_BraZ1	1277.6	+	1038	2119	2266	0.9351280
A06	5723584	5723971	A06p10850.2_BraZ1	38.7	-	340	387	387	1.0000000
A06	5724265	5725804	A06p10860.2_BraZ1	939.211	-	825	1483	1539	0.9636127
A06	5727012	5729009	A06p10870.2_BraZ1	748.286	+	462	1407	1997	0.7045568
A06	5731878	5733543	A06p10880.2_BraZ1	1117.27	+	549	1420	1665	0.8528529
A06	5733821	5735977	A06p10890.2_BraZ1	1680.83	-	1231	2156	2156	1.0000000
A06	5989646	5990715	A06p10900.2_BraZ1	915	+	1228	1069	1069	1.0000000
A06	5995301	5995751	A06p10910.2_BraZ1	45	-	85	410	450	0.9111111
A06	5998949	5999468	A06p10920.2_BraZ1	51.9	+	33	450	519	0.8670520
A06	6002098	6002814	A06p10930.2_BraZ1	69	-	109	604	716	0.8435754
A06	6004616	6005910	A06p10940.2_BraZ1	750	+	607	1115	1294	0.8616692
A06	6006979	6007678	A06p10950.2_BraZ1	69.9	-	34	422	699	0.6037196
A06	6012043	6012313	A06p10960.2_BraZ1	27	-	0	0	270	0.0000000
A06	6012837	6014421	A06p10970.2_BraZ1	13560	-	263	1472	1584	0.9292929
A06	6018922	6019176	A06p10980.2_BraZ1	16.5	+	37	251	254	0.9881890
A06	6019613	6020513	A06p10990.2_BraZ1	90	-	6	274	900	0.3044444
A06	6026027	6027423	A06p11000.2_BraZ1	1059	+	53	400	1396	0.2865329
A06	6033126	6035731	A06p11010.2_BraZ1	771.19	+	530	2207	2605	0.8472169
A06	6036281	6038834	A06p11020.2_BraZ1	255.3	+	245	2008	2553	0.7865257
A06	6040040	6042334	A06p11030.2_BraZ1	1299	+	862	1374	2294	0.5989538
A06	6042866	6044958	A06p11040.2_BraZ1	1341	-	121	1275	2092	0.6094646
A06	6051644	6052794	A06p11050.2_BraZ1	6744	+	868	1104	1150	0.9600000
A06	6053444	6054873	A06p11060.2_BraZ1	417.857	+	918	1429	1429	1.0000000
A06	6055071	6055194	A06p11070.2_BraZ1	12.3	+	224	123	123	1.0000000
A06	6059303	6059900	A06p11080.2_BraZ1	340	+	660	597	597	1.0000000
A06	6061041	6063433	A06p11090.2_BraZ1	287.868	-	622	1962	2392	0.8202341
A06	6064079	6067681	A06p11100.2_BraZ1	1019.66	+	1441	3177	3602	0.8820100
A06	6067222	6082152	A06p11110.2_BraZ1	3152.95	+	2496	10415	14930	0.6975887
A06	6083721	6086270	A06p11120.2_BraZ1	1452.97	+	307	1910	2549	0.7493135
A06	6086478	6087516	A06p11130.2_BraZ1	103.8	-	99	757	1038	0.7292871
A06	6089482	6095960	A06p11140.2_BraZ1	2732.48	+	1134	5154	6478	0.7956159
A06	6096053	6097658	A06p11150.2_BraZ1	1387.93	-	244	1575	1605	0.9813084
A06	6098299	6100205	A06p11160.2_BraZ1	13516	-	45	701	1906	0.3677859
A06	6102039	6104781	A06p11170.2_BraZ1	1422.61	+	841	2608	2742	0.9511306
A06	6105643	6107651	A06p11180.2_BraZ1	656	+	1632	1979	2008	0.9855578
A06	6108652	6111862	A06p11190.2_BraZ1	1825.48	+	1020	2729	3210	0.8501558
A06	6113795	6114114	A06p11200.2_BraZ1	216	-	120	296	319	0.9278997
A06	6292391	6294882	A06p11210.2_BraZ1	2121.56	+	455	2343	2491	0.9405861
A06	6295488	6296109	A06p11220.2_BraZ1	228	-	245	602	621	0.9694042
A06	6296194	6300122	A06p11230.2_BraZ1	586.096	-	1733	3652	3928	0.9297352
A06	6301148	6302825	A06p11240.2_BraZ1	167.7	+	198	753	1677	0.4490161
A06	6306843	6307779	A06p11250.2_BraZ1	93.6	-	38	391	936	0.4177350
A06	6313865	6314102	A06p11260.2_BraZ1	23.7	+	175	237	237	1.0000000
A06	6314446	6314686	A06p11270.2_BraZ1	24	-	145	240	240	1.0000000
A06	6316157	6319863	A06p11280.2_BraZ1	2994.1	-	1617	3706	3706	1.0000000
A06	6322425	6323352	A06p11290.2_BraZ1	470.25	+	374	927	927	1.0000000
A06	6323314	6323808	A06p11300.2_BraZ1	45.6	+	334	494	494	1.0000000
A06	6324238	6324557	A06p11310.2_BraZ1	273	+	174	306	319	0.9592476
A06	6324965	6328612	A06p11320.2_BraZ1	3770.25	+	2963	3379	3647	0.9265149
A06	6331844	6334112	A06p11330.2_BraZ1	804	-	2852	2268	2268	1.0000000
A06	6334943	6336001	A06p11340.2_BraZ1	767.833	-	385	1058	1058	1.0000000
A06	6336380	6337825	A06p11350.2_BraZ1	659.83	-	598	1445	1445	1.0000000
A06	6339129	6340727	A06p11360.2_BraZ1	1220.69	-	1175	1598	1598	1.0000000
A06	6342557	6344367	A06p11370.2_BraZ1	872.544	-	1771	1810	1810	1.0000000
A06	6345413	6346775	A06p11380.2_BraZ1	848	-	605	1356	1362	0.9955947
A06	6351248	6352890	A06p11390.2_BraZ1	1103.41	+	1046	1437	1642	0.8751522
A06	6353926	6356495	A06p11400.2_BraZ1	1347.84	+	1183	2474	2569	0.9630206
A06	6359423	6359764	A06p11410.2_BraZ1	35.5	+	115	313	341	0.9178886
A06	6359875	6371197	A06p11420.2_BraZ1	1620	+	5150	10810	11322	0.9547783
A06	6364027	6364326	A06p11430.2_BraZ1	159	-	181	299	299	1.0000000
A06	6374287	6376818	A06p11440.2_BraZ1	689.891	-	1220	2292	2531	0.9055709
A06	6384096	6386541	A06p11450.2_BraZ1	1728	-	1295	2401	2445	0.9820041
A06	6387143	6392690	A06p11460.2_BraZ1	2805.46	-	2279	5259	5547	0.9480801
A06	6393156	6398252	A06p11470.2_BraZ1	231	-	188	1867	5096	0.3663658
A06	6395933	6396350	A06p11480.2_BraZ1	41.7	-	1	30	417	0.0719424
A06	6403430	6405373	A06p11490.2_BraZ1	1293	-	152	365	1943	0.1878538
A06	6409586	6410864	A06p11500.2_BraZ1	663.875	+	2	150	1278	0.1173709
A06	6414312	6414985	A06p11510.2_BraZ1	435	-	37	496	673	0.7369985
A06	6517171	6517884	A06p11520.2_BraZ1	231	+	0	0	713	0.0000000
A06	6858396	6859673	A06p11530.2_BraZ1	663.875	+	5	132	1277	0.1033673
A06	6862021	6864447	A06p11540.2_BraZ1	20332	+	259	1638	2426	0.6751855
A06	6865147	6865315	A06p11550.2_BraZ1	16.8	-	328	168	168	1.0000000
A06	6865985	6870296	A06p11560.2_BraZ1	1935.48	-	1911	4044	4311	0.9380654
A06	6871844	6872006	A06p11570.2_BraZ1	13.2	+	101	162	162	1.0000000
A06	6872983	6876013	A06p11580.2_BraZ1	2474.33	+	1110	2723	3030	0.8986799
A06	6876650	6877727	A06p11590.2_BraZ1	107.1	-	492	1077	1077	1.0000000
A06	6878278	6880745	A06p11600.2_BraZ1	1458.53	-	1531	2360	2467	0.9566275
A06	6888534	6889620	A06p11610.2_BraZ1	663.75	+	321	1086	1086	1.0000000
A06	6890284	6892868	A06p11620.2_BraZ1	2181	-	1739	2584	2584	1.0000000
A06	6896015	6897437	A06p11630.2_BraZ1	950	-	2	199	1422	0.1399437
A06	6898577	6901495	A06p11640.2_BraZ1	953.089	-	677	2556	2918	0.8759424
A06	6902168	6902819	A06p11650.2_BraZ1	357	+	833	651	651	1.0000000
A06	6903977	6904656	A06p11660.2_BraZ1	423	-	718	679	679	1.0000000
A06	6907566	6909018	A06p11670.2_BraZ1	1155.23	-	1349	1452	1452	1.0000000
A06	6911007	6914640	A06p11680.2_BraZ1	1784.65	+	838	2700	3633	0.7431874
A06	6915043	6918555	A06p11690.2_BraZ1	3244.62	-	459	2929	3512	0.8339977
A06	6919632	6921520	A06p11700.2_BraZ1	435.683	-	819	1888	1888	1.0000000
A06	6921940	6923230	A06p11710.2_BraZ1	716.914	-	1453	1262	1290	0.9782946
A06	6925966	6928875	A06p11720.2_BraZ1	1605.33	-	886	2862	2909	0.9838433
A06	6933115	6939283	A06p11730.2_BraZ1	4118.15	-	1197	4793	6168	0.7770752
A06	6944669	6944825	A06p11740.2_BraZ1	11.1	-	43	156	156	1.0000000
A06	6944887	6945763	A06p11750.2_BraZ1	534	+	248	815	876	0.9303653
A06	6949071	6956330	A06p11760.2_BraZ1	456	-	596	1980	7259	0.2727648
A06	6950783	6951824	A06p11770.2_BraZ1	104.1	+	6	19	1041	0.0182517
A06	6958756	6959197	A06p11780.2_BraZ1	138	-	1450	441	441	1.0000000
A06	6962403	6963123	A06p11790.2_BraZ1	72	+	725	720	720	1.0000000
A06	6963852	6967420	A06p11800.2_BraZ1	2034.79	-	1013	3106	3568	0.8705157
A06	6969686	6969875	A06p11810.2_BraZ1	18.9	+	8	187	189	0.9894180
A06	6978793	6986300	A06p11820.2_BraZ1	1288.23	-	2915	6678	7507	0.8895698
A06	6987168	6993873	A06p11830.2_BraZ1	936	+	216	1044	6705	0.1557047
A06	7000925	7001612	A06p11840.2_BraZ1	462	-	182	566	687	0.8238719
A06	7003540	7004350	A06p11850.2_BraZ1	81	+	215	738	810	0.9111111
A06	7008114	7010935	A06p11860.2_BraZ1	1578.18	-	485	2420	2821	0.8578518
A06	7012497	7013200	A06p11870.2_BraZ1	4702.5	-	330	703	703	1.0000000
A06	7014066	7014804	A06p11880.2_BraZ1	382.297	-	657	738	738	1.0000000
A06	7015295	7016654	A06p11890.2_BraZ1	135.9	+	339	1344	1359	0.9889625
A06	7018572	7019059	A06p11900.2_BraZ1	43.2	+	304	487	487	1.0000000
A06	7020061	7022924	A06p11910.2_BraZ1	1566.2	-	272	2343	2863	0.8183723
A06	7024169	7025877	A06p11920.2_BraZ1	785.4	+	576	1644	1708	0.9625293
A06	7026098	7027262	A06p11930.2_BraZ1	116.4	-	34	847	1164	0.7276632
A06	7028143	7029696	A06p11940.2_BraZ1	545.7	-	598	1179	1553	0.7591758
A06	7030449	7032731	A06p11950.2_BraZ1	1843	-	642	2000	2282	0.8764242
A06	7036484	7036946	A06p11960.2_BraZ1	46.2	-	233	462	462	1.0000000
A06	7041689	7044122	A06p11970.2_BraZ1	1097.63	+	803	2381	2433	0.9786272
A06	7045159	7045656	A06p11980.2_BraZ1	43.7838	+	402	497	497	1.0000000
A06	7045813	7046314	A06p11990.2_BraZ1	62.7568	+	473	501	501	1.0000000
A06	7050765	7052196	A06p12000.2_BraZ1	1100.77	+	511	1392	1431	0.9727463
A06	7052450	7056098	A06p12010.2_BraZ1	2315.18	-	605	1948	3648	0.5339912
A06	7056510	7057953	A06p12020.2_BraZ1	810.783	-	1033	1443	1443	1.0000000
A06	7058879	7060904	A06p12030.2_BraZ1	1198.8	+	928	2004	2025	0.9896296
A06	7061412	7062144	A06p12040.2_BraZ1	73.2	+	65	631	732	0.8620219
A06	7062467	7065121	A06p12050.2_BraZ1	524.119	-	2123	2599	2654	0.9792765
A06	7066871	7072842	A06p12060.2_BraZ1	3784.05	+	1029	5362	5971	0.8980070
A06	7075418	7080806	A06p12070.2_BraZ1	3784.05	-	813	4416	5388	0.8195991
A06	7083568	7085209	A06p12080.2_BraZ1	658.125	+	871	1641	1641	1.0000000
A06	7085740	7087236	A06p12090.2_BraZ1	442.829	-	1079	1496	1496	1.0000000
A06	7087767	7088244	A06p12100.2_BraZ1	47.7	-	190	477	477	1.0000000
A06	7088849	7093551	A06p12110.2_BraZ1	2841.43	+	1161	4005	4702	0.8517652
A06	7094055	7094604	A06p12120.2_BraZ1	54.9	+	332	549	549	1.0000000
A06	7094991	7095908	A06p12130.2_BraZ1	326.368	-	770	917	917	1.0000000
A06	7096335	7097790	A06p12140.2_BraZ1	145.5	+	1417	1455	1455	1.0000000
A06	7098540	7101813	A06p12150.2_BraZ1	1305.4	+	1883	3273	3273	1.0000000
A06	7103014	7110806	A06p12160.2_BraZ1	4062.67	-	2838	6495	7792	0.8335472
A06	7111430	7114132	A06p12170.2_BraZ1	2301	-	1139	2140	2702	0.7920059
A06	7118150	7120260	A06p12180.2_BraZ1	1421.05	-	1379	2110	2110	1.0000000
A06	7121480	7122709	A06p12190.2_BraZ1	450.263	-	467	1229	1229	1.0000000
A06	7123278	7124419	A06p12200.2_BraZ1	1068	+	500	1075	1141	0.9421560
A06	7124937	7126182	A06p12210.2_BraZ1	352.688	-	1082	1245	1245	1.0000000
A06	7129361	7130180	A06p12220.2_BraZ1	81.9	-	198	648	819	0.7912088
A06	7132409	7133210	A06p12230.2_BraZ1	591	+	104	683	801	0.8526841
A06	7135120	7135549	A06p12240.2_BraZ1	1440	-	8	323	429	0.7529138
A06	7135558	7135983	A06p12250.2_BraZ1	360	-	0	0	425	0.0000000
A06	7136007	7136313	A06p12260.2_BraZ1	30.6	-	52	151	306	0.4934641
A06	7140548	7141621	A06p12270.2_BraZ1	397.073	+	820	1054	1073	0.9822927
A06	7146548	7147428	A06p12280.2_BraZ1	574.219	+	93	673	880	0.7647727
A06	7151238	7153273	A06p12290.2_BraZ1	955.976	-	1008	2022	2035	0.9936118
A06	7153864	7154814	A06p12300.2_BraZ1	660.955	+	273	858	950	0.9031579
A06	7155473	7155893	A06p12310.2_BraZ1	42	-	45	406	420	0.9666666
A06	7160850	7161578	A06p12320.2_BraZ1	258	+	807	728	728	1.0000000
A06	7161762	7161894	A06p12330.2_BraZ1	13.2	-	218	132	132	1.0000000
A06	7163011	7164057	A06p12340.2_BraZ1	978	+	112	962	1046	0.9196941
A06	7164324	7164845	A06p12350.2_BraZ1	303	-	234	521	521	1.0000000
A06	7165206	7166602	A06p12360.2_BraZ1	669.375	-	836	1376	1396	0.9856734
A06	7173270	7174047	A06p12370.2_BraZ1	77.7	+	21	481	777	0.6190476
A06	7174596	7181565	A06p12380.2_BraZ1	3652.87	-	2113	6675	6969	0.9578131
A06	7184757	7189293	A06p12390.2_BraZ1	1901.17	+	1759	4500	4536	0.9920635
A06	7189691	7192118	A06p12400.2_BraZ1	1921.98	-	795	2320	2427	0.9559126
A06	7203411	7205918	A06p12410.2_BraZ1	1788.65	+	817	2467	2507	0.9840447
A06	7210579	7211639	A06p12420.2_BraZ1	1648.5	+	0	0	1060	0.0000000
A06	7211841	7212712	A06p12430.2_BraZ1	228.48	+	110	748	871	0.8587830
A06	7213545	7213680	A06p12440.2_BraZ1	13.5	+	22	108	135	0.8000000
A06	7214273	7215364	A06p12450.2_BraZ1	192.5	+	421	1091	1091	1.0000000
A06	7218426	7218589	A06p12460.2_BraZ1	47	+	44	121	163	0.7423313
A06	7219434	7220275	A06p12470.2_BraZ1	327.68	+	0	0	841	0.0000000
A06	7224830	7227425	A06p12480.2_BraZ1	259.5	+	641	2337	2595	0.9005780
A06	7227693	7233633	A06p12490.2_BraZ1	4227.79	-	1273	5449	5940	0.9173400
A06	7241272	7243835	A06p12500.2_BraZ1	1801.44	+	745	2269	2563	0.8852907
A06	7248720	7248918	A06p12510.2_BraZ1	19.8	+	189	149	198	0.7525253
A06	7251400	7251613	A06p12520.2_BraZ1	21.3	-	1568	213	213	1.0000000
A06	7252573	7253300	A06p12530.2_BraZ1	1288	+	708	727	727	1.0000000
A06	7256594	7256837	A06p12540.2_BraZ1	24.3	+	210	243	243	1.0000000
A06	7258035	7258644	A06p12550.2_BraZ1	60.9	-	304	609	609	1.0000000
A06	7268681	7269256	A06p12560.2_BraZ1	483	+	726	575	575	1.0000000
A06	7294298	7299460	A06p12570.2_BraZ1	2898.14	+	1435	4980	5162	0.9647424
A06	7299962	7303092	A06p12580.2_BraZ1	1624.92	-	2155	3073	3130	0.9817891
A06	7304688	7306912	A06p12590.2_BraZ1	1314	+	1507	2224	2224	1.0000000
A06	7307646	7310586	A06p12600.2_BraZ1	2001.41	-	632	2506	2940	0.8523809
A06	7316206	7317283	A06p12610.2_BraZ1	107.7	-	189	1071	1077	0.9944290
A06	7318831	7320203	A06p12620.2_BraZ1	222	+	680	1200	1372	0.8746356
A06	7329608	7333225	A06p12630.2_BraZ1	1906.23	-	1222	2546	3617	0.7038983
A06	7333675	7336363	A06p12640.2_BraZ1	39.9	+	1301	2324	2688	0.8645833
A06	7333859	7335066	A06p12650.2_BraZ1	240	-	494	889	1207	0.7365369
A06	7336815	7337421	A06p12660.2_BraZ1	267.353	+	132	592	606	0.9768977
A06	7340973	7342529	A06p12670.2_BraZ1	256.034	-	440	1370	1556	0.8804627
A06	7342700	7343259	A06p12680.2_BraZ1	47.4828	-	265	490	559	0.8765653
A06	7345005	7347194	A06p12690.2_BraZ1	1321.53	-	1327	2189	2189	1.0000000
A06	7354997	7355968	A06p12700.2_BraZ1	207	+	1070	971	971	1.0000000
A06	7362915	7364365	A06p12710.2_BraZ1	1080	+	1262	1417	1450	0.9772414
A06	7366708	7367140	A06p12720.2_BraZ1	306	+	138	432	432	1.0000000
A06	7368286	7369594	A06p12730.2_BraZ1	954.688	-	582	1273	1308	0.9732416
A06	7375004	7375295	A06p12740.2_BraZ1	29.1	-	227	291	291	1.0000000
A06	7386203	7390294	A06p12750.2_BraZ1	215.7	-	2047	4091	4091	1.0000000
A06	7389568	7421184	A06p12760.2_BraZ1	458.4	-	10943	20901	31616	0.6610893
A06	7427375	7427690	A06p12770.2_BraZ1	31.5	-	42	315	315	1.0000000
A06	7428623	7430352	A06p12780.2_BraZ1	1237.23	+	359	1636	1729	0.9462117
A06	7430803	7431689	A06p12790.2_BraZ1	15928.5	-	256	886	886	1.0000000
A06	7432108	7434553	A06p12800.2_BraZ1	244.5	-	1794	2444	2445	0.9995910
A06	7435659	7439531	A06p12810.2_BraZ1	1033.26	+	2303	3858	3872	0.9963843
A06	7439962	7440915	A06p12820.2_BraZ1	729	+	347	936	953	0.9821616
A06	7441265	7442495	A06p12830.2_BraZ1	656.812	-	770	1230	1230	1.0000000
A06	7443270	7449598	A06p12840.2_BraZ1	2379.74	+	1827	5421	6328	0.8566688
A06	7450683	7452892	A06p12850.2_BraZ1	625.049	+	1388	2209	2209	1.0000000
A06	7453593	7457495	A06p12860.2_BraZ1	1846.03	+	1571	3881	3902	0.9946181
A06	7458495	7461550	A06p12870.2_BraZ1	883.5	+	1018	2868	3055	0.9387889
A06	7461854	7464558	A06p12880.2_BraZ1	1351.96	-	832	2454	2704	0.9075444
A06	7466066	7469298	A06p12890.2_BraZ1	2064	+	1183	3198	3232	0.9894802
A06	7469914	7471763	A06p12900.2_BraZ1	1332.08	+	408	1754	1849	0.9486209
A06	7471834	7474770	A06p12910.2_BraZ1	2003.4	-	548	2310	2936	0.7867848
A06	7475784	7477376	A06p12920.2_BraZ1	1338	-	341	1490	1592	0.9359297
A06	7478501	7478938	A06p12930.2_BraZ1	357	-	92	415	437	0.9496567
A06	7479476	7481521	A06p12940.2_BraZ1	194.4	-	761	2045	2045	1.0000000
A06	7481596	7483474	A06p12950.2_BraZ1	688.5	+	1336	1867	1878	0.9941427
A06	7486088	7488776	A06p12960.2_BraZ1	955.5	+	2322	2615	2688	0.9728423
A06	7489008	7490887	A06p12970.2_BraZ1	1131.85	-	1064	1734	1879	0.9228313
A06	7492604	7493882	A06p12980.2_BraZ1	884.864	+	803	1278	1278	1.0000000
A06	7494571	7494853	A06p12990.2_BraZ1	28.2	-	385	282	282	1.0000000
A06	7497775	7499483	A06p13000.2_BraZ1	1019.08	-	1107	1708	1708	1.0000000
A06	7501420	7503911	A06p13010.2_BraZ1	1056.34	+	2346	2491	2491	1.0000000
A06	7504898	7506735	A06p13020.2_BraZ1	1468.07	+	913	1837	1837	1.0000000
A06	7507107	7508250	A06p13030.2_BraZ1	639.086	-	432	1107	1143	0.9685040
A06	7509135	7509958	A06p13040.2_BraZ1	558	+	102	750	823	0.9113001
A06	7512884	7516991	A06p13050.2_BraZ1	3208.5	+	1010	3690	4107	0.8984661
A06	7519623	7520158	A06p13060.2_BraZ1	192.625	-	307	533	535	0.9962617
A06	7520324	7521137	A06p13070.2_BraZ1	81.3	+	212	813	813	1.0000000
A06	7521576	7525007	A06p13080.2_BraZ1	1209.48	-	1859	3421	3431	0.9970854
A06	7525119	7528044	A06p13090.2_BraZ1	1170.53	+	678	2594	2925	0.8868376
A06	7529335	7537006	A06p13100.2_BraZ1	1141.14	+	2253	6547	7671	0.8534741
A06	7543332	7544290	A06p13110.2_BraZ1	816	+	94	705	958	0.7359082
A06	7544693	7548775	A06p13120.2_BraZ1	1366.02	-	1446	3929	4082	0.9625184
A06	7549278	7551283	A06p13130.2_BraZ1	1386	+	568	1826	2005	0.9107232
A06	7560146	7561703	A06p13140.2_BraZ1	155.7	+	135	1299	1557	0.8342967
A06	7565565	7567131	A06p13150.2_BraZ1	156.6	+	433	1524	1566	0.9731801
A06	7575921	7577262	A06p13160.2_BraZ1	845.812	+	775	1341	1341	1.0000000
A06	7577409	7580589	A06p13170.2_BraZ1	2234.29	-	1047	2611	3180	0.8210692
A06	7582891	7585078	A06p13180.2_BraZ1	1555.37	+	593	1765	2187	0.8070416
A06	7585805	7587318	A06p13190.2_BraZ1	168	-	1093	1265	1513	0.8360872
A06	7588381	7589229	A06p13200.2_BraZ1	464.423	+	490	824	848	0.9716981
A06	7589565	7591677	A06p13210.2_BraZ1	1518	+	660	2082	2112	0.9857954
A06	7592248	7594797	A06p13220.2_BraZ1	1075.23	-	1451	2418	2549	0.9486073
A06	7595599	7595800	A06p13230.2_BraZ1	144	+	7	148	201	0.7363184
A06	7597313	7597835	A06p13240.2_BraZ1	52.2	+	134	439	522	0.8409961
A06	7597897	7602050	A06p13250.2_BraZ1	351	-	1032	2822	4153	0.6795088
A06	7602455	7602943	A06p13260.2_BraZ1	192	+	465	488	488	1.0000000
A06	7603570	7604766	A06p13270.2_BraZ1	624	-	608	1196	1196	1.0000000
A06	7608410	7608827	A06p13280.2_BraZ1	240	+	661	417	417	1.0000000
A06	7609843	7612687	A06p13290.2_BraZ1	1121.25	-	1850	2844	2844	1.0000000
A06	7615785	7616818	A06p13300.2_BraZ1	831.714	-	454	808	1033	0.7821878
A06	7620279	7620749	A06p13310.2_BraZ1	41.7	-	152	470	470	1.0000000
A06	7627051	7627882	A06p13320.2_BraZ1	738	+	151	566	831	0.6811071
A06	7629363	7629576	A06p13330.2_BraZ1	21.3	-	218	213	213	1.0000000
A06	7630697	7634617	A06p13340.2_BraZ1	2097.38	+	1362	2944	3920	0.7510204
A06	7638580	7639018	A06p13350.2_BraZ1	43.8	-	31	438	438	1.0000000
A06	7642609	7642879	A06p13360.2_BraZ1	27	-	452	270	270	1.0000000
A06	7644611	7646441	A06p13370.2_BraZ1	981.972	+	929	1830	1830	1.0000000
A06	7648511	7650036	A06p13380.2_BraZ1	492	-	1016	1338	1525	0.8773770
A06	7655224	7660666	A06p13390.2_BraZ1	2379.26	+	1915	4969	5442	0.9130834
A06	7661491	7662944	A06p13400.2_BraZ1	774	+	876	1453	1453	1.0000000
A06	7663280	7666232	A06p13410.2_BraZ1	1317.64	-	1684	2952	2952	1.0000000
A06	7670663	7680708	A06p13420.2_BraZ1	2060.17	+	4411	8645	10045	0.8606272
A06	7681090	7683832	A06p13430.2_BraZ1	945.818	-	1731	2699	2742	0.9843180
A06	7684781	7687930	A06p13440.2_BraZ1	2295	+	839	1768	3149	0.5614481
A06	7688879	7691399	A06p13450.2_BraZ1	252	-	751	2312	2520	0.9174603
A06	7694077	7694929	A06p13460.2_BraZ1	585	+	739	852	852	1.0000000
A06	7695483	7698180	A06p13470.2_BraZ1	1415.84	+	1247	2683	2697	0.9948090
A06	7699590	7701220	A06p13480.2_BraZ1	1106.93	+	538	1565	1630	0.9601227
A06	7708217	7718744	A06p13490.2_BraZ1	1632.86	+	1766	9095	10527	0.8639688
A06	7719930	7726712	A06p13500.2_BraZ1	3569.82	+	1011	4819	6782	0.7105573
A06	7728182	7731458	A06p13510.2_BraZ1	1525.49	+	1981	3135	3276	0.9569597
A06	7732192	7733290	A06p13520.2_BraZ1	381	+	320	1054	1098	0.9599271
A06	7734592	7738148	A06p13530.2_BraZ1	2239.24	+	728	3436	3556	0.9662542
A06	7739129	7739585	A06p13540.2_BraZ1	45.6	+	75	371	456	0.8135965
A06	7741575	7742076	A06p13550.2_BraZ1	405	+	368	501	501	1.0000000
A06	7745755	7747585	A06p13560.2_BraZ1	183	+	915	1705	1830	0.9316940
A06	7748030	7748645	A06p13570.2_BraZ1	468	-	297	615	615	1.0000000
A06	7749690	7750231	A06p13580.2_BraZ1	450	-	482	541	541	1.0000000
A06	7755719	7757368	A06p13590.2_BraZ1	1274.78	+	318	1573	1649	0.9539115
A06	7757996	7760149	A06p13600.2_BraZ1	582.983	-	345	1564	2153	0.7264282
A06	7760672	7762493	A06p13610.2_BraZ1	787.076	+	1170	1734	1821	0.9522241
A06	7762910	7764657	A06p13620.2_BraZ1	445.047	-	2245	1747	1747	1.0000000
A06	7765117	7767819	A06p13630.2_BraZ1	1591.25	-	615	2521	2702	0.9330126
A06	7769404	7770735	A06p13640.2_BraZ1	519	-	545	1331	1331	1.0000000
A06	7771203	7771589	A06p13650.2_BraZ1	104	+	11	242	386	0.6269430
A06	7771515	7793811	A06p13660.2_BraZ1	5869.06	+	14300	21805	22296	0.9779781
A06	7795448	7795733	A06p13670.2_BraZ1	28.5	+	98	229	285	0.8035088
A06	7797550	7801347	A06p13680.2_BraZ1	1538.42	-	1501	3746	3797	0.9865683
A06	7802880	7806935	A06p13690.2_BraZ1	2408.25	+	1075	3057	4055	0.7538841
A06	7811405	7815402	A06p13700.2_BraZ1	2300.22	+	1396	3496	3997	0.8746560
A06	7815811	7817924	A06p13710.2_BraZ1	2019	-	398	1854	2113	0.8774254
A06	7819535	7821040	A06p13720.2_BraZ1	785.684	+	1201	1505	1505	1.0000000
A06	7823200	7825372	A06p13730.2_BraZ1	1460.36	+	785	2075	2172	0.9553407
A06	7826065	7828997	A06p13740.2_BraZ1	1834.17	+	486	2059	2932	0.7022510
A06	7833662	7834458	A06p13750.2_BraZ1	571.154	+	0	0	796	0.0000000
A06	7835400	7837383	A06p13760.2_BraZ1	1275	+	930	1978	1983	0.9974785
A06	7839908	7842853	A06p13770.2_BraZ1	1365	-	526	2693	2945	0.9144312
A06	7845005	7845792	A06p13780.2_BraZ1	642	+	552	787	787	1.0000000
A06	7846843	7847212	A06p13790.2_BraZ1	36.9	+	342	369	369	1.0000000
A06	7850353	7851159	A06p13800.2_BraZ1	696	+	22	453	806	0.5620347
A06	7851299	7854991	A06p13810.2_BraZ1	2158.49	-	1018	3528	3692	0.9555796
A06	7857781	7858870	A06p13820.2_BraZ1	546	+	190	567	1089	0.5206612
A06	7859355	7861181	A06p13830.2_BraZ1	960	+	499	1739	1826	0.9523548
A06	7861483	7862720	A06p13840.2_BraZ1	1140	-	315	1237	1237	1.0000000
A06	7866192	7867895	A06p13850.2_BraZ1	878.242	-	880	1509	1703	0.8860834
A06	7868506	7868803	A06p13860.2_BraZ1	29.7	-	214	297	297	1.0000000
A06	7871182	7872927	A06p13870.2_BraZ1	873.091	+	794	1745	1745	1.0000000
A06	7873286	7875065	A06p13880.2_BraZ1	1026.46	-	1132	1491	1779	0.8381113
A06	7876336	7876591	A06p13890.2_BraZ1	25.5	+	179	255	255	1.0000000
A06	7876847	7877177	A06p13900.2_BraZ1	33	+	299	330	330	1.0000000
A06	7880249	7881011	A06p13910.2_BraZ1	1143.53	+	880	762	762	1.0000000
A06	7882240	7883094	A06p13920.2_BraZ1	660	+	138	753	854	0.8817330
A06	7884205	7885047	A06p13930.2_BraZ1	2486.25	+	139	842	842	1.0000000
A06	7886220	7887227	A06p13940.2_BraZ1	615	+	153	848	1007	0.8421053
A06	7888256	7892228	A06p13950.2_BraZ1	2141.66	-	853	3237	3972	0.8149547
A06	7892901	7897561	A06p13960.2_BraZ1	3008.05	+	909	3903	4660	0.8375536
A06	7898365	7898476	A06p13970.2_BraZ1	11.1	+	7	81	111	0.7297297
A06	7898930	7899290	A06p13980.2_BraZ1	282	+	23	211	360	0.5861111
A06	7903254	7907131	A06p13990.2_BraZ1	10080	+	456	3088	3877	0.7964922
A06	7907655	7910059	A06p14000.2_BraZ1	1201.75	-	1582	2404	2404	1.0000000
A06	7910742	7912663	A06p14010.2_BraZ1	602.503	-	522	1585	1921	0.8250911
A06	7914289	7914693	A06p14020.2_BraZ1	315	+	65	297	404	0.7351485
A06	7915926	7918866	A06p14030.2_BraZ1	1543.39	+	731	2729	2940	0.9282313
A06	7919746	7921309	A06p14040.2_BraZ1	483.636	+	509	1557	1563	0.9961612
A06	7923581	7927486	A06p14050.2_BraZ1	2155.14	+	1814	3902	3905	0.9992318
A06	7927856	7928063	A06p14060.2_BraZ1	20.7	+	214	207	207	1.0000000
A06	7928236	7928452	A06p14070.2_BraZ1	21.6	+	275	216	216	1.0000000
A06	7934540	7934940	A06p14080.2_BraZ1	22.8	+	108	383	400	0.9575000
A06	7938008	7939770	A06p14090.2_BraZ1	648	+	684	1500	1762	0.8513053
A06	7942806	7946657	A06p14100.2_BraZ1	2336.04	+	1553	3594	3851	0.9332641
A06	7947104	7948758	A06p14110.2_BraZ1	819.692	-	1749	1654	1654	1.0000000
A06	7949034	7950559	A06p14120.2_BraZ1	84	-	545	1466	1525	0.9613115
A06	7954203	7954362	A06p14130.2_BraZ1	15.9	-	0	0	159	0.0000000
A06	7959167	7960360	A06p14140.2_BraZ1	798.706	-	170	1041	1193	0.8725901
A06	7977555	7977801	A06p14150.2_BraZ1	24.6	-	93	246	246	1.0000000
A06	7979373	7982272	A06p14160.2_BraZ1	1879.79	-	2117	2899	2899	1.0000000
A06	7984407	7984752	A06p14170.2_BraZ1	34.5	+	52	322	345	0.9333333
A06	7985825	7988558	A06p14180.2_BraZ1	6667.4	+	1193	2540	2733	0.9293816
A06	7989360	7991954	A06p14190.2_BraZ1	1061.62	+	1210	2413	2594	0.9302236
A06	7992452	7993889	A06p14200.2_BraZ1	926.571	-	524	1363	1437	0.9485039
A06	7998019	7999120	A06p14210.2_BraZ1	110.1	-	420	1101	1101	1.0000000
A06	8003626	8004085	A06p14220.2_BraZ1	246	+	140	449	459	0.9782135
A06	8004525	8005013	A06p14230.2_BraZ1	375	-	259	488	488	1.0000000
A06	8005661	8009345	A06p14240.2_BraZ1	696.072	-	1150	2879	3684	0.7814875
A06	8009789	8010344	A06p14250.2_BraZ1	55.5	+	404	555	555	1.0000000
A06	8011208	8014151	A06p14260.2_BraZ1	1644.56	-	673	2787	2943	0.9469929
A06	8015289	8017311	A06p14270.2_BraZ1	1524	+	1018	2022	2022	1.0000000
A06	8017981	8018972	A06p14280.2_BraZ1	606	-	578	948	991	0.9566095
A06	8022355	8023991	A06p14290.2_BraZ1	1161	+	1093	1448	1636	0.8850856
A06	8028015	8030036	A06p14300.2_BraZ1	56.4	-	1065	1960	2021	0.9698169
A06	8030163	8030937	A06p14310.2_BraZ1	77.4	+	660	774	774	1.0000000
A06	8033073	8035281	A06p14320.2_BraZ1	220.8	+	1193	2208	2208	1.0000000
A06	8035875	8037446	A06p14330.2_BraZ1	967.136	-	1056	1571	1571	1.0000000
A06	8037897	8040126	A06p14340.2_BraZ1	1039.68	-	2032	2229	2229	1.0000000
A06	8040706	8042685	A06p14350.2_BraZ1	895.125	-	1500	1979	1979	1.0000000
A06	8046136	8052475	A06p14360.2_BraZ1	455	-	6135	6180	6339	0.9749172
A06	8054435	8060131	A06p14370.2_BraZ1	2284.75	+	6208	5633	5696	0.9889396
A06	8063197	8063752	A06p14380.2_BraZ1	55.5	+	871	555	555	1.0000000
A06	8064780	8065945	A06p14390.2_BraZ1	846	-	320	792	1165	0.6798283
A06	8068043	8072014	A06p14400.2_BraZ1	1433.92	-	2737	3971	3971	1.0000000
A06	8073931	8075175	A06p14410.2_BraZ1	456.75	+	0	0	1244	0.0000000
A06	8082078	8087265	A06p14420.2_BraZ1	11750	+	1732	4592	5187	0.8852901
A06	8093925	8097269	A06p14430.2_BraZ1	2130	+	1360	2795	3344	0.8358254
A06	8108562	8110788	A06p14440.2_BraZ1	222.6	+	441	1848	2226	0.8301887
A06	8112140	8113328	A06p14450.2_BraZ1	459	+	819	1188	1188	1.0000000
A06	8118673	8124081	A06p14460.2_BraZ1	2436	+	1572	4422	5408	0.8176775
A06	8125195	8125636	A06p14470.2_BraZ1	35.4	+	1	43	441	0.0975057
A06	8125931	8128879	A06p14480.2_BraZ1	545.417	-	1523	2121	2948	0.7194708
A06	8128907	8129362	A06p14490.2_BraZ1	399	-	0	0	455	0.0000000
A06	8132917	8134265	A06p14500.2_BraZ1	1221	+	0	0	1348	0.0000000
A06	8134152	8139743	A06p14510.2_BraZ1	989.203	+	26	1307	5591	0.2337686
A06	8140601	8146370	A06p14520.2_BraZ1	270.75	+	5948	5442	5769	0.9433177
A06	8146665	8147531	A06p14530.2_BraZ1	568.48	-	4	412	866	0.4757506
A06	8147531	8147986	A06p14540.2_BraZ1	399	-	0	0	455	0.0000000
A06	8151558	8158360	A06p14550.2_BraZ1	2966.67	+	65	1100	6802	0.1617171
A06	8163465	8163986	A06p14560.2_BraZ1	1674	-	4	223	521	0.4280230
A06	8164573	8164911	A06p14570.2_BraZ1	2520	-	135	338	338	1.0000000
A06	8165407	8165836	A06p14580.2_BraZ1	270	+	8	226	429	0.5268065
A06	8166131	8166969	A06p14590.2_BraZ1	545.417	-	2	278	838	0.3317423
A06	8166997	8167452	A06p14600.2_BraZ1	399	-	2	6	455	0.0131868
A06	8171020	8173217	A06p14610.2_BraZ1	276.9	+	5	204	2197	0.0928539
A06	8173391	8177840	A06p14620.2_BraZ1	371.25	+	126	2507	4449	0.5634974
A06	8178699	8179223	A06p14630.2_BraZ1	43.5	+	26	295	524	0.5629771
A06	8180384	8180839	A06p14640.2_BraZ1	399	-	0	0	455	0.0000000
A06	8184396	8186488	A06p14650.2_BraZ1	1221	+	10	307	2092	0.1467495
A06	8186779	8191823	A06p14660.2_BraZ1	273.844	+	403	2283	5044	0.4526170
A06	8192974	8193385	A06p14670.2_BraZ1	32.4	+	227	321	411	0.7810219
A06	8193680	8195349	A06p14680.2_BraZ1	1403.94	-	410	1528	1669	0.9155183
A06	8196257	8197415	A06p14690.2_BraZ1	804	+	1071	1158	1158	1.0000000
A06	8197748	8200833	A06p14700.2_BraZ1	2135.45	-	2243	2943	3085	0.9539708
A06	8201986	8203952	A06p14710.2_BraZ1	933.429	-	1170	1938	1966	0.9857579
A06	8206974	8210047	A06p14720.2_BraZ1	1585.6	+	941	3057	3073	0.9947934
A06	8210561	8212700	A06p14730.2_BraZ1	1102.42	-	1757	2139	2139	1.0000000
A06	8213642	8214221	A06p14740.2_BraZ1	57.9	+	496	579	579	1.0000000
A06	8214298	8216451	A06p14750.2_BraZ1	1604.4	-	1076	2117	2153	0.9832792
A06	8216781	8220180	A06p14760.2_BraZ1	652.8	-	1829	3271	3399	0.9623418
A06	8221251	8224046	A06p14770.2_BraZ1	1853.63	-	1804	2758	2795	0.9867620
A06	8225500	8227285	A06p14780.2_BraZ1	1300.73	-	1067	1755	1785	0.9831933
A06	8239723	8241968	A06p14790.2_BraZ1	1084.02	-	750	2049	2245	0.9126949
A06	8246155	8248546	A06p14800.2_BraZ1	239.1	+	2031	2391	2391	1.0000000
A06	8252757	8255418	A06p14810.2_BraZ1	266.1	+	2748	2661	2661	1.0000000
A06	8258370	8263167	A06p14820.2_BraZ1	1721.25	+	1124	3073	4797	0.6406087
A06	8264551	8266735	A06p14830.2_BraZ1	705.833	+	2136	2184	2184	1.0000000
A06	8269364	8292293	A06p14840.2_BraZ1	3363.81	-	10794	14525	22929	0.6334773
A06	8271584	8273249	A06p14850.2_BraZ1	1016.36	+	15	144	1665	0.0864865
A06	8280040	8282673	A06p14860.2_BraZ1	698.518	-	254	1736	2633	0.6593240
A06	8293278	8297455	A06p14870.2_BraZ1	547.5	-	2033	4177	4177	1.0000000
A06	8298091	8299168	A06p14880.2_BraZ1	753	+	583	1077	1077	1.0000000
A06	8306670	8308130	A06p14890.2_BraZ1	987	+	477	1449	1460	0.9924657
A06	8309306	8311119	A06p14900.2_BraZ1	513.512	-	353	1637	1813	0.9029233
A06	8313246	8316382	A06p14910.2_BraZ1	10083.2	-	2379	3028	3136	0.9655612
A06	8317375	8318397	A06p14920.2_BraZ1	237	-	202	922	1022	0.9021527
A06	8320935	8325548	A06p14930.2_BraZ1	2917.17	+	2147	4392	4613	0.9520919
A06	8325740	8325848	A06p14940.2_BraZ1	10.8	+	221	108	108	1.0000000
A06	8326529	8328290	A06p14950.2_BraZ1	723.344	+	965	1723	1761	0.9784213
A06	8328674	8332233	A06p14960.2_BraZ1	1871.75	-	2264	3517	3559	0.9881989
A06	8333318	8333822	A06p14970.2_BraZ1	50.4	-	93	364	504	0.7222222
A06	8337101	8338045	A06p14980.2_BraZ1	749.429	-	138	860	944	0.9110169
A06	8339275	8341952	A06p14990.2_BraZ1	2240.7	-	734	2435	2677	0.9096003
A06	8342414	8343179	A06p15000.2_BraZ1	75.3	-	199	765	765	1.0000000
A06	8343544	8353313	A06p15010.2_BraZ1	3804.37	-	4954	8899	9769	0.9109428
A06	8353999	8354729	A06p15020.2_BraZ1	543	+	370	730	730	1.0000000
A06	8357255	8357780	A06p15030.2_BraZ1	52.5	+	355	525	525	1.0000000
A06	8359641	8360384	A06p15040.2_BraZ1	633	+	185	743	743	1.0000000
A06	8360985	8363556	A06p15050.2_BraZ1	1338	-	2421	2571	2571	1.0000000
A06	8367683	8367997	A06p15060.2_BraZ1	153	-	502	314	314	1.0000000
A06	8368332	8368635	A06p15070.2_BraZ1	201	-	273	303	303	1.0000000
A06	8372259	8373205	A06p15080.2_BraZ1	222	-	554	946	946	1.0000000
A06	8374657	8375918	A06p15090.2_BraZ1	1009.55	-	1344	1261	1261	1.0000000
A06	8377659	8379688	A06p15100.2_BraZ1	806.011	-	1851	2029	2029	1.0000000
A06	8386801	8390767	A06p15110.2_BraZ1	2782.32	-	2394	3827	3966	0.9649521
A06	8393841	8394192	A06p15120.2_BraZ1	35.1	-	62	330	351	0.9401709
A06	8394492	8395097	A06p15130.2_BraZ1	31.5	+	287	605	605	1.0000000
A06	8400904	8401069	A06p15140.2_BraZ1	16.5	-	199	165	165	1.0000000
A06	8402177	8402726	A06p15150.2_BraZ1	54.9	+	396	549	549	1.0000000
A06	8403633	8417245	A06p15160.2_BraZ1	5400.21	+	3247	6317	13612	0.4640758
A06	8418917	8420418	A06p15170.2_BraZ1	689.44	+	176	1397	1501	0.9307129
A06	8426010	8426279	A06p15180.2_BraZ1	17.1	+	76	199	269	0.7397770
A06	8429374	8435066	A06p15190.2_BraZ1	2354.56	-	1140	3694	5692	0.6489810
A06	8436246	8437066	A06p15200.2_BraZ1	567	-	18	443	820	0.5402439
A06	8437621	8439921	A06p15210.2_BraZ1	6476.67	+	1148	2273	2300	0.9882609
A06	8440221	8446162	A06p15220.2_BraZ1	1492.85	+	2779	5802	5941	0.9766033
A06	8446684	8450141	A06p15230.2_BraZ1	1271.45	-	2430	3200	3457	0.9256581
A06	8451514	8455909	A06p15240.2_BraZ1	1854.67	+	1706	4158	4395	0.9460751
A06	8460616	8461856	A06p15250.2_BraZ1	742.054	+	701	1240	1240	1.0000000
A06	8462435	8465622	A06p15260.2_BraZ1	1824	+	2897	2949	3187	0.9253216
A06	8466059	8466887	A06p15270.2_BraZ1	747	+	81	626	828	0.7560387
A06	8467335	8470706	A06p15280.2_BraZ1	639.265	+	171	908	3371	0.2693563
A06	8468325	8470268	A06p15290.2_BraZ1	169.5	+	1	19	1943	0.0097787
A06	8471093	8471567	A06p15300.2_BraZ1	47.4	+	45	398	474	0.8396624
A06	8471736	8472832	A06p15310.2_BraZ1	688.977	-	229	984	1096	0.8978102
A06	8473524	8476084	A06p15320.2_BraZ1	2009.74	-	682	2379	2560	0.9292969
A06	8477721	8478276	A06p15330.2_BraZ1	237.5	-	180	555	555	1.0000000
A06	8483148	8483462	A06p15340.2_BraZ1	225	+	258	314	314	1.0000000
A06	8506672	8507951	A06p15350.2_BraZ1	957.6	+	831	1279	1279	1.0000000
A06	8511918	8514280	A06p15360.2_BraZ1	32533.5	+	1955	2344	2362	0.9923794
A06	8515007	8516045	A06p15370.2_BraZ1	101.4	+	118	1004	1038	0.9672447
A06	8525456	8527610	A06p15380.2_BraZ1	1725	-	42	1122	2154	0.5208914
A06	8541242	8541571	A06p15390.2_BraZ1	237	+	116	329	329	1.0000000
A06	8542869	8544655	A06p15400.2_BraZ1	918.929	+	1658	1786	1786	1.0000000
A06	8555326	8556187	A06p15410.2_BraZ1	425.375	-	555	861	861	1.0000000
A06	8558370	8558858	A06p15420.2_BraZ1	243	-	0	0	488	0.0000000
A06	8558933	8559422	A06p15430.2_BraZ1	285	-	3	175	489	0.3578732
A06	8561148	8563779	A06p15440.2_BraZ1	1310.36	+	1213	2540	2631	0.9654124
A06	8565384	8565675	A06p15450.2_BraZ1	29.1	-	51	291	291	1.0000000
A06	8565689	8571955	A06p15460.2_BraZ1	1632	-	4491	6219	6266	0.9924992
A06	8573331	8574251	A06p15470.2_BraZ1	443.179	+	385	885	920	0.9619565
A06	8574483	8580297	A06p15480.2_BraZ1	1070.32	-	3220	5384	5814	0.9260406
A06	8582104	8585827	A06p15490.2_BraZ1	1325.95	+	2517	3581	3723	0.9618587
A06	8590525	8592028	A06p15500.2_BraZ1	150.3	+	469	1478	1503	0.9833666
A06	8592481	8592598	A06p15510.2_BraZ1	11.7	+	175	117	117	1.0000000
A06	8593126	8593328	A06p15520.2_BraZ1	102	+	70	141	202	0.6980198
A06	8601053	8601230	A06p15530.2_BraZ1	17.7	-	0	0	177	0.0000000
A06	8611424	8614822	A06p15540.2_BraZ1	737.143	+	1647	3170	3398	0.9329017
A06	8652795	8655485	A06p15550.2_BraZ1	820.08	+	1645	2626	2690	0.9762082
A06	8661203	8662665	A06p15560.2_BraZ1	743.111	+	796	1462	1462	1.0000000
A06	8664161	8665304	A06p15570.2_BraZ1	114.3	+	432	1143	1143	1.0000000
A06	8665626	8665743	A06p15580.2_BraZ1	11.7	-	336	117	117	1.0000000
A06	8666348	8666924	A06p15590.2_BraZ1	54.6	-	45	47	576	0.0815972
A06	8667551	8667785	A06p15600.2_BraZ1	20.7	-	187	234	234	1.0000000
A06	8668135	8670181	A06p15610.2_BraZ1	784	+	135	719	2046	0.3514174
A06	8670555	8671209	A06p15620.2_BraZ1	65.4	-	130	654	654	1.0000000
A06	8672195	8678296	A06p15630.2_BraZ1	250	+	364	1480	6101	0.2425832
A06	8673913	8674592	A06p15640.2_BraZ1	66	-	0	0	679	0.0000000
A06	8678721	8679369	A06p15650.2_BraZ1	64.8	-	0	0	648	0.0000000
A06	8680826	8682164	A06p15660.2_BraZ1	174.654	+	88	823	1338	0.6150972
A06	8681035	8687176	A06p15670.2_BraZ1	186.577	+	92	831	6141	0.1353200
A06	8682797	8683476	A06p15680.2_BraZ1	66	-	0	0	679	0.0000000
A06	8687562	8692657	A06p15690.2_BraZ1	651	-	174	3001	5095	0.5890088
A06	8689205	8690665	A06p15700.2_BraZ1	1404	-	11	860	1460	0.5890411
A06	8693998	8700353	A06p15710.2_BraZ1	419.567	+	101	994	6355	0.1564123
A06	8695113	8695481	A06p15720.2_BraZ1	315	+	7	79	368	0.2146739
A06	8695974	8696653	A06p15730.2_BraZ1	66	-	0	0	679	0.0000000
A06	8702335	8702986	A06p15740.2_BraZ1	65.1	-	8	182	651	0.2795699
A06	8704444	8705983	A06p15750.2_BraZ1	597.5	+	15	441	1539	0.2865497
A06	8706415	8707094	A06p15760.2_BraZ1	66	-	0	0	679	0.0000000
A06	8710551	8710812	A06p15770.2_BraZ1	26.1	+	394	261	261	1.0000000
A06	8711805	8713665	A06p15780.2_BraZ1	436.398	-	1627	1860	1860	1.0000000
A06	8719587	8719854	A06p15790.2_BraZ1	26.7	-	1	11	267	0.0411985
A06	8729194	8729476	A06p15800.2_BraZ1	28.2	-	4	144	282	0.5106383
A06	8730860	8733013	A06p15810.2_BraZ1	1627.2	-	1237	2153	2153	1.0000000
A06	8735008	8736187	A06p15820.2_BraZ1	117.9	-	480	1179	1179	1.0000000
A06	8748415	8750945	A06p15830.2_BraZ1	1110.44	+	897	2482	2530	0.9810277
A06	8753598	8762446	A06p15840.2_BraZ1	2642.05	+	3814	7380	8848	0.8340868
A06	8767324	8769880	A06p15850.2_BraZ1	1455.33	-	652	2343	2556	0.9166667
A06	8772916	8775586	A06p15860.2_BraZ1	2580	+	1038	2666	2670	0.9985019
A06	8775713	8776980	A06p15870.2_BraZ1	294.764	-	956	1267	1267	1.0000000
A06	8776779	8778839	A06p15880.2_BraZ1	275.207	-	1234	2060	2060	1.0000000
A06	8783775	8784134	A06p15890.2_BraZ1	309	-	276	359	359	1.0000000
A06	8784451	8784910	A06p15900.2_BraZ1	45.9	+	51	259	459	0.5642701
A06	8785151	8785799	A06p15910.2_BraZ1	165	+	7590	648	648	1.0000000
A06	8787058	8789335	A06p15920.2_BraZ1	1668	+	598	1761	2277	0.7733861
A06	8791824	8796081	A06p15930.2_BraZ1	1992.16	+	2015	3320	4257	0.7798920
A06	8803717	8804362	A06p15940.2_BraZ1	64.5	-	91	642	645	0.9953488
A06	8804964	8806594	A06p15950.2_BraZ1	1557	-	571	1606	1630	0.9852761
A06	8808120	8809009	A06p15960.2_BraZ1	702	-	896	889	889	1.0000000
A06	8812383	8815626	A06p15970.2_BraZ1	213	-	1614	3081	3243	0.9500462
A06	8816889	8817147	A06p15980.2_BraZ1	25.8	+	112	258	258	1.0000000
A06	8817603	8818768	A06p15990.2_BraZ1	642	-	207	888	1165	0.7622318
A06	8829971	8832380	A06p16000.2_BraZ1	1795.2	+	1269	2226	2409	0.9240349
A06	8835075	8838540	A06p16010.2_BraZ1	2162.02	+	424	3074	3465	0.8871573
A06	8850494	8851778	A06p16020.2_BraZ1	865.368	-	581	1284	1284	1.0000000
A06	8855923	8857217	A06p16030.2_BraZ1	637.5	+	285	1167	1294	0.9018547
A06	8857941	8858926	A06p16040.2_BraZ1	71.7	+	227	942	985	0.9563452
A06	8861934	8862318	A06p16050.2_BraZ1	168	+	110	384	384	1.0000000
A06	8863522	8864392	A06p16060.2_BraZ1	717	-	404	870	870	1.0000000
A06	8867652	8868815	A06p16070.2_BraZ1	478.125	-	2	269	1163	0.2312984
A06	8871344	8872509	A06p16080.2_BraZ1	667.5	-	33	519	1165	0.4454935
A06	8873958	8875201	A06p16090.2_BraZ1	855	-	1005	1243	1243	1.0000000
A06	8877324	8878622	A06p16100.2_BraZ1	819	-	1215	1298	1298	1.0000000
A06	8881136	8881610	A06p16110.2_BraZ1	47.4	-	378	474	474	1.0000000
A06	8882376	8886565	A06p16120.2_BraZ1	2742.01	-	1293	3930	4189	0.9381714
A06	8900809	8906061	A06p16130.2_BraZ1	2952.41	+	313	2456	5252	0.4676314
A06	8906972	8907493	A06p16140.2_BraZ1	324	-	564	521	521	1.0000000
A06	8908193	8910647	A06p16150.2_BraZ1	1536.47	-	212	1904	2454	0.7758761
A06	8921905	8923237	A06p16160.2_BraZ1	153	+	0	0	1332	0.0000000
A06	8923422	8924534	A06p16170.2_BraZ1	302.973	+	0	0	1112	0.0000000
A06	8929085	8932423	A06p16180.2_BraZ1	1417.16	-	1130	3049	3338	0.9134212
A06	8935298	8937576	A06p16190.2_BraZ1	1394.61	+	1206	2253	2278	0.9890255
A06	8946596	8947655	A06p16200.2_BraZ1	105.9	-	138	822	1059	0.7762040
A06	8954228	8954912	A06p16210.2_BraZ1	68.4	-	76	557	684	0.8143275
A06	8959788	8960093	A06p16220.2_BraZ1	138	+	130	305	305	1.0000000
A06	8966203	8967107	A06p16230.2_BraZ1	8151	+	141	795	904	0.8794248
A06	8969423	8970940	A06p16240.2_BraZ1	451.636	-	640	1517	1517	1.0000000
A06	8972493	8973439	A06p16250.2_BraZ1	817.5	+	293	738	946	0.7801269
A06	8980363	8982771	A06p16260.2_BraZ1	974.317	-	928	2408	2408	1.0000000
A06	8984710	8986629	A06p16270.2_BraZ1	1196.53	+	735	1919	1919	1.0000000
A06	8992785	8993810	A06p16280.2_BraZ1	912	+	154	1025	1025	1.0000000
A06	8995343	8996832	A06p16290.2_BraZ1	1272	-	886	1489	1489	1.0000000
A06	8998147	8999962	A06p16300.2_BraZ1	181.5	-	379	986	1815	0.5432507
A06	9008779	9009193	A06p16310.2_BraZ1	234	+	474	414	414	1.0000000
A06	9010631	9015719	A06p16320.2_BraZ1	1466.1	-	4622	5001	5088	0.9829009
A06	9016662	9019750	A06p16330.2_BraZ1	1997.46	-	749	2369	3088	0.7671632
A06	9019858	9020059	A06p16340.2_BraZ1	132	-	243	201	201	1.0000000
A06	9023723	9025238	A06p16350.2_BraZ1	151.5	+	193	906	1515	0.5980198
A06	9031634	9031921	A06p16360.2_BraZ1	18.3	+	331	287	287	1.0000000
A06	9033595	9034724	A06p16370.2_BraZ1	390	-	1674	1129	1129	1.0000000
A06	9044741	9045337	A06p16380.2_BraZ1	55.2	+	1	53	596	0.0889262
A06	9045631	9045856	A06p16390.2_BraZ1	22.5	+	19	93	225	0.4133333
A06	9046070	9046316	A06p16400.2_BraZ1	174	+	143	151	246	0.6138211
A06	9046506	9047338	A06p16410.2_BraZ1	1086.88	+	170	656	832	0.7884616
A06	9068046	9068470	A06p16420.2_BraZ1	186	-	86	424	424	1.0000000
A06	9086577	9087883	A06p16430.2_BraZ1	237	+	195	1101	1306	0.8430322
A06	9093911	9096828	A06p16440.2_BraZ1	1331.07	-	643	2553	2917	0.8752143
A06	9099032	9100106	A06p16450.2_BraZ1	107.4	+	258	1058	1074	0.9851024
A06	9101398	9105669	A06p16460.2_BraZ1	2445	+	1815	3998	4271	0.9360805
A06	9105796	9105955	A06p16470.2_BraZ1	15.9	-	202	159	159	1.0000000
A06	9106101	9108217	A06p16480.2_BraZ1	1256.71	-	890	2092	2116	0.9886578
A06	9109002	9113553	A06p16490.2_BraZ1	543.4	-	3546	3970	4551	0.8723357
A06	9116397	9118823	A06p16500.2_BraZ1	2154	+	743	2235	2426	0.9212696
A06	9120050	9120789	A06p16510.2_BraZ1	325.818	+	64	562	739	0.7604871
A06	9125979	9127206	A06p16520.2_BraZ1	171	-	682	1227	1227	1.0000000
A06	9128670	9130824	A06p16530.2_BraZ1	830.437	+	506	1895	2154	0.8797586
A06	9131045	9131872	A06p16540.2_BraZ1	642	-	470	751	827	0.9081016
A06	9132556	9134197	A06p16550.2_BraZ1	2328	+	615	1641	1641	1.0000000
A06	9135345	9137169	A06p16560.2_BraZ1	1003.68	+	787	1820	1824	0.9978070
A06	9143040	9144036	A06p16570.2_BraZ1	99.6	+	338	944	996	0.9477912
A06	9145236	9147831	A06p16580.2_BraZ1	982.5	-	327	2264	2595	0.8724470
A06	9156503	9162248	A06p16590.2_BraZ1	2288.02	-	1097	5000	5745	0.8703220
A06	9171435	9172764	A06p16600.2_BraZ1	975	-	169	664	1329	0.4996238
A06	9173857	9175446	A06p16610.2_BraZ1	990.823	-	1116	1589	1589	1.0000000
A06	9176067	9177836	A06p16620.2_BraZ1	1225.93	-	1255	1769	1769	1.0000000
A06	9180997	9182781	A06p16630.2_BraZ1	1521.82	+	355	1646	1784	0.9226457
A06	9182996	9189924	A06p16640.2_BraZ1	2830.76	-	1209	5551	6928	0.8012413
A06	9190355	9191201	A06p16650.2_BraZ1	84.6	+	189	734	846	0.8676123
A06	9192794	9194025	A06p16660.2_BraZ1	1411.67	+	420	1231	1231	1.0000000
A06	9198518	9210220	A06p16670.2_BraZ1	2062.2	+	7239	11672	11702	0.9974363
A06	9205051	9206527	A06p16680.2_BraZ1	147.6	-	887	1476	1476	1.0000000
A06	9210220	9211570	A06p16690.2_BraZ1	810	-	890	1350	1350	1.0000000
A06	9213433	9214724	A06p16700.2_BraZ1	18217.5	-	1443	1221	1291	0.9457785
A06	9224884	9226016	A06p16710.2_BraZ1	457.714	+	401	1058	1132	0.9346290
A06	9232287	9232629	A06p16720.2_BraZ1	34.2	+	181	327	342	0.9561403
A06	9239389	9241129	A06p16730.2_BraZ1	414	+	1549	1740	1740	1.0000000
A06	9250153	9250378	A06p16740.2_BraZ1	22.5	+	2	176	225	0.7822222
A06	9253025	9253677	A06p16750.2_BraZ1	240	-	1814	652	652	1.0000000
A06	9257972	9261150	A06p16760.2_BraZ1	2707.74	-	757	2623	3178	0.8253618
A06	9271073	9284804	A06p16770.2_BraZ1	387.189	+	1480	4832	13731	0.3519045
A06	9315088	9315544	A06p16780.2_BraZ1	45.6	-	55	276	456	0.6052632
A06	9317160	9318825	A06p16790.2_BraZ1	743.885	+	732	1665	1665	1.0000000
A06	9320339	9320938	A06p16800.2_BraZ1	486	+	370	599	599	1.0000000
A06	9323119	9323341	A06p16810.2_BraZ1	22.2	+	93	179	222	0.8063063
A06	9323533	9324011	A06p16820.2_BraZ1	375	+	181	478	478	1.0000000
A06	9326728	9328378	A06p16830.2_BraZ1	2304.75	-	612	1644	1650	0.9963636
A06	9355341	9355830	A06p16840.2_BraZ1	48.9	+	473	489	489	1.0000000
A06	9364066	9367721	A06p16850.2_BraZ1	2277.01	+	1327	3561	3655	0.9742818
A06	9368152	9370112	A06p16860.2_BraZ1	1189.74	-	1754	1960	1960	1.0000000
A06	9371744	9374714	A06p16870.2_BraZ1	1714.65	-	868	2970	2970	1.0000000
A06	9377314	9392321	A06p16880.2_BraZ1	1121.55	-	8478	11635	15007	0.7753049
A06	9387831	9388136	A06p16890.2_BraZ1	228	+	0	0	305	0.0000000
A06	9388275	9388928	A06p16900.2_BraZ1	516	+	0	0	653	0.0000000
A06	9389229	9389627	A06p16910.2_BraZ1	388	+	0	0	398	0.0000000
A06	9396276	9399529	A06p16920.2_BraZ1	665.625	-	317	1175	3253	0.3612050
A06	9396503	9397040	A06p16930.2_BraZ1	53.7	+	71	360	537	0.6703911
A06	9411994	9413644	A06p16940.2_BraZ1	165	-	790	1575	1650	0.9545454
A06	9427037	9434304	A06p16950.2_BraZ1	1981.91	-	2848	7102	7267	0.9772946
A06	9441752	9443121	A06p16960.2_BraZ1	847.8	+	312	1354	1369	0.9890431
A06	9445431	9445650	A06p16970.2_BraZ1	21.9	+	5	79	219	0.3607306
A06	9452413	9453841	A06p16980.2_BraZ1	723.45	-	256	1117	1428	0.7822129
A06	9454415	9455791	A06p16990.2_BraZ1	835.7	+	1050	1376	1376	1.0000000
A06	9457107	9459412	A06p17000.2_BraZ1	327	-	1782	2228	2305	0.9665943
A06	9457440	9459404	A06p17010.2_BraZ1	114	-	1620	1887	1964	0.9607943
A06	9459793	9460732	A06p17020.2_BraZ1	755.083	-	248	939	939	1.0000000
A06	9461433	9462627	A06p17030.2_BraZ1	337.5	+	446	1194	1194	1.0000000
A06	9462847	9463432	A06p17040.2_BraZ1	58.5	-	500	585	585	1.0000000
A06	9467879	9478452	A06p17050.2_BraZ1	267	+	2293	7343	10573	0.6945049
A06	9484125	9485436	A06p17060.2_BraZ1	805.35	-	887	1311	1311	1.0000000
A06	9485931	9493548	A06p17070.2_BraZ1	416	+	3203	6133	7617	0.8051726
A06	9494435	9500390	A06p17080.2_BraZ1	2208.13	+	1520	4469	5955	0.7504618
A06	9501693	9502342	A06p17090.2_BraZ1	486	+	321	649	649	1.0000000
A06	9503245	9511286	A06p17100.2_BraZ1	360	-	3411	7638	8041	0.9498819
A06	9511415	9513015	A06p17110.2_BraZ1	809.455	+	729	1600	1600	1.0000000
A06	9514497	9517551	A06p17120.2_BraZ1	2063.23	-	168	1316	3054	0.4309103
A06	9522844	9524274	A06p17130.2_BraZ1	984.545	+	480	1171	1430	0.8188811
A06	9524746	9526808	A06p17140.2_BraZ1	633.333	-	894	2005	2062	0.9723569
A06	9535039	9535600	A06p17150.2_BraZ1	56.1	-	327	561	561	1.0000000
A06	9539849	9542640	A06p17160.2_BraZ1	1206.5	-	180	1987	2791	0.7119312
A06	9544518	9546435	A06p17170.2_BraZ1	916.324	-	1227	1831	1917	0.9551383
A06	9547594	9548802	A06p17180.2_BraZ1	549.88	-	731	1152	1208	0.9536424
A06	9549170	9551453	A06p17190.2_BraZ1	228.3	+	271	1694	2283	0.7420061
A06	9553846	9556849	A06p17200.2_BraZ1	1420.86	+	507	2430	3003	0.8091908
A06	9557873	9559513	A06p17210.2_BraZ1	901.552	-	479	1539	1640	0.9384146
A06	9562375	9563977	A06p17220.2_BraZ1	160.2	+	423	1568	1602	0.9787765
A06	9565868	9566636	A06p17230.2_BraZ1	76.8	+	155	719	768	0.9361979
A06	9570082	9570657	A06p17240.2_BraZ1	410.625	-	0	0	575	0.0000000
A06	9571220	9572291	A06p17250.2_BraZ1	107.1	-	0	0	1071	0.0000000
A06	9609571	9610179	A06p17260.2_BraZ1	318	-	0	0	608	0.0000000
A06	9611664	9612873	A06p17270.2_BraZ1	2387	+	598	1151	1209	0.9520265
A06	9616626	9617693	A06p17280.2_BraZ1	79.2	-	0	0	1067	0.0000000
A06	9624831	9625457	A06p17290.2_BraZ1	609	-	184	572	626	0.9137380
A06	9625811	9626861	A06p17300.2_BraZ1	667.227	-	274	963	1050	0.9171429
A06	9629305	9630955	A06p17310.2_BraZ1	1566	-	330	1323	1650	0.8018182
A06	9651222	9654404	A06p17320.2_BraZ1	1861.5	+	1225	3143	3182	0.9877436
A06	9654988	9665919	A06p17330.2_BraZ1	1703.31	-	8472	10726	10931	0.9812460
A06	9667584	9668414	A06p17340.2_BraZ1	360	-	586	830	830	1.0000000
A06	9674126	9674716	A06p17350.2_BraZ1	273	-	537	590	590	1.0000000
A06	9676721	9678038	A06p17360.2_BraZ1	7344	-	372	1250	1317	0.9491268
A06	9680839	9681162	A06p17370.2_BraZ1	255	-	0	0	323	0.0000000
A06	9685230	9686281	A06p17380.2_BraZ1	321	+	876	1041	1051	0.9904853
A06	9688376	9688982	A06p17390.2_BraZ1	45.6	+	151	333	606	0.5495049
A06	9689041	9691017	A06p17400.2_BraZ1	1639.29	-	871	1916	1976	0.9696356
A06	9691797	9697170	A06p17410.2_BraZ1	2769.25	-	3809	5363	5373	0.9981388
A06	9700202	9702671	A06p17420.2_BraZ1	898.333	+	1830	2411	2469	0.9765087
A06	9703014	9705477	A06p17430.2_BraZ1	1133.74	-	1442	2463	2463	1.0000000
A06	9707112	9708977	A06p17440.2_BraZ1	1174.5	-	1198	1759	1865	0.9431635
A06	9709435	9711337	A06p17450.2_BraZ1	446.775	-	1693	1902	1902	1.0000000
A06	9711653	9715284	A06p17460.2_BraZ1	3612	+	1342	3508	3631	0.9661250
A06	9722466	9723672	A06p17470.2_BraZ1	345.364	+	1197	1206	1206	1.0000000
A06	9724315	9726378	A06p17480.2_BraZ1	472.65	-	1954	2063	2063	1.0000000
A06	9739631	9744396	A06p17490.2_BraZ1	1768.11	+	1262	4366	4765	0.9162644
A06	9754580	9759037	A06p17500.2_BraZ1	255	+	9305	4305	4457	0.9658964
A06	9759960	9760253	A06p17510.2_BraZ1	177	-	926	293	293	1.0000000
A06	9761997	9765257	A06p17520.2_BraZ1	2225.58	+	1946	3260	3260	1.0000000
A06	9765706	9767358	A06p17530.2_BraZ1	633.316	-	944	1647	1652	0.9969734
A06	9770504	9771323	A06p17540.2_BraZ1	1618.8	+	43	598	819	0.7301587
A06	9771431	9772227	A06p17550.2_BraZ1	192	+	0	0	796	0.0000000
A06	9777870	9781258	A06p17560.2_BraZ1	1899.82	-	1593	3388	3388	1.0000000
A06	9790929	9791974	A06p17570.2_BraZ1	414	+	1155	1045	1045	1.0000000
A06	9793433	9794558	A06p17580.2_BraZ1	671.211	+	549	1079	1125	0.9591111
A06	9795321	9802234	A06p17590.2_BraZ1	3555.22	-	2628	6407	6913	0.9268045
A06	9805493	9806057	A06p17600.2_BraZ1	246	-	55	442	564	0.7836879
A06	9806783	9807048	A06p17610.2_BraZ1	210	+	204	265	265	1.0000000
A06	9814201	9815128	A06p17620.2_BraZ1	828	+	240	927	927	1.0000000
A06	9816382	9817324	A06p17630.2_BraZ1	552.794	+	25	436	942	0.4628450
A06	9823018	9823947	A06p17640.2_BraZ1	551.917	+	104	552	929	0.5941873
A06	9828204	9830561	A06p17650.2_BraZ1	273	-	243	1389	2357	0.5893084
A06	9833267	9833847	A06p17660.2_BraZ1	234	-	108	543	580	0.9362069
A06	9836486	9837091	A06p17670.2_BraZ1	246	-	286	605	605	1.0000000
A06	9843588	9848416	A06p17680.2_BraZ1	2731.93	+	1727	4619	4828	0.9567109
A06	9849606	9850080	A06p17690.2_BraZ1	47.4	-	483	474	474	1.0000000
A06	9850459	9853874	A06p17700.2_BraZ1	978.12	+	2132	3273	3415	0.9584187
A06	9856595	9857560	A06p17710.2_BraZ1	622.2	-	8	266	965	0.2756477
A06	9857683	9858015	A06p17720.2_BraZ1	19.2	-	0	0	332	0.0000000
A06	9860258	9860867	A06p17730.2_BraZ1	60.9	+	75	547	609	0.8981938
A06	9872597	9874042	A06p17740.2_BraZ1	1062.2	+	1639	1445	1445	1.0000000
A06	9874274	9877070	A06p17750.2_BraZ1	2227.68	-	471	2048	2796	0.7324750
A06	9881529	9882024	A06p17760.2_BraZ1	333	+	533	462	495	0.9333333
A06	9883645	9886152	A06p17770.2_BraZ1	1302	-	1279	2327	2507	0.9282010
A06	9886152	9886346	A06p17780.2_BraZ1	138	-	51	194	194	1.0000000
A06	9893097	9894009	A06p17790.2_BraZ1	768	-	1255	912	912	1.0000000
A06	9901154	9902977	A06p17800.2_BraZ1	568.257	-	1246	1640	1823	0.8996160
A06	9903263	9905248	A06p17810.2_BraZ1	672.927	-	1693	1951	1985	0.9828715
A06	9913525	9914461	A06p17820.2_BraZ1	93.6	+	236	887	936	0.9476496
A06	9917379	9920746	A06p17830.2_BraZ1	1143.72	-	1194	2974	3367	0.8832789
A06	9925901	9929420	A06p17840.2_BraZ1	351.9	+	258	1154	3519	0.3279341
A06	9931447	9933348	A06p17850.2_BraZ1	1048.63	+	605	1667	1901	0.8769069
A06	9933568	9934952	A06p17860.2_BraZ1	105	-	108	646	1384	0.4667630
A06	9965170	9968957	A06p17870.2_BraZ1	1804.08	-	2391	3787	3787	1.0000000
A06	9970076	9970585	A06p17880.2_BraZ1	222	-	454	509	509	1.0000000
A06	9970165	9970945	A06p17890.2_BraZ1	546	-	633	780	780	1.0000000
A06	9972365	9977155	A06p17900.2_BraZ1	495.37	+	653	2889	4790	0.6031315
A06	9982083	9982308	A06p17910.2_BraZ1	22.5	-	3	144	225	0.6400000
A06	9983123	9983237	A06p17920.2_BraZ1	11.4	-	0	0	114	0.0000000
A06	9983362	9983763	A06p17930.2_BraZ1	261	-	2	51	401	0.1271821
A06	9995995	10000995	A06p17940.2_BraZ1	3856.52	+	983	4056	5000	0.8112000
A06	10015122	10019110	A06p17950.2_BraZ1	2952.67	+	1333	3413	3988	0.8558174
A06	10021010	10022605	A06p17960.2_BraZ1	966	-	650	1479	1595	0.9272727
A06	10034265	10036827	A06p17970.2_BraZ1	193.5	+	289	438	2562	0.1709602
A06	10037027	10037375	A06p17980.2_BraZ1	267	-	28	232	348	0.6666667
A06	10040182	10041248	A06p17990.2_BraZ1	758.71	+	602	989	1066	0.9277673
A06	10052241	10052970	A06p18000.2_BraZ1	72.9	+	210	607	729	0.8326474
A06	10054260	10055864	A06p18010.2_BraZ1	2104	-	121	1210	1604	0.7543641
A06	10071476	10072265	A06p18020.2_BraZ1	78.9	+	231	789	789	1.0000000
A06	10074548	10074812	A06p18030.2_BraZ1	26.4	+	0	0	264	0.0000000
A06	10080854	10084634	A06p18040.2_BraZ1	1393.92	+	2836	3668	3780	0.9703704
A06	10085018	10086393	A06p18050.2_BraZ1	890.217	-	731	1375	1375	1.0000000
A06	10088123	10092030	A06p18060.2_BraZ1	1065.42	-	1860	2758	3907	0.7059125
A06	10096573	10098217	A06p18070.2_BraZ1	599.828	+	390	1573	1644	0.9568127
A06	10098964	10100263	A06p18080.2_BraZ1	1222.61	-	420	1280	1299	0.9853734
A06	10103018	10104343	A06p18090.2_BraZ1	2410.22	-	490	1314	1325	0.9916981
A06	10107075	10107492	A06p18100.2_BraZ1	321	-	95	417	417	1.0000000
A06	10122224	10122509	A06p18110.2_BraZ1	28.5	+	127	285	285	1.0000000
A06	10135320	10135926	A06p18120.2_BraZ1	60.6	+	2	17	606	0.0280528
A06	10140641	10153112	A06p18130.2_BraZ1	96.6667	+	2029	6850	12471	0.5492743
A06	10153447	10154120	A06p18140.2_BraZ1	1837.5	-	497	673	673	1.0000000
A06	10162795	10164001	A06p18150.2_BraZ1	120.6	+	317	1202	1206	0.9966832
A06	10167764	10170520	A06p18160.2_BraZ1	21586.5	+	1543	2724	2756	0.9883890
A06	10171999	10174383	A06p18170.2_BraZ1	18844.5	+	2040	2384	2384	1.0000000
A06	10175097	10177701	A06p18180.2_BraZ1	2247	+	1507	2604	2604	1.0000000
A06	10177925	10178579	A06p18190.2_BraZ1	65.4	-	622	654	654	1.0000000
A06	10179533	10185045	A06p18200.2_BraZ1	726	-	530	1854	5512	0.3363570
A06	10180667	10184292	A06p18210.2_BraZ1	7359.43	-	21	908	3625	0.2504828
A06	10190431	10190765	A06p18220.2_BraZ1	135	-	115	334	334	1.0000000
A06	10197637	10197771	A06p18230.2_BraZ1	114	-	11	106	134	0.7910448
A06	10197876	10199100	A06p18240.2_BraZ1	122.4	-	130	1110	1224	0.9068627
A06	10207111	10207519	A06p18250.2_BraZ1	243	-	381	408	408	1.0000000
A06	10213809	10227235	A06p18260.2_BraZ1	877.625	-	5421	13276	13426	0.9888276
A06	10223201	10224550	A06p18270.2_BraZ1	8460	+	402	1271	1349	0.9421794
A06	10228993	10229324	A06p18280.2_BraZ1	204	+	20	93	331	0.2809668
A06	10229939	10230131	A06p18290.2_BraZ1	19.2	+	21	114	192	0.5937500
A06	10234594	10234861	A06p18300.2_BraZ1	26.7	-	35	164	267	0.6142322
A06	10273236	10273998	A06p18310.2_BraZ1	76.2	+	199	668	762	0.8766404
A06	10274430	10275842	A06p18320.2_BraZ1	709.184	-	1490	1412	1412	1.0000000
A06	10282228	10284195	A06p18330.2_BraZ1	566.316	+	699	1850	1967	0.9405186
A06	10290074	10291281	A06p18340.2_BraZ1	105	+	728	1207	1207	1.0000000
A06	10291593	10295887	A06p18350.2_BraZ1	1452.56	-	3471	4294	4294	1.0000000
A06	10297858	10300665	A06p18360.2_BraZ1	1216.29	+	1138	2793	2807	0.9950125
A06	10303395	10304619	A06p18370.2_BraZ1	1137	+	318	1161	1224	0.9485294
A06	10305439	10307346	A06p18380.2_BraZ1	1081.77	-	917	1808	1907	0.9480860
A06	10310354	10310487	A06p18390.2_BraZ1	12.6	-	2	72	133	0.5413534
A06	10313959	10315711	A06p18400.2_BraZ1	173.4	+	750	1715	1752	0.9788813
A06	10316274	10317559	A06p18410.2_BraZ1	727.527	-	955	1285	1285	1.0000000
A06	10321758	10323952	A06p18420.2_BraZ1	1321.66	-	1094	2194	2194	1.0000000
A06	10328920	10333014	A06p18430.2_BraZ1	1957.5	-	2423	3955	4094	0.9660479
A06	10336193	10336698	A06p18440.2_BraZ1	378	-	360	505	505	1.0000000
A06	10337233	10338202	A06p18450.2_BraZ1	96.9	-	496	891	969	0.9195046
A06	10343775	10344366	A06p18460.2_BraZ1	59.1	-	80	320	591	0.5414551
A06	10345778	10345946	A06p18470.2_BraZ1	16.8	-	265	168	168	1.0000000
A06	10348002	10348276	A06p18480.2_BraZ1	21.9	-	255	274	274	1.0000000
A06	10361702	10361915	A06p18490.2_BraZ1	21.3	-	29	186	213	0.8732395
A06	10371245	10371425	A06p18500.2_BraZ1	18	-	22	163	180	0.9055555
A06	10371697	10371907	A06p18510.2_BraZ1	21	-	240	210	210	1.0000000
A06	10384156	10386405	A06p18520.2_BraZ1	1647	-	792	1994	2249	0.8866163
A06	10389191	10389656	A06p18530.2_BraZ1	46.5	-	152	386	465	0.8301075
A06	10391004	10393698	A06p18540.2_BraZ1	1084.69	+	1043	2232	2694	0.8285078
A06	10394209	10403601	A06p18550.2_BraZ1	2226.99	-	4985	8276	9392	0.8811755
A06	10401580	10404844	A06p18560.2_BraZ1	200.688	-	3056	3264	3264	1.0000000
A06	10405454	10410947	A06p18570.2_BraZ1	2052.73	-	4030	5430	5493	0.9885309
A06	10408346	10410395	A06p18580.2_BraZ1	204.9	-	1874	2025	2049	0.9882870
A06	10412944	10414734	A06p18590.2_BraZ1	927.692	-	2403	1790	1790	1.0000000
A06	10415507	10421461	A06p18600.2_BraZ1	3387.93	+	924	4134	5954	0.6943231
A06	10422265	10426180	A06p18610.2_BraZ1	2745.58	+	925	2923	3915	0.7466156
A06	10426464	10429547	A06p18620.2_BraZ1	2428.59	-	2683	3083	3083	1.0000000
A06	10430005	10430782	A06p18630.2_BraZ1	324.171	+	680	777	777	1.0000000
A06	10437149	10439905	A06p18640.2_BraZ1	960	+	1843	2686	2756	0.9746009
A06	10446952	10449109	A06p18650.2_BraZ1	215.7	+	581	1855	2157	0.8599907
A06	10453214	10455332	A06p18660.2_BraZ1	211.8	+	534	2103	2118	0.9929178
A06	10455638	10458392	A06p18670.2_BraZ1	1003.14	+	1152	2532	2754	0.9193900
A06	10459095	10459704	A06p18680.2_BraZ1	60.9	+	420	609	609	1.0000000
A06	10459962	10463249	A06p18690.2_BraZ1	1829.37	-	1188	3041	3287	0.9251597
A06	10464588	10470105	A06p18700.2_BraZ1	2834.13	+	2825	5037	5517	0.9129962
A06	10470494	10471260	A06p18710.2_BraZ1	669	+	523	766	766	1.0000000
A06	10478773	10484689	A06p18720.2_BraZ1	2575.33	+	1476	4575	5916	0.7733266
A06	10493973	10497054	A06p18730.2_BraZ1	2595.33	+	1414	2867	3081	0.9305421
A06	10497607	10500146	A06p18740.2_BraZ1	1497	+	607	2254	2539	0.8877511
A06	10508965	10510894	A06p18750.2_BraZ1	889.19	+	1428	1929	1929	1.0000000
A06	10511133	10511539	A06p18760.2_BraZ1	324	-	332	406	406	1.0000000
A06	10511862	10513070	A06p18770.2_BraZ1	981	+	740	1208	1208	1.0000000
A06	10515056	10515967	A06p18780.2_BraZ1	843	+	788	911	911	1.0000000
A06	10519194	10520121	A06p18790.2_BraZ1	615	-	97	732	927	0.7896440
A06	10523462	10523759	A06p18800.2_BraZ1	29.7	+	218	297	297	1.0000000
A06	10526647	10528252	A06p18810.2_BraZ1	1188.41	+	986	1605	1605	1.0000000
A06	10528525	10533393	A06p18820.2_BraZ1	228	-	1820	3432	4868	0.7050123
A06	10536244	10536829	A06p18830.2_BraZ1	58.5	-	302	408	585	0.6974359
A06	10538479	10539662	A06p18840.2_BraZ1	1079	-	786	1183	1183	1.0000000
A06	10540620	10542519	A06p18850.2_BraZ1	189.9	+	785	1822	1899	0.9594523
A06	10543445	10546215	A06p18860.2_BraZ1	1280.25	+	489	2293	2770	0.8277978
A06	10547174	10548592	A06p18870.2_BraZ1	2998.37	+	389	1338	1418	0.9435825
A06	10548787	10550953	A06p18880.2_BraZ1	216.6	-	368	1544	2166	0.7128347
A06	10558778	10560440	A06p18890.2_BraZ1	1413	+	498	1362	1662	0.8194946
A06	10562833	10562983	A06p18900.2_BraZ1	15	-	411	150	150	1.0000000
A06	10563289	10563430	A06p18910.2_BraZ1	14.1	+	386	141	141	1.0000000
A06	10565361	10565652	A06p18920.2_BraZ1	29.1	-	373	291	291	1.0000000
A06	10571281	10572501	A06p18930.2_BraZ1	91.5	-	972	1205	1220	0.9877049
A06	10591050	10599142	A06p18940.2_BraZ1	1296.12	-	7623	8092	8092	1.0000000
A06	10599823	10609805	A06p18950.2_BraZ1	1600.8	+	7255	9484	9982	0.9501102
A06	10614000	10617020	A06p18960.2_BraZ1	885.923	-	880	2770	3020	0.9172186
A06	10620615	10636805	A06p18970.2_BraZ1	469.875	-	3887	13578	16190	0.8386658
A06	10640566	10643341	A06p18980.2_BraZ1	397.812	-	120	463	2775	0.1668468
A06	10645655	10647422	A06p18990.2_BraZ1	176.7	+	1505	1767	1767	1.0000000
A06	10653088	10658569	A06p19000.2_BraZ1	3062.24	+	2261	5124	5481	0.9348659
A06	10658954	10659564	A06p19010.2_BraZ1	284.727	-	392	610	610	1.0000000
A06	10659665	10661819	A06p19020.2_BraZ1	256.295	-	2848	2112	2154	0.9805014
A06	10673640	10673934	A06p19030.2_BraZ1	29.4	+	591	294	294	1.0000000
A06	10674947	10676477	A06p19040.2_BraZ1	734.4	-	1977	1530	1530	1.0000000
A06	10682963	10683453	A06p19050.2_BraZ1	3960	-	41	283	490	0.5775510
A06	10685079	10686047	A06p19060.2_BraZ1	528	+	56	478	968	0.4938017
A06	10686704	10687718	A06p19070.2_BraZ1	101.4	-	563	1014	1014	1.0000000
A06	10688347	10688809	A06p19080.2_BraZ1	46.2	+	2	219	462	0.4740260
A06	10689255	10690970	A06p19090.2_BraZ1	183	+	699	1711	1715	0.9976676
A06	10700159	10701972	A06p19100.2_BraZ1	1280.64	+	1142	1813	1813	1.0000000
A06	10703547	10706698	A06p19110.2_BraZ1	1519.97	+	1364	2945	3151	0.9346240
A06	10721010	10722264	A06p19120.2_BraZ1	123.6	+	403	613	1254	0.4888357
A06	10722689	10722866	A06p19130.2_BraZ1	17.7	+	14	150	177	0.8474576
A06	10730312	10731557	A06p19140.2_BraZ1	122.7	+	381	1245	1245	1.0000000
A06	10733490	10733853	A06p19150.2_BraZ1	36.3	+	201	363	363	1.0000000
A06	10741458	10742180	A06p19160.2_BraZ1	426	+	267	722	722	1.0000000
A06	10756346	10758064	A06p19170.2_BraZ1	859.831	-	997	1640	1718	0.9545984
A06	10764563	10766834	A06p19180.2_BraZ1	2906.72	-	770	1610	2271	0.7089388
A06	10770193	10772151	A06p19190.2_BraZ1	854.604	+	1592	1958	1958	1.0000000
A06	10776076	10777733	A06p19200.2_BraZ1	1018.57	+	632	1287	1657	0.7767049
A06	10779685	10780916	A06p19210.2_BraZ1	366	-	215	1074	1231	0.8724614
A06	10782791	10785827	A06p19220.2_BraZ1	1714.95	+	1014	2939	3036	0.9680501
A06	10788246	10788372	A06p19230.2_BraZ1	12.6	+	196	126	126	1.0000000
A06	10795189	10795352	A06p19240.2_BraZ1	15.6	+	217	163	163	1.0000000
A06	10797280	10799035	A06p19250.2_BraZ1	1038	+	598	1686	1755	0.9606838
A06	10799902	10800469	A06p19260.2_BraZ1	56.7	-	9	48	567	0.0846561
A06	10801308	10804065	A06p19270.2_BraZ1	595.458	+	2564	2757	2757	1.0000000
A06	10814835	10815564	A06p19280.2_BraZ1	72.9	-	0	0	729	0.0000000
A06	10822137	10822419	A06p19290.2_BraZ1	28.2	-	62	77	282	0.2730497
A06	10827945	10831115	A06p19300.2_BraZ1	360	+	1974	2869	3170	0.9050473
A06	10828422	10829565	A06p19310.2_BraZ1	114.3	+	89	886	1143	0.7751531
A06	10830288	10830510	A06p19320.2_BraZ1	165	-	408	222	222	1.0000000
A06	10839748	10842360	A06p19330.2_BraZ1	369.794	+	1159	2329	2612	0.8916539
A06	10842867	10844365	A06p19340.2_BraZ1	841.853	-	199	1172	1498	0.7823765
A06	10850087	10854008	A06p19350.2_BraZ1	1344.7	-	1381	3298	3921	0.8411120
A06	10863840	10865656	A06p19360.2_BraZ1	975.84	+	697	1805	1816	0.9939427
A06	10866372	10868163	A06p19370.2_BraZ1	179.1	-	1521	1791	1791	1.0000000
A06	10872624	10876351	A06p19380.2_BraZ1	1766.74	-	658	2808	3727	0.7534210
A06	10883404	10883888	A06p19390.2_BraZ1	387	+	451	484	484	1.0000000
A06	10895786	10895921	A06p19400.2_BraZ1	13.5	-	4	135	135	1.0000000
A06	10896412	10896787	A06p19410.2_BraZ1	195	-	89	375	375	1.0000000
A06	10896903	10897038	A06p19420.2_BraZ1	13.5	+	18	135	135	1.0000000
A06	10912640	10913042	A06p19430.2_BraZ1	40.2	+	411	402	402	1.0000000
A06	10926229	10929760	A06p19440.2_BraZ1	1328.25	+	681	2361	3531	0.6686491
A06	10930011	10932521	A06p19450.2_BraZ1	609.371	-	1600	2455	2510	0.9780877
A06	10933461	10938514	A06p19460.2_BraZ1	2474.47	+	378	3107	5053	0.6148822
A06	10939941	10942842	A06p19470.2_BraZ1	1305.48	+	2158	2901	2901	1.0000000
A06	10944741	10947347	A06p19480.2_BraZ1	1029.5	-	707	2372	2606	0.9102072
A06	10955877	10956012	A06p19490.2_BraZ1	13.5	-	215	135	135	1.0000000
A06	10956285	10956869	A06p19500.2_BraZ1	159	-	416	584	584	1.0000000
A06	10956913	10957408	A06p19510.2_BraZ1	396	-	548	495	495	1.0000000
A06	10958137	10958656	A06p19520.2_BraZ1	51.9	-	396	519	519	1.0000000
A06	10971280	10976212	A06p19530.2_BraZ1	960.857	-	2301	4553	4932	0.9231549
A06	10988809	10989910	A06p19540.2_BraZ1	275	-	857	1101	1101	1.0000000
A06	10991129	10992135	A06p19550.2_BraZ1	302.957	-	1203	1006	1006	1.0000000
A06	10992431	10994147	A06p19560.2_BraZ1	1093.91	+	1082	1622	1716	0.9452214
A06	10994986	10995973	A06p19570.2_BraZ1	98.7	-	159	414	987	0.4194529
A06	11006103	11007090	A06p19580.2_BraZ1	98.7	-	42	450	987	0.4559270
A06	11022053	11022647	A06p19590.2_BraZ1	315	-	230	594	594	1.0000000
A06	11022804	11023122	A06p19600.2_BraZ1	153	-	163	318	318	1.0000000
A06	11027868	11033716	A06p19610.2_BraZ1	948	-	1134	4693	5848	0.8024966
A06	11035178	11037594	A06p19620.2_BraZ1	167.368	+	1857	2259	2416	0.9350166
A06	11039350	11045070	A06p19630.2_BraZ1	2411.69	+	1142	4995	5720	0.8732517
A06	11049108	11051112	A06p19640.2_BraZ1	1319.45	-	1337	1984	2004	0.9900200
A06	11054091	11054980	A06p19650.2_BraZ1	608.262	+	418	889	889	1.0000000
A06	11055414	11055853	A06p19660.2_BraZ1	366	-	292	434	439	0.9886105
A06	11058774	11060882	A06p19670.2_BraZ1	1470.72	+	331	1813	2108	0.8600569
A06	11061609	11061885	A06p19680.2_BraZ1	27.6	-	1226	276	276	1.0000000
A06	11067802	11069513	A06p19690.2_BraZ1	149.7	+	223	1196	1711	0.6990064
A06	11076138	11078740	A06p19700.2_BraZ1	1591.39	-	945	2282	2602	0.8770177
A06	11080979	11081688	A06p19710.2_BraZ1	417	+	48	406	709	0.5726375
A06	11082086	11084463	A06p19720.2_BraZ1	1092.75	-	488	2244	2377	0.9440471
A06	11091498	11095675	A06p19730.2_BraZ1	201	-	540	1737	4177	0.4158487
A06	11101853	11102458	A06p19740.2_BraZ1	213.469	-	0	0	605	0.0000000
A06	11109613	11110528	A06p19750.2_BraZ1	804	+	1178	915	915	1.0000000
A06	11113192	11114495	A06p19760.2_BraZ1	382.337	+	745	1266	1303	0.9716040
A06	11116433	11116622	A06p19770.2_BraZ1	18.9	+	984	189	189	1.0000000
A06	11120315	11121275	A06p19780.2_BraZ1	499.036	+	256	915	960	0.9531250
A06	11121712	11122979	A06p19790.2_BraZ1	738	-	1465	1267	1267	1.0000000
A06	11135378	11135504	A06p19800.2_BraZ1	12.6	+	142	126	126	1.0000000
A06	11137299	11138444	A06p19810.2_BraZ1	7359	-	622	1145	1145	1.0000000
A06	11147848	11148151	A06p19820.2_BraZ1	30.3	-	344	302	303	0.9966997
A06	11151381	11152873	A06p19830.2_BraZ1	74.7	-	894	1400	1492	0.9383378
A06	11154117	11157562	A06p19840.2_BraZ1	2602.53	+	882	2962	3445	0.8597968
A06	11157928	11162083	A06p19850.2_BraZ1	1331.76	-	434	2626	4155	0.6320096
A06	11163571	11164331	A06p19860.2_BraZ1	455	+	183	760	760	1.0000000
A06	11166785	11167457	A06p19870.2_BraZ1	67.2	+	146	500	672	0.7440476
A06	11174862	11180760	A06p19880.2_BraZ1	572.4	+	1411	4732	5898	0.8023059
A06	11180943	11182874	A06p19890.2_BraZ1	1347	-	588	1835	1931	0.9502848
A06	11184396	11184498	A06p19900.2_BraZ1	10.2	+	221	102	102	1.0000000
A06	11188315	11190490	A06p19910.2_BraZ1	837.623	+	2038	2175	2175	1.0000000
A06	11191610	11194690	A06p19920.2_BraZ1	20475	-	1318	2945	3080	0.9561688
A06	11215737	11216163	A06p19930.2_BraZ1	42.6	-	555	426	426	1.0000000
A06	11218048	11218580	A06p19940.2_BraZ1	237	+	360	532	532	1.0000000
A06	11225680	11227712	A06p19950.2_BraZ1	748.2	+	747	1864	2032	0.9173228
A06	11229777	11231790	A06p19960.2_BraZ1	1299	-	727	1647	2013	0.8181818
A06	11244535	11245203	A06p19970.2_BraZ1	642	-	745	668	668	1.0000000
A06	11251053	11251659	A06p19980.2_BraZ1	60.6	+	1288	606	606	1.0000000
A06	11262550	11262778	A06p19990.2_BraZ1	12.9	+	0	0	228	0.0000000
A06	11268618	11270220	A06p20000.2_BraZ1	372.222	+	10	508	1602	0.3171036
A06	11272256	11282202	A06p20010.2_BraZ1	837	-	541	2444	9946	0.2457269
A06	11283682	11288481	A06p20020.2_BraZ1	1641.59	-	2275	3488	4799	0.7268181
A06	11288596	11290845	A06p20030.2_BraZ1	228	-	1067	2249	2249	1.0000000
A06	11292907	11294970	A06p20040.2_BraZ1	1557	+	764	1975	2063	0.9573437
A06	11302286	11302952	A06p20050.2_BraZ1	66.6	+	283	666	666	1.0000000
A06	11303962	11304285	A06p20060.2_BraZ1	210	+	249	323	323	1.0000000
A06	11307033	11307441	A06p20070.2_BraZ1	40.8	+	725	408	408	1.0000000
A06	11308844	11315465	A06p20080.2_BraZ1	1086.93	+	1875	5867	6621	0.8861199
A06	11318839	11319642	A06p20090.2_BraZ1	434.75	+	1155	803	803	1.0000000
A06	11323619	11324347	A06p20100.2_BraZ1	636	+	2	29	728	0.0398352
A06	11341836	11342400	A06p20110.2_BraZ1	3240	-	42	447	564	0.7925532
A06	11350051	11351802	A06p20120.2_BraZ1	1094.16	-	689	1671	1751	0.9543118
A06	11359657	11359858	A06p20130.2_BraZ1	20.1	+	555	201	201	1.0000000
A06	11370943	11372509	A06p20140.2_BraZ1	156.6	+	346	932	1566	0.5951469
A06	11374357	11375651	A06p20150.2_BraZ1	117.6	-	1141	1284	1294	0.9922720
A06	11382335	11382925	A06p20160.2_BraZ1	972	+	815	590	590	1.0000000
A06	11384150	11385446	A06p20170.2_BraZ1	129.6	+	247	1062	1296	0.8194444
A06	11385827	11386335	A06p20180.2_BraZ1	378	-	229	508	508	1.0000000
A06	11389441	11392234	A06p20190.2_BraZ1	1149	-	525	2436	2793	0.8721805
A06	11407619	11407961	A06p20200.2_BraZ1	34.2	+	193	342	342	1.0000000
A06	11408519	11410651	A06p20210.2_BraZ1	1247.77	-	1042	2132	2132	1.0000000
A06	11412343	11412888	A06p20220.2_BraZ1	435	-	521	545	545	1.0000000
A06	11414420	11415709	A06p20230.2_BraZ1	39.9	+	1611	1289	1289	1.0000000
A06	11417525	11422697	A06p20240.2_BraZ1	3709.04	-	942	4244	5172	0.8205723
A06	11423958	11426183	A06p20250.2_BraZ1	1052.52	-	1152	2225	2225	1.0000000
A06	11442940	11444703	A06p20260.2_BraZ1	884.87	+	848	1562	1763	0.8859898
A06	11444865	11446688	A06p20270.2_BraZ1	870.462	-	1784	1807	1823	0.9912233
A06	11450659	11456835	A06p20280.2_BraZ1	1046.04	+	2628	5631	6176	0.9117552
A06	11457188	11460676	A06p20290.2_BraZ1	1717.2	-	873	3139	3488	0.8999426
A06	11477958	11479930	A06p20300.2_BraZ1	961.875	+	187	1200	1972	0.6085193
A06	11483019	11485021	A06p20310.2_BraZ1	1165.26	-	391	1567	2002	0.7827173
A06	11490909	11491986	A06p20320.2_BraZ1	645	-	22	82	1077	0.0761374
A06	11501905	11503573	A06p20330.2_BraZ1	1030.91	-	74	957	1668	0.5737410
A06	11512708	11513074	A06p20340.2_BraZ1	36.6	-	614	366	366	1.0000000
A06	11518388	11519878	A06p20350.2_BraZ1	4293	-	1309	1490	1490	1.0000000
A06	11522299	11524102	A06p20360.2_BraZ1	180.3	+	524	1785	1803	0.9900166
A06	11531887	11532518	A06p20370.2_BraZ1	552	-	122	499	631	0.7908083
A06	11533786	11536348	A06p20380.2_BraZ1	1236.71	+	1347	2425	2562	0.9465262
A06	11538405	11538823	A06p20390.2_BraZ1	288	-	2	157	418	0.3755981
A06	11540160	11540578	A06p20400.2_BraZ1	288	-	4	128	418	0.3062201
A06	11543144	11545075	A06p20410.2_BraZ1	1410.5	+	1629	1931	1931	1.0000000
A06	11545474	11547206	A06p20420.2_BraZ1	600.875	-	1633	1732	1732	1.0000000
A06	11551959	11552335	A06p20430.2_BraZ1	231	+	148	376	376	1.0000000
A06	11554169	11555266	A06p20440.2_BraZ1	819.643	+	395	1097	1097	1.0000000
A06	11567080	11571695	A06p20450.2_BraZ1	2964.74	+	701	3012	4615	0.6526544
A06	11572065	11582885	A06p20460.2_BraZ1	2676	-	6935	9634	10820	0.8903882
A06	11604663	11604879	A06p20470.2_BraZ1	21.6	+	28	121	216	0.5601852
A06	11617676	11618132	A06p20480.2_BraZ1	195	+	244	454	456	0.9956141
A06	11617850	11618109	A06p20490.2_BraZ1	76.5	+	98	259	259	1.0000000
A06	11619036	11621268	A06p20500.2_BraZ1	1196.67	-	1716	2209	2232	0.9896954
A06	11623358	11624062	A06p20510.2_BraZ1	687	-	3	170	704	0.2414773
A06	11637428	11639906	A06p20520.2_BraZ1	1654.71	+	550	2099	2478	0.8470541
A06	11640554	11642369	A06p20530.2_BraZ1	223.929	-	281	1230	1815	0.6776860
A06	11643495	11645529	A06p20540.2_BraZ1	787.5	-	1694	1766	2034	0.8682399
A06	11647964	11649527	A06p20550.2_BraZ1	552	+	105	973	1563	0.6225208
A06	11651396	11653518	A06p20560.2_BraZ1	1763.8	+	330	1498	2122	0.7059378
A06	11656427	11656671	A06p20570.2_BraZ1	174	-	232	244	244	1.0000000
A06	11656745	11657838	A06p20580.2_BraZ1	886.174	-	1110	996	1093	0.9112535
A06	11661454	11662337	A06p20590.2_BraZ1	246	+	889	883	883	1.0000000
A06	11664041	11664569	A06p20600.2_BraZ1	52.8	-	194	528	528	1.0000000
A06	11665088	11668012	A06p20610.2_BraZ1	2121	+	186	1830	2924	0.6258550
A06	11669061	11671837	A06p20620.2_BraZ1	1483.31	+	926	2485	2776	0.8951729
A06	11672583	11674889	A06p20630.2_BraZ1	919.667	+	1250	2306	2306	1.0000000
A06	11687592	11695926	A06p20640.2_BraZ1	771	-	6033	6887	8334	0.8263739
A06	11701728	11702713	A06p20650.2_BraZ1	339	-	1021	914	985	0.9279188
A06	11709412	11712512	A06p20660.2_BraZ1	252	+	29	194	3100	0.0625806
A06	11710568	11710843	A06p20670.2_BraZ1	186	+	2	20	275	0.0727273
A06	11737337	11740092	A06p20680.2_BraZ1	1811.76	+	761	1944	2755	0.7056261
A06	11749688	11755961	A06p20690.2_BraZ1	3897.86	-	115	1585	6273	0.2526702
A06	11767264	11768618	A06p20700.2_BraZ1	2240	+	0	0	1354	0.0000000
A06	11772567	11774242	A06p20710.2_BraZ1	14070	+	763	1431	1675	0.8543283
A06	11775001	11777613	A06p20720.2_BraZ1	180.6	-	1376	2485	2612	0.9513782
A06	11778535	11784796	A06p20730.2_BraZ1	3975.08	+	54	1568	6261	0.2504392
A06	11787439	11788574	A06p20740.2_BraZ1	1041	+	448	1049	1135	0.9242291
A06	11789102	11791631	A06p20750.2_BraZ1	1789.33	-	513	1823	2529	0.7208382
A06	11795111	11796679	A06p20760.2_BraZ1	890	+	1186	1568	1568	1.0000000
A06	11797179	11798176	A06p20770.2_BraZ1	174	+	528	997	997	1.0000000
A06	11800094	11800623	A06p20780.2_BraZ1	294	-	791	529	529	1.0000000
A06	11804516	11806337	A06p20790.2_BraZ1	1174.5	+	30	733	1821	0.4025261
A06	11808171	11809061	A06p20800.2_BraZ1	78	+	1076	890	890	1.0000000
A06	11812710	11812899	A06p20810.2_BraZ1	18.9	-	108	189	189	1.0000000
A06	11815361	11815514	A06p20820.2_BraZ1	15.3	-	25	153	153	1.0000000
A06	11816457	11818068	A06p20830.2_BraZ1	161.1	-	312	1090	1611	0.6765984
A06	11830292	11831273	A06p20840.2_BraZ1	456	-	306	981	981	1.0000000
A06	11834844	11836086	A06p20850.2_BraZ1	566.633	+	971	1182	1242	0.9516908
A06	11838984	11840474	A06p20860.2_BraZ1	185.437	+	62	412	1490	0.2765101
A06	11848506	11854783	A06p20870.2_BraZ1	3356.79	+	1166	4928	6277	0.7850884
A06	11854903	11856692	A06p20880.2_BraZ1	675	-	386	1155	1789	0.6456121
A06	11860582	11864971	A06p20890.2_BraZ1	2717.02	-	1280	4133	4389	0.9416724
A06	11866076	11875348	A06p20900.2_BraZ1	3599.26	-	1244	6878	9272	0.7418033
A06	11892439	11896886	A06p20910.2_BraZ1	2279.46	+	3729	4393	4447	0.9878570
A06	11902165	11902348	A06p20920.2_BraZ1	18.3	+	187	183	183	1.0000000
A06	11907327	11908087	A06p20930.2_BraZ1	282	-	237	760	760	1.0000000
A06	11935770	11938371	A06p20940.2_BraZ1	14202	+	385	2110	2601	0.8112264
A06	11951058	11951340	A06p20950.2_BraZ1	28.2	-	431	282	282	1.0000000
A06	11951892	11953651	A06p20960.2_BraZ1	752.377	-	586	1557	1759	0.8851620
A06	11956679	11956946	A06p20970.2_BraZ1	26.7	-	15	175	267	0.6554307
A06	11960314	11961004	A06p20980.2_BraZ1	68.7	+	579	690	690	1.0000000
A06	11961513	11963563	A06p20990.2_BraZ1	722.595	-	1712	2050	2050	1.0000000
A06	11966768	11967462	A06p21000.2_BraZ1	576	-	1013	694	694	1.0000000
A06	11967828	11968830	A06p21010.2_BraZ1	192	+	4	302	1002	0.3013972
A06	11970141	11970370	A06p21020.2_BraZ1	177	+	451	229	229	1.0000000
A06	11971568	11971772	A06p21030.2_BraZ1	20.4	-	678	204	204	1.0000000
A06	11971881	11972181	A06p21040.2_BraZ1	30	-	369	300	300	1.0000000
A06	11972722	11978783	A06p21050.2_BraZ1	1453.17	+	5464	6061	6061	1.0000000
A06	11985618	11985750	A06p21060.2_BraZ1	12.6	+	411	132	132	1.0000000
A06	11990933	11992757	A06p21070.2_BraZ1	810.71	+	1520	1824	1824	1.0000000
A06	12002462	12003893	A06p21080.2_BraZ1	143.1	-	352	1188	1431	0.8301887
A06	12016820	12018630	A06p21090.2_BraZ1	1123.08	-	428	1557	1810	0.8602210
A06	12029565	12032688	A06p21100.2_BraZ1	312.3	-	1785	2975	3123	0.9526097
A06	12033488	12035075	A06p21110.2_BraZ1	778.03	+	1880	1587	1587	1.0000000
A06	12039727	12041292	A06p21120.2_BraZ1	6248.4	+	1743	1565	1565	1.0000000
A06	12044171	12050696	A06p21130.2_BraZ1	1230.91	+	1802	4241	6525	0.6499617
A06	12058310	12060421	A06p21140.2_BraZ1	12873.9	+	833	1852	2111	0.8773093
A06	12061160	12061385	A06p21150.2_BraZ1	22.5	+	39	149	225	0.6622222
A06	12061718	12065561	A06p21160.2_BraZ1	1514.7	-	608	2574	3843	0.6697893
A06	12067608	12069217	A06p21170.2_BraZ1	841.432	-	1427	1609	1609	1.0000000
A06	12070821	12073902	A06p21180.2_BraZ1	1203	-	725	2620	3081	0.8503733
A06	12074029	12074320	A06p21190.2_BraZ1	246	+	405	283	291	0.9725086
A06	12085218	12085709	A06p21200.2_BraZ1	261	-	26	399	491	0.8126273
A06	12099914	12100106	A06p21210.2_BraZ1	19.2	+	371	192	192	1.0000000
A06	12113470	12115261	A06p21220.2_BraZ1	1290	+	342	1634	1791	0.9123394
A06	12119962	12121492	A06p21230.2_BraZ1	617.957	-	654	1476	1530	0.9647059
A06	12128892	12129444	A06p21240.2_BraZ1	55.2	+	6	71	552	0.1286232
A06	12134322	12135546	A06p21250.2_BraZ1	759	+	137	644	1224	0.5261438
A06	12135977	12142634	A06p21260.2_BraZ1	3188.65	-	1441	5236	6657	0.7865405
A06	12145064	12147943	A06p21270.2_BraZ1	1587.04	+	1343	2517	2879	0.8742619
A06	12148147	12149100	A06p21280.2_BraZ1	759.341	-	192	932	953	0.9779643
A06	12149477	12150415	A06p21290.2_BraZ1	684	-	104	740	938	0.7889126
A06	12164634	12166292	A06p21300.2_BraZ1	1578	+	262	1305	1658	0.7870929
A06	12176415	12176583	A06p21310.2_BraZ1	16.8	-	0	0	168	0.0000000
A06	12178560	12179250	A06p21320.2_BraZ1	69	+	377	690	690	1.0000000
A06	12180386	12182600	A06p21330.2_BraZ1	1673.44	-	718	2119	2214	0.9570912
A06	12184885	12187307	A06p21340.2_BraZ1	1681.31	-	352	2017	2422	0.8327828
A06	12192075	12192684	A06p21350.2_BraZ1	60.9	-	38	350	609	0.5747126
A06	12196566	12197429	A06p21360.2_BraZ1	327	+	392	863	863	1.0000000
A06	12212950	12213338	A06p21370.2_BraZ1	207	-	35	388	388	1.0000000
A06	12219958	12220207	A06p21380.2_BraZ1	24.9	+	16	162	249	0.6506024
A06	12223223	12226204	A06p21390.2_BraZ1	1538.25	+	192	1299	2981	0.4357598
A06	12227449	12227793	A06p21400.2_BraZ1	216	-	27	328	344	0.9534883
A06	12233154	12234708	A06p21410.2_BraZ1	665.5	+	414	1472	1554	0.9472330
A06	12235783	12236924	A06p21420.2_BraZ1	868.087	+	592	1102	1141	0.9658195
A06	12237842	12240992	A06p21430.2_BraZ1	12082.5	+	924	2455	3150	0.7793651
A06	12242155	12245072	A06p21440.2_BraZ1	1130.5	+	1306	2816	2917	0.9653754
A06	12248727	12250296	A06p21450.2_BraZ1	1377	+	1155	1456	1569	0.9279796
A06	12252830	12253178	A06p21460.2_BraZ1	34.8	+	93	298	348	0.8563218
A06	12253729	12257259	A06p21470.2_BraZ1	2184.94	-	1514	3460	3530	0.9801700
A06	12259987	12260320	A06p21480.2_BraZ1	33.3	+	490	333	333	1.0000000
A06	12265037	12288427	A06p21490.2_BraZ1	2527.38	+	17393	21505	23390	0.9194100
A06	12290386	12290572	A06p21500.2_BraZ1	18.6	+	0	0	186	0.0000000
A06	12295097	12301408	A06p21510.2_BraZ1	441.818	-	10007	6297	6311	0.9977816
A06	12299329	12299803	A06p21520.2_BraZ1	315	-	1961	474	474	1.0000000
A06	12307979	12308956	A06p21530.2_BraZ1	408	+	551	977	977	1.0000000
A06	12308555	12308927	A06p21540.2_BraZ1	168	+	259	372	372	1.0000000
A06	12315128	12317548	A06p21550.2_BraZ1	1514.2	+	726	2277	2420	0.9409091
A06	12319165	12321865	A06p21560.2_BraZ1	1635.91	+	623	2000	2700	0.7407407
A06	12325418	12326996	A06p21570.2_BraZ1	157.8	-	677	1346	1578	0.8529785
A06	12340161	12341657	A06p21580.2_BraZ1	430.667	-	41	922	1496	0.6163102
A06	12342168	12343052	A06p21590.2_BraZ1	192.519	+	124	864	884	0.9773756
A06	12343009	12344539	A06p21600.2_BraZ1	396.238	+	225	1423	1530	0.9300653
A06	12344756	12355245	A06p21610.2_BraZ1	1601.08	+	1386	6699	10489	0.6386691
A06	12355626	12356347	A06p21620.2_BraZ1	348	-	671	721	721	1.0000000
A06	12356142	12356376	A06p21630.2_BraZ1	147	-	266	234	234	1.0000000
A06	12359271	12366050	A06p21640.2_BraZ1	3674.08	+	1085	3568	6779	0.5263313
A06	12366396	12367734	A06p21650.2_BraZ1	133.8	-	167	890	1338	0.6651719
A06	12367949	12368567	A06p21660.2_BraZ1	61.8	+	251	602	618	0.9741100
A06	12368962	12370595	A06p21670.2_BraZ1	1464	-	462	1554	1633	0.9516228
A06	12371986	12373956	A06p21680.2_BraZ1	100138	+	351	1677	1970	0.8512690
A06	12377848	12378460	A06p21690.2_BraZ1	46.2	-	425	612	612	1.0000000
A06	12388145	12389219	A06p21700.2_BraZ1	325.714	-	490	1074	1074	1.0000000
A06	12389886	12390200	A06p21710.2_BraZ1	21	+	0	0	314	0.0000000
A06	12394410	12395378	A06p21720.2_BraZ1	810	-	340	946	968	0.9772727
A06	12397302	12400515	A06p21730.2_BraZ1	1918.09	-	221	1925	3213	0.5991285
A06	12424384	12425981	A06p21740.2_BraZ1	702.444	+	1081	1595	1597	0.9987476
A06	12428951	12429097	A06p21750.2_BraZ1	13.5	-	90	146	146	1.0000000
A06	12430954	12431761	A06p21760.2_BraZ1	351	-	803	807	807	1.0000000
A06	12433260	12435054	A06p21770.2_BraZ1	908.447	+	121	1114	1794	0.6209587
A06	12436107	12436521	A06p21780.2_BraZ1	41.4	+	9	251	414	0.6062802
A06	12436905	12437673	A06p21790.2_BraZ1	348	-	437	747	768	0.9726562
A06	12441520	12442856	A06p21800.2_BraZ1	2052.38	-	77	433	1336	0.3241018
A06	12443534	12445008	A06p21810.2_BraZ1	54	-	139	969	1474	0.6573948
A06	12450367	12451842	A06p21820.2_BraZ1	897.231	-	267	924	1475	0.6264407
A06	12452818	12456012	A06p21830.2_BraZ1	24335.5	+	575	2766	3194	0.8659987
A06	12456420	12462139	A06p21840.2_BraZ1	1590.75	+	4791	3483	5719	0.6090226
A06	12467906	12469275	A06p21850.2_BraZ1	1293	+	1022	1369	1369	1.0000000
A06	12480064	12483529	A06p21860.2_BraZ1	1395	+	2101	3166	3465	0.9137085
A06	12486385	12487816	A06p21870.2_BraZ1	3704.4	+	561	1391	1431	0.9720475
A06	12492731	12492976	A06p21880.2_BraZ1	105	+	28	245	245	1.0000000
A06	12493030	12494437	A06p21890.2_BraZ1	4440	+	128	1079	1407	0.7668799
A06	12495887	12496820	A06p21900.2_BraZ1	93.3	-	101	911	933	0.9764202
A06	12497633	12498764	A06p21910.2_BraZ1	310.65	+	216	919	1131	0.8125553
A06	12500611	12501214	A06p21920.2_BraZ1	174	+	38	484	603	0.8026534
A06	12518766	12519876	A06p21930.2_BraZ1	111	+	212	972	1110	0.8756757
A06	12526129	12526387	A06p21940.2_BraZ1	25.8	-	263	258	258	1.0000000
A06	12561065	12562328	A06p21950.2_BraZ1	126.3	+	73	261	1263	0.2066508
A06	12565204	12566320	A06p21960.2_BraZ1	1422	-	385	1043	1116	0.9345878
A06	12567646	12567936	A06p21970.2_BraZ1	261	-	2	59	290	0.2034483
A06	12573178	12574422	A06p21980.2_BraZ1	828	+	22	104	1244	0.0836013
A06	12574685	12576120	A06p21990.2_BraZ1	114156	-	7	280	1435	0.1951219
A06	12601068	12603236	A06p22000.2_BraZ1	2163.45	+	236	1791	2168	0.8261070
A06	12604289	12607703	A06p22010.2_BraZ1	243	+	2842	3414	3414	1.0000000
A06	12609690	12614077	A06p22020.2_BraZ1	1944.35	-	988	3375	4387	0.7693185
A06	12612427	12612808	A06p22030.2_BraZ1	38.1	-	22	251	381	0.6587927
A06	12615776	12616190	A06p22040.2_BraZ1	41.4	+	19	42	414	0.1014493
A06	12617281	12617698	A06p22050.2_BraZ1	41.7	+	163	395	417	0.9472422
A06	12618301	12620803	A06p22060.2_BraZ1	250.2	-	397	1846	2502	0.7378098
A06	12624452	12624725	A06p22070.2_BraZ1	222	-	12	74	273	0.2710623
A06	12649623	12653071	A06p22080.2_BraZ1	1367.76	+	1328	2813	3448	0.8158352
A06	12654533	12658914	A06p22090.2_BraZ1	1220.75	+	1226	3466	4381	0.7911436
A06	12668018	12668243	A06p22100.2_BraZ1	22.5	-	36	225	225	1.0000000
A06	12671744	12672319	A06p22110.2_BraZ1	525	-	563	575	575	1.0000000
A06	12672493	12673254	A06p22120.2_BraZ1	255	-	217	596	761	0.7831800
A06	12675177	12676892	A06p22130.2_BraZ1	484.25	-	321	915	1715	0.5335277
A06	12677895	12678369	A06p22140.2_BraZ1	47.4	+	3	187	474	0.3945148
A06	12678672	12683276	A06p22150.2_BraZ1	2248.17	-	375	2810	4604	0.6103388
A06	12683862	12685359	A06p22160.2_BraZ1	458.714	+	659	1497	1497	1.0000000
A06	12685685	12687404	A06p22170.2_BraZ1	830.638	-	1050	1719	1719	1.0000000
A06	12698210	12698747	A06p22180.2_BraZ1	447	-	586	537	537	1.0000000
A06	12702604	12703153	A06p22190.2_BraZ1	214.5	-	285	549	549	1.0000000
A06	12703466	12704699	A06p22200.2_BraZ1	123.3	-	293	1102	1233	0.8937551
A06	12740895	12742333	A06p22210.2_BraZ1	4725	+	105	925	1438	0.6432545
A06	12744362	12745449	A06p22220.2_BraZ1	534	-	913	1087	1087	1.0000000
A06	12749587	12750011	A06p22230.2_BraZ1	249	+	91	394	424	0.9292453
A06	12757325	12758332	A06p22240.2_BraZ1	875.045	-	26	393	1007	0.3902681
A06	12761821	12762446	A06p22250.2_BraZ1	360	-	469	625	625	1.0000000
A06	12783165	12783744	A06p22260.2_BraZ1	57.9	+	8	163	579	0.2815199
A06	12784940	12786565	A06p22270.2_BraZ1	2201.5	+	26	563	1625	0.3464615
A06	12788924	12791414	A06p22280.2_BraZ1	319.2	-	776	2042	2490	0.8200803
A06	12792907	12793486	A06p22290.2_BraZ1	57.9	+	0	0	579	0.0000000
A06	12803547	12805172	A06p22300.2_BraZ1	289.5	+	13	301	1625	0.1852308
A06	12807221	12807842	A06p22310.2_BraZ1	62.1	+	51	539	621	0.8679549
A06	12808391	12812381	A06p22320.2_BraZ1	957.833	-	2307	3826	3990	0.9588972
A06	12823540	12824808	A06p22330.2_BraZ1	57.3	+	355	1220	1268	0.9621451
A06	12825631	12826066	A06p22340.2_BraZ1	41.4	+	420	435	435	1.0000000
A06	12827383	12827695	A06p22350.2_BraZ1	31.2	-	68	204	312	0.6538461
A06	12839482	12840056	A06p22360.2_BraZ1	228	-	622	574	574	1.0000000
A06	12843074	12844453	A06p22370.2_BraZ1	1109.87	+	397	1178	1379	0.8542422
A06	12844730	12847022	A06p22380.2_BraZ1	1726.05	-	1281	2256	2292	0.9842932
A06	12847406	12848349	A06p22390.2_BraZ1	291	+	245	943	943	1.0000000
A06	12849290	12850749	A06p22400.2_BraZ1	936.923	+	958	1459	1459	1.0000000
A06	12851517	12853097	A06p22410.2_BraZ1	1334.67	-	52	771	1580	0.4879747
A06	12862160	12862675	A06p22420.2_BraZ1	426	-	16	264	515	0.5126213
A06	12862720	12862995	A06p22430.2_BraZ1	129	+	1	13	275	0.0472727
A06	12863039	12864148	A06p22440.2_BraZ1	251.357	+	8	123	1109	0.1109107
A06	12870185	12873428	A06p22450.2_BraZ1	324.3	-	117	1203	3243	0.3709528
A06	12873994	12875501	A06p22460.2_BraZ1	144.3	+	412	770	1507	0.5109489
A06	12880384	12886166	A06p22470.2_BraZ1	2634	+	976	4129	5782	0.7141128
A06	12895717	12896154	A06p22480.2_BraZ1	174	+	377	437	437	1.0000000
A06	12896658	12898095	A06p22490.2_BraZ1	4500	-	8	339	1437	0.2359081
A06	12906826	12909129	A06p22500.2_BraZ1	1328.44	+	977	2303	2303	1.0000000
A06	12913791	12914046	A06p22510.2_BraZ1	25.5	+	411	255	255	1.0000000
A06	12915485	12917600	A06p22520.2_BraZ1	1044.96	-	1262	2045	2115	0.9669031
A06	12918037	12918371	A06p22530.2_BraZ1	297	+	70	180	334	0.5389221
A06	12928453	12940963	A06p22540.2_BraZ1	2565	-	6843	9778	12510	0.7816147
A06	12941697	12943244	A06p22550.2_BraZ1	877.306	-	272	1286	1547	0.8312864
A06	12952661	12957413	A06p22560.2_BraZ1	2135.86	+	1305	3523	4752	0.7413720
A06	12957981	12959827	A06p22570.2_BraZ1	1214.92	-	488	1591	1846	0.8618635
A06	12967625	12968069	A06p22580.2_BraZ1	44.4	-	0	0	444	0.0000000
A06	12968138	12970049	A06p22590.2_BraZ1	248	+	44	871	1911	0.4557823
A06	12972833	12976536	A06p22600.2_BraZ1	768	+	1791	3690	3703	0.9964893
A06	12982590	12984073	A06p22610.2_BraZ1	65.7	+	116	643	1483	0.4335806
A06	12987537	12987792	A06p22620.2_BraZ1	25.5	-	0	0	255	0.0000000
A06	12988474	12988621	A06p22630.2_BraZ1	14.7	+	520	147	147	1.0000000
A06	13001971	13002118	A06p22640.2_BraZ1	14.7	+	181	147	147	1.0000000
A06	13008700	13010943	A06p22650.2_BraZ1	1557.82	+	535	1960	2243	0.8738297
A06	13041935	13044089	A06p22660.2_BraZ1	202.8	+	117	843	2154	0.3913649
A06	13046027	13046258	A06p22670.2_BraZ1	138	+	131	231	231	1.0000000
A06	13046606	13048760	A06p22680.2_BraZ1	215.4	+	362	1582	2154	0.7344475
A06	13049555	13051619	A06p22690.2_BraZ1	206.4	+	2073	2011	2064	0.9743217
A06	13053006	13054506	A06p22700.2_BraZ1	1416	-	396	1115	1500	0.7433333
A06	13055798	13057847	A06p22710.2_BraZ1	204.9	+	25	474	2049	0.2313324
A06	13060241	13060642	A06p22720.2_BraZ1	174	+	417	401	401	1.0000000
A06	13069575	13078506	A06p22730.2_BraZ1	2865.37	+	2314	7134	8931	0.7987908
A06	13080449	13080635	A06p22740.2_BraZ1	18.6	+	182	186	186	1.0000000
A06	13082379	13082657	A06p22750.2_BraZ1	180	-	215	278	278	1.0000000
A06	13083462	13085174	A06p22760.2_BraZ1	448.875	+	175	1539	1712	0.8989486
A06	13099993	13101651	A06p22770.2_BraZ1	1308.52	+	253	1488	1658	0.8974668
A06	13105168	13106040	A06p22780.2_BraZ1	483	+	8	193	872	0.2213303
A06	13110648	13110814	A06p22790.2_BraZ1	144	+	292	166	166	1.0000000
A06	13110814	13111823	A06p22800.2_BraZ1	438	+	1030	1009	1009	1.0000000
A06	13118954	13120775	A06p22810.2_BraZ1	1109.25	+	72	535	1821	0.2937946
A06	13126112	13126619	A06p22820.2_BraZ1	50.7	-	427	497	507	0.9802761
A06	13132265	13132508	A06p22830.2_BraZ1	24.3	-	170	243	243	1.0000000
A06	13147351	13151613	A06p22840.2_BraZ1	2291.69	+	926	3596	4262	0.8437353
A06	13153894	13156027	A06p22850.2_BraZ1	252	+	2660	2133	2133	1.0000000
A06	13158188	13159473	A06p22860.2_BraZ1	396	-	192	1205	1285	0.9377432
A06	13160466	13165892	A06p22870.2_BraZ1	2287.71	+	1126	4187	5426	0.7716550
A06	13179266	13182628	A06p22880.2_BraZ1	1913.92	+	723	2122	3362	0.6311719
A06	13183920	13186940	A06p22890.2_BraZ1	369.6	+	2054	3020	3020	1.0000000
A06	13187731	13187863	A06p22900.2_BraZ1	13.2	+	0	0	132	0.0000000
A06	13189942	13190192	A06p22910.2_BraZ1	168	+	340	250	250	1.0000000
A06	13202072	13205010	A06p22920.2_BraZ1	1839.2	+	1884	2882	2938	0.9809394
A06	13207336	13207636	A06p22930.2_BraZ1	276	+	370	300	300	1.0000000
A06	13253315	13253525	A06p22940.2_BraZ1	21	-	88	210	210	1.0000000
A06	13256411	13258131	A06p22950.2_BraZ1	1617	+	131	324	1720	0.1883721
A06	13259780	13261272	A06p22960.2_BraZ1	3213	+	285	928	1492	0.6219839
A06	13262360	13263360	A06p22970.2_BraZ1	453	+	0	0	1000	0.0000000
A06	13300209	13300617	A06p22980.2_BraZ1	40.8	+	55	362	408	0.8872549
A06	13300890	13303307	A06p22990.2_BraZ1	1530	-	273	1784	2417	0.7381051
A06	13345392	13347289	A06p23000.2_BraZ1	785.24	+	846	1083	1897	0.5709014
A06	13350512	13351350	A06p23010.2_BraZ1	365.714	-	709	838	838	1.0000000
A06	13353770	13355006	A06p23020.2_BraZ1	123.6	-	588	1236	1236	1.0000000
A06	13356092	13356386	A06p23030.2_BraZ1	29.4	+	541	294	294	1.0000000
A06	13363618	13363785	A06p23040.2_BraZ1	138	-	125	167	167	1.0000000
A06	13372508	13372920	A06p23050.2_BraZ1	210	-	689	412	412	1.0000000
A06	13373695	13374230	A06p23060.2_BraZ1	309	-	500	535	535	1.0000000
A06	13377623	13380368	A06p23070.2_BraZ1	2349	-	225	1367	2745	0.4979964
A06	13389638	13390321	A06p23080.2_BraZ1	303	-	2136	683	683	1.0000000
A06	13422986	13425025	A06p23090.2_BraZ1	300	+	1609	1818	2039	0.8916135
A06	13425786	13426444	A06p23100.2_BraZ1	528	-	166	634	658	0.9635258
A06	13429429	13430537	A06p23110.2_BraZ1	475.714	+	538	944	1108	0.8519856
A06	13443859	13446534	A06p23120.2_BraZ1	1097.06	+	1009	2636	2675	0.9854206
A06	13452649	13453729	A06p23130.2_BraZ1	611.625	-	883	1080	1080	1.0000000
A06	13462331	13462580	A06p23140.2_BraZ1	24.9	+	174	249	249	1.0000000
A06	13464456	13464896	A06p23150.2_BraZ1	1089	-	1103	440	440	1.0000000
A06	13466443	13470017	A06p23160.2_BraZ1	1326	+	1150	2616	3574	0.7319530
A06	13481368	13482799	A06p23170.2_BraZ1	237	+	1404	1431	1431	1.0000000
A06	13495775	13496129	A06p23180.2_BraZ1	35.4	-	430	354	354	1.0000000
A06	13498088	13501270	A06p23190.2_BraZ1	1869	+	447	2329	3182	0.7319296
A06	13513818	13514007	A06p23200.2_BraZ1	18.9	-	309	189	189	1.0000000
A06	13514682	13515135	A06p23210.2_BraZ1	36.6	-	650	453	453	1.0000000
A06	13516127	13516784	A06p23220.2_BraZ1	420	-	443	657	657	1.0000000
A06	13518985	13522527	A06p23230.2_BraZ1	1310.21	-	766	2527	3542	0.7134387
A06	13545237	13549538	A06p23240.2_BraZ1	2846.04	-	1216	3738	4301	0.8691002
A06	13559138	13564015	A06p23250.2_BraZ1	367.4	+	3526	4877	4877	1.0000000
A06	13566847	13568996	A06p23260.2_BraZ1	354	-	2160	2149	2149	1.0000000
A06	13571199	13571906	A06p23270.2_BraZ1	225	+	718	707	707	1.0000000
A06	13582416	13584021	A06p23280.2_BraZ1	238.5	+	859	1605	1605	1.0000000
A06	13588398	13589164	A06p23290.2_BraZ1	583	+	1	108	766	0.1409922
A06	13590862	13591221	A06p23300.2_BraZ1	198	+	1	121	359	0.3370474
A06	13593520	13597346	A06p23310.2_BraZ1	918.458	+	1506	3367	3826	0.8800313
A06	13597697	13597997	A06p23320.2_BraZ1	30	-	406	300	300	1.0000000
A06	13619604	13621156	A06p23330.2_BraZ1	980.652	+	513	1071	1552	0.6900773
A06	13631344	13632316	A06p23340.2_BraZ1	450	+	333	804	972	0.8271605
A06	13641898	13642229	A06p23350.2_BraZ1	132	-	100	331	331	1.0000000
A06	13642812	13643859	A06p23360.2_BraZ1	56.7	-	746	1047	1047	1.0000000
A06	13647008	13647188	A06p23370.2_BraZ1	18	+	270	180	180	1.0000000
A06	13651885	13652446	A06p23380.2_BraZ1	56.1	+	108	437	561	0.7789661
A06	13656622	13660140	A06p23390.2_BraZ1	1396.01	+	1751	3333	3518	0.9474133
A06	13667543	13668465	A06p23400.2_BraZ1	89.4	+	850	922	922	1.0000000
A06	13685126	13688423	A06p23410.2_BraZ1	6187.5	+	725	2030	3297	0.6157113
A06	13710787	13717622	A06p23420.2_BraZ1	3116.01	+	1330	5940	6835	0.8690563
A06	13725789	13729422	A06p23430.2_BraZ1	1585.51	+	621	2360	3633	0.6496009
A06	13740224	13741649	A06p23440.2_BraZ1	723	-	1274	1425	1425	1.0000000
A06	13742267	13743911	A06p23450.2_BraZ1	908.213	-	426	1512	1644	0.9197080
A06	13757779	13758224	A06p23460.2_BraZ1	228	-	841	445	445	1.0000000
A06	13765837	13768607	A06p23470.2_BraZ1	498.437	+	1781	2571	2770	0.9281588
A06	13776067	13776472	A06p23480.2_BraZ1	255	+	467	405	405	1.0000000
A06	13776714	13778933	A06p23490.2_BraZ1	462.5	-	1326	2219	2219	1.0000000
A06	13783317	13784724	A06p23500.2_BraZ1	140.7	+	436	695	1407	0.4939588
A06	13788033	13788598	A06p23510.2_BraZ1	216	-	1659	565	565	1.0000000
A06	13794361	13794496	A06p23520.2_BraZ1	13.5	+	0	0	135	0.0000000
A06	13794824	13795640	A06p23530.2_BraZ1	81.6	+	154	698	816	0.8553922
A06	13801089	13802212	A06p23540.2_BraZ1	621	-	72	781	1123	0.6954586
A06	13814355	13818552	A06p23550.2_BraZ1	2380.85	-	465	2967	4197	0.7069335
A06	13828660	13830023	A06p23560.2_BraZ1	978.667	+	255	928	1363	0.6808510
A06	13842126	13843573	A06p23570.2_BraZ1	372	-	621	1447	1447	1.0000000
A06	13844539	13845016	A06p23580.2_BraZ1	47.4	-	36	265	477	0.5555556
A06	13849583	13851710	A06p23590.2_BraZ1	1038.85	+	319	1934	2127	0.9092619
A06	13852353	13853690	A06p23600.2_BraZ1	688.696	-	517	1323	1337	0.9895288
A06	13864542	13865622	A06p23610.2_BraZ1	108	-	576	1080	1080	1.0000000
A06	13888260	13888819	A06p23620.2_BraZ1	385	+	173	545	559	0.9749553
A06	13889238	13894493	A06p23630.2_BraZ1	3174.87	-	1317	4433	5255	0.8435776
A06	13905663	13908250	A06p23640.2_BraZ1	1404	+	1143	2587	2587	1.0000000
A06	13909525	13911649	A06p23650.2_BraZ1	144	-	335	839	2124	0.3950094
A06	13915843	13916769	A06p23660.2_BraZ1	439.273	-	229	915	926	0.9881210
A06	13916958	13918340	A06p23670.2_BraZ1	201	+	255	928	1382	0.6714906
A06	13923734	13924275	A06p23680.2_BraZ1	41.4	+	271	541	541	1.0000000
A06	13924248	13925865	A06p23690.2_BraZ1	91.2	+	853	1617	1617	1.0000000
A06	13926955	13927584	A06p23700.2_BraZ1	345	+	940	598	629	0.9507154
A06	13930367	13931993	A06p23710.2_BraZ1	285.6	-	1261	1618	1626	0.9950799
A06	13933668	13935586	A06p23720.2_BraZ1	1041.85	-	1137	1918	1918	1.0000000
A06	13937273	13939800	A06p23730.2_BraZ1	1408.82	-	144	1807	2527	0.7150772
A06	13963072	13965317	A06p23740.2_BraZ1	528	+	1912	2245	2245	1.0000000
A06	13967880	13968066	A06p23750.2_BraZ1	18.6	+	153	186	186	1.0000000
A06	13968591	13972405	A06p23760.2_BraZ1	234	+	2980	3359	3814	0.8807027
A06	13972427	13973611	A06p23770.2_BraZ1	273	-	35	781	1184	0.6596284
A06	14055203	14056410	A06p23780.2_BraZ1	684	+	481	1013	1207	0.8392709
A06	14057869	14059059	A06p23790.2_BraZ1	261	+	2249	1190	1190	1.0000000
A06	14058135	14058344	A06p23800.2_BraZ1	102	-	653	209	209	1.0000000
A06	14069384	14069600	A06p23810.2_BraZ1	21.6	+	9	216	216	1.0000000
A06	14078924	14083685	A06p23820.2_BraZ1	3587.72	+	495	3013	4761	0.6328502
A06	14084522	14085477	A06p23830.2_BraZ1	297	-	19	417	955	0.4366492
A06	14088742	14089697	A06p23840.2_BraZ1	297	-	0	0	955	0.0000000
A06	14091044	14096347	A06p23850.2_BraZ1	660	+	12	136	5303	0.0256459
A06	14092963	14093918	A06p23860.2_BraZ1	297	-	0	0	955	0.0000000
A06	14096942	14097146	A06p23870.2_BraZ1	13.2	-	356	204	204	1.0000000
A06	14104274	14106465	A06p23880.2_BraZ1	1467.33	-	610	1948	2191	0.8890917
A06	14108240	14108562	A06p23890.2_BraZ1	237	-	3205	322	322	1.0000000
A06	14116945	14117062	A06p23900.2_BraZ1	11.7	+	97	117	117	1.0000000
A06	14127318	14129318	A06p23910.2_BraZ1	971.25	-	62	954	2000	0.4770000
A06	14132157	14133308	A06p23920.2_BraZ1	601.125	+	349	1151	1151	1.0000000
A06	14134591	14134832	A06p23930.2_BraZ1	207	+	188	241	241	1.0000000
A06	14140971	14142312	A06p23940.2_BraZ1	575.625	-	266	1231	1341	0.9179717
A06	14142279	14142750	A06p23950.2_BraZ1	364.875	-	78	471	471	1.0000000
A06	14154274	14155128	A06p23960.2_BraZ1	399	-	148	854	854	1.0000000
A06	14175237	14176167	A06p23970.2_BraZ1	93	-	42	414	930	0.4451613
A06	14237178	14237595	A06p23980.2_BraZ1	41.7	-	0	0	417	0.0000000
A06	14250203	14250773	A06p23990.2_BraZ1	318	+	0	0	570	0.0000000
A06	14251335	14253408	A06p24000.2_BraZ1	1216.23	+	0	0	2073	0.0000000
A06	14254232	14254523	A06p24010.2_BraZ1	29.1	+	0	0	291	0.0000000
A06	14258543	14260252	A06p24020.2_BraZ1	884.571	-	22	139	1709	0.0813341
A06	14263424	14263931	A06p24030.2_BraZ1	50.7	+	418	507	507	1.0000000
A06	14272836	14273067	A06p24040.2_BraZ1	23.1	-	396	231	231	1.0000000
A06	14273975	14275249	A06p24050.2_BraZ1	883.065	+	5347	1274	1274	1.0000000
A06	14276337	14277373	A06p24060.2_BraZ1	843	+	1543	1036	1036	1.0000000
A06	14277881	14278833	A06p24070.2_BraZ1	93.6	-	544	952	952	1.0000000
A06	14279358	14279793	A06p24080.2_BraZ1	9558	+	99	435	435	1.0000000
A06	14280992	14281775	A06p24090.2_BraZ1	645	-	259	783	783	1.0000000
A06	14282533	14284488	A06p24100.2_BraZ1	1436	-	216	1652	1955	0.8450128
A06	14284491	14284748	A06p24110.2_BraZ1	124.312	-	24	162	257	0.6303502
A06	14306022	14309858	A06p24120.2_BraZ1	1581	+	678	2101	3836	0.5477059
A06	14310796	14313055	A06p24130.2_BraZ1	619.643	+	848	2155	2259	0.9539619
A06	14313933	14354791	A06p24140.2_BraZ1	458.857	+	22307	39997	40858	0.9789270
A06	14340041	14343376	A06p24150.2_BraZ1	65	+	3950	3335	3335	1.0000000
A06	14355679	14359743	A06p24160.2_BraZ1	1133.24	+	148	1314	4064	0.3233268
A06	14407743	14408129	A06p24170.2_BraZ1	306	-	3	48	386	0.1243523
A06	14408220	14408442	A06p24180.2_BraZ1	22.2	+	3	192	222	0.8648649
A06	14424348	14424831	A06p24190.2_BraZ1	48.3	-	0	0	483	0.0000000
A06	14449015	14451059	A06p24200.2_BraZ1	1890	-	6	255	2044	0.1247554
A06	14454755	14455878	A06p24210.2_BraZ1	740.054	+	352	988	1123	0.8797863
A06	14458746	14463293	A06p24220.2_BraZ1	2777.74	-	1041	4360	4547	0.9588740
A06	14465414	14465967	A06p24230.2_BraZ1	135	-	470	553	553	1.0000000
A06	14465981	14467277	A06p24240.2_BraZ1	105	-	1991	1296	1296	1.0000000
A06	14467550	14468724	A06p24250.2_BraZ1	201.818	-	472	1089	1174	0.9275979
A06	14484961	14485633	A06p24260.2_BraZ1	492.857	+	83	672	672	1.0000000
A06	14489286	14489795	A06p24270.2_BraZ1	40.5	+	170	509	509	1.0000000
A06	14507845	14511869	A06p24280.2_BraZ1	480	-	4371	4024	4024	1.0000000
A06	14508234	14511996	A06p24290.2_BraZ1	798	-	3369	3762	3762	1.0000000
A06	14511930	14512599	A06p24300.2_BraZ1	60	-	293	669	669	1.0000000
A06	14545703	14547001	A06p24310.2_BraZ1	277.5	-	16	387	1298	0.2981510
A06	14548390	14549911	A06p24320.2_BraZ1	625.5	-	396	1414	1521	0.9296516
A06	14549611	14550580	A06p24330.2_BraZ1	66.6	-	165	894	969	0.9226006
A06	14553042	14557866	A06p24340.2_BraZ1	1983	-	560	3970	4824	0.8229685
A06	14559255	14560969	A06p24350.2_BraZ1	741	-	551	1488	1714	0.8681447
A06	14560960	14561386	A06p24360.2_BraZ1	417	-	287	375	426	0.8802817
A06	14563630	14568039	A06p24370.2_BraZ1	1593	-	195	2720	4409	0.6169199
A06	14568030	14568456	A06p24380.2_BraZ1	417	-	6	166	426	0.3896714
A06	14570704	14575546	A06p24390.2_BraZ1	1998	-	93	2411	4842	0.4979347
A06	14574241	14574616	A06p24400.2_BraZ1	345	-	0	0	375	0.0000000
A06	14577776	14582623	A06p24410.2_BraZ1	2034	-	678	3793	4847	0.7825459
A06	14591887	14596722	A06p24420.2_BraZ1	1853.25	-	2396	4158	4835	0.8599793
A06	14598957	14600259	A06p24430.2_BraZ1	108	-	35	432	1302	0.3317972
A06	14601909	14603834	A06p24440.2_BraZ1	414	-	2	176	1925	0.0914286
A06	14602493	14603509	A06p24450.2_BraZ1	86.4	-	0	0	1016	0.0000000
A06	14606018	14606390	A06p24460.2_BraZ1	282	-	144	372	372	1.0000000
A06	14606390	14610853	A06p24470.2_BraZ1	1542	-	236	3539	4463	0.7929644
A06	14613084	14617924	A06p24480.2_BraZ1	2034	-	138	2818	4840	0.5822314
A06	14620165	14625000	A06p24490.2_BraZ1	1557	-	375	3426	4835	0.7085832
A06	14627228	14628529	A06p24500.2_BraZ1	288	-	153	1301	1301	1.0000000
A06	14629912	14635594	A06p24510.2_BraZ1	7056	-	559	4399	5682	0.7741992
A06	14637830	14638760	A06p24520.2_BraZ1	735	-	75	833	930	0.8956989
A06	14641353	14645561	A06p24530.2_BraZ1	1368	-	276	3015	4208	0.7164924
A06	14644907	14646231	A06p24540.2_BraZ1	789	-	66	720	1324	0.5438067
A06	14648430	14649102	A06p24550.2_BraZ1	48	-	744	672	672	1.0000000
A06	14655323	14659197	A06p24560.2_BraZ1	2370.23	+	599	1392	3874	0.3593185
A06	14660811	14661358	A06p24570.2_BraZ1	357	-	134	547	547	1.0000000
A06	14671137	14671803	A06p24580.2_BraZ1	252	-	1254	666	666	1.0000000
A06	14785297	14785625	A06p24590.2_BraZ1	111	-	1105	328	328	1.0000000
A06	14786120	14786810	A06p24600.2_BraZ1	642	+	451	369	690	0.5347826
A06	14786762	14787644	A06p24610.2_BraZ1	66	+	81	127	882	0.1439909
A06	14801800	14801923	A06p24620.2_BraZ1	12.3	+	7	115	123	0.9349594
A06	14801963	14802095	A06p24630.2_BraZ1	13.2	-	57	132	132	1.0000000
A06	14802199	14802421	A06p24640.2_BraZ1	22.2	+	341	222	222	1.0000000
A06	14803334	14803982	A06p24650.2_BraZ1	64.8	+	15	130	648	0.2006173
A06	14804708	14815479	A06p24660.2_BraZ1	1338	-	12913	5649	10771	0.5244638
A06	14816174	14816579	A06p24670.2_BraZ1	40.5	-	1165	405	405	1.0000000
A06	14817391	14818291	A06p24680.2_BraZ1	498	-	1192	900	900	1.0000000
A06	14819535	14820652	A06p24690.2_BraZ1	48.9	-	1081	1077	1117	0.9641898
A06	14822639	14822859	A06p24700.2_BraZ1	102	-	304	220	220	1.0000000
A06	14823196	14823622	A06p24710.2_BraZ1	42.6	+	1099	426	426	1.0000000
A06	14839376	14842132	A06p24720.2_BraZ1	396	+	3371	2600	2756	0.9433962
A06	14855667	14857741	A06p24730.2_BraZ1	1092.79	-	73	1010	2074	0.4869817
A06	14960621	14961966	A06p24740.2_BraZ1	195.75	+	962	1345	1345	1.0000000
A06	14996628	14999385	A06p24750.2_BraZ1	1361.67	+	60	1158	2757	0.4200218
A06	15073329	15073694	A06p24760.2_BraZ1	32.7	+	137	357	365	0.9780822
A06	15112136	15112496	A06p24770.2_BraZ1	36	-	36	150	360	0.4166667
A06	15130877	15131771	A06p24780.2_BraZ1	627	-	113	645	894	0.7214765
A06	15171191	15171538	A06p24790.2_BraZ1	234	-	388	347	347	1.0000000
A06	15172276	15172875	A06p24800.2_BraZ1	160.8	-	304	599	599	1.0000000
A06	15176538	15180518	A06p24810.2_BraZ1	2952	+	316	2841	3980	0.7138191
A06	15223622	15225148	A06p24820.2_BraZ1	618	+	471	1487	1526	0.9744430
A06	15399520	15401670	A06p24830.2_BraZ1	1838.57	+	42	609	2150	0.2832558
A06	15411807	15414844	A06p24840.2_BraZ1	350	-	1164	3037	3037	1.0000000
A06	15434720	15435934	A06p24850.2_BraZ1	1201.5	-	1631	1214	1214	1.0000000
A06	15484760	15485805	A06p24860.2_BraZ1	339	+	4385	1045	1045	1.0000000
A06	15497887	15500535	A06p24870.2_BraZ1	686.25	-	267	1381	2648	0.5215257
A06	15514871	15517615	A06p24880.2_BraZ1	804.808	+	122	1469	2744	0.5353498
A06	15615512	15616528	A06p24890.2_BraZ1	930	-	40	765	1016	0.7529528
A06	15673752	15674129	A06p24900.2_BraZ1	453.75	-	448	377	377	1.0000000
A06	15684250	15684927	A06p24910.2_BraZ1	300	-	8	167	677	0.2466765
A06	15689726	15695676	A06p24920.2_BraZ1	1125.7	+	3279	5856	5950	0.9842017
A06	15707182	15714410	A06p24930.2_BraZ1	630	-	1920	5190	7228	0.7180409
A06	15743824	15743954	A06p24940.2_BraZ1	12	+	265	130	130	1.0000000
A06	15749495	15783676	A06p24950.2_BraZ1	183	+	15361	25912	34181	0.7580820
A06	15799221	15800533	A06p24960.2_BraZ1	732.6	+	602	1311	1312	0.9992378
A06	15801168	15802753	A06p24970.2_BraZ1	1302	+	606	1585	1585	1.0000000
A06	15803654	15804419	A06p24980.2_BraZ1	3417	+	293	765	765	1.0000000
A06	15805502	15806785	A06p24990.2_BraZ1	433.51	-	329	1278	1283	0.9961029
A06	15806114	15816734	A06p25000.2_BraZ1	603.441	-	1643	8542	10620	0.8043314
A06	15816554	15825640	A06p25010.2_BraZ1	698.231	-	3660	9020	9086	0.9927361
A06	15828432	15828964	A06p25020.2_BraZ1	378	+	453	532	532	1.0000000
A06	15831933	15832173	A06p25030.2_BraZ1	24	+	27	240	240	1.0000000
A06	15924030	15926467	A06p25040.2_BraZ1	1731.6	-	625	1372	2437	0.5629873
A06	15926439	15927545	A06p25050.2_BraZ1	1023	-	571	1077	1106	0.9737794
A06	15931641	15933753	A06p25060.2_BraZ1	1884	+	19	508	2112	0.2405303
A06	15958368	15958569	A06p25070.2_BraZ1	20.1	-	188	201	201	1.0000000
A06	15959931	15960045	A06p25080.2_BraZ1	11.4	-	160	114	114	1.0000000
A06	15961308	15961560	A06p25090.2_BraZ1	25.2	+	16318	252	252	1.0000000
A06	15961569	15961689	A06p25100.2_BraZ1	12	+	4415	120	120	1.0000000
A06	15963220	15964058	A06p25110.2_BraZ1	624	-	242	811	838	0.9677804
A06	15964280	15964973	A06p25120.2_BraZ1	69.3	-	972	670	693	0.9668109
A06	15966071	15966185	A06p25130.2_BraZ1	11.4	-	38	114	114	1.0000000
A06	15966853	15968157	A06p25140.2_BraZ1	471	-	592	1304	1304	1.0000000
A06	15968768	15970092	A06p25150.2_BraZ1	678	-	3588	1324	1324	1.0000000
A06	15972093	15973117	A06p25160.2_BraZ1	825	+	149	702	1024	0.6855469
A06	15975247	15975925	A06p25170.2_BraZ1	67.8	+	289	495	678	0.7300885
A06	15983472	15983631	A06p25180.2_BraZ1	15.9	+	66	159	159	1.0000000
A06	15984983	15985109	A06p25190.2_BraZ1	12.6	-	0	0	126	0.0000000
A06	15986425	15987770	A06p25200.2_BraZ1	513	+	16	553	1345	0.4111524
A06	15987781	15987967	A06p25210.2_BraZ1	18.6	+	1	87	186	0.4677419
A06	15991313	15991439	A06p25220.2_BraZ1	12.6	-	0	0	126	0.0000000
A06	15992753	16005450	A06p25230.2_BraZ1	170.333	+	6286	9253	12697	0.7287548
A06	16002791	16004805	A06p25240.2_BraZ1	49.8	+	1607	1795	2014	0.8912612
A06	16005515	16005629	A06p25250.2_BraZ1	11.4	-	15	67	114	0.5877193
A06	16006384	16006571	A06p25260.2_BraZ1	17.4	-	73	187	187	1.0000000
A06	16007488	16009091	A06p25270.2_BraZ1	903	-	9603	1603	1603	1.0000000
A06	16026487	16026987	A06p25280.2_BraZ1	297	+	10	415	500	0.8300000
A06	16045979	16047341	A06p25290.2_BraZ1	564.2	-	138	725	1362	0.5323054
A06	16049734	16050362	A06p25300.2_BraZ1	387	-	619	628	628	1.0000000
A06	16050814	16051083	A06p25310.2_BraZ1	150	+	26	232	269	0.8624535
A06	16051790	16052385	A06p25320.2_BraZ1	28.5	-	35	200	595	0.3361345
A06	16053264	16053507	A06p25330.2_BraZ1	132	+	61	243	243	1.0000000
A06	16058873	16065379	A06p25340.2_BraZ1	375	-	744	3599	6506	0.5531817
A06	16062259	16063198	A06p25350.2_BraZ1	573.333	-	57	263	939	0.2800852
A06	16078538	16078866	A06p25360.2_BraZ1	228	+	395	328	328	1.0000000
A06	16124235	16127338	A06p25370.2_BraZ1	919.6	+	7103	3087	3103	0.9948437
A06	16131559	16132425	A06p25380.2_BraZ1	36.9	-	1471	866	866	1.0000000
A06	16133308	16133626	A06p25390.2_BraZ1	279	+	270	318	318	1.0000000
A06	16133997	16134213	A06p25400.2_BraZ1	19.5	+	249	216	216	1.0000000
A06	16134686	16136607	A06p25410.2_BraZ1	783	-	4308	1921	1921	1.0000000
A06	16155052	16166144	A06p25420.2_BraZ1	450	+	1622	7041	11092	0.6347818
A06	16169241	16170812	A06p25430.2_BraZ1	79.5	+	168	1454	1571	0.9255251
A06	16202109	16202226	A06p25440.2_BraZ1	11.7	+	0	0	117	0.0000000
A06	16207756	16207873	A06p25450.2_BraZ1	11.7	+	1	70	117	0.5982906
A06	16217607	16217766	A06p25460.2_BraZ1	15.9	+	89	159	159	1.0000000
A06	16225064	16225397	A06p25470.2_BraZ1	33.3	+	138	329	333	0.9879880
A06	16225427	16228114	A06p25480.2_BraZ1	4116	+	1040	2037	2687	0.7580945
A06	18078528	18078900	A06p25490.2_BraZ1	37.2	+	15	369	372	0.9919355
A06	18382448	18382820	A06p25500.2_BraZ1	37.2	+	12	193	372	0.5188172
A06	18391939	18392311	A06p25510.2_BraZ1	37.2	-	0	0	372	0.0000000
A06	18479349	18479721	A06p25520.2_BraZ1	37.2	-	7	256	372	0.6881720
A06	18491148	18501886	A06p25530.2_BraZ1	2127	-	68	990	10738	0.0921959
A06	18503953	18504238	A06p25540.2_BraZ1	28.5	-	0	0	285	0.0000000
A06	18622961	18623753	A06p25550.2_BraZ1	264	-	4	279	792	0.3522727
A06	18624733	18624945	A06p25560.2_BraZ1	18.6	-	0	0	212	0.0000000
A06	18692261	18709631	A06p25570.2_BraZ1	4521	-	26	1093	17370	0.0629246
A06	18710294	18711332	A06p25580.2_BraZ1	103.8	-	0	0	1038	0.0000000
A06	18781634	18782006	A06p25590.2_BraZ1	37.2	-	22	370	372	0.9946237
A06	18805758	18806130	A06p25600.2_BraZ1	37.2	-	0	0	372	0.0000000
A06	18811993	18822731	A06p25610.2_BraZ1	4488	-	8	278	10738	0.0258894
A06	18916918	18919360	A06p25620.2_BraZ1	239.4	-	168	1066	2442	0.4365274
A06	18920019	18920943	A06p25630.2_BraZ1	39	-	0	0	924	0.0000000
A06	18959485	18959697	A06p25640.2_BraZ1	18.6	-	3	111	212	0.5235849
A06	18960942	18961187	A06p25650.2_BraZ1	15.3	+	0	0	245	0.0000000
A06	18962622	18963414	A06p25660.2_BraZ1	264	-	64	312	792	0.3939394
A06	18964394	18964606	A06p25670.2_BraZ1	18.6	-	0	0	212	0.0000000
A06	19034514	19045252	A06p25680.2_BraZ1	4488	-	0	0	10738	0.0000000
A06	19120158	19120530	A06p25690.2_BraZ1	37.2	-	2	204	372	0.5483871
A06	19205054	19205306	A06p25700.2_BraZ1	25.2	-	2	183	252	0.7261904
A06	19228549	19228801	A06p25710.2_BraZ1	25.2	-	0	0	252	0.0000000
A06	19231402	19231774	A06p25720.2_BraZ1	37.2	+	0	0	372	0.0000000
A06	19326676	19328395	A06p25730.2_BraZ1	171.9	-	199	1121	1719	0.6521233
A06	19354805	19358537	A06p25740.2_BraZ1	3633	-	97	1424	3732	0.3815649
A06	19450062	19450200	A06p25750.2_BraZ1	13.8	-	284	138	138	1.0000000
A06	19450620	19450815	A06p25760.2_BraZ1	19.5	+	199	195	195	1.0000000
A06	19481258	19481630	A06p25770.2_BraZ1	37.2	+	0	0	372	0.0000000
A06	19737779	19738151	A06p25780.2_BraZ1	37.2	-	2	11	372	0.0295699
A06	20060097	20060616	A06p25790.2_BraZ1	411	-	0	0	519	0.0000000
A06	20061325	20062592	A06p25800.2_BraZ1	1113	-	0	0	1267	0.0000000
A06	20097996	20100324	A06p25810.2_BraZ1	516	-	17	748	2328	0.3213058
A06	20101531	20107501	A06p25820.2_BraZ1	240	-	50	1331	5970	0.2229481
A06	20103108	20104107	A06p25830.2_BraZ1	267	-	10	309	999	0.3093093
A06	20103145	20104329	A06p25840.2_BraZ1	270	+	24	498	1184	0.4206081
A06	20103301	20105575	A06p25850.2_BraZ1	252	+	40	858	2274	0.3773087
A06	20103534	20108452	A06p25860.2_BraZ1	282	-	48	1242	4918	0.2525417
A06	20103621	20107142	A06p25870.2_BraZ1	704	-	48	1242	3521	0.3527407
A06	20110559	20111154	A06p25880.2_BraZ1	107.5	+	0	0	595	0.0000000
A06	20110713	20111867	A06p25890.2_BraZ1	273	+	1	22	1154	0.0190641
A06	20112585	20112900	A06p25900.2_BraZ1	267	-	0	0	315	0.0000000
A06	20113264	20119431	A06p25910.2_BraZ1	696	-	116	962	6167	0.1559916
A06	20113778	20117588	A06p25920.2_BraZ1	159	-	114	721	3810	0.1892388
A06	20114672	20115572	A06p25930.2_BraZ1	270	-	0	0	900	0.0000000
A06	20116496	20116969	A06p25940.2_BraZ1	228	-	1	61	473	0.1289641
A06	20121098	20124667	A06p25950.2_BraZ1	675	-	4	426	3569	0.1193612
A06	20147778	20148191	A06p25960.2_BraZ1	372	+	13	346	413	0.8377724
A06	20245914	20246613	A06p25970.2_BraZ1	171	+	3	275	699	0.3934192
A06	20246293	20246679	A06p25980.2_BraZ1	336	-	4	318	386	0.8238342
A06	20434424	20439132	A06p25990.2_BraZ1	309	-	16	816	4708	0.1733220
A06	20441687	20442412	A06p26000.2_BraZ1	309	-	2	116	725	0.1600000
A06	20451838	20452535	A06p26010.2_BraZ1	300	+	5	38	697	0.0545194
A06	20891404	20893007	A06p26020.2_BraZ1	780	-	0	0	1603	0.0000000
A06	20896836	20897451	A06p26030.2_BraZ1	61.5	-	423	615	615	1.0000000
A06	20982375	20982788	A06p26040.2_BraZ1	372	+	0	0	413	0.0000000
A06	21074495	21074881	A06p26050.2_BraZ1	336	-	0	0	386	0.0000000
A06	21517051	21517303	A06p26060.2_BraZ1	25.2	+	8	147	252	0.5833333
A06	21522170	21522422	A06p26070.2_BraZ1	25.2	+	0	0	252	0.0000000
A06	21569160	21569512	A06p26080.2_BraZ1	207	-	0	0	352	0.0000000
A06	22094988	22095123	A06p26090.2_BraZ1	13.5	-	1	32	135	0.2370370
A06	22178637	22178841	A06p26100.2_BraZ1	20.4	+	56	204	204	1.0000000
A06	22505263	22506177	A06p26110.2_BraZ1	432	+	763	624	914	0.6827133
A06	22566071	22566215	A06p26120.2_BraZ1	14.4	-	10	133	144	0.9236111
A06	22588125	22589417	A06p26130.2_BraZ1	51.3	-	257	1053	1292	0.8150155
A06	22589574	22589798	A06p26140.2_BraZ1	20.1	-	7	178	224	0.7946429
A06	22701158	22701308	A06p26150.2_BraZ1	15	+	2	82	150	0.5466667
A06	22805365	22805521	A06p26160.2_BraZ1	15.6	+	3	146	156	0.9358974
A06	22946045	22946957	A06p26170.2_BraZ1	330	-	47	554	912	0.6074561
A06	22947440	22950871	A06p26180.2_BraZ1	222	+	129	2223	3431	0.6479161
A06	22948332	22950408	A06p26190.2_BraZ1	285	-	68	1097	2076	0.5284200
A06	22951445	22953872	A06p26200.2_BraZ1	745.875	+	372	2117	2427	0.8722703
A06	22957116	22959626	A06p26210.2_BraZ1	606	+	200	1698	2510	0.6764940
A06	22962486	22963270	A06p26220.2_BraZ1	342.5	+	91	583	784	0.7436224
A06	22963720	22966867	A06p26230.2_BraZ1	255	-	395	2918	3147	0.9272323
A06	22967559	22969479	A06p26240.2_BraZ1	501	-	291	1713	1920	0.8921875
A06	22973461	23006739	A06p26250.2_BraZ1	1121.25	-	2142	20706	33278	0.6222129
A06	23046495	23048461	A06p26260.2_BraZ1	664	-	16	841	1966	0.4277721
A06	23047633	23050981	A06p26270.2_BraZ1	390	+	70	1731	3348	0.5170251
A06	23052839	23053571	A06p26280.2_BraZ1	231	+	47	613	732	0.8374317
A06	23053273	23053860	A06p26290.2_BraZ1	189	+	8	260	587	0.4429302
A06	23053828	23054345	A06p26300.2_BraZ1	212.5	+	1	82	517	0.1586073
A06	23053989	23055183	A06p26310.2_BraZ1	135	+	17	636	1194	0.5326633
A06	23054044	23056583	A06p26320.2_BraZ1	261	+	32	1088	2539	0.4285152
A06	23055781	23057401	A06p26330.2_BraZ1	189	-	4	355	1620	0.2191358
A06	23056092	23061703	A06p26340.2_BraZ1	1054.8	+	103	2513	5611	0.4478703
A06	23062954	23067428	A06p26350.2_BraZ1	444	+	46	1608	4474	0.3594099
A06	23063033	23066337	A06p26360.2_BraZ1	360	+	30	1219	3304	0.3689467
A06	23063442	23066785	A06p26370.2_BraZ1	267	+	27	1020	3343	0.3051152
A06	23075640	23077830	A06p26380.2_BraZ1	1035	+	61	927	2190	0.4232877
A06	23094063	23094933	A06p26390.2_BraZ1	428	+	24	705	870	0.8103448
A06	23118008	23121740	A06p26400.2_BraZ1	429	+	74	2248	3732	0.6023580
A06	23118602	23123054	A06p26410.2_BraZ1	438.75	+	68	2484	4452	0.5579515
A06	23121644	23122353	A06p26420.2_BraZ1	198	-	17	378	709	0.5331452
A06	23290234	23290450	A06p26430.2_BraZ1	21.6	-	4	128	216	0.5925926
A06	23407447	23408363	A06p26440.2_BraZ1	216	-	47	233	916	0.2543668
A06	23467232	23609260	A06p26450.2_BraZ1	456	+	8812	94462	142028	0.6650942
A06	23628147	23629034	A06p26460.2_BraZ1	217.038	-	33	15	887	0.0169109
A06	24011013	24011163	A06p26470.2_BraZ1	15	+	0	0	150	0.0000000
A06	24039942	24042882	A06p26480.2_BraZ1	477	-	66	1251	2940	0.4255102
A06	24059884	24061525	A06p26490.2_BraZ1	453	-	2	237	1641	0.1444241
A06	24084761	24087814	A06p26500.2_BraZ1	285	-	2	185	3053	0.0605961
A06	24308798	24308924	A06p26510.2_BraZ1	12.6	+	4	97	126	0.7698413
A06	24363341	24363491	A06p26520.2_BraZ1	15	-	2	109	150	0.7266667
A06	24388919	24389345	A06p26530.2_BraZ1	333	+	65	426	426	1.0000000
A06	24604842	24605085	A06p26540.2_BraZ1	111	+	4	84	243	0.3456790
A06	24606454	24608863	A06p26550.2_BraZ1	742.4	-	90	951	2409	0.3947696
A06	24631723	24632744	A06p26560.2_BraZ1	486	-	28	675	1021	0.6611165
A06	24635670	24645410	A06p26570.2_BraZ1	1212	-	177	4066	9740	0.4174538
A06	24647260	24649000	A06p26580.2_BraZ1	600	-	10	618	1740	0.3551724
A06	24651882	24668010	A06p26590.2_BraZ1	1161.6	-	2969	10689	16128	0.6627604
A06	24652648	24653536	A06p26600.2_BraZ1	231	-	653	888	888	1.0000000
A06	24675206	24677953	A06p26610.2_BraZ1	606	-	924	2506	2747	0.9122679
A06	24686895	24689515	A06p26620.2_BraZ1	576	-	826	2567	2620	0.9797710
A06	24926302	25046381	A06p26630.2_BraZ1	300	-	22690	81684	120079	0.6802522
A06	24931270	24983581	A06p26640.2_BraZ1	290.667	-	3325	28888	52311	0.5522357
A06	24983026	25025653	A06p26650.2_BraZ1	720.882	-	15910	33769	42627	0.7921974
A06	24998480	24999734	A06p26660.2_BraZ1	617.5	+	130	1252	1254	0.9984051
A06	25002876	25006839	A06p26670.2_BraZ1	858	+	1137	3963	3963	1.0000000
A06	25025653	25034812	A06p26680.2_BraZ1	702	-	1110	7572	9159	0.8267278
A06	25035270	25035657	A06p26690.2_BraZ1	225	-	13	349	387	0.9018088
A06	25035686	25038838	A06p26700.2_BraZ1	764	+	1066	2849	3152	0.9038706
A06	25047687	25048084	A06p26710.2_BraZ1	517.5	+	30	299	397	0.7531486
A06	25048084	25092521	A06p26720.2_BraZ1	270	+	5537	34264	44437	0.7710692
A06	25048844	25050151	A06p26730.2_BraZ1	708	-	102	1140	1307	0.8722265
A06	25066365	25067117	A06p26740.2_BraZ1	435	+	448	752	752	1.0000000
A06	25067521	25070219	A06p26750.2_BraZ1	1005	+	537	2529	2698	0.9373610
A06	25087190	25088115	A06p26760.2_BraZ1	519	-	189	925	925	1.0000000
A06	25090321	25125367	A06p26770.2_BraZ1	570	-	3373	23710	35046	0.6765394
A06	25148615	25148980	A06p26780.2_BraZ1	285	-	19	365	365	1.0000000
A06	25184305	25185305	A06p26790.2_BraZ1	324	+	250	678	1000	0.6780000
A06	25285187	25286044	A06p26800.2_BraZ1	510	+	8	439	857	0.5122520
A06	25288261	25308359	A06p26810.2_BraZ1	684	-	1760	11186	20098	0.5565728
A06	25304343	25304894	A06p26820.2_BraZ1	165	-	17	351	551	0.6370236
A06	25308152	25309703	A06p26830.2_BraZ1	231	+	51	1192	1551	0.7685364
A06	25308359	25311954	A06p26840.2_BraZ1	852	+	236	2612	3595	0.7265646
A06	25313986	25316670	A06p26850.2_BraZ1	348	-	501	2395	2684	0.8923249
A06	25404048	25411446	A06p26860.2_BraZ1	717	-	211	2929	7398	0.3959178
A06	25411448	25477044	A06p26870.2_BraZ1	615	-	2429	32071	65596	0.4889170
A06	25633961	25634108	A06p26880.2_BraZ1	14.7	-	23	142	147	0.9659864
A06	25634121	25664155	A06p26890.2_BraZ1	509.167	+	1168	16226	30034	0.5402544
A06	25638285	25697313	A06p26900.2_BraZ1	513	-	1822	27141	59028	0.4597988
A06	25671043	25695907	A06p26910.2_BraZ1	708	+	660	9734	24864	0.3914897
A06	25696445	25701331	A06p26920.2_BraZ1	702	+	177	3137	4886	0.6420385
A06	25696891	25697625	A06p26930.2_BraZ1	219	+	26	267	734	0.3637602
A06	25697230	25698155	A06p26940.2_BraZ1	147	+	2	249	925	0.2691892
A06	25733638	25733878	A06p26950.2_BraZ1	24	-	1	2	240	0.0083333
A06	25737509	25737749	A06p26960.2_BraZ1	24	-	5	219	240	0.9125000
A06	25810215	25905771	A06p26970.2_BraZ1	336	+	2128	40334	95556	0.4220980
A06	25971738	25972999	A06p26980.2_BraZ1	768	-	38	950	1261	0.7533703
A06	25983739	25985547	A06p26990.2_BraZ1	927	-	170	1589	1808	0.8788717
A06	25994819	25999468	A06p27000.2_BraZ1	628.25	+	695	4118	4649	0.8857819
A06	26006599	26016930	A06p27010.2_BraZ1	897.45	+	1077	8079	10331	0.7820153
A06	26040215	26042359	A06p27020.2_BraZ1	303	-	287	2035	2144	0.9491605
A06	26058557	26070306	A06p27030.2_BraZ1	1161	-	1055	9865	11749	0.8396459
A06	26099933	26119042	A06p27040.2_BraZ1	1834.22	+	3278	18158	19109	0.9502329
A06	26140841	26152812	A06p27050.2_BraZ1	1008	+	1809	10349	11971	0.8645059
A06	26154856	26156762	A06p27060.2_BraZ1	841.75	+	68	1142	1906	0.5991606
A06	26155597	26156329	A06p27070.2_BraZ1	117	+	29	450	732	0.6147541
A06	26165749	26184520	A06p27080.2_BraZ1	678	+	1255	15130	18771	0.8060306
A06	26184478	26190987	A06p27090.2_BraZ1	969	+	538	6012	6509	0.9236442
A06	26212362	26288211	A06p27100.2_BraZ1	189	+	4540	51410	75849	0.6777940
A06	26214182	26215237	A06p27110.2_BraZ1	1659	+	13	455	1055	0.4312796
A06	26219219	26221540	A06p27120.2_BraZ1	522	+	71	1382	2321	0.5954330
A06	26228368	26264281	A06p27130.2_BraZ1	795	+	2146	25313	35913	0.7048423
A06	26249008	26258693	A06p27140.2_BraZ1	339	+	949	8560	9685	0.8838410
A06	26277321	26278074	A06p27150.2_BraZ1	171	-	49	499	753	0.6626826
A06	26277432	26278026	A06p27160.2_BraZ1	144	-	21	388	594	0.6531987
A06	26282032	26286506	A06p27170.2_BraZ1	846	+	430	4457	4474	0.9962003
A06	26295170	26297263	A06p27180.2_BraZ1	519	+	140	2042	2093	0.9756331
A06	26333502	26336397	A06p27190.2_BraZ1	894	+	292	2703	2895	0.9336787
A06	26362443	26385270	A06p27200.2_BraZ1	987	+	653	12475	22827	0.5465019
A06	26427938	26428835	A06p27210.2_BraZ1	168	-	31	651	897	0.7257525
A06	26443594	26443870	A06p27220.2_BraZ1	27.6	+	51	276	276	1.0000000
A06	26455891	26457173	A06p27230.2_BraZ1	630	+	243	1156	1282	0.9017161
A06	26515613	26516506	A06p27240.2_BraZ1	330	-	182	855	893	0.9574468
A06	26517492	26521216	A06p27250.2_BraZ1	135.9	+	263	2884	3724	0.7744361
A06	26520903	26521558	A06p27260.2_BraZ1	105	+	2	167	655	0.2549618
A06	26522952	26525692	A06p27270.2_BraZ1	591	+	289	2356	2740	0.8598540
A06	26583617	26584479	A06p27280.2_BraZ1	396	-	198	800	862	0.9280742
A06	26585002	26593540	A06p27290.2_BraZ1	880	+	1625	7850	8538	0.9194191
A06	26602807	26604670	A06p27300.2_BraZ1	918.4	+	831	1863	1863	1.0000000
A06	26625083	26626944	A06p27310.2_BraZ1	707.143	+	320	1778	1861	0.9554003
A06	26632720	26634197	A06p27320.2_BraZ1	527.5	+	487	1477	1477	1.0000000
A06	26642799	26646419	A06p27330.2_BraZ1	681.429	+	303	3151	3620	0.8704420
A06	26644938	26645443	A06p27340.2_BraZ1	150	-	14	451	505	0.8930693
A06	26645443	26654044	A06p27350.2_BraZ1	252	-	817	7800	8601	0.9068713
A06	26789516	26790522	A06p27360.2_BraZ1	624	-	127	960	1006	0.9542744
A06	26808701	26810352	A06p27370.2_BraZ1	594	-	129	1357	1651	0.8219261
A06	26812784	26813062	A06p27380.2_BraZ1	162	-	2	128	278	0.4604317
A06	26823997	26848375	A06p27390.2_BraZ1	669	-	176	6288	24378	0.2579375
A06	26848599	26852202	A06p27400.2_BraZ1	1077	+	70	2210	3603	0.6133777
A06	26863208	26868550	A06p27410.2_BraZ1	495	+	59	1835	5342	0.3435043
A06	26867388	26891645	A06p27420.2_BraZ1	1581	+	458	10951	24257	0.4514573
A06	26903275	26905596	A06p27430.2_BraZ1	369	+	10	518	2321	0.2231797
A06	26904675	26910741	A06p27440.2_BraZ1	1246.88	+	119	3415	6066	0.5629740
A06	26906879	26910635	A06p27450.2_BraZ1	168	-	107	2530	3756	0.6735889
A06	26910818	26931684	A06p27460.2_BraZ1	594	+	180	5911	20866	0.2832838
A06	26956541	26968940	A06p27470.2_BraZ1	216	-	285	4674	12399	0.3769659
A06	27035298	27037555	A06p27480.2_BraZ1	468	+	24	1036	2257	0.4590164
A06	27048442	27049319	A06p27490.2_BraZ1	401.625	+	2	174	877	0.1984036
A06	27048883	27049827	A06p27500.2_BraZ1	273	-	44	404	944	0.4279661
A06	27049808	27060522	A06p27510.2_BraZ1	1400	+	657	8157	10714	0.7613403
A06	27060406	27061620	A06p27520.2_BraZ1	612	+	96	1002	1214	0.8253707
A06	27127573	27129108	A06p27530.2_BraZ1	702	+	230	1502	1535	0.9785016
A06	27132975	27146480	A06p27540.2_BraZ1	1701	+	1964	11087	13505	0.8209552
A06	27333281	27408586	A06p27550.2_BraZ1	318	-	11859	64678	75305	0.8588806
A06	27348390	27401753	A06p27560.2_BraZ1	1236	+	8626	44946	53363	0.8422690
A06	27348643	27400948	A06p27570.2_BraZ1	156	+	8361	43899	52305	0.8392888
A06	27399407	27400109	A06p27580.2_BraZ1	171	-	19	431	702	0.6139601
A06	27407515	27409526	A06p27590.2_BraZ1	300	+	154	1901	2011	0.9453008
A06	27409526	27410519	A06p27600.2_BraZ1	603	+	118	993	993	1.0000000
A06	27420719	27429011	A06p27610.2_BraZ1	1514.33	+	920	7509	8292	0.9055716
A06	27453880	27455172	A06p27620.2_BraZ1	666	+	492	1292	1292	1.0000000
A06	27491442	27494206	A06p27630.2_BraZ1	780	+	383	2416	2764	0.8740955
A06	27494029	27527057	A06p27640.2_BraZ1	1176	+	4778	22007	33028	0.6663134
A06	27495894	27523856	A06p27650.2_BraZ1	174	+	2888	17111	27962	0.6119376
A06	27536910	27537489	A06p27660.2_BraZ1	212	+	575	579	579	1.0000000
A06	27614714	27615393	A06p27670.2_BraZ1	186	-	135	679	679	1.0000000
A06	28011587	28012653	A06p27680.2_BraZ1	303	-	6	220	1066	0.2063790
A06	28067017	28068091	A06p27690.2_BraZ1	753	-	129	918	1074	0.8547486
A06	28069028	28073177	A06p27700.2_BraZ1	356.667	+	300	2912	4149	0.7018559
A06	28071983	28072505	A06p27710.2_BraZ1	52.2	-	4	168	522	0.3218391
A06	28104868	28105294	A06p27720.2_BraZ1	2478	+	22	389	426	0.9131455
A06	28106883	28107075	A06p27730.2_BraZ1	19.2	-	15	192	192	1.0000000
A06	28198430	28241867	A06p27740.2_BraZ1	1053	-	2154	32351	43437	0.7447798
A06	28233460	28233766	A06p27750.2_BraZ1	30.6	-	46	306	306	1.0000000
A06	28298920	28303724	A06p27760.2_BraZ1	609	-	253	4225	4804	0.8794754
A06	28451937	28452811	A06p27770.2_BraZ1	432	+	2	125	874	0.1430206
A06	28451985	28452530	A06p27780.2_BraZ1	144	+	1	25	545	0.0458716
A06	28454880	28456015	A06p27790.2_BraZ1	46464	-	28	865	1135	0.7621145
A06	28476637	28513372	A06p27800.2_BraZ1	1116	-	2072	26300	36735	0.7159384
A06	28476701	28477906	A06p27810.2_BraZ1	696	-	161	1205	1205	1.0000000
A06	28513363	28513733	A06p27820.2_BraZ1	363	+	61	370	370	1.0000000
A06	28731724	28732611	A06p27830.2_BraZ1	330	+	155	813	887	0.9165727
A06	28782044	28783118	A06p27840.2_BraZ1	1208.25	-	213	1035	1074	0.9636871
A06	28805986	28809906	A06p27850.2_BraZ1	324	+	60	1586	3920	0.4045918
A06	28814522	28830595	A06p27860.2_BraZ1	906.667	-	2812	14212	16073	0.8842158
A06	28830688	28831638	A06p27870.2_BraZ1	204	+	311	854	950	0.8989474
A06	28832091	28837113	A06p27880.2_BraZ1	1050	-	658	4726	5022	0.9410594
A06	28846451	28858078	A06p27890.2_BraZ1	1818.3	-	781	7111	11627	0.6115937
A06	28856711	28858796	A06p27900.2_BraZ1	1138.5	-	281	1760	2085	0.8441247
A06	28867903	28878008	A06p27910.2_BraZ1	1550.77	-	270	5367	10105	0.5311232
A06	28898872	28899356	A06p27920.2_BraZ1	318	+	1	25	484	0.0516529
A06	28899301	28901289	A06p27930.2_BraZ1	1133.82	-	1	21	1988	0.0105634
A06	28940510	28945698	A06p27940.2_BraZ1	1597.5	-	905	4342	5188	0.8369314
A06	28945698	28946182	A06p27950.2_BraZ1	294	-	247	484	484	1.0000000
A06	28954353	28964096	A06p27960.2_BraZ1	1533	-	1620	8532	9743	0.8757057
A06	28975907	28976291	A06p27970.2_BraZ1	213	-	52	377	384	0.9817708
A06	28980229	28999387	A06p27980.2_BraZ1	2039.79	-	1655	14297	19158	0.7462679
A06	28998339	28999006	A06p27990.2_BraZ1	402	-	294	667	667	1.0000000
A06	28999006	29024366	A06p28000.2_BraZ1	1032	+	3124	18083	25360	0.7130520
A06	29025090	29181898	A06p28010.2_BraZ1	204	-	25065	128673	156808	0.8205767
A06	29025206	29025908	A06p28020.2_BraZ1	171	+	92	702	702	1.0000000
A06	29025546	29025931	A06p28030.2_BraZ1	156	+	70	385	385	1.0000000
A06	29073546	29073846	A06p28040.2_BraZ1	30	-	125	300	300	1.0000000
A06	29204128	29229637	A06p28050.2_BraZ1	902.571	-	4935	23653	25509	0.9272414
A06	29229637	29244071	A06p28060.2_BraZ1	1596	+	2476	13086	14434	0.9066094
A06	29244471	29245245	A06p28070.2_BraZ1	270	+	129	774	774	1.0000000
A06	29244892	29247198	A06p28080.2_BraZ1	602	+	355	2190	2306	0.9496964
A06	29250521	29254812	A06p28090.2_BraZ1	981	-	45	2486	4291	0.5793521
A06	29256535	29261728	A06p28100.2_BraZ1	606	-	365	4181	5193	0.8051223
A06	29256600	29258934	A06p28110.2_BraZ1	258	+	113	1664	2334	0.7129391
A06	29261726	29264323	A06p28120.2_BraZ1	232	-	75	1399	2597	0.5386985
A06	29264321	29265230	A06p28130.2_BraZ1	330	+	86	909	909	1.0000000
A06	29320494	29321104	A06p28140.2_BraZ1	462	+	0	0	610	0.0000000
A06	29335882	29342457	A06p28150.2_BraZ1	734	-	623	6050	6575	0.9201521
A06	29342455	29343365	A06p28160.2_BraZ1	330	+	84	783	910	0.8604395
A06	29396732	29397651	A06p28170.2_BraZ1	1374	-	103	876	919	0.9532100
A06	29414671	29419847	A06p28180.2_BraZ1	906	-	403	4793	5176	0.9260046
A06	29447842	29449802	A06p28190.2_BraZ1	507	-	445	1838	1960	0.9377551
A06	29454273	29457909	A06p28200.2_BraZ1	492	-	200	2708	3636	0.7447745
A06	29466813	29473192	A06p28210.2_BraZ1	480	-	126	3469	6379	0.5438157
A06	29477404	29498842	A06p28220.2_BraZ1	274.286	-	2020	15819	21438	0.7378953
A06	29498318	29502586	A06p28230.2_BraZ1	376.5	-	164	1650	4268	0.3865979
A06	29509084	29515065	A06p28240.2_BraZ1	795.167	-	164	3335	5981	0.5575991
A06	29510526	29511721	A06p28250.2_BraZ1	354	-	8	121	1195	0.1012552
A06	29511695	29515009	A06p28260.2_BraZ1	438	+	121	2190	3314	0.6608328
A06	29526709	29528711	A06p28270.2_BraZ1	447	-	448	1863	2002	0.9305694
A06	29527814	29529025	A06p28280.2_BraZ1	187.5	+	421	1139	1211	0.9405450
A06	29543404	29544726	A06p28290.2_BraZ1	55.5	+	82	1200	1322	0.9077156
A06	29545330	29546460	A06p28300.2_BraZ1	297	+	62	461	1130	0.4079646
A06	29554916	29564829	A06p28310.2_BraZ1	1210.4	+	1607	8355	9913	0.8428326
A06	29564829	29567117	A06p28320.2_BraZ1	174	-	60	1162	2288	0.5078672
A06	29576417	29578921	A06p28330.2_BraZ1	1115.4	-	57	1505	2504	0.6010383
A06	29593164	29595233	A06p28340.2_BraZ1	651	-	264	1739	2069	0.8405027
A06	29595231	29596145	A06p28350.2_BraZ1	432	+	235	914	914	1.0000000
A06	29613947	29615398	A06p28360.2_BraZ1	399	-	800	1451	1451	1.0000000
A06	29644372	29644785	A06p28370.2_BraZ1	375	-	127	413	413	1.0000000
A06	29656406	29674030	A06p28380.2_BraZ1	702	+	357	9122	17624	0.5175896
A06	29689665	29689815	A06p28390.2_BraZ1	15	-	20	150	150	1.0000000
A06	29792947	29798346	A06p28400.2_BraZ1	306	-	636	3925	5399	0.7269865
A06	29860455	29860620	A06p28410.2_BraZ1	16.5	+	2	35	165	0.2121212
A06	29869770	29870469	A06p28420.2_BraZ1	111	+	12	321	699	0.4592275
A06	29990483	29991269	A06p28430.2_BraZ1	213	+	17	476	786	0.6055980
A06	30001757	30002106	A06p28440.2_BraZ1	225	-	11	295	349	0.8452722
A06	30037212	30038946	A06p28450.2_BraZ1	306	-	446	1734	1734	1.0000000
A06	30055742	30057791	A06p28460.2_BraZ1	309	-	136	1711	2049	0.8350415
A06	30139652	30140527	A06p28470.2_BraZ1	1602	+	168	816	875	0.9325714
A06	30199610	30236029	A06p28480.2_BraZ1	123	+	5289	32371	36419	0.8888492
A06	30396988	30397111	A06p28490.2_BraZ1	12.3	+	45	123	123	1.0000000
A06	30514595	30515502	A06p28500.2_BraZ1	330	-	16	546	907	0.6019846
A06	30518317	30521238	A06p28510.2_BraZ1	204	+	368	2746	2921	0.9400890
A06	30688742	30690017	A06p28520.2_BraZ1	258	+	407	1267	1275	0.9937255
A06	30691739	30724369	A06p28530.2_BraZ1	213.75	-	4864	26029	32630	0.7977015
A06	30724369	30725792	A06p28540.2_BraZ1	330	+	517	1312	1423	0.9219958
A06	30724680	30725944	A06p28550.2_BraZ1	321	-	309	1153	1264	0.9121835
A06	30734700	30735946	A06p28560.2_BraZ1	270	-	314	1246	1246	1.0000000
A06	30734813	30743982	A06p28570.2_BraZ1	315	-	1930	8636	9169	0.9418693
A06	30735408	30735964	A06p28580.2_BraZ1	249	+	104	556	556	1.0000000
A06	30748850	30750477	A06p28590.2_BraZ1	287	-	54	929	1627	0.5709895
A06	30749042	30750277	A06p28600.2_BraZ1	150	-	24	635	1235	0.5141701
A06	30749715	30751008	A06p28610.2_BraZ1	273	-	150	1112	1293	0.8600155
A06	30763696	30764810	A06p28620.2_BraZ1	402	-	172	1114	1114	1.0000000
A06	31366303	31366751	A06p28630.2_BraZ1	324	+	71	448	448	1.0000000
A06	31473299	31474373	A06p28640.2_BraZ1	753	-	245	1074	1074	1.0000000
A06	31475309	31476119	A06p28650.2_BraZ1	4416	+	111	707	810	0.8728395
A06	31478308	31478812	A06p28660.2_BraZ1	50.4	-	56	504	504	1.0000000
A06	31499534	31499960	A06p28670.2_BraZ1	2242	+	30	328	426	0.7699531
A06	31500765	31503396	A06p28680.2_BraZ1	531	-	108	1616	2631	0.6142151
A06	31590787	31593642	A06p28690.2_BraZ1	309	-	947	2379	2855	0.8332750
A06	31626062	31626564	A06p28700.2_BraZ1	165	-	48	502	502	1.0000000
A06	31638771	31639077	A06p28710.2_BraZ1	30.6	-	14	276	306	0.9019608
A06	31643975	31692357	A06p28720.2_BraZ1	240	-	3576	34929	48382	0.7219421
A06	31674551	31696754	A06p28730.2_BraZ1	360	-	1519	15017	22203	0.6763501
A06	31764927	31766993	A06p28740.2_BraZ1	660	-	247	1930	2066	0.9341723
A06	31765145	31766680	A06p28750.2_BraZ1	273	-	168	1497	1535	0.9752443
A06	31773545	31774250	A06p28760.2_BraZ1	414	-	45	583	705	0.8269504
A06	31774791	31777967	A06p28770.2_BraZ1	249	+	505	2887	3176	0.9090050
A06	31785334	31788571	A06p28780.2_BraZ1	672	-	53	1568	3237	0.4843991
A06	31787170	31788224	A06p28790.2_BraZ1	165	-	7	276	1054	0.2618596
A06	31800673	31801449	A06p28800.2_BraZ1	297	-	67	602	776	0.7757732
A06	31809636	31814140	A06p28810.2_BraZ1	969	-	105	1863	4504	0.4136323
A06	31814140	31815008	A06p28820.2_BraZ1	312	-	1	83	868	0.0956221
A06	31815368	31815875	A06p28830.2_BraZ1	222	-	0	0	507	0.0000000
A06	31823792	31826088	A06p28840.2_BraZ1	678	-	56	1083	2296	0.4716899
A06	31826323	31827297	A06p28850.2_BraZ1	291	-	41	645	974	0.6622177
A06	32068410	32068904	A06p28860.2_BraZ1	114	+	27	486	494	0.9838057
A06	32069496	32070497	A06p28870.2_BraZ1	291	-	34	653	1001	0.6523476
A06	32076371	32077084	A06p28880.2_BraZ1	252	-	12	399	713	0.5596073
A06	32077724	32079235	A06p28890.2_BraZ1	306	-	39	1017	1511	0.6730642
A06	32090665	32091354	A06p28900.2_BraZ1	279	-	14	505	689	0.7329463
A06	32104226	32104869	A06p28910.2_BraZ1	102	+	34	643	643	1.0000000
A06	32115794	32117168	A06p28920.2_BraZ1	372	+	22	788	1374	0.5735080
A06	32116683	32117993	A06p28930.2_BraZ1	379.5	-	32	1027	1310	0.7839695
A06	32118417	32142454	A06p28940.2_BraZ1	246	-	780	14734	24037	0.6129717
A06	32178084	32197141	A06p28950.2_BraZ1	243	-	417	8362	19057	0.4387889
A06	32191024	32272214	A06p28960.2_BraZ1	471	-	3024	45274	81190	0.5576302
A06	32198698	32199079	A06p28970.2_BraZ1	237	-	4	138	381	0.3622047
A06	32218351	32221442	A06p28980.2_BraZ1	258	-	52	1354	3091	0.4380459
A06	32219473	32222266	A06p28990.2_BraZ1	276	-	56	1355	2793	0.4851414
A06	32246999	32247873	A06p29000.2_BraZ1	432	-	2	223	874	0.2551487
A06	32247280	32247825	A06p29010.2_BraZ1	144	-	2	195	545	0.3577982
A06	32399991	32400297	A06p29020.2_BraZ1	17.1	-	64	306	306	1.0000000
A06	32542843	32544192	A06p29030.2_BraZ1	303	-	34	772	1349	0.5722758
A06	32546445	32570713	A06p29040.2_BraZ1	261	-	99	3942	24268	0.1624361
A06	32570560	32571395	A06p29050.2_BraZ1	217.875	+	19	543	835	0.6502994
A06	32572168	32573013	A06p29060.2_BraZ1	702	-	1	63	845	0.0745562
A06	32573424	32576888	A06p29070.2_BraZ1	315	-	4	406	3464	0.1172055
A06	32582747	32583236	A06p29080.2_BraZ1	48.9	-	108	475	489	0.9713702
A06	32596626	32597174	A06p29090.2_BraZ1	153	-	15	101	548	0.1843066
A06	32599395	32610061	A06p29100.2_BraZ1	657	+	14628	9233	10666	0.8656479
A06	32610061	32610478	A06p29110.2_BraZ1	258	+	16	386	417	0.9256595
A06	32623373	32625252	A06p29120.2_BraZ1	678	+	17	977	1879	0.5199574
A06	32632280	32632848	A06p29130.2_BraZ1	36.6	+	1	1	568	0.0017606
A06	32679418	32679544	A06p29140.2_BraZ1	12.6	+	2	38	126	0.3015873
A06	32930236	32930452	A06p29150.2_BraZ1	21.6	-	24	216	216	1.0000000
A06	33035453	33041104	A06p29160.2_BraZ1	696	+	116	2079	5651	0.3678995
A06	33040280	33041508	A06p29170.2_BraZ1	279	+	4	201	1228	0.1636808
A06	33040460	33041267	A06p29180.2_BraZ1	201	-	4	192	807	0.2379182
A06	33059482	33060499	A06p29190.2_BraZ1	633	-	25	579	1017	0.5693215
A06	33067509	33067813	A06p29200.2_BraZ1	240	+	4	265	304	0.8717105
A06	33103075	33103438	A06p29210.2_BraZ1	207	+	0	0	363	0.0000000
A06	33106671	33111888	A06p29220.2_BraZ1	1146	-	169	3576	5217	0.6854514
A06	33152413	33153322	A06p29230.2_BraZ1	384	-	35	772	909	0.8492849
A06	33161054	33165099	A06p29240.2_BraZ1	426	-	111	2601	4045	0.6430160
A06	33161286	33161949	A06p29250.2_BraZ1	309	+	40	663	663	1.0000000
A06	33165248	33169373	A06p29260.2_BraZ1	825	-	162	3086	4125	0.7481212
A06	33177068	33182364	A06p29270.2_BraZ1	126.9	+	34	1650	5296	0.3115559
A06	33190051	33194328	A06p29280.2_BraZ1	1230	+	24	900	4277	0.2104279
A06	33194527	33195539	A06p29290.2_BraZ1	378	-	14	407	1012	0.4021739
A06	33264752	33265990	A06p29300.2_BraZ1	189	-	66	1172	1238	0.9466882
A06	33264916	33278465	A06p29310.2_BraZ1	216	-	748	10902	13549	0.8046350
A06	33277101	33286348	A06p29320.2_BraZ1	186	-	766	7597	9247	0.8215637
A06	33306869	33307022	A06p29330.2_BraZ1	15.3	-	4738	153	153	1.0000000
A06	33326368	33327307	A06p29340.2_BraZ1	58.8	+	181	939	939	1.0000000
A06	33327406	33337324	A06p29350.2_BraZ1	543	+	940	8109	9918	0.8176044
A06	33337556	33341684	A06p29360.2_BraZ1	612.5	-	519	3822	4128	0.9258721
A06	33351682	33352847	A06p29370.2_BraZ1	82.8	+	24	613	1165	0.5261803
A06	33369319	33377502	A06p29380.2_BraZ1	716.114	-	818	7535	8183	0.9208114
A06	33377130	33379217	A06p29390.2_BraZ1	87	-	178	1996	2087	0.9563968
A06	33377502	33378367	A06p29400.2_BraZ1	192	+	70	821	865	0.9491329
A06	33377539	33379276	A06p29410.2_BraZ1	267	+	150	1693	1737	0.9746690
A06	33397224	33397741	A06p29420.2_BraZ1	348	-	7	212	517	0.4100580
A06	33397741	33399517	A06p29430.2_BraZ1	456	-	183	1634	1776	0.9200450
A06	33400013	33400139	A06p29440.2_BraZ1	12.6	-	22	110	126	0.8730159
A06	33435043	33461884	A06p29450.2_BraZ1	369	-	1496	17440	26841	0.6497523
A06	33461604	33462313	A06p29460.2_BraZ1	222	-	8	501	709	0.7066290
A06	33761770	33762680	A06p29470.2_BraZ1	330	-	6	477	910	0.5241758
A06	33762678	33765928	A06p29480.2_BraZ1	477	+	50	1368	3250	0.4209231
A06	33769392	33771565	A06p29490.2_BraZ1	666	+	22	841	2173	0.3870226
A06	33788369	33796080	A06p29500.2_BraZ1	1242	+	242	4182	7711	0.5423421
A06	33844976	33845890	A06p29510.2_BraZ1	432	-	0	0	914	0.0000000
A06	33998620	33998842	A06p29520.2_BraZ1	22.2	-	0	0	222	0.0000000
A06	33999310	34014464	A06p29530.2_BraZ1	252	+	348	6892	15154	0.4547974
A06	34044556	34045630	A06p29540.2_BraZ1	107.4	-	78	941	1074	0.8761639
A06	34304618	34305469	A06p29550.2_BraZ1	270	+	0	0	851	0.0000000
A06	34305734	34310955	A06p29560.2_BraZ1	390	-	49	1872	5221	0.3585520
A06	34309547	34310891	A06p29570.2_BraZ1	183	-	21	576	1344	0.4285714
A06	34309900	34310234	A06p29580.2_BraZ1	183	-	18	334	334	1.0000000
A06	34309914	34310970	A06p29590.2_BraZ1	219	+	19	468	1056	0.4431818
A06	34320444	34320911	A06p29600.2_BraZ1	306	+	2	212	467	0.4539615
A06	34320980	34322206	A06p29610.2_BraZ1	573	+	0	0	1226	0.0000000
A06	34324012	34330834	A06p29620.2_BraZ1	876	+	211	3810	6822	0.5584872
A06	34331186	34333440	A06p29630.2_BraZ1	318	+	22	932	2254	0.4134871
A06	34342011	34359575	A06p29640.2_BraZ1	670.5	+	299	8486	17564	0.4831474
A06	34343541	34346082	A06p29650.2_BraZ1	306	+	52	1106	2541	0.4352617
A06	34346639	34348586	A06p29660.2_BraZ1	672	+	48	1359	1947	0.6979969
A06	34347651	34350416	A06p29670.2_BraZ1	462	+	71	2143	2765	0.7750452
A06	34352166	34353147	A06p29680.2_BraZ1	282	+	0	0	981	0.0000000
A06	34352734	34353838	A06p29690.2_BraZ1	150	+	20	437	1104	0.3958333
A06	34360665	34374200	A06p29700.2_BraZ1	1179	+	224	5120	13535	0.3782785
A06	34370338	34372830	A06p29710.2_BraZ1	153	+	86	1485	2492	0.5959069
A06	34378184	34386249	A06p29720.2_BraZ1	1032.5	+	213	4835	8065	0.5995041
A06	34384669	34387811	A06p29730.2_BraZ1	303	-	170	1903	3142	0.6056652
A06	34386361	34386818	A06p29740.2_BraZ1	333	-	30	296	457	0.6477024
A06	34490553	34491379	A06p29750.2_BraZ1	246	-	17	422	826	0.5108959
A06	34612120	34612270	A06p29760.2_BraZ1	15	-	0	0	150	0.0000000
A06	34917529	34918427	A06p29770.2_BraZ1	432	-	11	322	898	0.3585746
A06	34917810	34918379	A06p29780.2_BraZ1	144	-	1	72	569	0.1265378
A06	35038899	35039160	A06p29790.2_BraZ1	26.1	-	15	208	261	0.7969348
A06	35099472	35099778	A06p29800.2_BraZ1	30.6	-	182	306	306	1.0000000
A06	35406597	35408222	A06p29810.2_BraZ1	1125	-	184	1336	1625	0.8221539
A06	35411569	35416422	A06p29820.2_BraZ1	558	-	384	4265	4853	0.8788378
A06	35546601	35547303	A06p29830.2_BraZ1	171	+	102	641	702	0.9131054
A06	35660667	35661774	A06p29840.2_BraZ1	273	+	99	811	1107	0.7326106
A06	35677685	35687228	A06p29850.2_BraZ1	4344	+	560	7710	9543	0.8079221
A06	35708767	35710364	A06p29860.2_BraZ1	809.6	+	9	775	1597	0.4852849
A06	35719397	35720344	A06p29870.2_BraZ1	372	+	106	928	947	0.9799367
A06	35724869	35726123	A06p29880.2_BraZ1	111	-	150	1084	1254	0.8644338
A06	35735260	35743203	A06p29890.2_BraZ1	1258.33	-	1066	7248	7943	0.9125016
A06	35743308	35743643	A06p29900.2_BraZ1	592.312	-	48	279	335	0.8328358
A06	35743633	35744557	A06p29910.2_BraZ1	19312	-	113	675	924	0.7305195
A06	35744582	35744929	A06p29920.2_BraZ1	272.864	-	238	347	347	1.0000000
A06	35770148	35770499	A06p29930.2_BraZ1	126	-	69	344	351	0.9800570
A06	35770918	35775362	A06p29940.2_BraZ1	847	-	886	3934	4444	0.8852385
A06	35776209	35776684	A06p29950.2_BraZ1	225	+	62	475	475	1.0000000
A06	35782284	35783129	A06p29960.2_BraZ1	37.5	-	400	845	845	1.0000000
A06	35785182	35786775	A06p29970.2_BraZ1	71.4	-	246	1487	1593	0.9334589
A06	35798806	35799819	A06p29980.2_BraZ1	456.75	-	423	964	1013	0.9516288
A06	35815472	35817046	A06p29990.2_BraZ1	320	-	172	1565	1574	0.9942821
A06	35830162	35832251	A06p30000.2_BraZ1	660	+	305	2075	2089	0.9932982
A06	35833685	35834209	A06p30010.2_BraZ1	300	-	20	422	524	0.8053435
A06	35835577	35853626	A06p30020.2_BraZ1	663	-	1466	10669	18049	0.5911131
A06	35835727	35836583	A06p30030.2_BraZ1	309	+	115	856	856	1.0000000
A06	35853413	35854352	A06p30040.2_BraZ1	318	-	118	938	939	0.9989350
A06	35907174	35908218	A06p30050.2_BraZ1	534	-	271	960	1044	0.9195402
A06	35997514	35997730	A06p30060.2_BraZ1	21.6	-	20	216	216	1.0000000
A06	36050039	36050503	A06p30070.2_BraZ1	228	-	36	464	464	1.0000000
A06	36192304	36193897	A06p30080.2_BraZ1	1128	-	51	1317	1593	0.8267420
A06	36343012	36343776	A06p30090.2_BraZ1	37.5	-	41	536	764	0.7015707
A06	36578534	36579432	A06p30100.2_BraZ1	270	-	46	599	898	0.6670378
A06	36666869	36667779	A06p30110.2_BraZ1	330	-	24	645	910	0.7087912
A06	36798048	36799048	A06p30120.2_BraZ1	342	+	312	972	1000	0.9720000
A06	37025001	37025361	A06p30130.2_BraZ1	36	-	36	360	360	1.0000000
A06	37076855	37077405	A06p30140.2_BraZ1	276	+	54	409	550	0.7436364
A06	37077429	37078324	A06p30150.2_BraZ1	231	-	152	895	895	1.0000000
A06	37077517	37077830	A06p30160.2_BraZ1	237	+	63	313	313	1.0000000
A06	37077604	37092056	A06p30170.2_BraZ1	34.5	+	3388	13528	14452	0.9360642
A06	37091164	37092710	A06p30180.2_BraZ1	204	-	757	1425	1546	0.9217335
A06	37111237	37113426	A06p30190.2_BraZ1	315	+	32	779	2189	0.3558702
A06	37111719	37113701	A06p30200.2_BraZ1	270	-	33	746	1982	0.3763875
A06	37113087	37113925	A06p30210.2_BraZ1	240	+	31	739	838	0.8818616
A06	37113957	37114820	A06p30220.2_BraZ1	279	+	8	341	863	0.3951333
A06	37122908	37123802	A06p30230.2_BraZ1	192	+	116	842	894	0.9418344
A06	37193938	37194324	A06p30240.2_BraZ1	336	+	40	335	386	0.8678756
A06	37194004	37194703	A06p30250.2_BraZ1	171	-	96	699	699	1.0000000
A06	37336182	37337040	A06p30260.2_BraZ1	432	+	18	732	858	0.8531469
A06	37336230	37336759	A06p30270.2_BraZ1	144	+	16	495	529	0.9357278
A06	37338878	37340257	A06p30280.2_BraZ1	405	-	31	809	1379	0.5866570
A06	37438040	37444006	A06p30290.2_BraZ1	990	-	248	5014	5966	0.8404291
A06	37440217	37440591	A06p30300.2_BraZ1	222	-	28	364	374	0.9732620
A06	37442819	37451293	A06p30310.2_BraZ1	633	-	349	6558	8474	0.7738966
A06	37451398	37470859	A06p30320.2_BraZ1	1743.96	-	874	14654	19461	0.7529932
A06	37470627	37471650	A06p30330.2_BraZ1	216	-	53	926	1023	0.9051808
A06	37494374	37495762	A06p30340.2_BraZ1	1018.88	-	150	1299	1388	0.9358790
A06	37495851	37532461	A06p30350.2_BraZ1	1245	-	2090	27826	36610	0.7600656
A06	37496417	37497331	A06p30360.2_BraZ1	432	+	114	829	914	0.9070022
A06	37516561	37523241	A06p30370.2_BraZ1	285	-	293	5280	6680	0.7904192
A06	37531754	37532400	A06p30380.2_BraZ1	234	+	8	466	646	0.7213622
A06	37584802	37585087	A06p30390.2_BraZ1	28.5	+	47	272	285	0.9543859
A06	37635387	37637535	A06p30400.2_BraZ1	1260	-	584	2148	2148	1.0000000
A06	37644317	37644743	A06p30410.2_BraZ1	333	-	225	426	426	1.0000000
A06	37661412	37663313	A06p30420.2_BraZ1	1102.5	-	237	1796	1901	0.9447659
A06	37666956	37679438	A06p30430.2_BraZ1	918	-	357	5918	12482	0.4741227
A06	37679451	37679601	A06p30440.2_BraZ1	15	+	5	125	150	0.8333333
A06	37722120	37740296	A06p30450.2_BraZ1	2200	-	674	7926	18176	0.4360695
A06	37726151	37759875	A06p30460.2_BraZ1	663.429	-	1295	18450	33724	0.5470881
A06	37759924	37760706	A06p30470.2_BraZ1	327	-	65	701	782	0.8964195
A06	37763216	37764235	A06p30480.2_BraZ1	52.2	-	26	696	1019	0.6830226
A06	37779343	37780735	A06p30490.2_BraZ1	742.5	-	18	973	1392	0.6989943
A06	37791662	37795746	A06p30500.2_BraZ1	429	-	90	2307	4084	0.5648873
A06	37804277	37804394	A06p30510.2_BraZ1	11.7	+	8	117	117	1.0000000
A06	37808964	37811671	A06p30520.2_BraZ1	414	+	62	1318	2707	0.4868858
A06	37811757	37834377	A06p30530.2_BraZ1	1248	+	79	2829	22620	0.1250663
A06	37815087	37815932	A06p30540.2_BraZ1	702	+	27	593	845	0.7017751
A06	37816481	37816980	A06p30550.2_BraZ1	228	-	0	0	499	0.0000000
A06	37821694	37824384	A06p30560.2_BraZ1	102	+	4	72	2690	0.0267658
A06	37837715	37839288	A06p30570.2_BraZ1	915	-	3	169	1573	0.1074380
A06	37842785	37844392	A06p30580.2_BraZ1	576	-	9	410	1607	0.2551338
A06	37844020	37846094	A06p30590.2_BraZ1	465	-	2	20	2074	0.0096432
A06	37870251	37874551	A06p30600.2_BraZ1	1092	+	172	2552	4300	0.5934884
A06	37886552	37891842	A06p30610.2_BraZ1	567.5	+	141	3050	5290	0.5765595
A06	37909725	37912064	A06p30620.2_BraZ1	564	+	10	765	2339	0.3270628
A06	37983008	38028946	A06p30630.2_BraZ1	360	+	4476	34020	45938	0.7405634
A06	37984542	38046923	A06p30640.2_BraZ1	72	+	4938	42083	62381	0.6746125
A06	37987148	37987448	A06p30650.2_BraZ1	30	+	22	300	300	1.0000000
A06	38030466	38032906	A06p30660.2_BraZ1	1342	+	57	748	2440	0.3065574
A06	38046038	38058367	A06p30670.2_BraZ1	895.556	+	923	9951	12329	0.8071214
A06	38086579	38087348	A06p30680.2_BraZ1	396	+	180	769	769	1.0000000
A06	38087348	38103968	A06p30690.2_BraZ1	1526.45	+	4048	15793	16620	0.9502407
A06	38090295	38091242	A06p30700.2_BraZ1	2880	+	843	947	947	1.0000000
A06	38100900	38104109	A06p30710.2_BraZ1	153	+	1073	3188	3209	0.9934559
A06	38112786	38118313	A06p30720.2_BraZ1	920	+	867	5451	5527	0.9862493
A06	38216681	38217747	A06p30730.2_BraZ1	829.5	+	5	242	1066	0.2270169
A06	38288305	38289058	A06p30740.2_BraZ1	186	-	135	739	753	0.9814077
A06	38288416	38289010	A06p30750.2_BraZ1	144	-	100	580	594	0.9764310
A06	38292739	38293411	A06p30760.2_BraZ1	54.3	+	5	252	672	0.3750000
A06	38297200	38297491	A06p30770.2_BraZ1	29.1	+	2	143	291	0.4914089
A06	38303711	38304002	A06p30780.2_BraZ1	29.1	+	17	291	291	1.0000000
A06	38305216	38307038	A06p30790.2_BraZ1	425	+	83	1387	1822	0.7612514
A06	38309843	38313958	A06p30800.2_BraZ1	226	-	396	3782	4115	0.9190766
A06	38312853	38366270	A06p30810.2_BraZ1	1182	+	2027	35877	53417	0.6716401
A06	38347743	38348765	A06p30820.2_BraZ1	612	+	32	870	1022	0.8512720
A06	38371889	38377283	A06p30830.2_BraZ1	657	+	492	4285	5394	0.7944012
A06	38393527	38396325	A06p30840.2_BraZ1	990	+	535	2597	2798	0.9281630
A06	38426793	38430130	A06p30850.2_BraZ1	1332	-	281	2359	3337	0.7069224
A06	38431039	38431228	A06p30860.2_BraZ1	18.9	-	84	189	189	1.0000000
A06	38431903	38432527	A06p30870.2_BraZ1	552	+	185	623	624	0.9983974
A06	38444187	38444463	A06p30880.2_BraZ1	27.6	+	65	110	276	0.3985507
A06	38494698	38495608	A06p30890.2_BraZ1	330	-	31	873	910	0.9593406
A06	38529348	38539504	A06p30900.2_BraZ1	393	-	2130	7292	10156	0.7179992
A06	38546876	38547044	A06p30910.2_BraZ1	12.9	+	3434	168	168	1.0000000
A06	38836884	38841156	A06p30920.2_BraZ1	648	+	189	3274	4272	0.7663858
A06	38838143	38840273	A06p30930.2_BraZ1	420	-	92	1829	2130	0.8586854
A06	38840543	38841381	A06p30940.2_BraZ1	252	-	53	783	838	0.9343675
A06	38862404	38863098	A06p30950.2_BraZ1	420	-	14	438	694	0.6311239
A06	38868285	38873938	A06p30960.2_BraZ1	252	-	301	3196	5653	0.5653635
A06	38870542	38873608	A06p30970.2_BraZ1	207	-	63	1232	3066	0.4018265
A06	38870972	38871763	A06p30980.2_BraZ1	615	+	47	653	791	0.8255373
A06	38901236	38902595	A06p30990.2_BraZ1	429	-	84	1189	1359	0.8749080
A06	38935126	38935276	A06p31000.2_BraZ1	15	+	0	0	150	0.0000000
A06	38970933	38971833	A06p31010.2_BraZ1	535	+	15	298	900	0.3311111
A06	39109135	39124500	A06p31020.2_BraZ1	1533.68	+	301	8288	15365	0.5394077
A06	39131064	39134599	A06p31030.2_BraZ1	1480.5	+	238	3182	3535	0.9001414
A06	39144402	39145002	A06p31040.2_BraZ1	426	+	23	498	600	0.8300000
A06	39145085	39152761	A06p31050.2_BraZ1	1747.85	+	554	4769	7676	0.6212871
A06	39162544	39169417	A06p31060.2_BraZ1	1061.25	+	150	4029	6873	0.5862069
A06	39168027	39169223	A06p31070.2_BraZ1	567.6	+	26	816	1196	0.6822742
A06	39169174	39175922	A06p31080.2_BraZ1	1834.74	+	255	4300	6748	0.6372259
A06	39178047	39178227	A06p31090.2_BraZ1	18	-	67	180	180	1.0000000
A06	39224036	39225508	A06p31100.2_BraZ1	2152.5	+	40	757	1472	0.5142663
A06	39236855	39263588	A06p31110.2_BraZ1	1446.67	+	1231	17555	26733	0.6566790
A06	39266278	39284702	A06p31120.2_BraZ1	231	-	231	6947	18424	0.3770625
A06	39285707	39288314	A06p31130.2_BraZ1	1386.27	+	27	1237	2607	0.4744917
A06	39297260	39297668	A06p31140.2_BraZ1	360	+	1	61	408	0.1495098
A06	39302391	39310080	A06p31150.2_BraZ1	234	+	260	3652	7689	0.4749642
A06	39302809	39328097	A06p31160.2_BraZ1	1257	+	1166	14273	25288	0.5644179
A06	39303734	39328097	A06p31170.2_BraZ1	333	+	1151	13789	24363	0.5659812
A06	39327351	39348004	A06p31180.2_BraZ1	663	+	1029	12052	20653	0.5835472
A06	39332265	39333160	A06p31190.2_BraZ1	1584	+	50	618	895	0.6905028
A06	39384638	39385049	A06p31200.2_BraZ1	41.1	+	44	411	411	1.0000000
A06	39524724	39533069	A06p31210.2_BraZ1	381	-	346	6345	8345	0.7603355
A06	39533236	39540844	A06p31220.2_BraZ1	933	-	39	1412	7608	0.1855941
A06	39540390	39540783	A06p31230.2_BraZ1	294	-	8	124	393	0.3155216
A06	39557935	39558334	A06p31240.2_BraZ1	39.9	-	6	173	399	0.4335839
A06	39598380	39598706	A06p31250.2_BraZ1	1237.5	-	4	116	326	0.3558282
A06	39609431	39611758	A06p31260.2_BraZ1	600	+	61	843	2327	0.3622690
A06	39619229	39650605	A06p31270.2_BraZ1	1817.67	-	3318	16534	31376	0.5269633
A06	39650450	39650831	A06p31280.2_BraZ1	198.75	-	7	195	381	0.5118110
A06	39687850	39689126	A06p31290.2_BraZ1	477	+	37	663	1276	0.5195925
A06	39689480	39725750	A06p31300.2_BraZ1	1803.6	+	3331	14572	36270	0.4017645
A06	39725838	39728664	A06p31310.2_BraZ1	918	+	226	2542	2826	0.8995046
A06	39727671	39728739	A06p31320.2_BraZ1	351	-	98	1033	1068	0.9672285
A06	39743086	39748140	A06p31330.2_BraZ1	1134	-	695	4357	5054	0.8620895
A06	39764201	39764640	A06p31340.2_BraZ1	288	+	30	371	439	0.8451025
A06	39764561	39772372	A06p31350.2_BraZ1	1011.38	+	89	2981	7811	0.3816413
A06	39769309	39782050	A06p31360.2_BraZ1	1281.25	+	403	6310	12741	0.4952515
A06	39779199	39780223	A06p31370.2_BraZ1	222	+	19	557	1024	0.5439453
A06	39781962	39783063	A06p31380.2_BraZ1	351	-	19	225	1101	0.2043597
A06	39782626	39782931	A06p31390.2_BraZ1	123	+	1	1	305	0.0032787
A06	39800657	39805636	A06p31400.2_BraZ1	1230	+	112	1652	4979	0.3317935
A06	39805078	39820693	A06p31410.2_BraZ1	665.143	+	330	6821	15615	0.4368236
A06	39820671	39821561	A06p31420.2_BraZ1	474	-	17	428	890	0.4808989
A06	39854614	39883835	A06p31430.2_BraZ1	1611	+	5035	23979	29221	0.8206084
A06	39855038	39858735	A06p31440.2_BraZ1	153	+	447	1866	3697	0.5047336
A06	39921129	39976767	A06p31450.2_BraZ1	276	-	2013	27992	55638	0.5031094
A06	40338311	40338901	A06p31460.2_BraZ1	273	+	11	370	590	0.6271186
A06	40379979	40381236	A06p31470.2_BraZ1	303	+	38	586	1257	0.4661893
A06	40454612	40465423	A06p31480.2_BraZ1	1083	+	87	3144	10811	0.2908149
A06	40592697	40596408	A06p31490.2_BraZ1	786	+	160	3264	3711	0.8795473
A06	40682970	40714919	A06p31500.2_BraZ1	548.857	+	1045	19565	31949	0.6123822
A06	40714956	40716223	A06p31510.2_BraZ1	381	+	40	971	1267	0.7663773
A06	40835061	40835367	A06p31520.2_BraZ1	17.1	+	44	279	306	0.9117647
A06	40835454	40836467	A06p31530.2_BraZ1	207	+	62	817	1013	0.8065153
A06	40899265	40900176	A06p31540.2_BraZ1	330	-	56	860	911	0.9440176
A06	41118176	41156219	A06p31550.2_BraZ1	1617	+	4379	31779	38043	0.8353442
A06	41192222	41193235	A06p31560.2_BraZ1	207	+	182	966	1013	0.9536031
A06	41365451	41372481	A06p31570.2_BraZ1	1198.11	+	1483	6459	7030	0.9187767
A06	41367061	41371175	A06p31580.2_BraZ1	550.4	-	1082	3994	4114	0.9708313
A06	41378403	41380114	A06p31590.2_BraZ1	693	+	587	1709	1711	0.9988311
A06	41403989	41404803	A06p31600.2_BraZ1	312	+	203	814	814	1.0000000
A06	41404147	41405659	A06p31610.2_BraZ1	363.6	+	204	1205	1512	0.7969577
A06	41405621	41410185	A06p31620.2_BraZ1	544	+	851	3965	4564	0.8687555
A06	41418838	41423936	A06p31630.2_BraZ1	1572	+	397	2362	5098	0.4633189
A06	41419462	41419852	A06p31640.2_BraZ1	180	+	185	390	390	1.0000000
A06	41431213	41439762	A06p31650.2_BraZ1	1066.67	+	911	7256	8549	0.8487542
A06	41439762	41450285	A06p31660.2_BraZ1	612.562	+	289	6639	10523	0.6309037
A06	41530077	41530197	A06p31670.2_BraZ1	12	-	6	97	120	0.8083333
A06	41530880	41531422	A06p31680.2_BraZ1	444	+	47	500	542	0.9225093
A06	41531939	41532824	A06p31690.2_BraZ1	441	-	1	10	885	0.0112994
A06	41533922	41542178	A06p31700.2_BraZ1	255	-	514	6443	8256	0.7804021
A06	41542861	41543416	A06p31710.2_BraZ1	1110	+	18	469	555	0.8450450
A06	41543933	41544818	A06p31720.2_BraZ1	465	-	120	872	885	0.9853107
A06	41609939	41610156	A06p31730.2_BraZ1	165	+	13	217	217	1.0000000
A06	41680441	41681183	A06p31740.2_BraZ1	294	-	21	503	742	0.6778976
A06	41681384	41723833	A06p31750.2_BraZ1	1104	-	2703	28555	42449	0.6726896
A06	41707641	41708579	A06p31760.2_BraZ1	576	+	111	779	938	0.8304904
A06	41724864	41726337	A06p31770.2_BraZ1	2992.5	+	162	1330	1473	0.9029192
A06	41746756	41760330	A06p31780.2_BraZ1	1341.21	+	1343	10228	13574	0.7534993
A06	41881796	41976371	A06p31790.2_BraZ1	470.167	-	11818	79168	94575	0.8370923
A06	41932791	41975320	A06p31800.2_BraZ1	198	-	6247	37007	42529	0.8701592
A06	42060086	42060942	A06p31810.2_BraZ1	282	+	27	607	856	0.7091122
A06	42060629	42071210	A06p31820.2_BraZ1	333	-	1766	10472	10581	0.9896985
A06	42060960	42069631	A06p31830.2_BraZ1	474	+	1409	8582	8671	0.9897359
A06	42070863	42072468	A06p31840.2_BraZ1	663	-	527	1605	1605	1.0000000
A06	42081190	42083277	A06p31850.2_BraZ1	662.75	-	630	2087	2087	1.0000000
A06	42089022	42092100	A06p31860.2_BraZ1	819	-	298	2567	3078	0.8339831
A06	42100021	42104181	A06p31870.2_BraZ1	609	-	954	4056	4160	0.9750000
A06	42109606	42109949	A06p31880.2_BraZ1	30.9	-	35	343	343	1.0000000
A06	42116836	42117019	A06p31890.2_BraZ1	18.3	+	1	18	183	0.0983607
A06	42120771	42122162	A06p31900.2_BraZ1	715.5	-	181	1391	1391	1.0000000
A06	42131977	42166113	A06p31910.2_BraZ1	690	-	10249	26329	34136	0.7712972
A06	42166166	42167024	A06p31920.2_BraZ1	445.5	+	352	858	858	1.0000000
A06	42167150	42181699	A06p31930.2_BraZ1	160.615	+	9755	14549	14549	1.0000000
A06	42168597	42169755	A06p31940.2_BraZ1	477	+	1166	1158	1158	1.0000000
A06	42179047	42179590	A06p31950.2_BraZ1	472.5	+	1451	543	543	1.0000000
A06	42182018	42183033	A06p31960.2_BraZ1	357	+	3877	1015	1015	1.0000000
A06	42184946	42185961	A06p31970.2_BraZ1	354	+	544	1015	1015	1.0000000
A06	42187503	42308564	A06p31980.2_BraZ1	1090.12	-	137627	114040	121061	0.9420044
A06	42202119	42203134	A06p31990.2_BraZ1	357	-	4720	1015	1015	1.0000000
A06	42225479	42234392	A06p32000.2_BraZ1	213	-	6578	8093	8913	0.9079996
A06	42225607	42226620	A06p32010.2_BraZ1	360	+	2938	1011	1013	0.9980257
A06	42234354	42234913	A06p32020.2_BraZ1	472.5	+	413	559	559	1.0000000
A06	42308564	42309419	A06p32030.2_BraZ1	375.375	+	406	783	855	0.9157895
A06	42310428	42317821	A06p32040.2_BraZ1	712	-	2837	6867	7393	0.9288516
A06	42317491	42318160	A06p32050.2_BraZ1	189	+	101	466	669	0.6965621
A06	42329417	42335613	A06p32060.2_BraZ1	356	-	2021	4506	6196	0.7272434
A06	42335606	42340064	A06p32070.2_BraZ1	1341	-	4164	4174	4458	0.9362943
A06	42362225	42363240	A06p32080.2_BraZ1	357	+	559	1015	1015	1.0000000
A06	42372820	42373036	A06p32090.2_BraZ1	21.6	+	0	0	216	0.0000000
A06	42379664	42380680	A06p32100.2_BraZ1	357	+	311	1016	1016	1.0000000
A06	42556878	42557278	A06p32110.2_BraZ1	264	-	12	345	400	0.8625000
A06	42557883	42558284	A06p32120.2_BraZ1	264	-	1	89	401	0.2219451
A06	42559834	42560519	A06p32130.2_BraZ1	216	-	2	254	685	0.3708029
A06	42561327	42561728	A06p32140.2_BraZ1	264	-	0	0	401	0.0000000
A06	42571824	42572698	A06p32150.2_BraZ1	432	-	124	874	874	1.0000000
A06	42572105	42572650	A06p32160.2_BraZ1	144	-	50	545	545	1.0000000
A06	42790782	42803420	A06p32170.2_BraZ1	333	+	9061	12022	12638	0.9512581
A06	42868597	42869490	A06p32180.2_BraZ1	516	-	376	893	893	1.0000000
A06	42869097	42966328	A06p32190.2_BraZ1	639	+	29079	96430	97231	0.9917619
A06	42882110	42893491	A06p32200.2_BraZ1	204	-	4374	11356	11381	0.9978033
A06	42964828	42967849	A06p32210.2_BraZ1	330	+	1014	3021	3021	1.0000000
A06	43125582	43126026	A06p32220.2_BraZ1	44.4	+	55	444	444	1.0000000
A06	43134028	43135101	A06p32230.2_BraZ1	267	+	60	1073	1073	1.0000000
A06	43135543	43153778	A06p32240.2_BraZ1	1941.35	-	916	12848	18235	0.7045791
A06	43140791	43143671	A06p32250.2_BraZ1	153	-	39	1630	2880	0.5659722
A06	43141058	43142897	A06p32260.2_BraZ1	246	+	28	1016	1839	0.5524741
A06	43186146	43186552	A06p32270.2_BraZ1	189	+	18	271	406	0.6674877
A06	43186725	43193022	A06p32280.2_BraZ1	1228.5	-	396	4259	6297	0.6763538
A06	43193943	43207353	A06p32290.2_BraZ1	633	+	1491	12739	13410	0.9499627
A06	43213102	43244878	A06p32300.2_BraZ1	723	-	5708	31289	31776	0.9846740
A06	43244891	43245041	A06p32310.2_BraZ1	15	+	42	150	150	1.0000000
A06	43313211	43315418	A06p32320.2_BraZ1	147	-	89	1181	2207	0.5351155
A06	43315806	43322065	A06p32330.2_BraZ1	915	-	413	4912	6259	0.7847899
A06	43317957	43318981	A06p32340.2_BraZ1	183	-	34	598	1024	0.5839844
A06	43322065	43324802	A06p32350.2_BraZ1	756.844	-	452	2678	2737	0.9784436
A06	43328661	43329729	A06p32360.2_BraZ1	273	-	112	1035	1068	0.9691011
A06	43350537	43351534	A06p32370.2_BraZ1	969.375	-	54	939	997	0.9418254
A06	43359759	43376483	A06p32380.2_BraZ1	1343.08	-	1630	12045	16724	0.7202224
A06	43371780	43377815	A06p32390.2_BraZ1	401.25	-	958	5839	6035	0.9675228
A06	43406862	43451919	A06p32400.2_BraZ1	591	+	7911	44382	45057	0.9850190
A06	43407568	43409866	A06p32410.2_BraZ1	387	-	215	2292	2298	0.9973890
A06	43408568	43410510	A06p32420.2_BraZ1	470.167	-	180	1942	1942	1.0000000
A06	43413264	43414403	A06p32430.2_BraZ1	652.5	-	174	1038	1139	0.9113258
A06	43486440	43507593	A06p32440.2_BraZ1	339	-	1648	17268	21153	0.8163381
A06	43511803	43516662	A06p32450.2_BraZ1	831	-	530	3773	4859	0.7764972
A06	43551187	43560157	A06p32460.2_BraZ1	738	+	607	7360	8970	0.8205128
A06	43553018	43556597	A06p32470.2_BraZ1	204	+	193	2793	3579	0.7803856
A06	43561002	43561729	A06p32480.2_BraZ1	243	-	152	727	727	1.0000000
A06	43579175	43582070	A06p32490.2_BraZ1	948	+	525	2874	2895	0.9927461
A06	43623213	43624128	A06p32500.2_BraZ1	288	-	114	869	915	0.9497268
A06	43624126	43638037	A06p32510.2_BraZ1	687	+	3232	13653	13911	0.9814535
A06	43663149	43669460	A06p32520.2_BraZ1	636	+	1021	6145	6311	0.9736967
A06	43673035	43673241	A06p32530.2_BraZ1	13.8	+	53	206	206	1.0000000
A06	43675867	43676302	A06p32540.2_BraZ1	285	+	62	435	435	1.0000000
A06	43690370	43691240	A06p32550.2_BraZ1	264	-	169	857	870	0.9850575
A06	43721273	43722115	A06p32560.2_BraZ1	306	+	88	842	842	1.0000000
A06	43724373	43730284	A06p32570.2_BraZ1	399	+	963	5804	5911	0.9818981
A06	44054736	44054988	A06p32580.2_BraZ1	25.2	+	0	0	252	0.0000000
A06	44085808	44086705	A06p32590.2_BraZ1	426	-	24	424	897	0.4726867
A06	44086077	44086657	A06p32600.2_BraZ1	144	-	24	376	580	0.6482759
A06	44301740	44303123	A06p32610.2_BraZ1	532	+	232	1362	1383	0.9848156
A06	44331724	44337948	A06p32620.2_BraZ1	303	+	405	4232	6224	0.6799486
A06	44332609	44336473	A06p32630.2_BraZ1	838.2	+	315	2782	3864	0.7199793
A06	44336667	44337604	A06p32640.2_BraZ1	237	+	36	826	937	0.8815368
A06	44340924	44348758	A06p32650.2_BraZ1	624	+	456	3285	7834	0.4193260
A06	44344833	44351069	A06p32660.2_BraZ1	636	+	591	4766	6236	0.7642720
A06	44359828	44367048	A06p32670.2_BraZ1	616.5	+	488	6074	7220	0.8412743
A06	44363114	44363681	A06p32680.2_BraZ1	210	-	49	534	567	0.9417989
A06	44367340	44368484	A06p32690.2_BraZ1	308	+	127	1123	1144	0.9816434
A06	44375880	44378579	A06p32700.2_BraZ1	1046.25	+	70	1239	2699	0.4590589
A06	44377596	44380104	A06p32710.2_BraZ1	228	+	2	171	2508	0.0681818
A06	44378157	44384028	A06p32720.2_BraZ1	228	-	216	2393	5871	0.4075966
A06	44380256	44383250	A06p32730.2_BraZ1	978.75	+	124	1444	2994	0.4822979
A06	44383244	44384226	A06p32740.2_BraZ1	426	+	99	924	982	0.9409369
A06	44392061	44393767	A06p32750.2_BraZ1	82.5	+	36	676	1706	0.3962485
A06	44413974	44463690	A06p32760.2_BraZ1	204	-	3546	33985	49716	0.6835827
A06	44483218	44483350	A06p32770.2_BraZ1	13.2	-	1	88	132	0.6666667
A06	44536885	44543240	A06p32780.2_BraZ1	495	+	597	5031	6355	0.7916601
A06	44543779	44545080	A06p32790.2_BraZ1	366	-	37	996	1301	0.7655650
A06	44544521	44588871	A06p32800.2_BraZ1	1668.55	+	4976	29291	44350	0.6604509
A06	44558846	44559756	A06p32810.2_BraZ1	255	-	58	808	910	0.8879121
A06	44588607	44589073	A06p32820.2_BraZ1	135	-	81	391	466	0.8390558
A06	44606009	44610328	A06p32830.2_BraZ1	249	-	790	4160	4319	0.9631859
A06	44940226	44947896	A06p32840.2_BraZ1	1224	+	1013	5859	7670	0.7638853
A06	44954287	44955970	A06p32850.2_BraZ1	258	-	14	460	1683	0.2733214
A06	44954778	44956763	A06p32860.2_BraZ1	492	+	18	885	1985	0.4458438
A06	44971071	44978844	A06p32870.2_BraZ1	1212	+	246	4223	7773	0.5432909
A06	44976280	44978755	A06p32880.2_BraZ1	222	-	32	1107	2475	0.4472727
A06	44979082	44983615	A06p32890.2_BraZ1	948	+	87	1858	4533	0.4098831
A06	44984009	44987939	A06p32900.2_BraZ1	501	+	191	2574	3930	0.6549618
A06	45003782	45004888	A06p32910.2_BraZ1	645	+	81	1083	1106	0.9792044
A06	45003837	45006911	A06p32920.2_BraZ1	210	-	159	2324	3074	0.7560182
A06	45005023	45006656	A06p32930.2_BraZ1	193.5	-	78	1156	1633	0.7078996
A06	45005196	45008646	A06p32940.2_BraZ1	645	+	96	1966	3450	0.5698551
A06	45005799	45006628	A06p32950.2_BraZ1	201	+	19	440	829	0.5307599
A06	45233453	45241283	A06p32960.2_BraZ1	375.375	-	17782	7256	7830	0.9266922
A06	45233975	45272888	A06p32970.2_BraZ1	216	+	32280	30328	38913	0.7793797
A06	45272206	45272763	A06p32980.2_BraZ1	472.5	-	409	557	557	1.0000000
A06	45272951	45273062	A06p32990.2_BraZ1	11.1	-	75	111	111	1.0000000
A06	45274140	45274938	A06p33000.2_BraZ1	344.167	+	67	722	798	0.9047619
A06	45298293	45299318	A06p33010.2_BraZ1	331.65	-	2667	1025	1025	1.0000000
A06	45300484	45301485	A06p33020.2_BraZ1	378	-	2961	1001	1001	1.0000000
A06	45303389	45304465	A06p33030.2_BraZ1	3056	+	1682	1076	1076	1.0000000
A06	45312872	45317458	A06p33040.2_BraZ1	2290.38	+	5715	4586	4586	1.0000000
A06	45325166	45325918	A06p33050.2_BraZ1	1023.75	-	222	737	752	0.9800532
A06	45339249	45340641	A06p33060.2_BraZ1	390.6	-	668	1376	1392	0.9885057
A06	45344289	45345215	A06p33070.2_BraZ1	299.722	+	770	926	926	1.0000000
A06	45345197	45346021	A06p33080.2_BraZ1	39	+	246	786	824	0.9538835
A06	45345758	45347013	A06p33090.2_BraZ1	707.933	+	308	1059	1255	0.8438247
A06	45355912	45361964	A06p33100.2_BraZ1	914.897	+	6296	6052	6052	1.0000000
A06	45356902	45357162	A06p33110.2_BraZ1	207	-	298	260	260	1.0000000
A06	45364941	45374636	A06p33120.2_BraZ1	4939.68	-	10627	9695	9695	1.0000000
A06	45377473	45378448	A06p33130.2_BraZ1	660	+	1331	975	975	1.0000000
A06	45378884	45383504	A06p33140.2_BraZ1	3503.91	-	4866	4620	4620	1.0000000
A06	45388355	45389604	A06p33150.2_BraZ1	142.545	-	1368	1249	1249	1.0000000
A06	45389963	45390128	A06p33160.2_BraZ1	16.5	-	123	165	165	1.0000000
A06	45390172	45390612	A06p33170.2_BraZ1	273	+	386	440	440	1.0000000
A06	45393732	45394144	A06p33180.2_BraZ1	21	+	640	412	412	1.0000000
A06	45402982	45404617	A06p33190.2_BraZ1	724	+	125	1483	1635	0.9070336
A06	45404980	45406261	A06p33200.2_BraZ1	366	+	11	680	1281	0.5308353
A06	45407431	45411608	A06p33210.2_BraZ1	119.7	-	547	3592	4177	0.8599473
A06	45412882	45417083	A06p33220.2_BraZ1	63	-	1100	4183	4201	0.9957153
A06	45417090	45418527	A06p33230.2_BraZ1	127.5	-	402	1370	1437	0.9533751
A06	45421981	45427872	A06p33240.2_BraZ1	1958.42	+	7776	5891	5891	1.0000000
A06	45444750	45447279	A06p33250.2_BraZ1	63.6	-	3409	2508	2529	0.9916963
A06	45502794	45505229	A06p33260.2_BraZ1	1408.82	+	2604	2435	2435	1.0000000
A06	45511725	45512191	A06p33270.2_BraZ1	384	+	646	466	466	1.0000000
A06	45512442	45515665	A06p33280.2_BraZ1	338.333	+	460	2640	3223	0.8191126
A06	45512612	45512907	A06p33290.2_BraZ1	207	-	86	295	295	1.0000000
A06	45515845	45516642	A06p33300.2_BraZ1	580.5	+	150	634	797	0.7954831
A06	45517078	45518842	A06p33310.2_BraZ1	873	+	256	1574	1764	0.8922902
A06	45518888	45519413	A06p33320.2_BraZ1	52.5	+	100	525	525	1.0000000
A06	45528684	45535311	A06p33330.2_BraZ1	3992.5	+	7298	6567	6627	0.9909461
A06	45535570	45535801	A06p33340.2_BraZ1	135	-	490	231	231	1.0000000
A06	45544622	45544907	A06p33350.2_BraZ1	219	-	678	285	285	1.0000000
A06	45544772	45545625	A06p33360.2_BraZ1	312	-	397	779	853	0.9132473
A06	45547522	45551223	A06p33370.2_BraZ1	1128.13	+	4657	3701	3701	1.0000000
A06	45563127	45563379	A06p33380.2_BraZ1	25.2	+	88	252	252	1.0000000
A06	45575714	45576063	A06p33390.2_BraZ1	336	-	497	349	349	1.0000000
A06	45582751	45586327	A06p33400.2_BraZ1	805.714	+	3725	3576	3576	1.0000000
A06	45643316	45645928	A06p33410.2_BraZ1	1621.3	-	2455	2612	2612	1.0000000
A06	45654182	45657251	A06p33420.2_BraZ1	1388.93	-	3768	3069	3069	1.0000000
A06	45748447	45749056	A06p33430.2_BraZ1	60.9	+	302	609	609	1.0000000
A06	45761608	45762862	A06p33440.2_BraZ1	125.4	-	1405	1254	1254	1.0000000
A06	45767810	45769892	A06p33450.2_BraZ1	208.2	-	2971	2082	2082	1.0000000
A06	45777747	45778298	A06p33460.2_BraZ1	372	+	450	551	551	1.0000000
A06	45819977	45830985	A06p33470.2_BraZ1	2650.03	+	4183	9059	11008	0.8229470
A06	45848923	45849574	A06p33480.2_BraZ1	138.958	-	1	69	651	0.1059908
A06	45849523	45850536	A06p33490.2_BraZ1	410.75	-	47	653	1013	0.6446199
A06	45851836	45851980	A06p33500.2_BraZ1	14.4	+	280	144	144	1.0000000
A06	45857844	45859185	A06p33510.2_BraZ1	648.615	+	719	1167	1341	0.8702461
A06	45859762	45860272	A06p33520.2_BraZ1	51	-	378	510	510	1.0000000
A06	45863174	45863519	A06p33530.2_BraZ1	34.5	-	149	301	345	0.8724638
A06	45863812	45864907	A06p33540.2_BraZ1	1540.5	+	50	650	1095	0.5936073
A06	45867298	45867811	A06p33550.2_BraZ1	51.3	-	717	513	513	1.0000000
A06	45904698	45906588	A06p33560.2_BraZ1	857.675	+	1685	1890	1890	1.0000000
A06	45922115	45924434	A06p33570.2_BraZ1	1344	-	575	1925	2319	0.8300992
A06	45959496	45967132	A06p33580.2_BraZ1	695.933	+	2300	6868	7636	0.8994238
A06	45985591	45987202	A06p33590.2_BraZ1	116613	+	69	989	1611	0.6139044
A06	46002470	46003207	A06p33600.2_BraZ1	314.313	+	362	737	737	1.0000000
A06	46014557	46023654	A06p33610.2_BraZ1	310.841	-	4300	8764	9097	0.9633945
A06	46046765	46049850	A06p33620.2_BraZ1	1347	-	109	1127	3085	0.3653160
A06	46050023	46050200	A06p33630.2_BraZ1	17.7	+	6	22	177	0.1242938
A06	46064746	46065463	A06p33640.2_BraZ1	450	-	580	717	717	1.0000000
A06	46065720	46067078	A06p33650.2_BraZ1	4878	-	157	1010	1358	0.7437408
A06	46068121	46069731	A06p33660.2_BraZ1	97754.2	-	156	1016	1610	0.6310559
A06	46075916	46076228	A06p33670.2_BraZ1	31.2	-	38	303	312	0.9711539
A06	46087490	46089135	A06p33680.2_BraZ1	3187.8	-	2066	1645	1645	1.0000000
A06	46126034	46127176	A06p33690.2_BraZ1	440	-	957	1142	1142	1.0000000
A06	46130090	46130732	A06p33700.2_BraZ1	64.2	-	925	642	642	1.0000000
A06	46143671	46144241	A06p33710.2_BraZ1	318	+	10	45	570	0.0789474
A06	46146915	46147585	A06p33720.2_BraZ1	315	+	15	311	670	0.4641791
A06	46150128	46150329	A06p33730.2_BraZ1	20.1	-	74	201	201	1.0000000
A06	46151306	46151450	A06p33740.2_BraZ1	14.4	-	0	0	144	0.0000000
A06	46165398	46165593	A06p33750.2_BraZ1	19.5	-	331	195	195	1.0000000
A06	46170355	46170627	A06p33760.2_BraZ1	21.9	+	14	193	272	0.7095588
A06	46171020	46173344	A06p33770.2_BraZ1	459	-	247	1849	2324	0.7956110
A06	46175900	46178822	A06p33780.2_BraZ1	1334.63	-	3233	2922	2922	1.0000000
A06	46189739	46189891	A06p33790.2_BraZ1	10.8	+	257	152	152	1.0000000
A06	46192425	46193877	A06p33800.2_BraZ1	145.2	+	46	144	1452	0.0991736
A06	46196463	46198172	A06p33810.2_BraZ1	107.7	+	820	1166	1709	0.6822703
A06	46215009	46226504	A06p33820.2_BraZ1	663	-	5614	10485	11495	0.9121357
A06	46246599	46250566	A06p33830.2_BraZ1	898.012	+	3405	3967	3967	1.0000000
A06	46288951	46289509	A06p33840.2_BraZ1	55.8	-	653	558	558	1.0000000
A06	46299644	46300681	A06p33850.2_BraZ1	256.029	+	1544	1037	1037	1.0000000
A06	46303165	46303751	A06p33860.2_BraZ1	2400	+	691	586	586	1.0000000
A06	46304209	46305970	A06p33870.2_BraZ1	176.1	-	220	1134	1761	0.6439523
A06	46310665	46310961	A06p33880.2_BraZ1	15.6	+	321	296	296	1.0000000
A06	46312406	46313974	A06p33890.2_BraZ1	824.022	+	661	1470	1568	0.9375000
A06	46318021	46319051	A06p33900.2_BraZ1	661.304	+	114	841	1030	0.8165048
A06	46319503	46320156	A06p33910.2_BraZ1	530.875	+	338	653	653	1.0000000
A06	46328551	46332044	A06p33920.2_BraZ1	2633.32	+	2428	3060	3493	0.8760378
A06	46337699	46338306	A06p33930.2_BraZ1	294	+	214	607	607	1.0000000
A06	46338360	46338638	A06p33940.2_BraZ1	23.1	+	47	227	278	0.8165467
A06	46339650	46344180	A06p33950.2_BraZ1	2315.54	+	1305	3582	4530	0.7907284
A06	46344619	46345381	A06p33960.2_BraZ1	566.633	-	309	747	762	0.9803150
A06	46347718	46348349	A06p33970.2_BraZ1	213	+	1298	631	631	1.0000000
A06	46351580	46352389	A06p33980.2_BraZ1	175.5	+	88	674	809	0.8331273
A06	46355656	46357187	A06p33990.2_BraZ1	795.621	-	7	82	1531	0.0535598
A06	46360561	46361709	A06p34000.2_BraZ1	1014	-	473	1088	1148	0.9477352
A06	46370927	46373463	A06p34010.2_BraZ1	1825.62	-	175	1417	2536	0.5587540
A06	46375099	46375744	A06p34020.2_BraZ1	387	+	162	645	645	1.0000000
A06	46375795	46376228	A06p34030.2_BraZ1	315	+	332	433	433	1.0000000
A06	46376441	46376630	A06p34040.2_BraZ1	18.9	+	9	123	189	0.6507937
A06	46383456	46386093	A06p34050.2_BraZ1	1414.88	-	290	2461	2637	0.9332575
A06	46388129	46388983	A06p34060.2_BraZ1	2025	-	291	854	854	1.0000000
A06	46400344	46401971	A06p34070.2_BraZ1	577.53	-	133	1314	1627	0.8076214
A06	46417369	46419321	A06p34080.2_BraZ1	792	+	63	1040	1952	0.5327869
A06	46418305	46418494	A06p34090.2_BraZ1	129	+	2	175	189	0.9259259
A06	46422041	46422995	A06p34100.2_BraZ1	196.364	+	941	954	954	1.0000000
A06	46424158	46424810	A06p34110.2_BraZ1	257.464	+	103	652	652	1.0000000
A06	46430643	46434066	A06p34120.2_BraZ1	1448.47	-	211	1340	3423	0.3914695
A06	46434735	46434981	A06p34130.2_BraZ1	24.6	-	109	246	246	1.0000000
A06	46437484	46438104	A06p34140.2_BraZ1	207	-	172	611	620	0.9854839
A06	46445141	46445672	A06p34150.2_BraZ1	228	-	58	71	531	0.1337100
A06	46446843	46448587	A06p34160.2_BraZ1	315	-	1482	1534	1744	0.8795872
A06	46449667	46473713	A06p34170.2_BraZ1	833.7	+	1022	9214	24046	0.3831822
A06	46473817	46475714	A06p34180.2_BraZ1	598.42	+	6	314	1897	0.1655245
A06	46494100	46494399	A06p34190.2_BraZ1	23.1	+	2	108	299	0.3612040
A06	46507669	46509963	A06p34200.2_BraZ1	838.929	+	1358	2201	2294	0.9594595
A06	46512926	46516725	A06p34210.2_BraZ1	545.882	+	2647	3799	3799	1.0000000
A06	46519354	46519687	A06p34220.2_BraZ1	186	-	117	333	333	1.0000000
A06	46549247	46551071	A06p34230.2_BraZ1	182.4	-	460	1171	1824	0.6419956
A06	46552797	46552974	A06p34240.2_BraZ1	17.7	-	0	0	177	0.0000000
A06	46555591	46555750	A06p34250.2_BraZ1	15.9	-	0	0	159	0.0000000
A06	46556203	46556614	A06p34260.2_BraZ1	243	-	7	133	411	0.3236010
A06	46558213	46560700	A06p34270.2_BraZ1	1252.36	-	634	2317	2487	0.9316446
A06	46566235	46567868	A06p34280.2_BraZ1	7473.38	+	770	1633	1633	1.0000000
A06	46568591	46569794	A06p34290.2_BraZ1	566.222	-	661	1144	1203	0.9509559
A06	46570488	46571687	A06p34300.2_BraZ1	1596	+	1296	1199	1199	1.0000000
A06	46572187	46573947	A06p34310.2_BraZ1	1008.48	-	536	1472	1760	0.8363636
A06	46585175	46590212	A06p34320.2_BraZ1	197.625	-	2405	4388	5037	0.8711535
A06	46593485	46598450	A06p34330.2_BraZ1	686.4	+	644	3660	4965	0.7371601
A06	46596936	46597430	A06p34340.2_BraZ1	286.125	+	130	494	494	1.0000000
A06	46599072	46600791	A06p34350.2_BraZ1	704.25	+	363	1687	1719	0.9813845
A06	46611258	46612624	A06p34360.2_BraZ1	12287.2	+	157	1056	1366	0.7730600
A06	46624736	46629213	A06p34370.2_BraZ1	2591.13	+	1294	4161	4477	0.9294170
A06	46630627	46632128	A06p34380.2_BraZ1	454.588	-	301	1201	1501	0.8001332
A06	46637478	46638906	A06p34390.2_BraZ1	142.8	+	220	836	1428	0.5854342
A06	46652579	46653456	A06p34400.2_BraZ1	363	-	1068	877	877	1.0000000
A06	46658703	46660398	A06p34410.2_BraZ1	169.5	-	601	1606	1695	0.9474926
A06	46663997	46665506	A06p34420.2_BraZ1	150.9	-	653	1509	1509	1.0000000
A06	46668843	46669119	A06p34430.2_BraZ1	27.6	-	747	276	276	1.0000000
A06	46669680	46671464	A06p34440.2_BraZ1	453	+	43	1064	1784	0.5964125
A06	46683937	46684938	A06p34450.2_BraZ1	525	-	448	776	1001	0.7752248
A06	46691340	46691854	A06p34460.2_BraZ1	45.3	-	121	473	514	0.9202335
A06	46698583	46699135	A06p34470.2_BraZ1	339	-	0	0	552	0.0000000
A06	46702775	46706647	A06p34480.2_BraZ1	849.943	+	1768	3425	3872	0.8845558
A06	46721385	46722019	A06p34490.2_BraZ1	183	+	456	634	634	1.0000000
A06	46732830	46733677	A06p34500.2_BraZ1	585	-	1156	847	847	1.0000000
A06	46733677	46733939	A06p34510.2_BraZ1	150	-	363	262	262	1.0000000
A06	46740370	46742794	A06p34520.2_BraZ1	11430	-	619	1577	2424	0.6505775
A06	46743854	46744064	A06p34530.2_BraZ1	21	+	6	104	210	0.4952381
A06	46745439	46747758	A06p34540.2_BraZ1	1421.95	+	655	2069	2319	0.8921949
A06	46754938	46755910	A06p34550.2_BraZ1	97.2	-	22	199	972	0.2047325
A06	46758507	46758670	A06p34560.2_BraZ1	150	+	2	68	163	0.4171779
A06	46771946	46772126	A06p34570.2_BraZ1	18	-	328	180	180	1.0000000
A06	46775349	46778030	A06p34580.2_BraZ1	865.396	+	1867	2559	2681	0.9544946
A06	46780116	46782514	A06p34590.2_BraZ1	746.778	-	561	2062	2398	0.8598832
A06	46818289	46821375	A06p34600.2_BraZ1	204	-	3123	2721	3086	0.8817239
A06	46822964	46824747	A06p34610.2_BraZ1	1230.87	+	501	1320	1783	0.7403253
A06	46826756	46826932	A06p34620.2_BraZ1	16.8	-	111	176	176	1.0000000
A06	46828734	46829002	A06p34630.2_BraZ1	249	+	627	268	268	1.0000000
A06	46840563	46841214	A06p34640.2_BraZ1	65.1	-	7	187	651	0.2872504
A06	46843748	46851914	A06p34650.2_BraZ1	1323	+	5136	7315	8166	0.8957874
A06	46848934	46849585	A06p34660.2_BraZ1	65.1	-	26	372	651	0.5714286
A06	46860346	46860761	A06p34670.2_BraZ1	216	+	474	415	415	1.0000000
A06	46861584	46862019	A06p34680.2_BraZ1	43.5	+	379	435	435	1.0000000
A06	46863950	46865607	A06p34690.2_BraZ1	393.571	+	2187	1637	1657	0.9879300
A06	46869928	46870487	A06p34700.2_BraZ1	363	-	152	535	559	0.9570662
A06	46872791	46875316	A06p34710.2_BraZ1	1375.5	+	1226	2010	2525	0.7960396
A06	46882738	46887507	A06p34720.2_BraZ1	1177.25	+	1176	3370	4769	0.7066471
A06	46883478	46883996	A06p34730.2_BraZ1	326.7	-	458	518	518	1.0000000
A06	46892039	46892327	A06p34740.2_BraZ1	28.8	-	294	288	288	1.0000000
A06	46893060	46896005	A06p34750.2_BraZ1	1107.63	-	1518	2770	2945	0.9405773
A06	46898138	46898503	A06p34760.2_BraZ1	306	+	271	365	365	1.0000000
A06	46900297	46902342	A06p34770.2_BraZ1	1041.16	-	338	1749	2045	0.8552567
A06	46912973	46917150	A06p34780.2_BraZ1	675	+	1584	3477	4177	0.8324156
A06	46917927	46919124	A06p34790.2_BraZ1	119.7	-	72	846	1197	0.7067669
A06	46920122	46920339	A06p34800.2_BraZ1	16.2	+	163	217	217	1.0000000
A06	46922525	46925198	A06p34810.2_BraZ1	1483.09	+	1918	2673	2673	1.0000000
A06	46926623	46927500	A06p34820.2_BraZ1	608.262	-	361	877	877	1.0000000
A06	46929318	46943230	A06p34830.2_BraZ1	2491.88	+	29761	10970	13912	0.7885279
A06	46945255	46949607	A06p34840.2_BraZ1	2044.31	-	1197	4088	4352	0.9393382
A06	46954437	46955316	A06p34850.2_BraZ1	426	+	80	330	879	0.3754266
A06	46956934	46957542	A06p34860.2_BraZ1	186	-	170	599	608	0.9851974
A06	46957600	46958279	A06p34870.2_BraZ1	354.375	-	273	679	679	1.0000000
A06	46962002	46962849	A06p34880.2_BraZ1	302.095	+	440	841	847	0.9929162
A06	46965676	46966776	A06p34890.2_BraZ1	447	+	621	1100	1100	1.0000000
A06	46994288	46996876	A06p34900.2_BraZ1	1278	+	1830	2588	2588	1.0000000
A06	47002784	47011585	A06p34910.2_BraZ1	1458	-	8898	8074	8801	0.9173958
A06	47038309	47042839	A06p34920.2_BraZ1	1776	+	11300	3410	4530	0.7527594
A06	47054218	47054869	A06p34930.2_BraZ1	65.1	+	395	651	651	1.0000000
A06	47063497	47064183	A06p34940.2_BraZ1	174	+	806	533	686	0.7769679
A06	47067450	47068053	A06p34950.2_BraZ1	360	+	211	493	603	0.8175788
A06	47071289	47073140	A06p34960.2_BraZ1	185.1	+	413	1633	1851	0.8822258
A06	47073720	47078356	A06p34970.2_BraZ1	878	-	2469	4556	4636	0.9827437
A06	47083348	47083822	A06p34980.2_BraZ1	47.4	-	1094	474	474	1.0000000
A06	47087090	47091231	A06p34990.2_BraZ1	1337.13	+	1047	2976	4141	0.7186670
A06	47092037	47093133	A06p35000.2_BraZ1	154.5	+	1085	1096	1096	1.0000000
A06	47097311	47110427	A06p35010.2_BraZ1	1342.97	-	9681	11721	13116	0.8936414
A06	47120503	47123486	A06p35020.2_BraZ1	1726.21	-	357	1979	2983	0.6634261
A06	47125544	47127910	A06p35030.2_BraZ1	993.429	-	829	2359	2366	0.9970414
A06	47136208	47149577	A06p35040.2_BraZ1	943.016	+	6696	12282	13369	0.9186925
A06	47153133	47154221	A06p35050.2_BraZ1	798	-	386	1070	1088	0.9834559
A06	47154756	47158205	A06p35060.2_BraZ1	2192.01	-	2432	3401	3449	0.9860829
A06	47161199	47162926	A06p35070.2_BraZ1	1027.9	-	886	1727	1727	1.0000000
A06	47165991	47166411	A06p35080.2_BraZ1	42	+	29	288	420	0.6857143
A06	47170980	47171422	A06p35090.2_BraZ1	43.8	+	102	411	442	0.9298642
A06	47175008	47176937	A06p35100.2_BraZ1	5583.6	+	897	1871	1929	0.9699326
A06	47177519	47182571	A06p35110.2_BraZ1	2362.28	-	2558	4962	5052	0.9821852
A06	47189496	47190002	A06p35120.2_BraZ1	411	+	0	0	506	0.0000000
A06	47198684	47199776	A06p35130.2_BraZ1	837	-	831	876	1092	0.8021978
A06	47200419	47201168	A06p35140.2_BraZ1	366	-	327	733	749	0.9786382
A06	47204043	47205428	A06p35150.2_BraZ1	514.8	-	805	1382	1385	0.9978339
A06	47206854	47210636	A06p35160.2_BraZ1	2230	-	1175	3448	3782	0.9116870
A06	47217421	47218210	A06p35170.2_BraZ1	485	-	164	787	789	0.9974651
A06	47222798	47224291	A06p35180.2_BraZ1	1325.25	+	485	1460	1493	0.9778969
A06	47227480	47228382	A06p35190.2_BraZ1	453	+	713	754	902	0.8359202
A06	47232873	47237027	A06p35200.2_BraZ1	1803.26	-	1627	3923	4154	0.9443910
A06	47252412	47252829	A06p35210.2_BraZ1	186	+	72	417	417	1.0000000
A06	47253228	47254063	A06p35220.2_BraZ1	672	-	561	822	835	0.9844311
A06	47254118	47257787	A06p35230.2_BraZ1	2402.62	-	481	2768	3669	0.7544290
A06	47259246	47260379	A06p35240.2_BraZ1	954	+	395	1055	1133	0.9311562
A06	47261349	47261563	A06p35250.2_BraZ1	135	-	273	214	214	1.0000000
A06	47263396	47264859	A06p35260.2_BraZ1	1012.34	+	238	1213	1463	0.8291183
A06	47267440	47272053	A06p35270.2_BraZ1	2903.34	+	223	2299	4613	0.4983742
A06	47273368	47274157	A06p35280.2_BraZ1	485	+	280	789	789	1.0000000
A06	47284470	47286851	A06p35290.2_BraZ1	1640.03	-	405	1716	2381	0.7207056
A06	47287407	47288898	A06p35300.2_BraZ1	149.1	-	469	1329	1491	0.8913481
A06	47289047	47290800	A06p35310.2_BraZ1	1434	-	281	1452	1753	0.8282943
A06	47296699	47298398	A06p35320.2_BraZ1	1224.5	-	1876	1699	1699	1.0000000
A06	47299401	47300592	A06p35330.2_BraZ1	744	+	621	1191	1191	1.0000000
A06	47300774	47302444	A06p35340.2_BraZ1	1153.68	-	496	1387	1670	0.8305389
A06	47309764	47311356	A06p35350.2_BraZ1	225	-	385	953	1592	0.5986181
A06	47310227	47311313	A06p35360.2_BraZ1	885	+	150	793	1086	0.7302026
A06	47311738	47312257	A06p35370.2_BraZ1	303	+	40	319	519	0.6146436
A06	47314665	47315485	A06p35380.2_BraZ1	789	+	120	714	820	0.8707317
A06	47318021	47319085	A06p35390.2_BraZ1	369	-	605	1064	1064	1.0000000
A06	47327762	47330519	A06p35400.2_BraZ1	1290.88	+	1294	2529	2757	0.9173014
A06	47334993	47335588	A06p35410.2_BraZ1	132	-	150	595	595	1.0000000
A06	47335396	47335968	A06p35420.2_BraZ1	472.65	-	216	572	572	1.0000000
A06	47336410	47338374	A06p35430.2_BraZ1	1016.44	+	851	1514	1964	0.7708758
A06	47339177	47339727	A06p35440.2_BraZ1	222	+	169	550	550	1.0000000
A06	47345194	47346255	A06p35450.2_BraZ1	6498	-	967	1045	1061	0.9849199
A06	47350569	47351667	A06p35460.2_BraZ1	492	+	625	1098	1098	1.0000000
A06	47351667	47351851	A06p35470.2_BraZ1	66.6	+	89	184	184	1.0000000
A06	47359031	47359363	A06p35480.2_BraZ1	19.2	+	0	0	332	0.0000000
A06	47359486	47360451	A06p35490.2_BraZ1	622.2	+	6	26	965	0.0269430
A06	47361781	47368153	A06p35500.2_BraZ1	1063.87	-	3806	5275	6372	0.8278406
A06	47368153	47368749	A06p35510.2_BraZ1	33.3	-	656	595	596	0.9983221
A06	47369353	47370106	A06p35520.2_BraZ1	678	+	287	744	753	0.9880478
A06	47372052	47376603	A06p35530.2_BraZ1	1884.65	-	322	2904	4551	0.6381015
A06	47386646	47387479	A06p35540.2_BraZ1	156	-	566	833	833	1.0000000
A06	47387591	47388144	A06p35550.2_BraZ1	438	+	76	492	553	0.8896926
A06	47389266	47389959	A06p35560.2_BraZ1	270	-	604	693	693	1.0000000
A06	47389959	47390891	A06p35570.2_BraZ1	873	-	825	932	932	1.0000000
A06	47396884	47397247	A06p35580.2_BraZ1	36.3	+	879	363	363	1.0000000
A06	47400093	47403996	A06p35590.2_BraZ1	1730.83	+	662	3368	3903	0.8629259
A06	47405065	47409120	A06p35600.2_BraZ1	2067.61	+	1235	3859	4055	0.9516646
A06	47410203	47413134	A06p35610.2_BraZ1	293.1	-	229	1392	2931	0.4749232
A06	47425194	47425325	A06p35620.2_BraZ1	11.4	-	24	131	131	1.0000000
A06	47427741	47431457	A06p35630.2_BraZ1	2370.01	+	686	3072	3716	0.8266954
A06	47433157	47434159	A06p35640.2_BraZ1	8181	+	76	787	1002	0.7854291
A06	47436577	47436998	A06p35650.2_BraZ1	144	-	980	421	421	1.0000000
A06	47436683	47436921	A06p35660.2_BraZ1	204	-	726	238	238	1.0000000
A06	47445298	47446651	A06p35670.2_BraZ1	135.3	+	271	1269	1353	0.9379157
A06	47455637	47456631	A06p35680.2_BraZ1	599.04	+	202	916	994	0.9215292
A06	47457038	47460129	A06p35690.2_BraZ1	1250.79	-	1027	2983	3091	0.9650599
A06	47460748	47461274	A06p35700.2_BraZ1	447	+	406	526	526	1.0000000
A06	47461438	47464263	A06p35710.2_BraZ1	12411	-	525	2584	2825	0.9146903
A06	47478984	47482935	A06p35720.2_BraZ1	3168	-	1633	3896	3951	0.9860795
A06	47499598	47500605	A06p35730.2_BraZ1	918	-	105	844	1007	0.8381331
A06	47502393	47513716	A06p35740.2_BraZ1	387	+	4654	11275	11323	0.9957609
A06	47512601	47513055	A06p35750.2_BraZ1	390	+	568	454	454	1.0000000
A06	47513951	47514583	A06p35760.2_BraZ1	1207.8	+	376	632	632	1.0000000
A06	47522616	47523157	A06p35770.2_BraZ1	453	+	78	409	541	0.7560074
A06	47529040	47529582	A06p35780.2_BraZ1	255	-	367	542	542	1.0000000
A06	47529868	47538522	A06p35790.2_BraZ1	704	+	11246	8654	8654	1.0000000
A06	47543592	47545627	A06p35800.2_BraZ1	3114	-	776	1844	2035	0.9061425
A06	47547576	47555869	A06p35810.2_BraZ1	454.25	-	10066	8246	8293	0.9943326
A06	47557515	47558392	A06p35820.2_BraZ1	306	+	188	742	877	0.8460661
A06	47560891	47561035	A06p35830.2_BraZ1	14.4	-	266	126	144	0.8750000
A06	47562023	47562203	A06p35840.2_BraZ1	18	-	31	86	180	0.4777778
A06	47576495	47577739	A06p35850.2_BraZ1	1010.09	+	74	858	1244	0.6897106
A06	47602287	47606978	A06p35860.2_BraZ1	477.273	+	4497	4691	4691	1.0000000
A06	47640222	47642621	A06p35870.2_BraZ1	1804.73	-	689	2291	2399	0.9549813
A06	47666211	47668918	A06p35880.2_BraZ1	1128	-	710	1950	2707	0.7203546
A06	47669641	47671542	A06p35890.2_BraZ1	13041	+	415	1777	1901	0.9347712
A06	47678712	47679180	A06p35900.2_BraZ1	120	+	2	151	468	0.3226496
A06	47681452	47683049	A06p35910.2_BraZ1	873	+	44	456	1597	0.2855354
A06	47686513	47688107	A06p35920.2_BraZ1	870	+	23	503	1594	0.3155583
A06	47694979	47696554	A06p35930.2_BraZ1	157.5	-	123	638	1575	0.4050794
A06	47722275	47723579	A06p35940.2_BraZ1	3112.2	+	12	672	1304	0.5153374
A06	47737381	47742738	A06p35950.2_BraZ1	2755.08	+	3083	5199	5357	0.9705059
A06	47743171	47745322	A06p35960.2_BraZ1	935	-	1360	2086	2151	0.9697815
A06	47746173	47748464	A06p35970.2_BraZ1	1511.98	+	744	2161	2291	0.9432562
A06	47751297	47753319	A06p35980.2_BraZ1	1185.17	+	980	2022	2022	1.0000000
A06	47755357	47756691	A06p35990.2_BraZ1	1155	+	461	1246	1334	0.9340330
A06	47758833	47760191	A06p36000.2_BraZ1	690	+	827	1358	1358	1.0000000
A06	47766047	47766806	A06p36010.2_BraZ1	75.9	+	1	79	759	0.1040843
A06	47766997	47768645	A06p36020.2_BraZ1	675	+	1239	1648	1648	1.0000000
A06	47770710	47771308	A06p36030.2_BraZ1	1698.55	+	42	548	598	0.9163880
A06	47774255	47781655	A06p36040.2_BraZ1	3237.24	+	3813	6450	7400	0.8716216
A06	47782691	47783653	A06p36050.2_BraZ1	723	-	12	192	962	0.1995842
A06	47789192	47789795	A06p36060.2_BraZ1	48	-	233	603	603	1.0000000
A06	47789672	47791421	A06p36070.2_BraZ1	32.4	-	451	1722	1749	0.9845626
A06	47799515	47815985	A06p36080.2_BraZ1	1206	+	7320	13127	16470	0.7970249
A06	47818904	47819087	A06p36090.2_BraZ1	18.3	+	211	183	183	1.0000000
A06	47819215	47819497	A06p36100.2_BraZ1	28.2	-	421	282	282	1.0000000
A06	47828184	47828891	A06p36110.2_BraZ1	195	-	441	707	707	1.0000000
A06	47828891	47829576	A06p36120.2_BraZ1	312	-	687	685	685	1.0000000
A06	47834328	47842189	A06p36130.2_BraZ1	2458.13	+	1561	4854	7861	0.6174787
A06	47846208	47847760	A06p36140.2_BraZ1	951	+	26	468	1552	0.3015464
A06	47849450	47850487	A06p36150.2_BraZ1	342	-	528	971	1037	0.9363549
A06	47851654	47853086	A06p36160.2_BraZ1	822	-	739	1390	1432	0.9706704
A06	47855046	47856118	A06p36170.2_BraZ1	612	-	339	821	1072	0.7658582
A06	47868490	47869839	A06p36180.2_BraZ1	621	+	93	735	1349	0.5448480
A06	47870710	47871091	A06p36190.2_BraZ1	38.1	+	33	353	381	0.9265092
A06	47873357	47873784	A06p36200.2_BraZ1	201	+	366	427	427	1.0000000
A06	47873789	47875274	A06p36210.2_BraZ1	833.783	+	514	1448	1485	0.9750842
A06	47878713	47880123	A06p36220.2_BraZ1	1103.14	-	162	1048	1410	0.7432624
A06	47905954	47907417	A06p36230.2_BraZ1	709.565	+	884	1463	1463	1.0000000
A06	47907573	47908278	A06p36240.2_BraZ1	70.5	-	343	683	705	0.9687943
A06	47908913	47909970	A06p36250.2_BraZ1	1216.8	+	572	1057	1057	1.0000000
A06	47911600	47913066	A06p36260.2_BraZ1	598.778	+	191	1387	1466	0.9461119
A06	47914556	47915211	A06p36270.2_BraZ1	306	-	733	655	655	1.0000000
A06	47920656	47922359	A06p36280.2_BraZ1	673.81	+	1020	1703	1703	1.0000000
A06	47922648	47925230	A06p36290.2_BraZ1	237.15	-	2227	2582	2582	1.0000000
A06	47926508	47929029	A06p36300.2_BraZ1	398	+	1379	1911	2521	0.7580325
A06	47931893	47933683	A06p36310.2_BraZ1	13300	+	1681	1789	1790	0.9994413
A06	47935297	47937245	A06p36320.2_BraZ1	621.5	-	262	1460	1948	0.7494866
A06	47939241	47943221	A06p36330.2_BraZ1	273	-	1947	2812	3980	0.7065327
A06	47944584	47945753	A06p36340.2_BraZ1	936	+	425	1156	1169	0.9888794
A06	47946298	47949442	A06p36350.2_BraZ1	1490.37	-	1609	3104	3144	0.9872773
A06	47950515	47951219	A06p36360.2_BraZ1	288	+	479	704	704	1.0000000
A06	47951768	47953314	A06p36370.2_BraZ1	907.923	-	792	1528	1546	0.9883571
A06	47961186	47963538	A06p36380.2_BraZ1	1303.71	+	856	2235	2352	0.9502551
A06	47967795	47969924	A06p36390.2_BraZ1	1963.33	+	814	1889	2129	0.8872710
A06	47971496	47979305	A06p36400.2_BraZ1	2595.88	-	891	4653	7809	0.5958509
A06	47983663	47986148	A06p36410.2_BraZ1	1693.41	+	829	2306	2485	0.9279678
A06	47987020	47987589	A06p36420.2_BraZ1	393	+	28	451	569	0.7926186
A06	47993480	47993946	A06p36430.2_BraZ1	291	+	313	466	466	1.0000000
A06	47995622	47998207	A06p36440.2_BraZ1	1832.16	-	534	1924	2585	0.7442940
A06	48001902	48002216	A06p36450.2_BraZ1	171	+	10	224	314	0.7133758
A06	48003306	48006069	A06p36460.2_BraZ1	1307.72	-	1493	2640	2763	0.9554832
A06	48006492	48009452	A06p36470.2_BraZ1	1420.85	-	740	2351	2960	0.7942567
A06	48010355	48025410	A06p36480.2_BraZ1	217.8	-	7569	11907	15055	0.7909001
A06	48021664	48024036	A06p36490.2_BraZ1	1727.55	-	272	1723	2372	0.7263913
A06	48028449	48028641	A06p36500.2_BraZ1	19.2	+	289	192	192	1.0000000
A06	48043156	48044422	A06p36510.2_BraZ1	1194	-	22	70	1266	0.0552923
A06	48060264	48060953	A06p36520.2_BraZ1	234	+	1062	689	689	1.0000000
A06	48065646	48067851	A06p36530.2_BraZ1	5715.42	+	1207	2028	2205	0.9197279
A06	48068902	48071694	A06p36540.2_BraZ1	1096.5	+	1068	2608	2792	0.9340974
A06	48073183	48085774	A06p36550.2_BraZ1	1606.21	+	2772	10096	12591	0.8018426
A06	48087245	48088402	A06p36560.2_BraZ1	760.32	+	357	1156	1157	0.9991357
A06	48089725	48094867	A06p36570.2_BraZ1	1585.4	-	1479	4592	5142	0.8930377
A06	48095091	48095409	A06p36580.2_BraZ1	31.8	-	69	318	318	1.0000000
A06	48095602	48095836	A06p36590.2_BraZ1	23.4	-	526	234	234	1.0000000
A06	48100839	48101721	A06p36600.2_BraZ1	867	+	240	713	882	0.8083900
A06	48108161	48110901	A06p36610.2_BraZ1	1317.69	-	851	2528	2740	0.9226277
A06	48114144	48117563	A06p36620.2_BraZ1	1402.59	+	1383	3375	3419	0.9871308
A06	48117883	48118884	A06p36630.2_BraZ1	855	-	271	916	1001	0.9150849
A06	48123105	48124274	A06p36640.2_BraZ1	865.682	-	1597	1169	1169	1.0000000
A06	48126781	48127330	A06p36650.2_BraZ1	54.9	+	2	25	549	0.0455373
A06	48128476	48128803	A06p36660.2_BraZ1	228	-	79	325	327	0.9938838
A06	48137206	48137674	A06p36670.2_BraZ1	46.8	+	660	468	468	1.0000000
A06	48144640	48145546	A06p36680.2_BraZ1	753	-	1	58	906	0.0640177
A06	48146173	48148266	A06p36690.2_BraZ1	216	+	134	1685	2093	0.8050645
A06	48147917	48148386	A06p36700.2_BraZ1	675	-	61	455	469	0.9701493
A06	48150687	48155430	A06p36710.2_BraZ1	618.571	+	1510	1627	4743	0.3430318
A06	48154039	48154768	A06p36720.2_BraZ1	72.9	+	0	0	729	0.0000000
A06	48164984	48168274	A06p36730.2_BraZ1	1423.12	+	2233	3284	3290	0.9981763
A06	48170498	48171324	A06p36740.2_BraZ1	491.328	+	391	802	826	0.9709443
A06	48175612	48176770	A06p36750.2_BraZ1	913.714	+	618	1158	1158	1.0000000
A06	48177456	48178899	A06p36760.2_BraZ1	527.16	-	195	1235	1443	0.8558559
A06	48179239	48181096	A06p36770.2_BraZ1	1020	-	658	1220	1857	0.6569736
A06	48192911	48193962	A06p36780.2_BraZ1	1032	-	466	1018	1051	0.9686013
A06	48196609	48197068	A06p36790.2_BraZ1	45.9	+	777	459	459	1.0000000
A06	48203509	48204713	A06p36800.2_BraZ1	768.6	-	492	1204	1204	1.0000000
A06	48216778	48219179	A06p36810.2_BraZ1	6240.15	-	236	1956	2401	0.8146605
A06	48222784	48224291	A06p36820.2_BraZ1	1107	-	20	280	1507	0.1857996
A06	48227399	48227708	A06p36830.2_BraZ1	30.9	+	403	309	309	1.0000000
A06	48231501	48231717	A06p36840.2_BraZ1	21.6	+	391	216	216	1.0000000
A06	48236658	48242446	A06p36850.2_BraZ1	68	-	4095	5332	5788	0.9212163
A06	48243986	48245457	A06p36860.2_BraZ1	341.667	-	631	1359	1471	0.9238613
A06	48248778	48250438	A06p36870.2_BraZ1	903.97	+	133	1307	1660	0.7873494
A06	48255252	48256337	A06p36880.2_BraZ1	585.341	-	1098	1085	1085	1.0000000
A06	48256629	48257723	A06p36890.2_BraZ1	1014	+	1026	1094	1094	1.0000000
A06	48257895	48258597	A06p36900.2_BraZ1	291	-	322	700	702	0.9971510
A06	48270006	48272749	A06p36910.2_BraZ1	273	-	2525	2743	2743	1.0000000
A06	48280592	48282156	A06p36920.2_BraZ1	1073.17	+	764	1515	1564	0.9686701
A06	48283436	48284231	A06p36930.2_BraZ1	450	+	479	795	795	1.0000000
A06	48297277	48297823	A06p36940.2_BraZ1	54.6	-	11	170	546	0.3113553
A06	48304837	48306966	A06p36950.2_BraZ1	1266.05	-	127	1240	2129	0.5824330
A06	48312186	48312871	A06p36960.2_BraZ1	570	+	245	658	685	0.9605839
A06	48314701	48315483	A06p36970.2_BraZ1	306	-	434	782	782	1.0000000
A06	48324675	48325026	A06p36980.2_BraZ1	35.1	+	73	351	351	1.0000000
A06	48325052	48325857	A06p36990.2_BraZ1	240	+	268	805	805	1.0000000
A06	48326463	48328668	A06p37000.2_BraZ1	356.25	-	176	1481	2205	0.6716554
A06	48331893	48334900	A06p37010.2_BraZ1	1046.84	+	913	2791	3007	0.9281676
A06	48339564	48341145	A06p37020.2_BraZ1	9840	+	881	1581	1581	1.0000000
A06	48342912	48343436	A06p37030.2_BraZ1	3262.5	+	789	524	524	1.0000000
A06	48345681	48347301	A06p37040.2_BraZ1	109.5	-	244	1261	1620	0.7783951
A06	48353721	48356245	A06p37050.2_BraZ1	1232.65	+	1001	2443	2524	0.9679081
A06	48356515	48358630	A06p37060.2_BraZ1	972	-	940	1988	2115	0.9399527
A06	48360620	48363697	A06p37070.2_BraZ1	1574.39	+	1075	2453	3077	0.7972051
A06	48364083	48365432	A06p37080.2_BraZ1	753.667	-	144	770	1349	0.5707932
A06	48365918	48367836	A06p37090.2_BraZ1	829.033	-	1014	1918	1918	1.0000000
A06	48368739	48369081	A06p37100.2_BraZ1	34.2	-	50	154	342	0.4502924
A06	48372993	48373233	A06p37110.2_BraZ1	24	-	327	240	240	1.0000000
A06	48375418	48377974	A06p37120.2_BraZ1	1159.2	+	2065	2553	2556	0.9988263
A06	48378800	48379360	A06p37130.2_BraZ1	30.9	-	125	547	560	0.9767857
A06	48379987	48381501	A06p37140.2_BraZ1	696	-	790	1514	1514	1.0000000
A06	48382027	48383590	A06p37150.2_BraZ1	1004.25	-	682	1563	1563	1.0000000
A06	48384661	48387409	A06p37160.2_BraZ1	676.8	+	1676	2748	2748	1.0000000
A06	48388169	48389088	A06p37170.2_BraZ1	704	-	497	919	919	1.0000000
A06	48390289	48391177	A06p37180.2_BraZ1	88.8	-	92	787	888	0.8862613
A06	48395594	48396431	A06p37190.2_BraZ1	362.143	+	6	159	837	0.1899642
A06	48396891	48397149	A06p37200.2_BraZ1	213.75	+	0	0	258	0.0000000
A06	48398112	48398244	A06p37210.2_BraZ1	13.2	-	474	132	132	1.0000000
A06	48409689	48411673	A06p37220.2_BraZ1	1634.14	-	395	1598	1984	0.8054435
A06	48412237	48413936	A06p37230.2_BraZ1	692.014	-	315	1594	1699	0.9381989
A06	48414373	48421709	A06p37240.2_BraZ1	2526.3	+	4317	7117	7336	0.9701472
A06	48421811	48422934	A06p37250.2_BraZ1	255	+	1127	1123	1123	1.0000000
A06	48425639	48427181	A06p37260.2_BraZ1	154.2	-	382	1530	1542	0.9922179
A06	48428934	48429630	A06p37270.2_BraZ1	474	+	510	696	696	1.0000000
A06	48458466	48459780	A06p37280.2_BraZ1	131.4	+	100	715	1314	0.5441400
A06	48461447	48462395	A06p37290.2_BraZ1	852	-	457	946	948	0.9978903
A06	48462998	48463877	A06p37300.2_BraZ1	506.88	+	659	879	879	1.0000000
A06	48464136	48467448	A06p37310.2_BraZ1	1632.19	-	1592	3282	3312	0.9909420
A06	48469813	48470151	A06p37320.2_BraZ1	147	+	71	279	338	0.8254438
A06	48470366	48471332	A06p37330.2_BraZ1	840	+	127	818	966	0.8467909
A06	48471643	48474174	A06p37340.2_BraZ1	1458.08	-	391	1839	2531	0.7265903
A06	48480943	48483211	A06p37350.2_BraZ1	1041.6	+	333	1443	2268	0.6362434
A06	48513780	48516520	A06p37360.2_BraZ1	1461.93	+	822	2495	2740	0.9105839
A06	48519149	48520919	A06p37370.2_BraZ1	8113	+	336	1471	1770	0.8310735
A06	48526848	48528665	A06p37380.2_BraZ1	1501	+	342	1535	1817	0.8447991
A06	48530922	48534891	A06p37390.2_BraZ1	6179	+	2118	3681	3969	0.9274377
A06	48540244	48541553	A06p37400.2_BraZ1	2011.5	-	303	1002	1309	0.7654698
A06	48561476	48563336	A06p37410.2_BraZ1	1042.09	-	942	1850	1860	0.9946237
A06	48564047	48566865	A06p37420.2_BraZ1	2110.57	-	833	2613	2818	0.9272534
A06	48568878	48571069	A06p37430.2_BraZ1	894.144	+	1520	2186	2191	0.9977179
A06	48573290	48574940	A06p37440.2_BraZ1	970.484	-	559	1601	1650	0.9703031
A06	48576765	48578709	A06p37450.2_BraZ1	1373.43	-	707	1836	1944	0.9444444
A06	48581237	48583249	A06p37460.2_BraZ1	1519.78	+	577	1950	2012	0.9691849
A06	48583643	48584090	A06p37470.2_BraZ1	42	-	28	324	447	0.7248322
A06	48586281	48588944	A06p37480.2_BraZ1	1704.38	+	1250	2585	2663	0.9707097
A06	48598463	48600025	A06p37490.2_BraZ1	1491	+	935	1562	1562	1.0000000
A06	48600164	48601469	A06p37500.2_BraZ1	130.5	-	204	979	1305	0.7501916
A06	48602981	48613466	A06p37510.2_BraZ1	1451.87	-	12961	10478	10485	0.9993324
A06	48608577	48609135	A06p37520.2_BraZ1	55.8	-	506	558	558	1.0000000
A06	48613763	48616766	A06p37530.2_BraZ1	1970.83	+	1547	2935	3003	0.9773560
A06	48619318	48619579	A06p37540.2_BraZ1	26.1	+	90	261	261	1.0000000
A06	48621345	48622364	A06p37550.2_BraZ1	2808	+	121	731	1019	0.7173700
A06	48622928	48623852	A06p37560.2_BraZ1	711.167	-	535	905	924	0.9794372
A06	48623967	48624102	A06p37570.2_BraZ1	13.5	-	225	135	135	1.0000000
A06	48624885	48625122	A06p37580.2_BraZ1	20.7	+	226	237	237	1.0000000
A06	48627124	48627441	A06p37590.2_BraZ1	171	+	353	317	317	1.0000000
A06	48627604	48627959	A06p37600.2_BraZ1	144	+	398	355	355	1.0000000
A06	48640078	48641296	A06p37610.2_BraZ1	1075.25	+	610	1065	1218	0.8743842
A06	48646409	48658081	A06p37620.2_BraZ1	2738.64	+	3872	9572	11672	0.8200822
A06	48658270	48659497	A06p37630.2_BraZ1	122.7	-	292	1127	1227	0.9185004
A06	48659815	48663725	A06p37640.2_BraZ1	2563.61	+	248	2807	3910	0.7179028
A06	48666379	48668958	A06p37650.2_BraZ1	1366.25	+	171	1445	2579	0.5602947
A06	48669999	48673176	A06p37660.2_BraZ1	1232.73	-	2556	3177	3177	1.0000000
A06	48675979	48676617	A06p37670.2_BraZ1	216	-	353	634	638	0.9937304
A06	48677101	48677697	A06p37680.2_BraZ1	555	-	305	568	596	0.9530202
A06	48678463	48681612	A06p37690.2_BraZ1	599.857	+	1489	2666	3149	0.8466180
A06	48681933	48684590	A06p37700.2_BraZ1	1336.56	-	2443	2608	2657	0.9815581
A06	48694670	48696086	A06p37710.2_BraZ1	141.6	+	748	1197	1416	0.8453390
A06	48696318	48699568	A06p37720.2_BraZ1	1495.23	-	881	2050	3250	0.6307693
A06	48700088	48700523	A06p37730.2_BraZ1	228	+	352	435	435	1.0000000
A06	48703294	48706178	A06p37740.2_BraZ1	1848.67	+	728	2465	2884	0.8547156
A06	48711161	48717560	A06p37750.2_BraZ1	2127.73	-	3663	6302	6399	0.9848414
A06	48718317	48718626	A06p37760.2_BraZ1	30.9	-	0	0	309	0.0000000
A06	48718855	48719240	A06p37770.2_BraZ1	315	+	0	0	385	0.0000000
A06	48722376	48724887	A06p37780.2_BraZ1	273	+	473	829	2511	0.3301474
A06	48726085	48729495	A06p37790.2_BraZ1	497.94	-	9	432	3410	0.1266862
A06	48729235	48730298	A06p37800.2_BraZ1	372	-	38	547	1063	0.5145814
A06	48731805	48738651	A06p37810.2_BraZ1	3122.5	+	540	3912	6846	0.5714286
A06	48738928	48740801	A06p37820.2_BraZ1	1059.84	-	1074	1873	1873	1.0000000
A06	48741620	48743494	A06p37830.2_BraZ1	1165.5	+	894	1874	1874	1.0000000
A06	48744985	48747039	A06p37840.2_BraZ1	771.429	+	1246	2005	2054	0.9761441
A06	48747790	48749486	A06p37850.2_BraZ1	738.104	+	1252	1695	1696	0.9994104
A06	48749761	48751181	A06p37860.2_BraZ1	640.714	-	1084	1420	1420	1.0000000
A06	48761105	48762122	A06p37870.2_BraZ1	101.7	-	155	893	1017	0.8780727
A06	48762980	48764473	A06p37880.2_BraZ1	880.714	-	593	1472	1493	0.9859344
A06	48767589	48771187	A06p37890.2_BraZ1	2468.96	+	348	2971	3598	0.8257365
A06	48771565	48772272	A06p37900.2_BraZ1	498	-	380	707	707	1.0000000
A06	48773087	48775803	A06p37910.2_BraZ1	1630.71	-	1350	2675	2716	0.9849043
A06	48777072	48778402	A06p37920.2_BraZ1	987.955	-	247	1149	1330	0.8639098
A06	48781394	48787986	A06p37930.2_BraZ1	3069.53	-	1524	5006	6592	0.7594053
A06	48789432	48790704	A06p37940.2_BraZ1	549	-	441	1116	1272	0.8773585
A06	48798060	48799239	A06p37950.2_BraZ1	1005	-	107	761	1179	0.6454623
A06	48803366	48805017	A06p37960.2_BraZ1	963.462	-	437	1451	1651	0.8788613
A06	48808190	48809471	A06p37970.2_BraZ1	987	-	157	658	1281	0.5136612
A06	48821417	48822389	A06p37980.2_BraZ1	311.304	-	1095	972	972	1.0000000
A06	48823357	48825585	A06p37990.2_BraZ1	809.522	-	1270	2118	2228	0.9506283
A06	48825771	48827061	A06p38000.2_BraZ1	8701	+	868	1290	1290	1.0000000
A06	48827483	48829946	A06p38010.2_BraZ1	2555.56	-	2527	2454	2463	0.9963459
A06	48831580	48832519	A06p38020.2_BraZ1	477	+	93	807	939	0.8594249
A06	48833986	48835965	A06p38030.2_BraZ1	1512	+	626	1908	1979	0.9641233
A06	48836764	48838568	A06p38040.2_BraZ1	698.863	-	1346	1804	1804	1.0000000
A06	48839192	48840858	A06p38050.2_BraZ1	1144.17	+	1331	1666	1666	1.0000000
A06	48841241	48842875	A06p38060.2_BraZ1	968.6	-	1240	1634	1634	1.0000000
A06	48853089	48854004	A06p38070.2_BraZ1	91.5	+	195	915	915	1.0000000
A06	48865559	48865688	A06p38080.2_BraZ1	12.9	+	2	97	129	0.7519380
A06	48867866	48869145	A06p38090.2_BraZ1	478.8	+	0	0	1279	0.0000000
A06	48870744	48874449	A06p38100.2_BraZ1	370.5	+	851	2404	3705	0.6488529
A06	48874819	48877098	A06p38110.2_BraZ1	1668	-	253	2056	2279	0.9021501
A06	48879173	48881563	A06p38120.2_BraZ1	1457.5	+	954	2235	2390	0.9351465
A06	48887499	48887874	A06p38130.2_BraZ1	37.5	+	170	375	375	1.0000000
A06	48891249	48894587	A06p38140.2_BraZ1	1929.09	+	362	2166	3338	0.6488916
A06	48896922	48898381	A06p38150.2_BraZ1	978	-	253	1340	1459	0.9184373
A06	48901574	48902606	A06p38160.2_BraZ1	320.576	-	550	1032	1032	1.0000000
A06	48903157	48905080	A06p38170.2_BraZ1	896	-	818	1649	1923	0.8575143
A06	48906430	48907914	A06p38180.2_BraZ1	137.7	-	559	1384	1484	0.9326146
A06	48908369	48910009	A06p38190.2_BraZ1	1104.3	+	361	1532	1640	0.9341463
A06	48910255	48912493	A06p38200.2_BraZ1	1242	+	1513	2130	2238	0.9517426
A06	48913002	48916497	A06p38210.2_BraZ1	2288.93	+	322	2751	3495	0.7871245
A06	48918998	48919765	A06p38220.2_BraZ1	429	+	657	767	767	1.0000000
A06	48920454	48925045	A06p38230.2_BraZ1	4427.8	+	1635	3503	4591	0.7630146
A06	48926712	48928161	A06p38240.2_BraZ1	144.9	-	247	1439	1449	0.9930987
A06	48937813	48942624	A06p38250.2_BraZ1	1567.4	+	2151	4740	4811	0.9852421
A06	48946315	48947219	A06p38260.2_BraZ1	273	+	162	856	904	0.9469026
A06	48949615	48950201	A06p38270.2_BraZ1	135	-	16	189	586	0.3225256
A06	48951854	48955435	A06p38280.2_BraZ1	540	+	2168	3581	3581	1.0000000
A06	48957609	48961505	A06p38290.2_BraZ1	1384	+	2235	3891	3896	0.9987167
A06	48962042	48963928	A06p38300.2_BraZ1	784.682	-	727	1719	1886	0.9114528
A06	48964852	48966392	A06p38310.2_BraZ1	1159.39	+	882	1499	1540	0.9733766
A06	48966694	48967285	A06p38320.2_BraZ1	56.1	+	219	591	591	1.0000000
A06	48968141	48971172	A06p38330.2_BraZ1	1411.79	+	1033	3014	3031	0.9943913
A06	48972394	48974246	A06p38340.2_BraZ1	1273.7	+	551	1424	1852	0.7688985
A06	48975370	48975526	A06p38350.2_BraZ1	15.6	-	365	156	156	1.0000000
A06	48976172	48976756	A06p38360.2_BraZ1	453	-	113	584	584	1.0000000
A06	48998199	48999601	A06p38370.2_BraZ1	56.7	+	87	701	1402	0.5000000
A06	49001596	49003897	A06p38380.2_BraZ1	1222.67	-	1200	1764	2301	0.7666232
A06	49005282	49005678	A06p38390.2_BraZ1	333	+	4	76	396	0.1919192
A06	49006631	49008428	A06p38400.2_BraZ1	179.7	-	399	1700	1797	0.9460211
A06	49012710	49014766	A06p38410.2_BraZ1	1043.32	-	1317	2056	2056	1.0000000
A06	49020488	49028756	A06p38420.2_BraZ1	684	-	1639	4687	8268	0.5668844
A06	49030418	49032305	A06p38430.2_BraZ1	3300	-	396	1556	1887	0.8245893
A06	49033000	49038205	A06p38440.2_BraZ1	2098.8	-	927	4456	5205	0.8560999
A06	49046491	49050345	A06p38450.2_BraZ1	2367.69	-	1448	3800	3854	0.9859886
A06	49054040	49054559	A06p38460.2_BraZ1	444	-	264	408	519	0.7861272
A06	49056686	49057468	A06p38470.2_BraZ1	552	-	1263	782	782	1.0000000
A06	49058837	49060702	A06p38480.2_BraZ1	1809	+	3506	1865	1865	1.0000000
A06	49062606	49063152	A06p38490.2_BraZ1	54.6	+	155	546	546	1.0000000
A06	49064293	49067117	A06p38500.2_BraZ1	1224	+	2796	2824	2824	1.0000000
A06	49068027	49069718	A06p38510.2_BraZ1	1617	+	423	1346	1691	0.7959787
A06	49070078	49070611	A06p38520.2_BraZ1	936	-	514	533	533	1.0000000
A06	49079560	49080820	A06p38530.2_BraZ1	126	-	572	1151	1260	0.9134921
A06	49089906	49091187	A06p38540.2_BraZ1	360	+	24	276	1281	0.2154567
A06	49104079	49104361	A06p38550.2_BraZ1	25.8	+	0	0	282	0.0000000
A06	49106097	49107317	A06p38560.2_BraZ1	831.158	-	280	1185	1220	0.9713115
A06	49107838	49113197	A06p38570.2_BraZ1	741	+	4175	4738	5359	0.8841202
A06	49116870	49117921	A06p38580.2_BraZ1	447.353	-	352	1051	1051	1.0000000
A06	49118111	49119098	A06p38590.2_BraZ1	363.794	-	418	987	987	1.0000000
A06	49122048	49123496	A06p38600.2_BraZ1	666.562	+	779	1089	1448	0.7520718
A06	49123855	49126572	A06p38610.2_BraZ1	879.667	-	643	2520	2717	0.9274936
A06	49133744	49134001	A06p38620.2_BraZ1	219	-	519	257	257	1.0000000
A06	49135719	49138167	A06p38630.2_BraZ1	234	-	0	0	2448	0.0000000
A06	49139281	49139413	A06p38640.2_BraZ1	13.2	-	0	0	132	0.0000000
A06	49142343	49143421	A06p38650.2_BraZ1	990.45	-	9	134	1078	0.1243043
A06	49147246	49148926	A06p38660.2_BraZ1	882.39	+	629	1618	1680	0.9630952
A06	49157015	49161979	A06p38670.2_BraZ1	3019.62	+	1172	4181	4964	0.8422643
A06	49178372	49180747	A06p38680.2_BraZ1	308.425	+	688	2359	2375	0.9932632
A06	49186798	49187181	A06p38690.2_BraZ1	198	+	284	374	383	0.9765013
A06	49187307	49187902	A06p38700.2_BraZ1	489	-	53	253	595	0.4252101
A06	49195070	49195443	A06p38710.2_BraZ1	243	-	82	371	373	0.9946381
A06	49197921	49199023	A06p38720.2_BraZ1	513.068	-	667	1102	1102	1.0000000
A06	49201621	49201945	A06p38730.2_BraZ1	32.4	+	57	324	324	1.0000000
A06	49204197	49205406	A06p38740.2_BraZ1	621	+	177	980	1209	0.8105873
A06	49208863	49210794	A06p38750.2_BraZ1	1011.13	+	839	1796	1931	0.9300880
A06	49211526	49211913	A06p38760.2_BraZ1	38.7	+	73	362	387	0.9354005
A06	49212048	49212574	A06p38770.2_BraZ1	441	-	552	526	526	1.0000000
A06	49212968	49214493	A06p38780.2_BraZ1	1671.6	-	1126	1525	1525	1.0000000
A06	49215987	49217144	A06p38790.2_BraZ1	336	+	500	1157	1157	1.0000000
A06	49218277	49218463	A06p38800.2_BraZ1	18.6	+	242	186	186	1.0000000
A06	49218534	49218780	A06p38810.2_BraZ1	24.6	+	261	246	246	1.0000000
A06	49219880	49221762	A06p38820.2_BraZ1	1413	-	285	1386	1882	0.7364506
A06	49223178	49224261	A06p38830.2_BraZ1	468	+	846	1083	1083	1.0000000
A06	49226955	49227643	A06p38840.2_BraZ1	615	+	513	688	688	1.0000000
A06	49230732	49231063	A06p38850.2_BraZ1	27.3	+	302	331	331	1.0000000
A06	49231751	49234050	A06p38860.2_BraZ1	1445.65	-	1092	1816	2299	0.7899086
A06	49237672	49241959	A06p38870.2_BraZ1	1927.17	+	1830	4157	4287	0.9696758
A06	49244877	49249291	A06p38880.2_BraZ1	2215.54	+	2835	4135	4414	0.9367920
A06	49252892	49253205	A06p38890.2_BraZ1	28.8	-	77	249	313	0.7955272
A06	49253977	49254160	A06p38900.2_BraZ1	18.3	+	170	183	183	1.0000000
A06	49254946	49257372	A06p38910.2_BraZ1	975.357	+	1543	2391	2426	0.9855729
A06	49258259	49259809	A06p38920.2_BraZ1	4970	-	1740	1550	1550	1.0000000
A06	49260932	49262066	A06p38930.2_BraZ1	113.4	-	871	1134	1134	1.0000000
A06	49268811	49270810	A06p38940.2_BraZ1	935.222	-	1045	1814	1999	0.9074537
A06	49271604	49274338	A06p38950.2_BraZ1	1549.57	+	755	2523	2734	0.9228237
A06	49274804	49275180	A06p38960.2_BraZ1	37.5	+	560	376	376	1.0000000
A06	49276498	49276633	A06p38970.2_BraZ1	13.5	-	80	113	135	0.8370370
A06	49277176	49277551	A06p38980.2_BraZ1	198	-	153	375	375	1.0000000
A06	49284762	49286614	A06p38990.2_BraZ1	958.435	+	717	1689	1852	0.9119871
A06	49286745	49287348	A06p39000.2_BraZ1	60.3	-	243	603	603	1.0000000
A06	49289275	49289895	A06p39010.2_BraZ1	300	+	409	620	620	1.0000000
A06	49292783	49293472	A06p39020.2_BraZ1	390	+	240	594	689	0.8621190
A06	49300533	49300999	A06p39030.2_BraZ1	333	-	696	466	466	1.0000000
A06	49303398	49307419	A06p39040.2_BraZ1	615.385	+	1598	3898	4021	0.9694106
A06	49311629	49321332	A06p39050.2_BraZ1	587.538	+	3182	4698	9703	0.4841802
A06	49322289	49324532	A06p39060.2_BraZ1	903.171	-	1073	2236	2243	0.9968792
A06	49325308	49327951	A06p39070.2_BraZ1	1598.72	+	711	2445	2643	0.9250851
A06	49328264	49329722	A06p39080.2_BraZ1	145.8	-	277	1280	1458	0.8779150
A06	49330850	49333556	A06p39090.2_BraZ1	1739.41	-	639	2557	2706	0.9449372
A06	49334344	49335594	A06p39100.2_BraZ1	5071.5	+	169	1140	1250	0.9120000
A06	49339224	49340085	A06p39110.2_BraZ1	735	+	367	861	861	1.0000000
A06	49375045	49375894	A06p39120.2_BraZ1	84.9	+	437	849	849	1.0000000
A06	49378289	49380675	A06p39130.2_BraZ1	985.833	-	223	1545	2386	0.6475272
A06	49399853	49400343	A06p39140.2_BraZ1	261	-	142	484	490	0.9877551
A06	49404036	49406208	A06p39150.2_BraZ1	1707.64	-	462	1985	2172	0.9139042
A06	49414326	49415403	A06p39160.2_BraZ1	107.7	+	105	949	1077	0.8811513
A06	49425350	49426360	A06p39170.2_BraZ1	686.4	-	232	1010	1010	1.0000000
A06	49426727	49426946	A06p39180.2_BraZ1	21.9	-	23	194	219	0.8858448
A06	49450131	49450814	A06p39190.2_BraZ1	186	+	259	635	683	0.9297218
A06	49451880	49453804	A06p39200.2_BraZ1	1115.11	+	666	1708	1924	0.8877339
A06	49455811	49456556	A06p39210.2_BraZ1	510	+	559	745	745	1.0000000
A06	49461021	49462158	A06p39220.2_BraZ1	905.932	+	428	1126	1137	0.9903254
A06	49462429	49468150	A06p39230.2_BraZ1	1719.9	-	1477	4329	5721	0.7566859
A06	49469053	49470297	A06p39240.2_BraZ1	879	-	673	1244	1244	1.0000000
A06	49472396	49474659	A06p39250.2_BraZ1	596.7	-	1225	2263	2263	1.0000000
A06	49475070	49475911	A06p39260.2_BraZ1	396.174	+	379	841	841	1.0000000
A06	49476040	49478123	A06p39270.2_BraZ1	1194.62	-	148	1526	2083	0.7325972
A06	49484297	49488342	A06p39280.2_BraZ1	2044.55	+	2487	4045	4045	1.0000000
A06	49489041	49489461	A06p39290.2_BraZ1	42	-	215	420	420	1.0000000
A06	49516934	49517558	A06p39300.2_BraZ1	345	-	64	59	624	0.0945513
A06	49525068	49526473	A06p39310.2_BraZ1	882	-	273	1322	1405	0.9409252
A06	49534782	49534932	A06p39320.2_BraZ1	15	-	0	0	150	0.0000000
A06	49544299	49545314	A06p39330.2_BraZ1	1117.5	+	942	1015	1015	1.0000000
A06	49555464	49563825	A06p39340.2_BraZ1	1435.11	-	4063	7535	8361	0.9012080
A06	49566379	49569335	A06p39350.2_BraZ1	1205.12	-	852	2790	2956	0.9438430
A06	49572390	49572615	A06p39360.2_BraZ1	22.5	+	277	225	225	1.0000000
A06	49573753	49577164	A06p39370.2_BraZ1	1348.91	-	1296	2914	3411	0.8542950
A06	49598199	49599087	A06p39380.2_BraZ1	88.8	+	127	721	888	0.8119369
A06	49604393	49606435	A06p39390.2_BraZ1	900.548	-	778	2042	2042	1.0000000
A06	49608893	49610475	A06p39400.2_BraZ1	10956	-	640	1582	1582	1.0000000
A06	49612378	49617170	A06p39410.2_BraZ1	3114.71	+	1311	4189	4792	0.8741653
A06	49617972	49621177	A06p39420.2_BraZ1	1997.59	+	900	2415	3205	0.7535101
A06	49621721	49627883	A06p39430.2_BraZ1	3583.68	-	1215	4785	6162	0.7765336
A06	49632826	49635534	A06p39440.2_BraZ1	1453.09	+	920	2284	2708	0.8434269
A06	49637237	49637846	A06p39450.2_BraZ1	3307.5	+	162	533	609	0.8752053
A06	49638455	49640637	A06p39460.2_BraZ1	1717.33	-	822	2162	2182	0.9908341
A06	49644484	49646217	A06p39470.2_BraZ1	737.5	-	125	1031	1733	0.5949221
A06	49648957	49649146	A06p39480.2_BraZ1	18.9	-	241	189	189	1.0000000
A06	49649647	49650642	A06p39490.2_BraZ1	113.87	-	12	486	995	0.4884422
A06	49655691	49655802	A06p39500.2_BraZ1	11.1	-	0	0	111	0.0000000
A06	49655983	49656699	A06p39510.2_BraZ1	366	-	0	0	716	0.0000000
A06	49658598	49658877	A06p39520.2_BraZ1	27.9	+	21	213	279	0.7634408
A06	49659056	49661977	A06p39530.2_BraZ1	1656.63	-	511	2671	2921	0.9144129
A06	49669896	49673011	A06p39540.2_BraZ1	1325.45	+	2362	3115	3115	1.0000000
A06	49673487	49675905	A06p39550.2_BraZ1	1261.67	-	1398	2384	2418	0.9859388
A06	49678409	49680886	A06p39560.2_BraZ1	1637.1	+	2753	2477	2477	1.0000000
A06	49681378	49684435	A06p39570.2_BraZ1	2889	-	2450	3057	3057	1.0000000
A06	49684660	49686814	A06p39580.2_BraZ1	215.1	+	832	2150	2154	0.9981430
A06	49691033	49691951	A06p39590.2_BraZ1	91.8	-	16	396	918	0.4313726
A06	49695243	49697247	A06p39600.2_BraZ1	200.4	-	486	1825	2004	0.9106786
A06	49699218	49699585	A06p39610.2_BraZ1	186	-	382	367	367	1.0000000
A06	49699716	49700193	A06p39620.2_BraZ1	47.7	-	198	477	477	1.0000000
A06	49700700	49703111	A06p39630.2_BraZ1	711	-	30	619	2411	0.2567399
A06	49707354	49711323	A06p39640.2_BraZ1	1709.16	+	2114	3559	3969	0.8966994
A06	49711688	49713548	A06p39650.2_BraZ1	2267.79	-	790	1724	1860	0.9268817
A06	49753039	49753920	A06p39660.2_BraZ1	426	-	190	881	881	1.0000000
A06	49767387	49768720	A06p39670.2_BraZ1	1645	+	533	1328	1333	0.9962491
A06	49771522	49772038	A06p39680.2_BraZ1	360	+	114	423	516	0.8197674
A06	49780962	49781305	A06p39690.2_BraZ1	306	-	101	323	343	0.9416910
A06	49781912	49784137	A06p39700.2_BraZ1	2136	+	219	1955	2225	0.8786517
A06	49789079	49790765	A06p39710.2_BraZ1	582	-	105	1445	1686	0.8570581
A06	49793679	49793907	A06p39720.2_BraZ1	12	+	7	68	228	0.2982456
A06	49796999	49797155	A06p39730.2_BraZ1	15.6	+	130	156	156	1.0000000
A06	49802974	49805786	A06p39740.2_BraZ1	1983.13	+	384	2643	2812	0.9399004
A06	49806552	49809124	A06p39750.2_BraZ1	1396.19	-	2202	2572	2572	1.0000000
A06	49811281	49814950	A06p39760.2_BraZ1	1778.71	-	5310	3669	3669	1.0000000
A06	49818562	49821639	A06p39770.2_BraZ1	2994	+	335	2337	3077	0.7595060
A06	49829245	49829599	A06p39780.2_BraZ1	35.4	+	4	22	354	0.0621469
A06	49832490	49832946	A06p39790.2_BraZ1	16.8	+	412	408	456	0.8947368
A06	49833313	49833430	A06p39800.2_BraZ1	11.7	+	162	117	117	1.0000000
A06	49839003	49840246	A06p39810.2_BraZ1	833.13	+	215	1158	1243	0.9316171
A06	49841656	49843352	A06p39820.2_BraZ1	768.92	-	1002	1692	1696	0.9976415
A06	49844893	49848513	A06p39830.2_BraZ1	2635.59	+	508	3216	3620	0.8883978
A06	49849250	49863614	A06p39840.2_BraZ1	2185.04	+	3947	9699	14364	0.6752297
A06	49852868	49854056	A06p39850.2_BraZ1	204	+	219	967	1188	0.8139731
A06	49854643	49855203	A06p39860.2_BraZ1	300	+	53	149	560	0.2660714
A06	49870164	49871501	A06p39870.2_BraZ1	1107	+	42	390	1337	0.2916978
A06	49882355	49882795	A06p39880.2_BraZ1	35.1	-	401	440	440	1.0000000
A06	49895360	49896977	A06p39890.2_BraZ1	1413	-	136	1279	1617	0.7909709
A06	49901510	49902785	A06p39900.2_BraZ1	600.218	-	47	801	1275	0.6282353
A06	49903467	49905357	A06p39910.2_BraZ1	189	-	622	1858	1890	0.9830688
A06	49906423	49907425	A06p39920.2_BraZ1	98.1	-	366	852	1002	0.8502994
A06	49912191	49918693	A06p39930.2_BraZ1	726.45	-	3339	6020	6502	0.9258690
A06	49918751	49919466	A06p39940.2_BraZ1	330	+	297	715	715	1.0000000
A06	49936705	49937066	A06p39950.2_BraZ1	237	+	23	282	361	0.7811635
A06	49938222	49939022	A06p39960.2_BraZ1	33.913	+	345	800	800	1.0000000
A06	49939470	49939611	A06p39970.2_BraZ1	14.1	-	255	141	141	1.0000000
A06	49943664	49945557	A06p39980.2_BraZ1	1075.5	+	533	1528	1893	0.8071843
A06	49948277	49950976	A06p39990.2_BraZ1	1770	+	1221	2606	2699	0.9655428
A06	49951343	49952731	A06p40000.2_BraZ1	1245	-	515	1380	1388	0.9942363
A06	49954639	49956244	A06p40010.2_BraZ1	1965	+	208	1391	1605	0.8666667
A06	49959003	49959515	A06p40020.2_BraZ1	180	+	60	341	512	0.6660156
A06	49964067	49964250	A06p40030.2_BraZ1	18.3	-	25	183	183	1.0000000
A06	49968159	49969573	A06p40040.2_BraZ1	63	-	1827	1414	1414	1.0000000
A06	49975779	49977673	A06p40050.2_BraZ1	681.652	+	1003	1894	1894	1.0000000
A06	49978653	49980228	A06p40060.2_BraZ1	1401	+	222	1241	1575	0.7879365
A06	49983535	49984441	A06p40070.2_BraZ1	2106	+	128	877	906	0.9679912
A06	49985396	49987791	A06p40080.2_BraZ1	1482	+	1041	2323	2395	0.9699374
A06	49988577	49989073	A06p40090.2_BraZ1	234.286	+	84	427	496	0.8608871
A06	49989432	49990695	A06p40100.2_BraZ1	422.172	-	920	1255	1263	0.9936659
A06	49991925	49993369	A06p40110.2_BraZ1	873	+	1101	1326	1444	0.9182826
A06	49993687	49996748	A06p40120.2_BraZ1	2314.02	-	1147	2895	3061	0.9457694
A06	49997090	49998568	A06p40130.2_BraZ1	530.333	-	704	1478	1478	1.0000000
A06	50000100	50001768	A06p40140.2_BraZ1	1410	+	780	1589	1668	0.9526379
A06	50007199	50009856	A06p40150.2_BraZ1	1640.23	-	917	2623	2657	0.9872036
A06	50010337	50013786	A06p40160.2_BraZ1	1220.77	-	2609	3326	3449	0.9643375
A06	50014189	50014519	A06p40170.2_BraZ1	33	+	326	330	330	1.0000000
A06	50016470	50017871	A06p40180.2_BraZ1	1115.12	+	220	1313	1401	0.9371877
A06	50019977	50023298	A06p40190.2_BraZ1	2842	-	1602	2837	3321	0.8542607
A06	50027725	50028451	A06p40200.2_BraZ1	72.6	+	218	715	726	0.9848485
A06	50031531	50031764	A06p40210.2_BraZ1	150	-	443	233	233	1.0000000
A06	50034692	50034908	A06p40220.2_BraZ1	21.6	-	134	216	216	1.0000000
A06	50036892	50044150	A06p40230.2_BraZ1	3420.74	-	3176	6787	7258	0.9351061
A06	50052045	50053080	A06p40240.2_BraZ1	582	+	310	1035	1035	1.0000000
A06	50054357	50055220	A06p40250.2_BraZ1	42	+	138	863	863	1.0000000
A06	50055214	50059701	A06p40260.2_BraZ1	287.4	-	762	4397	4487	0.9799421
A06	50060196	50064138	A06p40270.2_BraZ1	201	-	2093	3931	3942	0.9972095
A06	50064195	50066349	A06p40280.2_BraZ1	150	-	579	2067	2154	0.9596100
A06	50067712	50068329	A06p40290.2_BraZ1	33.3	+	66	617	617	1.0000000
A06	50089487	50091818	A06p40300.2_BraZ1	1356	+	756	1523	2331	0.6533676
A06	50095089	50098550	A06p40310.2_BraZ1	1042.03	-	1040	2953	3461	0.8532216
A06	50106502	50113074	A06p40320.2_BraZ1	2512.02	-	1932	5245	6572	0.7980828
A06	50122525	50123957	A06p40330.2_BraZ1	402	+	1713	1431	1432	0.9993017
A06	50125497	50127951	A06p40340.2_BraZ1	245.4	+	886	2340	2454	0.9535452
A06	50129554	50130365	A06p40350.2_BraZ1	408.975	+	573	811	811	1.0000000
A06	50133166	50134575	A06p40360.2_BraZ1	3879	-	428	1326	1409	0.9410930
A06	50136984	50142785	A06p40370.2_BraZ1	1422.79	-	3801	5575	5801	0.9610412
A06	50145660	50146632	A06p40380.2_BraZ1	97.2	-	583	972	972	1.0000000
A06	50152335	50152500	A06p40390.2_BraZ1	16.5	+	55	165	165	1.0000000
A06	50154371	50155277	A06p40400.2_BraZ1	765	+	281	810	906	0.8940398
A06	50162750	50164106	A06p40410.2_BraZ1	813	+	328	1283	1356	0.9461652
A06	50165422	50166832	A06p40420.2_BraZ1	141	-	399	1065	1410	0.7553192
A06	50168205	50172169	A06p40430.2_BraZ1	730.8	+	938	3125	3964	0.7883451
A06	50182913	50185490	A06p40440.2_BraZ1	2014.43	+	914	2017	2577	0.7826930
A06	50186432	50188213	A06p40450.2_BraZ1	294.545	-	766	1544	1781	0.8669287
A06	50188287	50189199	A06p40460.2_BraZ1	91.2	-	379	912	912	1.0000000
A06	50193146	50193281	A06p40470.2_BraZ1	13.5	+	0	0	135	0.0000000
A06	50197942	50199807	A06p40480.2_BraZ1	1509	-	554	1126	1865	0.6037533
A06	50203210	50204592	A06p40490.2_BraZ1	588.774	-	423	1094	1382	0.7916064
A06	50204971	50208999	A06p40500.2_BraZ1	1869.65	+	2260	3831	4028	0.9510924
A06	50210554	50211003	A06p40510.2_BraZ1	39.9	+	148	449	449	1.0000000
A06	50211453	50212176	A06p40520.2_BraZ1	72.3	+	441	723	723	1.0000000
A06	50214187	50214496	A06p40530.2_BraZ1	30.9	+	286	309	309	1.0000000
A06	50214781	50215771	A06p40540.2_BraZ1	505	-	599	986	990	0.9959596
A06	50217757	50220214	A06p40550.2_BraZ1	903.913	+	1235	2263	2457	0.9210419
A06	50220993	50229656	A06p40560.2_BraZ1	485.625	-	8245	8455	8663	0.9759898
A06	50241198	50243641	A06p40570.2_BraZ1	342	-	794	2385	2443	0.9762587
A06	50246927	50247533	A06p40580.2_BraZ1	276	-	535	606	606	1.0000000
A06	50252471	50253901	A06p40590.2_BraZ1	733.259	+	260	1345	1430	0.9405594
A06	50259071	50260689	A06p40600.2_BraZ1	547.418	+	1644	1618	1618	1.0000000
A06	50261868	50262729	A06p40610.2_BraZ1	86.1	-	249	828	861	0.9616725
A06	50266364	50266715	A06p40620.2_BraZ1	35.1	-	35	348	351	0.9914530
A06	50268255	50269767	A06p40630.2_BraZ1	151.2	+	380	1398	1512	0.9246032
A06	50273468	50283866	A06p40640.2_BraZ1	529.2	+	1666	5837	10398	0.5613580
A06	50288247	50288659	A06p40650.2_BraZ1	300	-	201	350	412	0.8495145
A06	50288688	50288856	A06p40660.2_BraZ1	16.8	-	0	0	168	0.0000000
A06	50302500	50302626	A06p40670.2_BraZ1	12.6	+	28	126	126	1.0000000
A06	50302782	50303295	A06p40680.2_BraZ1	51.3	+	9	198	513	0.3859649
A06	50311640	50312376	A06p40690.2_BraZ1	405.375	-	62	553	736	0.7513587
A06	50317240	50318065	A06p40700.2_BraZ1	82.5	-	201	541	825	0.6557575
A06	50322269	50324317	A06p40710.2_BraZ1	1545	+	151	924	2048	0.4511719
A06	50330002	50330576	A06p40720.2_BraZ1	360	-	433	574	574	1.0000000
A06	50331017	50332994	A06p40730.2_BraZ1	196.8	+	50	448	1977	0.2266060
A06	50334725	50335652	A06p40740.2_BraZ1	696	+	5	285	927	0.3074434
A06	50336289	50337920	A06p40750.2_BraZ1	747	+	132	1166	1631	0.7148988
A06	50338056	50343618	A06p40760.2_BraZ1	1194.67	+	288	2087	5562	0.3752247
A06	50344128	50345034	A06p40770.2_BraZ1	90.6	+	6	340	906	0.3752759
A06	50345321	50347539	A06p40780.2_BraZ1	669	+	6	525	2218	0.2366997
A06	50347842	50348603	A06p40790.2_BraZ1	483	+	12	306	761	0.4021025
A06	50348603	50348975	A06p40800.2_BraZ1	34.5	+	7	253	372	0.6801075
A06	50352632	50353219	A06p40810.2_BraZ1	1026	-	140	565	587	0.9625213
A06	50357825	50358764	A06p40820.2_BraZ1	127.5	-	710	926	939	0.9861555
A06	50360863	50361190	A06p40830.2_BraZ1	32.7	-	5	101	327	0.3088685
A06	50367381	50369234	A06p40840.2_BraZ1	889.143	-	435	1679	1853	0.9060982
A06	50369692	50371794	A06p40850.2_BraZ1	1875	-	408	1301	2102	0.6189343
A06	50394125	50395793	A06p40860.2_BraZ1	885	+	52	789	1668	0.4730216
A06	50404817	50405050	A06p40870.2_BraZ1	186	+	36	233	233	1.0000000
A06	50411652	50412462	A06p40880.2_BraZ1	735	+	1102	810	810	1.0000000
A06	50416656	50432615	A06p40890.2_BraZ1	10134.2	+	2216	9068	15959	0.5682060
A06	50435355	50437878	A06p40900.2_BraZ1	735.429	-	947	2522	2523	0.9996036
A06	50442204	50447421	A06p40910.2_BraZ1	2102.11	+	815	4360	5217	0.8357294
A06	50456308	50457778	A06p40920.2_BraZ1	1077	+	2266	1470	1470	1.0000000
A06	50462305	50462857	A06p40930.2_BraZ1	55.2	+	354	552	552	1.0000000
A06	50464492	50465280	A06p40940.2_BraZ1	46.2	+	468	714	788	0.9060914
A06	50465467	50466319	A06p40950.2_BraZ1	85.2	-	181	730	852	0.8568075
A06	50467359	50467613	A06p40960.2_BraZ1	165	-	268	254	254	1.0000000
A06	50468380	50470082	A06p40970.2_BraZ1	1305.65	+	452	1532	1702	0.9001175
A06	50474153	50476149	A06p40980.2_BraZ1	683.185	-	1135	1996	1996	1.0000000
A06	50486659	50489406	A06p40990.2_BraZ1	364	+	3305	2747	2747	1.0000000
A06	50508689	50509220	A06p41000.2_BraZ1	53.1	+	320	531	531	1.0000000
A06	50512019	50514843	A06p41010.2_BraZ1	1489.45	-	2056	2809	2824	0.9946884
A06	50520362	50521144	A06p41020.2_BraZ1	348	-	390	750	782	0.9590793
A06	50521278	50522179	A06p41030.2_BraZ1	540.6	-	459	901	901	1.0000000
A06	50522870	50525013	A06p41040.2_BraZ1	1594.67	+	907	2074	2143	0.9678022
A06	50529967	50532080	A06p41050.2_BraZ1	2070.07	+	1092	2059	2113	0.9744439
A06	50539769	50541950	A06p41060.2_BraZ1	2041.88	+	935	2170	2181	0.9949564
A06	50543996	50545621	A06p41070.2_BraZ1	746.76	-	328	1524	1625	0.9378461
A06	50547776	50548460	A06p41080.2_BraZ1	439.92	-	285	650	684	0.9502924
A06	50554439	50557535	A06p41090.2_BraZ1	1571.54	+	1541	3096	3096	1.0000000
A06	50558709	50559500	A06p41100.2_BraZ1	630	+	122	446	791	0.5638433
A06	50561223	50561931	A06p41110.2_BraZ1	70.8	+	421	708	708	1.0000000
A06	50562963	50563173	A06p41120.2_BraZ1	21	-	103	210	210	1.0000000
A06	50567541	50569709	A06p41130.2_BraZ1	800.308	+	782	2059	2168	0.9497232
A06	50570059	50570397	A06p41140.2_BraZ1	216	-	347	276	338	0.8165681
A06	50571241	50573372	A06p41150.2_BraZ1	2520	-	790	2119	2131	0.9943689
A06	50573848	50575778	A06p41160.2_BraZ1	1230	-	967	1897	1930	0.9829016
A06	50601404	50604652	A06p41170.2_BraZ1	2042.2	-	943	3238	3248	0.9969212
A06	50605585	50605930	A06p41180.2_BraZ1	20.7	-	131	345	345	1.0000000
A06	50606462	50607269	A06p41190.2_BraZ1	79.2	-	386	757	807	0.9380421
A06	50614983	50616684	A06p41200.2_BraZ1	267	-	280	1577	1701	0.9271017
A06	50617639	50617987	A06p41210.2_BraZ1	34.8	-	518	348	348	1.0000000
A06	50619055	50619199	A06p41220.2_BraZ1	14.4	-	2	136	144	0.9444444
A06	50620066	50620414	A06p41230.2_BraZ1	34.8	-	75	348	348	1.0000000
A06	50622491	50622839	A06p41240.2_BraZ1	34.8	-	174	348	348	1.0000000
A06	50625342	50625690	A06p41250.2_BraZ1	34.8	-	24	275	348	0.7902299
A06	50627120	50627468	A06p41260.2_BraZ1	34.8	-	0	0	348	0.0000000
A06	50628341	50628689	A06p41270.2_BraZ1	34.8	-	5	323	348	0.9281609
A06	50629561	50629909	A06p41280.2_BraZ1	34.8	-	22	346	348	0.9942529
A06	50630779	50636567	A06p41290.2_BraZ1	192	-	3482	5701	5788	0.9849689
A06	50632507	50633168	A06p41300.2_BraZ1	489	-	408	661	661	1.0000000
A06	50636618	50637401	A06p41310.2_BraZ1	78.3	+	470	758	783	0.9680715
A06	50641695	50641962	A06p41320.2_BraZ1	26.7	-	12	203	267	0.7602996
A06	50646454	50647792	A06p41330.2_BraZ1	44.1	-	1237	1338	1338	1.0000000
A06	50654331	50657576	A06p41340.2_BraZ1	2288.27	-	1163	3221	3245	0.9926040
A06	50667747	50668311	A06p41350.2_BraZ1	56.4	+	3	17	564	0.0301418
A06	50670956	50671744	A06p41360.2_BraZ1	384.037	+	350	788	788	1.0000000
A06	50672153	50673916	A06p41370.2_BraZ1	1385.22	-	1016	1460	1763	0.8281339
A06	50675440	50676202	A06p41380.2_BraZ1	286.875	+	145	737	762	0.9671916
A06	50677936	50679903	A06p41390.2_BraZ1	1122	-	1091	1950	1967	0.9913574
A06	50685615	50687117	A06p41400.2_BraZ1	91.2857	-	370	981	1502	0.6531292
A06	50689480	50692692	A06p41410.2_BraZ1	1192.92	-	731	2994	3212	0.9321295
A06	50692796	50701233	A06p41420.2_BraZ1	476.211	+	4728	5918	8437	0.7014341
A06	50696803	50697379	A06p41430.2_BraZ1	162	-	8	302	576	0.5243056
A06	50711128	50711489	A06p41440.2_BraZ1	240	+	338	361	361	1.0000000
A06	50718685	50719151	A06p41450.2_BraZ1	39	-	193	466	466	1.0000000
A06	50720972	50721140	A06p41460.2_BraZ1	16.8	+	30	71	168	0.4226190
A06	50725961	50727446	A06p41470.2_BraZ1	387	-	1640	1485	1485	1.0000000
A06	50733233	50733652	A06p41480.2_BraZ1	354	+	455	419	419	1.0000000
A06	50733741	50734086	A06p41490.2_BraZ1	34.5	+	557	345	345	1.0000000
A06	50734536	50736861	A06p41500.2_BraZ1	1016.69	+	2311	2320	2325	0.9978495
A06	50738362	50738646	A06p41510.2_BraZ1	19.5	+	208	284	284	1.0000000
A06	50739509	50739641	A06p41520.2_BraZ1	13.2	-	405	132	132	1.0000000
A06	50739848	50742121	A06p41530.2_BraZ1	1434	-	1202	2273	2273	1.0000000
A06	50743657	50745896	A06p41540.2_BraZ1	930	-	831	1953	2239	0.8722644
A06	50747902	50749024	A06p41550.2_BraZ1	112.2	+	375	1122	1122	1.0000000
A06	50749210	50749541	A06p41560.2_BraZ1	225	+	509	331	331	1.0000000
A06	50752019	50753058	A06p41570.2_BraZ1	444	-	1444	1039	1039	1.0000000
A06	50756626	50759477	A06p41580.2_BraZ1	1396.29	+	2078	2851	2851	1.0000000
A06	50764096	50767610	A06p41590.2_BraZ1	2460.27	+	1687	3358	3514	0.9556062
A06	50770309	50771986	A06p41600.2_BraZ1	1071.71	-	1516	1677	1677	1.0000000
A06	50775284	50775657	A06p41610.2_BraZ1	27.9	-	133	373	373	1.0000000
A06	50776470	50777039	A06p41620.2_BraZ1	438	-	91	461	569	0.8101933
A06	50780166	50781343	A06p41630.2_BraZ1	602.062	-	525	1162	1177	0.9872558
A06	50782108	50782574	A06p41640.2_BraZ1	291	-	325	466	466	1.0000000
A06	50785579	50788186	A06p41650.2_BraZ1	1611	+	1708	2588	2607	0.9927119
A06	50790329	50791822	A06p41660.2_BraZ1	780	-	665	1294	1493	0.8667113
A06	50797659	50798421	A06p41670.2_BraZ1	76.2	+	566	762	762	1.0000000
A06	50801189	50802228	A06p41680.2_BraZ1	450.439	+	932	1039	1039	1.0000000
A06	50802569	50804913	A06p41690.2_BraZ1	1240.61	-	1735	2344	2344	1.0000000
A06	50805240	50806659	A06p41700.2_BraZ1	534.857	+	1100	1419	1419	1.0000000
A06	50807479	50807820	A06p41710.2_BraZ1	246	+	466	341	341	1.0000000
A06	50807820	50810345	A06p41720.2_BraZ1	387.545	+	1566	2489	2525	0.9857426
A06	50810819	50816171	A06p41730.2_BraZ1	765	-	5084	5352	5352	1.0000000
A06	50821699	50823750	A06p41740.2_BraZ1	747	-	1256	2051	2051	1.0000000
A06	50836512	50838984	A06p41750.2_BraZ1	1211.47	+	179	1766	2472	0.7144013
A06	50840344	50841823	A06p41760.2_BraZ1	741	-	1096	1479	1479	1.0000000
A06	50845996	50849521	A06p41770.2_BraZ1	2072.78	-	875	2433	3525	0.6902128
A06	50849955	50850807	A06p41780.2_BraZ1	495	-	762	852	852	1.0000000
A06	50855477	50857241	A06p41790.2_BraZ1	176.4	+	483	1664	1764	0.9433107
A06	50857703	50858759	A06p41800.2_BraZ1	468	-	913	1056	1056	1.0000000
A06	50860378	50861767	A06p41810.2_BraZ1	684	-	1483	1351	1389	0.9726422
A06	50863688	50868232	A06p41820.2_BraZ1	2313.01	-	2020	4347	4544	0.9566461
A06	50872033	50872948	A06p41830.2_BraZ1	134.75	-	58	780	915	0.8524590
A06	50878703	50879300	A06p41840.2_BraZ1	42.9	-	887	597	597	1.0000000
A06	50880819	50884294	A06p41850.2_BraZ1	2215.93	-	1583	2907	3475	0.8365468
A06	50887837	50888110	A06p41860.2_BraZ1	27.3	+	381	273	273	1.0000000
A06	50889034	50889736	A06p41870.2_BraZ1	70.2	+	511	683	702	0.9729345
A06	50897091	50902471	A06p41880.2_BraZ1	1822.79	+	3460	5366	5380	0.9973978
A06	50903181	50904874	A06p41890.2_BraZ1	1308	-	993	1676	1693	0.9899586
A06	50907729	50908737	A06p41900.2_BraZ1	100.8	-	186	724	1008	0.7182540
A06	50911287	50912464	A06p41910.2_BraZ1	468.837	+	588	1161	1177	0.9864061
A06	50913010	50914605	A06p41920.2_BraZ1	899.646	+	965	1595	1595	1.0000000
A06	50915196	50916778	A06p41930.2_BraZ1	63.9	-	1234	1582	1582	1.0000000
A06	50920545	50926464	A06p41940.2_BraZ1	2396.24	+	3370	5843	5919	0.9871600
A06	50926636	50936940	A06p41950.2_BraZ1	2009.81	-	4583	9865	10304	0.9573952
A06	50928357	50928879	A06p41960.2_BraZ1	52.2	-	225	522	522	1.0000000
A06	50939494	50940884	A06p41970.2_BraZ1	984	-	718	1343	1390	0.9661871
A06	50943018	50944733	A06p41980.2_BraZ1	853.662	-	75	624	1715	0.3638484
A06	50955818	50956532	A06p41990.2_BraZ1	71.4	-	415	714	714	1.0000000
A06	50960370	50963164	A06p42000.2_BraZ1	1522.23	+	2417	2743	2794	0.9817466
A06	50965648	50969247	A06p42010.2_BraZ1	777.754	+	3716	3599	3599	1.0000000
A06	50969335	50970037	A06p42020.2_BraZ1	70.2	-	362	700	702	0.9971510
A06	50970737	50975311	A06p42030.2_BraZ1	2728.9	+	2380	4574	4574	1.0000000
A06	50975788	50980882	A06p42040.2_BraZ1	2327.86	-	3027	4977	5094	0.9770318
A06	50982619	50983578	A06p42050.2_BraZ1	208.552	-	477	959	959	1.0000000
A06	50988867	50991669	A06p42060.2_BraZ1	1498	+	978	2505	2802	0.8940043
A06	50993753	50995755	A06p42070.2_BraZ1	30487.5	+	461	1678	2002	0.8381618
A06	51001049	51005978	A06p42080.2_BraZ1	1162.55	-	1264	4526	4929	0.9182390
A06	51012685	51017520	A06p42090.2_BraZ1	2160.54	+	2072	4777	4835	0.9880041
A06	51017637	51017943	A06p42100.2_BraZ1	210	+	419	306	306	1.0000000
A06	51018055	51022062	A06p42110.2_BraZ1	2384.33	+	2091	3732	4007	0.9313701
A06	51023944	51034778	A06p42120.2_BraZ1	1895.97	+	3904	6264	10834	0.5781798
A06	51035090	51036443	A06p42130.2_BraZ1	135.3	-	536	1273	1353	0.9408721
A06	51037164	51039621	A06p42140.2_BraZ1	1401	-	1007	2103	2457	0.8559219
A06	51050812	51057094	A06p42150.2_BraZ1	912	+	3977	4598	6282	0.7319325
A06	51057827	51061398	A06p42160.2_BraZ1	1735.03	-	5513	3571	3571	1.0000000
A06	51064952	51066852	A06p42170.2_BraZ1	1209.31	-	940	1900	1900	1.0000000
A06	51068226	51070719	A06p42180.2_BraZ1	249.3	+	910	2493	2493	1.0000000
A06	51071065	51072052	A06p42190.2_BraZ1	98.7	+	101	592	987	0.5997974
A06	51072939	51075377	A06p42200.2_BraZ1	1560.65	-	356	2139	2438	0.8773585
A06	51090888	51092184	A06p42210.2_BraZ1	1118.02	-	962	1211	1296	0.9344136
A06	51092109	51099835	A06p42220.2_BraZ1	2122.73	-	4340	7322	7726	0.9477090
A06	51105973	51106516	A06p42230.2_BraZ1	54.3	-	712	543	543	1.0000000
A06	51107241	51110422	A06p42240.2_BraZ1	2674.74	-	1071	3092	3181	0.9720214
A06	51113077	51114874	A06p42250.2_BraZ1	90.6	-	572	1471	1797	0.8185865
A06	51120876	51121173	A06p42260.2_BraZ1	29.7	+	235	297	297	1.0000000
A06	51121537	51123672	A06p42270.2_BraZ1	1461.8	-	998	1932	2135	0.9049180
A06	51124161	51125438	A06p42280.2_BraZ1	190	+	1001	1256	1277	0.9835552
A06	51131105	51131912	A06p42290.2_BraZ1	80.7	-	815	807	807	1.0000000
A06	51132316	51132838	A06p42300.2_BraZ1	192	+	461	522	522	1.0000000
A06	51133430	51134758	A06p42310.2_BraZ1	942	-	322	1102	1328	0.8298193
A06	51136741	51139919	A06p42320.2_BraZ1	1319.37	-	1631	3039	3178	0.9562618
A06	51140552	51142088	A06p42330.2_BraZ1	153	+	111	1256	1536	0.8177083
A06	51144684	51146290	A06p42340.2_BraZ1	919.273	+	523	1574	1606	0.9800747
A06	51146871	51150518	A06p42350.2_BraZ1	1399.54	-	1404	3546	3647	0.9723060
A06	51154165	51157440	A06p42360.2_BraZ1	1535.6	-	884	2939	3275	0.8974046
A06	51163657	51164166	A06p42370.2_BraZ1	264	+	484	509	509	1.0000000
A06	51166502	51167693	A06p42380.2_BraZ1	494.875	-	1240	1191	1191	1.0000000
A06	51172162	51180261	A06p42390.2_BraZ1	3785.87	+	5489	7653	8099	0.9449314
A06	51185604	51187415	A06p42400.2_BraZ1	1725	-	550	1761	1811	0.9723909
A06	51189299	51190745	A06p42410.2_BraZ1	592.341	-	480	1253	1446	0.8665283
A06	51193395	51193616	A06p42420.2_BraZ1	18.3	-	304	212	221	0.9592760
A06	51196439	51196793	A06p42430.2_BraZ1	35.4	-	525	354	354	1.0000000
A06	51196847	51212897	A06p42440.2_BraZ1	4989.71	-	9921	14539	16050	0.9058567
A06	51214254	51217840	A06p42450.2_BraZ1	1880.77	+	1911	3551	3586	0.9902398
A06	51219594	51219921	A06p42460.2_BraZ1	32.7	-	361	327	327	1.0000000
A06	51219955	51225028	A06p42470.2_BraZ1	733.479	+	4028	4053	5073	0.7989355
A06	51225795	51227278	A06p42480.2_BraZ1	411	-	1321	1483	1483	1.0000000
A06	51227866	51228097	A06p42490.2_BraZ1	23.1	-	359	231	231	1.0000000
A06	51228481	51229680	A06p42500.2_BraZ1	488.235	+	979	1199	1199	1.0000000
A06	51230351	51232997	A06p42510.2_BraZ1	1476.56	-	1616	2544	2646	0.9614512
A06	51243716	51245175	A06p42520.2_BraZ1	809.64	-	720	1443	1459	0.9890336
A06	51246032	51255092	A06p42530.2_BraZ1	6907.25	+	4905	8963	9060	0.9892936
A06	51264058	51267109	A06p42540.2_BraZ1	2413.95	+	836	3010	3051	0.9865618
A06	51267831	51268317	A06p42550.2_BraZ1	1356	+	658	486	486	1.0000000
A06	51268764	51269097	A06p42560.2_BraZ1	592	+	388	333	333	1.0000000
A06	51270825	51272040	A06p42570.2_BraZ1	121.5	+	782	1215	1215	1.0000000
A06	51274786	51278863	A06p42580.2_BraZ1	1896.6	+	1801	3633	4077	0.8910964
A06	51285427	51287878	A06p42590.2_BraZ1	1341.04	-	1548	2400	2451	0.9791921
A06	51289459	51290642	A06p42600.2_BraZ1	1030.05	-	474	1183	1183	1.0000000
A06	51296365	51297732	A06p42610.2_BraZ1	783	-	95	421	1367	0.3079737
A06	51302390	51302839	A06p42620.2_BraZ1	348	-	230	449	449	1.0000000
A06	51303416	51304443	A06p42630.2_BraZ1	777	-	216	834	1027	0.8120740
A06	51307846	51309586	A06p42640.2_BraZ1	190.286	-	428	1504	1740	0.8643678
A06	51310618	51311603	A06p42650.2_BraZ1	738.15	-	62	651	985	0.6609137
A06	51320123	51320541	A06p42660.2_BraZ1	327	+	88	382	418	0.9138756
A06	51322457	51336386	A06p42670.2_BraZ1	1567.29	-	2311	8560	13929	0.6145452
A06	51343560	51345039	A06p42680.2_BraZ1	4185	-	83	1291	1479	0.8728871
A06	51345762	51348471	A06p42690.2_BraZ1	838.462	-	1298	2609	2709	0.9630860
A06	51349467	51353614	A06p42700.2_BraZ1	915	+	494	1077	4147	0.2597058
A06	51350183	51351355	A06p42710.2_BraZ1	101.1	+	3	132	1172	0.1126280
A06	51354525	51359143	A06p42720.2_BraZ1	1482.01	-	2086	4219	4618	0.9135990
A06	51360442	51364003	A06p42730.2_BraZ1	506.515	+	2136	3561	3561	1.0000000
A06	51364882	51365896	A06p42740.2_BraZ1	101.4	-	172	740	1014	0.7297831
A06	51377957	51382677	A06p42750.2_BraZ1	883.5	+	3752	4720	4720	1.0000000
A06	51383463	51384625	A06p42760.2_BraZ1	113.542	+	1182	1110	1162	0.9552495
A06	51393546	51393759	A06p42770.2_BraZ1	21.3	-	32	160	213	0.7511737
A06	51398106	51399649	A06p42780.2_BraZ1	579.333	-	278	1181	1543	0.7653921
A06	51410529	51413196	A06p42790.2_BraZ1	1320	-	1145	2667	2667	1.0000000
A06	51418068	51419555	A06p42800.2_BraZ1	747	-	731	1487	1487	1.0000000
A06	51427816	51428403	A06p42810.2_BraZ1	516	+	198	562	587	0.9574106
A06	51429751	51430198	A06p42820.2_BraZ1	44.7	+	250	447	447	1.0000000
A06	51431003	51433540	A06p42830.2_BraZ1	16623.8	+	512	2407	2537	0.9487584
A06	51433769	51436367	A06p42840.2_BraZ1	1091.07	-	1906	2532	2598	0.9745958
A06	51442301	51443729	A06p42850.2_BraZ1	142.8	+	115	1178	1428	0.8249300
A06	51444066	51445572	A06p42860.2_BraZ1	507	-	359	1133	1506	0.7523240
A06	51447512	51449871	A06p42870.2_BraZ1	9184.5	-	412	2322	2359	0.9843154
A06	51460622	51460733	A06p42880.2_BraZ1	11.1	-	94	111	111	1.0000000
A06	51461357	51462824	A06p42890.2_BraZ1	743.262	+	1681	1467	1467	1.0000000
A06	51465915	51466197	A06p42900.2_BraZ1	28.2	-	387	282	282	1.0000000
A06	51478887	51480591	A06p42910.2_BraZ1	680.942	+	10	111	1704	0.0651408
A06	51481643	51481929	A06p42920.2_BraZ1	264	-	9	128	286	0.4475524
A06	51493369	51495303	A06p42930.2_BraZ1	959.583	+	321	1695	1934	0.8764219
A06	51495303	51495534	A06p42940.2_BraZ1	162	+	21	163	231	0.7056277
A06	51496381	51497271	A06p42950.2_BraZ1	1327.5	-	878	890	890	1.0000000
A06	51498453	51501819	A06p42960.2_BraZ1	504	+	2137	3178	3366	0.9441473
A06	51498891	51500195	A06p42970.2_BraZ1	711	+	420	1192	1304	0.9141104
A06	51505111	51506665	A06p42980.2_BraZ1	1257.68	+	1812	1554	1554	1.0000000
A06	51507250	51518973	A06p42990.2_BraZ1	4770.44	-	5213	10155	11723	0.8662459
A06	51524731	51543204	A06p43000.2_BraZ1	9716.87	-	6330	15430	18473	0.8352731
A06	51547387	51548476	A06p43010.2_BraZ1	744	+	361	1032	1089	0.9476584
A06	51549435	51550616	A06p43020.2_BraZ1	864.474	+	408	1081	1181	0.9153260
A06	51551000	51556367	A06p43030.2_BraZ1	2709.12	-	2250	4567	5367	0.8509409
A06	51557962	51559802	A06p43040.2_BraZ1	1242	+	607	1660	1840	0.9021739
A06	51566891	51568910	A06p43050.2_BraZ1	1741.94	+	813	2019	2019	1.0000000
A06	51569888	51573654	A06p43060.2_BraZ1	1265.98	-	2858	3756	3766	0.9973447
A06	51577586	51578024	A06p43070.2_BraZ1	234	-	0	0	438	0.0000000
A06	51580793	51581204	A06p43080.2_BraZ1	41.1	+	224	411	411	1.0000000
A06	51583939	51584243	A06p43090.2_BraZ1	20.7	+	143	304	304	1.0000000
A06	51586104	51587495	A06p43100.2_BraZ1	1204	+	820	1279	1391	0.9194824
A06	51588548	51590244	A06p43110.2_BraZ1	1377.44	-	634	1638	1696	0.9658019
A06	51595496	51596750	A06p43120.2_BraZ1	125.4	+	251	1223	1254	0.9752791
A06	51598535	51599307	A06p43130.2_BraZ1	690	-	392	772	772	1.0000000
A06	51601191	51601534	A06p43140.2_BraZ1	258	+	5	103	343	0.3002915
A06	51607804	51611458	A06p43150.2_BraZ1	1495.2	-	1599	2961	3654	0.8103448
A06	51624505	51625504	A06p43160.2_BraZ1	99.9	+	551	999	999	1.0000000
A06	51629601	51630015	A06p43170.2_BraZ1	41.4	+	157	320	414	0.7729468
A06	51632399	51633952	A06p43180.2_BraZ1	1056	+	227	1472	1553	0.9478429
A06	51634412	51641191	A06p43190.2_BraZ1	2116.55	-	2335	6486	6779	0.9567783
A06	51641341	51641739	A06p43200.2_BraZ1	270	+	145	398	398	1.0000000
A06	51649336	51650218	A06p43210.2_BraZ1	88.2	-	298	882	882	1.0000000
A06	51651806	51652291	A06p43220.2_BraZ1	375	+	85	287	485	0.5917526
A06	51652674	51653540	A06p43230.2_BraZ1	84.9	-	365	847	866	0.9780601
A06	51654772	51655088	A06p43240.2_BraZ1	162	+	0	0	316	0.0000000
A06	51655092	51656523	A06p43250.2_BraZ1	519	+	0	0	1431	0.0000000
A06	51662635	51663643	A06p43260.2_BraZ1	258	-	2231	1008	1008	1.0000000
A06	51664845	51665131	A06p43270.2_BraZ1	168	+	0	0	286	0.0000000
A06	51665810	51666541	A06p43280.2_BraZ1	1436.5	-	1	54	731	0.0738714
A06	51671490	51673208	A06p43290.2_BraZ1	1277.78	+	227	1566	1718	0.9115250
A06	51673523	51676039	A06p43300.2_BraZ1	1027.05	-	1188	2347	2516	0.9328299
A06	51676732	51680890	A06p43310.2_BraZ1	210	-	165	3204	4158	0.7705628
A06	51677336	51677861	A06p43320.2_BraZ1	52.5	+	10	463	525	0.8819048
A06	51681526	51682602	A06p43330.2_BraZ1	753	+	114	1015	1076	0.9433085
A06	51685611	51688210	A06p43340.2_BraZ1	573.913	+	1531	2570	2599	0.9888419
A06	51688936	51689591	A06p43350.2_BraZ1	570	-	528	655	655	1.0000000
A06	51690301	51692513	A06p43360.2_BraZ1	1140.79	+	1720	2212	2212	1.0000000
A06	51696470	51697847	A06p43370.2_BraZ1	137.7	-	663	1339	1377	0.9724038
A06	51708577	51710184	A06p43380.2_BraZ1	1515	+	408	1346	1607	0.8375856
A06	51722634	51724216	A06p43390.2_BraZ1	6960	+	269	1442	1582	0.9115044
A06	51724926	51726484	A06p43400.2_BraZ1	1491	-	1403	1545	1558	0.9916559
A06	51733655	51734445	A06p43410.2_BraZ1	485	-	44	542	790	0.6860759
A06	51739029	51739770	A06p43420.2_BraZ1	74.1	+	586	741	741	1.0000000
A06	51742246	51743095	A06p43430.2_BraZ1	59.1	+	7	85	849	0.1001178
A06	51746010	51747201	A06p43440.2_BraZ1	66.3	+	639	1191	1191	1.0000000
A06	51748071	51748360	A06p43450.2_BraZ1	246	-	479	289	289	1.0000000
A06	51754423	51755122	A06p43460.2_BraZ1	579	-	295	699	699	1.0000000
A06	51766923	51768221	A06p43470.2_BraZ1	555	+	646	1274	1298	0.9815100
A06	51776710	51778638	A06p43480.2_BraZ1	981.257	+	1022	1928	1928	1.0000000
A06	51779123	51785578	A06p43490.2_BraZ1	1744.69	-	3189	6307	6455	0.9770721
A06	51797982	51798606	A06p43500.2_BraZ1	62.4	+	216	624	624	1.0000000
A06	51798919	51799267	A06p43510.2_BraZ1	337.5	+	163	348	348	1.0000000
A06	51801697	51801889	A06p43520.2_BraZ1	19.2	+	145	192	192	1.0000000
A06	51803044	51807509	A06p43530.2_BraZ1	2923.6	+	972	4030	4465	0.9025756
A06	51813212	51815623	A06p43540.2_BraZ1	1355.55	+	905	2187	2411	0.9070925
A06	51815820	51817808	A06p43550.2_BraZ1	1359.76	-	692	1835	1988	0.9230382
A06	51818247	51819044	A06p43560.2_BraZ1	162	-	710	797	797	1.0000000
A06	51824162	51825239	A06p43570.2_BraZ1	107.7	+	526	1048	1077	0.9730734
A06	51826196	51827210	A06p43580.2_BraZ1	602.727	+	146	894	1014	0.8816568
A06	51827779	51829794	A06p43590.2_BraZ1	1869	-	775	2015	2015	1.0000000
A06	51831849	51839583	A06p43600.2_BraZ1	2281.27	-	2835	7316	7734	0.9459530
A06	51843315	51845264	A06p43610.2_BraZ1	451.313	-	213	1716	1949	0.8804515
A06	51854259	51855526	A06p43620.2_BraZ1	462	+	682	1265	1267	0.9984215
A06	51857921	51858962	A06p43630.2_BraZ1	104.1	+	273	692	1041	0.6647455
A06	51859750	51862694	A06p43640.2_BraZ1	1666.99	-	1162	2727	2944	0.9262908
A06	51863080	51866912	A06p43650.2_BraZ1	1445.04	+	1346	3675	3832	0.9590293
A06	51870561	51872420	A06p43660.2_BraZ1	20424	+	679	1713	1859	0.9214631
A06	51872781	51874333	A06p43670.2_BraZ1	1865.5	-	1627	1552	1552	1.0000000
A06	51877472	51879655	A06p43680.2_BraZ1	1002.67	-	2671	2183	2183	1.0000000
A06	51883899	51884663	A06p43690.2_BraZ1	510	+	6	250	764	0.3272251
A06	51893829	51894643	A06p43700.2_BraZ1	324	-	22	185	814	0.2272727
A06	51896364	51900921	A06p43710.2_BraZ1	1155	+	3186	4530	4557	0.9940751
A06	51901127	51902691	A06p43720.2_BraZ1	1488	-	369	1418	1564	0.9066496
A06	51903731	51907752	A06p43730.2_BraZ1	27820	+	2413	3825	4021	0.9512559
A06	51907938	51909082	A06p43740.2_BraZ1	954	-	592	1144	1144	1.0000000
A06	51909983	51910684	A06p43750.2_BraZ1	522	-	461	701	701	1.0000000
A06	51914379	51915639	A06p43760.2_BraZ1	126	+	267	1166	1260	0.9253968
A06	51916401	51917260	A06p43770.2_BraZ1	272.276	+	592	859	859	1.0000000
A06	51918014	51919610	A06p43780.2_BraZ1	537.496	+	697	1515	1596	0.9492481
A06	51919291	51920422	A06p43790.2_BraZ1	351.768	+	289	1052	1131	0.9301503
A06	51920944	51923810	A06p43800.2_BraZ1	2205	-	2106	2813	2866	0.9815073
A06	51938114	51940138	A06p43810.2_BraZ1	1908	-	497	1709	2024	0.8443676
A06	51949975	51950799	A06p43820.2_BraZ1	332.75	+	13	331	824	0.4016990
A06	51973728	51974811	A06p43830.2_BraZ1	108.3	-	352	897	1083	0.8282548
A06	51975035	51976986	A06p43840.2_BraZ1	1278.85	-	28	651	1951	0.3336750
A06	51979681	51979843	A06p43850.2_BraZ1	16.2	-	148	162	162	1.0000000
A06	51984551	51985927	A06p43860.2_BraZ1	55.8	+	229	1084	1376	0.7877907
A06	51986974	51989619	A06p43870.2_BraZ1	1170.7	-	775	1824	2645	0.6896030
A06	51994479	51995964	A06p43880.2_BraZ1	148.5	+	38	647	1485	0.4356902
A06	52005661	52007250	A06p43890.2_BraZ1	815	+	732	1486	1589	0.9351794
A06	52010918	52013186	A06p43900.2_BraZ1	1594.78	-	1546	2122	2268	0.9356261
A06	52013901	52014624	A06p43910.2_BraZ1	458.449	+	178	723	723	1.0000000
A06	52014924	52017474	A06p43920.2_BraZ1	960.251	-	850	2428	2550	0.9521568
A06	52018329	52021260	A06p43930.2_BraZ1	1665.08	-	945	2648	2931	0.9034459
A06	52025628	52027995	A06p43940.2_BraZ1	81.1579	+	69	484	2367	0.2044782
A06	52027853	52028664	A06p43950.2_BraZ1	108.221	+	19	464	811	0.5721332
A06	52033803	52037034	A06p43960.2_BraZ1	2932.63	+	1491	3214	3231	0.9947385
A06	52052446	52053121	A06p43970.2_BraZ1	67.5	-	337	675	675	1.0000000
A06	52060353	52062766	A06p43980.2_BraZ1	1626.9	-	736	2056	2413	0.8520514
A06	52074048	52075295	A06p43990.2_BraZ1	3111.43	-	197	1056	1247	0.8468324
A06	52078945	52079473	A06p44000.2_BraZ1	52.8	-	429	528	528	1.0000000
A06	52082160	52085610	A06p44010.2_BraZ1	1596.12	+	2309	3450	3450	1.0000000
A06	52089642	52090689	A06p44020.2_BraZ1	628.364	+	243	796	1047	0.7602674
A06	52091625	52093825	A06p44030.2_BraZ1	1424.55	+	1236	2104	2200	0.9563636
A06	52098607	52101699	A06p44040.2_BraZ1	302.1	+	2043	3065	3092	0.9912678
A06	52108367	52109408	A06p44050.2_BraZ1	104.1	+	516	1041	1041	1.0000000
A06	52120356	52121526	A06p44060.2_BraZ1	819	-	2834	1170	1170	1.0000000
A06	52123095	52123363	A06p44070.2_BraZ1	189	+	625	268	268	1.0000000
A06	52124824	52125976	A06p44080.2_BraZ1	115.2	-	2341	1152	1152	1.0000000
A06	52126133	52127356	A06p44090.2_BraZ1	741	-	2578	1223	1223	1.0000000
A06	52128100	52130370	A06p44100.2_BraZ1	1134	-	1023	1987	2270	0.8753304
A06	52133583	52135029	A06p44110.2_BraZ1	1161	+	695	1431	1446	0.9896265
A06	52135289	52137150	A06p44120.2_BraZ1	951.083	-	892	1745	1861	0.9376679
A06	52137948	52140212	A06p44130.2_BraZ1	1309.03	+	773	1831	2264	0.8087456
A06	52140749	52142924	A06p44140.2_BraZ1	971.856	-	390	1815	2175	0.8344827
A06	52143875	52144349	A06p44150.2_BraZ1	47.4	-	164	470	474	0.9915612
A06	52146741	52147206	A06p44160.2_BraZ1	46.5	-	9	227	465	0.4881721
A06	52147820	52148198	A06p44170.2_BraZ1	37.8	+	71	324	378	0.8571429
A06	52148748	52149436	A06p44180.2_BraZ1	58.5	-	21	382	688	0.5552326
A06	52152774	52155599	A06p44190.2_BraZ1	2342.7	+	2904	2825	2825	1.0000000
A06	52155678	52156695	A06p44200.2_BraZ1	468	+	1107	1017	1017	1.0000000
A06	52162785	52164576	A06p44210.2_BraZ1	454	-	1748	1765	1791	0.9854830
A06	52179042	52181796	A06p44220.2_BraZ1	2661	+	1506	2659	2754	0.9655047
A06	52182590	52183470	A06p44230.2_BraZ1	505.714	-	516	872	880	0.9909091
A06	52186348	52187371	A06p44240.2_BraZ1	102.3	+	83	889	1023	0.8690127
A06	52187642	52189618	A06p44250.2_BraZ1	760.37	-	363	1719	1976	0.8699393
A06	52190863	52191241	A06p44260.2_BraZ1	37.8	-	218	378	378	1.0000000
A06	52195598	52198034	A06p44270.2_BraZ1	243.6	-	364	1653	2436	0.6785714
A06	52203259	52204346	A06p44280.2_BraZ1	506.25	-	605	1087	1087	1.0000000
A06	52208984	52209245	A06p44290.2_BraZ1	138	+	138	261	261	1.0000000
A06	52213475	52214438	A06p44300.2_BraZ1	96.3	-	151	733	963	0.7611631
A06	52222369	52227453	A06p44310.2_BraZ1	2321.6	+	2698	4776	5084	0.9394178
A06	52228992	52231298	A06p44320.2_BraZ1	1000	+	305	1922	2306	0.8334779
A06	52234261	52236129	A06p44330.2_BraZ1	807.852	+	298	943	1868	0.5048180
A06	52248740	52250445	A06p44340.2_BraZ1	914.447	+	573	1615	1705	0.9472141
A06	52251334	52254555	A06p44350.2_BraZ1	1449	-	870	2636	3221	0.8183794
A06	52259665	52262469	A06p44360.2_BraZ1	582.562	+	1455	2710	2804	0.9664764
A06	52263722	52263959	A06p44370.2_BraZ1	23.7	+	118	237	237	1.0000000
A06	52264618	52267725	A06p44380.2_BraZ1	2032.12	-	913	3107	3107	1.0000000
A06	52268646	52269753	A06p44390.2_BraZ1	285	+	653	1107	1107	1.0000000
A06	52269888	52271651	A06p44400.2_BraZ1	1166.5	+	745	1573	1763	0.8922291
A06	52272957	52273263	A06p44410.2_BraZ1	30.6	+	92	280	306	0.9150327
A06	52274595	52282812	A06p44420.2_BraZ1	10780	+	3208	7882	8217	0.9592308
A06	52283461	52285848	A06p44430.2_BraZ1	699	+	1673	1770	2387	0.7415165
A06	52285948	52286493	A06p44440.2_BraZ1	369	+	404	545	545	1.0000000
A06	52286844	52288263	A06p44450.2_BraZ1	657	-	895	1419	1419	1.0000000
A06	52288637	52291104	A06p44460.2_BraZ1	92.7273	+	2169	2467	2467	1.0000000
A06	52291890	52295409	A06p44470.2_BraZ1	904.519	-	3107	3519	3519	1.0000000
A06	52297642	52299991	A06p44480.2_BraZ1	1175.62	+	350	2194	2349	0.9340145
A06	52306292	52307598	A06p44490.2_BraZ1	1071	-	180	1129	1306	0.8644717
A06	52328671	52329766	A06p44500.2_BraZ1	109.5	+	145	686	1095	0.6264840
A06	52334085	52334388	A06p44510.2_BraZ1	189	+	121	292	303	0.9636964
A06	52334808	52335306	A06p44520.2_BraZ1	348	-	124	498	498	1.0000000
A06	52337206	52337815	A06p44530.2_BraZ1	60.9	+	477	609	609	1.0000000
A06	52343954	52344215	A06p44540.2_BraZ1	26.1	-	239	261	261	1.0000000
A06	52345536	52346252	A06p44550.2_BraZ1	323.4	+	119	699	716	0.9762570
A06	52349512	52352170	A06p44560.2_BraZ1	356.818	+	2720	2658	2658	1.0000000
A06	52353253	52354714	A06p44570.2_BraZ1	141.9	+	366	1256	1461	0.8596851
A06	52359121	52361059	A06p44580.2_BraZ1	1175.93	-	1337	1938	1938	1.0000000
A06	52362805	52364923	A06p44590.2_BraZ1	878.836	-	1367	2100	2118	0.9915014
A06	52365786	52365966	A06p44600.2_BraZ1	18	-	139	176	180	0.9777778
A06	52367106	52369056	A06p44610.2_BraZ1	1073.74	-	2031	1950	1950	1.0000000
A06	52372729	52372966	A06p44620.2_BraZ1	23.7	+	336	237	237	1.0000000
A06	52373643	52374664	A06p44630.2_BraZ1	336	+	608	1017	1021	0.9960822
A06	52378959	52379205	A06p44640.2_BraZ1	24.6	-	300	246	246	1.0000000
A06	52385915	52387719	A06p44650.2_BraZ1	829.02	+	726	1782	1804	0.9878049
A06	52391071	52395189	A06p44660.2_BraZ1	1959.06	+	1674	3898	4118	0.9465760
A06	52399077	52403464	A06p44670.2_BraZ1	2029.57	+	4417	4387	4387	1.0000000
A06	52403730	52409100	A06p44680.2_BraZ1	2505.83	+	3066	5365	5370	0.9990689
A06	52412386	52415015	A06p44690.2_BraZ1	1574.86	+	536	2602	2629	0.9897299
A06	52415185	52417156	A06p44700.2_BraZ1	598	+	1052	1971	1971	1.0000000
A06	52415456	52415840	A06p44710.2_BraZ1	38.4	+	448	384	384	1.0000000
A06	52418591	52419720	A06p44720.2_BraZ1	96	+	244	990	1129	0.8768822
A06	52421346	52422990	A06p44730.2_BraZ1	741.2	+	573	1644	1644	1.0000000
A06	52430265	52435316	A06p44740.2_BraZ1	2541.48	+	1534	5017	5051	0.9932687
A06	52436103	52442286	A06p44750.2_BraZ1	3031.94	-	2883	6154	6183	0.9953097
A06	52446142	52448721	A06p44760.2_BraZ1	1871.72	+	816	2238	2579	0.8677782
A06	52453129	52453435	A06p44770.2_BraZ1	30.6	-	175	306	306	1.0000000
A06	52460939	52462344	A06p44780.2_BraZ1	6963	-	1776	1405	1405	1.0000000
A06	52462703	52462963	A06p44790.2_BraZ1	16.8	-	430	260	260	1.0000000
A06	52465246	52466446	A06p44800.2_BraZ1	85.5	-	481	1200	1200	1.0000000
A06	52467108	52468655	A06p44810.2_BraZ1	698.364	-	473	1282	1547	0.8287007
A06	52487576	52487882	A06p44820.2_BraZ1	30.6	-	112	306	306	1.0000000
A06	52495202	52496057	A06p44830.2_BraZ1	85.5	-	12	272	855	0.3181286
A06	52500979	52503495	A06p44840.2_BraZ1	213.3	+	375	1915	2516	0.7611288
A06	52510144	52511219	A06p44850.2_BraZ1	505.909	+	933	1075	1075	1.0000000
A06	52512476	52513529	A06p44860.2_BraZ1	493.364	-	981	1045	1053	0.9924027
A06	52515558	52516026	A06p44870.2_BraZ1	1116	-	384	468	468	1.0000000
A06	52528124	52530186	A06p44880.2_BraZ1	12144	+	1170	1859	2062	0.9015519
A06	52530139	52530463	A06p44890.2_BraZ1	32.4	-	213	324	324	1.0000000
A06	52530636	52532297	A06p44900.2_BraZ1	2705.4	-	689	1649	1661	0.9927754
A06	52540801	52541355	A06p44910.2_BraZ1	288	+	0	0	554	0.0000000
A06	52543810	52544155	A06p44920.2_BraZ1	34.5	-	16	254	345	0.7362319
A06	52562705	52563200	A06p44930.2_BraZ1	1476	-	283	495	495	1.0000000
A06	52564585	52569269	A06p44940.2_BraZ1	1079.14	-	3952	4432	4684	0.9461998
A06	52569906	52571141	A06p44950.2_BraZ1	355.5	-	910	1227	1235	0.9935223
A06	52572000	52577880	A06p44960.2_BraZ1	2329.67	+	2521	5138	5880	0.8738095
A06	52578218	52578776	A06p44970.2_BraZ1	4620	+	299	558	558	1.0000000
A06	52579413	52581770	A06p44980.2_BraZ1	1015.04	+	1434	2357	2357	1.0000000
A06	52582050	52589502	A06p44990.2_BraZ1	3165.72	-	4298	7419	7452	0.9955717
A06	52591017	52595146	A06p45000.2_BraZ1	1920.55	-	2262	3992	4129	0.9668201
A06	52596059	52600228	A06p45010.2_BraZ1	1862.5	-	1000	3994	4169	0.9580235
A06	52606195	52606378	A06p45020.2_BraZ1	18.3	+	22	183	183	1.0000000
A06	52611445	52613013	A06p45030.2_BraZ1	856	+	521	1568	1568	1.0000000
A06	52613611	52615563	A06p45040.2_BraZ1	1255.86	-	624	1900	1952	0.9733607
A06	52622161	52622812	A06p45050.2_BraZ1	65.1	+	335	651	651	1.0000000
A06	52623081	52635527	A06p45060.2_BraZ1	909	-	2866	12001	12446	0.9642456
A06	52636033	52638100	A06p45070.2_BraZ1	1155	-	1068	2038	2067	0.9859700
A06	52638450	52639903	A06p45080.2_BraZ1	472.376	-	2580	1453	1453	1.0000000
A06	52643347	52645311	A06p45090.2_BraZ1	1345.5	-	437	1473	1964	0.7500000
A06	52646140	52647055	A06p45100.2_BraZ1	91.5	-	518	912	915	0.9967213
A06	52659437	52659915	A06p45110.2_BraZ1	228	-	247	478	478	1.0000000
A06	52661478	52661650	A06p45120.2_BraZ1	12	+	1	49	172	0.2848837
A06	52662100	52663237	A06p45130.2_BraZ1	2784	+	0	0	1137	0.0000000
A06	52671669	52672572	A06p45140.2_BraZ1	90.3	-	548	903	903	1.0000000
A06	52680749	52686857	A06p45150.2_BraZ1	2028.38	-	3388	5708	6108	0.9345121
A06	52687096	52688698	A06p45160.2_BraZ1	670.781	+	630	1483	1602	0.9257178
A06	52689274	52691435	A06p45170.2_BraZ1	992.148	+	647	2058	2161	0.9523369
A06	52692265	52694765	A06p45180.2_BraZ1	1221.72	+	1274	2424	2500	0.9696000
A06	52697229	52697529	A06p45190.2_BraZ1	30	+	310	300	300	1.0000000
A06	52702607	52707558	A06p45200.2_BraZ1	1352.25	-	411	2811	4951	0.5677641
A06	52719982	52721806	A06p45210.2_BraZ1	182.4	+	405	1741	1824	0.9544956
A06	52723206	52724762	A06p45220.2_BraZ1	1038	-	811	1467	1556	0.9428021
A06	52730867	52731140	A06p45230.2_BraZ1	27.3	-	146	273	273	1.0000000
A06	52731237	52735621	A06p45240.2_BraZ1	2912.77	-	2031	4004	4384	0.9133212
A06	52736096	52738086	A06p45250.2_BraZ1	189	-	759	1841	1990	0.9251256
A06	52738908	52742055	A06p45260.2_BraZ1	2209.28	-	1554	3142	3147	0.9984112
A06	52743423	52747238	A06p45270.2_BraZ1	3783.18	-	1787	3698	3815	0.9693316
A06	52750937	52756381	A06p45280.2_BraZ1	459	-	639	761	5444	0.1397869
A06	52757486	52757912	A06p45290.2_BraZ1	42.6	+	393	426	426	1.0000000
A06	52760902	52767891	A06p45300.2_BraZ1	3356.79	-	3463	6665	6989	0.9536414
A06	52768971	52771575	A06p45310.2_BraZ1	1653.32	-	985	2439	2604	0.9366360
A06	52773565	52775792	A06p45320.2_BraZ1	1527.6	-	1019	2227	2227	1.0000000
A06	52776544	52778456	A06p45330.2_BraZ1	1833	+	888	1912	1912	1.0000000
A06	52779782	52782522	A06p45340.2_BraZ1	1271.65	+	842	2690	2740	0.9817518
A06	52785029	52786627	A06p45350.2_BraZ1	987	+	491	1301	1598	0.8141427
A06	52796359	52807345	A06p45360.2_BraZ1	4504.93	+	2462	7773	10986	0.7075369
A06	52807541	52808284	A06p45370.2_BraZ1	576	-	56	654	743	0.8802153
A06	52808800	52809714	A06p45380.2_BraZ1	2838	+	720	914	914	1.0000000
A06	52809833	52811450	A06p45390.2_BraZ1	807.975	-	769	1458	1617	0.9016697
A06	52812466	52815197	A06p45400.2_BraZ1	1361.57	-	978	2454	2731	0.8985720
A06	52818981	52819785	A06p45410.2_BraZ1	334.708	-	163	713	804	0.8868159
A06	52821445	52823517	A06p45420.2_BraZ1	1328.24	-	844	2063	2072	0.9956564
A06	52833225	52834107	A06p45430.2_BraZ1	88.2	+	220	780	882	0.8843538
A06	52835344	52837228	A06p45440.2_BraZ1	188.4	+	900	1843	1884	0.9782378
A06	52838857	52841895	A06p45450.2_BraZ1	1401.34	-	1254	2781	3038	0.9154049
A06	52846553	52848860	A06p45460.2_BraZ1	1833	-	839	2145	2307	0.9297789
A06	52860924	52861309	A06p45470.2_BraZ1	30.9	-	328	385	385	1.0000000
A06	52867763	52870603	A06p45480.2_BraZ1	1660.43	+	811	1865	2840	0.6566901
A06	52873380	52873959	A06p45490.2_BraZ1	57.9	-	9	188	579	0.3246978
A06	52882834	52882993	A06p45500.2_BraZ1	15.9	-	100	159	159	1.0000000
A06	52883658	52884978	A06p45510.2_BraZ1	132	+	252	1222	1320	0.9257576
A06	52885958	52888220	A06p45520.2_BraZ1	987.807	-	1045	1974	2262	0.8726791
A06	52895462	52898754	A06p45530.2_BraZ1	1219.33	+	697	2951	3292	0.8964155
A06	52904522	52905101	A06p45540.2_BraZ1	507	-	409	579	579	1.0000000
A06	52911800	52923263	A06p45550.2_BraZ1	551.119	-	8906	10247	11463	0.8939196
A06	52925104	52926067	A06p45560.2_BraZ1	415.35	-	120	712	963	0.7393562
A06	52927912	52928047	A06p45570.2_BraZ1	13.5	+	36	135	135	1.0000000
A06	52928484	52929645	A06p45580.2_BraZ1	696.514	+	392	832	1161	0.7166236
A06	52930218	52931502	A06p45590.2_BraZ1	11029.5	-	206	1062	1284	0.8271028
A06	52931966	52932329	A06p45600.2_BraZ1	36.3	+	10	197	363	0.5426998
A06	52937649	52940766	A06p45610.2_BraZ1	2580	-	220	2110	3117	0.6769329
A06	52941736	52942534	A06p45620.2_BraZ1	6111	+	261	642	798	0.8045112
A06	52945095	52946109	A06p45630.2_BraZ1	844	+	713	1014	1014	1.0000000
A06	52946396	52947379	A06p45640.2_BraZ1	435	-	531	879	983	0.8942014
A06	52948265	52950039	A06p45650.2_BraZ1	882	-	972	1774	1774	1.0000000
A06	52953458	52954520	A06p45660.2_BraZ1	168	+	1293	1062	1062	1.0000000
A06	52955481	52959145	A06p45670.2_BraZ1	923.873	-	2484	3581	3664	0.9773471
A06	52960563	52963695	A06p45680.2_BraZ1	1617	+	1160	2999	3132	0.9575351
A06	52965568	52967592	A06p45690.2_BraZ1	1947	+	178	1242	2024	0.6136364
A06	52971720	52971951	A06p45700.2_BraZ1	23.1	-	214	231	231	1.0000000
A06	52974185	52975005	A06p45710.2_BraZ1	18.3	+	311	820	820	1.0000000
A06	52977987	52979821	A06p45720.2_BraZ1	6131.33	-	576	1310	1834	0.7142857
A06	52981295	52981725	A06p45730.2_BraZ1	264	-	803	430	430	1.0000000
A06	52981725	52982064	A06p45740.2_BraZ1	267	-	427	339	339	1.0000000
A06	52987153	52987784	A06p45750.2_BraZ1	465	+	1	49	631	0.0776545
A06	53003976	53005029	A06p45760.2_BraZ1	731.85	+	205	1033	1053	0.9810066
A06	53005040	53005343	A06p45770.2_BraZ1	30.3	-	377	303	303	1.0000000
A06	53005442	53008332	A06p45780.2_BraZ1	1240.31	-	1191	2647	2890	0.9159170
A06	53012267	53013210	A06p45790.2_BraZ1	297.6	-	1	78	943	0.0827147
A06	53027152	53029261	A06p45800.2_BraZ1	927.818	+	1127	2098	2109	0.9947842
A06	53033999	53034350	A06p45810.2_BraZ1	35.1	-	3	88	351	0.2507122
A06	53040417	53040933	A06p45820.2_BraZ1	51.6	-	66	422	516	0.8178294
A06	53042725	53045503	A06p45830.2_BraZ1	1530.99	+	1226	2576	2778	0.9272858
A06	53045787	53052220	A06p45840.2_BraZ1	2377.14	-	2891	5620	6433	0.8736204
A06	53053288	53054335	A06p45850.2_BraZ1	104.7	+	361	1047	1047	1.0000000
A06	53055993	53059790	A06p45860.2_BraZ1	2031.6	+	2333	3737	3797	0.9841980
A06	53060107	53060606	A06p45870.2_BraZ1	367.909	+	383	499	499	1.0000000
A06	53061564	53062009	A06p45880.2_BraZ1	772.2	+	176	445	445	1.0000000
A06	53062664	53065678	A06p45890.2_BraZ1	1999.04	-	1646	2782	3014	0.9230259
A06	53069615	53069928	A06p45900.2_BraZ1	24.3	+	0	0	313	0.0000000
A06	53075240	53077290	A06p45910.2_BraZ1	1172.73	-	572	1887	2050	0.9204878
A06	53087743	53089414	A06p45920.2_BraZ1	566.618	-	689	1584	1671	0.9479353
A06	53089922	53090418	A06p45930.2_BraZ1	426	+	588	496	496	1.0000000
A06	53092758	53093550	A06p45940.2_BraZ1	303	-	101	674	792	0.8510101
A06	53095456	53095885	A06p45950.2_BraZ1	42.9	+	89	422	429	0.9836830
A06	53096909	53097372	A06p45960.2_BraZ1	324	+	220	439	463	0.9481642
A06	53099354	53107301	A06p45970.2_BraZ1	4824.19	+	471	3456	7947	0.4348811
A06	53108015	53108858	A06p45980.2_BraZ1	84.3	-	486	843	843	1.0000000
A06	53123918	53128039	A06p45990.2_BraZ1	2211.64	+	1589	3242	4121	0.7867023
A06	53129215	53130546	A06p46000.2_BraZ1	273	+	556	1317	1331	0.9894816
A06	53133945	53137040	A06p46010.2_BraZ1	932.769	+	1527	3003	3095	0.9702746
A06	53148176	53148518	A06p46020.2_BraZ1	34.2	+	152	335	342	0.9795322
A06	53149898	53150438	A06p46030.2_BraZ1	384	+	343	540	540	1.0000000
A06	53157881	53158376	A06p46040.2_BraZ1	49.5	+	13	246	495	0.4969697
A06	53164293	53165809	A06p46050.2_BraZ1	570	+	713	1516	1516	1.0000000
A06	53171863	53180470	A06p46060.2_BraZ1	1195.56	-	5705	8046	8607	0.9348205
A06	53182530	53184248	A06p46070.2_BraZ1	1050.38	-	1427	1669	1718	0.9714785
A06	53187265	53189196	A06p46080.2_BraZ1	1222.69	-	720	1761	1931	0.9119627
A06	53191412	53192567	A06p46090.2_BraZ1	582	-	769	1151	1155	0.9965368
A06	53196998	53198659	A06p46100.2_BraZ1	1131.56	-	56	831	1661	0.5003010
A06	53202876	53206786	A06p46110.2_BraZ1	2175.38	+	1650	3730	3910	0.9539642
A06	53207856	53208489	A06p46120.2_BraZ1	63.3	+	321	591	633	0.9336493
A06	53210922	53214311	A06p46130.2_BraZ1	786	+	3181	3363	3389	0.9923281
A06	53212101	53212990	A06p46140.2_BraZ1	323	-	1180	889	889	1.0000000
A06	53214374	53215987	A06p46150.2_BraZ1	1506	-	85	1175	1613	0.7284563
A06	53221035	53221550	A06p46160.2_BraZ1	417	+	224	434	515	0.8427184
A06	53226653	53227796	A06p46170.2_BraZ1	114.3	+	606	1143	1143	1.0000000
A06	53230871	53231951	A06p46180.2_BraZ1	108	-	195	1057	1080	0.9787037
A06	53232508	53239569	A06p46190.2_BraZ1	2623.51	+	4191	6223	7061	0.8813199
A06	53239976	53243181	A06p46200.2_BraZ1	1230.46	-	3095	3170	3205	0.9890795
A06	53243723	53244393	A06p46210.2_BraZ1	255	-	726	657	670	0.9805970
A06	53246186	53247390	A06p46220.2_BraZ1	621.5	-	374	1204	1204	1.0000000
A06	53250469	53254551	A06p46230.2_BraZ1	818.286	+	2451	3942	4082	0.9657031
A06	53254936	53257653	A06p46240.2_BraZ1	2304	-	841	2648	2717	0.9746044
A06	53258308	53261997	A06p46250.2_BraZ1	1713.16	-	1895	3689	3689	1.0000000
A06	53262462	53263383	A06p46260.2_BraZ1	465	-	184	917	921	0.9956569
A06	53263694	53265162	A06p46270.2_BraZ1	279	-	111	864	1468	0.5885559
A06	53267114	53267619	A06p46280.2_BraZ1	237	+	39	484	505	0.9584159
A06	53268166	53268519	A06p46290.2_BraZ1	237	+	167	328	353	0.9291785
A06	53271686	53272127	A06p46300.2_BraZ1	243	+	97	437	441	0.9909297
A06	53274058	53274479	A06p46310.2_BraZ1	240	+	184	421	421	1.0000000
A06	53279912	53327146	A06p46320.2_BraZ1	927.5	-	13975	39377	47234	0.8336580
A06	53285289	53288362	A06p46330.2_BraZ1	1973.33	-	434	2177	3073	0.7084283
A06	53289578	53291088	A06p46340.2_BraZ1	576	+	100	931	1510	0.6165563
A06	53306511	53306899	A06p46350.2_BraZ1	291.273	+	455	388	388	1.0000000
A06	53309781	53310256	A06p46360.2_BraZ1	351	-	296	475	475	1.0000000
A06	53311519	53314599	A06p46370.2_BraZ1	2064	-	105	976	3080	0.3168831
A06	53316766	53317403	A06p46380.2_BraZ1	222	+	62	324	637	0.5086342
A06	53330252	53332259	A06p46390.2_BraZ1	200.7	+	417	1436	2007	0.7154958
A06	53333566	53334688	A06p46400.2_BraZ1	933	-	3	161	1122	0.1434938
A06	53335515	53340884	A06p46410.2_BraZ1	450	-	162	2207	5369	0.4110635
A06	53341193	53341459	A06p46420.2_BraZ1	18.9	+	1	7	266	0.0263158
A06	53342092	53345092	A06p46430.2_BraZ1	20002.5	-	76	1194	3000	0.3980000
A06	53350634	53353477	A06p46440.2_BraZ1	2037	+	634	2706	2843	0.9518115
A06	53352779	53353175	A06p46450.2_BraZ1	273	-	90	396	396	1.0000000
A06	53356016	53356535	A06p46460.2_BraZ1	51.9	-	356	519	519	1.0000000
A06	53362308	53364400	A06p46470.2_BraZ1	818.667	+	1156	2079	2092	0.9937859
A06	53365328	53370230	A06p46480.2_BraZ1	1588	+	3195	4715	4902	0.9618523
A06	53371432	53373105	A06p46490.2_BraZ1	595.636	+	858	1673	1673	1.0000000
A06	53378527	53380606	A06p46500.2_BraZ1	1707.75	+	403	1638	2079	0.7878788
A06	53380881	53381660	A06p46510.2_BraZ1	407.523	-	709	779	779	1.0000000
A06	53381935	53383669	A06p46520.2_BraZ1	878.917	+	1702	1734	1734	1.0000000
A06	53388518	53389592	A06p46530.2_BraZ1	589.636	+	747	1074	1074	1.0000000
A06	53390533	53394486	A06p46540.2_BraZ1	2405.45	+	1407	3759	3953	0.9509233
A06	53394655	53396359	A06p46550.2_BraZ1	153.6	-	457	1704	1704	1.0000000
A06	53397317	53399110	A06p46560.2_BraZ1	809.182	-	1799	1793	1793	1.0000000
A06	53402993	53405498	A06p46570.2_BraZ1	1006.91	+	1675	2424	2505	0.9676647
A06	53408605	53410344	A06p46580.2_BraZ1	410.957	+	574	1730	1739	0.9948246
A06	53411091	53412354	A06p46590.2_BraZ1	654	-	116	793	1263	0.6278701
A06	53417060	53418363	A06p46600.2_BraZ1	693	+	825	1303	1303	1.0000000
A06	53420202	53421074	A06p46610.2_BraZ1	9690	+	522	872	872	1.0000000
A06	53422222	53424562	A06p46620.2_BraZ1	1347.53	-	2369	2340	2340	1.0000000
A06	53425861	53427588	A06p46630.2_BraZ1	628.138	+	845	1709	1727	0.9895773
A06	53428552	53430801	A06p46640.2_BraZ1	147	-	809	1913	2249	0.8506002
A06	53432186	53433736	A06p46650.2_BraZ1	1026	-	665	1537	1550	0.9916129
A06	53434150	53435358	A06p46660.2_BraZ1	492	+	864	1208	1208	1.0000000
A06	53437234	53437582	A06p46670.2_BraZ1	34.8	+	267	348	348	1.0000000
A06	53445334	53448128	A06p46680.2_BraZ1	1624.16	+	1583	2739	2794	0.9803150
A06	53449753	53450265	A06p46690.2_BraZ1	1269	-	1	123	512	0.2402344
A06	53454297	53457208	A06p46700.2_BraZ1	1217.56	-	846	2770	2911	0.9515631
A06	53459325	53460657	A06p46710.2_BraZ1	571.705	-	953	1332	1332	1.0000000
A06	53460675	53463085	A06p46720.2_BraZ1	351	-	1045	2279	2410	0.9456431
A06	53465384	53466170	A06p46730.2_BraZ1	78.6	+	213	555	786	0.7061068
A06	53467807	53469212	A06p46740.2_BraZ1	609.531	+	703	1405	1405	1.0000000
A06	53469749	53474322	A06p46750.2_BraZ1	1839.13	-	1582	3862	4573	0.8445222
A06	53481665	53482371	A06p46760.2_BraZ1	483	-	87	706	706	1.0000000
A06	53490154	53490448	A06p46770.2_BraZ1	29.4	-	0	0	294	0.0000000
A06	53493754	53494424	A06p46780.2_BraZ1	495	-	196	639	670	0.9537314
A06	53495292	53496210	A06p46790.2_BraZ1	177.545	-	681	804	918	0.8758170
A06	53497691	53502788	A06p46800.2_BraZ1	2680.56	+	1162	4575	5097	0.8975868
A06	53504874	53508340	A06p46810.2_BraZ1	14858	-	1803	3460	3466	0.9982689
A06	53509579	53517399	A06p46820.2_BraZ1	3068.04	-	1043	6392	7820	0.8173913
A06	53518224	53518473	A06p46830.2_BraZ1	24.9	-	127	249	249	1.0000000
A06	53519499	53521773	A06p46840.2_BraZ1	1866	+	1060	2238	2274	0.9841689
A06	53524028	53526688	A06p46850.2_BraZ1	2384.42	-	849	2660	2660	1.0000000
A06	53527878	53529606	A06p46860.2_BraZ1	1557	-	831	1548	1728	0.8958333
A06	53530425	53532239	A06p46870.2_BraZ1	842.842	-	607	1671	1814	0.9211687
A06	53538984	53546848	A06p46880.2_BraZ1	3844.74	+	2287	6262	7864	0.7962869
A06	53547171	53549937	A06p46890.2_BraZ1	1429.07	-	1358	2764	2766	0.9992769
A06	53554509	53555145	A06p46900.2_BraZ1	332	+	614	636	636	1.0000000
A06	53555429	53556048	A06p46910.2_BraZ1	519	-	910	619	619	1.0000000
A06	53559719	53560691	A06p46920.2_BraZ1	97.2	+	176	796	972	0.8189300
A06	53562952	53569630	A06p46930.2_BraZ1	1612.38	+	3009	6588	6678	0.9865229
A06	53564920	53566628	A06p46940.2_BraZ1	665.467	-	856	1708	1708	1.0000000
A06	53570194	53573151	A06p46950.2_BraZ1	1041.45	-	1840	2913	2957	0.9851201
A06	53578049	53581078	A06p46960.2_BraZ1	690	+	1109	2869	3029	0.9471773
A06	53589346	53589829	A06p46970.2_BraZ1	48.3	+	4	185	483	0.3830228
A06	53593557	53598156	A06p46980.2_BraZ1	2076	+	957	3574	4599	0.7771255
A06	53600652	53602959	A06p46990.2_BraZ1	1935.45	+	1423	2307	2307	1.0000000
A06	53603221	53607167	A06p47000.2_BraZ1	2434.12	-	846	3386	3946	0.8580841
A06	53608071	53611266	A06p47010.2_BraZ1	319.5	-	234	2468	3195	0.7724569
A06	53612279	53613563	A06p47020.2_BraZ1	128.4	-	202	1192	1284	0.9283489
A06	53617198	53620360	A06p47030.2_BraZ1	1281.23	+	2059	3162	3162	1.0000000
A06	53621016	53622764	A06p47040.2_BraZ1	1008	+	946	1699	1748	0.9719679
A06	53623362	53624187	A06p47050.2_BraZ1	672	-	159	776	825	0.9406061
A06	53625861	53627966	A06p47060.2_BraZ1	1051.2	+	567	1963	2105	0.9325415
A06	53628336	53631909	A06p47070.2_BraZ1	1049.62	+	1420	3518	3573	0.9846068
A06	53631983	53632383	A06p47080.2_BraZ1	15.3	+	315	400	400	1.0000000
A06	53635127	53635667	A06p47090.2_BraZ1	54	+	24	360	540	0.6666667
A06	53643139	53647638	A06p47100.2_BraZ1	2589.19	-	1793	4235	4499	0.9413203
A06	53650498	53653035	A06p47110.2_BraZ1	1059.87	-	403	2314	2537	0.9121009
A06	53653721	53655430	A06p47120.2_BraZ1	250.125	-	991	1499	1709	0.8771212
A06	53656048	53657353	A06p47130.2_BraZ1	130.5	+	547	1305	1305	1.0000000
A06	53658331	53659380	A06p47140.2_BraZ1	6283	+	1930	1049	1049	1.0000000
A06	53659584	53661866	A06p47150.2_BraZ1	1242	-	1653	2282	2282	1.0000000
A06	53663432	53665231	A06p47160.2_BraZ1	594	-	1362	1799	1799	1.0000000
A06	53665499	53666741	A06p47170.2_BraZ1	513	+	1101	1242	1242	1.0000000
A06	53667312	53672787	A06p47180.2_BraZ1	2808.94	-	2257	5288	5475	0.9658448
A06	53678674	53681612	A06p47190.2_BraZ1	1653.91	+	2518	2906	2938	0.9891083
A06	53681991	53683112	A06p47200.2_BraZ1	719.2	-	1246	1121	1121	1.0000000
A06	53683405	53685419	A06p47210.2_BraZ1	1077.63	-	1229	2014	2014	1.0000000
A06	53685885	53687574	A06p47220.2_BraZ1	880.312	+	0	0	1689	0.0000000
A06	53703469	53703619	A06p47230.2_BraZ1	15	+	3	117	150	0.7800000
A06	53719375	53719525	A06p47240.2_BraZ1	15	-	0	0	150	0.0000000
A06	53720691	53722037	A06p47250.2_BraZ1	1026	+	1	40	1346	0.0297177
A06	53726767	53734881	A06p47260.2_BraZ1	3459.86	-	2304	7426	8114	0.9152083
A06	53739596	53745733	A06p47270.2_BraZ1	3890.55	+	2098	5063	6137	0.8249959
A06	53746131	53747970	A06p47280.2_BraZ1	8349	-	1155	1839	1839	1.0000000
A06	53749251	53749801	A06p47290.2_BraZ1	52.5	+	291	550	550	1.0000000
A06	53753997	53756229	A06p47300.2_BraZ1	1497	+	235	1250	2232	0.5600358
A06	53761435	53761783	A06p47310.2_BraZ1	34.8	-	227	348	348	1.0000000
A06	53768834	53769233	A06p47320.2_BraZ1	39.9	+	62	315	399	0.7894737
A06	53772655	53773174	A06p47330.2_BraZ1	51.9	-	40	251	519	0.4836223
A06	53784391	53784862	A06p47340.2_BraZ1	47.1	-	102	348	471	0.7388535
A06	53789848	53791770	A06p47350.2_BraZ1	1277.77	+	1023	1880	1922	0.9781477
A06	53792211	53794121	A06p47360.2_BraZ1	1072.66	-	560	1848	1910	0.9675393
A06	53799872	53800553	A06p47370.2_BraZ1	420.955	+	43	310	681	0.4552129
A06	53801646	53805870	A06p47380.2_BraZ1	1010.1	-	749	2219	4224	0.5253314
A06	53812089	53815225	A06p47390.2_BraZ1	2043	+	1618	3000	3136	0.9566327
A06	53816001	53820174	A06p47400.2_BraZ1	2206.29	-	2522	4060	4173	0.9729211
A06	53828733	53832860	A06p47410.2_BraZ1	536.044	-	1016	3069	4127	0.7436395
A06	53837450	53837657	A06p47420.2_BraZ1	20.7	-	229	207	207	1.0000000
A06	53846569	53848193	A06p47430.2_BraZ1	845.429	-	502	1482	1624	0.9125616
A06	53855383	53858001	A06p47440.2_BraZ1	1350.34	-	348	2106	2618	0.8044308
A06	53902532	53907619	A06p47450.2_BraZ1	2604.48	+	3900	5012	5087	0.9852566
A06	53908293	53910036	A06p47460.2_BraZ1	252.522	-	336	1393	1743	0.7991968
A06	53911476	53913763	A06p47470.2_BraZ1	1242.6	-	1021	2190	2287	0.9575863
A06	53915627	53915975	A06p47480.2_BraZ1	34.8	-	711	348	348	1.0000000
A06	53916719	53918658	A06p47490.2_BraZ1	1134.74	-	925	1939	1939	1.0000000
A06	53921962	53923333	A06p47500.2_BraZ1	137.1	-	270	1054	1371	0.7687819
A06	53925467	53927927	A06p47510.2_BraZ1	1371	+	915	1623	2460	0.6597561
A06	53930529	53931900	A06p47520.2_BraZ1	137.1	+	917	1371	1371	1.0000000
A06	53939657	53940792	A06p47530.2_BraZ1	8844	+	1191	1025	1135	0.9030837
A06	53943679	53948542	A06p47540.2_BraZ1	6804	+	4683	4795	4863	0.9860169
A06	53949659	53950802	A06p47550.2_BraZ1	10110	+	265	1050	1143	0.9186352
A06	53951944	53953255	A06p47560.2_BraZ1	750	-	559	1163	1311	0.8871091
A06	53959905	53961660	A06p47570.2_BraZ1	965.25	+	1834	1689	1755	0.9623932
A06	53967928	53968259	A06p47580.2_BraZ1	243	-	367	331	331	1.0000000
A06	53970484	53970691	A06p47590.2_BraZ1	20.7	-	3	78	207	0.3768116
A06	53971624	53972468	A06p47600.2_BraZ1	279	+	368	844	844	1.0000000
A06	53974350	53975327	A06p47610.2_BraZ1	471	+	898	977	977	1.0000000
A06	53976020	53976992	A06p47620.2_BraZ1	97.2	+	449	936	972	0.9629630
A06	53977388	53981829	A06p47630.2_BraZ1	2662.87	-	3054	4429	4441	0.9972979
A06	53982674	53983910	A06p47640.2_BraZ1	123.6	+	602	1236	1236	1.0000000
A06	53984388	53985690	A06p47650.2_BraZ1	130.2	-	928	1302	1302	1.0000000
A06	53987988	53988660	A06p47660.2_BraZ1	67.2	-	188	672	672	1.0000000
A06	53989110	53991237	A06p47670.2_BraZ1	1686	-	2218	2127	2127	1.0000000
A06	53991741	53992856	A06p47680.2_BraZ1	1014	+	663	1099	1115	0.9856502
A06	53993204	53993887	A06p47690.2_BraZ1	606	-	124	570	683	0.8345534
A06	53994829	53995585	A06p47700.2_BraZ1	75.3	-	313	756	756	1.0000000
A06	53996340	53996682	A06p47710.2_BraZ1	34.2	-	46	316	342	0.9239766
A06	53997235	53998292	A06p47720.2_BraZ1	936	-	94	865	1057	0.8183538
A06	53999636	54001430	A06p47730.2_BraZ1	179.4	-	225	1353	1794	0.7541806
A06	54004544	54005969	A06p47740.2_BraZ1	974.4	+	1028	1425	1425	1.0000000
A06	54006438	54008276	A06p47750.2_BraZ1	1102.75	+	317	1694	1838	0.9216540
A06	54008700	54010954	A06p47760.2_BraZ1	1490.26	-	1237	2251	2254	0.9986690
A06	54012615	54013047	A06p47770.2_BraZ1	43.2	+	672	432	432	1.0000000
A06	54016209	54024787	A06p47780.2_BraZ1	1626.67	+	6137	8241	8578	0.9607134
A06	54022889	54023168	A06p47790.2_BraZ1	264	+	164	279	279	1.0000000
A06	54025597	54027179	A06p47800.2_BraZ1	925.091	-	1420	1582	1582	1.0000000
A06	54027719	54028826	A06p47810.2_BraZ1	9060	+	1097	1107	1107	1.0000000
A06	54031262	54032456	A06p47820.2_BraZ1	930	-	1045	1194	1194	1.0000000
A06	54037233	54037494	A06p47830.2_BraZ1	26.1	+	41	238	261	0.9118774
A06	54045914	54048009	A06p47840.2_BraZ1	768	+	1049	1983	2095	0.9465394
A06	54049167	54051500	A06p47850.2_BraZ1	1137.5	-	1199	2333	2333	1.0000000
A06	54057402	54059091	A06p47860.2_BraZ1	1465.2	-	5	18	1689	0.0106572
A06	54059497	54061454	A06p47870.2_BraZ1	834.174	+	1066	1955	1957	0.9989780
A06	54063228	54064642	A06p47880.2_BraZ1	1155	+	147	1050	1414	0.7425743
A06	54065254	54072073	A06p47890.2_BraZ1	1774.49	+	4517	6216	6819	0.9115706
A06	54073047	54080513	A06p47900.2_BraZ1	3626.54	-	2447	6901	7466	0.9243236
A06	54086312	54087347	A06p47910.2_BraZ1	103.5	+	147	975	1035	0.9420290
A06	54089541	54090441	A06p47920.2_BraZ1	90	-	1070	900	900	1.0000000
A06	54111122	54116998	A06p47930.2_BraZ1	282.625	-	6321	5876	5876	1.0000000
A06	54113295	54119658	A06p47940.2_BraZ1	218.625	-	5182	5953	6363	0.9355650
A06	54126519	54126954	A06p47950.2_BraZ1	43.5	-	431	435	435	1.0000000
A06	54129462	54130935	A06p47960.2_BraZ1	1053.83	-	169	985	1473	0.6687033
A06	54134403	54140923	A06p47970.2_BraZ1	5842.96	-	3157	6355	6520	0.9746932
A06	54161515	54167703	A06p47980.2_BraZ1	3538.07	+	1935	5736	6188	0.9269554
A06	54170742	54170895	A06p47990.2_BraZ1	15.3	+	228	153	153	1.0000000
A06	54175898	54176463	A06p48000.2_BraZ1	279	+	684	565	565	1.0000000
A06	54183626	54184862	A06p48010.2_BraZ1	123.6	-	391	1236	1236	1.0000000
A06	54189183	54190283	A06p48020.2_BraZ1	5724	-	403	1083	1100	0.9845455
A06	54191768	54193978	A06p48030.2_BraZ1	11647	-	878	2085	2210	0.9434389
A06	54196361	54201531	A06p48040.2_BraZ1	2205.45	+	2550	4872	5170	0.9423597
A06	54204335	54205751	A06p48050.2_BraZ1	141.6	+	330	1275	1416	0.9004237
A06	54206265	54212266	A06p48060.2_BraZ1	2019.23	+	1130	4788	6001	0.7978670
A06	54212556	54216263	A06p48070.2_BraZ1	1787.74	-	1343	3707	3707	1.0000000
A06	54216907	54219001	A06p48080.2_BraZ1	209.4	-	766	2094	2094	1.0000000
A06	54224096	54229778	A06p48090.2_BraZ1	1558.51	-	4824	5639	5682	0.9924322
A06	54230905	54233846	A06p48100.2_BraZ1	1266.56	-	2613	2916	2941	0.9914995
A06	54233976	54235731	A06p48110.2_BraZ1	1689	+	912	1744	1755	0.9937322
A06	54236809	54238312	A06p48120.2_BraZ1	150.3	-	450	1405	1503	0.9347970
A06	54239792	54241298	A06p48130.2_BraZ1	150.6	-	874	1420	1506	0.9428951
A06	54247384	54248340	A06p48140.2_BraZ1	949.5	-	339	956	956	1.0000000
A06	54249916	54251389	A06p48150.2_BraZ1	147.3	-	511	1417	1473	0.9619824
A06	54254359	54255865	A06p48160.2_BraZ1	4239	+	569	1506	1506	1.0000000
A06	54257331	54259032	A06p48170.2_BraZ1	170.1	-	637	1701	1701	1.0000000
A06	54261877	54262219	A06p48180.2_BraZ1	34.2	-	125	336	342	0.9824561
A06	54263610	54267143	A06p48190.2_BraZ1	1259.41	+	1513	3530	3533	0.9991509
A06	54266004	54266366	A06p48200.2_BraZ1	247.95	+	75	359	362	0.9917127
A06	54267444	54269164	A06p48210.2_BraZ1	963	+	1012	1720	1720	1.0000000
A06	54270842	54271447	A06p48220.2_BraZ1	237	+	557	605	605	1.0000000
A06	54272492	54274277	A06p48230.2_BraZ1	178.5	-	1260	1785	1785	1.0000000
A06	54275877	54277593	A06p48240.2_BraZ1	1590	+	774	1716	1716	1.0000000
A06	54281325	54291126	A06p48250.2_BraZ1	2112	+	5403	9433	9801	0.9624528
A06	54284959	54285266	A06p48260.2_BraZ1	210	+	509	307	307	1.0000000
A06	54291903	54294074	A06p48270.2_BraZ1	700.267	-	1190	2119	2171	0.9760479
A06	54294638	54294913	A06p48280.2_BraZ1	13.8	+	39	275	275	1.0000000
A06	54297106	54302772	A06p48290.2_BraZ1	3228.27	+	1354	4528	5666	0.7991529
A06	54303873	54305644	A06p48300.2_BraZ1	714.15	-	1654	1771	1771	1.0000000
A06	54320017	54325325	A06p48310.2_BraZ1	3407.37	+	2083	4483	5308	0.8445742
A06	54331916	54333008	A06p48320.2_BraZ1	109.2	+	726	1092	1092	1.0000000
A06	54334004	54334658	A06p48330.2_BraZ1	5953.5	-	263	644	654	0.9847095
A06	54335046	54335480	A06p48340.2_BraZ1	399	+	1	53	434	0.1221198
A06	54335445	54336110	A06p48350.2_BraZ1	63	+	2	175	665	0.2631579
A06	54336643	54339743	A06p48360.2_BraZ1	1999.83	-	1378	2920	3100	0.9419355
A06	54343463	54343646	A06p48370.2_BraZ1	18.3	+	18	155	183	0.8469945
A06	54345276	54346107	A06p48380.2_BraZ1	33.9	+	181	831	831	1.0000000
A06	54353747	54355407	A06p48390.2_BraZ1	1278	+	334	1513	1660	0.9114458
A06	54356116	54356665	A06p48400.2_BraZ1	54.9	-	448	549	549	1.0000000
A06	54358386	54361176	A06p48410.2_BraZ1	742.762	-	1571	2661	2790	0.9537634
A06	54361151	54366804	A06p48420.2_BraZ1	868.99	-	4315	5638	5653	0.9973465
A06	54367395	54370586	A06p48430.2_BraZ1	28842	-	706	2769	3191	0.8677530
A06	54374274	54381001	A06p48440.2_BraZ1	4248.6	-	3104	6069	6727	0.9021852
A06	54391320	54393159	A06p48450.2_BraZ1	657.36	+	372	1199	1839	0.6519848
A06	54394973	54395981	A06p48460.2_BraZ1	712.5	-	943	1008	1008	1.0000000
A06	54396699	54398922	A06p48470.2_BraZ1	1069.62	-	513	1826	2223	0.8214125
A06	54407783	54409861	A06p48480.2_BraZ1	28927.5	+	737	1856	2078	0.8931665
A06	54412143	54412989	A06p48490.2_BraZ1	84.6	+	121	516	846	0.6099291
A06	54413544	54413832	A06p48500.2_BraZ1	28.8	+	453	288	288	1.0000000
A06	54416077	54418866	A06p48510.2_BraZ1	682.04	+	3183	2789	2789	1.0000000
A06	54419421	54421824	A06p48520.2_BraZ1	1005.71	+	1284	2145	2403	0.8926342
A06	54422715	54423629	A06p48530.2_BraZ1	399	+	54	264	914	0.2888403
A06	54431852	54433425	A06p48540.2_BraZ1	737.824	+	1052	1573	1573	1.0000000
A06	54438035	54439315	A06p48550.2_BraZ1	1122	+	648	1252	1280	0.9781250
A06	54442823	54444221	A06p48560.2_BraZ1	645.652	+	771	1377	1398	0.9849786
A06	54446034	54446835	A06p48570.2_BraZ1	80.1	-	513	772	801	0.9637952
A06	54448303	54453000	A06p48580.2_BraZ1	3248.4	-	2945	4677	4697	0.9957420
A06	54461592	54462305	A06p48590.2_BraZ1	165	+	710	713	713	1.0000000
A06	54462973	54464823	A06p48600.2_BraZ1	1734	-	1497	1761	1850	0.9518919
A06	54465561	54466131	A06p48610.2_BraZ1	57	-	436	570	570	1.0000000
A06	54467303	54467879	A06p48620.2_BraZ1	57.6	-	342	576	576	1.0000000
A06	54469525	54472313	A06p48630.2_BraZ1	1464	-	856	2301	2788	0.8253228
A06	54477760	54478873	A06p48640.2_BraZ1	111.3	+	455	1017	1113	0.9137467
A06	54479823	54480535	A06p48650.2_BraZ1	333	+	507	712	712	1.0000000
A06	54486322	54488597	A06p48660.2_BraZ1	684.438	-	671	1675	2275	0.7362638
A06	54490550	54490883	A06p48670.2_BraZ1	240	+	337	333	333	1.0000000
A06	54497926	54500036	A06p48680.2_BraZ1	142.2	+	1898	2110	2110	1.0000000
A06	54502606	54505815	A06p48690.2_BraZ1	2554.39	+	1076	2989	3209	0.9314428
A06	54506497	54507394	A06p48700.2_BraZ1	30438	-	171	790	897	0.8807135
A06	54508278	54509067	A06p48710.2_BraZ1	486	-	32	652	789	0.8263625
A06	54509335	54509641	A06p48720.2_BraZ1	30.6	-	495	306	306	1.0000000
A06	54512433	54520860	A06p48730.2_BraZ1	5044.07	-	6515	8248	8427	0.9787588
A06	54525735	54526134	A06p48740.2_BraZ1	39.9	-	549	399	399	1.0000000
A06	54533423	54536468	A06p48750.2_BraZ1	1530.83	-	1661	1687	3045	0.5540230
A06	54538384	54538735	A06p48760.2_BraZ1	35.1	-	1121	351	351	1.0000000
A06	54540200	54540860	A06p48770.2_BraZ1	318	+	136	558	660	0.8454546
A06	54541263	54541701	A06p48780.2_BraZ1	234	+	42	438	438	1.0000000
A06	54543222	54543774	A06p48790.2_BraZ1	55.2	-	857	552	552	1.0000000
A06	54543774	54550898	A06p48800.2_BraZ1	4329	-	4564	6848	7124	0.9612577
A06	54552424	54553981	A06p48810.2_BraZ1	155.7	-	92	544	1557	0.3493899
A06	54556750	54558964	A06p48820.2_BraZ1	670.375	-	437	621	2214	0.2804878
A06	54560636	54562191	A06p48830.2_BraZ1	2450.25	-	107	1225	1555	0.7877814
A06	54563725	54565282	A06p48840.2_BraZ1	155.7	-	0	0	1557	0.0000000
A06	54568148	54576940	A06p48850.2_BraZ1	1227.13	+	4886	7931	8792	0.9020700
A06	54578215	54580337	A06p48860.2_BraZ1	1000.77	+	1604	2082	2122	0.9811499
A06	54582863	54584737	A06p48870.2_BraZ1	993.888	+	657	1874	1874	1.0000000
A06	54585183	54587830	A06p48880.2_BraZ1	1526.61	+	872	2646	2647	0.9996222
A06	54589231	54590821	A06p48890.2_BraZ1	12180	-	853	1590	1590	1.0000000
A06	54597444	54602898	A06p48900.2_BraZ1	2453.33	+	1572	5014	5454	0.9193253
A06	54603270	54603951	A06p48910.2_BraZ1	546	-	414	661	681	0.9706314
A06	54609198	54609330	A06p48920.2_BraZ1	13.2	-	52	132	132	1.0000000
A06	54614076	54628589	A06p48930.2_BraZ1	1362.5	-	2177	10807	14513	0.7446427
A06	54629813	54633266	A06p48940.2_BraZ1	772.417	-	576	2980	3453	0.8630177
A06	54634302	54641531	A06p48950.2_BraZ1	1144	+	4130	7097	7229	0.9817402
A06	54641596	54642617	A06p48960.2_BraZ1	81.6667	+	911	1021	1021	1.0000000
A06	54643511	54647140	A06p48970.2_BraZ1	1249.2	-	1552	3571	3629	0.9840176
A06	54648033	54648408	A06p48980.2_BraZ1	37.5	+	48	375	375	1.0000000
A06	54648919	54651704	A06p48990.2_BraZ1	1231.63	-	596	2012	2785	0.7224417
A06	54655580	54658221	A06p49000.2_BraZ1	1531.8	+	458	2333	2641	0.8833775
A06	54662673	54663623	A06p49010.2_BraZ1	846	+	158	948	950	0.9978948
A06	54664049	54664348	A06p49020.2_BraZ1	201	+	378	299	299	1.0000000
A06	54664749	54665262	A06p49030.2_BraZ1	51.3	+	327	513	513	1.0000000
A06	54665885	54668507	A06p49040.2_BraZ1	650.25	-	841	2615	2622	0.9973303
A06	54669921	54671143	A06p49050.2_BraZ1	378.667	-	1775	1222	1222	1.0000000
A06	54672241	54673992	A06p49060.2_BraZ1	1695	+	257	1447	1751	0.8263849
A06	54674952	54675195	A06p49070.2_BraZ1	24.3	+	209	243	243	1.0000000
A06	54676473	54676695	A06p49080.2_BraZ1	22.2	+	160	222	222	1.0000000
A06	54677062	54682989	A06p49090.2_BraZ1	2834.06	-	1835	4781	5927	0.8066475
A06	54684511	54686161	A06p49100.2_BraZ1	755.81	+	603	1650	1650	1.0000000
A06	54687078	54690487	A06p49110.2_BraZ1	1408.39	+	1865	3242	3409	0.9510120
A06	54693607	54694711	A06p49120.2_BraZ1	15903	-	534	1104	1104	1.0000000
A06	54696469	54699743	A06p49130.2_BraZ1	2005.56	-	1368	3074	3274	0.9389126
A06	54702293	54702452	A06p49140.2_BraZ1	15.9	-	1	36	159	0.2264151
A06	54719998	54720625	A06p49150.2_BraZ1	62.7	+	10	20	627	0.0318979
A06	54723862	54736387	A06p49160.2_BraZ1	1869.32	+	9206	12409	12525	0.9907385
A06	54742221	54743070	A06p49170.2_BraZ1	84.9	-	163	758	849	0.8928151
A06	54745217	54747501	A06p49180.2_BraZ1	870.192	+	1328	2258	2284	0.9886165
A06	54748246	54750144	A06p49190.2_BraZ1	1168.75	+	578	1708	1898	0.8998947
A06	54761718	54763534	A06p49200.2_BraZ1	673.905	+	883	1816	1816	1.0000000
A06	54764341	54764988	A06p49210.2_BraZ1	564	+	85	430	647	0.6646059
A06	54771919	54772346	A06p49220.2_BraZ1	288	+	13	397	427	0.9297424
A06	54776215	54779731	A06p49230.2_BraZ1	1452	+	1294	3405	3516	0.9684300
A06	54779974	54782011	A06p49240.2_BraZ1	203.7	-	144	1541	2037	0.7565047
A06	54782219	54785075	A06p49250.2_BraZ1	1484.82	+	1516	2830	2856	0.9908963
A06	54785360	54788136	A06p49260.2_BraZ1	2313.86	-	725	2534	2776	0.9128242
A06	54793928	54794051	A06p49270.2_BraZ1	12.3	-	299	123	123	1.0000000
A06	54797864	54802309	A06p49280.2_BraZ1	249	+	2018	2760	4445	0.6209224
A06	54802619	54803921	A06p49290.2_BraZ1	130.2	+	391	1267	1302	0.9731183
A06	54804826	54806605	A06p49300.2_BraZ1	967.26	-	182	1584	1779	0.8903878
A06	54807212	54807921	A06p49310.2_BraZ1	2173	+	165	617	709	0.8702398
A06	54808518	54810425	A06p49320.2_BraZ1	5307.26	-	1176	1907	1907	1.0000000
A06	54812284	54813280	A06p49330.2_BraZ1	99.6	+	202	996	996	1.0000000
A06	54815245	54817508	A06p49340.2_BraZ1	438	+	873	1933	2263	0.8541759
A06	54817888	54818098	A06p49350.2_BraZ1	21	-	87	210	210	1.0000000
A06	54819038	54820414	A06p49360.2_BraZ1	3907.75	-	504	1247	1376	0.9062500
A06	54827962	54828898	A06p49370.2_BraZ1	93.6	+	284	936	936	1.0000000
A06	54829777	54832384	A06p49380.2_BraZ1	1135.47	+	1513	2572	2607	0.9865746
A06	54832576	54833188	A06p49390.2_BraZ1	516	-	470	612	612	1.0000000
A06	54834068	54834886	A06p49400.2_BraZ1	36.3	-	352	818	818	1.0000000
A06	54835857	54839071	A06p49410.2_BraZ1	1358.44	-	1088	3052	3214	0.9495955
A06	54839265	54841507	A06p49420.2_BraZ1	1122.57	+	1020	2181	2242	0.9727921
A06	54843137	54845021	A06p49430.2_BraZ1	1001.25	+	879	1839	1884	0.9761146
A06	54845920	54848066	A06p49440.2_BraZ1	1240.8	+	832	2121	2146	0.9883504
A06	54848654	54849993	A06p49450.2_BraZ1	1820	-	1978	1339	1339	1.0000000
A06	54850834	54853450	A06p49460.2_BraZ1	1522.03	+	1636	2616	2616	1.0000000
A06	54854090	54856937	A06p49470.2_BraZ1	741.04	+	2767	2847	2847	1.0000000
A06	54857948	54860420	A06p49480.2_BraZ1	1875.39	+	1301	2337	2472	0.9453884
A06	54861329	54877754	A06p49490.2_BraZ1	2963.09	-	5396	12137	16425	0.7389346
A06	54862296	54862642	A06p49500.2_BraZ1	258	+	281	346	346	1.0000000
A06	54863582	54865598	A06p49510.2_BraZ1	432	+	73	1136	2016	0.5634921
A06	54883469	54884428	A06p49520.2_BraZ1	384	+	51	658	959	0.6861314
A06	54889768	54891592	A06p49530.2_BraZ1	891.12	+	64	903	1824	0.4950658
A06	54895071	54896636	A06p49540.2_BraZ1	867.5	-	69	671	1565	0.4287540
A06	54897738	54899238	A06p49550.2_BraZ1	148.8	+	719	1500	1500	1.0000000
A06	54900761	54901799	A06p49560.2_BraZ1	103.8	+	738	1038	1038	1.0000000
A06	54903874	54910117	A06p49570.2_BraZ1	2979.73	-	3050	5810	6243	0.9306423
A06	54915465	54917089	A06p49580.2_BraZ1	1143.45	-	213	1412	1624	0.8694581
A06	54920709	54921714	A06p49590.2_BraZ1	609.375	+	373	920	1005	0.9154229
A06	54922460	54924439	A06p49600.2_BraZ1	1258	-	1334	1979	1979	1.0000000
A06	54925138	54927436	A06p49610.2_BraZ1	1298.65	+	1777	2298	2298	1.0000000
A06	54927660	54929232	A06p49620.2_BraZ1	1299.79	-	741	1524	1572	0.9694657
A06	54930326	54931682	A06p49630.2_BraZ1	135.6	+	338	923	1356	0.6806785
A06	54932078	54932538	A06p49640.2_BraZ1	366	-	8	339	460	0.7369565
A06	54932770	54932902	A06p49650.2_BraZ1	13.2	-	3	8	132	0.0606061
A06	54934379	54938386	A06p49660.2_BraZ1	1320.85	-	685	2956	4007	0.7377090
A06	54942361	54942643	A06p49670.2_BraZ1	28.2	-	509	282	282	1.0000000
A06	54945958	54949765	A06p49680.2_BraZ1	1444.97	+	2043	3383	3807	0.8886262
A06	54950533	54951870	A06p49690.2_BraZ1	1062	-	568	1301	1337	0.9730740
A06	54952870	54955125	A06p49700.2_BraZ1	1199.9	-	768	2178	2255	0.9658536
A06	54957154	54961119	A06p49710.2_BraZ1	26370	+	461	2826	3965	0.7127364
A06	54966848	54967974	A06p49720.2_BraZ1	762	+	210	890	1126	0.7904086
A06	54983561	54984414	A06p49730.2_BraZ1	756	+	297	853	853	1.0000000
A06	54985197	54987814	A06p49740.2_BraZ1	213	+	1131	2478	2617	0.9468858
A06	54985749	54986817	A06p49750.2_BraZ1	106.8	+	404	1017	1068	0.9522472
A06	54988087	54990230	A06p49760.2_BraZ1	1575	-	397	1837	2143	0.8572095
A06	54998484	55000859	A06p49770.2_BraZ1	1230.5	-	375	1520	2375	0.6400000
A06	55002482	55003978	A06p49780.2_BraZ1	1143	-	861	1496	1496	1.0000000
A06	55005253	55006348	A06p49790.2_BraZ1	15120	-	478	1094	1095	0.9990867
A06	55007002	55008809	A06p49800.2_BraZ1	1106.86	+	654	1806	1807	0.9994466
A06	55009175	55011544	A06p49810.2_BraZ1	4688.57	-	1520	1868	2369	0.7885184
A06	55013257	55016005	A06p49820.2_BraZ1	1492.76	-	2235	2748	2748	1.0000000
A06	55016642	55016972	A06p49830.2_BraZ1	33	+	250	330	330	1.0000000
A06	55017897	55018980	A06p49840.2_BraZ1	108.3	+	108	744	1083	0.6869806
A06	55025704	55034469	A06p49850.2_BraZ1	5526	+	4990	7874	8765	0.8983457
A06	55036280	55037467	A06p49860.2_BraZ1	648.415	-	800	1187	1187	1.0000000
A06	55042909	55044712	A06p49870.2_BraZ1	1494	+	226	1433	1803	0.7947865
A06	55045446	55047222	A06p49880.2_BraZ1	177.6	+	428	1682	1776	0.9470721
A06	55049239	55051132	A06p49890.2_BraZ1	14040	+	481	1859	1893	0.9820391
A06	55054749	55058239	A06p49900.2_BraZ1	9036	+	1949	3255	3490	0.9326648
A06	55068270	55070149	A06p49910.2_BraZ1	1503	-	127	1461	1879	0.7775412
A06	55076620	55078220	A06p49920.2_BraZ1	8250	+	637	1570	1600	0.9812500
A06	55085522	55088331	A06p49930.2_BraZ1	1134.19	+	1435	2581	2809	0.9188323
A06	55091988	55092369	A06p49940.2_BraZ1	38.1	+	319	373	381	0.9790026
A06	55094211	55095802	A06p49950.2_BraZ1	1602	+	759	1525	1591	0.9585167
A06	55100162	55103125	A06p49960.2_BraZ1	1304.95	+	1593	2806	2963	0.9470131
A06	55103599	55106074	A06p49970.2_BraZ1	1273.12	+	1302	2409	2475	0.9733334
A06	55107605	55107713	A06p49980.2_BraZ1	10.8	-	138	108	108	1.0000000
A06	55109588	55112199	A06p49990.2_BraZ1	1162.93	-	91	1501	2611	0.5748755
A06	55115543	55117185	A06p50000.2_BraZ1	1074.67	-	1233	1642	1642	1.0000000
A06	55117932	55118244	A06p50010.2_BraZ1	31.2	-	94	312	312	1.0000000
A06	55119010	55120928	A06p50020.2_BraZ1	1358.73	-	639	1907	1918	0.9942648
A06	55124059	55128336	A06p50030.2_BraZ1	1932.4	-	2818	4062	4277	0.9497311
A06	55128759	55130209	A06p50040.2_BraZ1	695.4	-	1302	1450	1450	1.0000000
A06	55131318	55132811	A06p50050.2_BraZ1	1425	-	865	1493	1493	1.0000000
A06	55133786	55137025	A06p50060.2_BraZ1	1208.67	-	1017	3150	3239	0.9725224
A06	55141890	55143268	A06p50070.2_BraZ1	1296	+	326	1284	1378	0.9317852
A06	55144533	55144974	A06p50080.2_BraZ1	186	-	288	387	441	0.8775510
A06	55147534	55149121	A06p50090.2_BraZ1	745	+	2	19	1587	0.0119723
A06	55151422	55152293	A06p50100.2_BraZ1	780	+	111	329	871	0.3777268
A06	55158163	55158901	A06p50110.2_BraZ1	73.8	-	152	725	738	0.9823848
A06	55160462	55161251	A06p50120.2_BraZ1	453.143	+	86	756	789	0.9581749
A06	55165011	55166077	A06p50130.2_BraZ1	797.455	+	918	1066	1066	1.0000000
A06	55166270	55167227	A06p50140.2_BraZ1	95.7	-	1077	957	957	1.0000000
A06	55170285	55170567	A06p50150.2_BraZ1	28.2	+	275	282	282	1.0000000
A06	55175879	55177796	A06p50160.2_BraZ1	808.51	-	1514	1917	1917	1.0000000
A06	55183738	55184692	A06p50170.2_BraZ1	95.4	-	329	941	954	0.9863732
A06	55189320	55189931	A06p50180.2_BraZ1	519	+	220	611	611	1.0000000
A06	55198818	55202195	A06p50190.2_BraZ1	468	-	3168	3377	3377	1.0000000
A06	55209166	55209667	A06p50200.2_BraZ1	50.1	+	490	501	501	1.0000000
A06	55210543	55212406	A06p50210.2_BraZ1	1203.54	-	1104	1863	1863	1.0000000
A06	55212801	55219026	A06p50220.2_BraZ1	339	+	8156	6225	6225	1.0000000
A06	55213063	55213702	A06p50230.2_BraZ1	63.9	+	545	639	639	1.0000000
A06	55221083	55225410	A06p50240.2_BraZ1	2443.23	+	1222	3600	4327	0.8319852
A06	55226787	55245333	A06p50250.2_BraZ1	1839.74	-	15183	18499	18546	0.9974658
A06	55246077	55253396	A06p50260.2_BraZ1	281.273	+	3881	6950	7319	0.9495833
A06	55253689	55256667	A06p50270.2_BraZ1	1081.67	-	1090	2730	2978	0.9167227
A06	55260984	55267486	A06p50280.2_BraZ1	2040.69	+	3060	6430	6502	0.9889265
A06	55271622	55273119	A06p50290.2_BraZ1	535.5	+	635	1349	1497	0.9011356
A06	55272292	55273226	A06p50300.2_BraZ1	503.176	+	207	811	934	0.8683084
A06	55280074	55282243	A06p50310.2_BraZ1	1111.53	-	697	2151	2169	0.9917012
A06	55284612	55286324	A06p50320.2_BraZ1	1818	-	1658	1712	1712	1.0000000
A06	55286938	55287817	A06p50330.2_BraZ1	759	-	348	879	879	1.0000000
A06	55289280	55292532	A06p50340.2_BraZ1	1639.97	-	2418	3202	3252	0.9846249
A06	55313453	55313576	A06p50350.2_BraZ1	12.3	+	53	105	123	0.8536586
A06	55321503	55321680	A06p50360.2_BraZ1	17.7	+	45	122	177	0.6892655
A06	55324333	55325642	A06p50370.2_BraZ1	10080	-	203	999	1309	0.7631780
A06	55339645	55341001	A06p50380.2_BraZ1	135.6	-	123	1057	1356	0.7794985
A06	55342229	55346400	A06p50390.2_BraZ1	2609.37	-	1983	3902	4171	0.9355071
A06	55353494	55355328	A06p50400.2_BraZ1	1425	+	108	1508	1834	0.8222464
A06	55365787	55366024	A06p50410.2_BraZ1	23.7	+	203	237	237	1.0000000
A06	55368654	55368927	A06p50420.2_BraZ1	27.3	+	162	273	273	1.0000000
A06	55379755	55380634	A06p50430.2_BraZ1	87.9	-	507	765	879	0.8703071
A06	55383408	55383546	A06p50440.2_BraZ1	13.8	-	188	138	138	1.0000000
A06	55387786	55388129	A06p50450.2_BraZ1	288	+	309	343	343	1.0000000
A06	55414986	55417588	A06p50460.2_BraZ1	1892.25	+	959	2513	2602	0.9657955
A06	55418167	55418281	A06p50470.2_BraZ1	11.4	+	329	114	114	1.0000000
A06	55422961	55423390	A06p50480.2_BraZ1	348	-	523	429	429	1.0000000
A06	55426265	55431385	A06p50490.2_BraZ1	3459.11	+	2401	5072	5120	0.9906250
A06	55432709	55433198	A06p50500.2_BraZ1	48.9	-	112	476	489	0.9734151
A06	55434585	55434699	A06p50510.2_BraZ1	11.4	+	74	114	114	1.0000000
A06	55435188	55435686	A06p50520.2_BraZ1	49.8	-	1	114	498	0.2289157
A06	55438269	55439451	A06p50530.2_BraZ1	118.2	-	454	1182	1182	1.0000000
A06	55443818	55446724	A06p50540.2_BraZ1	1142.8	-	1960	2579	2906	0.8874742
A06	55460804	55464580	A06p50550.2_BraZ1	1638.4	+	1195	3243	3776	0.8588454
A06	55470240	55470753	A06p50560.2_BraZ1	51.3	-	40	329	513	0.6413255
A06	55477339	55477706	A06p50570.2_BraZ1	273	-	141	348	367	0.9482289
A06	55479197	55479571	A06p50580.2_BraZ1	2232	-	327	374	374	1.0000000
A06	55479942	55483114	A06p50590.2_BraZ1	928.909	-	1662	3125	3172	0.9851828
A06	55485585	55489816	A06p50600.2_BraZ1	821.381	-	1645	2284	4231	0.5398251
A06	55494322	55494490	A06p50610.2_BraZ1	16.8	-	434	168	168	1.0000000
A06	55494999	55496943	A06p50620.2_BraZ1	194.4	-	698	1793	1944	0.9223251
A06	55499613	55501506	A06p50630.2_BraZ1	189.3	-	562	1823	1893	0.9630216
A06	55501781	55508529	A06p50640.2_BraZ1	744.791	-	3494	6354	6748	0.9416123
A06	55514344	55516134	A06p50650.2_BraZ1	914.794	-	1286	1790	1790	1.0000000
A06	55516195	55516348	A06p50660.2_BraZ1	15.3	-	178	153	153	1.0000000
A06	55518295	55522825	A06p50670.2_BraZ1	414	+	1880	4510	4530	0.9955850
A06	55522887	55523037	A06p50680.2_BraZ1	15	+	64	150	150	1.0000000
A06	55523536	55524854	A06p50690.2_BraZ1	686.645	-	199	860	1318	0.6525038
A06	55643348	55644049	A06p50700.2_BraZ1	1266	+	134	692	701	0.9871612
A06	55671847	55672699	A06p50710.2_BraZ1	397.552	-	556	820	852	0.9624413
A06	55675820	55677693	A06p50720.2_BraZ1	297	+	84	818	1873	0.4367325
A06	55682236	55683097	A06p50730.2_BraZ1	472.5	-	1241	861	861	1.0000000
A06	55683879	55685062	A06p50740.2_BraZ1	7272	+	823	1060	1183	0.8960270
A06	55688297	55690028	A06p50750.2_BraZ1	1256.33	+	778	1695	1731	0.9792027
A06	55691415	55693262	A06p50760.2_BraZ1	327	+	1756	1847	1847	1.0000000
A06	55694389	55695943	A06p50770.2_BraZ1	660.326	-	192	1151	1554	0.7406693
A06	55696476	55698587	A06p50780.2_BraZ1	657.9	-	563	2087	2111	0.9886310
A06	55708925	55709793	A06p50790.2_BraZ1	681	+	434	865	868	0.9965438
A06	55710075	55710524	A06p50800.2_BraZ1	357	-	590	449	449	1.0000000
A06	55711445	55722028	A06p50810.2_BraZ1	2023.14	-	7887	10342	10583	0.9772276
A06	55722444	55724596	A06p50820.2_BraZ1	1035.13	+	981	2152	2152	1.0000000
A06	55726170	55727849	A06p50830.2_BraZ1	1121.31	+	1326	1679	1679	1.0000000
A06	55728060	55729161	A06p50840.2_BraZ1	110.1	-	362	1018	1101	0.9246140
A06	55732514	55738500	A06p50850.2_BraZ1	1908	-	1500	5507	5986	0.9199799
A06	55738695	55740279	A06p50860.2_BraZ1	1080	-	807	1584	1584	1.0000000
A06	55746959	55747649	A06p50870.2_BraZ1	1644.5	+	604	690	690	1.0000000
A06	55748943	55750794	A06p50880.2_BraZ1	987	-	1102	1797	1851	0.9708266
A06	55754452	55755505	A06p50890.2_BraZ1	462	-	618	928	1053	0.8812916
A06	55758077	55761104	A06p50900.2_BraZ1	1272	-	652	2722	3027	0.8992402
A06	55769391	55772030	A06p50910.2_BraZ1	1404.59	-	919	2562	2639	0.9708223
A06	55987223	55996068	A06p50920.2_BraZ1	1026.52	+	4005	6445	8845	0.7286603
A06	55997681	55998215	A06p50930.2_BraZ1	53.4	+	114	384	534	0.7191011
A06	55999168	56000887	A06p50940.2_BraZ1	766.955	+	603	1655	1719	0.9627690
A06	56001079	56003143	A06p50950.2_BraZ1	206.4	-	486	1978	2064	0.9583333
A06	56004384	56008204	A06p50960.2_BraZ1	1377	+	939	2739	3820	0.7170157
A06	56008797	56010256	A06p50970.2_BraZ1	525.789	+	667	1372	1459	0.9403701
A06	56012391	56014327	A06p50980.2_BraZ1	1339.25	+	774	1936	1936	1.0000000
A06	56015728	56016704	A06p50990.2_BraZ1	627.429	-	159	713	976	0.7305328
A06	56019146	56031818	A06p51000.2_BraZ1	4042.01	+	4346	11051	12672	0.8720801
A06	56043870	56048056	A06p51010.2_BraZ1	1987.33	+	1863	3895	4186	0.9304826
A06	56048924	56050881	A06p51020.2_BraZ1	1695	+	961	1916	1957	0.9790496
A06	56051162	56052966	A06p51030.2_BraZ1	1734	+	364	1556	1804	0.8625277
A06	56053410	56054796	A06p51040.2_BraZ1	138.6	+	131	1170	1386	0.8441558
A06	56056842	56059121	A06p51050.2_BraZ1	994.332	-	920	2205	2279	0.9675296
A06	56062285	56066727	A06p51060.2_BraZ1	966	-	2008	4052	4442	0.9122017
A06	56071657	56072581	A06p51070.2_BraZ1	755.893	+	229	924	924	1.0000000
A06	56075351	56076567	A06p51080.2_BraZ1	940.154	-	438	1216	1216	1.0000000
A06	56078202	56080229	A06p51090.2_BraZ1	998.556	-	1377	2003	2027	0.9881598
A06	56083479	56084337	A06p51100.2_BraZ1	85.8	+	230	858	858	1.0000000
A06	56087292	56087688	A06p51110.2_BraZ1	39.6	+	683	396	396	1.0000000
A06	56088197	56089185	A06p51120.2_BraZ1	690	-	311	777	988	0.7864373
A06	56091367	56093997	A06p51130.2_BraZ1	1610.39	+	1208	2409	2630	0.9159696
A06	56096846	56098566	A06p51140.2_BraZ1	776.16	+	682	1530	1720	0.8895349
A06	56101137	56104981	A06p51150.2_BraZ1	2961	-	622	2290	3844	0.5957336
A06	56105806	56106539	A06p51160.2_BraZ1	2838	-	457	733	733	1.0000000
A06	56108820	56110062	A06p51170.2_BraZ1	124.2	+	329	1198	1242	0.9645733
A06	56118203	56119565	A06p51180.2_BraZ1	136.2	-	312	1362	1362	1.0000000
A06	56125208	56128445	A06p51190.2_BraZ1	1566.07	+	582	2236	3237	0.6907631
A06	56134550	56135166	A06p51200.2_BraZ1	318	+	133	616	616	1.0000000
A06	56142038	56142970	A06p51210.2_BraZ1	597.333	-	342	708	932	0.7596567
A06	56143793	56146096	A06p51220.2_BraZ1	3726.67	-	742	2099	2303	0.9114199
A06	56157973	56160242	A06p51230.2_BraZ1	1175.79	+	1451	2250	2269	0.9916263
A06	56163442	56165583	A06p51240.2_BraZ1	1233.54	+	1277	2141	2141	1.0000000
A06	56166156	56168291	A06p51250.2_BraZ1	1666.15	-	602	2082	2135	0.9751756
A06	56172893	56175589	A06p51260.2_BraZ1	1841.75	+	496	2425	2696	0.8994807
A06	56175972	56176859	A06p51270.2_BraZ1	6225.19	-	692	798	887	0.8996618
A06	56177884	56179293	A06p51280.2_BraZ1	704.905	-	626	1409	1409	1.0000000
A06	56179771	56181634	A06p51290.2_BraZ1	849.571	+	1504	1863	1863	1.0000000
A06	56181939	56184020	A06p51300.2_BraZ1	1404.21	-	524	1921	2081	0.9231139
A06	56187053	56188839	A06p51310.2_BraZ1	866.526	+	741	1537	1786	0.8605823
A06	56189453	56190726	A06p51320.2_BraZ1	972	-	456	1252	1273	0.9835035
A06	56191128	56193245	A06p51330.2_BraZ1	616.221	+	1641	2043	2117	0.9650449
A06	56194167	56201068	A06p51340.2_BraZ1	3428.66	-	3284	6717	6901	0.9733372
A06	56202055	56202475	A06p51350.2_BraZ1	42	-	122	378	420	0.9000000
A06	56204157	56204577	A06p51360.2_BraZ1	291	+	164	386	420	0.9190476
A06	56211181	56215383	A06p51370.2_BraZ1	3496.32	-	489	3082	4202	0.7334602
A06	56222020	56223660	A06p51380.2_BraZ1	647.5	-	1038	1630	1640	0.9939024
A06	56225831	56228535	A06p51390.2_BraZ1	1169.41	-	916	2445	2704	0.9042160
A06	56241139	56242876	A06p51400.2_BraZ1	760.19	-	1383	1737	1737	1.0000000
A06	56243528	56245570	A06p51410.2_BraZ1	624.464	-	1511	2041	2042	0.9995103
A06	56246451	56247687	A06p51420.2_BraZ1	978	-	507	1187	1236	0.9603560
A06	56250391	56251564	A06p51430.2_BraZ1	813.167	+	357	1104	1173	0.9411765
A06	56252127	56253320	A06p51440.2_BraZ1	1062.35	+	803	1193	1193	1.0000000
A06	56262258	56263408	A06p51450.2_BraZ1	857.75	+	291	1141	1150	0.9921739
A06	56266534	56266861	A06p51460.2_BraZ1	32.7	+	120	319	327	0.9755352
A06	56268462	56269626	A06p51470.2_BraZ1	2268	+	551	1158	1164	0.9948454
A06	56276087	56279135	A06p51480.2_BraZ1	304.8	+	627	2509	3048	0.8231627
A06	56280180	56280354	A06p51490.2_BraZ1	17.4	+	52	17	174	0.0977011
A06	56285585	56285903	A06p51500.2_BraZ1	31.8	+	1	15	318	0.0471698
A06	56287374	56289121	A06p51510.2_BraZ1	1426.7	+	963	1706	1747	0.9765312
A06	56289728	56290949	A06p51520.2_BraZ1	122.1	+	452	1221	1221	1.0000000
A06	56294914	56296356	A06p51530.2_BraZ1	1101	+	407	1305	1442	0.9049931
A06	56297967	56300205	A06p51540.2_BraZ1	223.8	+	1348	2229	2238	0.9959785
A06	56304801	56306456	A06p51550.2_BraZ1	222	-	1549	1655	1655	1.0000000
A06	56309055	56309608	A06p51560.2_BraZ1	234	-	228	553	553	1.0000000
A06	56317078	56319927	A06p51570.2_BraZ1	1482.69	+	452	2347	2849	0.8237978
A06	56318448	56318811	A06p51580.2_BraZ1	36.3	-	150	363	363	1.0000000
A06	56329685	56333383	A06p51590.2_BraZ1	1741.94	-	242	2072	3698	0.5603029
A06	56338969	56340502	A06p51600.2_BraZ1	1238.1	-	402	1301	1533	0.8486627
A06	56341102	56343488	A06p51610.2_BraZ1	772.2	-	1268	2386	2386	1.0000000
A06	56349716	56350025	A06p51620.2_BraZ1	30.9	-	125	309	309	1.0000000
A06	56351457	56354088	A06p51630.2_BraZ1	1225.27	-	1220	2591	2631	0.9847966
A06	56364186	56367573	A06p51640.2_BraZ1	338.7	+	461	2797	3387	0.8258045
A06	56373510	56375882	A06p51650.2_BraZ1	8177	-	614	2216	2372	0.9342327
A06	56381193	56381916	A06p51660.2_BraZ1	72.3	-	233	634	723	0.8769018
A06	56385543	56389813	A06p51670.2_BraZ1	495	+	355	2380	4270	0.5573770
A06	56391127	56394130	A06p51680.2_BraZ1	1499.84	-	1345	2937	3003	0.9780220
A06	56399534	56401174	A06p51690.2_BraZ1	492	-	1045	1640	1640	1.0000000
A06	56403108	56411008	A06p51700.2_BraZ1	1872.18	+	5768	7754	7900	0.9815190
A06	56411113	56412505	A06p51710.2_BraZ1	139.2	-	625	1368	1392	0.9827586
A06	56413686	56415583	A06p51720.2_BraZ1	1002	-	313	1599	1897	0.8429099
A06	56419129	56419426	A06p51730.2_BraZ1	29.7	-	691	297	297	1.0000000
A06	56426368	56430878	A06p51740.2_BraZ1	2764.32	+	1773	4232	4510	0.9383592
A06	56434219	56435167	A06p51750.2_BraZ1	94.8	+	314	948	948	1.0000000
A06	56447257	56450516	A06p51760.2_BraZ1	1650.69	-	1361	3203	3259	0.9828168
A06	56455782	56458561	A06p51770.2_BraZ1	2616	+	1389	2779	2779	1.0000000
A06	56458942	56459834	A06p51780.2_BraZ1	76.25	+	601	892	892	1.0000000
A06	56459382	56460878	A06p51790.2_BraZ1	461.25	+	1476	1496	1496	1.0000000
A06	56460953	56461244	A06p51800.2_BraZ1	170.625	+	394	291	291	1.0000000
A06	56462834	56464263	A06p51810.2_BraZ1	815.443	+	666	1417	1429	0.9916025
A06	56467395	56470830	A06p51820.2_BraZ1	1755.67	+	1773	3127	3435	0.9103348
A06	56471955	56472471	A06p51830.2_BraZ1	51.6	-	744	516	516	1.0000000
A06	56476460	56479380	A06p51840.2_BraZ1	690.25	-	2442	2920	2920	1.0000000
A06	56486945	56491173	A06p51850.2_BraZ1	2121	+	3044	4134	4228	0.9777673
A06	56495300	56497749	A06p51860.2_BraZ1	705	-	825	2232	2449	0.9113924
A06	56503712	56504728	A06p51870.2_BraZ1	332.5	-	828	978	1016	0.9625984
A06	56508370	56509176	A06p51880.2_BraZ1	423	+	767	806	806	1.0000000
A06	56513406	56516350	A06p51890.2_BraZ1	13081.5	-	1619	2944	2944	1.0000000
A06	56523889	56524333	A06p51900.2_BraZ1	210	+	1042	444	444	1.0000000
A06	56528651	56531270	A06p51910.2_BraZ1	813.75	-	1105	2578	2619	0.9843452
A06	56537530	56539876	A06p51920.2_BraZ1	1389	+	1208	2320	2346	0.9889173
A06	56540938	56544991	A06p51930.2_BraZ1	1923.16	+	2557	3923	4053	0.9679250
A06	56546017	56549095	A06p51940.2_BraZ1	1501.88	-	750	2947	3078	0.9574399
A06	56560518	56561492	A06p51950.2_BraZ1	505.08	+	35	305	974	0.3131417
A06	56567901	56568936	A06p51960.2_BraZ1	861	+	106	619	1035	0.5980676
A06	56571398	56571947	A06p51970.2_BraZ1	330	-	31	364	549	0.6630237
A06	56572260	56573765	A06p51980.2_BraZ1	1350	+	317	1338	1505	0.8890365
A06	56577057	56577870	A06p51990.2_BraZ1	440	-	409	812	813	0.9987700
A06	56579263	56580276	A06p52000.2_BraZ1	3106.75	-	524	972	1013	0.9595262
A06	56581079	56586329	A06p52010.2_BraZ1	639	+	804	2721	5250	0.5182857
A06	56587551	56588295	A06p52020.2_BraZ1	618	-	188	691	744	0.9287634
A06	56588942	56592809	A06p52030.2_BraZ1	1639.39	-	659	2955	3867	0.7641582
A06	56596591	56597155	A06p52040.2_BraZ1	56.4	+	78	353	564	0.6258865
A06	56606005	56606879	A06p52050.2_BraZ1	372	+	193	376	874	0.4302059
A06	56609545	56611431	A06p52060.2_BraZ1	172.5	+	701	1807	1886	0.9581124
A06	56619097	56620577	A06p52070.2_BraZ1	892.05	+	1193	1480	1480	1.0000000
A06	56620895	56621401	A06p52080.2_BraZ1	405	-	251	506	506	1.0000000
A06	56621482	56623351	A06p52090.2_BraZ1	525	+	871	1869	1869	1.0000000
A06	56626913	56630822	A06p52100.2_BraZ1	126	-	3598	3909	3909	1.0000000
A06	56634078	56634843	A06p52110.2_BraZ1	519.391	+	465	765	765	1.0000000
A06	56635270	56635908	A06p52120.2_BraZ1	558	-	590	638	638	1.0000000
A06	56637841	56638584	A06p52130.2_BraZ1	456	-	651	743	743	1.0000000
A06	56643599	56644202	A06p52140.2_BraZ1	447	-	24	73	603	0.1210614
A06	56647667	56649597	A06p52150.2_BraZ1	1857	+	366	1708	1930	0.8849741
A06	56650934	56651255	A06p52160.2_BraZ1	32.1	+	8	68	321	0.2118380
A06	56653792	56654167	A06p52170.2_BraZ1	37.5	+	0	0	375	0.0000000
A06	56669143	56672030	A06p52180.2_BraZ1	1485.74	-	539	2461	2887	0.8524420
A06	56675566	56692679	A06p52190.2_BraZ1	2133.11	-	3528	11162	17113	0.6522527
A06	56695524	56697655	A06p52200.2_BraZ1	1022.35	+	860	1952	2131	0.9160019
A06	56699643	56699857	A06p52210.2_BraZ1	21	+	70	201	214	0.9392523
A06	56699894	56700207	A06p52220.2_BraZ1	30.9	-	2	111	313	0.3546326
A06	56705020	56705161	A06p52230.2_BraZ1	14.1	-	186	141	141	1.0000000
A06	56708127	56710428	A06p52240.2_BraZ1	1437.86	+	475	2235	2301	0.9713168
A06	56711736	56716352	A06p52250.2_BraZ1	2667.4	+	2087	4547	4616	0.9850520
A06	56729306	56732991	A06p52260.2_BraZ1	565.714	+	1729	3641	3685	0.9880597
A06	56734932	56735766	A06p52270.2_BraZ1	83.4	-	292	834	834	1.0000000
A06	56736426	56738476	A06p52280.2_BraZ1	1683	-	1213	2045	2050	0.9975610
A06	56740327	56741582	A06p52290.2_BraZ1	280.971	+	1094	1252	1255	0.9976096
A06	56741774	56742989	A06p52300.2_BraZ1	651	-	695	1215	1215	1.0000000
A06	56749779	56750259	A06p52310.2_BraZ1	48	+	513	480	480	1.0000000
A06	56751577	56753253	A06p52320.2_BraZ1	807	+	674	1487	1676	0.8872315
A06	56754922	56756030	A06p52330.2_BraZ1	733.875	+	524	1105	1108	0.9972924
A06	56756605	56758636	A06p52340.2_BraZ1	203.1	+	1552	2009	2031	0.9891679
A06	56759526	56760692	A06p52350.2_BraZ1	651.606	+	664	1136	1166	0.9742710
A06	56761671	56762046	A06p52360.2_BraZ1	141	-	1	51	375	0.1360000
A06	56762378	56765260	A06p52370.2_BraZ1	1001.22	-	2343	2882	2882	1.0000000
A06	56768769	56771195	A06p52380.2_BraZ1	1483.36	+	690	2187	2426	0.9014840
A06	56771415	56772246	A06p52390.2_BraZ1	533.647	-	1125	831	831	1.0000000
A06	56773368	56775637	A06p52400.2_BraZ1	2181	-	250	1595	2269	0.7029529
A06	56782509	56784845	A06p52410.2_BraZ1	664.773	+	82	1147	2336	0.4910103
A06	56784762	56786728	A06p52420.2_BraZ1	265	+	396	1162	1966	0.5910478
A06	56797727	56806726	A06p52430.2_BraZ1	1433.4	+	2004	7739	8999	0.8599845
A06	56809916	56810991	A06p52440.2_BraZ1	726.857	-	0	0	1075	0.0000000
A06	56812993	56813443	A06p52450.2_BraZ1	45	-	93	450	450	1.0000000
A06	56817008	56817128	A06p52460.2_BraZ1	12	+	0	0	120	0.0000000
A06	56817367	56817597	A06p52470.2_BraZ1	198	+	0	0	230	0.0000000
A06	56817617	56817779	A06p52480.2_BraZ1	16.2	+	0	0	162	0.0000000
A06	56821282	56826992	A06p52490.2_BraZ1	3259.83	+	2114	5293	5710	0.9269702
A06	56827577	56830330	A06p52500.2_BraZ1	936.429	-	2185	2753	2753	1.0000000
A06	56830704	56832045	A06p52510.2_BraZ1	12913	+	668	1331	1341	0.9925429
A06	56832574	56833267	A06p52520.2_BraZ1	69.3	-	921	693	693	1.0000000
A06	56834548	56835644	A06p52530.2_BraZ1	687	-	89	650	1096	0.5930657
A06	56836190	56838187	A06p52540.2_BraZ1	1346.29	-	1566	1997	1997	1.0000000
A06	56845090	56845638	A06p52550.2_BraZ1	306	+	58	444	548	0.8102190
A06	56846692	56850381	A06p52560.2_BraZ1	2802.81	-	978	3385	3689	0.9175928
A06	56851163	56851307	A06p52570.2_BraZ1	14.4	+	175	144	144	1.0000000
A06	56851756	56854087	A06p52580.2_BraZ1	1133.17	-	485	1121	2331	0.4809095
A06	56854720	56856509	A06p52590.2_BraZ1	1335	+	761	1685	1789	0.9418670
A06	56856930	56858959	A06p52600.2_BraZ1	1636.56	-	205	1746	2029	0.8605224
A06	56860408	56861628	A06p52610.2_BraZ1	1140	-	563	1220	1220	1.0000000
A06	56862264	56864344	A06p52620.2_BraZ1	1105	-	928	2066	2080	0.9932692
A06	56867614	56869513	A06p52630.2_BraZ1	1665	+	756	1899	1899	1.0000000
A06	56869668	56870720	A06p52640.2_BraZ1	667.789	-	500	973	1052	0.9249049
A06	56874474	56876466	A06p52650.2_BraZ1	914.071	+	1321	1992	1992	1.0000000
A06	56876908	56882165	A06p52660.2_BraZ1	1495.45	-	1857	4409	5257	0.8386913
A06	56882865	56891814	A06p52670.2_BraZ1	4348.24	-	2202	7295	8949	0.8151749
A06	56892410	56893697	A06p52680.2_BraZ1	1047	+	739	1287	1287	1.0000000
A06	56894075	56895026	A06p52690.2_BraZ1	1252.8	-	389	951	951	1.0000000
A06	56895302	56896806	A06p52700.2_BraZ1	924.364	-	1058	1493	1504	0.9926862
A06	56899715	56901862	A06p52710.2_BraZ1	866.327	+	2085	2147	2147	1.0000000
A06	56903478	56904059	A06p52720.2_BraZ1	1503	+	284	581	581	1.0000000
A06	56906816	56908200	A06p52730.2_BraZ1	1619.43	+	790	1384	1384	1.0000000
A06	56908880	56909420	A06p52740.2_BraZ1	54	+	69	514	540	0.9518518
A06	56910789	56911796	A06p52750.2_BraZ1	783	+	950	1007	1007	1.0000000
A06	56912838	56913387	A06p52760.2_BraZ1	450	+	274	542	549	0.9872496
A06	56914369	56915498	A06p52770.2_BraZ1	829.286	+	940	1129	1129	1.0000000
A06	56919625	56922082	A06p52780.2_BraZ1	1981.69	+	597	1813	2457	0.7378917
A06	56924410	56924773	A06p52790.2_BraZ1	36.3	+	417	363	363	1.0000000
A06	56927079	56928881	A06p52800.2_BraZ1	994.365	+	793	1725	1802	0.9572697
A06	56932630	56933371	A06p52810.2_BraZ1	9990	+	744	741	741	1.0000000
A06	56933838	56935861	A06p52820.2_BraZ1	1035.18	-	496	1395	2023	0.6895700
A06	56937796	56938180	A06p52830.2_BraZ1	38.4	-	24	67	384	0.1744792
A06	56939570	56941088	A06p52840.2_BraZ1	1054.43	+	524	1438	1518	0.9472991
A06	56941902	56947467	A06p52850.2_BraZ1	3681.97	-	1476	4394	5565	0.7895777
A06	56948756	56949157	A06p52860.2_BraZ1	144	-	260	401	401	1.0000000
A06	56949606	56951118	A06p52870.2_BraZ1	975.72	-	130	1323	1512	0.8750000
A06	56951744	56952497	A06p52880.2_BraZ1	34.3636	-	950	753	753	1.0000000
A06	56952558	56952957	A06p52890.2_BraZ1	1618.91	-	417	399	399	1.0000000
A06	56955201	56956537	A06p52900.2_BraZ1	756	+	408	1024	1336	0.7664671
A06	56957686	56959297	A06p52910.2_BraZ1	1093.09	+	420	1461	1611	0.9068902
A06	56959412	56960953	A06p52920.2_BraZ1	976.87	-	983	1541	1541	1.0000000
A06	56962284	56962914	A06p52930.2_BraZ1	63	-	81	117	630	0.1857143
A06	56963521	56963932	A06p52940.2_BraZ1	240	-	0	0	411	0.0000000
A06	56964962	56970135	A06p52950.2_BraZ1	2239.63	-	2106	4623	5173	0.8936787
A06	56978648	56979765	A06p52960.2_BraZ1	806.559	+	1392	1117	1117	1.0000000
A06	56980428	56982934	A06p52970.2_BraZ1	177	-	694	1373	2506	0.5478851
A06	56986291	56987731	A06p52980.2_BraZ1	144	+	1037	1440	1440	1.0000000
A06	56987863	56988278	A06p52990.2_BraZ1	327	+	408	415	415	1.0000000
A06	56988572	56992172	A06p53000.2_BraZ1	1051.63	-	2281	3514	3600	0.9761111
A06	56995395	56996639	A06p53010.2_BraZ1	697.143	-	861	1244	1244	1.0000000
A06	57000536	57002242	A06p53020.2_BraZ1	997.232	-	229	1442	1706	0.8452520
A06	57006438	57007302	A06p53030.2_BraZ1	86.4	-	471	862	864	0.9976852
A06	57012770	57012935	A06p53040.2_BraZ1	16.5	-	71	158	165	0.9575757
A06	57017253	57017907	A06p53050.2_BraZ1	65.4	+	340	654	654	1.0000000
A06	57019170	57020924	A06p53060.2_BraZ1	951.9	+	782	1731	1754	0.9868871
A06	57021423	57022768	A06p53070.2_BraZ1	596.043	-	1105	1345	1345	1.0000000
A06	57027335	57027712	A06p53080.2_BraZ1	204	+	28	354	377	0.9389920
A06	57029433	57030878	A06p53090.2_BraZ1	521.053	+	1722	1445	1445	1.0000000
A06	57031958	57033503	A06p53100.2_BraZ1	634.081	+	892	1493	1545	0.9663430
A06	57034370	57035465	A06p53110.2_BraZ1	109.5	-	652	1095	1095	1.0000000
A06	57038830	57039829	A06p53120.2_BraZ1	99.9	-	73	250	999	0.2502503
A06	57042932	57045068	A06p53130.2_BraZ1	1254.23	-	1422	2136	2136	1.0000000
A06	57048185	57049438	A06p53140.2_BraZ1	615	+	530	1253	1253	1.0000000
A06	57049525	57051143	A06p53150.2_BraZ1	332.308	+	261	1497	1618	0.9252163
A06	57055517	57055968	A06p53160.2_BraZ1	269.182	-	391	451	451	1.0000000
A06	57056759	57059472	A06p53170.2_BraZ1	826.8	+	2048	2706	2713	0.9974198
A06	57063250	57064946	A06p53180.2_BraZ1	1165.71	+	314	1576	1696	0.9292453
A06	57066922	57067633	A06p53190.2_BraZ1	552	-	311	711	711	1.0000000
A06	57087408	57088567	A06p53200.2_BraZ1	738.286	-	522	1159	1159	1.0000000
A06	57096721	57101879	A06p53210.2_BraZ1	2503.24	+	2776	5061	5158	0.9811943
A06	57102638	57103985	A06p53220.2_BraZ1	612	-	866	1347	1347	1.0000000
A06	57104182	57105028	A06p53230.2_BraZ1	84.6	+	684	846	846	1.0000000
A06	57105698	57113064	A06p53240.2_BraZ1	3892.85	-	2664	6939	7366	0.9420310
A06	57116137	57117130	A06p53250.2_BraZ1	99.3	+	322	868	993	0.8741188
A06	57118071	57118659	A06p53260.2_BraZ1	58.8	+	49	318	588	0.5408163
A06	57121813	57122374	A06p53270.2_BraZ1	56.1	+	49	439	561	0.7825312
A06	57124862	57125447	A06p53280.2_BraZ1	58.5	+	227	585	585	1.0000000
A06	57127925	57131475	A06p53290.2_BraZ1	801	-	775	3324	3550	0.9363380
A06	57132350	57133003	A06p53300.2_BraZ1	444	-	335	653	653	1.0000000
A06	57133876	57134425	A06p53310.2_BraZ1	54.9	+	220	533	549	0.9708561
A06	57134877	57137052	A06p53320.2_BraZ1	217.5	-	1428	2155	2175	0.9908046
A06	57139413	57142113	A06p53330.2_BraZ1	363	+	517	2366	2700	0.8762963
A06	57144157	57146868	A06p53340.2_BraZ1	363	+	297	1881	2711	0.6938399
A06	57148830	57151462	A06p53350.2_BraZ1	363	+	2874	2304	2632	0.8753799
A06	57153483	57154097	A06p53360.2_BraZ1	348	+	1246	614	614	1.0000000
A06	57159747	57163743	A06p53370.2_BraZ1	1883.82	-	1041	3501	3996	0.8761261
A06	57166395	57167104	A06p53380.2_BraZ1	255	-	194	709	709	1.0000000
A06	57171341	57173162	A06p53390.2_BraZ1	9765	-	137	1392	1821	0.7644151
A06	57173415	57174085	A06p53400.2_BraZ1	255	-	21	271	670	0.4044776
A06	57176643	57177416	A06p53410.2_BraZ1	585	+	10	22	773	0.0284605
A06	57180066	57181367	A06p53420.2_BraZ1	119.7	-	90	1069	1301	0.8216757
A06	57183371	57184296	A06p53430.2_BraZ1	1344	-	568	919	925	0.9935135
A06	57185899	57187680	A06p53440.2_BraZ1	729.214	-	1161	1664	1781	0.9343066
A06	57188849	57190156	A06p53450.2_BraZ1	787.786	+	560	1307	1307	1.0000000
A06	57190498	57191586	A06p53460.2_BraZ1	864	-	811	1088	1088	1.0000000
A06	57194778	57196666	A06p53470.2_BraZ1	147.6	-	1338	1864	1888	0.9872881
A06	57198961	57199768	A06p53480.2_BraZ1	80.7	-	256	801	807	0.9925650
A06	57210723	57211529	A06p53490.2_BraZ1	558	-	275	773	806	0.9590571
A06	57211497	57211850	A06p53500.2_BraZ1	32.1	-	217	353	353	1.0000000
A06	57218372	57219348	A06p53510.2_BraZ1	903	+	112	744	976	0.7622951
A06	57219730	57223175	A06p53520.2_BraZ1	300	+	1254	3056	3445	0.8870828
A06	57233844	57234477	A06p53530.2_BraZ1	63.3	+	162	537	633	0.8483412
A06	57237091	57237778	A06p53540.2_BraZ1	68.7	-	11	372	687	0.5414847
A06	57242671	57243199	A06p53550.2_BraZ1	52.8	+	415	528	528	1.0000000
A06	57252663	57254400	A06p53560.2_BraZ1	173.7	-	304	1178	1737	0.6781808
A06	57258140	57259935	A06p53570.2_BraZ1	1059.12	+	1623	1795	1795	1.0000000
A06	57260514	57263875	A06p53580.2_BraZ1	2099.05	+	1980	3088	3361	0.9187742
A06	57264178	57265276	A06p53590.2_BraZ1	109.8	-	520	1098	1098	1.0000000
A06	57287889	57289284	A06p53600.2_BraZ1	519.1	-	2	70	1395	0.0501792
A06	57289243	57289863	A06p53610.2_BraZ1	191.4	-	2	283	620	0.4564516
A06	57291250	57292384	A06p53620.2_BraZ1	681	+	631	1134	1134	1.0000000
A06	57293231	57294616	A06p53630.2_BraZ1	442	-	596	1349	1385	0.9740072
A06	57297217	57298977	A06p53640.2_BraZ1	600.875	-	1443	1733	1760	0.9846591
A06	57306195	57307878	A06p53650.2_BraZ1	975	-	402	1287	1683	0.7647059
A06	57317939	57318803	A06p53660.2_BraZ1	86.4	-	53	299	864	0.3460648
A06	57320561	57323271	A06p53670.2_BraZ1	1267.86	-	1055	2641	2710	0.9745387
A06	57328169	57329064	A06p53680.2_BraZ1	414	+	307	895	895	1.0000000
A06	57329936	57333069	A06p53690.2_BraZ1	970	+	2	20	3133	0.0063837
A06	57338521	57341190	A06p53700.2_BraZ1	1666.03	+	157	1754	2669	0.6571749
A06	57342693	57343843	A06p53710.2_BraZ1	859.773	-	115	925	1150	0.8043478
A06	57351046	57353182	A06p53720.2_BraZ1	213.6	+	285	1277	2136	0.5978464
A06	57353452	57355856	A06p53730.2_BraZ1	1396.96	-	385	1829	2404	0.7608153
A06	57358561	57364244	A06p53740.2_BraZ1	4936.32	-	1931	5614	5683	0.9878585
A06	57365156	57367014	A06p53750.2_BraZ1	1089.37	-	707	1837	1858	0.9886975
A06	57370435	57390686	A06p53760.2_BraZ1	968.42	-	6987	15685	20251	0.7745296
A06	57392391	57394407	A06p53770.2_BraZ1	1394.84	-	919	1929	2016	0.9568452
A06	57395415	57399555	A06p53780.2_BraZ1	2765.45	-	1776	3980	4140	0.9613526
A06	57400566	57403002	A06p53790.2_BraZ1	1470	+	2090	2436	2436	1.0000000
A06	57405213	57407628	A06p53800.2_BraZ1	972	+	696	2164	2415	0.8960662
A06	57411466	57414186	A06p53810.2_BraZ1	1174.78	+	1779	2558	2720	0.9404412
A06	57415133	57417359	A06p53820.2_BraZ1	1426.97	-	725	2218	2226	0.9964061
A06	57419477	57419690	A06p53830.2_BraZ1	21.3	+	129	213	213	1.0000000
A06	57422815	57425429	A06p53840.2_BraZ1	1217.73	+	577	2611	2614	0.9988523
A06	57427279	57430992	A06p53850.2_BraZ1	2116.73	+	1751	3640	3713	0.9803393
A06	57431609	57434020	A06p53860.2_BraZ1	1097.2	-	1119	2325	2411	0.9643301
A06	57435595	57436056	A06p53870.2_BraZ1	3366	+	9	256	461	0.5553145
A06	57468577	57472238	A06p53880.2_BraZ1	1567.79	+	366	2127	3661	0.5809888
A06	57475807	57476242	A06p53890.2_BraZ1	43.5	+	7	168	435	0.3862069
A06	57480239	57480596	A06p53900.2_BraZ1	35.7	+	326	357	357	1.0000000
A06	57481208	57485690	A06p53910.2_BraZ1	1353.62	-	1495	4283	4482	0.9556002
A06	57486709	57491732	A06p53920.2_BraZ1	2244.61	+	2102	4734	5023	0.9424646
A06	57492547	57495271	A06p53930.2_BraZ1	1661.4	+	1311	2561	2724	0.9401615
A06	57496899	57505290	A06p53940.2_BraZ1	1224.67	+	4447	8170	8391	0.9736623
A06	57506475	57506696	A06p53950.2_BraZ1	102	+	204	221	221	1.0000000
A06	57508874	57509980	A06p53960.2_BraZ1	440	-	15	154	1106	0.1392405
A06	57510984	57511206	A06p53970.2_BraZ1	22.2	-	93	222	222	1.0000000
A06	57514544	57514784	A06p53980.2_BraZ1	24	+	40	118	240	0.4916667
A06	57515483	57518036	A06p53990.2_BraZ1	977.745	-	632	2455	2553	0.9616138
A06	57520205	57521624	A06p54000.2_BraZ1	141.9	+	429	1374	1419	0.9682875
A06	57521697	57522351	A06p54010.2_BraZ1	65.4	-	52	425	654	0.6498471
A06	57523443	57524169	A06p54020.2_BraZ1	72.6	-	13	182	726	0.2506887
A06	57531935	57532949	A06p54030.2_BraZ1	101.4	+	252	994	1014	0.9802761
A06	57536500	57541255	A06p54040.2_BraZ1	2962.36	-	1015	3488	4755	0.7335436
A06	57542294	57542913	A06p54050.2_BraZ1	371.415	-	965	619	619	1.0000000
A06	57543608	57544953	A06p54060.2_BraZ1	476.836	+	599	1326	1345	0.9858736
A06	57546468	57548301	A06p54070.2_BraZ1	560.653	-	1221	1833	1833	1.0000000
A06	57549692	57550010	A06p54080.2_BraZ1	31.8	-	598	318	318	1.0000000
A06	57550167	57551853	A06p54090.2_BraZ1	1035	-	1198	1686	1686	1.0000000
A06	57555344	57556296	A06p54100.2_BraZ1	579	+	28	376	952	0.3949580
A06	57561418	57561907	A06p54110.2_BraZ1	48.9	+	7	16	489	0.0327198
A06	57563287	57563560	A06p54120.2_BraZ1	27.3	-	367	265	273	0.9706960
A06	57566798	57569892	A06p54130.2_BraZ1	1883.07	+	347	2328	3094	0.7524241
A06	57574859	57576012	A06p54140.2_BraZ1	843	+	195	912	1153	0.7909800
A06	57576743	57576954	A06p54150.2_BraZ1	20.7	-	35	112	211	0.5308057
A06	57578480	57579764	A06p54160.2_BraZ1	849	+	685	1284	1284	1.0000000
A06	57580542	57581985	A06p54170.2_BraZ1	144.3	-	123	741	1443	0.5135135
A06	57593588	57599171	A06p54180.2_BraZ1	3224.18	-	1358	4951	5583	0.8867992
A06	57603061	57605691	A06p54190.2_BraZ1	1751.58	+	1361	2499	2630	0.9501901
A06	57606844	57608049	A06p54200.2_BraZ1	910.6	-	1089	1205	1205	1.0000000
A06	57608690	57609876	A06p54210.2_BraZ1	55.5	+	670	1186	1186	1.0000000
A06	57611425	57612065	A06p54220.2_BraZ1	360	+	197	368	640	0.5750000
A06	57614060	57614947	A06p54230.2_BraZ1	651	-	169	793	887	0.8940248
A06	57616891	57620265	A06p54240.2_BraZ1	2308.9	+	2164	3374	3374	1.0000000
A06	57620967	57621321	A06p54250.2_BraZ1	35.4	-	975	354	354	1.0000000
A06	57623052	57623406	A06p54260.2_BraZ1	35.4	-	449	354	354	1.0000000
A06	57625133	57625487	A06p54270.2_BraZ1	35.4	-	225	351	354	0.9915254
A06	57626787	57627141	A06p54280.2_BraZ1	35.4	-	1185	354	354	1.0000000
A06	57628452	57628806	A06p54290.2_BraZ1	35.4	-	515	354	354	1.0000000
A06	57630117	57630471	A06p54300.2_BraZ1	35.4	-	457	354	354	1.0000000
A06	57631679	57632033	A06p54310.2_BraZ1	35.4	-	9	347	354	0.9802260
A06	57633067	57633421	A06p54320.2_BraZ1	35.4	-	146	354	354	1.0000000
A06	57634454	57634808	A06p54330.2_BraZ1	35.4	-	56	354	354	1.0000000
A06	57635825	57636179	A06p54340.2_BraZ1	35.4	-	570	354	354	1.0000000
A06	57637307	57638141	A06p54350.2_BraZ1	83.4	-	676	813	834	0.9748201
A06	57640076	57641301	A06p54360.2_BraZ1	741	+	482	1119	1225	0.9134694
A06	57643565	57645408	A06p54370.2_BraZ1	1021.3	-	589	1825	1843	0.9902333
A06	57648689	57649728	A06p54380.2_BraZ1	684	-	1265	1039	1039	1.0000000
A06	57650919	57652847	A06p54390.2_BraZ1	1120.62	-	1664	1928	1928	1.0000000
A06	57653940	57657278	A06p54400.2_BraZ1	1876.27	+	3073	3249	3338	0.9733374
A06	57657864	57658338	A06p54410.2_BraZ1	47.4	-	218	418	474	0.8818566
A06	57659165	57660732	A06p54420.2_BraZ1	578.16	+	411	1405	1567	0.8966178
A06	57660901	57661342	A06p54430.2_BraZ1	25.5	+	409	441	441	1.0000000
A06	57664031	57665273	A06p54440.2_BraZ1	713.95	-	693	1242	1242	1.0000000
A06	57666854	57668356	A06p54450.2_BraZ1	481.419	+	1096	1502	1502	1.0000000
A06	57671041	57672592	A06p54460.2_BraZ1	827.673	+	503	1336	1551	0.8613797
A06	57674790	57677133	A06p54470.2_BraZ1	234.3	+	294	1819	2343	0.7763551
A06	57678644	57682630	A06p54480.2_BraZ1	2424	+	2488	3362	3986	0.8434521
A06	57686630	57689873	A06p54490.2_BraZ1	324.3	+	1909	3182	3243	0.9811903
A06	57690384	57691672	A06p54500.2_BraZ1	891	-	906	1288	1288	1.0000000
A06	57692399	57694541	A06p54510.2_BraZ1	214.2	+	1135	2136	2142	0.9971989
A06	57695271	57697438	A06p54520.2_BraZ1	1020	-	1206	2167	2167	1.0000000
A06	57700567	57701479	A06p54530.2_BraZ1	91.2	+	740	912	912	1.0000000
A06	57701674	57702357	A06p54540.2_BraZ1	297	+	970	683	683	1.0000000
A06	57702923	57704067	A06p54550.2_BraZ1	867	-	416	1134	1144	0.9912587
A06	57704409	57706099	A06p54560.2_BraZ1	888.75	+	909	1429	1690	0.8455621
A06	57708016	57708163	A06p54570.2_BraZ1	14.7	+	0	0	147	0.0000000
A06	57710829	57713831	A06p54580.2_BraZ1	1019.32	+	961	2811	3002	0.9363757
A06	57715376	57716979	A06p54590.2_BraZ1	462	+	143	1250	1603	0.7797879
A06	57717730	57717928	A06p54600.2_BraZ1	19.8	+	339	198	198	1.0000000
A06	57723750	57725660	A06p54610.2_BraZ1	1413	+	561	1858	1910	0.9727749
A06	57727417	57729272	A06p54620.2_BraZ1	622.184	+	1330	1830	1855	0.9865229
A06	57734684	57736547	A06p54630.2_BraZ1	1592.5	+	382	1484	1863	0.7965647
A06	57739081	57740064	A06p54640.2_BraZ1	291	+	559	850	983	0.8646999
A06	57741179	57741391	A06p54650.2_BraZ1	13.8	-	404	212	212	1.0000000
A06	57742827	57745800	A06p54660.2_BraZ1	12548.7	+	2464	2855	2973	0.9603094
A06	57753137	57755840	A06p54670.2_BraZ1	1504.22	+	1317	2235	2703	0.8268591
A06	57756753	57759209	A06p54680.2_BraZ1	1109.66	+	1828	2452	2456	0.9983714
A06	57759640	57764370	A06p54690.2_BraZ1	2253.33	-	2013	4470	4730	0.9450317
A06	57765934	57774885	A06p54700.2_BraZ1	3078.28	+	12970	8812	8951	0.9844710
A06	57775434	57776931	A06p54710.2_BraZ1	575.362	-	1270	1497	1497	1.0000000
A06	57778060	57779800	A06p54720.2_BraZ1	172.8	+	566	1736	1740	0.9977012
A06	57780599	57782589	A06p54730.2_BraZ1	1892.16	-	819	1945	1990	0.9773870
A06	57789323	57791377	A06p54740.2_BraZ1	1098	+	25	85	2054	0.0413827
A06	57793490	57794385	A06p54750.2_BraZ1	408	+	32	539	895	0.6022347
A06	57794913	57796217	A06p54760.2_BraZ1	882.482	-	33	823	1304	0.6311350
A06	57799352	57801143	A06p54770.2_BraZ1	962.833	-	1120	1791	1791	1.0000000
A06	57802635	57803604	A06p54780.2_BraZ1	96.9	+	386	919	969	0.9484004
A06	57809299	57812180	A06p54790.2_BraZ1	612.432	+	1355	2817	2881	0.9777855
A06	57816100	57816361	A06p54800.2_BraZ1	26.1	-	322	261	261	1.0000000
A06	57818274	57819616	A06p54810.2_BraZ1	1043.39	+	874	1342	1342	1.0000000
A06	57828341	57830056	A06p54820.2_BraZ1	1073.86	+	169	1408	1715	0.8209913
A06	57834456	57838234	A06p54830.2_BraZ1	2847.67	+	351	2640	3778	0.6987824
A06	57842633	57843968	A06p54840.2_BraZ1	936	-	386	1288	1335	0.9647940
A06	57851510	57854261	A06p54850.2_BraZ1	1083.4	-	2131	2751	2751	1.0000000
A06	57855928	57858688	A06p54860.2_BraZ1	1441.23	+	806	2593	2760	0.9394928
A06	57859351	57859468	A06p54870.2_BraZ1	11.7	+	83	117	117	1.0000000
A06	57860562	57860685	A06p54880.2_BraZ1	12.3	+	109	123	123	1.0000000
A06	57862467	57872137	A06p54890.2_BraZ1	4168.76	-	5714	9546	9670	0.9871768
A06	57873007	57876487	A06p54900.2_BraZ1	1696.26	+	2567	3415	3480	0.9813218
A06	57877986	57878898	A06p54910.2_BraZ1	728.64	+	690	912	912	1.0000000
A06	57880701	57881580	A06p54920.2_BraZ1	84	+	384	879	879	1.0000000
A06	57883095	57884010	A06p54930.2_BraZ1	91.5	+	851	915	915	1.0000000
A06	57884407	57888347	A06p54940.2_BraZ1	636.423	-	2287	3940	3940	1.0000000
A06	57890872	57894674	A06p54950.2_BraZ1	3729	+	724	2655	3802	0.6983167
A06	57989437	57991640	A06p54960.2_BraZ1	16695	+	679	1661	2203	0.7539719
A06	57992965	57994039	A06p54970.2_BraZ1	107.4	-	62	868	1074	0.8081937
A06	57994532	57996750	A06p54980.2_BraZ1	684.041	-	1023	2195	2218	0.9896303
A06	57997121	58001208	A06p54990.2_BraZ1	2224.64	+	1922	3719	4087	0.9099584
A06	58005358	58007316	A06p55000.2_BraZ1	4003.71	+	291	1182	1958	0.6036772
A06	58011277	58012431	A06p55010.2_BraZ1	603	+	690	1149	1154	0.9956672
A06	58015636	58017061	A06p55020.2_BraZ1	142.5	+	150	1074	1425	0.7536842
A06	58018050	58019877	A06p55030.2_BraZ1	518.529	-	1531	1827	1827	1.0000000
A06	58021856	58023161	A06p55040.2_BraZ1	586.364	+	525	1291	1305	0.9892721
A06	58023756	58024107	A06p55050.2_BraZ1	35.1	+	409	351	351	1.0000000
A06	58024217	58027530	A06p55060.2_BraZ1	2420.74	-	705	2952	3313	0.8910353
A06	58030632	58031191	A06p55070.2_BraZ1	465	+	336	559	559	1.0000000
A06	58036038	58037616	A06p55080.2_BraZ1	714.581	+	1322	1578	1578	1.0000000
A06	58039019	58041066	A06p55090.2_BraZ1	1208.41	-	438	1877	2047	0.9169517
A06	58044788	58044965	A06p55100.2_BraZ1	17.7	-	0	0	177	0.0000000
A06	58051349	58052636	A06p55110.2_BraZ1	1032	+	825	1287	1287	1.0000000
A06	58053156	58053726	A06p55120.2_BraZ1	57	-	170	557	570	0.9771930
A06	58055310	58057163	A06p55130.2_BraZ1	939.017	+	1651	1853	1853	1.0000000
A06	58059844	58062662	A06p55140.2_BraZ1	1632	+	496	2286	2818	0.8112136
A06	58067312	58069768	A06p55150.2_BraZ1	1136	+	1103	2454	2456	0.9991857
A06	58073362	58074664	A06p55160.2_BraZ1	130.2	+	963	1302	1302	1.0000000
A06	58078136	58079780	A06p55170.2_BraZ1	164.4	+	136	719	1644	0.4373479
A06	58082758	58090982	A06p55180.2_BraZ1	806.021	+	5750	7858	8224	0.9554961
A06	58086849	58087395	A06p55190.2_BraZ1	252	-	937	546	546	1.0000000
A06	58094349	58095282	A06p55200.2_BraZ1	93.3	-	180	933	933	1.0000000
A06	58097717	58099214	A06p55210.2_BraZ1	1330.31	+	244	1497	1497	1.0000000
A06	58099522	58101049	A06p55220.2_BraZ1	1530	-	986	1478	1527	0.9679109
A06	58102138	58103881	A06p55230.2_BraZ1	174.3	+	675	1743	1743	1.0000000
A06	58104416	58105697	A06p55240.2_BraZ1	14436	-	1063	1281	1281	1.0000000
A06	58106704	58114887	A06p55250.2_BraZ1	1295	+	7842	8183	8183	1.0000000
A06	58109698	58109948	A06p55260.2_BraZ1	165	-	143	250	250	1.0000000
A06	58111937	58113465	A06p55270.2_BraZ1	16426	-	1304	1528	1528	1.0000000
A06	58116952	58118126	A06p55280.2_BraZ1	113.7	+	169	1097	1174	0.9344122
A06	58121910	58127878	A06p55290.2_BraZ1	2788	-	4340	5685	5968	0.9525805
A06	58129587	58131194	A06p55300.2_BraZ1	619.429	+	1016	1541	1607	0.9589297
A06	58132946	58133818	A06p55310.2_BraZ1	639	+	36	45	872	0.0516055
A06	58133914	58134103	A06p55320.2_BraZ1	129	+	0	0	189	0.0000000
A06	58136982	58137478	A06p55330.2_BraZ1	171	+	650	496	496	1.0000000
A06	58137220	58138430	A06p55340.2_BraZ1	141	+	773	1144	1210	0.9454545
A06	58139000	58140984	A06p55350.2_BraZ1	822.545	-	617	1859	1984	0.9369960
A06	58149039	58155409	A06p55360.2_BraZ1	4844.87	-	2454	6046	6370	0.9491366
A06	58159721	58160064	A06p55370.2_BraZ1	787.5	+	0	0	343	0.0000000
A06	58163545	58165859	A06p55380.2_BraZ1	9067.5	-	641	2065	2314	0.8923941
A06	58172804	58173539	A06p55390.2_BraZ1	73.5	-	5	95	735	0.1292517
A06	58178797	58180792	A06p55400.2_BraZ1	1325.45	+	358	1650	1995	0.8270677
A06	58181035	58183212	A06p55410.2_BraZ1	2001	-	1013	1910	2177	0.8773541
A06	58185049	58185850	A06p55420.2_BraZ1	80.1	+	742	801	801	1.0000000
A06	58186795	58189394	A06p55430.2_BraZ1	1564.21	-	1077	2474	2599	0.9519046
A06	58192957	58193338	A06p55440.2_BraZ1	38.1	-	329	381	381	1.0000000
A06	58197414	58198783	A06p55450.2_BraZ1	1134.61	+	1029	1369	1369	1.0000000
A06	58199075	58203327	A06p55460.2_BraZ1	2665.07	-	1280	4030	4252	0.9477893
A06	58204015	58205651	A06p55470.2_BraZ1	813	-	177	1258	1636	0.7689487
A06	58209711	58210771	A06p55480.2_BraZ1	296.653	+	948	1001	1060	0.9443396
A06	58215868	58217235	A06p55490.2_BraZ1	1178.59	+	829	1351	1367	0.9882956
A06	58217916	58220949	A06p55500.2_BraZ1	1705.17	-	1707	2669	3033	0.8799868
A06	58223061	58224638	A06p55510.2_BraZ1	1086	+	452	1174	1577	0.7444515
A06	58226222	58226516	A06p55520.2_BraZ1	29.4	-	159	294	294	1.0000000
A06	58229612	58231773	A06p55530.2_BraZ1	1221.61	+	1758	2139	2161	0.9898195
A06	58232178	58234221	A06p55540.2_BraZ1	1102.68	-	2030	2027	2043	0.9921684
A06	58239540	58244094	A06p55550.2_BraZ1	1022.66	+	2704	3472	4554	0.7624066
A06	58246259	58254807	A06p55560.2_BraZ1	4080.2	+	3079	7730	8548	0.9043051
A06	58263086	58264571	A06p55570.2_BraZ1	1281	+	95	986	1485	0.6639731
A06	58265079	58265797	A06p55580.2_BraZ1	597	+	556	718	718	1.0000000
A06	58270474	58273597	A06p55590.2_BraZ1	1243	+	659	2704	3123	0.8658341
A06	58277542	58277953	A06p55600.2_BraZ1	41.1	+	126	409	411	0.9951338
A06	58278893	58279920	A06p55610.2_BraZ1	588	-	57	629	1027	0.6124635
A06	58280028	58281733	A06p55620.2_BraZ1	1677	-	922	1703	1705	0.9988270
A06	58282613	58286969	A06p55630.2_BraZ1	2623.9	-	1966	4349	4356	0.9983930
A06	58291956	58292163	A06p55640.2_BraZ1	20.7	+	181	207	207	1.0000000
A06	58303385	58307058	A06p55650.2_BraZ1	1434.6	+	1127	3162	3673	0.8608767
A06	58307372	58307930	A06p55660.2_BraZ1	55.8	-	441	558	558	1.0000000
A06	58308746	58311841	A06p55670.2_BraZ1	1581	-	1434	2223	3095	0.7182552
A06	58320890	58322896	A06p55680.2_BraZ1	997.071	+	1350	2006	2006	1.0000000
A06	58323531	58324853	A06p55690.2_BraZ1	579.5	-	1048	1322	1322	1.0000000
A06	58325233	58327837	A06p55700.2_BraZ1	24453	-	1854	1672	2604	0.6420891
A06	58330552	58333931	A06p55710.2_BraZ1	684.409	+	3462	3351	3379	0.9917135
A06	58337176	58340377	A06p55720.2_BraZ1	1788.63	-	3441	3201	3201	1.0000000
A06	58339801	58340494	A06p55730.2_BraZ1	174	-	973	659	693	0.9509379
A06	58346730	58347169	A06p55740.2_BraZ1	363	-	817	439	439	1.0000000
A06	58349879	58350976	A06p55750.2_BraZ1	954	-	51	526	1097	0.4794895
A06	58352383	58354825	A06p55760.2_BraZ1	1372.8	-	1529	2388	2442	0.9778870
A06	58357428	58357677	A06p55770.2_BraZ1	24.9	-	21	139	249	0.5582329
A06	58359700	58363832	A06p55780.2_BraZ1	2569.83	-	2904	4100	4132	0.9922556
A06	58370803	58371211	A06p55790.2_BraZ1	40.8	-	37	278	408	0.6813725
A06	58373653	58378414	A06p55800.2_BraZ1	2525.71	-	2291	4476	4761	0.9401386
A06	58380955	58383690	A06p55810.2_BraZ1	263.25	-	2750	2735	2735	1.0000000
A06	58384761	58385853	A06p55820.2_BraZ1	109.2	-	784	1019	1092	0.9331502
A06	58392080	58394033	A06p55830.2_BraZ1	195.3	+	973	1939	1953	0.9928315
A06	58395043	58396968	A06p55840.2_BraZ1	841.067	+	513	1621	1925	0.8420779
A06	58400100	58400592	A06p55850.2_BraZ1	49.2	-	1617	492	492	1.0000000
A06	58405263	58407324	A06p55860.2_BraZ1	1608	+	132	1197	2061	0.5807860
A06	58408898	58410576	A06p55870.2_BraZ1	64989	-	86	923	1678	0.5500596
A06	58412830	58414500	A06p55880.2_BraZ1	29480	+	85	920	1670	0.5508982
A06	58416280	58421168	A06p55890.2_BraZ1	2977.76	+	2008	4818	4888	0.9856792
A06	58421854	58425089	A06p55900.2_BraZ1	1213.33	+	2574	3235	3235	1.0000000
A06	58425837	58431110	A06p55910.2_BraZ1	2359.92	-	2899	4682	5273	0.8879196
A06	58435496	58435793	A06p55920.2_BraZ1	29.7	+	71	258	297	0.8686869
A06	58437111	58437504	A06p55930.2_BraZ1	39.3	+	257	393	393	1.0000000
A06	58438740	58439192	A06p55940.2_BraZ1	324	+	6	38	452	0.0840708
A06	58440830	58441939	A06p55950.2_BraZ1	705	+	106	529	1109	0.4770063
A06	58444002	58444548	A06p55960.2_BraZ1	54.6	+	425	546	546	1.0000000
A06	58444935	58446913	A06p55970.2_BraZ1	1162.98	-	1485	1851	1978	0.9357938
A06	58448317	58448977	A06p55980.2_BraZ1	251.727	-	753	660	660	1.0000000
A06	58454255	58455388	A06p55990.2_BraZ1	762	-	654	1133	1133	1.0000000
A06	58456484	58460964	A06p56000.2_BraZ1	1829.99	+	4328	4243	4480	0.9470982
A06	58462930	58465106	A06p56010.2_BraZ1	2040	-	718	1984	2176	0.9117647
A06	58466152	58469382	A06p56020.2_BraZ1	1632.43	-	2274	3230	3230	1.0000000
A06	58471064	58473326	A06p56030.2_BraZ1	1250.96	-	1820	2244	2262	0.9920424
A06	58475250	58476898	A06p56040.2_BraZ1	952.5	-	1668	1648	1648	1.0000000
A06	58480493	58482583	A06p56050.2_BraZ1	1383	+	524	2086	2090	0.9980861
A06	58484339	58484474	A06p56060.2_BraZ1	13.5	+	138	135	135	1.0000000
A06	58485196	58487584	A06p56070.2_BraZ1	2034	+	805	1914	2388	0.8015075
A06	58489092	58491291	A06p56080.2_BraZ1	1109.33	+	1451	2041	2199	0.9281492
A06	58493328	58495843	A06p56090.2_BraZ1	1146.84	+	2856	2515	2515	1.0000000
A06	58496236	58497298	A06p56100.2_BraZ1	639	-	1234	1062	1062	1.0000000
A06	58500522	58502632	A06p56110.2_BraZ1	1710	+	2342	2110	2110	1.0000000
A06	58504012	58506719	A06p56120.2_BraZ1	517	-	2724	2707	2707	1.0000000
A06	58509494	58514386	A06p56130.2_BraZ1	1306.33	+	3301	4890	4892	0.9995912
A06	58515992	58519208	A06p56140.2_BraZ1	2360.83	+	1673	3012	3216	0.9365672
A06	58519900	58521571	A06p56150.2_BraZ1	1158.3	-	1279	1671	1671	1.0000000
A06	58523649	58524746	A06p56160.2_BraZ1	459.734	-	1074	1097	1097	1.0000000
A06	58536212	58538452	A06p56170.2_BraZ1	2166	-	1141	2161	2240	0.9647322
A06	58540181	58543536	A06p56180.2_BraZ1	2222.61	+	2146	3355	3355	1.0000000
A06	58544448	58544938	A06p56190.2_BraZ1	405	+	280	490	490	1.0000000
A06	58546645	58548129	A06p56200.2_BraZ1	558.25	-	2016	1484	1484	1.0000000
A06	58550108	58551279	A06p56210.2_BraZ1	1065	-	157	820	1171	0.7002562
A06	58555986	58557009	A06p56220.2_BraZ1	102.3	-	18	46	1023	0.0449658
A06	58559114	58560703	A06p56230.2_BraZ1	962.727	-	841	1539	1589	0.9685337
A06	58561852	58564520	A06p56240.2_BraZ1	1132.46	-	1035	2462	2668	0.9227886
A06	58566196	58570031	A06p56250.2_BraZ1	2402.88	-	2345	3693	3835	0.9629726
A06	58572706	58574000	A06p56260.2_BraZ1	828.952	-	1882	1294	1294	1.0000000
A06	58580704	58586850	A06p56270.2_BraZ1	2144.77	-	5184	6075	6146	0.9884478
A06	58588285	58591227	A06p56280.2_BraZ1	2404.06	-	862	2586	2942	0.8789939
A06	58592009	58594493	A06p56290.2_BraZ1	1137	-	1640	2484	2484	1.0000000
A06	58606414	58606726	A06p56300.2_BraZ1	31.2	-	166	312	312	1.0000000
A06	58606919	58607150	A06p56310.2_BraZ1	23.1	-	46	231	231	1.0000000
A06	58607821	58609877	A06p56320.2_BraZ1	990.852	+	782	1535	2056	0.7465953
A06	58609948	58610050	A06p56330.2_BraZ1	10.2	+	30	94	102	0.9215686
A06	58616879	58617638	A06p56340.2_BraZ1	75.9	-	55	387	759	0.5098814
A06	58618429	58626409	A06p56350.2_BraZ1	2180.1	-	1459	5951	7980	0.7457393
A06	58629804	58634026	A06p56360.2_BraZ1	74174.4	-	1020	3746	4222	0.8872572
A06	58635348	58636347	A06p56370.2_BraZ1	521.333	-	648	999	999	1.0000000
A06	58638840	58643057	A06p56380.2_BraZ1	126984	-	687	3750	4217	0.8892578
A06	58643603	58644809	A06p56390.2_BraZ1	120.6	+	1215	1206	1206	1.0000000
A06	58645304	58649772	A06p56400.2_BraZ1	3630	+	1877	4090	4468	0.9153984
A06	58650159	58652590	A06p56410.2_BraZ1	1007.22	+	1791	2431	2431	1.0000000
A06	58653569	58655126	A06p56420.2_BraZ1	155.7	+	615	1419	1557	0.9113680
A06	58658709	58660227	A06p56430.2_BraZ1	151.8	+	356	1292	1518	0.8511199
A06	58660665	58662219	A06p56440.2_BraZ1	155.4	+	436	1460	1554	0.9395109
A06	58665634	58667200	A06p56450.2_BraZ1	156.6	-	174	1024	1566	0.6538953
A06	58669380	58670167	A06p56460.2_BraZ1	92.1429	+	143	451	787	0.5730622
A06	58669801	58670330	A06p56470.2_BraZ1	228	+	5	237	529	0.4480151
A06	58671401	58672934	A06p56480.2_BraZ1	153.3	-	113	797	1533	0.5198956
A06	58675274	58676774	A06p56490.2_BraZ1	150	-	145	693	1500	0.4620000
A06	58678118	58679394	A06p56500.2_BraZ1	931.667	+	548	1110	1276	0.8699059
A06	58685010	58687518	A06p56510.2_BraZ1	709.435	+	1939	2504	2508	0.9984051
A06	58694581	58698166	A06p56520.2_BraZ1	358.5	-	1292	3409	3585	0.9509066
A06	58738207	58738495	A06p56530.2_BraZ1	28.8	-	200	288	288	1.0000000
A06	58739896	58746117	A06p56540.2_BraZ1	120	-	1799	3132	6221	0.5034561
A06	58744030	58744943	A06p56550.2_BraZ1	246	-	87	413	913	0.4523549
A06	58746117	58747809	A06p56560.2_BraZ1	366	+	1240	1692	1692	1.0000000
A06	58748108	58749520	A06p56570.2_BraZ1	1009.16	-	771	1320	1412	0.9348442
A06	58750568	58751225	A06p56580.2_BraZ1	260.3	-	633	657	657	1.0000000
A06	58752149	58752563	A06p56590.2_BraZ1	436	-	243	374	414	0.9033816
A06	58752903	58755767	A06p56600.2_BraZ1	2544.57	-	471	2335	2864	0.8152933
A06	58758084	58759942	A06p56610.2_BraZ1	1305	+	1510	1858	1858	1.0000000
A06	58759920	58761110	A06p56620.2_BraZ1	1068	+	1068	1190	1190	1.0000000
A06	58761473	58761862	A06p56630.2_BraZ1	294	-	558	389	389	1.0000000
A06	58762919	58766676	A06p56640.2_BraZ1	1541.71	-	2032	3650	3757	0.9715198
A06	58767433	58768217	A06p56650.2_BraZ1	343.753	-	785	784	784	1.0000000
A06	58770278	58771097	A06p56660.2_BraZ1	81.9	+	551	819	819	1.0000000
A06	58771898	58772958	A06p56670.2_BraZ1	432	+	704	1060	1060	1.0000000
A06	58773277	58776013	A06p56680.2_BraZ1	1322.36	-	2242	2736	2736	1.0000000
A06	58777805	58779275	A06p56690.2_BraZ1	893.25	+	569	1155	1470	0.7857143
A06	58780123	58782859	A06p56700.2_BraZ1	273.3	+	151	2224	2736	0.8128655
A06	58783637	58784167	A06p56710.2_BraZ1	195	+	598	530	530	1.0000000
A06	58787906	58794423	A06p56720.2_BraZ1	3326.87	-	784	4222	6517	0.6478441
A06	58797974	58799046	A06p56730.2_BraZ1	832.636	+	413	1072	1072	1.0000000
A06	58800739	58801515	A06p56740.2_BraZ1	2748	+	326	552	776	0.7113402
A06	58803354	58805084	A06p56750.2_BraZ1	1502.36	+	166	1453	1730	0.8398844
A06	58805354	58807060	A06p56760.2_BraZ1	948	-	782	1587	1706	0.9302462
A06	58810114	58810838	A06p56770.2_BraZ1	642	-	195	724	724	1.0000000
A06	58812495	58814694	A06p56780.2_BraZ1	1446.71	+	511	1792	2199	0.8149159
A06	58815602	58818216	A06p56790.2_BraZ1	1062.72	+	755	2379	2614	0.9100994
A06	58819015	58820943	A06p56800.2_BraZ1	371.23	+	450	1866	1928	0.9678423
A06	58821503	58822839	A06p56810.2_BraZ1	6519.38	-	987	1336	1336	1.0000000
A06	58825210	58826678	A06p56820.2_BraZ1	715.275	+	626	1468	1468	1.0000000
A06	58826733	58831348	A06p56830.2_BraZ1	1295.68	+	2270	4084	4615	0.8849404
A06	58831730	58832182	A06p56840.2_BraZ1	258	+	330	452	452	1.0000000
A06	58832441	58833602	A06p56850.2_BraZ1	116.1	-	725	1161	1161	1.0000000
A06	58834176	58835224	A06p56860.2_BraZ1	496.731	-	677	999	1048	0.9532443
A06	58836123	58836965	A06p56870.2_BraZ1	78.9	+	81	558	842	0.6627079
A06	58840441	58842103	A06p56880.2_BraZ1	1297.74	+	1688	1662	1662	1.0000000
A06	58844719	58845034	A06p56890.2_BraZ1	31.5	-	16	103	315	0.3269841
A06	58852996	58853299	A06p56900.2_BraZ1	30.3	-	396	303	303	1.0000000
A06	58854127	58854427	A06p56910.2_BraZ1	30	+	198	300	300	1.0000000
A06	58854607	58857305	A06p56920.2_BraZ1	2564.5	-	966	2678	2698	0.9925871
A06	58860145	58863159	A06p56930.2_BraZ1	945	+	719	2741	3014	0.9094227
A06	58865532	58875360	A06p56940.2_BraZ1	5540.69	+	1890	5837	9828	0.5939153
A06	58876319	58876838	A06p56950.2_BraZ1	51.9	+	289	519	519	1.0000000
A06	58877466	58879423	A06p56960.2_BraZ1	1109.61	+	1642	1957	1957	1.0000000
A06	58882029	58883036	A06p56970.2_BraZ1	885	-	53	745	1007	0.7398213
A06	58891142	58891479	A06p56980.2_BraZ1	324	-	323	337	337	1.0000000
A06	58892223	58896289	A06p56990.2_BraZ1	2367.2	-	808	3415	4066	0.8398918
A06	58897312	58898282	A06p57000.2_BraZ1	743.217	-	800	970	970	1.0000000
A06	58898837	58899604	A06p57010.2_BraZ1	396.455	+	711	767	767	1.0000000
A06	58899811	58901345	A06p57020.2_BraZ1	868.32	-	865	1534	1534	1.0000000
A06	58901687	58903865	A06p57030.2_BraZ1	1564.75	-	448	1864	2178	0.8558310
A06	58929083	58930582	A06p57040.2_BraZ1	1157.1	+	549	1499	1499	1.0000000
A06	58930829	58932883	A06p57050.2_BraZ1	1446.24	-	1216	2054	2054	1.0000000
A06	58933844	58938561	A06p57060.2_BraZ1	1555.56	-	2757	4481	4717	0.9499682
A06	58940719	58941681	A06p57070.2_BraZ1	79.5	+	234	888	962	0.9230769
A06	58941972	58944384	A06p57080.2_BraZ1	1424.39	-	815	2343	2412	0.9713930
A06	58948093	58949958	A06p57090.2_BraZ1	1216.05	-	665	1597	1865	0.8563003
A06	58951068	58953576	A06p57100.2_BraZ1	2475.86	-	1096	2379	2508	0.9485646
A06	58959590	58962041	A06p57110.2_BraZ1	1345.5	-	1046	1530	2451	0.6242350
A06	58962226	58963374	A06p57120.2_BraZ1	806.211	+	729	1148	1148	1.0000000
A06	58963571	58964900	A06p57130.2_BraZ1	132.9	-	419	1329	1329	1.0000000
A06	58965215	58971090	A06p57140.2_BraZ1	2061.57	+	1814	4823	5875	0.8209361
A06	58971520	58973176	A06p57150.2_BraZ1	1251.14	-	517	1308	1656	0.7898551
A06	58973785	58980799	A06p57160.2_BraZ1	3986.64	-	808	3078	7014	0.4388366
A06	58983700	58987220	A06p57170.2_BraZ1	3375.73	+	34	354	3520	0.1005682
A06	58988722	58989889	A06p57180.2_BraZ1	116.7	+	14	311	1167	0.2664953
A06	58991013	58993889	A06p57190.2_BraZ1	3583.8	+	231	1719	2876	0.5977051
A07	9992	12007	A07p00010.2_BraZ1	734.127	+	433	1529	2015	0.7588089
A07	12679	15641	A07p00020.2_BraZ1	939	+	616	2155	2962	0.7275490
A07	17976	18938	A07p00030.2_BraZ1	69.3	+	110	741	962	0.7702703
A07	19445	20141	A07p00040.2_BraZ1	452.455	-	404	696	696	1.0000000
A07	20564	22383	A07p00050.2_BraZ1	1309.37	-	292	1767	1819	0.9714128
A07	23056	23236	A07p00060.2_BraZ1	18	+	0	0	180	0.0000000
A07	23887	25820	A07p00070.2_BraZ1	4935	-	1301	1894	1933	0.9798241
A07	26048	28989	A07p00080.2_BraZ1	603	+	1764	2190	2941	0.7446447
A07	32304	33929	A07p00090.2_BraZ1	725.625	-	2402	1625	1625	1.0000000
A07	34693	36069	A07p00100.2_BraZ1	751.739	-	648	1376	1376	1.0000000
A07	38968	40121	A07p00110.2_BraZ1	660.357	-	457	1153	1153	1.0000000
A07	40456	41562	A07p00120.2_BraZ1	717.148	+	534	1106	1106	1.0000000
A07	49241	49370	A07p00130.2_BraZ1	12.9	+	148	129	129	1.0000000
A07	51329	52867	A07p00140.2_BraZ1	1458	+	99	703	1538	0.4570871
A07	53569	54334	A07p00150.2_BraZ1	76.5	-	1115	765	765	1.0000000
A07	55538	57180	A07p00160.2_BraZ1	1166	-	541	1642	1642	1.0000000
A07	60658	61113	A07p00170.2_BraZ1	1755	-	977	455	455	1.0000000
A07	73298	75843	A07p00180.2_BraZ1	2002	-	92	1204	2545	0.4730845
A07	80513	80997	A07p00190.2_BraZ1	390	+	3	19	484	0.0392562
A07	82667	84032	A07p00200.2_BraZ1	872.714	+	97	1057	1365	0.7743590
A07	88684	89103	A07p00210.2_BraZ1	243	+	669	419	419	1.0000000
A07	96238	98898	A07p00220.2_BraZ1	1584.38	+	579	2488	2660	0.9353383
A07	105280	106957	A07p00230.2_BraZ1	1566	+	1336	1677	1677	1.0000000
A07	111105	113026	A07p00240.2_BraZ1	1439.83	+	690	1874	1921	0.9755336
A07	118412	118785	A07p00250.2_BraZ1	273	-	296	373	373	1.0000000
A07	124968	125599	A07p00260.2_BraZ1	1759.5	-	781	587	631	0.9302694
A07	126160	132020	A07p00270.2_BraZ1	1646.34	-	1715	4668	5860	0.7965870
A07	138844	141217	A07p00280.2_BraZ1	1220.4	-	79	1510	2373	0.6363253
A07	149723	150149	A07p00290.2_BraZ1	222	+	152	426	426	1.0000000
A07	150889	152335	A07p00300.2_BraZ1	1302	+	290	1382	1446	0.9557400
A07	152984	153605	A07p00310.2_BraZ1	62.1	-	316	621	621	1.0000000
A07	158041	160850	A07p00320.2_BraZ1	1160.33	+	653	2251	2809	0.8013528
A07	162211	163629	A07p00330.2_BraZ1	766.8	-	565	1323	1418	0.9330043
A07	163827	165254	A07p00340.2_BraZ1	1329.9	+	784	1427	1427	1.0000000
A07	165604	166206	A07p00350.2_BraZ1	190.568	-	392	602	602	1.0000000
A07	166562	167309	A07p00360.2_BraZ1	195	+	456	710	747	0.9504685
A07	168042	176803	A07p00370.2_BraZ1	2320.11	+	2017	6644	8761	0.7583609
A07	178047	178950	A07p00380.2_BraZ1	618	+	234	775	903	0.8582503
A07	185881	189166	A07p00390.2_BraZ1	1186.88	-	18083	3285	3285	1.0000000
A07	189663	191293	A07p00400.2_BraZ1	1020.83	-	216	1480	1630	0.9079754
A07	196761	196863	A07p00410.2_BraZ1	10.2	-	55	102	102	1.0000000
A07	198713	199135	A07p00420.2_BraZ1	216	-	199	375	422	0.8886256
A07	199347	200794	A07p00430.2_BraZ1	658.667	+	1329	1418	1447	0.9799585
A07	201202	202960	A07p00440.2_BraZ1	175.8	-	85	931	1758	0.5295790
A07	210020	215867	A07p00450.2_BraZ1	1960.01	-	2893	5304	5847	0.9071319
A07	222792	237370	A07p00460.2_BraZ1	731.909	-	32167	10445	14578	0.7164906
A07	244215	246660	A07p00470.2_BraZ1	1861.57	+	622	2195	2445	0.8977505
A07	247864	252583	A07p00480.2_BraZ1	2940.06	-	882	2556	4719	0.5416402
A07	254843	256678	A07p00490.2_BraZ1	1344	+	540	1431	1835	0.7798365
A07	257640	292324	A07p00500.2_BraZ1	5334.32	+	16562	28886	34684	0.8328336
A07	279817	280172	A07p00510.2_BraZ1	249	+	246	355	355	1.0000000
A07	293553	295385	A07p00520.2_BraZ1	1028.78	+	466	1711	1832	0.9339520
A07	295843	296877	A07p00530.2_BraZ1	504	+	565	1034	1034	1.0000000
A07	297132	297312	A07p00540.2_BraZ1	18	-	290	180	180	1.0000000
A07	300235	306147	A07p00550.2_BraZ1	2889	+	232	663	5912	0.1121448
A07	316107	322784	A07p00560.2_BraZ1	4080	-	565	3485	6677	0.5219410
A07	352092	352437	A07p00570.2_BraZ1	249	+	8	216	345	0.6260870
A07	353178	356764	A07p00580.2_BraZ1	120	+	6681	3586	3586	1.0000000
A07	354477	355515	A07p00590.2_BraZ1	576	+	1804	1038	1038	1.0000000
A07	355093	356578	A07p00600.2_BraZ1	391.5	+	3978	1485	1485	1.0000000
A07	362433	364114	A07p00610.2_BraZ1	653.333	-	969	1476	1681	0.8780488
A07	373885	374998	A07p00620.2_BraZ1	111.3	+	99	1074	1113	0.9649596
A07	376198	377496	A07p00630.2_BraZ1	255	+	773	1298	1298	1.0000000
A07	377513	377639	A07p00640.2_BraZ1	12.6	+	201	126	126	1.0000000
A07	380773	381121	A07p00650.2_BraZ1	20.7	-	395	348	348	1.0000000
A07	384934	393974	A07p00660.2_BraZ1	1775.67	+	6198	8731	9040	0.9658186
A07	394378	395876	A07p00670.2_BraZ1	780	-	267	1244	1498	0.8304406
A07	397175	400414	A07p00680.2_BraZ1	1457.38	+	777	2864	3239	0.8842235
A07	402541	409254	A07p00690.2_BraZ1	4129.55	+	562	3342	6713	0.4978400
A07	422606	424787	A07p00700.2_BraZ1	1240.27	+	1138	2057	2181	0.9431453
A07	426787	427144	A07p00710.2_BraZ1	366	+	44	357	357	1.0000000
A07	427627	427762	A07p00720.2_BraZ1	13.5	+	27	135	135	1.0000000
A07	430001	430136	A07p00730.2_BraZ1	13.5	+	5	135	135	1.0000000
A07	433031	434573	A07p00740.2_BraZ1	727.067	+	700	1540	1542	0.9987030
A07	435208	437182	A07p00750.2_BraZ1	1468.17	-	867	1940	1974	0.9827761
A07	440424	443397	A07p00760.2_BraZ1	362.211	+	2233	2900	2973	0.9754457
A07	445644	447101	A07p00770.2_BraZ1	829.903	-	744	1328	1457	0.9114619
A07	484944	489295	A07p00780.2_BraZ1	3131.56	+	1101	3011	4351	0.6920248
A07	490225	491404	A07p00790.2_BraZ1	117.9	-	469	1128	1179	0.9567430
A07	493771	496391	A07p00800.2_BraZ1	1993.64	-	718	1837	2620	0.7011451
A07	512135	513354	A07p00810.2_BraZ1	96.6667	+	21	171	1219	0.1402789
A07	515964	519116	A07p00820.2_BraZ1	2501.62	+	429	1798	3152	0.5704315
A07	524315	524836	A07p00830.2_BraZ1	1674	-	113	489	521	0.9385797
A07	525372	525710	A07p00840.2_BraZ1	2520	-	21	173	338	0.5118343
A07	531399	535740	A07p00850.2_BraZ1	2163.74	+	1848	3431	4341	0.7903709
A07	537587	538766	A07p00860.2_BraZ1	117.9	+	516	1130	1179	0.9584394
A07	540384	540735	A07p00870.2_BraZ1	35.1	+	244	351	351	1.0000000
A07	545874	546534	A07p00880.2_BraZ1	66	+	47	476	660	0.7212121
A07	547271	547526	A07p00890.2_BraZ1	25.5	+	243	255	255	1.0000000
A07	548795	549332	A07p00900.2_BraZ1	53.7	+	314	526	537	0.9795159
A07	551430	552164	A07p00910.2_BraZ1	267	+	800	734	734	1.0000000
A07	554627	581676	A07p00920.2_BraZ1	579.9	+	12467	26093	27049	0.9646567
A07	566947	568383	A07p00930.2_BraZ1	2692.5	+	704	1436	1436	1.0000000
A07	581801	583704	A07p00940.2_BraZ1	114.3	-	1750	1903	1903	1.0000000
A07	593924	602300	A07p00950.2_BraZ1	2870.74	+	1748	6580	8376	0.7855778
A07	602804	605863	A07p00960.2_BraZ1	1492.68	-	605	2735	3059	0.8940830
A07	617523	618962	A07p00970.2_BraZ1	282	-	17	608	1439	0.4225156
A07	618787	619122	A07p00980.2_BraZ1	249	-	0	0	335	0.0000000
A07	620713	621295	A07p00990.2_BraZ1	276	+	28	17	582	0.0292096
A07	621690	623505	A07p01000.2_BraZ1	1266.3	-	445	1777	1815	0.9790633
A07	624646	626278	A07p01010.2_BraZ1	163.2	-	556	1425	1632	0.8731618
A07	627319	630303	A07p01020.2_BraZ1	1429.19	-	1521	2951	2984	0.9889410
A07	638928	639326	A07p01030.2_BraZ1	261	-	597	398	398	1.0000000
A07	647930	648853	A07p01040.2_BraZ1	32.7	+	1031	923	923	1.0000000
A07	649005	649845	A07p01050.2_BraZ1	765	+	997	840	840	1.0000000
A07	651330	652499	A07p01060.2_BraZ1	58.2	+	827	1169	1169	1.0000000
A07	657245	658329	A07p01070.2_BraZ1	438.75	+	301	977	1084	0.9012915
A07	667063	668137	A07p01080.2_BraZ1	107.4	-	143	954	1074	0.8882682
A07	706302	708637	A07p01090.2_BraZ1	799.889	+	180	1260	2335	0.5396146
A07	709611	710492	A07p01100.2_BraZ1	478.659	-	562	881	881	1.0000000
A07	718767	719947	A07p01110.2_BraZ1	417	+	45	584	1180	0.4949152
A07	724596	725285	A07p01120.2_BraZ1	396	+	439	689	689	1.0000000
A07	727543	732757	A07p01130.2_BraZ1	1080	+	1521	4014	5214	0.7698504
A07	728701	729918	A07p01140.2_BraZ1	8736	-	536	950	1217	0.7806081
A07	732115	732517	A07p01150.2_BraZ1	38.4	+	16	149	402	0.3706468
A07	733495	734453	A07p01160.2_BraZ1	318	-	462	958	958	1.0000000
A07	733708	735947	A07p01170.2_BraZ1	147	-	1198	2215	2239	0.9892809
A07	739512	740886	A07p01180.2_BraZ1	137.4	-	84	877	1374	0.6382824
A07	746065	746485	A07p01190.2_BraZ1	42	-	258	415	420	0.9880952
A07	748791	749661	A07p01200.2_BraZ1	630	-	27	479	870	0.5505747
A07	750295	751223	A07p01210.2_BraZ1	426.857	-	521	928	928	1.0000000
A07	751614	752560	A07p01220.2_BraZ1	390	+	866	946	946	1.0000000
A07	752979	756336	A07p01230.2_BraZ1	2484.64	-	1689	2961	3357	0.8820375
A07	759996	761311	A07p01240.2_BraZ1	405.053	-	742	1296	1315	0.9855514
A07	761590	763434	A07p01250.2_BraZ1	883.02	+	2302	1843	1844	0.9994577
A07	764848	765334	A07p01260.2_BraZ1	333	+	275	486	486	1.0000000
A07	765344	765599	A07p01270.2_BraZ1	25.5	+	253	255	255	1.0000000
A07	765997	796980	A07p01280.2_BraZ1	1688.14	-	7682	15121	30983	0.4880418
A07	800529	801698	A07p01290.2_BraZ1	4781.62	+	61	577	1169	0.4935842
A07	817408	821631	A07p01300.2_BraZ1	1445.37	-	51	1335	4223	0.3161260
A07	825168	826336	A07p01310.2_BraZ1	3982.12	+	90	580	1168	0.4965754
A07	827616	828233	A07p01320.2_BraZ1	316.75	+	204	617	617	1.0000000
A07	828419	830553	A07p01330.2_BraZ1	45	+	234	1361	2134	0.6377695
A07	830582	830690	A07p01340.2_BraZ1	10.8	+	0	0	108	0.0000000
A07	833658	834540	A07p01350.2_BraZ1	88.2	+	420	825	882	0.9353741
A07	850457	885525	A07p01360.2_BraZ1	712.031	-	14130	23716	35068	0.6762861
A07	886402	889459	A07p01370.2_BraZ1	1156.76	+	1969	2917	3057	0.9542035
A07	891164	893262	A07p01380.2_BraZ1	541.227	-	1625	2098	2098	1.0000000
A07	893556	894792	A07p01390.2_BraZ1	609	-	256	1118	1236	0.9045308
A07	897900	898008	A07p01400.2_BraZ1	10.8	+	4	25	108	0.2314815
A07	898036	900751	A07p01410.2_BraZ1	712.236	+	545	2637	2715	0.9712707
A07	902161	903005	A07p01420.2_BraZ1	300	+	205	353	844	0.4182464
A07	909187	910303	A07p01430.2_BraZ1	111.6	+	149	1003	1116	0.8987455
A07	911006	913972	A07p01440.2_BraZ1	1373.5	-	1062	2111	2966	0.7117330
A07	918718	923214	A07p01450.2_BraZ1	1483.5	+	1027	3111	4496	0.6919484
A07	924870	938009	A07p01460.2_BraZ1	1788.06	-	5516	12339	13139	0.9391125
A07	932853	933314	A07p01470.2_BraZ1	342	-	334	461	461	1.0000000
A07	942771	943227	A07p01480.2_BraZ1	45.6	-	232	456	456	1.0000000
A07	946801	949979	A07p01490.2_BraZ1	1529.09	-	962	2740	3178	0.8621775
A07	951669	954076	A07p01500.2_BraZ1	1068.14	-	1708	2406	2407	0.9995846
A07	964734	966552	A07p01510.2_BraZ1	1914.96	+	4538	1818	1818	1.0000000
A07	994037	994205	A07p01520.2_BraZ1	16.8	+	19	168	168	1.0000000
A07	994693	995516	A07p01530.2_BraZ1	350	+	972	823	823	1.0000000
A07	996628	1011835	A07p01540.2_BraZ1	3123.75	+	10266	13643	15207	0.8971526
A07	1014776	1015256	A07p01550.2_BraZ1	1965	-	0	0	480	0.0000000
A07	1015512	1016150	A07p01560.2_BraZ1	435	+	28	291	638	0.4561129
A07	1020695	1026886	A07p01570.2_BraZ1	2852.86	+	484	4130	6191	0.6670974
A07	1027492	1028876	A07p01580.2_BraZ1	684.943	-	497	1376	1384	0.9942197
A07	1029864	1031254	A07p01590.2_BraZ1	35.1	-	507	1304	1390	0.9381295
A07	1033029	1035696	A07p01600.2_BraZ1	1335.53	-	1728	2372	2667	0.8893888
A07	1037456	1039251	A07p01610.2_BraZ1	1155	-	33	263	1795	0.1465181
A07	1040503	1040734	A07p01620.2_BraZ1	23.1	+	19	231	231	1.0000000
A07	1041207	1041696	A07p01630.2_BraZ1	48.9	+	5	134	489	0.2740286
A07	1046059	1048077	A07p01640.2_BraZ1	918	+	199	1122	2018	0.5559961
A07	1048472	1048710	A07p01650.2_BraZ1	19.2	+	36	238	238	1.0000000
A07	1051416	1052973	A07p01660.2_BraZ1	1469.6	+	829	1085	1557	0.6968529
A07	1055351	1062019	A07p01670.2_BraZ1	2464.48	+	901	4012	6668	0.6016797
A07	1062267	1064358	A07p01680.2_BraZ1	209.1	-	875	1930	2091	0.9230034
A07	1067949	1068057	A07p01690.2_BraZ1	10.8	+	208	108	108	1.0000000
A07	1075456	1075842	A07p01700.2_BraZ1	297	+	474	386	386	1.0000000
A07	1076193	1076672	A07p01710.2_BraZ1	31.5	-	700	479	479	1.0000000
A07	1076663	1077264	A07p01720.2_BraZ1	32.7	-	888	601	601	1.0000000
A07	1078049	1078711	A07p01730.2_BraZ1	432	+	35	634	662	0.9577039
A07	1080625	1081258	A07p01740.2_BraZ1	348	+	480	633	633	1.0000000
A07	1082673	1082937	A07p01750.2_BraZ1	26.4	+	399	264	264	1.0000000
A07	1083636	1084008	A07p01760.2_BraZ1	37.2	+	276	372	372	1.0000000
A07	1086791	1087714	A07p01770.2_BraZ1	882	-	743	923	923	1.0000000
A07	1094911	1095013	A07p01780.2_BraZ1	10.2	+	159	102	102	1.0000000
A07	1095025	1098807	A07p01790.2_BraZ1	303.545	-	782	3334	3782	0.8815442
A07	1101571	1104013	A07p01800.2_BraZ1	5016	+	1525	2413	2442	0.9881245
A07	1104416	1106980	A07p01810.2_BraZ1	1721.43	-	2156	2450	2564	0.9555382
A07	1113449	1114301	A07p01820.2_BraZ1	711	+	868	849	852	0.9964789
A07	1117096	1118134	A07p01830.2_BraZ1	103.8	+	749	1016	1038	0.9788054
A07	1119748	1120783	A07p01840.2_BraZ1	324	+	1402	1035	1035	1.0000000
A07	1128861	1129848	A07p01850.2_BraZ1	474	-	533	987	987	1.0000000
A07	1132423	1133623	A07p01860.2_BraZ1	842.625	-	179	995	1200	0.8291667
A07	1153935	1157342	A07p01870.2_BraZ1	2190.04	+	1169	2683	3407	0.7874963
A07	1157601	1160869	A07p01880.2_BraZ1	966	-	1875	2861	3268	0.8754590
A07	1167682	1167844	A07p01890.2_BraZ1	16.2	+	58	162	162	1.0000000
A07	1168855	1169310	A07p01900.2_BraZ1	234	+	32	277	455	0.6087912
A07	1178460	1178832	A07p01910.2_BraZ1	37.2	+	210	372	372	1.0000000
A07	1184360	1194314	A07p01920.2_BraZ1	3270.63	-	4318	9396	9954	0.9439421
A07	1200590	1201046	A07p01930.2_BraZ1	117	+	309	456	456	1.0000000
A07	1201106	1201762	A07p01940.2_BraZ1	642.6	+	491	656	656	1.0000000
A07	1227310	1227510	A07p01950.2_BraZ1	15	-	513	200	200	1.0000000
A07	1229916	1232605	A07p01960.2_BraZ1	300	+	3492	2689	2689	1.0000000
A07	1237602	1240241	A07p01970.2_BraZ1	2421	+	443	2209	2639	0.8370595
A07	1240649	1242180	A07p01980.2_BraZ1	922.145	-	797	1474	1531	0.9627694
A07	1244597	1246761	A07p01990.2_BraZ1	918.75	-	538	1625	2164	0.7509242
A07	1248781	1249162	A07p02000.2_BraZ1	38.1	-	2	17	381	0.0446194
A07	1255560	1260983	A07p02010.2_BraZ1	2613.28	-	713	4246	5423	0.7829615
A07	1295374	1297716	A07p02020.2_BraZ1	1135.62	-	1051	2303	2342	0.9833476
A07	1303720	1304179	A07p02030.2_BraZ1	45.9	-	295	459	459	1.0000000
A07	1309028	1311355	A07p02040.2_BraZ1	1824	+	488	2108	2327	0.9058874
A07	1312892	1315879	A07p02050.2_BraZ1	1851	-	1684	2739	2987	0.9169735
A07	1317956	1320171	A07p02060.2_BraZ1	1854	+	742	1923	2215	0.8681716
A07	1323381	1329099	A07p02070.2_BraZ1	2036.3	+	4312	5444	5718	0.9520811
A07	1339190	1342582	A07p02080.2_BraZ1	1011.15	-	2157	3325	3392	0.9802476
A07	1347328	1347584	A07p02090.2_BraZ1	156	+	221	256	256	1.0000000
A07	1350658	1356827	A07p02100.2_BraZ1	795.222	-	2429	5426	6169	0.8795591
A07	1357509	1357730	A07p02110.2_BraZ1	171	+	6	165	221	0.7466063
A07	1364835	1366330	A07p02120.2_BraZ1	870	+	790	1231	1495	0.8234113
A07	1369161	1371733	A07p02130.2_BraZ1	1140.18	-	778	2123	2572	0.8254277
A07	1376034	1377083	A07p02140.2_BraZ1	591	+	628	1049	1049	1.0000000
A07	1378017	1380525	A07p02150.2_BraZ1	1574.22	-	1136	2138	2508	0.8524721
A07	1389264	1390552	A07p02160.2_BraZ1	953.804	-	690	1288	1288	1.0000000
A07	1392342	1393686	A07p02170.2_BraZ1	771	-	998	1344	1344	1.0000000
A07	1394587	1406076	A07p02180.2_BraZ1	1390.55	-	6459	10687	11489	0.9301941
A07	1413198	1415807	A07p02190.2_BraZ1	1555.2	+	1411	2418	2609	0.9267918
A07	1416385	1429031	A07p02200.2_BraZ1	861.3	-	2470	11782	12646	0.9316780
A07	1429813	1435814	A07p02210.2_BraZ1	270.375	-	6934	6001	6001	1.0000000
A07	1440121	1441081	A07p02220.2_BraZ1	699	+	138	144	960	0.1500000
A07	1445908	1446654	A07p02230.2_BraZ1	316.286	+	4	58	746	0.0777480
A07	1448895	1449246	A07p02240.2_BraZ1	35.1	+	186	305	351	0.8689459
A07	1467261	1467751	A07p02250.2_BraZ1	390	+	44	353	490	0.7204081
A07	1468595	1471095	A07p02260.2_BraZ1	826.203	-	309	1479	2500	0.5916000
A07	1478963	1480190	A07p02270.2_BraZ1	122.4	+	129	821	1227	0.6691117
A07	1481411	1481920	A07p02280.2_BraZ1	444	+	133	509	509	1.0000000
A07	1487685	1488543	A07p02290.2_BraZ1	317.864	-	1370	858	858	1.0000000
A07	1508756	1509935	A07p02300.2_BraZ1	117.9	-	142	944	1179	0.8006786
A07	1513907	1514174	A07p02310.2_BraZ1	180	+	468	267	267	1.0000000
A07	1515531	1515771	A07p02320.2_BraZ1	24	+	190	240	240	1.0000000
A07	1518770	1519416	A07p02330.2_BraZ1	198	+	302	646	646	1.0000000
A07	1519906	1520041	A07p02340.2_BraZ1	13.5	+	96	135	135	1.0000000
A07	1523355	1524435	A07p02350.2_BraZ1	108	-	32	228	1080	0.2111111
A07	1527641	1527815	A07p02360.2_BraZ1	17.4	+	313	174	174	1.0000000
A07	1541205	1541989	A07p02370.2_BraZ1	228	-	120	492	784	0.6275510
A07	1543298	1543967	A07p02380.2_BraZ1	66.9	-	121	233	669	0.3482810
A07	1546755	1549235	A07p02390.2_BraZ1	1482	-	195	859	2480	0.3463710
A07	1566880	1567054	A07p02400.2_BraZ1	17.4	-	24	157	174	0.9022989
A07	1577770	1579204	A07p02410.2_BraZ1	143.4	-	198	1183	1434	0.8249651
A07	1617134	1617626	A07p02420.2_BraZ1	372	+	94	492	492	1.0000000
A07	1624194	1625664	A07p02430.2_BraZ1	651.522	+	60	924	1470	0.6285715
A07	1638183	1638560	A07p02440.2_BraZ1	204	-	83	377	377	1.0000000
A07	1640877	1641745	A07p02450.2_BraZ1	222	-	584	868	868	1.0000000
A07	1646898	1648374	A07p02460.2_BraZ1	147.6	-	145	1133	1476	0.7676152
A07	1654636	1655740	A07p02470.2_BraZ1	1872	-	795	980	1104	0.8876812
A07	1655682	1656731	A07p02480.2_BraZ1	2266	-	800	1049	1049	1.0000000
A07	1659601	1660008	A07p02490.2_BraZ1	405	-	131	407	407	1.0000000
A07	1673459	1675981	A07p02500.2_BraZ1	656.036	+	1365	2519	2522	0.9988105
A07	1677887	1678841	A07p02510.2_BraZ1	95.4	-	513	925	954	0.9696017
A07	1688597	1688938	A07p02520.2_BraZ1	165	-	507	341	341	1.0000000
A07	1695522	1696506	A07p02530.2_BraZ1	245.25	+	274	984	984	1.0000000
A07	1696941	1697288	A07p02540.2_BraZ1	52.2	+	0	0	347	0.0000000
A07	1697391	1698644	A07p02550.2_BraZ1	319.8	+	0	0	1253	0.0000000
A07	1700901	1701822	A07p02560.2_BraZ1	92.1	-	98	593	921	0.6438653
A07	1709693	1712154	A07p02570.2_BraZ1	1685.62	+	96	871	2461	0.3539212
A07	1716246	1716562	A07p02580.2_BraZ1	294	-	116	316	316	1.0000000
A07	1719897	1720214	A07p02590.2_BraZ1	204	+	572	317	317	1.0000000
A07	1723294	1723675	A07p02600.2_BraZ1	279	-	188	381	381	1.0000000
A07	1723771	1723897	A07p02610.2_BraZ1	12.6	-	94	126	126	1.0000000
A07	1734202	1742649	A07p02620.2_BraZ1	1794.38	+	9673	8351	8447	0.9886350
A07	1745626	1746635	A07p02630.2_BraZ1	469.895	-	4	106	1009	0.1050545
A07	1749137	1749426	A07p02640.2_BraZ1	114	+	372	289	289	1.0000000
A07	1750143	1751585	A07p02650.2_BraZ1	233.625	+	1910	1442	1442	1.0000000
A07	1751937	1752135	A07p02660.2_BraZ1	19.8	+	218	198	198	1.0000000
A07	1753099	1754869	A07p02670.2_BraZ1	1066.7	-	645	1620	1770	0.9152542
A07	1755744	1756053	A07p02680.2_BraZ1	30.9	+	181	309	309	1.0000000
A07	1756390	1757486	A07p02690.2_BraZ1	570.13	-	511	1092	1096	0.9963503
A07	1761570	1761807	A07p02700.2_BraZ1	23.7	-	279	237	237	1.0000000
A07	1763223	1763352	A07p02710.2_BraZ1	12.9	-	277	129	129	1.0000000
A07	1766073	1767199	A07p02720.2_BraZ1	684	+	185	306	1126	0.2717584
A07	1767199	1768117	A07p02730.2_BraZ1	585	+	189	300	918	0.3267974
A07	1768044	1769268	A07p02740.2_BraZ1	122.4	+	132	535	1224	0.4370915
A07	1771257	1771887	A07p02750.2_BraZ1	63	+	12	104	630	0.1650794
A07	1778550	1779516	A07p02760.2_BraZ1	603	+	589	962	966	0.9958592
A07	1781896	1782686	A07p02770.2_BraZ1	54.6	+	563	790	790	1.0000000
A07	1782786	1784417	A07p02780.2_BraZ1	9620	-	71	691	1631	0.4236664
A07	1792910	1794741	A07p02790.2_BraZ1	282	+	252	1512	1831	0.8257782
A07	1821602	1822940	A07p02800.2_BraZ1	771.477	+	16	237	1338	0.1771300
A07	1828366	1828636	A07p02810.2_BraZ1	27	+	13	41	270	0.1518518
A07	1841860	1842172	A07p02820.2_BraZ1	31.2	+	212	312	312	1.0000000
A07	1843584	1844944	A07p02830.2_BraZ1	1137	-	392	1347	1360	0.9904412
A07	1850188	1850904	A07p02840.2_BraZ1	690	+	308	693	716	0.9678771
A07	1853296	1853693	A07p02850.2_BraZ1	165	-	621	397	397	1.0000000
A07	1855731	1855896	A07p02860.2_BraZ1	16.5	+	338	165	165	1.0000000
A07	1859629	1860487	A07p02870.2_BraZ1	471	+	836	858	858	1.0000000
A07	1864779	1865646	A07p02880.2_BraZ1	86.7	-	156	566	867	0.6528258
A07	1866291	1867553	A07p02890.2_BraZ1	502.68	-	988	1262	1262	1.0000000
A07	1869619	1869866	A07p02900.2_BraZ1	189	+	108	247	247	1.0000000
A07	1872307	1872649	A07p02910.2_BraZ1	249	-	430	342	342	1.0000000
A07	1875206	1876054	A07p02920.2_BraZ1	630	-	446	848	848	1.0000000
A07	1877447	1879086	A07p02930.2_BraZ1	581.468	+	877	1602	1639	0.9774253
A07	1880023	1883513	A07p02940.2_BraZ1	2021.25	-	2157	3465	3490	0.9928367
A07	1888454	1888730	A07p02950.2_BraZ1	27.6	-	313	249	276	0.9021739
A07	1890191	1890562	A07p02960.2_BraZ1	204	-	130	365	371	0.9838275
A07	1894463	1896327	A07p02970.2_BraZ1	643.388	+	341	1378	1864	0.7392704
A07	1896942	1899797	A07p02980.2_BraZ1	1389.91	-	354	2446	2855	0.8567426
A07	1919576	1920290	A07p02990.2_BraZ1	201	-	11	84	714	0.1176471
A07	1932581	1932707	A07p03000.2_BraZ1	12.6	+	0	0	126	0.0000000
A07	1932843	1933350	A07p03010.2_BraZ1	50.7	+	4	221	507	0.4358974
A07	1941986	1944087	A07p03020.2_BraZ1	2000	-	89	977	2101	0.4650167
A07	1945972	1946514	A07p03030.2_BraZ1	171	-	11	286	542	0.5276753
A07	1953485	1955044	A07p03040.2_BraZ1	792	+	480	1394	1559	0.8941630
A07	1955921	1958053	A07p03050.2_BraZ1	1269.6	+	673	1503	2132	0.7049718
A07	1970800	1976556	A07p03060.2_BraZ1	440.438	+	5612	5735	5756	0.9963517
A07	1980294	1981684	A07p03070.2_BraZ1	331.429	-	1095	1390	1390	1.0000000
A07	1991992	1994990	A07p03080.2_BraZ1	1113.15	+	695	2372	2998	0.7911941
A07	2002445	2002604	A07p03090.2_BraZ1	15.9	-	19	159	159	1.0000000
A07	2006377	2007658	A07p03100.2_BraZ1	666.157	-	489	640	1281	0.4996097
A07	2009773	2010583	A07p03110.2_BraZ1	360	-	743	810	810	1.0000000
A07	2019178	2019531	A07p03120.2_BraZ1	312	+	305	353	353	1.0000000
A07	2021210	2021572	A07p03130.2_BraZ1	330	-	38	358	362	0.9889503
A07	2023230	2024243	A07p03140.2_BraZ1	804	-	323	932	1013	0.9200395
A07	2026271	2026412	A07p03150.2_BraZ1	14.1	+	982	141	141	1.0000000
A07	2028597	2028714	A07p03160.2_BraZ1	11.7	+	73	117	117	1.0000000
A07	2038828	2039155	A07p03170.2_BraZ1	32.7	-	1	10	327	0.0305810
A07	2052261	2053381	A07p03180.2_BraZ1	621.6	-	636	1120	1120	1.0000000
A07	2054289	2055373	A07p03190.2_BraZ1	996	-	62	841	1084	0.7758303
A07	2059143	2059713	A07p03200.2_BraZ1	57	-	0	0	570	0.0000000
A07	2061382	2061979	A07p03210.2_BraZ1	59.7	-	0	0	597	0.0000000
A07	2062255	2062585	A07p03220.2_BraZ1	279	+	3	72	330	0.2181818
A07	2063743	2063881	A07p03230.2_BraZ1	13.8	+	0	0	138	0.0000000
A07	2067460	2067786	A07p03240.2_BraZ1	243	+	443	326	326	1.0000000
A07	2075156	2076493	A07p03250.2_BraZ1	638.69	+	615	1279	1337	0.9566193
A07	2076636	2077140	A07p03260.2_BraZ1	50.4	-	43	439	504	0.8710318
A07	2081356	2083835	A07p03270.2_BraZ1	492.8	+	216	1143	2479	0.4610730
A07	2084100	2085291	A07p03280.2_BraZ1	1116	-	3	55	1191	0.0461797
A07	2088172	2089891	A07p03290.2_BraZ1	1149.43	+	6	268	1719	0.1559046
A07	2090780	2090981	A07p03300.2_BraZ1	20.1	+	0	0	201	0.0000000
A07	2094964	2097037	A07p03310.2_BraZ1	1027.8	-	4	158	2073	0.0762180
A07	2099097	2100254	A07p03320.2_BraZ1	1074	+	8	19	1157	0.0164218
A07	2102195	2109850	A07p03330.2_BraZ1	1414.76	-	1764	5415	7655	0.7073808
A07	2103654	2105038	A07p03340.2_BraZ1	280.8	+	529	1367	1384	0.9877167
A07	2115000	2115907	A07p03350.2_BraZ1	753	+	33	81	907	0.0893054
A07	2117142	2118005	A07p03360.2_BraZ1	375.75	-	3	51	863	0.0590962
A07	2129832	2131109	A07p03370.2_BraZ1	708	+	512	967	1277	0.7572435
A07	2133721	2134216	A07p03380.2_BraZ1	408	-	59	85	495	0.1717172
A07	2134794	2135256	A07p03390.2_BraZ1	116	-	88	437	462	0.9458874
A07	2136034	2136751	A07p03400.2_BraZ1	71.7	-	0	0	717	0.0000000
A07	2140326	2140506	A07p03410.2_BraZ1	18	-	27	39	180	0.2166667
A07	2140650	2141050	A07p03420.2_BraZ1	856	+	100	233	400	0.5825000
A07	2150262	2150433	A07p03430.2_BraZ1	17.1	+	7	75	171	0.4385965
A07	2160584	2162776	A07p03440.2_BraZ1	796.8	-	96	755	2192	0.3444343
A07	2163369	2167122	A07p03450.2_BraZ1	1017.28	+	169	1740	3753	0.4636291
A07	2167122	2167687	A07p03460.2_BraZ1	420	-	48	367	565	0.6495575
A07	2167932	2170813	A07p03470.2_BraZ1	772.8	+	3194	2347	2881	0.8146477
A07	2173497	2173809	A07p03480.2_BraZ1	31.2	-	18	238	312	0.7628205
A07	2174500	2174662	A07p03490.2_BraZ1	16.2	-	102	162	162	1.0000000
A07	2178844	2179125	A07p03500.2_BraZ1	23.4	+	177	281	281	1.0000000
A07	2191667	2193705	A07p03510.2_BraZ1	592.348	-	462	1172	2038	0.5750736
A07	2196882	2199024	A07p03520.2_BraZ1	1206.4	+	310	1557	2142	0.7268907
A07	2220470	2221759	A07p03530.2_BraZ1	42267	-	189	1272	1289	0.9868115
A07	2236911	2237889	A07p03540.2_BraZ1	447	+	317	953	978	0.9744377
A07	2247517	2248151	A07p03550.2_BraZ1	675	-	561	634	634	1.0000000
A07	2254123	2255710	A07p03560.2_BraZ1	5757	+	475	1500	1587	0.9451796
A07	2271652	2272394	A07p03570.2_BraZ1	2821.5	-	12	393	742	0.5296496
A07	2274328	2274850	A07p03580.2_BraZ1	252.844	+	94	459	522	0.8793104
A07	2285293	2288536	A07p03590.2_BraZ1	1360.99	+	1701	3194	3243	0.9848905
A07	2289356	2292132	A07p03600.2_BraZ1	1725	+	741	2214	2776	0.7975504
A07	2299213	2300086	A07p03610.2_BraZ1	87.3	+	278	809	873	0.9266896
A07	2305188	2305988	A07p03620.2_BraZ1	696	+	378	747	800	0.9337500
A07	2313666	2314428	A07p03630.2_BraZ1	75	+	92	173	762	0.2270341
A07	2319654	2320746	A07p03640.2_BraZ1	864	-	27	233	1092	0.2133700
A07	2322610	2323480	A07p03650.2_BraZ1	67.5	+	1548	870	870	1.0000000
A07	2325395	2327566	A07p03660.2_BraZ1	1417.5	+	920	1893	2171	0.8719484
A07	2347240	2352933	A07p03670.2_BraZ1	3351.2	+	2849	5309	5693	0.9325488
A07	2355791	2361447	A07p03680.2_BraZ1	3245.19	+	387	3169	5656	0.5602900
A07	2365727	2367418	A07p03690.2_BraZ1	140.625	-	430	764	1691	0.4518037
A07	2376087	2377687	A07p03700.2_BraZ1	614.088	-	941	1600	1600	1.0000000
A07	2379949	2385430	A07p03710.2_BraZ1	2235.16	-	419	3125	5481	0.5701514
A07	2390408	2391812	A07p03720.2_BraZ1	692.143	-	201	1201	1404	0.8554131
A07	2397895	2398883	A07p03730.2_BraZ1	652.5	-	66	681	988	0.6892713
A07	2403011	2403702	A07p03740.2_BraZ1	35.7	+	396	691	691	1.0000000
A07	2410305	2411226	A07p03750.2_BraZ1	92.1	-	33	625	921	0.6786102
A07	2414805	2415351	A07p03760.2_BraZ1	333.5	+	1060	546	546	1.0000000
A07	2416938	2417152	A07p03770.2_BraZ1	135	+	280	214	214	1.0000000
A07	2418988	2424381	A07p03780.2_BraZ1	973.333	+	8968	5393	5393	1.0000000
A07	2425153	2425575	A07p03790.2_BraZ1	339	-	464	422	422	1.0000000
A07	2434143	2437166	A07p03800.2_BraZ1	1269.67	-	740	2300	3023	0.7608336
A07	2441778	2447167	A07p03810.2_BraZ1	1158.52	-	656	2790	5389	0.5177213
A07	2448083	2450545	A07p03820.2_BraZ1	178.273	-	458	2327	2462	0.9451665
A07	2458774	2459817	A07p03830.2_BraZ1	314.857	+	454	1043	1043	1.0000000
A07	2460624	2460807	A07p03840.2_BraZ1	18.3	+	119	183	183	1.0000000
A07	2469705	2470401	A07p03850.2_BraZ1	588	+	55	696	696	1.0000000
A07	2470857	2471154	A07p03860.2_BraZ1	243	-	4	232	297	0.7811448
A07	2474878	2475996	A07p03870.2_BraZ1	495	-	331	952	1118	0.8515206
A07	2484403	2495072	A07p03880.2_BraZ1	3000	-	3749	5038	10669	0.4722092
A07	2496165	2497332	A07p03890.2_BraZ1	720	-	117	738	1167	0.6323907
A07	2507455	2509058	A07p03900.2_BraZ1	557.053	-	714	1587	1603	0.9900187
A07	2510727	2512595	A07p03910.2_BraZ1	288.947	-	922	1868	1868	1.0000000
A07	2513861	2518035	A07p03920.2_BraZ1	423	+	957	1721	4174	0.4123143
A07	2521516	2524808	A07p03930.2_BraZ1	1422.18	+	2078	3229	3292	0.9808627
A07	2531366	2534380	A07p03940.2_BraZ1	1158	+	1756	2875	3014	0.9538819
A07	2539236	2540419	A07p03950.2_BraZ1	1101	+	312	1061	1183	0.8968723
A07	2542071	2543238	A07p03960.2_BraZ1	303	+	178	1072	1167	0.9185947
A07	2558786	2563891	A07p03970.2_BraZ1	1025.82	+	1685	2670	5105	0.5230166
A07	2564463	2564701	A07p03980.2_BraZ1	21	-	0	0	238	0.0000000
A07	2565382	2567235	A07p03990.2_BraZ1	1785	-	98	917	1853	0.4948732
A07	2572762	2573571	A07p04000.2_BraZ1	56.7	-	216	790	809	0.9765142
A07	2574139	2575424	A07p04010.2_BraZ1	423.196	+	1069	1285	1285	1.0000000
A07	2585274	2585566	A07p04020.2_BraZ1	27.9	+	239	292	292	1.0000000
A07	2590728	2593605	A07p04030.2_BraZ1	2150.93	+	1699	2636	2877	0.9162322
A07	2593662	2598136	A07p04040.2_BraZ1	784.636	+	2925	4145	4474	0.9264640
A07	2606971	2609309	A07p04050.2_BraZ1	12318.8	-	795	1908	2338	0.8160821
A07	2609516	2611400	A07p04060.2_BraZ1	188.4	-	1076	1870	1884	0.9925690
A07	2621496	2623647	A07p04070.2_BraZ1	1077.34	-	39	539	2151	0.2505811
A07	2644011	2647057	A07p04080.2_BraZ1	1621.97	+	465	2061	3046	0.6766251
A07	2647490	2647874	A07p04090.2_BraZ1	342	+	297	384	384	1.0000000
A07	2651910	2658023	A07p04100.2_BraZ1	1329.32	+	3051	5179	6113	0.8472109
A07	2672768	2673449	A07p04110.2_BraZ1	68.1	+	49	270	681	0.3964758
A07	2678236	2679349	A07p04120.2_BraZ1	408.857	+	643	793	1113	0.7124888
A07	2684244	2685669	A07p04130.2_BraZ1	532.636	+	304	878	1425	0.6161404
A07	2700731	2701172	A07p04140.2_BraZ1	44.1	+	0	0	441	0.0000000
A07	2706335	2710381	A07p04150.2_BraZ1	2016	-	1495	3234	4046	0.7993079
A07	2713365	2718457	A07p04160.2_BraZ1	5660	+	3786	4997	5092	0.9813433
A07	2722422	2724354	A07p04170.2_BraZ1	949.375	-	898	1836	1932	0.9503106
A07	2735779	2737370	A07p04180.2_BraZ1	561.6	-	332	1274	1591	0.8007542
A07	2739535	2740646	A07p04190.2_BraZ1	345.882	+	575	676	1111	0.6084608
A07	2742011	2743920	A07p04200.2_BraZ1	1600.8	-	379	1904	1909	0.9973809
A07	2748525	2748819	A07p04210.2_BraZ1	234	+	116	291	294	0.9897959
A07	2750720	2751286	A07p04220.2_BraZ1	474	-	212	521	566	0.9204947
A07	2751301	2751442	A07p04230.2_BraZ1	14.1	-	127	141	141	1.0000000
A07	2759663	2759852	A07p04240.2_BraZ1	18.9	+	196	189	189	1.0000000
A07	2760745	2761179	A07p04250.2_BraZ1	366	-	365	434	434	1.0000000
A07	2763070	2763521	A07p04260.2_BraZ1	43.2	+	154	451	451	1.0000000
A07	2768445	2769926	A07p04270.2_BraZ1	633.6	-	1165	1481	1481	1.0000000
A07	2770968	2772081	A07p04280.2_BraZ1	111.3	-	440	1113	1113	1.0000000
A07	2782113	2787945	A07p04290.2_BraZ1	252.648	-	1761	4664	5832	0.7997257
A07	2788147	2789469	A07p04300.2_BraZ1	379.545	-	96	375	1322	0.2836611
A07	2792725	2793404	A07p04310.2_BraZ1	144	+	65	585	679	0.8615611
A07	2801394	2802262	A07p04320.2_BraZ1	155.76	-	90	543	868	0.6255760
A07	2802464	2803524	A07p04330.2_BraZ1	495	-	4	21	1060	0.0198113
A07	2806780	2807467	A07p04340.2_BraZ1	144	+	18	332	687	0.4832605
A07	2816133	2817192	A07p04350.2_BraZ1	495	-	0	0	1059	0.0000000
A07	2819679	2823405	A07p04360.2_BraZ1	1177.77	-	621	2803	3726	0.7522812
A07	2824614	2827768	A07p04370.2_BraZ1	1558.11	-	1640	3019	3154	0.9571972
A07	2832229	2833170	A07p04380.2_BraZ1	453	-	1144	941	941	1.0000000
A07	2838406	2839483	A07p04390.2_BraZ1	107.7	+	44	351	1077	0.3259053
A07	2842118	2846546	A07p04400.2_BraZ1	765	+	2117	4081	4428	0.9216350
A07	2847782	2850276	A07p04410.2_BraZ1	423	-	2264	2494	2494	1.0000000
A07	2852941	2853485	A07p04420.2_BraZ1	408.75	+	695	544	544	1.0000000
A07	2884928	2885521	A07p04430.2_BraZ1	132.75	+	402	593	593	1.0000000
A07	2908611	2909772	A07p04440.2_BraZ1	480	+	378	1161	1161	1.0000000
A07	2915637	2917466	A07p04450.2_BraZ1	1186.03	+	129	1522	1829	0.8321487
A07	2918553	2920776	A07p04460.2_BraZ1	221.4	+	571	1285	2223	0.5780477
A07	2929880	2932023	A07p04470.2_BraZ1	481.25	+	0	0	2143	0.0000000
A07	2933555	2936418	A07p04480.2_BraZ1	1316.55	+	909	2684	2863	0.9374782
A07	2937548	2937723	A07p04490.2_BraZ1	108	+	68	164	175	0.9371428
A07	2937785	2938310	A07p04500.2_BraZ1	52.5	+	20	400	525	0.7619048
A07	2952368	2953056	A07p04510.2_BraZ1	282	+	230	688	688	1.0000000
A07	2969469	2972621	A07p04520.2_BraZ1	2505.41	+	724	2027	3152	0.6430838
A07	2973733	2976591	A07p04530.2_BraZ1	22802	-	537	1883	2858	0.6588523
A07	2978589	2980501	A07p04540.2_BraZ1	848.7	+	822	1784	1912	0.9330544
A07	2983607	2985174	A07p04550.2_BraZ1	15750	-	369	1515	1567	0.9668156
A07	2986869	2988334	A07p04560.2_BraZ1	1060.24	-	275	1106	1465	0.7549488
A07	3001596	3002388	A07p04570.2_BraZ1	79.2	-	200	587	792	0.7411616
A07	3005667	3006447	A07p04580.2_BraZ1	78	-	163	533	780	0.6833333
A07	3008378	3008882	A07p04590.2_BraZ1	240	-	396	504	504	1.0000000
A07	3020020	3021239	A07p04600.2_BraZ1	807.619	-	95	486	1219	0.3986875
A07	3034347	3034713	A07p04610.2_BraZ1	276	+	2	125	366	0.3415301
A07	3044022	3044461	A07p04620.2_BraZ1	39	-	264	439	439	1.0000000
A07	3050484	3053540	A07p04630.2_BraZ1	2507.14	+	387	2213	3056	0.7241492
A07	3056649	3059230	A07p04640.2_BraZ1	1174.2	-	314	1605	2581	0.6218520
A07	3061903	3062206	A07p04650.2_BraZ1	225	+	353	303	303	1.0000000
A07	3066704	3071445	A07p04660.2_BraZ1	1138.2	-	1362	4161	4741	0.8776630
A07	3080459	3086273	A07p04670.2_BraZ1	2434.26	-	515	4279	5814	0.7359821
A07	3089761	3092234	A07p04680.2_BraZ1	1394.72	+	678	2386	2473	0.9648200
A07	3095204	3099389	A07p04690.2_BraZ1	1856.71	-	170	796	4185	0.1902031
A07	3101577	3102170	A07p04700.2_BraZ1	507	-	83	540	593	0.9106240
A07	3105054	3114952	A07p04710.2_BraZ1	488.25	+	645	4863	9898	0.4913114
A07	3107510	3107662	A07p04720.2_BraZ1	123	+	1	20	152	0.1315790
A07	3107510	3109196	A07p04730.2_BraZ1	314.364	+	95	546	1686	0.3238434
A07	3120118	3120450	A07p04740.2_BraZ1	243	+	120	332	332	1.0000000
A07	3133303	3145098	A07p04750.2_BraZ1	4416	+	2834	9056	11795	0.7677830
A07	3145540	3147823	A07p04760.2_BraZ1	1651.08	-	822	2035	2283	0.8913710
A07	3158044	3163072	A07p04770.2_BraZ1	768.575	+	3770	4471	5028	0.8892204
A07	3165723	3172210	A07p04780.2_BraZ1	1410	-	4290	6414	6487	0.9887467
A07	3173458	3173883	A07p04790.2_BraZ1	396	+	301	425	425	1.0000000
A07	3182979	3184633	A07p04800.2_BraZ1	1551	+	249	1454	1654	0.8790810
A07	3186482	3187035	A07p04810.2_BraZ1	375	-	159	438	553	0.7920434
A07	3188036	3190262	A07p04820.2_BraZ1	222.6	+	1172	1804	2226	0.8104223
A07	3195745	3197300	A07p04830.2_BraZ1	871.125	+	843	1533	1555	0.9858521
A07	3204248	3206309	A07p04840.2_BraZ1	206.1	+	111	1157	2061	0.5613779
A07	3207487	3208438	A07p04850.2_BraZ1	165	-	292	932	951	0.9800211
A07	3211043	3213298	A07p04860.2_BraZ1	1187.17	+	358	1044	2255	0.4629712
A07	3214216	3217008	A07p04870.2_BraZ1	1739.76	-	160	1439	2792	0.5154011
A07	3221356	3221481	A07p04880.2_BraZ1	12.3	-	246	125	125	1.0000000
A07	3222082	3222205	A07p04890.2_BraZ1	12.3	-	284	123	123	1.0000000
A07	3231624	3232725	A07p04900.2_BraZ1	482.476	-	300	777	1101	0.7057221
A07	3233504	3234763	A07p04910.2_BraZ1	397.5	-	157	778	1259	0.6179507
A07	3241212	3241642	A07p04920.2_BraZ1	231	-	604	430	430	1.0000000
A07	3248682	3249274	A07p04930.2_BraZ1	510	+	360	592	592	1.0000000
A07	3255129	3258231	A07p04940.2_BraZ1	310.2	+	86	714	3102	0.2301741
A07	3259208	3259481	A07p04950.2_BraZ1	27.3	+	10	211	273	0.7728938
A07	3259884	3260993	A07p04960.2_BraZ1	277.2	+	273	371	1109	0.3345356
A07	3270493	3274578	A07p04970.2_BraZ1	2313.54	+	88	2030	4085	0.4969400
A07	3280201	3280880	A07p04980.2_BraZ1	184.333	-	0	0	679	0.0000000
A07	3282656	3284195	A07p04990.2_BraZ1	1114.67	-	110	666	1539	0.4327485
A07	3289007	3298583	A07p05000.2_BraZ1	256	-	5914	8866	9576	0.9258563
A07	3300589	3302103	A07p05010.2_BraZ1	699.6	+	410	1152	1514	0.7608983
A07	3311208	3311907	A07p05020.2_BraZ1	309	-	290	501	699	0.7167382
A07	3313398	3314090	A07p05030.2_BraZ1	62.4	-	261	692	692	1.0000000
A07	3314285	3314796	A07p05040.2_BraZ1	297	+	154	438	511	0.8571429
A07	3318376	3320736	A07p05050.2_BraZ1	1572.34	+	124	1355	2360	0.5741525
A07	3322767	3323940	A07p05060.2_BraZ1	932.88	-	8	355	1173	0.3026428
A07	3335523	3337450	A07p05070.2_BraZ1	705.988	-	122	1492	1927	0.7742605
A07	3338949	3340635	A07p05080.2_BraZ1	167.1	+	232	938	1686	0.5563464
A07	3344875	3346361	A07p05090.2_BraZ1	587.76	+	497	1461	1486	0.9831763
A07	3349004	3351716	A07p05100.2_BraZ1	1302.48	+	817	2090	2712	0.7706490
A07	3354303	3354553	A07p05110.2_BraZ1	261	+	198	250	250	1.0000000
A07	3360820	3362539	A07p05120.2_BraZ1	3476	+	306	1344	1719	0.7818499
A07	3364873	3365071	A07p05130.2_BraZ1	19.8	+	151	198	198	1.0000000
A07	3373967	3375442	A07p05140.2_BraZ1	1299	-	246	1101	1475	0.7464406
A07	3375894	3377615	A07p05150.2_BraZ1	327	+	2018	1721	1721	1.0000000
A07	3387841	3389377	A07p05160.2_BraZ1	152.4	-	186	749	1536	0.4876302
A07	3391493	3391769	A07p05170.2_BraZ1	27.6	-	29	256	276	0.9275362
A07	3401437	3401732	A07p05180.2_BraZ1	26.4	+	172	295	295	1.0000000
A07	3413384	3415784	A07p05190.2_BraZ1	2029.2	+	709	2278	2400	0.9491667
A07	3416581	3417274	A07p05200.2_BraZ1	495	-	104	621	693	0.8961039
A07	3423650	3427000	A07p05210.2_BraZ1	1233	+	235	2887	3350	0.8617911
A07	3429580	3432894	A07p05220.2_BraZ1	2763.48	+	668	2709	3314	0.8174412
A07	3441419	3442240	A07p05230.2_BraZ1	1448.4	+	40	620	821	0.7551766
A07	3442348	3443145	A07p05240.2_BraZ1	174	+	0	0	797	0.0000000
A07	3456670	3461351	A07p05250.2_BraZ1	2536.55	-	686	2591	4681	0.5535142
A07	3463798	3528693	A07p05260.2_BraZ1	755.556	-	34051	48140	64895	0.7418137
A07	3472614	3474314	A07p05270.2_BraZ1	6309.9	-	716	1679	1700	0.9876471
A07	3479193	3480891	A07p05280.2_BraZ1	20855.2	-	6	542	1698	0.3191991
A07	3486964	3488663	A07p05290.2_BraZ1	25728	-	0	0	1699	0.0000000
A07	3494732	3496431	A07p05300.2_BraZ1	26496	-	0	0	1699	0.0000000
A07	3508401	3510100	A07p05310.2_BraZ1	25728	-	161	1219	1699	0.7174809
A07	3531656	3531945	A07p05320.2_BraZ1	204	+	458	289	289	1.0000000
A07	3533948	3535645	A07p05330.2_BraZ1	16896	-	455	1577	1697	0.9292870
A07	3550806	3551485	A07p05340.2_BraZ1	555	+	150	679	679	1.0000000
A07	3553919	3554915	A07p05350.2_BraZ1	237	-	84	867	996	0.8704819
A07	3555110	3555664	A07p05360.2_BraZ1	389.4	-	141	554	554	1.0000000
A07	3556410	3564211	A07p05370.2_BraZ1	501	+	10627	7801	7801	1.0000000
A07	3568352	3570169	A07p05380.2_BraZ1	429	-	2658	1817	1817	1.0000000
A07	3574508	3576804	A07p05390.2_BraZ1	1390.23	+	1019	2152	2296	0.9372822
A07	3578596	3579879	A07p05400.2_BraZ1	864	+	732	1243	1283	0.9688231
A07	3580384	3581146	A07p05410.2_BraZ1	447.222	+	128	164	762	0.2152231
A07	3593533	3593696	A07p05420.2_BraZ1	12.3	+	982	163	163	1.0000000
A07	3600292	3601764	A07p05430.2_BraZ1	240	+	507	1472	1472	1.0000000
A07	3624746	3627622	A07p05440.2_BraZ1	729	-	636	2278	2876	0.7920723
A07	3640130	3641708	A07p05450.2_BraZ1	537	+	60	1243	1578	0.7877060
A07	3651338	3651665	A07p05460.2_BraZ1	32.7	-	293	327	327	1.0000000
A07	3651692	3652571	A07p05470.2_BraZ1	457.5	-	871	879	879	1.0000000
A07	3655010	3656495	A07p05480.2_BraZ1	148.5	+	52	568	1485	0.3824916
A07	3656730	3657520	A07p05490.2_BraZ1	513.714	-	168	707	790	0.8949367
A07	3667052	3667397	A07p05500.2_BraZ1	34.5	-	1876	345	345	1.0000000
A07	3675436	3675790	A07p05510.2_BraZ1	35.4	+	8	131	354	0.3700565
A07	3676602	3676975	A07p05520.2_BraZ1	261	-	8	218	373	0.5844504
A07	3677155	3690374	A07p05530.2_BraZ1	10124.9	-	451	3965	13219	0.2999471
A07	3693297	3704530	A07p05540.2_BraZ1	732	+	9816	11229	11233	0.9996439
A07	3695332	3695932	A07p05550.2_BraZ1	231	+	1041	600	600	1.0000000
A07	3704640	3704936	A07p05560.2_BraZ1	267	+	404	296	296	1.0000000
A07	3705308	3710114	A07p05570.2_BraZ1	2260.37	-	858	2675	4806	0.5565959
A07	3726643	3726838	A07p05580.2_BraZ1	19.5	+	157	195	195	1.0000000
A07	3737967	3740325	A07p05590.2_BraZ1	235.8	+	3385	2358	2358	1.0000000
A07	3741392	3741790	A07p05600.2_BraZ1	318	-	81	393	398	0.9874372
A07	3761808	3762810	A07p05610.2_BraZ1	100.2	-	120	961	1002	0.9590818
A07	3765393	3765694	A07p05620.2_BraZ1	135	+	977	301	301	1.0000000
A07	3767912	3771039	A07p05630.2_BraZ1	1298.57	+	961	2296	3127	0.7342501
A07	3775789	3776788	A07p05640.2_BraZ1	309	+	164	821	999	0.8218218
A07	3780769	3784078	A07p05650.2_BraZ1	3644.38	-	475	1660	3309	0.5016621
A07	3792013	3792208	A07p05660.2_BraZ1	19.5	-	21	132	195	0.6769231
A07	3796881	3797593	A07p05670.2_BraZ1	294	-	591	712	712	1.0000000
A07	3800316	3802795	A07p05680.2_BraZ1	2349	+	717	2237	2479	0.9023800
A07	3807148	3808845	A07p05690.2_BraZ1	1617	+	705	1359	1697	0.8008250
A07	3816895	3817695	A07p05700.2_BraZ1	705	-	99	787	800	0.9837500
A07	3825067	3825379	A07p05710.2_BraZ1	31.2	-	473	312	312	1.0000000
A07	3826250	3826550	A07p05720.2_BraZ1	30	+	0	0	300	0.0000000
A07	3826550	3829987	A07p05730.2_BraZ1	181.8	+	0	0	3437	0.0000000
A07	3832072	3832345	A07p05740.2_BraZ1	27.3	+	0	0	273	0.0000000
A07	3833164	3833892	A07p05750.2_BraZ1	655.2	+	0	0	728	0.0000000
A07	3833876	3837675	A07p05760.2_BraZ1	11256.5	+	4	447	3799	0.1176625
A07	3838000	3838995	A07p05770.2_BraZ1	13.5	-	2	263	995	0.2643216
A07	3838995	3839219	A07p05780.2_BraZ1	132	-	1	128	224	0.5714286
A07	3844156	3846135	A07p05790.2_BraZ1	930.857	+	817	1774	1979	0.8964123
A07	3865479	3865593	A07p05800.2_BraZ1	11.4	+	56	114	114	1.0000000
A07	3869917	3873883	A07p05810.2_BraZ1	2339.77	+	1240	3922	3966	0.9889057
A07	3878642	3879798	A07p05820.2_BraZ1	828	+	925	1156	1156	1.0000000
A07	3880851	3881793	A07p05830.2_BraZ1	846	+	385	942	942	1.0000000
A07	3899734	3900784	A07p05840.2_BraZ1	105	+	271	1050	1050	1.0000000
A07	3903189	3903768	A07p05850.2_BraZ1	57.9	-	19	293	579	0.5060449
A07	3909707	3910352	A07p05860.2_BraZ1	64.5	-	228	530	645	0.8217054
A07	3917603	3919683	A07p05870.2_BraZ1	976.5	-	440	1809	2080	0.8697115
A07	3924399	3926331	A07p05880.2_BraZ1	1203.5	+	587	1663	1932	0.8607661
A07	3928225	3935846	A07p05890.2_BraZ1	1322.5	+	3770	6619	7621	0.8685212
A07	3944339	3945845	A07p05900.2_BraZ1	1377	-	308	664	1506	0.4409031
A07	3949738	3949888	A07p05910.2_BraZ1	15	+	107	150	150	1.0000000
A07	3950477	3952379	A07p05920.2_BraZ1	190.2	-	166	1414	1902	0.7434280
A07	3972308	3974307	A07p05930.2_BraZ1	1720.83	-	167	1579	1999	0.7898949
A07	3976407	3976530	A07p05940.2_BraZ1	12.3	-	94	123	123	1.0000000
A07	3998111	3998937	A07p05950.2_BraZ1	717	+	1494	826	826	1.0000000
A07	4001236	4001380	A07p05960.2_BraZ1	14.4	+	0	0	144	0.0000000
A07	4008847	4009470	A07p05970.2_BraZ1	378	-	496	425	623	0.6821830
A07	4012063	4013045	A07p05980.2_BraZ1	499.8	-	26	247	982	0.2515275
A07	4015332	4015613	A07p05990.2_BraZ1	24.6	+	424	281	281	1.0000000
A07	4034969	4036270	A07p06000.2_BraZ1	582	+	753	1190	1301	0.9146810
A07	4053900	4057719	A07p06010.2_BraZ1	297	+	2946	3819	3819	1.0000000
A07	4058970	4061390	A07p06020.2_BraZ1	1671	+	1439	2370	2420	0.9793388
A07	4062183	4065532	A07p06030.2_BraZ1	1067.54	-	1335	2123	3349	0.6339206
A07	4079127	4082452	A07p06040.2_BraZ1	1827.24	-	928	2764	3325	0.8312782
A07	4103268	4104882	A07p06050.2_BraZ1	1455	-	20	649	1614	0.4021066
A07	4107139	4107934	A07p06060.2_BraZ1	357	+	162	470	795	0.5911950
A07	4112029	4113987	A07p06070.2_BraZ1	1314	-	1938	1845	1958	0.9422880
A07	4115349	4116631	A07p06080.2_BraZ1	925.714	-	201	1059	1282	0.8260530
A07	4127183	4128885	A07p06090.2_BraZ1	20175	+	57	761	1702	0.4471210
A07	4135969	4137284	A07p06100.2_BraZ1	936	-	402	1015	1315	0.7718631
A07	4137788	4138064	A07p06110.2_BraZ1	27.6	-	47	174	276	0.6304348
A07	4154115	4155301	A07p06120.2_BraZ1	506.423	-	103	696	1186	0.5868465
A07	4158966	4159323	A07p06130.2_BraZ1	35.7	-	11	241	357	0.6750700
A07	4160805	4161958	A07p06140.2_BraZ1	794.231	+	113	1017	1153	0.8820468
A07	4190275	4191177	A07p06150.2_BraZ1	817	+	393	765	902	0.8481153
A07	4199608	4201122	A07p06160.2_BraZ1	484.704	-	726	1426	1514	0.9418758
A07	4208740	4209787	A07p06170.2_BraZ1	6762	-	514	868	1047	0.8290353
A07	4225523	4225863	A07p06180.2_BraZ1	249	-	83	302	340	0.8882353
A07	4262612	4262951	A07p06190.2_BraZ1	213	-	4498	339	339	1.0000000
A07	4276839	4278852	A07p06200.2_BraZ1	710.342	+	299	1767	2013	0.8777943
A07	4279556	4280260	A07p06210.2_BraZ1	1293.75	+	11	451	704	0.6406250
A07	4280454	4280869	A07p06220.2_BraZ1	273	+	17	189	415	0.4554217
A07	4284174	4284405	A07p06230.2_BraZ1	23.1	+	0	0	231	0.0000000
A07	4288120	4290078	A07p06240.2_BraZ1	1089.77	-	495	1529	1958	0.7808989
A07	4297969	4299403	A07p06250.2_BraZ1	143.4	-	0	0	1434	0.0000000
A07	4300423	4300720	A07p06260.2_BraZ1	29.7	-	23	124	297	0.4175084
A07	4314229	4317911	A07p06270.2_BraZ1	1665	-	5417	3463	3682	0.9405215
A07	4320970	4322228	A07p06280.2_BraZ1	798.6	+	21	413	1258	0.3282989
A07	4323196	4323394	A07p06290.2_BraZ1	18.3	+	142	198	198	1.0000000
A07	4323681	4324651	A07p06300.2_BraZ1	626.182	-	604	970	970	1.0000000
A07	4371866	4372046	A07p06310.2_BraZ1	18	-	10	180	180	1.0000000
A07	4375931	4376132	A07p06320.2_BraZ1	20.1	-	53	201	201	1.0000000
A07	4388789	4390233	A07p06330.2_BraZ1	336	+	1110	1444	1444	1.0000000
A07	4395289	4398743	A07p06340.2_BraZ1	766.071	-	697	2622	3454	0.7591199
A07	4401114	4426759	A07p06350.2_BraZ1	447	-	13147	20646	25645	0.8050692
A07	4435830	4438251	A07p06360.2_BraZ1	242.1	+	167	1746	2421	0.7211896
A07	4439174	4447241	A07p06370.2_BraZ1	966.15	-	2474	6003	8067	0.7441428
A07	4492257	4494483	A07p06380.2_BraZ1	222.6	+	87	893	2226	0.4011680
A07	4502784	4503960	A07p06390.2_BraZ1	1143	+	1048	1003	1176	0.8528911
A07	4503960	4507877	A07p06400.2_BraZ1	4517.14	+	463	3214	3917	0.8205259
A07	4508585	4509294	A07p06410.2_BraZ1	69.6	-	24	363	709	0.5119887
A07	4510151	4511356	A07p06420.2_BraZ1	742.5	-	250	977	1205	0.8107884
A07	4510646	4516723	A07p06430.2_BraZ1	11485.5	-	3159	5223	6077	0.8594701
A07	4511331	4511794	A07p06440.2_BraZ1	327	-	145	415	463	0.8963283
A07	4536778	4537024	A07p06450.2_BraZ1	24.6	+	215	246	246	1.0000000
A07	4545663	4545851	A07p06460.2_BraZ1	10.8	-	23	188	188	1.0000000
A07	4546881	4547165	A07p06470.2_BraZ1	26.4	-	157	284	284	1.0000000
A07	4548419	4553677	A07p06480.2_BraZ1	2112.12	-	2110	4042	5258	0.7687334
A07	4633798	4634743	A07p06490.2_BraZ1	405	-	7	559	945	0.5915344
A07	4650204	4651510	A07p06500.2_BraZ1	312	+	367	1306	1306	1.0000000
A07	4673395	4673515	A07p06510.2_BraZ1	12	-	65	120	120	1.0000000
A07	4673551	4674428	A07p06520.2_BraZ1	1058.4	-	533	846	877	0.9646522
A07	4683720	4683954	A07p06530.2_BraZ1	23.4	+	66	234	234	1.0000000
A07	4696565	4697112	A07p06540.2_BraZ1	29.1	+	1832	547	547	1.0000000
A07	4699692	4700379	A07p06550.2_BraZ1	151.5	+	0	0	687	0.0000000
A07	4701448	4701697	A07p06560.2_BraZ1	159	-	0	0	249	0.0000000
A07	4715611	4716298	A07p06570.2_BraZ1	321	+	2	165	687	0.2401747
A07	4717367	4717616	A07p06580.2_BraZ1	159	-	2	139	249	0.5582329
A07	4732930	4733617	A07p06590.2_BraZ1	227.25	+	47	297	687	0.4323144
A07	4756054	4756489	A07p06600.2_BraZ1	35.1	-	377	435	435	1.0000000
A07	4760239	4764130	A07p06610.2_BraZ1	720	-	2679	3891	3891	1.0000000
A07	4762425	4762875	A07p06620.2_BraZ1	351	-	358	450	450	1.0000000
A07	4879305	4879743	A07p06630.2_BraZ1	43.8	-	725	438	438	1.0000000
A07	4881368	4881548	A07p06640.2_BraZ1	18	-	396	180	180	1.0000000
A07	4931412	4932097	A07p06650.2_BraZ1	54.9	-	225	306	685	0.4467153
A07	4934190	4934385	A07p06660.2_BraZ1	19.5	-	42	163	195	0.8358974
A07	4935258	4944433	A07p06670.2_BraZ1	759.052	+	24159	9175	9175	1.0000000
A07	4944694	4945475	A07p06680.2_BraZ1	61.8	-	1305	781	781	1.0000000
A07	4950516	4951140	A07p06690.2_BraZ1	62.4	-	6	34	624	0.0544872
A07	4953186	4954017	A07p06700.2_BraZ1	756	-	282	601	831	0.7232251
A07	4954160	4956077	A07p06710.2_BraZ1	191.7	-	158	324	1917	0.1690141
A07	4958069	4958409	A07p06720.2_BraZ1	174	+	366	340	340	1.0000000
A07	4995476	4998058	A07p06730.2_BraZ1	1379.43	+	966	1800	2582	0.6971340
A07	4998293	5003309	A07p06740.2_BraZ1	1883.33	-	413	2800	5016	0.5582137
A07	5007978	5018667	A07p06750.2_BraZ1	660	+	3644	10657	10689	0.9970063
A07	5018767	5019101	A07p06760.2_BraZ1	146.25	+	11	149	334	0.4461078
A07	5024483	5025069	A07p06770.2_BraZ1	25.2	-	189	586	586	1.0000000
A07	5035746	5036511	A07p06780.2_BraZ1	651	+	33	433	765	0.5660131
A07	5068266	5086524	A07p06790.2_BraZ1	255.556	+	5155	14422	18258	0.7899003
A07	5087593	5087842	A07p06800.2_BraZ1	159	-	1	128	249	0.5140562
A07	5129804	5130501	A07p06810.2_BraZ1	46.2	-	29	246	697	0.3529412
A07	5133286	5137204	A07p06820.2_BraZ1	396.917	+	345	2803	3918	0.7154160
A07	5139340	5140538	A07p06830.2_BraZ1	2400	-	44	764	1198	0.6377295
A07	5145474	5145768	A07p06840.2_BraZ1	29.4	-	20	124	294	0.4217687
A07	5154118	5155457	A07p06850.2_BraZ1	790.348	-	166	909	1339	0.6788648
A07	5155543	5159841	A07p06860.2_BraZ1	702.075	+	2741	3870	4298	0.9004188
A07	5174961	5184936	A07p06870.2_BraZ1	640.522	-	3722	8925	9975	0.8947368
A07	5256814	5260151	A07p06880.2_BraZ1	1048.04	-	532	2233	3337	0.6691639
A07	5300293	5301505	A07p06890.2_BraZ1	121.2	+	900	1212	1212	1.0000000
A07	5301817	5302762	A07p06900.2_BraZ1	94.5	+	639	945	945	1.0000000
A07	5304282	5304935	A07p06910.2_BraZ1	33.9	+	75	407	653	0.6232772
A07	5304956	5305169	A07p06920.2_BraZ1	21.3	+	58	213	213	1.0000000
A07	5345220	5353458	A07p06930.2_BraZ1	333	+	910	6692	8238	0.8123331
A07	5353848	5354095	A07p06940.2_BraZ1	19.2	-	142	247	247	1.0000000
A07	5354958	5357546	A07p06950.2_BraZ1	5622.86	-	87	974	2588	0.3763524
A07	5365347	5367580	A07p06960.2_BraZ1	408	+	1629	2233	2233	1.0000000
A07	5368462	5370196	A07p06970.2_BraZ1	186	-	979	1734	1734	1.0000000
A07	5437758	5437944	A07p06980.2_BraZ1	18.6	+	188	186	186	1.0000000
A07	5438233	5438344	A07p06990.2_BraZ1	11.1	+	25	111	111	1.0000000
A07	5440383	5441893	A07p07000.2_BraZ1	49.8	-	2393	1510	1510	1.0000000
A07	5441958	5442246	A07p07010.2_BraZ1	28.8	-	252	288	288	1.0000000
A07	5466657	5467125	A07p07020.2_BraZ1	46.8	+	425	468	468	1.0000000
A07	5467446	5468226	A07p07030.2_BraZ1	63	+	943	780	780	1.0000000
A07	5471626	5471851	A07p07040.2_BraZ1	22.5	-	2408	225	225	1.0000000
A07	5472852	5484066	A07p07050.2_BraZ1	2241	-	8146	7547	11214	0.6729980
A07	5484504	5485089	A07p07060.2_BraZ1	58.5	-	11	102	585	0.1743590
A07	5490207	5490741	A07p07070.2_BraZ1	53.4	+	592	534	534	1.0000000
A07	5492587	5501601	A07p07080.2_BraZ1	1308.36	+	5751	8995	9014	0.9978921
A07	5502096	5502685	A07p07090.2_BraZ1	40.2	-	119	589	589	1.0000000
A07	5503640	5503961	A07p07100.2_BraZ1	32.1	+	288	321	321	1.0000000
A07	5505270	5505601	A07p07110.2_BraZ1	28.8	+	226	302	331	0.9123867
A07	5677700	5679114	A07p07120.2_BraZ1	593.697	+	76	1077	1414	0.7616690
A07	5680886	5681359	A07p07130.2_BraZ1	126	+	210	473	473	1.0000000
A07	5683858	5684086	A07p07140.2_BraZ1	22.8	-	1214	228	228	1.0000000
A07	5854731	5854955	A07p07150.2_BraZ1	210	-	602	224	224	1.0000000
A07	5878283	5878460	A07p07160.2_BraZ1	17.7	+	16	177	177	1.0000000
A07	5947678	5989761	A07p07170.2_BraZ1	585	-	24509	39221	42083	0.9319915
A07	5994890	5995167	A07p07180.2_BraZ1	21.3	-	212	277	277	1.0000000
A07	6025362	6026835	A07p07190.2_BraZ1	857.25	+	49	431	1473	0.2926001
A07	6086849	6088774	A07p07200.2_BraZ1	1245	+	253	1861	1925	0.9667532
A07	6090143	6090669	A07p07210.2_BraZ1	474	+	141	485	526	0.9220532
A07	6091347	6093826	A07p07220.2_BraZ1	1648	+	245	1633	2479	0.6587334
A07	6095131	6095824	A07p07230.2_BraZ1	57.6	-	1012	693	693	1.0000000
A07	6098189	6098990	A07p07240.2_BraZ1	450	-	23	301	801	0.3757803
A07	6212815	6213016	A07p07250.2_BraZ1	20.1	-	32	201	201	1.0000000
A07	6249245	6249593	A07p07260.2_BraZ1	34.8	+	0	0	348	0.0000000
A07	6251418	6252322	A07p07270.2_BraZ1	552.5	-	1099	904	904	1.0000000
A07	6258854	6259155	A07p07280.2_BraZ1	252	-	3845	301	301	1.0000000
A07	6262179	6262641	A07p07290.2_BraZ1	393	-	221	462	462	1.0000000
A07	6282634	6282867	A07p07300.2_BraZ1	18.6	-	464	233	233	1.0000000
A07	6283878	6284283	A07p07310.2_BraZ1	183	-	402	405	405	1.0000000
A07	6285489	6286863	A07p07320.2_BraZ1	35.7	+	699	1224	1374	0.8908297
A07	6752110	6754212	A07p07330.2_BraZ1	1941	+	149	1000	2102	0.4757374
A07	6835939	6836149	A07p07340.2_BraZ1	21	+	5	190	210	0.9047619
A07	6837013	6838009	A07p07350.2_BraZ1	592.8	-	69	806	996	0.8092369
A07	6839249	6839390	A07p07360.2_BraZ1	14.1	+	120	141	141	1.0000000
A07	6839525	6840142	A07p07370.2_BraZ1	264	+	674	617	617	1.0000000
A07	6845383	6845740	A07p07380.2_BraZ1	35.7	+	2	67	357	0.1876751
A07	6845981	6847993	A07p07390.2_BraZ1	28260	-	77	921	2012	0.4577535
A07	6862425	6863488	A07p07400.2_BraZ1	1957.5	-	84	648	1063	0.6095955
A07	6872097	6872595	A07p07410.2_BraZ1	408	-	4	132	498	0.2650602
A07	6882119	6884917	A07p07420.2_BraZ1	1682.21	+	308	1806	2798	0.6454610
A07	6885414	6886985	A07p07430.2_BraZ1	712.5	-	80	948	1571	0.6034373
A07	6897220	6901271	A07p07440.2_BraZ1	1479.9	-	745	3503	4051	0.8647248
A07	6902156	6903755	A07p07450.2_BraZ1	159.9	+	61	648	1599	0.4052533
A07	6908584	6910129	A07p07460.2_BraZ1	1184.4	-	839	1444	1545	0.9346278
A07	6925445	6927508	A07p07470.2_BraZ1	668.114	-	437	1187	2063	0.5753757
A07	6946518	6947897	A07p07480.2_BraZ1	641.073	-	71	969	1379	0.7026831
A07	6966767	6967062	A07p07490.2_BraZ1	18	-	721	295	295	1.0000000
A07	7033150	7034792	A07p07500.2_BraZ1	1334.17	+	14	308	1642	0.1875761
A07	7061688	7064148	A07p07510.2_BraZ1	2298	+	117	1667	2460	0.6776423
A07	7066489	7068309	A07p07520.2_BraZ1	1316.57	+	1118	1395	1820	0.7664835
A07	7068745	7070947	A07p07530.2_BraZ1	667.146	-	420	1590	2202	0.7220709
A07	7069516	7070092	A07p07540.2_BraZ1	264	-	4	74	576	0.1284722
A07	7075771	7077792	A07p07550.2_BraZ1	1037.85	-	647	1428	2021	0.7065809
A07	7079149	7079735	A07p07560.2_BraZ1	207	+	486	586	586	1.0000000
A07	7088577	7089127	A07p07570.2_BraZ1	270	-	134	550	550	1.0000000
A07	7105627	7106634	A07p07580.2_BraZ1	366	-	1236	1007	1007	1.0000000
A07	7111391	7113427	A07p07590.2_BraZ1	1398.62	-	99	917	2036	0.4503929
A07	7113514	7113634	A07p07600.2_BraZ1	12	+	48	120	120	1.0000000
A07	7120386	7134834	A07p07610.2_BraZ1	1837	-	11185	14020	14448	0.9703766
A07	7148159	7149841	A07p07620.2_BraZ1	3166.67	-	1539	1682	1682	1.0000000
A07	7180575	7181428	A07p07630.2_BraZ1	371.2	+	80	609	853	0.7139508
A07	7203645	7204485	A07p07640.2_BraZ1	36.6	-	517	840	840	1.0000000
A07	7211630	7213573	A07p07650.2_BraZ1	1457.25	+	52	867	1943	0.4462172
A07	7217816	7219803	A07p07660.2_BraZ1	591	+	1783	1987	1987	1.0000000
A07	7220976	7224643	A07p07670.2_BraZ1	366.333	-	5147	3576	3667	0.9751841
A07	7225923	7228124	A07p07680.2_BraZ1	1099	+	1344	1759	2201	0.7991822
A07	7229668	7229941	A07p07690.2_BraZ1	27.3	-	102	247	273	0.9047619
A07	7232548	7235664	A07p07700.2_BraZ1	2274.32	+	169	882	3116	0.2830552
A07	7274846	7275219	A07p07710.2_BraZ1	225	+	57	299	373	0.8016086
A07	7280340	7280713	A07p07720.2_BraZ1	225	+	1	31	373	0.0831099
A07	7285831	7286204	A07p07730.2_BraZ1	225	+	2	16	373	0.0428954
A07	7287979	7289392	A07p07740.2_BraZ1	2565	+	348	1345	1413	0.9518754
A07	7292914	7294966	A07p07750.2_BraZ1	205.2	-	82	1037	2052	0.5053606
A07	7301923	7302381	A07p07760.2_BraZ1	264	-	60	413	458	0.9017467
A07	7315439	7316585	A07p07770.2_BraZ1	286.529	-	180	747	1146	0.6518325
A07	7318223	7319433	A07p07780.2_BraZ1	95.7	+	409	902	1210	0.7454545
A07	7327898	7329928	A07p07790.2_BraZ1	1111.96	+	683	1908	2030	0.9399015
A07	7330200	7331745	A07p07800.2_BraZ1	582.273	-	230	1275	1545	0.8252427
A07	7335584	7335914	A07p07810.2_BraZ1	189	-	117	330	330	1.0000000
A07	7345553	7345991	A07p07820.2_BraZ1	43.8	+	34	181	438	0.4132420
A07	7351379	7352041	A07p07830.2_BraZ1	339	+	412	662	662	1.0000000
A07	7357437	7358941	A07p07840.2_BraZ1	3855	+	114	871	1504	0.5791224
A07	7365035	7365474	A07p07850.2_BraZ1	36.9	+	4	16	439	0.0364465
A07	7375849	7377152	A07p07860.2_BraZ1	985.598	+	149	1063	1303	0.8158097
A07	7377987	7378716	A07p07870.2_BraZ1	513.068	-	95	710	729	0.9739369
A07	7386037	7387701	A07p07880.2_BraZ1	1381.54	+	69	802	1664	0.4819711
A07	7390343	7390984	A07p07890.2_BraZ1	207	-	199	638	641	0.9953198
A07	7395316	7397005	A07p07900.2_BraZ1	168.9	+	373	1603	1689	0.9490823
A07	7397299	7402111	A07p07910.2_BraZ1	2791.38	-	728	1892	4812	0.3931837
A07	7407716	7408193	A07p07920.2_BraZ1	47.7	+	11	197	477	0.4129979
A07	7408891	7413875	A07p07930.2_BraZ1	2976	-	474	3254	4984	0.6528893
A07	7414992	7416628	A07p07940.2_BraZ1	735	+	586	1116	1636	0.6821516
A07	7423761	7424670	A07p07950.2_BraZ1	90.9	-	23	461	909	0.5071507
A07	7437767	7438114	A07p07960.2_BraZ1	222	-	519	347	347	1.0000000
A07	7441270	7442015	A07p07970.2_BraZ1	375	+	796	745	745	1.0000000
A07	7442171	7442764	A07p07980.2_BraZ1	438	+	574	593	593	1.0000000
A07	7443501	7443820	A07p07990.2_BraZ1	231	+	369	319	319	1.0000000
A07	7469791	7470129	A07p08000.2_BraZ1	25.5	+	226	337	338	0.9970414
A07	7471250	7473323	A07p08010.2_BraZ1	1506.37	+	544	1706	2073	0.8229619
A07	7480907	7484895	A07p08020.2_BraZ1	1511.73	+	412	3016	3988	0.7562688
A07	7486906	7487931	A07p08030.2_BraZ1	252	+	673	1025	1025	1.0000000
A07	7491011	7491707	A07p08040.2_BraZ1	369	+	1283	696	696	1.0000000
A07	7492326	7494442	A07p08050.2_BraZ1	1362.84	+	66	881	2116	0.4163516
A07	7499242	7499404	A07p08060.2_BraZ1	16.2	-	9	122	162	0.7530864
A07	7517272	7534162	A07p08070.2_BraZ1	1574.8	+	13805	10525	16890	0.6231498
A07	7519260	7520178	A07p08080.2_BraZ1	571.3	-	21	490	918	0.5337691
A07	7535978	7536935	A07p08090.2_BraZ1	384	+	1213	940	957	0.9822361
A07	7542284	7543244	A07p08100.2_BraZ1	96	+	470	960	960	1.0000000
A07	7551352	7553096	A07p08110.2_BraZ1	830.25	-	284	1512	1744	0.8669725
A07	7553703	7554147	A07p08120.2_BraZ1	44.4	-	142	444	444	1.0000000
A07	7559845	7561489	A07p08130.2_BraZ1	1141.06	-	598	1153	1644	0.7013382
A07	7562258	7564722	A07p08140.2_BraZ1	1759.02	-	669	2169	2464	0.8802760
A07	7578546	7581623	A07p08150.2_BraZ1	713.95	+	2685	3077	3077	1.0000000
A07	7581953	7584957	A07p08160.2_BraZ1	1473.18	-	554	2170	3004	0.7223701
A07	7590901	7592463	A07p08170.2_BraZ1	1248	+	325	1474	1562	0.9436620
A07	7593676	7594584	A07p08180.2_BraZ1	405	-	52	476	908	0.5242290
A07	7596364	7596496	A07p08190.2_BraZ1	13.2	-	169	132	132	1.0000000
A07	7598064	7598331	A07p08200.2_BraZ1	17.1	+	335	267	267	1.0000000
A07	7599734	7601156	A07p08210.2_BraZ1	511	-	1130	1422	1422	1.0000000
A07	7603088	7604406	A07p08220.2_BraZ1	1242	-	218	1025	1318	0.7776935
A07	7611900	7612841	A07p08230.2_BraZ1	372	-	1005	941	941	1.0000000
A07	7615676	7623438	A07p08240.2_BraZ1	3327.18	+	205	1966	7762	0.2532852
A07	7624144	7625047	A07p08250.2_BraZ1	90.3	+	126	896	903	0.9922481
A07	7632021	7633258	A07p08260.2_BraZ1	114.3	-	502	1130	1237	0.9135004
A07	7642887	7643001	A07p08270.2_BraZ1	11.4	-	139	114	114	1.0000000
A07	7645324	7646078	A07p08280.2_BraZ1	468	-	352	754	754	1.0000000
A07	7647791	7647977	A07p08290.2_BraZ1	18.6	-	310	186	186	1.0000000
A07	7648426	7648882	A07p08300.2_BraZ1	45.6	+	0	0	456	0.0000000
A07	7650577	7650802	A07p08310.2_BraZ1	22.5	+	25	152	225	0.6755555
A07	7661791	7661966	A07p08320.2_BraZ1	16.5	+	29	175	175	1.0000000
A07	7665681	7667005	A07p08330.2_BraZ1	131.1	+	9	262	1324	0.1978852
A07	7733331	7736707	A07p08340.2_BraZ1	4350	-	1679	3303	3376	0.9783768
A07	7746505	7747825	A07p08350.2_BraZ1	132	+	153	1086	1320	0.8227273
A07	7747910	7748027	A07p08360.2_BraZ1	11.7	+	2	117	117	1.0000000
A07	7755467	7756880	A07p08370.2_BraZ1	804.109	+	55	462	1413	0.3269639
A07	7768634	7768931	A07p08380.2_BraZ1	243	+	272	297	297	1.0000000
A07	7769366	7770062	A07p08390.2_BraZ1	588	-	153	696	696	1.0000000
A07	7780014	7782176	A07p08400.2_BraZ1	1272.16	+	878	2113	2162	0.9773358
A07	7782729	7784526	A07p08410.2_BraZ1	1710	-	209	1121	1797	0.6238174
A07	7787895	7789107	A07p08420.2_BraZ1	121.2	-	103	478	1212	0.3943895
A07	7792989	7794054	A07p08430.2_BraZ1	555.636	+	424	1010	1065	0.9483568
A07	7796975	7798134	A07p08440.2_BraZ1	243	+	1	4	1159	0.0034513
A07	7800205	7800840	A07p08450.2_BraZ1	228	+	236	635	635	1.0000000
A07	7804401	7805889	A07p08460.2_BraZ1	148.8	+	237	624	1488	0.4193548
A07	7813681	7815414	A07p08470.2_BraZ1	1047.75	+	439	1481	1733	0.8545874
A07	7815949	7817695	A07p08480.2_BraZ1	174.6	-	359	1503	1746	0.8608248
A07	7824187	7824536	A07p08490.2_BraZ1	201	+	182	349	349	1.0000000
A07	7827414	7830171	A07p08500.2_BraZ1	766.071	-	508	2215	2757	0.8034095
A07	7836232	7836718	A07p08510.2_BraZ1	48.6	+	288	399	486	0.8209876
A07	7839751	7842014	A07p08520.2_BraZ1	1297.2	-	239	1313	2263	0.5802033
A07	7842765	7845784	A07p08530.2_BraZ1	1249.41	+	1379	2343	3019	0.7760848
A07	7846281	7850481	A07p08540.2_BraZ1	983.396	-	773	3450	4200	0.8214286
A07	7851690	7852003	A07p08550.2_BraZ1	27	-	694	313	313	1.0000000
A07	7855385	7856186	A07p08560.2_BraZ1	80.1	-	9	250	801	0.3121099
A07	7874423	7883203	A07p08570.2_BraZ1	5513.65	+	1091	5640	8780	0.6423690
A07	7884019	7884904	A07p08580.2_BraZ1	88.5	-	934	885	885	1.0000000
A07	7885410	7886535	A07p08590.2_BraZ1	490.2	+	1006	1125	1125	1.0000000
A07	7890005	7892729	A07p08600.2_BraZ1	1507.09	-	713	2176	2724	0.7988253
A07	7894004	7894211	A07p08610.2_BraZ1	20.7	-	238	207	207	1.0000000
A07	7894244	7894592	A07p08620.2_BraZ1	32.4	+	338	348	348	1.0000000
A07	7901200	7902507	A07p08630.2_BraZ1	570.046	-	574	1231	1307	0.9418516
A07	7902754	7903599	A07p08640.2_BraZ1	50.7	+	457	845	845	1.0000000
A07	7904461	7906242	A07p08650.2_BraZ1	948.857	-	260	1218	1781	0.6838855
A07	7908623	7908966	A07p08660.2_BraZ1	279	-	273	343	343	1.0000000
A07	7909429	7911086	A07p08670.2_BraZ1	255	-	234	1274	1657	0.7688594
A07	7920419	7920870	A07p08680.2_BraZ1	183	+	301	451	451	1.0000000
A07	7921567	7923461	A07p08690.2_BraZ1	920.5	-	1426	1894	1894	1.0000000
A07	7928742	7929483	A07p08700.2_BraZ1	266.625	+	357	741	741	1.0000000
A07	7936672	7937071	A07p08710.2_BraZ1	231	-	1701	399	399	1.0000000
A07	7940867	7941299	A07p08720.2_BraZ1	43.2	+	138	432	432	1.0000000
A07	7941966	7946693	A07p08730.2_BraZ1	519	+	4142	4716	4727	0.9976729
A07	7947579	7948029	A07p08740.2_BraZ1	44.4	+	899	450	450	1.0000000
A07	7964982	7965282	A07p08750.2_BraZ1	30	-	111	300	300	1.0000000
A07	7967932	7968555	A07p08760.2_BraZ1	294	+	269	623	623	1.0000000
A07	7978565	7980388	A07p08770.2_BraZ1	954.75	+	1486	1823	1823	1.0000000
A07	7981301	7982190	A07p08780.2_BraZ1	546	+	697	889	889	1.0000000
A07	7982983	7983547	A07p08790.2_BraZ1	56.4	+	483	564	564	1.0000000
A07	7984252	7984936	A07p08800.2_BraZ1	294	-	881	684	684	1.0000000
A07	7985517	7985800	A07p08810.2_BraZ1	21	+	124	283	283	1.0000000
A07	7993481	7993778	A07p08820.2_BraZ1	29.7	-	102	297	297	1.0000000
A07	8006219	8007350	A07p08830.2_BraZ1	113.1	-	312	1131	1131	1.0000000
A07	8011976	8013164	A07p08840.2_BraZ1	553.667	-	179	842	1188	0.7087542
A07	8016895	8017864	A07p08850.2_BraZ1	398	+	36	694	969	0.7162023
A07	8017864	8018950	A07p08860.2_BraZ1	643.571	+	56	967	1086	0.8904236
A07	8021421	8022474	A07p08870.2_BraZ1	105.3	-	20	435	1053	0.4131054
A07	8026410	8026791	A07p08880.2_BraZ1	35.4	-	238	381	381	1.0000000
A07	8029373	8030747	A07p08890.2_BraZ1	831.6	+	239	1177	1374	0.8566230
A07	8051008	8051257	A07p08900.2_BraZ1	12.6	+	396	249	249	1.0000000
A07	8070865	8074282	A07p08910.2_BraZ1	1200	+	874	2554	3417	0.7474393
A07	8079984	8082420	A07p08920.2_BraZ1	2209.09	-	301	1967	2436	0.8074713
A07	8089781	8092120	A07p08930.2_BraZ1	1500.75	+	430	1915	2339	0.8187259
A07	8099244	8099376	A07p08940.2_BraZ1	13.2	-	27	132	132	1.0000000
A07	8099736	8100094	A07p08950.2_BraZ1	147	-	282	358	358	1.0000000
A07	8101659	8102333	A07p08960.2_BraZ1	234	+	982	674	674	1.0000000
A07	8102904	8103780	A07p08970.2_BraZ1	750	+	503	876	876	1.0000000
A07	8106406	8108004	A07p08980.2_BraZ1	543.333	-	1714	1598	1598	1.0000000
A07	8110757	8112034	A07p08990.2_BraZ1	740.969	+	454	1225	1277	0.9592795
A07	8113193	8113367	A07p09000.2_BraZ1	17.4	+	458	174	174	1.0000000
A07	8114901	8115306	A07p09010.2_BraZ1	243	+	580	405	405	1.0000000
A07	8115629	8115963	A07p09020.2_BraZ1	135	+	267	334	334	1.0000000
A07	8121905	8157206	A07p09030.2_BraZ1	207	-	18609	28202	35301	0.7989009
A07	8123363	8123869	A07p09040.2_BraZ1	48.9	-	297	368	506	0.7272727
A07	8139038	8140642	A07p09050.2_BraZ1	894	+	570	976	1604	0.6084788
A07	8140957	8141957	A07p09060.2_BraZ1	6468	+	247	791	1000	0.7910000
A07	8142124	8152239	A07p09070.2_BraZ1	958.009	-	2569	5436	10115	0.5374197
A07	8159752	8161001	A07p09080.2_BraZ1	5042.25	+	853	1026	1249	0.8214571
A07	8161753	8161936	A07p09090.2_BraZ1	18.3	+	111	183	183	1.0000000
A07	8167962	8169196	A07p09100.2_BraZ1	1188	-	214	1097	1234	0.8889790
A07	8174540	8175164	A07p09110.2_BraZ1	318	+	389	609	624	0.9759616
A07	8176111	8177314	A07p09120.2_BraZ1	120.3	+	65	647	1203	0.5378221
A07	8179916	8182722	A07p09130.2_BraZ1	1693.83	-	459	2730	2806	0.9729152
A07	8186845	8189367	A07p09140.2_BraZ1	2010.19	-	1450	2522	2522	1.0000000
A07	8206818	8208782	A07p09150.2_BraZ1	1200.4	+	302	1480	1964	0.7535642
A07	8222022	8222283	A07p09160.2_BraZ1	26.1	-	310	261	261	1.0000000
A07	8226814	8227848	A07p09170.2_BraZ1	945	-	163	829	1034	0.8017408
A07	8229348	8229534	A07p09180.2_BraZ1	18.6	-	236	186	186	1.0000000
A07	8233971	8238157	A07p09190.2_BraZ1	2500.99	-	1651	3645	4186	0.8707597
A07	8240697	8241083	A07p09200.2_BraZ1	312	-	138	355	386	0.9196891
A07	8241356	8241467	A07p09210.2_BraZ1	11.1	+	37	111	111	1.0000000
A07	8251845	8253497	A07p09220.2_BraZ1	687	-	351	1251	1652	0.7572639
A07	8259325	8261713	A07p09230.2_BraZ1	62058.8	-	246	2046	2388	0.8567839
A07	8277415	8277791	A07p09240.2_BraZ1	300	-	1033	376	376	1.0000000
A07	8282500	8283080	A07p09250.2_BraZ1	456	-	1077	580	580	1.0000000
A07	8291861	8292295	A07p09260.2_BraZ1	168	+	264	434	434	1.0000000
A07	8302445	8304736	A07p09270.2_BraZ1	1146.11	+	777	2133	2291	0.9310345
A07	8315597	8316770	A07p09280.2_BraZ1	969	+	421	1079	1173	0.9198636
A07	8320070	8322002	A07p09290.2_BraZ1	2100.9	+	191	1335	1932	0.6909938
A07	8337164	8339064	A07p09300.2_BraZ1	822	+	15	690	1900	0.3631579
A07	8346702	8348262	A07p09310.2_BraZ1	977.5	-	117	1270	1560	0.8141026
A07	8357031	8360341	A07p09320.2_BraZ1	3135	+	559	2238	3310	0.6761329
A07	8360468	8361953	A07p09330.2_BraZ1	148.5	-	61	854	1485	0.5750841
A07	8368866	8369031	A07p09340.2_BraZ1	15.9	+	139	165	165	1.0000000
A07	8369064	8374876	A07p09350.2_BraZ1	3239.03	+	4253	5261	5812	0.9051961
A07	8378313	8379992	A07p09360.2_BraZ1	814	+	1048	1519	1679	0.9047052
A07	8380431	8381022	A07p09370.2_BraZ1	577.5	-	292	580	591	0.9813875
A07	8406582	8407549	A07p09380.2_BraZ1	816	+	704	859	967	0.8883144
A07	8421310	8421712	A07p09390.2_BraZ1	340	-	166	402	402	1.0000000
A07	8423306	8424821	A07p09400.2_BraZ1	151.5	+	126	890	1515	0.5874587
A07	8437568	8437700	A07p09410.2_BraZ1	13.2	-	103	132	132	1.0000000
A07	8446239	8447366	A07p09420.2_BraZ1	692.769	+	789	1127	1127	1.0000000
A07	8446603	8447432	A07p09430.2_BraZ1	189	+	775	829	829	1.0000000
A07	8449439	8451772	A07p09440.2_BraZ1	1125	-	1579	2316	2333	0.9927133
A07	8476167	8478940	A07p09450.2_BraZ1	1560.73	+	649	2667	2773	0.9617742
A07	8481336	8481961	A07p09460.2_BraZ1	1922	-	10	247	625	0.3952000
A07	8487162	8487914	A07p09470.2_BraZ1	681	+	557	604	752	0.8031915
A07	8489414	8492469	A07p09480.2_BraZ1	1803.98	+	1374	2947	3055	0.9646481
A07	8492972	8493480	A07p09490.2_BraZ1	273	-	38	327	508	0.6437008
A07	8498866	8502005	A07p09500.2_BraZ1	2772	+	147	2193	3139	0.6986302
A07	8503267	8504566	A07p09510.2_BraZ1	129.9	-	750	1299	1299	1.0000000
A07	8509452	8519856	A07p09520.2_BraZ1	1656.77	-	3964	7726	10404	0.7425990
A07	8521030	8522368	A07p09530.2_BraZ1	644.196	+	161	693	1338	0.5179372
A07	8526215	8526638	A07p09540.2_BraZ1	336	+	0	0	423	0.0000000
A07	8528419	8529970	A07p09550.2_BraZ1	8089.12	-	293	1315	1551	0.8478401
A07	8560471	8561203	A07p09560.2_BraZ1	73.2	-	178	658	732	0.8989071
A07	8563108	8564695	A07p09570.2_BraZ1	662.5	-	148	767	1587	0.4833018
A07	8565179	8565917	A07p09580.2_BraZ1	73.8	+	87	688	738	0.9322493
A07	8566014	8566944	A07p09590.2_BraZ1	822	-	89	784	930	0.8430107
A07	8571168	8573103	A07p09600.2_BraZ1	193.5	-	434	1250	1935	0.6459948
A07	8573464	8576551	A07p09610.2_BraZ1	1901.45	-	1153	2870	3087	0.9297052
A07	8576972	8577437	A07p09620.2_BraZ1	46.5	-	346	465	465	1.0000000
A07	8583835	8584391	A07p09630.2_BraZ1	322.5	-	814	556	556	1.0000000
A07	8587412	8589363	A07p09640.2_BraZ1	1644	-	295	1446	1951	0.7411584
A07	8593333	8594283	A07p09650.2_BraZ1	611.471	-	545	829	950	0.8726315
A07	8594682	8596581	A07p09660.2_BraZ1	183.971	-	1895	1899	1899	1.0000000
A07	8612829	8613326	A07p09670.2_BraZ1	300	-	338	497	497	1.0000000
A07	8627678	8629455	A07p09680.2_BraZ1	764.227	-	463	1710	1777	0.9622960
A07	8668301	8669687	A07p09690.2_BraZ1	859.846	-	557	1356	1386	0.9783550
A07	8671044	8673340	A07p09700.2_BraZ1	1092	+	2215	2296	2296	1.0000000
A07	8674103	8674388	A07p09710.2_BraZ1	195	-	500	285	285	1.0000000
A07	8674439	8674913	A07p09720.2_BraZ1	171.818	-	656	474	474	1.0000000
A07	8675877	8676003	A07p09730.2_BraZ1	12.6	-	130	126	126	1.0000000
A07	8677508	8677646	A07p09740.2_BraZ1	13.8	+	334	138	138	1.0000000
A07	8678606	8682072	A07p09750.2_BraZ1	1380.72	-	2379	3400	3466	0.9809579
A07	8683881	8684004	A07p09760.2_BraZ1	12.3	-	119	123	123	1.0000000
A07	8684336	8685324	A07p09770.2_BraZ1	4137	-	663	988	988	1.0000000
A07	8692430	8696275	A07p09780.2_BraZ1	2182.99	+	715	1937	3845	0.5037711
A07	8696999	8702565	A07p09790.2_BraZ1	2668.58	-	1529	4360	5566	0.7833273
A07	8723029	8724787	A07p09800.2_BraZ1	175.8	+	4	202	1758	0.1149033
A07	8735933	8738615	A07p09810.2_BraZ1	339.429	+	2	164	2682	0.0611484
A07	8742143	8742254	A07p09820.2_BraZ1	11.1	-	7	111	111	1.0000000
A07	8742341	8745227	A07p09830.2_BraZ1	1805.76	-	52	726	2886	0.2515593
A07	8747895	8749505	A07p09840.2_BraZ1	1256.73	+	656	1341	1610	0.8329192
A07	8754899	8755124	A07p09850.2_BraZ1	22.5	+	8	38	225	0.1688889
A07	8758308	8758638	A07p09860.2_BraZ1	33	+	30	295	330	0.8939394
A07	8770059	8772414	A07p09870.2_BraZ1	1012.48	+	165	954	2355	0.4050955
A07	8774895	8776710	A07p09880.2_BraZ1	1077.38	-	287	912	1815	0.5024793
A07	8781495	8785130	A07p09890.2_BraZ1	3423	+	175	2258	3635	0.6211829
A07	8785859	8786851	A07p09900.2_BraZ1	430.1	+	171	465	992	0.4687500
A07	8794166	8794621	A07p09910.2_BraZ1	336.6	-	220	455	455	1.0000000
A07	8796827	8799490	A07p09920.2_BraZ1	1532.73	-	972	2172	2663	0.8156215
A07	8803369	8807939	A07p09930.2_BraZ1	1864.62	+	1523	3579	4570	0.7831510
A07	8808221	8810338	A07p09940.2_BraZ1	728.579	-	514	1455	2117	0.6872934
A07	8826083	8829002	A07p09950.2_BraZ1	11086.9	+	1470	2655	2919	0.9095581
A07	8829375	8829636	A07p09960.2_BraZ1	26.1	+	267	261	261	1.0000000
A07	8830159	8833182	A07p09970.2_BraZ1	14091	-	2613	2998	3023	0.9917301
A07	8836620	8837982	A07p09980.2_BraZ1	136.2	-	130	862	1362	0.6328928
A07	8846314	8846644	A07p09990.2_BraZ1	33	-	394	330	330	1.0000000
A07	8853040	8854934	A07p10000.2_BraZ1	487.641	+	216	1331	1894	0.7027455
A07	8869345	8869893	A07p10010.2_BraZ1	244	+	105	548	548	1.0000000
A07	8870277	8870621	A07p10020.2_BraZ1	279	-	158	344	344	1.0000000
A07	8872272	8873435	A07p10030.2_BraZ1	585	+	1130	1163	1163	1.0000000
A07	8876591	8878805	A07p10040.2_BraZ1	48114	+	595	1378	2214	0.6224029
A07	8879894	8880248	A07p10050.2_BraZ1	35.4	-	0	0	354	0.0000000
A07	8884858	8885231	A07p10060.2_BraZ1	264	+	76	298	373	0.7989276
A07	8893679	8895672	A07p10070.2_BraZ1	1354.1	-	151	1147	1993	0.5755143
A07	8898510	8907050	A07p10080.2_BraZ1	249	+	2408	6679	8540	0.7820843
A07	8899337	8899723	A07p10090.2_BraZ1	259	-	307	386	386	1.0000000
A07	8913439	8915070	A07p10100.2_BraZ1	1405.76	-	8	384	1631	0.2354384
A07	8915917	8917244	A07p10110.2_BraZ1	595.857	+	129	799	1327	0.6021100
A07	8919348	8922168	A07p10120.2_BraZ1	2739	-	457	1978	2820	0.7014185
A07	8924369	8924936	A07p10130.2_BraZ1	417.562	+	7	222	567	0.3915344
A07	8925456	8925799	A07p10140.2_BraZ1	237	-	2	28	343	0.0816327
A07	8931518	8932727	A07p10150.2_BraZ1	120.9	+	25	634	1209	0.5244004
A07	8934910	8937663	A07p10160.2_BraZ1	1952.57	+	1005	2483	2753	0.9019251
A07	8938556	8939604	A07p10170.2_BraZ1	876	-	168	815	1048	0.7776718
A07	8946756	8947537	A07p10180.2_BraZ1	63.6	-	99	422	781	0.5403329
A07	8947739	8949365	A07p10190.2_BraZ1	70.8	-	586	1071	1626	0.6586716
A07	8955372	8956082	A07p10200.2_BraZ1	900	+	202	608	710	0.8563380
A07	8957627	8957847	A07p10210.2_BraZ1	19.2	+	140	220	220	1.0000000
A07	8961443	8961761	A07p10220.2_BraZ1	31.8	-	948	318	318	1.0000000
A07	8966025	8966160	A07p10230.2_BraZ1	13.5	+	148	135	135	1.0000000
A07	8984488	8986692	A07p10240.2_BraZ1	1015.78	+	938	2113	2204	0.9587114
A07	8986744	8986873	A07p10250.2_BraZ1	12.9	+	156	129	129	1.0000000
A07	8987689	8989174	A07p10260.2_BraZ1	900	+	653	1430	1485	0.9629630
A07	8990668	8990824	A07p10270.2_BraZ1	15.6	+	284	156	156	1.0000000
A07	8996101	8996329	A07p10280.2_BraZ1	22.8	+	216	228	228	1.0000000
A07	8999199	9000083	A07p10290.2_BraZ1	741	+	37	531	884	0.6006787
A07	9019150	9020064	A07p10300.2_BraZ1	744	+	246	914	914	1.0000000
A07	9022630	9028336	A07p10310.2_BraZ1	3746.8	-	1673	5191	5706	0.9097441
A07	9039881	9040601	A07p10320.2_BraZ1	192	+	554	720	720	1.0000000
A07	9048395	9048620	A07p10330.2_BraZ1	153	-	6	168	225	0.7466667
A07	9068633	9068768	A07p10340.2_BraZ1	13.5	+	4	78	135	0.5777778
A07	9092462	9093461	A07p10350.2_BraZ1	99.9	-	89	404	999	0.4044044
A07	9116027	9116189	A07p10360.2_BraZ1	16.2	-	172	162	162	1.0000000
A07	9122754	9124224	A07p10370.2_BraZ1	824.348	-	685	1470	1470	1.0000000
A07	9128084	9128963	A07p10380.2_BraZ1	513.196	-	166	871	879	0.9908987
A07	9131766	9133338	A07p10390.2_BraZ1	612.164	-	683	1442	1572	0.9173028
A07	9134041	9139652	A07p10400.2_BraZ1	2528.33	-	2882	5265	5611	0.9383354
A07	9147198	9152579	A07p10410.2_BraZ1	3510.5	-	1426	4124	5381	0.7664003
A07	9164204	9166353	A07p10420.2_BraZ1	935.25	-	919	1842	2149	0.8571429
A07	9166824	9168601	A07p10430.2_BraZ1	626.432	+	931	1511	1777	0.8503095
A07	9168968	9173202	A07p10440.2_BraZ1	1572.92	-	1582	4060	4234	0.9589041
A07	9173718	9176462	A07p10450.2_BraZ1	1708.5	-	4121	2734	2744	0.9963557
A07	9177993	9178539	A07p10460.2_BraZ1	54.6	+	21	86	546	0.1575092
A07	9179057	9184777	A07p10470.2_BraZ1	1898.86	-	782	4193	5720	0.7330419
A07	9191235	9191559	A07p10480.2_BraZ1	32.4	+	37	306	324	0.9444444
A07	9218030	9222072	A07p10490.2_BraZ1	1621.2	-	2250	4020	4042	0.9945571
A07	9219529	9220516	A07p10500.2_BraZ1	399	-	804	987	987	1.0000000
A07	9223175	9224475	A07p10510.2_BraZ1	3492.67	+	380	1050	1300	0.8076923
A07	9228285	9230266	A07p10520.2_BraZ1	920.694	+	313	1510	1981	0.7622413
A07	9231683	9232007	A07p10530.2_BraZ1	32.4	-	22	296	324	0.9135802
A07	9240434	9240548	A07p10540.2_BraZ1	11.4	+	67	114	114	1.0000000
A07	9243481	9245689	A07p10550.2_BraZ1	13824.4	-	3252	2185	2208	0.9895833
A07	9255672	9260013	A07p10560.2_BraZ1	2130.43	+	866	3427	4341	0.7894495
A07	9260623	9268985	A07p10570.2_BraZ1	1145.38	-	2439	5661	8362	0.6769912
A07	9272502	9272859	A07p10580.2_BraZ1	35.7	+	18	357	357	1.0000000
A07	9278752	9279049	A07p10590.2_BraZ1	243	+	8	222	297	0.7474747
A07	9279527	9280223	A07p10600.2_BraZ1	588	-	6	569	696	0.8175287
A07	9283992	9297936	A07p10610.2_BraZ1	982.987	-	4928	9173	13944	0.6578457
A07	9292274	9294605	A07p10620.2_BraZ1	840	-	110	1187	2331	0.5092235
A07	9309317	9309692	A07p10630.2_BraZ1	162	+	314	375	375	1.0000000
A07	9316088	9317509	A07p10640.2_BraZ1	1542.75	-	303	1421	1421	1.0000000
A07	9327669	9327813	A07p10650.2_BraZ1	14.4	+	188	144	144	1.0000000
A07	9350737	9356407	A07p10660.2_BraZ1	2211.4	+	444	4097	5670	0.7225749
A07	9357083	9360314	A07p10670.2_BraZ1	2181.27	-	479	1896	3231	0.5868152
A07	9398446	9398680	A07p10680.2_BraZ1	23.1	+	145	234	234	1.0000000
A07	9412024	9413265	A07p10690.2_BraZ1	764.5	+	753	1234	1241	0.9943594
A07	9413779	9414922	A07p10700.2_BraZ1	272.955	-	337	1039	1143	0.9090114
A07	9416984	9417724	A07p10710.2_BraZ1	538.02	-	369	740	740	1.0000000
A07	9419827	9422302	A07p10720.2_BraZ1	1833.42	-	1203	2459	2475	0.9935353
A07	9428961	9430915	A07p10730.2_BraZ1	504.436	+	507	1431	1954	0.7323439
A07	9430991	9432541	A07p10740.2_BraZ1	824.87	-	128	1288	1550	0.8309677
A07	9433173	9433600	A07p10750.2_BraZ1	264	-	390	427	427	1.0000000
A07	9439799	9440963	A07p10760.2_BraZ1	360	+	808	1129	1164	0.9699312
A07	9440914	9441544	A07p10770.2_BraZ1	165	+	394	613	630	0.9730158
A07	9443011	9445153	A07p10780.2_BraZ1	214.2	-	597	1689	2142	0.7885154
A07	9445469	9446451	A07p10790.2_BraZ1	273.635	-	902	982	982	1.0000000
A07	9448048	9449062	A07p10800.2_BraZ1	288	+	798	1014	1014	1.0000000
A07	9449323	9451978	A07p10810.2_BraZ1	1528.26	-	544	2440	2655	0.9190207
A07	9452028	9452783	A07p10820.2_BraZ1	333	-	751	755	755	1.0000000
A07	9460885	9463240	A07p10830.2_BraZ1	1665.47	-	1382	2294	2355	0.9740977
A07	9472553	9473768	A07p10840.2_BraZ1	600	-	131	765	1215	0.6296296
A07	9480290	9488211	A07p10850.2_BraZ1	822.216	-	3727	6597	7921	0.8328494
A07	9496164	9497332	A07p10860.2_BraZ1	681	+	1383	1168	1168	1.0000000
A07	9498947	9499777	A07p10870.2_BraZ1	330	+	689	830	830	1.0000000
A07	9500796	9503086	A07p10880.2_BraZ1	1071	-	248	1792	2290	0.7825328
A07	9503914	9508701	A07p10890.2_BraZ1	2390.05	-	642	3848	4787	0.8038437
A07	9518195	9518876	A07p10900.2_BraZ1	561	+	75	503	681	0.7386197
A07	9521375	9521599	A07p10910.2_BraZ1	201	-	113	224	224	1.0000000
A07	9524433	9525585	A07p10920.2_BraZ1	804.375	-	32	419	1152	0.3637153
A07	9527503	9527971	A07p10930.2_BraZ1	46.8	+	16	98	468	0.2094017
A07	9543069	9544568	A07p10940.2_BraZ1	3697.5	+	171	974	1499	0.6497665
A07	9552775	9553080	A07p10950.2_BraZ1	228	+	25	302	305	0.9901639
A07	9555525	9555717	A07p10960.2_BraZ1	19.2	-	20	192	192	1.0000000
A07	9557041	9557345	A07p10970.2_BraZ1	228	-	52	304	304	1.0000000
A07	9563196	9563882	A07p10980.2_BraZ1	1101.75	+	981	686	686	1.0000000
A07	9572528	9572972	A07p10990.2_BraZ1	44.4	+	115	430	444	0.9684685
A07	9586143	9586563	A07p11000.2_BraZ1	42	+	72	342	420	0.8142857
A07	9588000	9588417	A07p11010.2_BraZ1	41.7	-	197	417	417	1.0000000
A07	9592677	9594027	A07p11020.2_BraZ1	825.554	+	2251	1350	1350	1.0000000
A07	9595175	9595988	A07p11030.2_BraZ1	465	-	699	813	813	1.0000000
A07	9601309	9602530	A07p11040.2_BraZ1	122.1	+	558	1164	1221	0.9533169
A07	9602929	9604249	A07p11050.2_BraZ1	654	-	494	1198	1320	0.9075758
A07	9606024	9606806	A07p11060.2_BraZ1	517.818	+	203	779	782	0.9961637
A07	9614435	9614938	A07p11070.2_BraZ1	32.4	+	309	503	503	1.0000000
A07	9625719	9627216	A07p11080.2_BraZ1	149.7	+	650	1260	1497	0.8416834
A07	9633421	9633808	A07p11090.2_BraZ1	30.6	+	704	387	387	1.0000000
A07	9635160	9638803	A07p11100.2_BraZ1	2119.07	-	801	999	3643	0.2742245
A07	9645285	9647723	A07p11110.2_BraZ1	1190.02	+	938	2197	2438	0.9011485
A07	9649333	9651201	A07p11120.2_BraZ1	1483.57	+	294	775	1868	0.4148822
A07	9653975	9654757	A07p11130.2_BraZ1	439.6	+	573	782	782	1.0000000
A07	9655266	9655485	A07p11140.2_BraZ1	21.9	+	7	65	219	0.2968037
A07	9656756	9657513	A07p11150.2_BraZ1	654	+	12	359	757	0.4742404
A07	9662757	9663231	A07p11160.2_BraZ1	31.8	-	412	474	474	1.0000000
A07	9666604	9667609	A07p11170.2_BraZ1	519	-	232	574	1005	0.5711443
A07	9689434	9689999	A07p11180.2_BraZ1	43.2	-	496	565	565	1.0000000
A07	9695499	9696098	A07p11190.2_BraZ1	558	-	674	599	599	1.0000000
A07	9710166	9711592	A07p11200.2_BraZ1	1161	+	99	599	1426	0.4200561
A07	9721171	9722751	A07p11210.2_BraZ1	695.967	-	235	1225	1580	0.7753165
A07	9727298	9728568	A07p11220.2_BraZ1	531.927	+	509	1210	1270	0.9527559
A07	9730587	9731553	A07p11230.2_BraZ1	96.6	+	6	156	966	0.1614907
A07	9746347	9746560	A07p11240.2_BraZ1	21.3	+	227	213	213	1.0000000
A07	9749889	9751969	A07p11250.2_BraZ1	992.25	+	1660	2080	2080	1.0000000
A07	9754621	9756854	A07p11260.2_BraZ1	540	-	686	2007	2233	0.8987908
A07	9768300	9769797	A07p11270.2_BraZ1	1790.1	+	112	957	1497	0.6392785
A07	9770755	9771083	A07p11280.2_BraZ1	31.2	-	70	303	328	0.9237805
A07	9788546	9793564	A07p11290.2_BraZ1	718.545	+	1125	3641	5018	0.7255879
A07	9807871	9818017	A07p11300.2_BraZ1	315	-	9974	10129	10146	0.9983245
A07	9825037	9826831	A07p11310.2_BraZ1	1242	+	538	1348	1794	0.7513936
A07	9833897	9834302	A07p11320.2_BraZ1	342	+	184	405	405	1.0000000
A07	9834620	9835829	A07p11330.2_BraZ1	780	-	89	848	1209	0.7014061
A07	9838845	9839607	A07p11340.2_BraZ1	76.2	-	38	568	762	0.7454068
A07	9840546	9841047	A07p11350.2_BraZ1	282	+	408	501	501	1.0000000
A07	9852367	9854241	A07p11360.2_BraZ1	889.899	-	499	1687	1874	0.9002134
A07	9855823	9856490	A07p11370.2_BraZ1	31.8	-	74	281	667	0.4212894
A07	9877496	9878595	A07p11380.2_BraZ1	349.35	-	853	1066	1099	0.9699727
A07	9896094	9896482	A07p11390.2_BraZ1	22.8	-	339	388	388	1.0000000
A07	9915347	9919146	A07p11400.2_BraZ1	1773.35	+	838	3111	3799	0.8188997
A07	9926002	9926452	A07p11410.2_BraZ1	45	-	59	202	450	0.4488889
A07	9930898	9933686	A07p11420.2_BraZ1	1624.44	-	457	1820	2788	0.6527977
A07	9941521	9941773	A07p11430.2_BraZ1	162	+	321	252	252	1.0000000
A07	9942284	9954594	A07p11440.2_BraZ1	1200.42	+	7491	10921	12310	0.8871649
A07	9958999	9960580	A07p11450.2_BraZ1	158.1	-	208	948	1581	0.5996205
A07	9961954	9963550	A07p11460.2_BraZ1	159.6	-	169	1060	1596	0.6641604
A07	9967441	9967844	A07p11470.2_BraZ1	219	+	399	403	403	1.0000000
A07	9969353	9970114	A07p11480.2_BraZ1	615	-	864	761	761	1.0000000
A07	9971010	9972449	A07p11490.2_BraZ1	443.104	+	598	1439	1439	1.0000000
A07	9974618	9976468	A07p11500.2_BraZ1	1568.86	-	706	1715	1850	0.9270270
A07	9978164	9978665	A07p11510.2_BraZ1	399	+	0	0	501	0.0000000
A07	10001909	10004108	A07p11520.2_BraZ1	1163.93	-	869	2147	2199	0.9763529
A07	10018016	10031281	A07p11530.2_BraZ1	1180.59	+	4820	12716	13265	0.9586129
A07	10028782	10029193	A07p11540.2_BraZ1	216	-	337	401	411	0.9756691
A07	10031843	10033120	A07p11550.2_BraZ1	934.95	-	391	1272	1277	0.9960846
A07	10033564	10033879	A07p11560.2_BraZ1	31.5	-	178	315	315	1.0000000
A07	10034575	10035920	A07p11570.2_BraZ1	690.538	+	56	229	1345	0.1702602
A07	10040852	10042455	A07p11580.2_BraZ1	11961.6	+	1	106	1603	0.0661260
A07	10047384	10049053	A07p11590.2_BraZ1	11491.2	+	119	982	1669	0.5883763
A07	10052565	10054294	A07p11600.2_BraZ1	872.231	+	413	964	1729	0.5575477
A07	10055790	10056354	A07p11610.2_BraZ1	486	+	537	500	564	0.8865248
A07	10058534	10059426	A07p11620.2_BraZ1	303	+	129	336	892	0.3766816
A07	10061336	10062704	A07p11630.2_BraZ1	837	-	291	659	1368	0.4817252
A07	10066272	10068792	A07p11640.2_BraZ1	342	+	1228	2489	2520	0.9876984
A07	10069728	10075713	A07p11650.2_BraZ1	2177.56	-	1490	4814	5985	0.8043442
A07	10076845	10081098	A07p11660.2_BraZ1	750	+	1212	4047	4253	0.9515636
A07	10081619	10086991	A07p11670.2_BraZ1	2745.25	-	939	4275	5372	0.7957930
A07	10094540	10101893	A07p11680.2_BraZ1	3904.48	-	1359	4617	7353	0.6279070
A07	10103926	10104101	A07p11690.2_BraZ1	14.7	-	66	175	175	1.0000000
A07	10104327	10105602	A07p11700.2_BraZ1	127.5	-	198	812	1275	0.6368628
A07	10109001	10109190	A07p11710.2_BraZ1	18.9	+	30	189	189	1.0000000
A07	10117360	10118164	A07p11720.2_BraZ1	54.3	+	77	615	804	0.7649254
A07	10120881	10122474	A07p11730.2_BraZ1	159.3	+	35	310	1593	0.1946014
A07	10124969	10126849	A07p11740.2_BraZ1	846	+	1345	1880	1880	1.0000000
A07	10127598	10127751	A07p11750.2_BraZ1	15.3	+	351	153	153	1.0000000
A07	10134553	10136258	A07p11760.2_BraZ1	1128.28	+	458	1584	1705	0.9290323
A07	10139574	10142296	A07p11770.2_BraZ1	1363.26	-	1537	2722	2722	1.0000000
A07	10149601	10150695	A07p11780.2_BraZ1	819	+	678	1094	1094	1.0000000
A07	10152979	10153522	A07p11790.2_BraZ1	292.8	-	282	543	543	1.0000000
A07	10154365	10154798	A07p11800.2_BraZ1	3284.4	-	582	433	433	1.0000000
A07	10162380	10164274	A07p11810.2_BraZ1	699.2	+	376	1682	1894	0.8880676
A07	10165121	10165709	A07p11820.2_BraZ1	177	+	249	359	588	0.6105442
A07	10166692	10167189	A07p11830.2_BraZ1	321	-	90	400	497	0.8048290
A07	10167529	10168440	A07p11840.2_BraZ1	744	-	512	863	911	0.9473106
A07	10171443	10171951	A07p11850.2_BraZ1	420	+	422	508	508	1.0000000
A07	10180519	10180666	A07p11860.2_BraZ1	14.7	+	122	147	147	1.0000000
A07	10192976	10193798	A07p11870.2_BraZ1	82.2	-	519	822	822	1.0000000
A07	10194694	10194892	A07p11880.2_BraZ1	19.8	+	188	198	198	1.0000000
A07	10198972	10200055	A07p11890.2_BraZ1	534.188	-	129	786	1083	0.7257618
A07	10218089	10218731	A07p11900.2_BraZ1	64.2	-	31	545	642	0.8489097
A07	10227681	10229751	A07p11910.2_BraZ1	1026	-	958	1806	2070	0.8724638
A07	10292436	10296126	A07p11920.2_BraZ1	674.286	-	2502	3638	3690	0.9859079
A07	10297110	10303071	A07p11930.2_BraZ1	937.2	-	8113	5956	5961	0.9991612
A07	10303091	10304654	A07p11940.2_BraZ1	477	-	1575	1555	1563	0.9948816
A07	10311486	10311937	A07p11950.2_BraZ1	238.846	+	398	451	451	1.0000000
A07	10317518	10320072	A07p11960.2_BraZ1	2002	+	159	1096	2554	0.4291308
A07	10322862	10329691	A07p11970.2_BraZ1	3379.98	+	1229	5338	6829	0.7816664
A07	10330092	10330896	A07p11980.2_BraZ1	80.4	-	12	110	804	0.1368159
A07	10333318	10334122	A07p11990.2_BraZ1	80.4	+	30	105	804	0.1305970
A07	10334523	10335513	A07p12000.2_BraZ1	435	-	172	523	990	0.5282828
A07	10337418	10340482	A07p12010.2_BraZ1	2070.41	+	462	2147	3064	0.7007180
A07	10342297	10343743	A07p12020.2_BraZ1	834	-	1149	1446	1446	1.0000000
A07	10358246	10360762	A07p12030.2_BraZ1	330.702	-	2999	2501	2516	0.9940382
A07	10361434	10363188	A07p12040.2_BraZ1	1058.2	+	3447	1754	1754	1.0000000
A07	10365056	10365692	A07p12050.2_BraZ1	588	+	1224	636	636	1.0000000
A07	10366750	10369733	A07p12060.2_BraZ1	780.692	-	4728	2983	2983	1.0000000
A07	10369820	10371466	A07p12070.2_BraZ1	1455	-	2420	1646	1646	1.0000000
A07	10377255	10382380	A07p12080.2_BraZ1	1543.08	-	2360	4782	5125	0.9330732
A07	10404114	10408296	A07p12090.2_BraZ1	551.25	+	272	1401	4182	0.3350072
A07	10409273	10410002	A07p12100.2_BraZ1	72.9	-	254	729	729	1.0000000
A07	10411364	10412156	A07p12110.2_BraZ1	79.2	-	84	411	792	0.5189394
A07	10416978	10435811	A07p12120.2_BraZ1	438.3	+	6484	16929	18833	0.8989009
A07	10424393	10424982	A07p12130.2_BraZ1	509.85	+	38	563	589	0.9558574
A07	10442684	10455963	A07p12140.2_BraZ1	303.3	+	7729	10919	13279	0.8222758
A07	10457008	10466949	A07p12150.2_BraZ1	305.4	+	1149	7158	9941	0.7200483
A07	10467586	10467913	A07p12160.2_BraZ1	279	+	260	327	327	1.0000000
A07	10471275	10471502	A07p12170.2_BraZ1	18	+	194	227	227	1.0000000
A07	10472130	10472457	A07p12180.2_BraZ1	32.7	+	1254	327	327	1.0000000
A07	10477832	10483007	A07p12190.2_BraZ1	303	+	1987	4579	5175	0.8848309
A07	10487537	10496951	A07p12200.2_BraZ1	304.8	+	991	4460	9414	0.4737625
A07	10504399	10504657	A07p12210.2_BraZ1	216	-	92	258	258	1.0000000
A07	10507662	10523998	A07p12220.2_BraZ1	2150.87	+	4095	8497	16336	0.5201396
A07	10514003	10514321	A07p12230.2_BraZ1	31.8	+	614	318	318	1.0000000
A07	10514388	10515306	A07p12240.2_BraZ1	91.8	+	712	918	918	1.0000000
A07	10536351	10537600	A07p12250.2_BraZ1	590.318	-	8	130	1249	0.1040833
A07	10548116	10551531	A07p12260.2_BraZ1	177	+	478	3238	3415	0.9481698
A07	10557233	10557633	A07p12270.2_BraZ1	150	+	1	29	400	0.0725000
A07	10571316	10571472	A07p12280.2_BraZ1	15.6	+	41	156	156	1.0000000
A07	10584465	10606923	A07p12290.2_BraZ1	516	-	4257	13886	22458	0.6183097
A07	10612800	10613167	A07p12300.2_BraZ1	159	+	142	367	367	1.0000000
A07	10618780	10623869	A07p12310.2_BraZ1	1631.57	+	700	2368	5089	0.4653173
A07	10624370	10631943	A07p12320.2_BraZ1	339	+	6626	7074	7573	0.9341080
A07	10632125	10633823	A07p12330.2_BraZ1	1157	-	122	569	1698	0.3351001
A07	10636827	10638549	A07p12340.2_BraZ1	1045.23	-	106	1171	1722	0.6800233
A07	10645585	10646095	A07p12350.2_BraZ1	51	-	18	195	510	0.3823529
A07	10661866	10662277	A07p12360.2_BraZ1	41.1	+	228	411	411	1.0000000
A07	10668427	10671900	A07p12370.2_BraZ1	1871.37	-	655	2629	3473	0.7569824
A07	10673699	10675202	A07p12380.2_BraZ1	624.143	-	881	1503	1503	1.0000000
A07	10694690	10707395	A07p12390.2_BraZ1	1453.24	-	7996	12518	12705	0.9852814
A07	10710984	10711472	A07p12400.2_BraZ1	384	+	13	465	488	0.9528689
A07	10713250	10716230	A07p12410.2_BraZ1	72	+	903	2566	2980	0.8610739
A07	10719495	10721948	A07p12420.2_BraZ1	1092	-	1102	2453	2453	1.0000000
A07	10722372	10723716	A07p12430.2_BraZ1	693.239	-	305	1344	1344	1.0000000
A07	10724129	10724569	A07p12440.2_BraZ1	108	+	315	440	440	1.0000000
A07	10724915	10725329	A07p12450.2_BraZ1	41.4	-	141	390	414	0.9420290
A07	10727716	10729096	A07p12460.2_BraZ1	3606.75	+	1089	1380	1380	1.0000000
A07	10730281	10731103	A07p12470.2_BraZ1	472	-	436	822	822	1.0000000
A07	10734028	10734172	A07p12480.2_BraZ1	14.4	-	178	144	144	1.0000000
A07	10737290	10738091	A07p12490.2_BraZ1	4284	-	621	801	801	1.0000000
A07	10739262	10741972	A07p12500.2_BraZ1	2224.36	+	489	1993	2710	0.7354243
A07	10743821	10745493	A07p12510.2_BraZ1	1334.96	+	97	971	1672	0.5807416
A07	10745789	10747334	A07p12520.2_BraZ1	154.5	-	237	1470	1545	0.9514563
A07	10749934	10750582	A07p12530.2_BraZ1	64.8	+	316	648	648	1.0000000
A07	10750964	10755485	A07p12540.2_BraZ1	2764.67	-	1245	3810	4521	0.8427339
A07	10763167	10763896	A07p12550.2_BraZ1	72.9	+	173	574	729	0.7873800
A07	10766716	10767245	A07p12560.2_BraZ1	171	+	46	338	529	0.6389414
A07	10767754	10769712	A07p12570.2_BraZ1	1438.2	+	111	1275	1958	0.6511747
A07	10776690	10779794	A07p12580.2_BraZ1	1981.06	+	2026	3104	3104	1.0000000
A07	10782457	10786892	A07p12590.2_BraZ1	1826.14	+	3868	4428	4435	0.9984217
A07	10790022	10790139	A07p12600.2_BraZ1	11.7	+	70	117	117	1.0000000
A07	10792717	10793038	A07p12610.2_BraZ1	32.1	-	27	307	321	0.9563863
A07	10812189	10813050	A07p12620.2_BraZ1	433.304	-	459	861	861	1.0000000
A07	10824117	10830422	A07p12630.2_BraZ1	249	+	1437	2168	6305	0.3438541
A07	10839788	10840111	A07p12640.2_BraZ1	23.7	+	265	323	323	1.0000000
A07	10841561	10844100	A07p12650.2_BraZ1	1767.7	+	1765	2539	2539	1.0000000
A07	10844150	10846023	A07p12660.2_BraZ1	192	-	1840	1873	1873	1.0000000
A07	10850834	10852750	A07p12670.2_BraZ1	5844	-	861	1916	1916	1.0000000
A07	10857626	10859008	A07p12680.2_BraZ1	285.6	-	905	1382	1382	1.0000000
A07	10861174	10862233	A07p12690.2_BraZ1	346.214	-	599	1059	1059	1.0000000
A07	10867245	10868960	A07p12700.2_BraZ1	9562.5	-	1141	1715	1715	1.0000000
A07	10874281	10874965	A07p12710.2_BraZ1	68.4	-	62	397	684	0.5804093
A07	10896051	10896585	A07p12720.2_BraZ1	53.4	+	3	136	534	0.2546816
A07	10900009	10901276	A07p12730.2_BraZ1	303	-	488	1244	1267	0.9818469
A07	10905545	10906458	A07p12740.2_BraZ1	516	-	30	354	913	0.3877327
A07	10908310	10930930	A07p12750.2_BraZ1	1120.23	-	11533	15478	22620	0.6842617
A07	10936298	10937557	A07p12760.2_BraZ1	32025	+	49	341	1259	0.2708499
A07	10938324	10939124	A07p12770.2_BraZ1	321	+	615	800	800	1.0000000
A07	10939046	10939495	A07p12780.2_BraZ1	390	+	503	449	449	1.0000000
A07	10940755	10941781	A07p12790.2_BraZ1	384.091	-	718	1026	1026	1.0000000
A07	10953495	10953923	A07p12800.2_BraZ1	318	-	385	428	428	1.0000000
A07	10956154	10958848	A07p12810.2_BraZ1	1137	+	356	2164	2694	0.8032665
A07	10959607	10960141	A07p12820.2_BraZ1	53.4	-	368	534	534	1.0000000
A07	10963115	10964087	A07p12830.2_BraZ1	6674	-	702	972	972	1.0000000
A07	10968642	10970178	A07p12840.2_BraZ1	625.6	-	1547	1536	1536	1.0000000
A07	10977191	10977878	A07p12850.2_BraZ1	177	-	114	659	687	0.9592431
A07	10978359	10979683	A07p12860.2_BraZ1	171	-	622	1277	1324	0.9645015
A07	10984643	10985702	A07p12870.2_BraZ1	597	-	1237	1059	1059	1.0000000
A07	10996257	10998070	A07p12880.2_BraZ1	2795	+	321	1508	1813	0.8317705
A07	10998904	11004247	A07p12890.2_BraZ1	883.2	+	5662	5343	5343	1.0000000
A07	11014540	11018646	A07p12900.2_BraZ1	893.206	+	3260	4106	4106	1.0000000
A07	11022402	11024050	A07p12910.2_BraZ1	891	+	1077	1648	1648	1.0000000
A07	11028576	11033618	A07p12920.2_BraZ1	870.75	+	3580	4980	5042	0.9877033
A07	11033679	11033790	A07p12930.2_BraZ1	11.1	+	56	111	111	1.0000000
A07	11034259	11034991	A07p12940.2_BraZ1	657	+	175	732	732	1.0000000
A07	11035526	11035862	A07p12950.2_BraZ1	33.6	-	92	281	336	0.8363096
A07	11037813	11040645	A07p12960.2_BraZ1	795.2	-	2035	2822	2832	0.9964689
A07	11040750	11041026	A07p12970.2_BraZ1	27.6	-	328	276	276	1.0000000
A07	11043805	11044216	A07p12980.2_BraZ1	41.1	+	103	392	411	0.9537713
A07	11050453	11051187	A07p12990.2_BraZ1	333	-	526	734	734	1.0000000
A07	11065152	11065872	A07p13000.2_BraZ1	72	+	84	379	720	0.5263889
A07	11067062	11068527	A07p13010.2_BraZ1	813.75	-	97	792	1465	0.5406143
A07	11073869	11077062	A07p13020.2_BraZ1	2997	-	405	2638	3193	0.8261822
A07	11081545	11082077	A07p13030.2_BraZ1	402	+	116	458	532	0.8609022
A07	11087090	11087351	A07p13040.2_BraZ1	26.1	-	11	101	261	0.3869732
A07	11091389	11093027	A07p13050.2_BraZ1	594	-	1771	1621	1638	0.9896215
A07	11096609	11097679	A07p13060.2_BraZ1	492	+	10	187	1070	0.1747664
A07	11097913	11099995	A07p13070.2_BraZ1	914.696	+	1537	2019	2082	0.9697406
A07	11107714	11108023	A07p13080.2_BraZ1	30.9	-	12	23	309	0.0744337
A07	11110612	11110919	A07p13090.2_BraZ1	29.7	-	75	307	307	1.0000000
A07	11118775	11119282	A07p13100.2_BraZ1	50.7	+	126	453	507	0.8934911
A07	11122567	11123101	A07p13110.2_BraZ1	53.4	-	213	534	534	1.0000000
A07	11136002	11141673	A07p13120.2_BraZ1	1763.01	-	2726	5279	5671	0.9308764
A07	11150046	11150538	A07p13130.2_BraZ1	615	+	1196	492	492	1.0000000
A07	11158507	11159681	A07p13140.2_BraZ1	984	+	58	761	1174	0.6482112
A07	11161425	11161973	A07p13150.2_BraZ1	378	+	470	548	548	1.0000000
A07	11166126	11169436	A07p13160.2_BraZ1	870	+	1508	2205	3310	0.6661631
A07	11170032	11170278	A07p13170.2_BraZ1	24.6	+	12	46	246	0.1869919
A07	11178489	11178823	A07p13180.2_BraZ1	267	+	284	334	334	1.0000000
A07	11185648	11186741	A07p13190.2_BraZ1	414.75	-	1745	1093	1093	1.0000000
A07	11199649	11201076	A07p13200.2_BraZ1	1152	+	132	894	1427	0.6264892
A07	11205205	11205449	A07p13210.2_BraZ1	177	+	13	182	244	0.7459016
A07	11206648	11207380	A07p13220.2_BraZ1	73.2	+	49	643	732	0.8784153
A07	11211062	11211644	A07p13230.2_BraZ1	216	+	0	0	582	0.0000000
A07	11215857	11217278	A07p13240.2_BraZ1	492	-	1215	1328	1421	0.9345531
A07	11218419	11219135	A07p13250.2_BraZ1	26.4	-	568	716	716	1.0000000
A07	11228898	11232038	A07p13260.2_BraZ1	1655.06	+	1232	2951	3140	0.9398089
A07	11233611	11233834	A07p13270.2_BraZ1	138	+	314	223	223	1.0000000
A07	11243743	11244874	A07p13280.2_BraZ1	1050	+	28	675	1131	0.5968170
A07	11246024	11247956	A07p13290.2_BraZ1	1546.88	-	1741	1931	1932	0.9994824
A07	11250010	11250295	A07p13300.2_BraZ1	28.5	+	369	285	285	1.0000000
A07	11252917	11253643	A07p13310.2_BraZ1	72.6	-	30	534	726	0.7355372
A07	11260709	11261242	A07p13320.2_BraZ1	375	+	309	533	533	1.0000000
A07	11273926	11276862	A07p13330.2_BraZ1	1384.98	-	201	944	2936	0.3215259
A07	11287556	11288285	A07p13340.2_BraZ1	72.9	+	9	330	729	0.4526749
A07	11302623	11303887	A07p13350.2_BraZ1	777.333	+	1035	1205	1264	0.9533228
A07	11304442	11306354	A07p13360.2_BraZ1	744.708	-	513	1673	1912	0.8750000
A07	11310364	11311345	A07p13370.2_BraZ1	507	-	450	948	981	0.9663609
A07	11314059	11315149	A07p13380.2_BraZ1	930	+	781	1090	1090	1.0000000
A07	11316191	11316718	A07p13390.2_BraZ1	372	-	440	527	527	1.0000000
A07	11318851	11319119	A07p13400.2_BraZ1	192	+	218	268	268	1.0000000
A07	11323556	11324878	A07p13410.2_BraZ1	591	-	722	1226	1322	0.9273828
A07	11328011	11328881	A07p13420.2_BraZ1	87	+	76	595	870	0.6839080
A07	11329811	11330024	A07p13430.2_BraZ1	21.3	-	336	213	213	1.0000000
A07	11333645	11338431	A07p13440.2_BraZ1	2482.72	-	1554	4437	4786	0.9270790
A07	11339221	11340056	A07p13450.2_BraZ1	336	-	425	835	835	1.0000000
A07	11343387	11348076	A07p13460.2_BraZ1	673.684	-	1979	3941	4689	0.8404777
A07	11349315	11350626	A07p13470.2_BraZ1	938.667	-	924	1311	1311	1.0000000
A07	11368899	11369231	A07p13480.2_BraZ1	276	+	0	0	332	0.0000000
A07	11375469	11377002	A07p13490.2_BraZ1	1238.53	-	541	1106	1533	0.7214612
A07	11382516	11387366	A07p13500.2_BraZ1	1947.47	+	1760	4186	4850	0.8630928
A07	11387446	11387935	A07p13510.2_BraZ1	48.9	-	196	489	489	1.0000000
A07	11389276	11390371	A07p13520.2_BraZ1	711	+	479	1095	1095	1.0000000
A07	11398043	11399977	A07p13530.2_BraZ1	1237.5	-	343	1837	1934	0.9498449
A07	11406811	11406946	A07p13540.2_BraZ1	13.5	+	417	135	135	1.0000000
A07	11408346	11409209	A07p13550.2_BraZ1	726	-	427	835	863	0.9675550
A07	11411026	11413266	A07p13560.2_BraZ1	828.96	-	982	2199	2240	0.9816964
A07	11426739	11428584	A07p13570.2_BraZ1	1158	+	540	1566	1845	0.8487805
A07	11430178	11431222	A07p13580.2_BraZ1	525	+	362	963	1044	0.9224138
A07	11432311	11433169	A07p13590.2_BraZ1	85.8	-	437	858	858	1.0000000
A07	11433802	11435711	A07p13600.2_BraZ1	1332	-	1063	1540	1909	0.8067051
A07	11445035	11446451	A07p13610.2_BraZ1	1185.9	+	535	1237	1416	0.8735875
A07	11447572	11448176	A07p13620.2_BraZ1	222	+	693	604	604	1.0000000
A07	11448783	11449972	A07p13630.2_BraZ1	991.667	-	341	1183	1189	0.9949538
A07	11454044	11454233	A07p13640.2_BraZ1	18.9	+	68	189	189	1.0000000
A07	11459204	11461958	A07p13650.2_BraZ1	2790	+	1976	2500	2754	0.9077705
A07	11463714	11467658	A07p13660.2_BraZ1	2598.11	-	1858	3944	3944	1.0000000
A07	11473063	11474432	A07p13670.2_BraZ1	876.75	-	273	1369	1369	1.0000000
A07	11476135	11481330	A07p13680.2_BraZ1	511.2	-	5948	5018	5195	0.9659288
A07	11483008	11485951	A07p13690.2_BraZ1	816	-	1607	2940	2943	0.9989806
A07	11486284	11486833	A07p13700.2_BraZ1	54.9	+	87	549	549	1.0000000
A07	11486988	11487090	A07p13710.2_BraZ1	10.2	+	169	102	102	1.0000000
A07	11487878	11489059	A07p13720.2_BraZ1	561.6	+	1062	1181	1181	1.0000000
A07	11489569	11491307	A07p13730.2_BraZ1	556.5	+	702	1729	1738	0.9948216
A07	11492076	11493090	A07p13740.2_BraZ1	2706	+	652	1014	1014	1.0000000
A07	11493971	11494298	A07p13750.2_BraZ1	32.7	+	310	326	327	0.9969419
A07	11501853	11503230	A07p13760.2_BraZ1	1245.54	+	447	1377	1377	1.0000000
A07	11504039	11505543	A07p13770.2_BraZ1	987.275	-	517	1399	1504	0.9301862
A07	11508419	11515884	A07p13780.2_BraZ1	255.867	+	2030	7085	7465	0.9490958
A07	11508972	11511739	A07p13790.2_BraZ1	1027.68	+	398	2563	2767	0.9262739
A07	11516177	11518223	A07p13800.2_BraZ1	1344.61	-	1100	1831	2046	0.8949169
A07	11520285	11520788	A07p13810.2_BraZ1	2691	-	300	503	503	1.0000000
A07	11521884	11522465	A07p13820.2_BraZ1	45.3333	-	750	581	581	1.0000000
A07	11525856	11529670	A07p13830.2_BraZ1	2827.78	-	1166	3559	3814	0.9331411
A07	11531054	11531405	A07p13840.2_BraZ1	297	-	3	58	351	0.1652422
A07	11532104	11532845	A07p13850.2_BraZ1	504	+	490	733	741	0.9892038
A07	11533120	11534213	A07p13860.2_BraZ1	597	-	753	1093	1093	1.0000000
A07	11535002	11535488	A07p13870.2_BraZ1	48.6	-	196	486	486	1.0000000
A07	11537248	11539319	A07p13880.2_BraZ1	544.762	-	178	1223	2071	0.5905360
A07	11543018	11543337	A07p13890.2_BraZ1	246	+	0	0	319	0.0000000
A07	11543345	11543676	A07p13900.2_BraZ1	21.0909	+	0	0	331	0.0000000
A07	11546579	11547562	A07p13910.2_BraZ1	315	-	512	977	983	0.9938962
A07	11550295	11553070	A07p13920.2_BraZ1	1365.68	+	1492	2687	2775	0.9682883
A07	11553317	11554877	A07p13930.2_BraZ1	156	-	152	1181	1560	0.7570513
A07	11556389	11561185	A07p13940.2_BraZ1	2134.27	-	2572	4573	4796	0.9535029
A07	11562487	11565539	A07p13950.2_BraZ1	2044.23	+	1221	2973	3052	0.9741153
A07	11567526	11567962	A07p13960.2_BraZ1	279	+	510	416	436	0.9541284
A07	11568613	11571553	A07p13970.2_BraZ1	2068.26	+	877	2820	2940	0.9591837
A07	11571784	11572755	A07p13980.2_BraZ1	515.1	-	1267	971	971	1.0000000
A07	11573344	11575603	A07p13990.2_BraZ1	881.865	+	2139	2259	2259	1.0000000
A07	11576397	11578449	A07p14000.2_BraZ1	1249.13	-	342	1668	2052	0.8128655
A07	11585345	11586503	A07p14010.2_BraZ1	504.947	+	625	1125	1158	0.9715026
A07	11589644	11589977	A07p14020.2_BraZ1	252	+	7	11	333	0.0330330
A07	11590246	11591959	A07p14030.2_BraZ1	462.375	+	127	1209	1713	0.7057793
A07	11592599	11594542	A07p14040.2_BraZ1	780	-	115	1165	1943	0.5995883
A07	11600295	11608900	A07p14050.2_BraZ1	816.87	+	2465	5174	8605	0.6012783
A07	11610229	11610952	A07p14060.2_BraZ1	72.3	-	161	573	723	0.7925311
A07	11614548	11616996	A07p14070.2_BraZ1	1079.94	+	599	2094	2448	0.8553922
A07	11617353	11619626	A07p14080.2_BraZ1	1061.93	-	1520	2273	2273	1.0000000
A07	11619985	11622574	A07p14090.2_BraZ1	1427.54	+	1078	2403	2589	0.9281576
A07	11624250	11626832	A07p14100.2_BraZ1	1539.54	-	1161	2582	2582	1.0000000
A07	11629050	11629410	A07p14110.2_BraZ1	36	+	5	96	360	0.2666667
A07	11633414	11635454	A07p14120.2_BraZ1	802	+	1043	1552	2040	0.7607843
A07	11641584	11642841	A07p14130.2_BraZ1	125.7	+	155	892	1257	0.7096261
A07	11645775	11646099	A07p14140.2_BraZ1	279	-	414	324	324	1.0000000
A07	11655665	11657966	A07p14150.2_BraZ1	460	-	1833	2301	2301	1.0000000
A07	11659389	11660937	A07p14160.2_BraZ1	660	+	1773	1548	1548	1.0000000
A07	11667485	11669707	A07p14170.2_BraZ1	938.955	+	429	2030	2222	0.9135914
A07	11671376	11671898	A07p14180.2_BraZ1	1674	-	0	0	522	0.0000000
A07	11675166	11675379	A07p14190.2_BraZ1	18.9	-	90	210	213	0.9859155
A07	11682838	11683726	A07p14200.2_BraZ1	88.8	-	15	483	888	0.5439189
A07	11684416	11684527	A07p14210.2_BraZ1	11.1	+	69	111	111	1.0000000
A07	11698572	11698779	A07p14220.2_BraZ1	20.7	+	118	207	207	1.0000000
A07	11699514	11700069	A07p14230.2_BraZ1	55.5	-	60	490	555	0.8828829
A07	11701482	11702127	A07p14240.2_BraZ1	64.5	-	51	293	645	0.4542636
A07	11710493	11710938	A07p14250.2_BraZ1	270	-	1	34	445	0.0764045
A07	11714250	11714953	A07p14260.2_BraZ1	276	-	0	0	703	0.0000000
A07	11717883	11720639	A07p14270.2_BraZ1	2670	+	37	815	2756	0.2957184
A07	11728535	11730424	A07p14280.2_BraZ1	564	+	686	1728	1889	0.9147697
A07	11730925	11733949	A07p14290.2_BraZ1	1688.34	-	1525	3024	3024	1.0000000
A07	11742737	11744484	A07p14300.2_BraZ1	534	-	1566	1747	1747	1.0000000
A07	11744587	11746365	A07p14310.2_BraZ1	1029.3	-	700	1744	1778	0.9808774
A07	11748169	11749309	A07p14320.2_BraZ1	114	+	483	983	1140	0.8622807
A07	11749760	11751090	A07p14330.2_BraZ1	576.145	-	1484	1330	1330	1.0000000
A07	11751703	11752219	A07p14340.2_BraZ1	51.6	-	501	516	516	1.0000000
A07	11754878	11755236	A07p14350.2_BraZ1	198	+	73	299	358	0.8351955
A07	11755337	11761754	A07p14360.2_BraZ1	67.8	-	5086	6181	6417	0.9632227
A07	11761777	11761882	A07p14370.2_BraZ1	10.5	-	226	105	105	1.0000000
A07	11765231	11767868	A07p14380.2_BraZ1	864.935	+	925	2366	2637	0.8972317
A07	11772047	11773662	A07p14390.2_BraZ1	1258	+	454	1615	1615	1.0000000
A07	11774181	11775603	A07p14400.2_BraZ1	142.2	-	296	1272	1422	0.8945147
A07	11786082	11791515	A07p14410.2_BraZ1	432	+	1610	5038	5433	0.9272962
A07	11793750	11793930	A07p14420.2_BraZ1	18	+	222	180	180	1.0000000
A07	11803202	11804545	A07p14430.2_BraZ1	4061.25	-	832	1325	1343	0.9865972
A07	11807071	11808555	A07p14440.2_BraZ1	324	-	1590	1484	1484	1.0000000
A07	11809828	11811497	A07p14450.2_BraZ1	703.977	-	1585	1669	1669	1.0000000
A07	11814307	11816942	A07p14460.2_BraZ1	1430.86	-	1024	2433	2635	0.9233397
A07	11821443	11822473	A07p14470.2_BraZ1	375.75	+	4	143	1030	0.1388350
A07	11822721	11823745	A07p14480.2_BraZ1	87.3	-	474	1024	1024	1.0000000
A07	11826465	11828371	A07p14490.2_BraZ1	831.228	+	1395	1906	1906	1.0000000
A07	11831702	11832044	A07p14500.2_BraZ1	34.2	+	12	123	342	0.3596491
A07	11841343	11841547	A07p14510.2_BraZ1	20.4	-	287	204	204	1.0000000
A07	11852745	11853129	A07p14520.2_BraZ1	38.4	+	7	173	384	0.4505208
A07	11861133	11862510	A07p14530.2_BraZ1	19018.5	-	251	1258	1377	0.9135802
A07	11866501	11878927	A07p14540.2_BraZ1	1497.18	+	7339	11934	12426	0.9604056
A07	11871676	11873140	A07p14550.2_BraZ1	146.4	-	296	1234	1464	0.8428962
A07	11881377	11882782	A07p14560.2_BraZ1	873.214	+	616	1394	1405	0.9921708
A07	11889852	11897948	A07p14570.2_BraZ1	2113.06	-	5157	7848	8096	0.9693676
A07	11905319	11910211	A07p14580.2_BraZ1	3106.94	+	1688	4424	4892	0.9043336
A07	11911628	11912337	A07p14590.2_BraZ1	357	-	8	294	709	0.4146686
A07	11914727	11915343	A07p14600.2_BraZ1	401.143	+	463	616	616	1.0000000
A07	11919912	11920272	A07p14610.2_BraZ1	172.714	-	86	325	360	0.9027778
A07	11921408	11930098	A07p14620.2_BraZ1	222	+	6894	8675	8690	0.9982738
A07	11925659	11927694	A07p14630.2_BraZ1	687	+	1821	2020	2035	0.9926290
A07	11931947	11934210	A07p14640.2_BraZ1	696	+	1210	2152	2263	0.9509501
A07	11936046	11940371	A07p14650.2_BraZ1	687	+	1805	4150	4325	0.9595376
A07	11940823	11947673	A07p14660.2_BraZ1	1796.79	-	3838	6472	6850	0.9448175
A07	11948042	11950995	A07p14670.2_BraZ1	1774.45	-	1239	2953	2953	1.0000000
A07	11954244	11954484	A07p14680.2_BraZ1	24	-	14	182	240	0.7583333
A07	11954812	11954962	A07p14690.2_BraZ1	15	-	5	112	150	0.7466667
A07	11961390	11962330	A07p14700.2_BraZ1	198	-	762	915	940	0.9734042
A07	11962555	11963035	A07p14710.2_BraZ1	48	+	790	480	480	1.0000000
A07	11964221	11965276	A07p14720.2_BraZ1	365.125	-	775	1055	1055	1.0000000
A07	11966373	11969239	A07p14730.2_BraZ1	1688.89	-	1697	2748	2866	0.9588276
A07	11976240	11977049	A07p14740.2_BraZ1	604.8	+	2	19	809	0.0234858
A07	11977482	11978247	A07p14750.2_BraZ1	204	-	37	266	765	0.3477124
A07	11977855	11978079	A07p14760.2_BraZ1	132	-	5	23	224	0.1026786
A07	11981076	11982385	A07p14770.2_BraZ1	7416	+	110	855	1309	0.6531703
A07	11982705	11983992	A07p14780.2_BraZ1	680.6	-	2	120	1287	0.0932401
A07	11988026	11988663	A07p14790.2_BraZ1	252.167	-	75	560	637	0.8791209
A07	12004067	12005300	A07p14800.2_BraZ1	574.583	-	1236	1176	1233	0.9537713
A07	12011165	12012009	A07p14810.2_BraZ1	216	+	25	709	844	0.8400474
A07	12012931	12013704	A07p14820.2_BraZ1	343.2	+	458	770	773	0.9961190
A07	12013993	12015347	A07p14830.2_BraZ1	664.865	-	687	1354	1354	1.0000000
A07	12018541	12019632	A07p14840.2_BraZ1	876	+	907	1091	1091	1.0000000
A07	12020993	12022037	A07p14850.2_BraZ1	104.4	+	1057	1044	1044	1.0000000
A07	12022581	12022935	A07p14860.2_BraZ1	35.4	+	260	354	354	1.0000000
A07	12024380	12025646	A07p14870.2_BraZ1	126.6	+	110	1088	1266	0.8593997
A07	12026299	12029242	A07p14880.2_BraZ1	2557.41	-	1501	2735	2943	0.9293238
A07	12034082	12040018	A07p14890.2_BraZ1	667.321	+	4341	5927	5936	0.9984838
A07	12040484	12041839	A07p14900.2_BraZ1	621.214	+	1535	1355	1355	1.0000000
A07	12043737	12044114	A07p14910.2_BraZ1	294	+	377	377	377	1.0000000
A07	12046783	12046939	A07p14920.2_BraZ1	15.6	-	19	153	156	0.9807692
A07	12049119	12053625	A07p14930.2_BraZ1	2105.83	+	2261	4348	4506	0.9649357
A07	12060304	12061210	A07p14940.2_BraZ1	417.125	-	474	906	906	1.0000000
A07	12061639	12062764	A07p14950.2_BraZ1	579	+	643	1125	1125	1.0000000
A07	12066105	12066370	A07p14960.2_BraZ1	153	+	278	265	265	1.0000000
A07	12068219	12068669	A07p14970.2_BraZ1	45	+	375	450	450	1.0000000
A07	12071746	12071927	A07p14980.2_BraZ1	15	-	520	181	181	1.0000000
A07	12073644	12074100	A07p14990.2_BraZ1	45.6	+	160	441	456	0.9671053
A07	12081842	12082280	A07p15000.2_BraZ1	43.8	+	32	134	438	0.3059361
A07	12085939	12086593	A07p15010.2_BraZ1	65.4	-	98	634	654	0.9694189
A07	12087083	12089407	A07p15020.2_BraZ1	1822.86	-	656	2006	2324	0.8631669
A07	12092325	12093361	A07p15030.2_BraZ1	724.75	-	75	932	1036	0.8996139
A07	12094510	12094636	A07p15040.2_BraZ1	12.6	+	85	126	126	1.0000000
A07	12101020	12104994	A07p15050.2_BraZ1	403.75	+	1193	2475	3974	0.6227982
A07	12108276	12110761	A07p15060.2_BraZ1	1798.14	-	1371	2436	2485	0.9802817
A07	12115162	12115362	A07p15070.2_BraZ1	168	+	215	200	200	1.0000000
A07	12132210	12133051	A07p15080.2_BraZ1	285	+	124	840	841	0.9988109
A07	12136690	12137816	A07p15090.2_BraZ1	559	+	122	749	1126	0.6651865
A07	12138812	12139358	A07p15100.2_BraZ1	249	+	12	242	546	0.4432234
A07	12140465	12140603	A07p15110.2_BraZ1	13.8	+	0	0	138	0.0000000
A07	12169420	12169567	A07p15120.2_BraZ1	14.7	-	255	147	147	1.0000000
A07	12169853	12170905	A07p15130.2_BraZ1	336	+	1452	1052	1052	1.0000000
A07	12173543	12174644	A07p15140.2_BraZ1	514.688	+	1471	1101	1101	1.0000000
A07	12175242	12179497	A07p15150.2_BraZ1	827.26	+	864	1873	4255	0.4401880
A07	12183799	12193260	A07p15160.2_BraZ1	587.1	+	794	6278	9461	0.6635662
A07	12194424	12194652	A07p15170.2_BraZ1	22.8	-	5	65	228	0.2850877
A07	12200575	12201516	A07p15180.2_BraZ1	231	+	30	654	941	0.6950053
A07	12205993	12210792	A07p15190.2_BraZ1	1516.12	+	3771	4677	4799	0.9745780
A07	12221110	12224051	A07p15200.2_BraZ1	1487.93	-	274	1752	2941	0.5957158
A07	12228884	12229513	A07p15210.2_BraZ1	7614	+	498	629	629	1.0000000
A07	12237282	12237672	A07p15220.2_BraZ1	243	+	273	390	390	1.0000000
A07	12241718	12244754	A07p15230.2_BraZ1	1707	+	520	2222	3036	0.7318841
A07	12245038	12247579	A07p15240.2_BraZ1	234.783	-	1450	2539	2541	0.9992129
A07	12251020	12255749	A07p15250.2_BraZ1	2338.89	-	2361	3823	4729	0.8084161
A07	12258301	12259903	A07p15260.2_BraZ1	69.0789	-	342	1136	1602	0.7091136
A07	12260387	12265776	A07p15270.2_BraZ1	2450.67	-	1377	4210	5389	0.7812210
A07	12267469	12270926	A07p15280.2_BraZ1	358.6	-	1211	2917	3457	0.8437952
A07	12279443	12281796	A07p15290.2_BraZ1	1776.7	+	1178	2266	2353	0.9630259
A07	12282966	12284159	A07p15300.2_BraZ1	59.1	+	592	1143	1193	0.9580889
A07	12285198	12285510	A07p15310.2_BraZ1	31.2	-	0	0	312	0.0000000
A07	12292436	12295124	A07p15320.2_BraZ1	1239.98	+	1022	2667	2688	0.9921875
A07	12297840	12306348	A07p15330.2_BraZ1	20067.3	+	1605	5250	8508	0.6170663
A07	12306815	12307088	A07p15340.2_BraZ1	240	+	375	273	273	1.0000000
A07	12309201	12309565	A07p15350.2_BraZ1	261	+	207	364	364	1.0000000
A07	12310620	12312762	A07p15360.2_BraZ1	1111.63	+	1543	2142	2142	1.0000000
A07	12316199	12317348	A07p15370.2_BraZ1	114.9	+	225	901	1149	0.7841601
A07	12321619	12322071	A07p15380.2_BraZ1	300	-	167	423	452	0.9358407
A07	12323557	12324043	A07p15390.2_BraZ1	378	+	12	355	486	0.7304527
A07	12329591	12334335	A07p15400.2_BraZ1	1456.29	+	2436	2953	4744	0.6224705
A07	12334675	12335834	A07p15410.2_BraZ1	436.696	-	589	1135	1159	0.9792925
A07	12342189	12342916	A07p15420.2_BraZ1	3042	+	41	330	727	0.4539202
A07	12347582	12348011	A07p15430.2_BraZ1	339	+	15	126	429	0.2937063
A07	12351000	12352148	A07p15440.2_BraZ1	554.2	+	1438	1139	1148	0.9921603
A07	12356180	12361775	A07p15450.2_BraZ1	2322.04	-	1228	5151	5595	0.9206434
A07	12365242	12366297	A07p15460.2_BraZ1	292.5	+	926	1055	1055	1.0000000
A07	12366637	12368199	A07p15470.2_BraZ1	10848	+	2701	1562	1562	1.0000000
A07	12370012	12370691	A07p15480.2_BraZ1	213	+	442	674	679	0.9926362
A07	12379592	12380696	A07p15490.2_BraZ1	110.1	+	820	1104	1104	1.0000000
A07	12380946	12384055	A07p15500.2_BraZ1	634.578	-	1924	3036	3109	0.9765198
A07	12387330	12387869	A07p15510.2_BraZ1	316.25	-	549	539	539	1.0000000
A07	12388616	12390020	A07p15520.2_BraZ1	140.4	+	878	1404	1404	1.0000000
A07	12390378	12390916	A07p15530.2_BraZ1	411	-	104	522	538	0.9702602
A07	12392007	12393926	A07p15540.2_BraZ1	739.481	-	905	1775	1919	0.9249609
A07	12398051	12401396	A07p15550.2_BraZ1	507.78	+	1271	2711	3345	0.8104634
A07	12401238	12421658	A07p15560.2_BraZ1	1053.09	+	8234	17288	20420	0.8466210
A07	12412649	12413047	A07p15570.2_BraZ1	124.8	-	117	398	398	1.0000000
A07	12413213	12413586	A07p15580.2_BraZ1	156.75	-	245	373	373	1.0000000
A07	12417094	12417356	A07p15590.2_BraZ1	216	-	124	262	262	1.0000000
A07	12423873	12425092	A07p15600.2_BraZ1	722.87	-	373	1219	1219	1.0000000
A07	12430055	12430604	A07p15610.2_BraZ1	54.9	-	4	41	549	0.0746812
A07	12431687	12433355	A07p15620.2_BraZ1	777.45	-	1139	1649	1668	0.9886091
A07	12442159	12454348	A07p15630.2_BraZ1	1275.72	-	6940	11589	12189	0.9507753
A07	12449982	12451695	A07p15640.2_BraZ1	780	-	313	1296	1713	0.7565674
A07	12457432	12462966	A07p15650.2_BraZ1	1399.11	+	2535	5315	5534	0.9604264
A07	12463918	12464359	A07p15660.2_BraZ1	44.1	-	113	441	441	1.0000000
A07	12465332	12468732	A07p15670.2_BraZ1	551.72	+	2178	3300	3400	0.9705882
A07	12469168	12476346	A07p15680.2_BraZ1	4213.06	-	2710	6853	7178	0.9547228
A07	12476731	12477994	A07p15690.2_BraZ1	414	-	854	1113	1263	0.8812352
A07	12480054	12480729	A07p15700.2_BraZ1	67.5	+	364	669	675	0.9911111
A07	12485605	12488156	A07p15710.2_BraZ1	1750.05	-	1529	2490	2551	0.9760878
A07	12496360	12496919	A07p15720.2_BraZ1	480	-	701	559	559	1.0000000
A07	12502749	12503541	A07p15730.2_BraZ1	480	-	419	792	792	1.0000000
A07	12513481	12515280	A07p15740.2_BraZ1	578.143	+	1297	1799	1799	1.0000000
A07	12516089	12516441	A07p15750.2_BraZ1	249	+	131	352	352	1.0000000
A07	12520480	12522440	A07p15760.2_BraZ1	490.286	+	19	296	1960	0.1510204
A07	12526874	12528207	A07p15770.2_BraZ1	318	+	0	0	1333	0.0000000
A07	12528393	12529465	A07p15780.2_BraZ1	351	+	4	49	1072	0.0457090
A07	12534972	12535128	A07p15790.2_BraZ1	15.6	+	2	124	156	0.7948718
A07	12536589	12537039	A07p15800.2_BraZ1	141	-	2	165	450	0.3666667
A07	12544803	12550345	A07p15810.2_BraZ1	1746.32	+	2224	5168	5542	0.9325153
A07	12551863	12552268	A07p15820.2_BraZ1	40.5	-	182	405	405	1.0000000
A07	12552340	12552547	A07p15830.2_BraZ1	20.7	-	85	207	207	1.0000000
A07	12554115	12556577	A07p15840.2_BraZ1	1695.94	+	390	1787	2462	0.7258326
A07	12575134	12575462	A07p15850.2_BraZ1	285	+	572	328	328	1.0000000
A07	12577550	12579339	A07p15860.2_BraZ1	5362.5	+	521	1185	1789	0.6623812
A07	12584186	12584621	A07p15870.2_BraZ1	43.5	-	222	435	435	1.0000000
A07	12586908	12589075	A07p15880.2_BraZ1	1767	-	642	2042	2167	0.9423166
A07	12594211	12595217	A07p15890.2_BraZ1	819	-	158	913	1006	0.9075547
A07	12615894	12616652	A07p15900.2_BraZ1	4735.5	-	8	161	758	0.2124011
A07	12623745	12625132	A07p15910.2_BraZ1	501	+	390	1130	1387	0.8147080
A07	12630814	12632989	A07p15920.2_BraZ1	1038.87	+	1129	2074	2175	0.9535632
A07	12634042	12636290	A07p15930.2_BraZ1	613.125	-	1100	2156	2248	0.9590747
A07	12642065	12643757	A07p15940.2_BraZ1	1423.53	-	831	1647	1692	0.9734042
A07	12654058	12655059	A07p15950.2_BraZ1	227.5	+	2023	1001	1001	1.0000000
A07	12658816	12660485	A07p15960.2_BraZ1	903.491	+	1363	1669	1669	1.0000000
A07	12661002	12661639	A07p15970.2_BraZ1	336.175	-	216	637	637	1.0000000
A07	12663016	12663469	A07p15980.2_BraZ1	44.7	+	657	453	453	1.0000000
A07	12665078	12668481	A07p15990.2_BraZ1	1507.5	-	2498	3403	3403	1.0000000
A07	12669103	12670987	A07p16000.2_BraZ1	15810	+	701	1783	1884	0.9463906
A07	12671176	12671860	A07p16010.2_BraZ1	68.4	-	397	684	684	1.0000000
A07	12675494	12676228	A07p16020.2_BraZ1	309	+	1041	734	734	1.0000000
A07	12717830	12718050	A07p16030.2_BraZ1	18	-	25	147	220	0.6681818
A07	12718747	12728093	A07p16040.2_BraZ1	1306.95	+	3219	7732	9346	0.8273058
A07	12733732	12735019	A07p16050.2_BraZ1	639.48	+	288	1286	1287	0.9992230
A07	12735235	12739764	A07p16060.2_BraZ1	1552.61	-	1783	4309	4529	0.9514242
A07	12748800	12749818	A07p16070.2_BraZ1	705.091	-	656	1018	1018	1.0000000
A07	12760129	12764904	A07p16080.2_BraZ1	2039.9	+	1352	4291	4775	0.8986387
A07	12765632	12766878	A07p16090.2_BraZ1	1155	+	154	1127	1246	0.9044944
A07	12767232	12767721	A07p16100.2_BraZ1	48.9	-	76	248	489	0.5071574
A07	12778898	12779604	A07p16110.2_BraZ1	213	+	284	569	706	0.8059490
A07	12784749	12785277	A07p16120.2_BraZ1	450	+	1	16	528	0.0303030
A07	12793750	12796015	A07p16130.2_BraZ1	1643.73	+	305	1708	2265	0.7540839
A07	12802183	12802636	A07p16140.2_BraZ1	438	+	429	453	453	1.0000000
A07	12804012	12805322	A07p16150.2_BraZ1	528.75	+	477	1287	1310	0.9824427
A07	12805602	12806637	A07p16160.2_BraZ1	103.5	-	125	715	1035	0.6908212
A07	12830859	12833590	A07p16170.2_BraZ1	912	+	1007	2237	2731	0.8191139
A07	12840208	12840978	A07p16180.2_BraZ1	282	+	691	770	770	1.0000000
A07	12849195	12849525	A07p16190.2_BraZ1	33	+	181	299	330	0.9060606
A07	12850251	12850572	A07p16200.2_BraZ1	30	+	35	214	321	0.6666667
A07	12855462	12856745	A07p16210.2_BraZ1	687.225	-	748	1283	1283	1.0000000
A07	12857173	12860161	A07p16220.2_BraZ1	1103.18	-	739	2274	2988	0.7610442
A07	12865184	12866783	A07p16230.2_BraZ1	159.9	+	1331	1599	1599	1.0000000
A07	12867275	12868496	A07p16240.2_BraZ1	786	-	598	1156	1221	0.9467649
A07	12883152	12885903	A07p16250.2_BraZ1	1467	+	1133	2525	2751	0.9178481
A07	12886744	12888297	A07p16260.2_BraZ1	1467	+	197	911	1553	0.5866066
A07	12891576	12894204	A07p16270.2_BraZ1	1536	+	2761	2628	2628	1.0000000
A07	12898207	12900469	A07p16280.2_BraZ1	607.091	-	681	2139	2262	0.9456233
A07	12908568	12910243	A07p16290.2_BraZ1	2616	+	804	1663	1675	0.9928358
A07	12911990	12913464	A07p16300.2_BraZ1	661.851	+	950	1474	1474	1.0000000
A07	12914466	12915813	A07p16310.2_BraZ1	721.65	-	968	1347	1347	1.0000000
A07	12919055	12919748	A07p16320.2_BraZ1	492	+	807	693	693	1.0000000
A07	12920330	12921020	A07p16330.2_BraZ1	600	-	120	565	690	0.8188406
A07	12929130	12931307	A07p16340.2_BraZ1	1039.09	-	1271	2037	2177	0.9356913
A07	12942834	12943680	A07p16350.2_BraZ1	84.6	-	441	638	846	0.7541371
A07	12948512	12949469	A07p16360.2_BraZ1	95.7	-	559	957	957	1.0000000
A07	12965431	12967593	A07p16370.2_BraZ1	15554.2	+	1495	2162	2162	1.0000000
A07	12968886	12970465	A07p16380.2_BraZ1	159	+	1534	1579	1579	1.0000000
A07	12971491	12973193	A07p16390.2_BraZ1	821.25	-	712	1649	1702	0.9688601
A07	12975874	12978070	A07p16400.2_BraZ1	967.227	+	573	2003	2196	0.9121130
A07	12979877	12980296	A07p16410.2_BraZ1	31.8	-	394	419	419	1.0000000
A07	12984859	12986547	A07p16420.2_BraZ1	774	-	1303	1688	1688	1.0000000
A07	12989094	12990774	A07p16430.2_BraZ1	500.243	+	1230	1103	1680	0.6565476
A07	12991355	12992893	A07p16440.2_BraZ1	914.286	-	377	1538	1538	1.0000000
A07	12996285	12997247	A07p16450.2_BraZ1	372	+	2	16	962	0.0166320
A07	13006614	13007228	A07p16460.2_BraZ1	480	-	159	573	614	0.9332247
A07	13011145	13013135	A07p16470.2_BraZ1	855.938	+	151	1665	1990	0.8366834
A07	13016086	13019237	A07p16480.2_BraZ1	1261.58	+	1421	3019	3151	0.9581085
A07	13022773	13023067	A07p16490.2_BraZ1	29.4	+	23	131	294	0.4455782
A07	13024038	13024911	A07p16500.2_BraZ1	87.3	+	129	641	873	0.7342497
A07	13035914	13036659	A07p16510.2_BraZ1	2846.25	-	510	745	745	1.0000000
A07	13038291	13038598	A07p16520.2_BraZ1	450	+	436	307	307	1.0000000
A07	13040639	13042043	A07p16530.2_BraZ1	140.4	-	821	1404	1404	1.0000000
A07	13044500	13046050	A07p16540.2_BraZ1	748.02	+	1337	1550	1550	1.0000000
A07	13050376	13052708	A07p16550.2_BraZ1	1118.02	+	110	1408	2332	0.6037736
A07	13061910	13063777	A07p16560.2_BraZ1	693	+	436	1475	1867	0.7900375
A07	13064222	13064483	A07p16570.2_BraZ1	18.9	+	470	261	261	1.0000000
A07	13064800	13065049	A07p16580.2_BraZ1	24.9	-	316	249	249	1.0000000
A07	13065302	13066356	A07p16590.2_BraZ1	138	-	1023	1054	1054	1.0000000
A07	13069821	13071177	A07p16600.2_BraZ1	1260	+	56	719	1356	0.5302360
A07	13073588	13074075	A07p16610.2_BraZ1	312	+	143	426	487	0.8747433
A07	13083890	13084559	A07p16620.2_BraZ1	66.9	-	136	655	669	0.9790732
A07	13095087	13095322	A07p16630.2_BraZ1	17.7	+	0	0	235	0.0000000
A07	13096136	13096307	A07p16640.2_BraZ1	17.1	+	200	171	171	1.0000000
A07	13098867	13099514	A07p16650.2_BraZ1	1110	-	411	647	647	1.0000000
A07	13121466	13124044	A07p16660.2_BraZ1	1137.08	+	999	2244	2578	0.8704422
A07	13127145	13127883	A07p16670.2_BraZ1	73.8	-	251	663	738	0.8983740
A07	13144365	13147445	A07p16680.2_BraZ1	373.898	+	1864	3016	3080	0.9792208
A07	13144791	13145183	A07p16690.2_BraZ1	34.5	+	448	392	392	1.0000000
A07	13148729	13150112	A07p16700.2_BraZ1	138.3	+	70	406	1383	0.2935647
A07	13150799	13151492	A07p16710.2_BraZ1	69.3	+	86	343	693	0.4949495
A07	13153739	13154276	A07p16720.2_BraZ1	53.7	+	0	0	537	0.0000000
A07	13158099	13160450	A07p16730.2_BraZ1	1326.55	-	1087	2279	2351	0.9693747
A07	13160865	13161563	A07p16740.2_BraZ1	486	-	807	698	698	1.0000000
A07	13161912	13163408	A07p16750.2_BraZ1	683.1	-	1270	1496	1496	1.0000000
A07	13164536	13165139	A07p16760.2_BraZ1	60.3	-	486	603	603	1.0000000
A07	13167743	13170341	A07p16770.2_BraZ1	1203.54	-	2325	2598	2598	1.0000000
A07	13171308	13172242	A07p16780.2_BraZ1	346.48	-	885	934	934	1.0000000
A07	13173489	13179016	A07p16790.2_BraZ1	2739.89	-	1617	5193	5527	0.9395694
A07	13182667	13182982	A07p16800.2_BraZ1	27.3	+	173	315	315	1.0000000
A07	13184028	13184238	A07p16810.2_BraZ1	21	+	18	210	210	1.0000000
A07	13188302	13189844	A07p16820.2_BraZ1	312	-	1868	1542	1542	1.0000000
A07	13190771	13191688	A07p16830.2_BraZ1	245.25	+	832	917	917	1.0000000
A07	13213790	13214000	A07p16840.2_BraZ1	21	+	120	210	210	1.0000000
A07	13214068	13214215	A07p16850.2_BraZ1	14.7	+	202	147	147	1.0000000
A07	13214628	13215033	A07p16860.2_BraZ1	40.5	-	165	405	405	1.0000000
A07	13218835	13219006	A07p16870.2_BraZ1	16.8	+	170	171	171	1.0000000
A07	13224957	13230974	A07p16880.2_BraZ1	474	+	1445	5687	6017	0.9451554
A07	13233066	13233381	A07p16890.2_BraZ1	159	-	333	315	315	1.0000000
A07	13234313	13235963	A07p16900.2_BraZ1	165	-	988	1650	1650	1.0000000
A07	13240474	13242543	A07p16910.2_BraZ1	1392	+	1811	2069	2069	1.0000000
A07	13246646	13248596	A07p16920.2_BraZ1	627.2	-	1641	1950	1950	1.0000000
A07	13260236	13260974	A07p16930.2_BraZ1	660	+	8	47	738	0.0636856
A07	13261621	13262410	A07p16940.2_BraZ1	78.9	-	318	776	789	0.9835234
A07	13267534	13267798	A07p16950.2_BraZ1	26.4	+	12	60	264	0.2272727
A07	13271082	13274899	A07p16960.2_BraZ1	1196.95	+	1848	3450	3817	0.9038512
A07	13293309	13294449	A07p16970.2_BraZ1	114	+	90	979	1140	0.8587719
A07	13298394	13300785	A07p16980.2_BraZ1	1992.6	-	609	2179	2391	0.9113342
A07	13301910	13304350	A07p16990.2_BraZ1	2268	-	819	2052	2440	0.8409836
A07	13308308	13310463	A07p17000.2_BraZ1	663	-	1333	2032	2155	0.9429234
A07	13316806	13318424	A07p17010.2_BraZ1	625	-	1092	1618	1618	1.0000000
A07	13317120	13317305	A07p17020.2_BraZ1	171	+	91	185	185	1.0000000
A07	13320950	13326174	A07p17030.2_BraZ1	800.115	+	1680	4786	5224	0.9161562
A07	13321503	13322140	A07p17040.2_BraZ1	504	+	43	578	637	0.9073783
A07	13324882	13325323	A07p17050.2_BraZ1	44.1	+	14	231	441	0.5238096
A07	13326694	13326796	A07p17060.2_BraZ1	10.2	-	0	0	102	0.0000000
A07	13329849	13331190	A07p17070.2_BraZ1	1182.79	+	338	1312	1341	0.9783744
A07	13331859	13333287	A07p17080.2_BraZ1	645.909	-	643	1416	1428	0.9915966
A07	13336395	13337122	A07p17090.2_BraZ1	135	+	392	727	727	1.0000000
A07	13343568	13344312	A07p17100.2_BraZ1	74.4	-	93	682	744	0.9166667
A07	13347272	13348904	A07p17110.2_BraZ1	1107.86	+	23	368	1632	0.2254902
A07	13359483	13360107	A07p17120.2_BraZ1	62.4	-	127	624	624	1.0000000
A07	13370496	13371574	A07p17130.2_BraZ1	719.688	-	399	1078	1078	1.0000000
A07	13381690	13381982	A07p17140.2_BraZ1	117	+	0	0	292	0.0000000
A07	13386351	13387060	A07p17150.2_BraZ1	42.6	+	0	0	709	0.0000000
A07	13393327	13394034	A07p17160.2_BraZ1	42.6	+	0	0	707	0.0000000
A07	13398956	13400541	A07p17170.2_BraZ1	951	+	70	783	1585	0.4940063
A07	13405999	13413678	A07p17180.2_BraZ1	41006.2	+	1014	5313	7679	0.6918870
A07	13414758	13415661	A07p17190.2_BraZ1	493.615	+	177	841	903	0.9313400
A07	13420000	13421595	A07p17200.2_BraZ1	860.429	+	914	1595	1595	1.0000000
A07	13429986	13432702	A07p17210.2_BraZ1	1024.92	+	1396	2712	2716	0.9985272
A07	13435125	13436058	A07p17220.2_BraZ1	93.3	-	44	592	933	0.6345123
A07	13443980	13445378	A07p17230.2_BraZ1	55.5	-	1179	1398	1398	1.0000000
A07	13449591	13451112	A07p17240.2_BraZ1	708.714	+	1109	1521	1521	1.0000000
A07	13454315	13455772	A07p17250.2_BraZ1	1386	+	817	1419	1457	0.9739190
A07	13456006	13456735	A07p17260.2_BraZ1	72.9	-	0	0	729	0.0000000
A07	13459337	13460707	A07p17270.2_BraZ1	942.857	-	307	1171	1370	0.8547446
A07	13461099	13461746	A07p17280.2_BraZ1	210	+	632	647	647	1.0000000
A07	13461779	13467265	A07p17290.2_BraZ1	312	-	990	3856	5486	0.7028801
A07	13467935	13469241	A07p17300.2_BraZ1	250.818	+	617	1235	1306	0.9456356
A07	13472176	13472767	A07p17310.2_BraZ1	59.1	-	442	591	591	1.0000000
A07	13477254	13479335	A07p17320.2_BraZ1	351	+	1519	2014	2081	0.9678040
A07	13482681	13485998	A07p17330.2_BraZ1	2361.44	-	1134	3043	3317	0.9173952
A07	13487528	13489008	A07p17340.2_BraZ1	504.706	+	1155	1480	1480	1.0000000
A07	13489429	13493905	A07p17350.2_BraZ1	2680.36	-	1603	4409	4476	0.9850313
A07	13496006	13498233	A07p17360.2_BraZ1	402	-	377	1163	2227	0.5222272
A07	13499680	13501044	A07p17370.2_BraZ1	516.75	-	1677	1364	1364	1.0000000
A07	13508603	13511477	A07p17380.2_BraZ1	1245.91	+	2323	2791	2874	0.9711204
A07	13518659	13521622	A07p17390.2_BraZ1	2222.18	-	903	2721	2963	0.9183260
A07	13533530	13538819	A07p17400.2_BraZ1	2002.99	-	2849	5106	5289	0.9653999
A07	13544506	13545547	A07p17410.2_BraZ1	104.1	+	236	866	1041	0.8318924
A07	13545948	13546444	A07p17420.2_BraZ1	960	-	518	496	496	1.0000000
A07	13546715	13548287	A07p17430.2_BraZ1	678.353	+	1591	1572	1572	1.0000000
A07	13549866	13550092	A07p17440.2_BraZ1	14.7	+	302	226	226	1.0000000
A07	13556769	13559346	A07p17450.2_BraZ1	1326	+	1139	2577	2577	1.0000000
A07	13562284	13584664	A07p17460.2_BraZ1	1772.23	+	21984	21842	22380	0.9759607
A07	13566165	13566624	A07p17470.2_BraZ1	45.6	-	244	444	459	0.9673203
A07	13568443	13568820	A07p17480.2_BraZ1	162	-	432	377	377	1.0000000
A07	13570947	13571722	A07p17490.2_BraZ1	663	+	247	752	775	0.9703226
A07	13573314	13573665	A07p17500.2_BraZ1	35.1	+	104	351	351	1.0000000
A07	13586567	13586744	A07p17510.2_BraZ1	17.7	-	537	177	177	1.0000000
A07	13594391	13595527	A07p17520.2_BraZ1	789.75	+	1	58	1136	0.0510563
A07	13596643	13597147	A07p17530.2_BraZ1	50.4	+	128	498	504	0.9880952
A07	13598154	13598886	A07p17540.2_BraZ1	73.2	-	734	732	732	1.0000000
A07	13600190	13602068	A07p17550.2_BraZ1	1567.5	+	398	1320	1878	0.7028754
A07	13602772	13609144	A07p17560.2_BraZ1	1417.86	-	190	689	6372	0.1081293
A07	13607242	13608505	A07p17570.2_BraZ1	126.3	+	0	0	1263	0.0000000
A07	13610305	13615012	A07p17580.2_BraZ1	645	+	164	1069	4707	0.2271086
A07	13616421	13619026	A07p17590.2_BraZ1	789.75	+	262	1548	2605	0.5942419
A07	13620131	13624187	A07p17600.2_BraZ1	435	+	3326	3646	4056	0.8989152
A07	13624890	13631261	A07p17610.2_BraZ1	1423.17	-	21	524	6371	0.0822477
A07	13627769	13630622	A07p17620.2_BraZ1	2649	+	0	0	2853	0.0000000
A07	13632422	13637125	A07p17630.2_BraZ1	645	+	429	1659	4703	0.3527535
A07	13644228	13645147	A07p17640.2_BraZ1	17457	+	224	884	919	0.9619151
A07	13646581	13647279	A07p17650.2_BraZ1	249	+	1011	698	698	1.0000000
A07	13647304	13651569	A07p17660.2_BraZ1	1810.91	+	1374	3481	4265	0.8161782
A07	13651671	13652232	A07p17670.2_BraZ1	483	-	11	120	561	0.2139037
A07	13655058	13655511	A07p17680.2_BraZ1	45.3	+	700	453	453	1.0000000
A07	13655895	13656252	A07p17690.2_BraZ1	35.7	+	172	357	357	1.0000000
A07	13656353	13656923	A07p17700.2_BraZ1	492	-	2	25	570	0.0438596
A07	13659302	13659619	A07p17710.2_BraZ1	297	+	113	317	317	1.0000000
A07	13659720	13660270	A07p17720.2_BraZ1	459	-	30	423	550	0.7690909
A07	13673460	13680853	A07p17730.2_BraZ1	2697.36	-	839	5372	7393	0.7266333
A07	13682789	13683889	A07p17740.2_BraZ1	576.25	-	701	1048	1100	0.9527273
A07	13693253	13696235	A07p17750.2_BraZ1	1413.09	-	548	2921	2982	0.9795439
A07	13702554	13704168	A07p17760.2_BraZ1	161.4	+	243	1211	1614	0.7503098
A07	13715218	13715800	A07p17770.2_BraZ1	58.2	+	133	582	582	1.0000000
A07	13721787	13722612	A07p17780.2_BraZ1	355.909	-	414	798	825	0.9672727
A07	13723327	13727647	A07p17790.2_BraZ1	2296.71	+	3343	4320	4320	1.0000000
A07	13728534	13729700	A07p17800.2_BraZ1	663	+	818	1166	1166	1.0000000
A07	13730187	13731990	A07p17810.2_BraZ1	902.308	-	991	1803	1803	1.0000000
A07	13734374	13734830	A07p17820.2_BraZ1	372	-	146	434	456	0.9517544
A07	13736012	13737345	A07p17830.2_BraZ1	886.385	-	1217	1333	1333	1.0000000
A07	13738433	13740832	A07p17840.2_BraZ1	930	+	1473	2368	2399	0.9870780
A07	13748062	13748296	A07p17850.2_BraZ1	23.4	-	90	234	234	1.0000000
A07	13749410	13749575	A07p17860.2_BraZ1	16.5	+	219	165	165	1.0000000
A07	13751107	13753781	A07p17870.2_BraZ1	1461.02	+	881	2634	2674	0.9850411
A07	13754420	13755120	A07p17880.2_BraZ1	56.7	-	593	700	700	1.0000000
A07	13759113	13759890	A07p17890.2_BraZ1	447	-	449	777	777	1.0000000
A07	13760280	13760760	A07p17900.2_BraZ1	48	-	0	0	480	0.0000000
A07	13769380	13771051	A07p17910.2_BraZ1	167.1	+	508	1604	1671	0.9599043
A07	13774846	13776667	A07p17920.2_BraZ1	182.1	+	378	1465	1821	0.8045030
A07	13777392	13777566	A07p17930.2_BraZ1	17.4	-	0	0	174	0.0000000
A07	13777585	13777786	A07p17940.2_BraZ1	20.1	-	0	0	201	0.0000000
A07	13781059	13783110	A07p17950.2_BraZ1	453	-	1431	2051	2051	1.0000000
A07	13784577	13787739	A07p17960.2_BraZ1	1433.23	+	2324	3162	3162	1.0000000
A07	13789440	13793102	A07p17970.2_BraZ1	2437.62	-	1630	3641	3662	0.9942654
A07	13800175	13802506	A07p17980.2_BraZ1	821.267	+	700	1831	2331	0.7854998
A07	13814487	13815310	A07p17990.2_BraZ1	255	+	159	702	823	0.8529769
A07	13816918	13817299	A07p18000.2_BraZ1	198	+	0	0	381	0.0000000
A07	13823591	13823726	A07p18010.2_BraZ1	13.5	+	56	112	135	0.8296296
A07	13826904	13827354	A07p18020.2_BraZ1	45	+	88	390	450	0.8666667
A07	13833826	13834189	A07p18030.2_BraZ1	267	-	579	363	363	1.0000000
A07	13838120	13839031	A07p18040.2_BraZ1	405	+	1384	911	911	1.0000000
A07	13850254	13852569	A07p18050.2_BraZ1	1092.45	+	629	2106	2315	0.9097192
A07	13856759	13857123	A07p18060.2_BraZ1	168	-	666	364	364	1.0000000
A07	13860658	13861571	A07p18070.2_BraZ1	297	+	111	690	913	0.7557503
A07	13861865	13865374	A07p18080.2_BraZ1	37.3333	+	3266	3371	3509	0.9606726
A07	13866885	13867416	A07p18090.2_BraZ1	53.1	-	205	446	531	0.8399247
A07	13880324	13887003	A07p18100.2_BraZ1	2108.13	+	5715	6429	6679	0.9625692
A07	13891808	13897030	A07p18110.2_BraZ1	2552.62	+	2981	5051	5222	0.9672539
A07	13899630	13901580	A07p18120.2_BraZ1	844.727	-	764	1900	1950	0.9743590
A07	13904088	13908522	A07p18130.2_BraZ1	1329.7	-	4262	4434	4434	1.0000000
A07	13910752	13915326	A07p18140.2_BraZ1	2232.48	+	2073	4419	4574	0.9661128
A07	13916379	13917678	A07p18150.2_BraZ1	129.9	-	656	1299	1299	1.0000000
A07	13918258	13919965	A07p18160.2_BraZ1	170.7	+	252	1504	1707	0.8810779
A07	13920872	13926240	A07p18170.2_BraZ1	1544.33	+	4538	5165	5368	0.9621833
A07	13934284	13934649	A07p18180.2_BraZ1	23.7	-	9	237	365	0.6493151
A07	13935676	13937086	A07p18190.2_BraZ1	1086	+	844	1346	1410	0.9546099
A07	13939359	13943683	A07p18200.2_BraZ1	1663.83	-	1417	3924	4324	0.9074931
A07	13946225	13946986	A07p18210.2_BraZ1	10489.5	-	443	759	761	0.9973719
A07	13948829	13951028	A07p18220.2_BraZ1	1177.78	-	943	2088	2199	0.9495225
A07	13958191	13961790	A07p18230.2_BraZ1	1584.57	+	1836	3572	3599	0.9924979
A07	13969461	13970928	A07p18240.2_BraZ1	1096.17	-	157	1106	1467	0.7539195
A07	13975764	13976156	A07p18250.2_BraZ1	652.5	-	296	392	392	1.0000000
A07	13980368	13981232	A07p18260.2_BraZ1	771	+	347	864	864	1.0000000
A07	13983750	13984106	A07p18270.2_BraZ1	33.9	-	1304	356	356	1.0000000
A07	13988390	13989182	A07p18280.2_BraZ1	438	+	638	792	792	1.0000000
A07	13990177	13991038	A07p18290.2_BraZ1	63.9	+	629	861	861	1.0000000
A07	13995417	13996019	A07p18300.2_BraZ1	519	+	8	100	602	0.1661130
A07	13996844	13999094	A07p18310.2_BraZ1	1652.45	-	625	2096	2250	0.9315556
A07	14004533	14006816	A07p18320.2_BraZ1	228.3	+	762	2225	2283	0.9745948
A07	14011142	14012105	A07p18330.2_BraZ1	96.3	+	147	910	963	0.9449636
A07	14013613	14016370	A07p18340.2_BraZ1	1472.1	-	974	2667	2757	0.9673558
A07	14017042	14022924	A07p18350.2_BraZ1	1021.36	-	3869	5643	5882	0.9593676
A07	14020322	14021437	A07p18360.2_BraZ1	663	-	684	1115	1115	1.0000000
A07	14034111	14048110	A07p18370.2_BraZ1	1167.5	+	7666	13623	13999	0.9731410
A07	14041794	14043201	A07p18380.2_BraZ1	140.7	+	113	1308	1407	0.9296376
A07	14053148	14054725	A07p18390.2_BraZ1	4823.67	+	2293	1577	1577	1.0000000
A07	14057272	14062914	A07p18400.2_BraZ1	336	+	3244	5501	5642	0.9750088
A07	14063173	14064076	A07p18410.2_BraZ1	90.3	-	472	903	903	1.0000000
A07	14065524	14065803	A07p18420.2_BraZ1	27.9	-	571	279	279	1.0000000
A07	14073938	14074085	A07p18430.2_BraZ1	14.7	+	56	147	147	1.0000000
A07	14084408	14084830	A07p18440.2_BraZ1	258	+	138	373	422	0.8838863
A07	14089704	14094158	A07p18450.2_BraZ1	2553.88	+	1952	3805	4454	0.8542883
A07	14094183	14094940	A07p18460.2_BraZ1	57.1765	+	174	696	757	0.9194188
A07	14096388	14097612	A07p18470.2_BraZ1	1039.64	-	676	1224	1224	1.0000000
A07	14104455	14107897	A07p18480.2_BraZ1	1647	+	1052	3085	3442	0.8962812
A07	14107985	14108901	A07p18490.2_BraZ1	420.429	+	348	916	916	1.0000000
A07	14110609	14112002	A07p18500.2_BraZ1	604.5	+	842	1393	1393	1.0000000
A07	14112634	14113061	A07p18510.2_BraZ1	321	+	510	427	427	1.0000000
A07	14113129	14114257	A07p18520.2_BraZ1	281.333	+	527	1128	1128	1.0000000
A07	14114335	14114605	A07p18530.2_BraZ1	159	+	63	270	270	1.0000000
A07	14115247	14116773	A07p18540.2_BraZ1	1419	-	756	1522	1526	0.9973788
A07	14117485	14119222	A07p18550.2_BraZ1	1247.28	+	650	1547	1737	0.8906160
A07	14119791	14120739	A07p18560.2_BraZ1	94.8	-	666	948	948	1.0000000
A07	14130876	14133542	A07p18570.2_BraZ1	3601.5	+	1771	2666	2666	1.0000000
A07	14144456	14145023	A07p18580.2_BraZ1	56.7	+	94	480	567	0.8465608
A07	14156554	14158539	A07p18590.2_BraZ1	896.402	+	971	1797	1985	0.9052896
A07	14159518	14160829	A07p18600.2_BraZ1	131.1	+	1255	1311	1311	1.0000000
A07	14161147	14162594	A07p18610.2_BraZ1	133.5	+	556	1447	1447	1.0000000
A07	14163533	14164694	A07p18620.2_BraZ1	690	+	355	1053	1161	0.9069768
A07	14165010	14166888	A07p18630.2_BraZ1	1225.32	-	863	1878	1878	1.0000000
A07	14174781	14176049	A07p18640.2_BraZ1	560.735	+	2204	1268	1268	1.0000000
A07	14176641	14177643	A07p18650.2_BraZ1	631.8	+	545	1002	1002	1.0000000
A07	14177846	14185892	A07p18660.2_BraZ1	4480.91	-	2291	6900	8046	0.8575690
A07	14186632	14187673	A07p18670.2_BraZ1	104.1	-	689	1041	1041	1.0000000
A07	14192656	14193374	A07p18680.2_BraZ1	702	-	0	0	718	0.0000000
A07	14195407	14195797	A07p18690.2_BraZ1	39	-	228	390	390	1.0000000
A07	14197878	14198538	A07p18700.2_BraZ1	66	-	225	619	660	0.9378788
A07	14205750	14209167	A07p18710.2_BraZ1	1781.55	+	2379	3417	3417	1.0000000
A07	14211310	14212477	A07p18720.2_BraZ1	116.7	-	635	1163	1167	0.9965724
A07	14213357	14213660	A07p18730.2_BraZ1	30.3	+	2	187	303	0.6171617
A07	14214048	14215358	A07p18740.2_BraZ1	525	+	21	506	1310	0.3862596
A07	14220414	14220964	A07p18750.2_BraZ1	468	+	258	479	550	0.8709091
A07	14222250	14224356	A07p18760.2_BraZ1	737.325	+	402	1940	2106	0.9211776
A07	14225134	14226367	A07p18770.2_BraZ1	968.381	-	167	863	1233	0.6999189
A07	14228083	14228253	A07p18780.2_BraZ1	16.8	-	374	170	170	1.0000000
A07	14230011	14230680	A07p18790.2_BraZ1	36.3	+	26	296	669	0.4424514
A07	14232789	14233452	A07p18800.2_BraZ1	66.3	+	373	663	663	1.0000000
A07	14233819	14235325	A07p18810.2_BraZ1	604.235	-	1529	1506	1506	1.0000000
A07	14236275	14238716	A07p18820.2_BraZ1	1506.96	-	1077	2230	2441	0.9135600
A07	14244259	14247898	A07p18830.2_BraZ1	1621.14	+	2284	3639	3639	1.0000000
A07	14249321	14252263	A07p18840.2_BraZ1	1542.75	+	2338	2872	2942	0.9762067
A07	14252860	14254651	A07p18850.2_BraZ1	982.929	-	1467	1791	1791	1.0000000
A07	14258129	14259149	A07p18860.2_BraZ1	102	-	804	1020	1020	1.0000000
A07	14265066	14266371	A07p18870.2_BraZ1	75	+	680	1305	1305	1.0000000
A07	14267128	14270170	A07p18880.2_BraZ1	1744.2	+	1279	2783	3042	0.9148586
A07	14270875	14271160	A07p18890.2_BraZ1	28.5	+	375	285	285	1.0000000
A07	14271654	14273761	A07p18900.2_BraZ1	1734	-	679	2107	2107	1.0000000
A07	14306018	14306306	A07p18910.2_BraZ1	28.8	-	13	191	288	0.6631944
A07	14310031	14310262	A07p18920.2_BraZ1	23.1	-	4	93	231	0.4025974
A07	14317991	14318297	A07p18930.2_BraZ1	30.6	-	6	213	306	0.6960784
A07	14324454	14324757	A07p18940.2_BraZ1	30.3	-	60	104	303	0.3432343
A07	14326341	14329680	A07p18950.2_BraZ1	1778.4	-	1398	3023	3339	0.9053609
A07	14333627	14334294	A07p18960.2_BraZ1	522	-	60	310	667	0.4647676
A07	14341093	14341606	A07p18970.2_BraZ1	363	+	35	101	513	0.1968811
A07	14345947	14348564	A07p18980.2_BraZ1	1813.7	-	699	2434	2617	0.9300726
A07	14349457	14350003	A07p18990.2_BraZ1	354	-	263	546	546	1.0000000
A07	14351268	14353059	A07p19000.2_BraZ1	179.1	-	468	1767	1791	0.9865997
A07	14354922	14356409	A07p19010.2_BraZ1	312	+	127	394	1487	0.2649630
A07	14357279	14358462	A07p19020.2_BraZ1	2496.6	+	5292	1180	1183	0.9974641
A07	14364898	14365705	A07p19030.2_BraZ1	80.7	-	58	269	807	0.3333333
A07	14373155	14373461	A07p19040.2_BraZ1	249	+	63	218	306	0.7124183
A07	14375625	14379021	A07p19050.2_BraZ1	1725.46	-	2133	3374	3396	0.9935218
A07	14380570	14384468	A07p19060.2_BraZ1	2195.17	-	843	3123	3898	0.8011801
A07	14385634	14393101	A07p19070.2_BraZ1	142.425	-	853	2360	7467	0.3160573
A07	14392567	14395338	A07p19080.2_BraZ1	225.7	-	1537	2771	2771	1.0000000
A07	14396392	14397921	A07p19090.2_BraZ1	1110	-	201	1089	1529	0.7122302
A07	14400091	14401533	A07p19100.2_BraZ1	1175.33	+	732	1442	1442	1.0000000
A07	14401770	14403432	A07p19110.2_BraZ1	1121.58	-	1076	1662	1662	1.0000000
A07	14404287	14405669	A07p19120.2_BraZ1	5062.5	-	263	1352	1382	0.9782923
A07	14423766	14425215	A07p19130.2_BraZ1	144.9	-	429	1449	1449	1.0000000
A07	14434141	14434345	A07p19140.2_BraZ1	20.4	-	228	204	204	1.0000000
A07	14435779	14438270	A07p19150.2_BraZ1	1230.68	+	1651	2491	2491	1.0000000
A07	14439506	14440679	A07p19160.2_BraZ1	117.3	+	1463	1173	1173	1.0000000
A07	14445057	14446050	A07p19170.2_BraZ1	723	+	603	993	993	1.0000000
A07	14449578	14450644	A07p19180.2_BraZ1	972	+	99	837	1066	0.7851782
A07	14450839	14456384	A07p19190.2_BraZ1	2609.18	-	3600	5303	5545	0.9563571
A07	14456980	14457223	A07p19200.2_BraZ1	24.3	-	131	138	243	0.5679013
A07	14459637	14459952	A07p19210.2_BraZ1	30.3	+	68	315	315	1.0000000
A07	14461450	14462884	A07p19220.2_BraZ1	206.889	+	214	889	1434	0.6199442
A07	14468780	14472014	A07p19230.2_BraZ1	1643.34	+	1765	3000	3234	0.9276438
A07	14473438	14474192	A07p19240.2_BraZ1	403.636	-	789	754	754	1.0000000
A07	14477340	14478830	A07p19250.2_BraZ1	1046.8	-	307	1062	1490	0.7127517
A07	14488611	14490905	A07p19260.2_BraZ1	2564.5	-	659	2161	2294	0.9420227
A07	14493537	14495133	A07p19270.2_BraZ1	558.804	+	548	1516	1596	0.9498747
A07	14498515	14499335	A07p19280.2_BraZ1	711	+	240	820	820	1.0000000
A07	14500462	14505539	A07p19290.2_BraZ1	1117.49	+	2592	4999	5077	0.9846366
A07	14505621	14507487	A07p19300.2_BraZ1	186.6	-	862	1866	1866	1.0000000
A07	14511611	14512937	A07p19310.2_BraZ1	738.188	+	1410	1326	1326	1.0000000
A07	14513287	14515592	A07p19320.2_BraZ1	1887	+	1473	2270	2305	0.9848156
A07	14516501	14518696	A07p19330.2_BraZ1	1258.39	+	1506	2195	2195	1.0000000
A07	14519725	14523930	A07p19340.2_BraZ1	2271.08	+	1655	4139	4205	0.9843044
A07	14526739	14527764	A07p19350.2_BraZ1	5054	-	671	1000	1025	0.9756098
A07	14531503	14531864	A07p19360.2_BraZ1	267	+	143	361	361	1.0000000
A07	14533120	14533314	A07p19370.2_BraZ1	18.9	+	131	194	194	1.0000000
A07	14540818	14541553	A07p19380.2_BraZ1	73.5	+	441	735	735	1.0000000
A07	14545047	14546291	A07p19390.2_BraZ1	783	+	977	1244	1244	1.0000000
A07	14548050	14550833	A07p19400.2_BraZ1	1967.43	+	1376	2783	2783	1.0000000
A07	14551213	14553693	A07p19410.2_BraZ1	747.353	-	3015	2480	2480	1.0000000
A07	14555015	14556122	A07p19420.2_BraZ1	110.7	+	1208	1107	1107	1.0000000
A07	14556461	14557535	A07p19430.2_BraZ1	630.24	-	1206	1074	1074	1.0000000
A07	14558141	14559637	A07p19440.2_BraZ1	912.656	-	685	1398	1496	0.9344920
A07	14562560	14566997	A07p19450.2_BraZ1	3086.84	-	2358	4388	4437	0.9889565
A07	14567276	14567644	A07p19460.2_BraZ1	213	-	645	368	368	1.0000000
A07	14572526	14573832	A07p19470.2_BraZ1	2808	+	339	1086	1306	0.8315467
A07	14581716	14583209	A07p19480.2_BraZ1	1008	-	617	1401	1493	0.9383791
A07	14589169	14589367	A07p19490.2_BraZ1	19.8	+	324	198	198	1.0000000
A07	14590275	14591904	A07p19500.2_BraZ1	1114.29	+	950	1584	1629	0.9723757
A07	14592682	14594347	A07p19510.2_BraZ1	1077	+	1042	1567	1665	0.9411411
A07	14594826	14596297	A07p19520.2_BraZ1	989.857	-	547	1339	1471	0.9102651
A07	14600002	14600432	A07p19530.2_BraZ1	285	-	936	430	430	1.0000000
A07	14602343	14606013	A07p19540.2_BraZ1	969	+	131	831	3670	0.2264305
A07	14608488	14608843	A07p19550.2_BraZ1	279	-	4	22	355	0.0619718
A07	14610940	14611567	A07p19560.2_BraZ1	62.7	-	97	210	627	0.3349282
A07	14612895	14615587	A07p19570.2_BraZ1	1393.11	+	1060	2659	2692	0.9877415
A07	14620199	14620837	A07p19580.2_BraZ1	384.8	+	531	638	638	1.0000000
A07	14621317	14622153	A07p19590.2_BraZ1	297.64	-	538	836	836	1.0000000
A07	14623167	14628482	A07p19600.2_BraZ1	1485.26	-	2312	3272	5315	0.6156162
A07	14630054	14631329	A07p19610.2_BraZ1	976.56	+	940	1275	1275	1.0000000
A07	14632526	14647459	A07p19620.2_BraZ1	5032.67	-	6496	14429	14933	0.9662492
A07	14654515	14659729	A07p19630.2_BraZ1	1601.9	-	3956	4686	5214	0.8987342
A07	14666884	14667272	A07p19640.2_BraZ1	33.9	-	566	388	388	1.0000000
A07	14686712	14690098	A07p19650.2_BraZ1	2628.45	-	3550	2494	3386	0.7365623
A07	14692021	14694333	A07p19660.2_BraZ1	1055.38	+	1747	2310	2312	0.9991350
A07	14701928	14702788	A07p19670.2_BraZ1	241.5	+	351	860	860	1.0000000
A07	14709452	14710144	A07p19680.2_BraZ1	2100	-	134	551	692	0.7962428
A07	14714396	14714919	A07p19690.2_BraZ1	49.2	+	77	176	523	0.3365201
A07	14740005	14743057	A07p19700.2_BraZ1	1727.21	+	981	2498	3052	0.8184797
A07	14747971	14748814	A07p19710.2_BraZ1	387	+	15	101	843	0.1198102
A07	14758850	14761763	A07p19720.2_BraZ1	21210	+	1407	2898	2913	0.9948507
A07	14768553	14772057	A07p19730.2_BraZ1	1295.11	-	2787	3503	3504	0.9997146
A07	14780328	14782722	A07p19740.2_BraZ1	239.1	-	1706	2291	2394	0.9569758
A07	14785845	14788141	A07p19750.2_BraZ1	1582.16	-	1618	2189	2296	0.9533972
A07	14788760	14799444	A07p19760.2_BraZ1	6873.2	-	926	5474	10684	0.5123549
A07	14801081	14803183	A07p19770.2_BraZ1	1108.96	-	1639	2102	2102	1.0000000
A07	14808655	14809444	A07p19780.2_BraZ1	78.9	-	308	789	789	1.0000000
A07	14811666	14815711	A07p19790.2_BraZ1	1637.88	-	1217	3832	4045	0.9473424
A07	14816977	14818677	A07p19800.2_BraZ1	743.75	-	362	1641	1700	0.9652941
A07	14823661	14824236	A07p19810.2_BraZ1	1800	+	108	518	575	0.9008695
A07	14825121	14829676	A07p19820.2_BraZ1	2554.01	-	982	4235	4555	0.9297475
A07	14835523	14838821	A07p19830.2_BraZ1	32913	+	473	3257	3298	0.9875682
A07	14839634	14842128	A07p19840.2_BraZ1	1926	-	257	1783	2494	0.7149158
A07	14844867	14845998	A07p19850.2_BraZ1	285	+	84	854	1131	0.7550840
A07	14848417	14851843	A07p19860.2_BraZ1	1955.95	+	866	3131	3426	0.9138938
A07	14853548	14854799	A07p19870.2_BraZ1	484	+	307	1144	1251	0.9144684
A07	14855430	14855679	A07p19880.2_BraZ1	24.9	+	253	249	249	1.0000000
A07	14857831	14858320	A07p19890.2_BraZ1	47.1	+	295	489	489	1.0000000
A07	14858749	14858986	A07p19900.2_BraZ1	23.7	+	75	220	237	0.9282700
A07	14871175	14873354	A07p19910.2_BraZ1	1162.78	+	919	1838	2179	0.8435062
A07	14882023	14883974	A07p19920.2_BraZ1	372.135	+	3195	1951	1951	1.0000000
A07	14884047	14884627	A07p19930.2_BraZ1	192	+	1730	580	580	1.0000000
A07	14889829	14891534	A07p19940.2_BraZ1	2380	+	867	1644	1705	0.9642228
A07	14892877	14895681	A07p19950.2_BraZ1	1601.11	+	746	2547	2804	0.9083452
A07	14900162	14900366	A07p19960.2_BraZ1	20.4	-	26	190	204	0.9313725
A07	14902926	14904442	A07p19970.2_BraZ1	502.32	-	2276	1486	1516	0.9802111
A07	14905134	14905848	A07p19980.2_BraZ1	71.4	+	350	714	714	1.0000000
A07	14906281	14906401	A07p19990.2_BraZ1	12	+	139	120	120	1.0000000
A07	14907336	14908102	A07p20000.2_BraZ1	573	+	488	766	766	1.0000000
A07	14912235	14912682	A07p20010.2_BraZ1	44.7	+	205	410	447	0.9172260
A07	14914301	14915574	A07p20020.2_BraZ1	1014.41	-	153	1062	1273	0.8342498
A07	14919982	14922703	A07p20030.2_BraZ1	1105	-	783	2370	2721	0.8710033
A07	14925249	14925913	A07p20040.2_BraZ1	492	-	98	661	664	0.9954819
A07	14930959	14934271	A07p20050.2_BraZ1	8496	-	1020	2761	3312	0.8336353
A07	14942021	14942360	A07p20060.2_BraZ1	33.9	+	738	339	339	1.0000000
A07	14947856	14951768	A07p20070.2_BraZ1	1326	-	2500	3529	3912	0.9020961
A07	14954543	14954726	A07p20080.2_BraZ1	18.3	+	307	183	183	1.0000000
A07	14956331	14956747	A07p20090.2_BraZ1	342	-	509	416	416	1.0000000
A07	14957427	14961405	A07p20100.2_BraZ1	2081.88	+	1548	3791	3978	0.9529914
A07	14961652	14962656	A07p20110.2_BraZ1	666	-	966	1004	1004	1.0000000
A07	14966773	14970144	A07p20120.2_BraZ1	1281	-	721	3202	3371	0.9498665
A07	14971251	14972305	A07p20130.2_BraZ1	1428	-	772	1054	1054	1.0000000
A07	14977222	14977681	A07p20140.2_BraZ1	45.9	-	345	459	459	1.0000000
A07	14982427	14983334	A07p20150.2_BraZ1	410.278	-	721	907	907	1.0000000
A07	14984653	14985791	A07p20160.2_BraZ1	2865.9	+	871	1106	1138	0.9718805
A07	14993665	14995267	A07p20170.2_BraZ1	522.133	+	968	1551	1602	0.9681648
A07	14996866	14999446	A07p20180.2_BraZ1	1271	+	1665	2418	2580	0.9372093
A07	15001078	15003091	A07p20190.2_BraZ1	201.3	-	499	1612	2013	0.8007948
A07	15017370	15018849	A07p20200.2_BraZ1	147.9	-	95	541	1479	0.3657877
A07	15025491	15027598	A07p20210.2_BraZ1	1129.41	-	603	1984	2107	0.9416232
A07	15028868	15029502	A07p20220.2_BraZ1	4018.5	+	457	634	634	1.0000000
A07	15030228	15030934	A07p20230.2_BraZ1	330	-	869	706	706	1.0000000
A07	15033822	15034587	A07p20240.2_BraZ1	510	+	483	765	765	1.0000000
A07	15035878	15036394	A07p20250.2_BraZ1	734.4	-	700	516	516	1.0000000
A07	15037193	15038554	A07p20260.2_BraZ1	599.109	-	1412	1361	1361	1.0000000
A07	15039599	15040930	A07p20270.2_BraZ1	1245	+	555	1331	1331	1.0000000
A07	15041653	15042038	A07p20280.2_BraZ1	316	-	410	385	385	1.0000000
A07	15041971	15043167	A07p20290.2_BraZ1	2156	-	615	1196	1196	1.0000000
A07	15044510	15047741	A07p20300.2_BraZ1	1728	+	2124	3231	3231	1.0000000
A07	15055308	15055970	A07p20310.2_BraZ1	585	+	329	660	662	0.9969789
A07	15059918	15064579	A07p20320.2_BraZ1	2675.79	+	1753	4571	4661	0.9806908
A07	15069599	15070629	A07p20330.2_BraZ1	57	+	610	1030	1030	1.0000000
A07	15073523	15074127	A07p20340.2_BraZ1	42.9	+	637	604	604	1.0000000
A07	15074617	15077695	A07p20350.2_BraZ1	2304	-	779	3077	3078	0.9996751
A07	15077859	15078506	A07p20360.2_BraZ1	165	-	626	647	647	1.0000000
A07	15085044	15090410	A07p20370.2_BraZ1	2345.52	-	1296	3828	5366	0.7133805
A07	15099774	15100913	A07p20380.2_BraZ1	398.4	-	1432	1139	1139	1.0000000
A07	15101938	15111206	A07p20390.2_BraZ1	3492.9	-	5032	8963	9268	0.9670911
A07	15119998	15122171	A07p20400.2_BraZ1	1710.91	+	1169	2173	2173	1.0000000
A07	15123138	15125243	A07p20410.2_BraZ1	1125	-	1041	2085	2105	0.9904988
A07	15142712	15143184	A07p20420.2_BraZ1	399	-	45	143	472	0.3029661
A07	15144637	15145068	A07p20430.2_BraZ1	348	-	328	431	431	1.0000000
A07	15150270	15154063	A07p20440.2_BraZ1	1758.11	+	2069	3756	3793	0.9902452
A07	15155103	15155553	A07p20450.2_BraZ1	44.1	+	0	0	450	0.0000000
A07	15156998	15158794	A07p20460.2_BraZ1	3344.14	-	1314	1796	1796	1.0000000
A07	15160365	15161630	A07p20470.2_BraZ1	948	+	1063	1265	1265	1.0000000
A07	15172163	15172541	A07p20480.2_BraZ1	37.8	-	17	283	378	0.7486773
A07	15175115	15176669	A07p20490.2_BraZ1	570.714	-	1188	1489	1554	0.9581724
A07	15179872	15181701	A07p20500.2_BraZ1	1255.18	-	602	1776	1829	0.9710224
A07	15183825	15185544	A07p20510.2_BraZ1	171.9	+	162	1446	1719	0.8411868
A07	15188576	15190955	A07p20520.2_BraZ1	1119.27	+	1513	2332	2379	0.9802438
A07	15194204	15194966	A07p20530.2_BraZ1	642	+	96	263	762	0.3451444
A07	15198340	15200274	A07p20540.2_BraZ1	1492.62	+	703	1820	1934	0.9410548
A07	15204082	15205906	A07p20550.2_BraZ1	951	+	577	1440	1824	0.7894737
A07	15207495	15208781	A07p20560.2_BraZ1	292.32	+	961	1235	1286	0.9603422
A07	15226371	15227238	A07p20570.2_BraZ1	86.7	+	34	484	867	0.5582469
A07	15238080	15239750	A07p20580.2_BraZ1	804.632	+	177	1394	1670	0.8347306
A07	15241779	15242673	A07p20590.2_BraZ1	384.54	-	783	894	894	1.0000000
A07	15244513	15246377	A07p20600.2_BraZ1	3136.22	+	1363	1864	1864	1.0000000
A07	15248493	15250775	A07p20610.2_BraZ1	1423.43	+	841	2213	2282	0.9697633
A07	15257563	15260616	A07p20620.2_BraZ1	1877.41	+	234	1688	3053	0.5528988
A07	15272861	15276592	A07p20630.2_BraZ1	677.867	+	1251	3240	3731	0.8683999
A07	15280722	15282882	A07p20640.2_BraZ1	990.663	+	1096	2158	2160	0.9990741
A07	15283804	15285429	A07p20650.2_BraZ1	955.098	+	544	1524	1625	0.9378461
A07	15290055	15294170	A07p20660.2_BraZ1	2063.37	+	2185	3978	4115	0.9667072
A07	15294929	15295289	A07p20670.2_BraZ1	36	-	214	360	360	1.0000000
A07	15295998	15296759	A07p20680.2_BraZ1	54.6	-	13	237	761	0.3114323
A07	15300861	15301257	A07p20690.2_BraZ1	39.6	-	266	396	396	1.0000000
A07	15302821	15306185	A07p20700.2_BraZ1	714	-	2821	3363	3364	0.9997028
A07	15308762	15310853	A07p20710.2_BraZ1	9900	+	1184	2041	2091	0.9760880
A07	15338470	15340846	A07p20720.2_BraZ1	1892.08	+	317	1979	2376	0.8329124
A07	15349362	15353004	A07p20730.2_BraZ1	426	-	2231	3440	3642	0.9445360
A07	15353010	15353467	A07p20740.2_BraZ1	363	-	256	457	457	1.0000000
A07	15353467	15353908	A07p20750.2_BraZ1	171	-	306	387	441	0.8775510
A07	15355422	15356563	A07p20760.2_BraZ1	427.8	+	941	1105	1141	0.9684488
A07	15356947	15358400	A07p20770.2_BraZ1	1262.21	-	1040	1453	1453	1.0000000
A07	15359281	15359620	A07p20780.2_BraZ1	33.9	+	294	339	339	1.0000000
A07	15360036	15360393	A07p20790.2_BraZ1	18.9	+	305	357	357	1.0000000
A07	15364126	15367143	A07p20800.2_BraZ1	1476.04	-	2340	3012	3017	0.9983428
A07	15368579	15368945	A07p20810.2_BraZ1	255	-	64	366	366	1.0000000
A07	15372960	15373308	A07p20820.2_BraZ1	34.8	+	138	348	348	1.0000000
A07	15373848	15374406	A07p20830.2_BraZ1	55.8	+	336	558	558	1.0000000
A07	15375058	15375596	A07p20840.2_BraZ1	26.1	-	511	538	538	1.0000000
A07	15376916	15377642	A07p20850.2_BraZ1	72.6	+	548	726	726	1.0000000
A07	15377799	15381383	A07p20860.2_BraZ1	1528.77	-	2220	3537	3584	0.9868861
A07	15382004	15386240	A07p20870.2_BraZ1	2345.75	-	2635	4236	4236	1.0000000
A07	15390663	15396728	A07p20880.2_BraZ1	253	-	632	1890	6065	0.3116241
A07	15397799	15399002	A07p20890.2_BraZ1	120.3	-	956	1203	1203	1.0000000
A07	15399958	15401942	A07p20900.2_BraZ1	1401	-	1021	1956	1984	0.9858871
A07	15412730	15414154	A07p20910.2_BraZ1	7371	-	216	1108	1424	0.7780899
A07	15420489	15420957	A07p20920.2_BraZ1	825	+	376	468	468	1.0000000
A07	15439574	15457492	A07p20930.2_BraZ1	2854.17	+	7694	15679	17918	0.8750418
A07	15460308	15463124	A07p20940.2_BraZ1	987.179	-	815	2364	2816	0.8394886
A07	15481830	15483438	A07p20950.2_BraZ1	717	+	709	1541	1608	0.9583333
A07	15484120	15484324	A07p20960.2_BraZ1	20.4	-	329	204	204	1.0000000
A07	15486872	15488670	A07p20970.2_BraZ1	1507.57	-	350	1283	1798	0.7135707
A07	15503325	15504873	A07p20980.2_BraZ1	154.8	-	68	869	1548	0.5613695
A07	15510283	15512026	A07p20990.2_BraZ1	174.3	-	353	1736	1743	0.9959840
A07	15526093	15534972	A07p21000.2_BraZ1	306	+	5391	7899	8879	0.8896272
A07	15534314	15534785	A07p21010.2_BraZ1	225	+	162	471	471	1.0000000
A07	15535704	15536922	A07p21020.2_BraZ1	121.8	-	497	852	1218	0.6995074
A07	15545439	15545677	A07p21030.2_BraZ1	12.9	+	0	0	238	0.0000000
A07	15546996	15548633	A07p21040.2_BraZ1	891	-	139	1238	1637	0.7562615
A07	15572058	15572511	A07p21050.2_BraZ1	45.3	+	12	57	453	0.1258278
A07	15578137	15578587	A07p21060.2_BraZ1	45	+	107	441	450	0.9800000
A07	15580313	15580553	A07p21070.2_BraZ1	24	-	287	240	240	1.0000000
A07	15581924	15583770	A07p21080.2_BraZ1	869.732	-	1733	1841	1846	0.9972914
A07	15586070	15587500	A07p21090.2_BraZ1	3277.5	+	215	1009	1430	0.7055944
A07	15588840	15589848	A07p21100.2_BraZ1	186	-	421	881	1008	0.8740079
A07	15592346	15595703	A07p21110.2_BraZ1	2136.35	-	500	2407	3357	0.7170092
A07	15611809	15612580	A07p21120.2_BraZ1	75.6	-	210	771	771	1.0000000
A07	15614265	15614758	A07p21130.2_BraZ1	192	-	699	493	493	1.0000000
A07	15622700	15623276	A07p21140.2_BraZ1	36	-	86	281	576	0.4878472
A07	15625441	15627403	A07p21150.2_BraZ1	1277.27	+	1319	1962	1962	1.0000000
A07	15634291	15634705	A07p21160.2_BraZ1	41.4	-	155	410	414	0.9903381
A07	15637841	15639624	A07p21170.2_BraZ1	806	+	2162	1783	1783	1.0000000
A07	15649499	15653521	A07p21180.2_BraZ1	2210.81	-	3865	3991	4022	0.9922924
A07	15659618	15661581	A07p21190.2_BraZ1	1860	+	23	325	1963	0.1655629
A07	15663606	15664520	A07p21200.2_BraZ1	277.629	+	62	451	914	0.4934354
A07	15674256	15676581	A07p21210.2_BraZ1	1595.79	-	257	1669	2325	0.7178494
A07	15699739	15700716	A07p21220.2_BraZ1	467.6	-	216	904	977	0.9252815
A07	15701129	15702194	A07p21230.2_BraZ1	98.4	-	628	1065	1065	1.0000000
A07	15707757	15709776	A07p21240.2_BraZ1	898.971	+	944	1947	2019	0.9643388
A07	15710653	15712523	A07p21250.2_BraZ1	2369.25	-	788	1844	1870	0.9860963
A07	15717378	15719237	A07p21260.2_BraZ1	772.962	-	1570	1859	1859	1.0000000
A07	15725103	15728865	A07p21270.2_BraZ1	2106.63	+	1827	3718	3762	0.9883041
A07	15730406	15731337	A07p21280.2_BraZ1	377.636	+	785	931	931	1.0000000
A07	15732431	15735111	A07p21290.2_BraZ1	2127	-	585	2364	2680	0.8820896
A07	15738705	15740311	A07p21300.2_BraZ1	943.091	+	1227	1581	1606	0.9844334
A07	15742722	15744837	A07p21310.2_BraZ1	211.5	+	752	1980	2115	0.9361702
A07	15746319	15748173	A07p21320.2_BraZ1	185.4	+	947	1790	1854	0.9654800
A07	15749000	15752421	A07p21330.2_BraZ1	2136.86	-	1505	3189	3421	0.9321836
A07	15755525	15759416	A07p21340.2_BraZ1	3798	-	119	1066	3891	0.2739656
A07	15760048	15761432	A07p21350.2_BraZ1	303.75	+	97	334	1384	0.2413295
A07	15765089	15766145	A07p21360.2_BraZ1	975	-	526	1056	1056	1.0000000
A07	15768079	15768474	A07p21370.2_BraZ1	210	+	142	395	395	1.0000000
A07	15768511	15769033	A07p21380.2_BraZ1	852	+	97	411	522	0.7873563
A07	15769837	15770672	A07p21390.2_BraZ1	186	+	634	835	835	1.0000000
A07	15772651	15773131	A07p21400.2_BraZ1	48	+	533	480	480	1.0000000
A07	15773421	15774612	A07p21410.2_BraZ1	714	+	907	1191	1191	1.0000000
A07	15779470	15779698	A07p21420.2_BraZ1	120	-	444	228	228	1.0000000
A07	15783922	15785393	A07p21430.2_BraZ1	108	-	185	1262	1471	0.8579198
A07	15794229	15796210	A07p21440.2_BraZ1	1166.4	+	367	1572	1981	0.7935386
A07	15803055	15803385	A07p21450.2_BraZ1	33	+	167	330	330	1.0000000
A07	15803911	15804249	A07p21460.2_BraZ1	32.7	+	141	338	338	1.0000000
A07	15809595	15810866	A07p21470.2_BraZ1	645	+	680	1130	1271	0.8890637
A07	15814133	15816131	A07p21480.2_BraZ1	18757.5	-	563	1508	1998	0.7547548
A07	15822704	15823462	A07p21490.2_BraZ1	195	-	378	758	758	1.0000000
A07	15823462	15826758	A07p21500.2_BraZ1	432	+	831	2811	3296	0.8528519
A07	15827299	15829222	A07p21510.2_BraZ1	1412.73	-	848	1679	1923	0.8731149
A07	15833224	15834852	A07p21520.2_BraZ1	744.519	+	881	1613	1628	0.9907863
A07	15835057	15836648	A07p21530.2_BraZ1	949.44	-	769	1515	1591	0.9522313
A07	15840358	15841163	A07p21540.2_BraZ1	546	-	18	536	805	0.6658385
A07	15844753	15845174	A07p21550.2_BraZ1	39.3	+	89	258	421	0.6128266
A07	15852343	15854773	A07p21560.2_BraZ1	1128.11	+	434	2269	2430	0.9337448
A07	15861518	15862517	A07p21570.2_BraZ1	735.795	+	431	999	999	1.0000000
A07	15863570	15865368	A07p21580.2_BraZ1	1224.76	-	526	1508	1798	0.8387097
A07	15866945	15868652	A07p21590.2_BraZ1	922.5	+	562	1540	1707	0.9021676
A07	15871833	15874740	A07p21600.2_BraZ1	1366.32	-	573	2648	2907	0.9109047
A07	15879245	15881480	A07p21610.2_BraZ1	1415.32	+	300	1384	2235	0.6192394
A07	15890174	15904933	A07p21620.2_BraZ1	2001.55	+	20985	14321	14759	0.9703232
A07	15912895	15915289	A07p21630.2_BraZ1	1210.85	+	1324	2366	2394	0.9883041
A07	15916473	15917082	A07p21640.2_BraZ1	60.9	-	260	609	609	1.0000000
A07	15919748	15921520	A07p21650.2_BraZ1	812.371	-	1555	1772	1772	1.0000000
A07	15924879	15926072	A07p21660.2_BraZ1	1858.5	-	371	1193	1193	1.0000000
A07	15929097	15929685	A07p21670.2_BraZ1	58.8	-	16	311	588	0.5289116
A07	15929878	15930343	A07p21680.2_BraZ1	780	+	3	91	465	0.1956989
A07	15930621	15930896	A07p21690.2_BraZ1	180	-	2	33	275	0.1200000
A07	15933414	15933805	A07p21700.2_BraZ1	24	-	0	0	391	0.0000000
A07	15934721	15936675	A07p21710.2_BraZ1	1103.52	+	347	1886	1954	0.9651996
A07	15936699	15936858	A07p21720.2_BraZ1	15.9	+	225	159	159	1.0000000
A07	15938890	15940544	A07p21730.2_BraZ1	1176	+	479	1612	1654	0.9746070
A07	15940962	15943095	A07p21740.2_BraZ1	4861.8	-	1341	2064	2133	0.9676512
A07	15945033	15945814	A07p21750.2_BraZ1	280.5	+	261	781	781	1.0000000
A07	15946338	15947581	A07p21760.2_BraZ1	587.821	-	77	1094	1243	0.8801287
A07	15950927	15951680	A07p21770.2_BraZ1	663	+	23	384	753	0.5099602
A07	15958168	15960775	A07p21780.2_BraZ1	260.7	+	353	1927	2607	0.7391638
A07	15968190	15969573	A07p21790.2_BraZ1	138.3	+	378	1153	1383	0.8336949
A07	15971256	15974147	A07p21800.2_BraZ1	1199.09	+	568	2599	2891	0.8989969
A07	15977723	15978449	A07p21810.2_BraZ1	72.6	+	383	726	726	1.0000000
A07	15979519	15980962	A07p21820.2_BraZ1	144.3	-	100	635	1443	0.4400554
A07	15983456	15985531	A07p21830.2_BraZ1	1190.19	+	156	1510	2075	0.7277108
A07	15988831	15991464	A07p21840.2_BraZ1	2005.31	+	156	1480	2633	0.5620965
A07	15992709	15993068	A07p21850.2_BraZ1	273	-	3	20	359	0.0557103
A07	15997182	15997508	A07p21860.2_BraZ1	240	-	0	0	326	0.0000000
A07	15998963	16006116	A07p21870.2_BraZ1	516	+	832	3773	7153	0.5274710
A07	16006461	16012874	A07p21880.2_BraZ1	3458	+	1622	3537	6413	0.5515360
A07	16013286	16013682	A07p21890.2_BraZ1	640	-	589	396	396	1.0000000
A07	16022754	16023905	A07p21900.2_BraZ1	888.675	+	282	1149	1151	0.9982624
A07	16029651	16031671	A07p21910.2_BraZ1	8613	+	1090	1907	2020	0.9440594
A07	16044506	16046067	A07p21920.2_BraZ1	1302	+	574	1560	1561	0.9993594
A07	16047797	16048388	A07p21930.2_BraZ1	59.1	+	81	471	591	0.7969543
A07	16048679	16050812	A07p21940.2_BraZ1	213.3	-	135	942	2133	0.4416315
A07	16053933	16054797	A07p21950.2_BraZ1	491.786	+	56	538	864	0.6226852
A07	16058541	16059731	A07p21960.2_BraZ1	1008	-	199	1154	1190	0.9697479
A07	16069682	16071794	A07p21970.2_BraZ1	211.2	+	304	809	2112	0.3830492
A07	16089888	16090829	A07p21980.2_BraZ1	279	+	889	941	941	1.0000000
A07	16094913	16097308	A07p21990.2_BraZ1	1937.34	-	625	1843	2395	0.7695198
A07	16099135	16100314	A07p22000.2_BraZ1	4252.5	-	664	1179	1179	1.0000000
A07	16101111	16101372	A07p22010.2_BraZ1	26.1	-	20	261	261	1.0000000
A07	16108203	16108594	A07p22020.2_BraZ1	312	-	616	391	391	1.0000000
A07	16109401	16109710	A07p22030.2_BraZ1	30.9	-	40	309	309	1.0000000
A07	16113309	16116083	A07p22040.2_BraZ1	1809.74	+	763	2592	2774	0.9343908
A07	16119019	16121038	A07p22050.2_BraZ1	201.9	+	359	680	2019	0.3368004
A07	16124215	16126073	A07p22060.2_BraZ1	1282.81	+	381	1792	1858	0.9644780
A07	16127916	16129555	A07p22070.2_BraZ1	840	-	1606	1639	1639	1.0000000
A07	16130240	16135445	A07p22080.2_BraZ1	1800.88	-	2927	4761	5205	0.9146974
A07	16132171	16132995	A07p22090.2_BraZ1	627	-	70	642	824	0.7791262
A07	16135839	16137417	A07p22100.2_BraZ1	544.172	-	168	1393	1578	0.8827630
A07	16139242	16140277	A07p22110.2_BraZ1	103.5	+	256	1035	1035	1.0000000
A07	16141142	16141843	A07p22120.2_BraZ1	617.55	-	21	338	701	0.4821683
A07	16146271	16148953	A07p22130.2_BraZ1	268.2	-	413	2342	2682	0.8732289
A07	16157419	16159091	A07p22140.2_BraZ1	372	-	289	1318	1672	0.7882775
A07	16165677	16168418	A07p22150.2_BraZ1	12765.2	+	422	2188	2741	0.7982488
A07	16170170	16171934	A07p22160.2_BraZ1	176.4	+	327	1225	1764	0.6944444
A07	16172257	16173432	A07p22170.2_BraZ1	633	-	556	821	1175	0.6987234
A07	16177892	16188325	A07p22180.2_BraZ1	6338.45	-	6098	9902	10433	0.9491038
A07	16209395	16219714	A07p22190.2_BraZ1	5586.35	+	1952	7809	10319	0.7567594
A07	16220320	16221119	A07p22200.2_BraZ1	495	+	322	799	799	1.0000000
A07	16222590	16225029	A07p22210.2_BraZ1	243.9	+	251	1281	2439	0.5252153
A07	16225894	16227044	A07p22220.2_BraZ1	380.464	+	407	1150	1150	1.0000000
A07	16237993	16239604	A07p22230.2_BraZ1	161.1	+	278	1390	1611	0.8628181
A07	16240130	16240634	A07p22240.2_BraZ1	381	+	64	236	504	0.4682540
A07	16241636	16242338	A07p22250.2_BraZ1	70.2	-	53	496	702	0.7065527
A07	16243621	16245539	A07p22260.2_BraZ1	1188	-	589	1893	1918	0.9869656
A07	16250996	16251762	A07p22270.2_BraZ1	660	+	305	700	766	0.9138381
A07	16255266	16258092	A07p22280.2_BraZ1	1158.58	+	990	2581	2826	0.9133050
A07	16258244	16258704	A07p22290.2_BraZ1	327	-	152	460	460	1.0000000
A07	16259586	16260621	A07p22300.2_BraZ1	3055.2	+	510	1001	1035	0.9671497
A07	16261008	16261227	A07p22310.2_BraZ1	21.9	+	114	219	219	1.0000000
A07	16263036	16264389	A07p22320.2_BraZ1	1090.12	-	701	1155	1353	0.8536586
A07	16267047	16272440	A07p22330.2_BraZ1	2660	+	626	3554	5393	0.6590024
A07	16281721	16281958	A07p22340.2_BraZ1	23.7	-	82	237	237	1.0000000
A07	16283487	16287284	A07p22350.2_BraZ1	1960.94	-	1363	3649	3797	0.9610218
A07	16293076	16295926	A07p22360.2_BraZ1	1510.79	+	1416	2258	2850	0.7922807
A07	16297616	16298676	A07p22370.2_BraZ1	17931	-	167	948	1060	0.8943396
A07	16305945	16306440	A07p22380.2_BraZ1	339	+	369	495	495	1.0000000
A07	16315647	16317836	A07p22390.2_BraZ1	1221.32	+	256	1828	2189	0.8350845
A07	16319434	16322511	A07p22400.2_BraZ1	2183.9	-	2340	3077	3077	1.0000000
A07	16329807	16331137	A07p22410.2_BraZ1	888.341	+	305	907	1330	0.6819549
A07	16334477	16334693	A07p22420.2_BraZ1	21.6	+	0	0	216	0.0000000
A07	16336184	16336400	A07p22430.2_BraZ1	21.6	+	0	0	216	0.0000000
A07	16337680	16337890	A07p22440.2_BraZ1	21	+	82	210	210	1.0000000
A07	16338365	16338575	A07p22450.2_BraZ1	21	-	53	210	210	1.0000000
A07	16339861	16340113	A07p22460.2_BraZ1	25.2	+	330	252	252	1.0000000
A07	16341587	16343230	A07p22470.2_BraZ1	1339.25	+	292	1336	1643	0.8131467
A07	16343586	16344205	A07p22480.2_BraZ1	531	-	81	571	619	0.9224555
A07	16347091	16347196	A07p22490.2_BraZ1	10.5	+	95	105	105	1.0000000
A07	16347412	16348777	A07p22500.2_BraZ1	774.692	+	361	1290	1365	0.9450549
A07	16350693	16351476	A07p22510.2_BraZ1	78.3	-	230	593	783	0.7573435
A07	16351847	16353803	A07p22520.2_BraZ1	1020.88	+	487	1864	1956	0.9529653
A07	16357609	16358304	A07p22530.2_BraZ1	594	+	404	695	695	1.0000000
A07	16360016	16362668	A07p22540.2_BraZ1	1461.55	+	1421	2605	2652	0.9822775
A07	16363191	16366378	A07p22550.2_BraZ1	1938.75	-	386	2172	3187	0.6815187
A07	16368646	16371634	A07p22560.2_BraZ1	1829.88	+	468	2207	2988	0.7386212
A07	16372961	16375057	A07p22570.2_BraZ1	1397.25	-	439	1960	2096	0.9351145
A07	16375916	16377297	A07p22580.2_BraZ1	726	-	593	1381	1381	1.0000000
A07	16378802	16380497	A07p22590.2_BraZ1	169.5	-	36	589	1695	0.3474926
A07	16383612	16385055	A07p22600.2_BraZ1	538.35	-	420	1443	1443	1.0000000
A07	16385969	16386910	A07p22610.2_BraZ1	3848	-	466	941	941	1.0000000
A07	16390440	16399610	A07p22620.2_BraZ1	1760.29	+	11933	8958	9170	0.9768811
A07	16401887	16403316	A07p22630.2_BraZ1	792	+	84	812	1429	0.5682296
A07	16413410	16413803	A07p22640.2_BraZ1	183.75	+	682	393	393	1.0000000
A07	16414396	16414507	A07p22650.2_BraZ1	11.1	+	179	111	111	1.0000000
A07	16415227	16416299	A07p22660.2_BraZ1	523.692	-	573	1072	1072	1.0000000
A07	16424331	16433333	A07p22670.2_BraZ1	2653.36	-	3328	7789	9002	0.8652521
A07	16436352	16436635	A07p22680.2_BraZ1	177	-	5	54	283	0.1908127
A07	16439811	16443837	A07p22690.2_BraZ1	10674.7	-	1058	3072	4026	0.7630402
A07	16445086	16448536	A07p22700.2_BraZ1	1929.56	-	686	2427	3450	0.7034783
A07	16457331	16457522	A07p22710.2_BraZ1	18	-	5	191	191	1.0000000
A07	16470557	16470979	A07p22720.2_BraZ1	309	-	269	422	422	1.0000000
A07	16472318	16473753	A07p22730.2_BraZ1	1000.29	+	585	1379	1435	0.9609756
A07	16481121	16481424	A07p22740.2_BraZ1	30.3	+	203	303	303	1.0000000
A07	16481771	16484926	A07p22750.2_BraZ1	7120.5	+	1397	2934	3155	0.9299524
A07	16486759	16488440	A07p22760.2_BraZ1	25440	+	374	1419	1681	0.8441404
A07	16501538	16503946	A07p22770.2_BraZ1	1359	+	1023	1955	2408	0.8118771
A07	16507639	16507925	A07p22780.2_BraZ1	195	-	45	286	286	1.0000000
A07	16512558	16512829	A07p22790.2_BraZ1	165	-	0	0	271	0.0000000
A07	16514807	16516239	A07p22800.2_BraZ1	855	+	507	1018	1432	0.7108939
A07	16524972	16526099	A07p22810.2_BraZ1	590.557	-	668	1127	1127	1.0000000
A07	16533672	16534266	A07p22820.2_BraZ1	59.4	+	142	594	594	1.0000000
A07	16534526	16536235	A07p22830.2_BraZ1	1252.36	-	803	1709	1709	1.0000000
A07	16538498	16541337	A07p22840.2_BraZ1	1106.37	+	1604	2792	2839	0.9834449
A07	16541557	16544346	A07p22850.2_BraZ1	1108.64	-	1046	2508	2789	0.8992471
A07	16546332	16549845	A07p22860.2_BraZ1	1405.33	+	1610	3496	3513	0.9951608
A07	16552533	16552689	A07p22870.2_BraZ1	15.6	+	253	156	156	1.0000000
A07	16557390	16560221	A07p22880.2_BraZ1	1579.5	+	858	2138	2831	0.7552102
A07	16562107	16562811	A07p22890.2_BraZ1	2435.25	+	29	514	704	0.7301136
A07	16563042	16564561	A07p22900.2_BraZ1	621	+	84	824	1519	0.5424622
A07	16569743	16573235	A07p22910.2_BraZ1	1466.45	+	2210	3488	3492	0.9988545
A07	16578876	16580932	A07p22920.2_BraZ1	1465.2	-	389	1514	2056	0.7363814
A07	16583267	16584470	A07p22930.2_BraZ1	4533.75	+	784	1188	1203	0.9875312
A07	16586393	16588853	A07p22940.2_BraZ1	1687.93	+	813	2344	2460	0.9528455
A07	16592318	16595017	A07p22950.2_BraZ1	1534.18	-	360	1903	2699	0.7050760
A07	16596292	16597976	A07p22960.2_BraZ1	857.143	-	592	1639	1684	0.9732779
A07	16600750	16601761	A07p22970.2_BraZ1	101.1	+	270	940	1011	0.9297725
A07	16603296	16603905	A07p22980.2_BraZ1	2886	-	371	609	609	1.0000000
A07	16604388	16607901	A07p22990.2_BraZ1	1798.09	-	1914	3300	3513	0.9393681
A07	16612149	16613427	A07p23000.2_BraZ1	127.8	-	285	1173	1278	0.9178404
A07	16614017	16614167	A07p23010.2_BraZ1	15	-	151	150	150	1.0000000
A07	16614188	16614454	A07p23020.2_BraZ1	192	-	89	266	266	1.0000000
A07	16615191	16615407	A07p23030.2_BraZ1	21.6	-	16	48	216	0.2222222
A07	16618140	16618775	A07p23040.2_BraZ1	381.333	+	0	0	635	0.0000000
A07	16620648	16621847	A07p23050.2_BraZ1	433.065	-	308	1005	1199	0.8381985
A07	16626489	16628641	A07p23060.2_BraZ1	301.5	+	1157	2036	2152	0.9460967
A07	16629124	16631570	A07p23070.2_BraZ1	940.5	-	719	2247	2446	0.9186427
A07	16632311	16633925	A07p23080.2_BraZ1	161.4	-	339	1424	1614	0.8822801
A07	16638590	16651233	A07p23090.2_BraZ1	6507.9	+	2606	10620	12643	0.8399905
A07	16652022	16652235	A07p23100.2_BraZ1	21.3	-	50	171	213	0.8028169
A07	16657073	16657643	A07p23110.2_BraZ1	57	+	58	544	570	0.9543859
A07	16662458	16665875	A07p23120.2_BraZ1	1239.49	-	3319	3280	3417	0.9599063
A07	16668451	16672385	A07p23130.2_BraZ1	1840.52	+	1165	3602	3934	0.9156075
A07	16672611	16672968	A07p23140.2_BraZ1	192	-	589	357	357	1.0000000
A07	16674072	16677007	A07p23150.2_BraZ1	1306.73	-	324	1977	2935	0.6735945
A07	16689677	16690443	A07p23160.2_BraZ1	1016	-	474	766	766	1.0000000
A07	16690528	16690762	A07p23170.2_BraZ1	23.4	-	366	234	234	1.0000000
A07	16691448	16694167	A07p23180.2_BraZ1	257.375	-	892	2620	2719	0.9635895
A07	16699266	16702006	A07p23190.2_BraZ1	33337.5	+	833	2589	2740	0.9448905
A07	16702399	16703113	A07p23200.2_BraZ1	498	+	220	580	714	0.8123249
A07	16703400	16708608	A07p23210.2_BraZ1	1210.79	-	2183	4812	5208	0.9239631
A07	16717374	16718760	A07p23220.2_BraZ1	427.769	+	332	1336	1386	0.9639249
A07	16720121	16721263	A07p23230.2_BraZ1	1056	-	147	1008	1142	0.8826620
A07	16724635	16727495	A07p23240.2_BraZ1	753.293	-	2183	2860	2860	1.0000000
A07	16727650	16730467	A07p23250.2_BraZ1	1752	+	1088	2373	2817	0.8423855
A07	16730493	16730673	A07p23260.2_BraZ1	18	+	38	180	180	1.0000000
A07	16736792	16740285	A07p23270.2_BraZ1	1497.35	+	868	3398	3493	0.9728028
A07	16741206	16741893	A07p23280.2_BraZ1	491.625	-	488	678	687	0.9868996
A07	16743614	16745868	A07p23290.2_BraZ1	1451.84	+	699	2229	2254	0.9889086
A07	16746081	16747330	A07p23300.2_BraZ1	392.438	-	1727	1249	1249	1.0000000
A07	16751452	16754158	A07p23310.2_BraZ1	1286.61	+	872	2662	2706	0.9837399
A07	16755185	16759047	A07p23320.2_BraZ1	1880.5	+	869	3123	3862	0.8086483
A07	16760581	16764063	A07p23330.2_BraZ1	1332.71	+	512	2580	3482	0.7409534
A07	16764999	16766003	A07p23340.2_BraZ1	723	-	157	856	1004	0.8525897
A07	16768982	16769551	A07p23350.2_BraZ1	381	+	345	565	569	0.9929701
A07	16770425	16774796	A07p23360.2_BraZ1	2259.21	+	1841	3751	4371	0.8581560
A07	16780982	16781156	A07p23370.2_BraZ1	17.4	-	194	174	174	1.0000000
A07	16788186	16791845	A07p23380.2_BraZ1	2218.39	+	878	3007	3659	0.8218092
A07	16795752	16796238	A07p23390.2_BraZ1	48.6	+	112	290	486	0.5967078
A07	16796738	16799468	A07p23400.2_BraZ1	25884	-	639	2294	2730	0.8402930
A07	16804948	16806545	A07p23410.2_BraZ1	921.857	-	1249	1597	1597	1.0000000
A07	16808614	16813167	A07p23420.2_BraZ1	2172	-	2666	4553	4553	1.0000000
A07	16821937	16824136	A07p23430.2_BraZ1	1503	+	326	1384	2199	0.6293770
A07	16830448	16832290	A07p23440.2_BraZ1	7166.25	-	2758	1842	1842	1.0000000
A07	16832603	16834303	A07p23450.2_BraZ1	216.48	-	1734	1700	1700	1.0000000
A07	16834838	16835436	A07p23460.2_BraZ1	26.7	-	265	598	598	1.0000000
A07	16836169	16837190	A07p23470.2_BraZ1	887.643	-	991	1021	1021	1.0000000
A07	16841632	16842133	A07p23480.2_BraZ1	50.1	-	106	414	501	0.8263473
A07	16843344	16844016	A07p23490.2_BraZ1	396	+	407	672	672	1.0000000
A07	16844453	16846795	A07p23500.2_BraZ1	615	-	283	2004	2342	0.8556789
A07	16855149	16856619	A07p23510.2_BraZ1	12680	-	594	1455	1470	0.9897959
A07	16869657	16875855	A07p23520.2_BraZ1	3944.66	+	1177	4959	6198	0.8000968
A07	16877869	16878879	A07p23530.2_BraZ1	657.455	+	540	913	1010	0.9039604
A07	16879393	16880579	A07p23540.2_BraZ1	665.625	-	361	1186	1186	1.0000000
A07	16882364	16883182	A07p23550.2_BraZ1	467.5	-	29	186	818	0.2273839
A07	16885147	16885864	A07p23560.2_BraZ1	71.7	+	109	601	717	0.8382148
A07	16886160	16886682	A07p23570.2_BraZ1	174	-	135	485	522	0.9291188
A07	16890619	16891129	A07p23580.2_BraZ1	168	-	106	510	510	1.0000000
A07	16892339	16893522	A07p23590.2_BraZ1	732.955	+	653	913	1183	0.7717667
A07	16893764	16897469	A07p23600.2_BraZ1	1991.25	-	865	3470	3705	0.9365722
A07	16904524	16908502	A07p23610.2_BraZ1	1509.98	-	1567	3970	3978	0.9979889
A07	16909024	16911178	A07p23620.2_BraZ1	1080	+	340	1398	2154	0.6490251
A07	16913235	16913742	A07p23630.2_BraZ1	50.7	+	5	101	507	0.1992110
A07	16913779	16916275	A07p23640.2_BraZ1	473.783	-	1012	2173	2496	0.8705930
A07	16917156	16917573	A07p23650.2_BraZ1	41.7	+	145	417	417	1.0000000
A07	16919874	16921048	A07p23660.2_BraZ1	606	+	522	817	1174	0.6959114
A07	16921509	16928649	A07p23670.2_BraZ1	2236.56	-	2020	6007	7140	0.8413165
A07	16936006	16937477	A07p23680.2_BraZ1	6017.25	-	818	1424	1471	0.9680489
A07	16937715	16938500	A07p23690.2_BraZ1	366.6	+	169	758	785	0.9656051
A07	16939788	16940413	A07p23700.2_BraZ1	4998.75	-	154	615	625	0.9840000
A07	16941239	16941768	A07p23710.2_BraZ1	294.915	-	204	529	529	1.0000000
A07	16943549	16945640	A07p23720.2_BraZ1	829.85	-	1175	2072	2091	0.9909135
A07	16946725	16949134	A07p23730.2_BraZ1	1506	+	0	0	2409	0.0000000
A07	16952985	16953272	A07p23740.2_BraZ1	180	+	0	0	287	0.0000000
A07	16955319	16956037	A07p23750.2_BraZ1	216	-	0	0	718	0.0000000
A07	16957824	16959453	A07p23760.2_BraZ1	162.9	+	338	1259	1629	0.7728668
A07	16962588	16965253	A07p23770.2_BraZ1	1791	-	198	1916	2665	0.7189493
A07	16973721	16975285	A07p23780.2_BraZ1	857.196	+	790	1556	1564	0.9948849
A07	16988813	16990051	A07p23790.2_BraZ1	384	-	427	900	1238	0.7269790
A07	17000383	17001689	A07p23800.2_BraZ1	2272.88	+	1258	1306	1306	1.0000000
A07	17002109	17002279	A07p23810.2_BraZ1	14.1	+	6	25	170	0.1470588
A07	17002568	17002802	A07p23820.2_BraZ1	23.4	-	0	0	234	0.0000000
A07	17003118	17003382	A07p23830.2_BraZ1	880	-	6	227	264	0.8598485
A07	17006757	17010618	A07p23840.2_BraZ1	1861.54	+	3281	3822	3861	0.9898990
A07	17011795	17012911	A07p23850.2_BraZ1	111.6	-	62	117	1116	0.1048387
A07	17014634	17015144	A07p23860.2_BraZ1	51	+	485	510	510	1.0000000
A07	17017293	17019523	A07p23870.2_BraZ1	555	-	629	1920	2230	0.8609865
A07	17021956	17023726	A07p23880.2_BraZ1	1085.33	-	2402	1770	1770	1.0000000
A07	17024896	17025919	A07p23890.2_BraZ1	102.3	+	978	1023	1023	1.0000000
A07	17026893	17028849	A07p23900.2_BraZ1	857.812	+	784	1956	1956	1.0000000
A07	17029075	17029954	A07p23910.2_BraZ1	612	-	130	706	879	0.8031855
A07	17030537	17031006	A07p23920.2_BraZ1	447	+	16	129	469	0.2750533
A07	17038910	17040516	A07p23930.2_BraZ1	547.826	+	1045	1606	1606	1.0000000
A07	17046069	17050813	A07p23940.2_BraZ1	929.231	+	2456	4304	4744	0.9072512
A07	17052650	17055108	A07p23950.2_BraZ1	1016.25	+	2405	2322	2458	0.9446704
A07	17058314	17059825	A07p23960.2_BraZ1	3976	+	524	1511	1511	1.0000000
A07	17060123	17060829	A07p23970.2_BraZ1	624	-	377	706	706	1.0000000
A07	17061729	17063358	A07p23980.2_BraZ1	708.4	-	775	1606	1629	0.9858809
A07	17076655	17080613	A07p23990.2_BraZ1	966	+	1139	3619	3958	0.9143507
A07	17082333	17085085	A07p24000.2_BraZ1	2063.69	-	744	2237	2752	0.8128633
A07	17085114	17085706	A07p24010.2_BraZ1	231	-	429	592	592	1.0000000
A07	17086240	17088763	A07p24020.2_BraZ1	1170	-	1809	2519	2523	0.9984146
A07	17089191	17091361	A07p24030.2_BraZ1	1155	-	1180	2130	2170	0.9815668
A07	17091642	17092948	A07p24040.2_BraZ1	719.1	+	565	1306	1306	1.0000000
A07	17093308	17093816	A07p24050.2_BraZ1	300	+	37	325	508	0.6397638
A07	17097218	17103325	A07p24060.2_BraZ1	1359	-	17789	5935	6107	0.9718356
A07	17106278	17106683	A07p24070.2_BraZ1	40.5	+	231	405	405	1.0000000
A07	17107019	17109030	A07p24080.2_BraZ1	1425	-	951	1962	2011	0.9756340
A07	17110190	17113333	A07p24090.2_BraZ1	42910	-	2546	3141	3143	0.9993637
A07	17115160	17116216	A07p24100.2_BraZ1	135	-	25	435	1056	0.4119318
A07	17121284	17122352	A07p24110.2_BraZ1	417	+	539	1006	1068	0.9419476
A07	17125567	17125738	A07p24120.2_BraZ1	17.1	-	23	171	171	1.0000000
A07	17126636	17126971	A07p24130.2_BraZ1	30.9	-	224	335	335	1.0000000
A07	17131004	17133771	A07p24140.2_BraZ1	658.534	+	585	2249	2767	0.8127936
A07	17134059	17134873	A07p24150.2_BraZ1	498	-	811	814	814	1.0000000
A07	17136253	17136826	A07p24160.2_BraZ1	57.3	+	56	396	573	0.6910995
A07	17138581	17140313	A07p24170.2_BraZ1	7621.2	+	418	1717	1732	0.9913395
A07	17144169	17151115	A07p24180.2_BraZ1	2884.21	+	1982	5764	6946	0.8298301
A07	17160839	17161874	A07p24190.2_BraZ1	942	+	271	980	1035	0.9468599
A07	17161893	17165028	A07p24200.2_BraZ1	618	+	2673	3135	3135	1.0000000
A07	17168695	17175729	A07p24210.2_BraZ1	2144.73	+	5691	6159	7034	0.8756042
A07	17189277	17197977	A07p24220.2_BraZ1	86.1	+	2144	7419	8700	0.8527586
A07	17192110	17193810	A07p24230.2_BraZ1	1323	+	509	1657	1700	0.9747059
A07	17198713	17199512	A07p24240.2_BraZ1	570	+	361	799	799	1.0000000
A07	17201578	17202916	A07p24250.2_BraZ1	10164	-	86	938	1338	0.7010463
A07	17203629	17204649	A07p24260.2_BraZ1	573	-	436	1011	1020	0.9911765
A07	17205670	17209176	A07p24270.2_BraZ1	1517.14	+	1849	3370	3506	0.9612094
A07	17211171	17212719	A07p24280.2_BraZ1	1470	-	244	1290	1548	0.8333333
A07	17212846	17217651	A07p24290.2_BraZ1	189	-	2093	4457	4805	0.9275755
A07	17221360	17221737	A07p24300.2_BraZ1	330	+	288	377	377	1.0000000
A07	17222337	17222846	A07p24310.2_BraZ1	33.6	-	659	509	509	1.0000000
A07	17225757	17226825	A07p24320.2_BraZ1	106.8	-	200	751	1068	0.7031835
A07	17233128	17234874	A07p24330.2_BraZ1	1431	-	614	1375	1746	0.7875143
A07	17240602	17243221	A07p24340.2_BraZ1	249	-	33011	2619	2619	1.0000000
A07	17246466	17248195	A07p24350.2_BraZ1	665.832	+	1196	1726	1729	0.9982649
A07	17249995	17251691	A07p24360.2_BraZ1	1140.27	+	677	1569	1696	0.9251179
A07	17253712	17254740	A07p24370.2_BraZ1	557.322	+	786	1028	1028	1.0000000
A07	17255342	17258166	A07p24380.2_BraZ1	2521.92	-	955	2609	2824	0.9238669
A07	17262699	17263181	A07p24390.2_BraZ1	192	-	38	353	482	0.7323651
A07	17263420	17263594	A07p24400.2_BraZ1	17.4	-	25	163	174	0.9367816
A07	17266370	17268721	A07p24410.2_BraZ1	2205	-	143	1191	2351	0.5065929
A07	17283384	17284911	A07p24420.2_BraZ1	718.52	-	38	503	1527	0.3294041
A07	17288830	17289701	A07p24430.2_BraZ1	451.5	+	245	871	871	1.0000000
A07	17291837	17295368	A07p24440.2_BraZ1	2935.87	+	486	2558	3531	0.7244407
A07	17298423	17300973	A07p24450.2_BraZ1	1419	-	194	1372	2550	0.5380392
A07	17303759	17311758	A07p24460.2_BraZ1	2004.62	-	3150	7612	7999	0.9516190
A07	17318872	17320849	A07p24470.2_BraZ1	548.018	+	1390	1977	1977	1.0000000
A07	17325086	17325254	A07p24480.2_BraZ1	16.8	+	85	165	168	0.9821429
A07	17326019	17328080	A07p24490.2_BraZ1	513	+	940	2061	2061	1.0000000
A07	17328573	17330628	A07p24500.2_BraZ1	205.2	-	66	758	2055	0.3688565
A07	17332467	17333364	A07p24510.2_BraZ1	89.7	-	4	165	897	0.1839465
A07	17334633	17335909	A07p24520.2_BraZ1	309	+	876	1245	1276	0.9757053
A07	17338009	17338126	A07p24530.2_BraZ1	11.7	-	139	117	117	1.0000000
A07	17341468	17344179	A07p24540.2_BraZ1	544	+	200	1911	2711	0.7049059
A07	17349028	17349553	A07p24550.2_BraZ1	52.5	+	28	127	525	0.2419048
A07	17352861	17353868	A07p24560.2_BraZ1	658.364	+	322	1007	1007	1.0000000
A07	17355433	17357446	A07p24570.2_BraZ1	1362	+	156	1245	2013	0.6184799
A07	17359616	17365702	A07p24580.2_BraZ1	184.091	+	6055	5599	6086	0.9199803
A07	17386433	17388590	A07p24590.2_BraZ1	1105.24	+	222	1454	2157	0.6740844
A07	17393941	17395913	A07p24600.2_BraZ1	5617.5	+	438	1556	1972	0.7890466
A07	17398352	17399365	A07p24610.2_BraZ1	425.25	+	340	836	1013	0.8252715
A07	17401997	17403314	A07p24620.2_BraZ1	917.73	-	785	1317	1317	1.0000000
A07	17413577	17415775	A07p24630.2_BraZ1	1414.29	+	1110	2134	2198	0.9708826
A07	17417189	17418584	A07p24640.2_BraZ1	698.906	-	891	1395	1395	1.0000000
A07	17424754	17427154	A07p24650.2_BraZ1	11058	-	659	2209	2400	0.9204167
A07	17430344	17430977	A07p24660.2_BraZ1	63.3	-	101	577	633	0.9115324
A07	17432136	17435172	A07p24670.2_BraZ1	2133.25	+	1702	2748	3036	0.9051383
A07	17436800	17437601	A07p24680.2_BraZ1	638.182	+	157	796	801	0.9937578
A07	17437875	17439799	A07p24690.2_BraZ1	804.34	-	1714	1924	1924	1.0000000
A07	17447220	17448255	A07p24700.2_BraZ1	441.083	+	258	746	1035	0.7207729
A07	17449831	17453356	A07p24710.2_BraZ1	1499.17	-	2471	3461	3525	0.9818439
A07	17454927	17456141	A07p24720.2_BraZ1	415.333	-	1434	1214	1214	1.0000000
A07	17456408	17457123	A07p24730.2_BraZ1	265.588	-	0	0	715	0.0000000
A07	17470641	17472160	A07p24740.2_BraZ1	831.273	+	1753	1519	1519	1.0000000
A07	17472592	17473000	A07p24750.2_BraZ1	40.8	-	292	408	408	1.0000000
A07	17476763	17477530	A07p24760.2_BraZ1	525	-	575	653	767	0.8513690
A07	17479129	17484536	A07p24770.2_BraZ1	2616.3	-	3281	5402	5407	0.9990753
A07	17485075	17486227	A07p24780.2_BraZ1	115.2	-	1001	1152	1152	1.0000000
A07	17489671	17489785	A07p24790.2_BraZ1	11.4	-	415	114	114	1.0000000
A07	17489968	17490082	A07p24800.2_BraZ1	11.4	-	506	114	114	1.0000000
A07	17491420	17492987	A07p24810.2_BraZ1	852	-	681	1428	1567	0.9112955
A07	17511126	17515724	A07p24820.2_BraZ1	4189.5	-	2092	4433	4598	0.9641148
A07	17516720	17519754	A07p24830.2_BraZ1	1008.13	-	1855	3034	3034	1.0000000
A07	17520614	17523083	A07p24840.2_BraZ1	1360.03	-	913	2400	2469	0.9720535
A07	17529339	17530470	A07p24850.2_BraZ1	377.719	+	981	1131	1131	1.0000000
A07	17532547	17534313	A07p24860.2_BraZ1	858	+	670	1766	1766	1.0000000
A07	17536099	17537884	A07p24870.2_BraZ1	914.062	-	64	1130	1785	0.6330532
A07	17542445	17544013	A07p24880.2_BraZ1	1503	+	103	1082	1568	0.6900510
A07	17545707	17548288	A07p24890.2_BraZ1	1503	-	472	2070	2581	0.8020147
A07	17550433	17552807	A07p24900.2_BraZ1	1575	-	560	2310	2374	0.9730413
A07	17560610	17560929	A07p24910.2_BraZ1	622.125	+	6	158	319	0.4952978
A07	17561572	17563412	A07p24920.2_BraZ1	315	+	932	1603	1840	0.8711957
A07	17563827	17565427	A07p24930.2_BraZ1	1159.3	-	549	1576	1600	0.9850000
A07	17566202	17567289	A07p24940.2_BraZ1	53.4	-	319	1081	1087	0.9944802
A07	17568779	17570479	A07p24950.2_BraZ1	987	-	466	1565	1700	0.9205883
A07	17575072	17576205	A07p24960.2_BraZ1	801	-	719	1120	1133	0.9885260
A07	17577266	17579883	A07p24970.2_BraZ1	157.5	+	1363	2465	2617	0.9419183
A07	17580680	17581365	A07p24980.2_BraZ1	51.8824	-	244	681	685	0.9941606
A07	17582988	17595069	A07p24990.2_BraZ1	2154.03	+	5064	10978	12081	0.9086996
A07	17586112	17588473	A07p25000.2_BraZ1	1662.86	-	596	2295	2361	0.9720457
A07	17592639	17592958	A07p25010.2_BraZ1	222	+	164	319	319	1.0000000
A07	17595320	17596499	A07p25020.2_BraZ1	71.7	-	347	1122	1179	0.9516540
A07	17599211	17602561	A07p25030.2_BraZ1	2225.37	+	1	3	3350	0.0008955
A07	17609890	17613240	A07p25040.2_BraZ1	2228.54	+	1	9	3350	0.0026866
A07	17625482	17626371	A07p25050.2_BraZ1	750	-	14	366	889	0.4116985
A07	17630873	17631773	A07p25060.2_BraZ1	750	-	6	142	900	0.1577778
A07	17641417	17644811	A07p25070.2_BraZ1	1835.67	-	822	3088	3394	0.9098409
A07	17652579	17654503	A07p25080.2_BraZ1	1113	-	147	739	1924	0.3840956
A07	17656925	17658137	A07p25090.2_BraZ1	647.687	+	263	1123	1212	0.9265677
A07	17658897	17659616	A07p25100.2_BraZ1	180.8	-	91	613	719	0.8525730
A07	17662534	17664419	A07p25110.2_BraZ1	12496	+	1129	1855	1885	0.9840849
A07	17665647	17666871	A07p25120.2_BraZ1	122.4	+	1194	1224	1224	1.0000000
A07	17673243	17674549	A07p25130.2_BraZ1	382.375	-	0	0	1306	0.0000000
A07	17680210	17682408	A07p25140.2_BraZ1	1389	+	286	1445	2198	0.6574158
A07	17683302	17686329	A07p25150.2_BraZ1	2258.35	-	215	1792	3027	0.5920053
A07	17687618	17689262	A07p25160.2_BraZ1	164.4	-	329	1418	1644	0.8625304
A07	17691189	17691669	A07p25170.2_BraZ1	357	-	574	480	480	1.0000000
A07	17694960	17695688	A07p25180.2_BraZ1	207	-	298	728	728	1.0000000
A07	17700147	17701267	A07p25190.2_BraZ1	1026	-	70	445	1120	0.3973214
A07	17716196	17717406	A07p25200.2_BraZ1	524.771	+	388	1172	1210	0.9685950
A07	17717928	17718564	A07p25210.2_BraZ1	309	+	164	636	636	1.0000000
A07	17719305	17724498	A07p25220.2_BraZ1	2612.55	-	1961	4410	5193	0.8492201
A07	17726689	17727041	A07p25230.2_BraZ1	264	-	409	352	352	1.0000000
A07	17731888	17733445	A07p25240.2_BraZ1	731.591	+	948	1557	1557	1.0000000
A07	17737797	17739183	A07p25250.2_BraZ1	138.6	+	417	1344	1386	0.9696970
A07	17745772	17747198	A07p25260.2_BraZ1	1341	+	837	1426	1426	1.0000000
A07	17747678	17749132	A07p25270.2_BraZ1	1001.58	-	386	927	1454	0.6375516
A07	17754820	17755102	A07p25280.2_BraZ1	28.2	+	103	282	282	1.0000000
A07	17755386	17755768	A07p25290.2_BraZ1	303	-	349	382	382	1.0000000
A07	17756208	17757109	A07p25300.2_BraZ1	732	-	434	901	901	1.0000000
A07	17759750	17760128	A07p25310.2_BraZ1	32.7	+	200	378	378	1.0000000
A07	17764527	17766851	A07p25320.2_BraZ1	986.82	-	543	2046	2324	0.8803787
A07	17771633	17774197	A07p25330.2_BraZ1	1451.67	-	775	2225	2564	0.8677847
A07	17782519	17798602	A07p25340.2_BraZ1	1028.83	+	4706	13710	16083	0.8524529
A07	17803295	17804858	A07p25350.2_BraZ1	1476	-	178	1495	1563	0.9564939
A07	17808133	17815183	A07p25360.2_BraZ1	543	-	3729	6584	7050	0.9339007
A07	17816828	17820206	A07p25370.2_BraZ1	1022.9	-	2344	3378	3378	1.0000000
A07	17824096	17826654	A07p25380.2_BraZ1	1093.02	+	2744	2558	2558	1.0000000
A07	17828014	17828860	A07p25390.2_BraZ1	84.6	-	869	846	846	1.0000000
A07	17829568	17837323	A07p25400.2_BraZ1	3680	+	5999	7327	7755	0.9448098
A07	17840665	17841793	A07p25410.2_BraZ1	417	-	589	1128	1128	1.0000000
A07	17841266	17842151	A07p25420.2_BraZ1	537	+	578	885	885	1.0000000
A07	17842619	17843216	A07p25430.2_BraZ1	381	+	234	597	597	1.0000000
A07	17844016	17846043	A07p25440.2_BraZ1	1125	+	203	1187	2027	0.5855945
A07	17851194	17851722	A07p25450.2_BraZ1	33	-	548	528	528	1.0000000
A07	17857334	17857520	A07p25460.2_BraZ1	18.6	+	5	101	186	0.5430108
A07	17858262	17858517	A07p25470.2_BraZ1	189	-	278	255	255	1.0000000
A07	17859181	17860201	A07p25480.2_BraZ1	102	+	692	1020	1020	1.0000000
A07	17861114	17862218	A07p25490.2_BraZ1	110.4	+	498	1104	1104	1.0000000
A07	17866282	17869250	A07p25500.2_BraZ1	803.961	-	1144	2968	2968	1.0000000
A07	17872849	17873109	A07p25510.2_BraZ1	177	-	120	260	260	1.0000000
A07	17876108	17878439	A07p25520.2_BraZ1	232.5	-	443	2078	2331	0.8914629
A07	17884431	17889900	A07p25530.2_BraZ1	2010.19	+	1887	4548	5469	0.8315963
A07	17890427	17891676	A07p25540.2_BraZ1	833.143	-	259	973	1249	0.7790232
A07	17893272	17894164	A07p25550.2_BraZ1	408	-	1057	892	892	1.0000000
A07	17897311	17898126	A07p25560.2_BraZ1	460.184	+	809	815	815	1.0000000
A07	17898451	17899648	A07p25570.2_BraZ1	1101	-	735	1197	1197	1.0000000
A07	17915688	17918036	A07p25580.2_BraZ1	627.136	+	1355	2294	2348	0.9770017
A07	17918808	17918965	A07p25590.2_BraZ1	13.8	-	136	157	157	1.0000000
A07	17919253	17920306	A07p25600.2_BraZ1	369	-	617	1029	1053	0.9772080
A07	17924478	17926281	A07p25610.2_BraZ1	180.3	+	643	1765	1803	0.9789240
A07	17935782	17935893	A07p25620.2_BraZ1	11.1	+	21	99	111	0.8918919
A07	17936361	17936718	A07p25630.2_BraZ1	279	+	6	117	357	0.3277311
A07	17939104	17941210	A07p25640.2_BraZ1	659.44	-	746	2060	2106	0.9781576
A07	17942961	17944275	A07p25650.2_BraZ1	131.4	+	590	1189	1314	0.9048706
A07	17947791	17948865	A07p25660.2_BraZ1	22479.8	+	172	794	1074	0.7392924
A07	17951989	17953891	A07p25670.2_BraZ1	1226.7	-	110	974	1902	0.5120925
A07	17957886	17958099	A07p25680.2_BraZ1	21.3	+	24	130	213	0.6103286
A07	17963008	17963758	A07p25690.2_BraZ1	75	-	551	750	750	1.0000000
A07	17966644	17967013	A07p25700.2_BraZ1	36.9	-	265	369	369	1.0000000
A07	17967776	17968618	A07p25710.2_BraZ1	513	-	541	801	842	0.9513064
A07	17969367	17971713	A07p25720.2_BraZ1	234.6	+	737	2206	2346	0.9403239
A07	17975236	17977024	A07p25730.2_BraZ1	873.409	-	806	1644	1788	0.9194631
A07	17985498	17987152	A07p25740.2_BraZ1	608.375	+	1263	1654	1654	1.0000000
A07	17987491	17990014	A07p25750.2_BraZ1	1188.52	-	1736	2495	2523	0.9889021
A07	17990465	17994333	A07p25760.2_BraZ1	533.311	-	2450	3682	3868	0.9519131
A07	17994741	18002163	A07p25770.2_BraZ1	2968.47	+	2659	6462	7422	0.8706548
A07	18002805	18003720	A07p25780.2_BraZ1	385.778	-	1162	915	915	1.0000000
A07	18004285	18005858	A07p25790.2_BraZ1	929.829	+	612	1567	1573	0.9961857
A07	18009805	18010376	A07p25800.2_BraZ1	3984	-	317	571	571	1.0000000
A07	18010731	18011221	A07p25810.2_BraZ1	47.4	-	430	490	490	1.0000000
A07	18013236	18021789	A07p25820.2_BraZ1	365.106	-	4287	7166	8553	0.8378347
A07	18022739	18025951	A07p25830.2_BraZ1	325.379	-	2642	3212	3212	1.0000000
A07	18026998	18033573	A07p25840.2_BraZ1	539.949	-	4798	6053	6575	0.9206083
A07	18033868	18039267	A07p25850.2_BraZ1	2708.83	-	1207	4077	5399	0.7551398
A07	18044383	18044938	A07p25860.2_BraZ1	55.5	+	294	555	555	1.0000000
A07	18049260	18050458	A07p25870.2_BraZ1	793.565	-	179	884	1198	0.7378965
A07	18056035	18056398	A07p25880.2_BraZ1	234	+	242	363	363	1.0000000
A07	18058996	18062066	A07p25890.2_BraZ1	891.798	+	1352	3055	3070	0.9951140
A07	18063184	18066940	A07p25900.2_BraZ1	173	-	4759	3606	3756	0.9600639
A07	18074826	18075872	A07p25910.2_BraZ1	446.857	+	1115	1046	1046	1.0000000
A07	18076903	18078909	A07p25920.2_BraZ1	1219.95	+	1359	2006	2006	1.0000000
A07	18079326	18082131	A07p25930.2_BraZ1	871.709	-	1479	2805	2805	1.0000000
A07	18084067	18087044	A07p25940.2_BraZ1	1762.56	+	1333	2785	2977	0.9355056
A07	18087691	18088438	A07p25950.2_BraZ1	504	-	607	747	747	1.0000000
A07	18089110	18091776	A07p25960.2_BraZ1	1754.74	-	547	2491	2666	0.9343586
A07	18093315	18096141	A07p25970.2_BraZ1	1811.65	+	1423	2091	2826	0.7399151
A07	18096611	18099544	A07p25980.2_BraZ1	1438.97	-	1222	2898	2933	0.9880669
A07	18100846	18103567	A07p25990.2_BraZ1	1711	+	612	2627	2721	0.9654539
A07	18104711	18106227	A07p26000.2_BraZ1	945	-	641	1492	1516	0.9841689
A07	18107271	18111645	A07p26010.2_BraZ1	1993.41	-	1734	4347	4374	0.9938272
A07	18113474	18116300	A07p26020.2_BraZ1	1828.45	-	2148	2826	2826	1.0000000
A07	18118031	18120687	A07p26030.2_BraZ1	1347.4	+	1431	2652	2656	0.9984940
A07	18121299	18122733	A07p26040.2_BraZ1	623.5	+	1314	1434	1434	1.0000000
A07	18123056	18124012	A07p26050.2_BraZ1	2259.75	-	1274	956	956	1.0000000
A07	18124463	18125249	A07p26060.2_BraZ1	78.6	-	98	694	786	0.8829517
A07	18130906	18140132	A07p26070.2_BraZ1	250.8	+	316	3518	9226	0.3813137
A07	18141513	18157600	A07p26080.2_BraZ1	338.1	+	1749	8963	16087	0.5571579
A07	18161001	18161193	A07p26090.2_BraZ1	19.2	+	32	135	192	0.7031250
A07	18165726	18168389	A07p26100.2_BraZ1	1477.01	-	1837	2598	2663	0.9755914
A07	18169246	18170601	A07p26110.2_BraZ1	588	-	199	629	1355	0.4642066
A07	18176154	18176991	A07p26120.2_BraZ1	189	+	303	817	837	0.9761052
A07	18182369	18192225	A07p26130.2_BraZ1	757.816	+	2664	6906	9856	0.7006899
A07	18186821	18187586	A07p26140.2_BraZ1	76.5	+	7	38	765	0.0496732
A07	18192622	18196663	A07p26150.2_BraZ1	1532.35	-	1180	3956	4041	0.9789656
A07	18199642	18201061	A07p26160.2_BraZ1	745.136	-	495	1366	1419	0.9626498
A07	18201925	18202654	A07p26170.2_BraZ1	72.9	-	501	729	729	1.0000000
A07	18203082	18207459	A07p26180.2_BraZ1	1152.6	-	4859	4377	4377	1.0000000
A07	18205917	18206226	A07p26190.2_BraZ1	30.9	-	332	309	309	1.0000000
A07	18210770	18212322	A07p26200.2_BraZ1	928.636	-	1989	1552	1552	1.0000000
A07	18213176	18214752	A07p26210.2_BraZ1	222.886	-	1636	1576	1576	1.0000000
A07	18215815	18221701	A07p26220.2_BraZ1	3016.69	-	1712	5333	5886	0.9060482
A07	18223468	18225955	A07p26230.2_BraZ1	1484.42	+	1215	2487	2487	1.0000000
A07	18226299	18229579	A07p26240.2_BraZ1	1415.98	-	2041	3202	3280	0.9762195
A07	18231571	18231812	A07p26250.2_BraZ1	180	+	86	241	241	1.0000000
A07	18233461	18235093	A07p26260.2_BraZ1	163.2	+	536	1632	1632	1.0000000
A07	18235864	18250012	A07p26270.2_BraZ1	5580	+	3723	12059	14148	0.8523466
A07	18251926	18254011	A07p26280.2_BraZ1	1474.96	+	1340	1907	2085	0.9146283
A07	18257678	18268002	A07p26290.2_BraZ1	2346.55	+	2795	8808	10324	0.8531577
A07	18263973	18264678	A07p26300.2_BraZ1	648	+	288	705	705	1.0000000
A07	18268508	18268865	A07p26310.2_BraZ1	312	-	50	231	357	0.6470588
A07	18270792	18276281	A07p26320.2_BraZ1	693.818	+	1723	4900	5489	0.8926945
A07	18272815	18274354	A07p26330.2_BraZ1	1216	-	534	1530	1539	0.9941521
A07	18276762	18277483	A07p26340.2_BraZ1	286.5	-	251	683	721	0.9472954
A07	18277483	18278301	A07p26350.2_BraZ1	744	-	106	764	818	0.9339854
A07	18278820	18280212	A07p26360.2_BraZ1	612	+	208	1249	1392	0.8972701
A07	18281107	18282039	A07p26370.2_BraZ1	843	-	489	917	932	0.9839056
A07	18282939	18283841	A07p26380.2_BraZ1	288	-	426	902	902	1.0000000
A07	18291719	18295725	A07p26390.2_BraZ1	2332.21	+	1471	3958	4006	0.9880180
A07	18299096	18301639	A07p26400.2_BraZ1	1283.74	+	1588	2543	2543	1.0000000
A07	18302012	18304026	A07p26410.2_BraZ1	607.2	-	2906	2000	2014	0.9930487
A07	18307239	18308789	A07p26420.2_BraZ1	933.033	+	843	1468	1550	0.9470968
A07	18310051	18311889	A07p26430.2_BraZ1	691.031	+	2258	1838	1838	1.0000000
A07	18312603	18313386	A07p26440.2_BraZ1	78.3	-	171	737	783	0.9412516
A07	18318445	18319057	A07p26450.2_BraZ1	61.2	+	111	549	612	0.8970588
A07	18319444	18320474	A07p26460.2_BraZ1	810	-	168	1006	1030	0.9766991
A07	18323908	18325220	A07p26470.2_BraZ1	950.344	+	170	1312	1312	1.0000000
A07	18326613	18327696	A07p26480.2_BraZ1	379.641	+	547	1083	1083	1.0000000
A07	18327980	18329207	A07p26490.2_BraZ1	122.7	-	67	568	1227	0.4629177
A07	18331677	18331809	A07p26500.2_BraZ1	13.2	-	325	132	132	1.0000000
A07	18332007	18333229	A07p26510.2_BraZ1	243.656	-	886	1185	1222	0.9697218
A07	18343557	18349823	A07p26520.2_BraZ1	3659.88	+	3696	5333	6266	0.8511012
A07	18350153	18353820	A07p26530.2_BraZ1	967.372	-	1793	3609	3667	0.9841833
A07	18358384	18360055	A07p26540.2_BraZ1	1434	+	740	1645	1671	0.9844404
A07	18361638	18362298	A07p26550.2_BraZ1	66	-	419	297	660	0.4500000
A07	18365053	18367025	A07p26560.2_BraZ1	130.8	+	817	1812	1972	0.9188641
A07	18368686	18370521	A07p26570.2_BraZ1	684.938	-	947	1695	1835	0.9237057
A07	18371145	18371337	A07p26580.2_BraZ1	19.2	+	34	174	192	0.9062500
A07	18376111	18377501	A07p26590.2_BraZ1	1011	-	435	1309	1390	0.9417266
A07	18378330	18384478	A07p26600.2_BraZ1	4621.75	-	1553	5685	6148	0.9246910
A07	18385687	18388888	A07p26610.2_BraZ1	1203.63	+	1173	2978	3201	0.9303343
A07	18390684	18398383	A07p26620.2_BraZ1	1237.71	+	1447	5282	7699	0.6860631
A07	18407789	18408387	A07p26630.2_BraZ1	276	+	562	598	598	1.0000000
A07	18408986	18411705	A07p26640.2_BraZ1	1368.78	-	869	2322	2719	0.8539904
A07	18412133	18412415	A07p26650.2_BraZ1	28.2	-	56	282	282	1.0000000
A07	18417214	18417625	A07p26660.2_BraZ1	41.1	+	168	411	411	1.0000000
A07	18418550	18421558	A07p26670.2_BraZ1	1229.31	+	1526	2939	3008	0.9770612
A07	18429864	18432165	A07p26680.2_BraZ1	743.743	+	1282	2082	2301	0.9048240
A07	18433890	18436782	A07p26690.2_BraZ1	1742.22	+	1475	2881	2892	0.9961964
A07	18437431	18439810	A07p26700.2_BraZ1	1029.46	-	2068	2379	2379	1.0000000
A07	18440451	18440922	A07p26710.2_BraZ1	47.1	-	46	416	471	0.8832272
A07	18449305	18453703	A07p26720.2_BraZ1	709.312	+	1246	3897	4398	0.8860846
A07	18454409	18459294	A07p26730.2_BraZ1	1118.33	+	1986	4749	4885	0.9721597
A07	18459910	18465868	A07p26740.2_BraZ1	3961.94	-	1510	4606	5958	0.7730782
A07	18472007	18472745	A07p26750.2_BraZ1	73.8	+	316	738	738	1.0000000
A07	18472915	18473090	A07p26760.2_BraZ1	156	+	110	175	175	1.0000000
A07	18474346	18475357	A07p26770.2_BraZ1	101.1	-	369	985	1011	0.9742829
A07	18485647	18486824	A07p26780.2_BraZ1	3371.14	-	259	756	1177	0.6423110
A07	18488760	18489392	A07p26790.2_BraZ1	363	+	224	632	632	1.0000000
A07	18490159	18491348	A07p26800.2_BraZ1	750.865	-	274	1185	1189	0.9966359
A07	18494500	18499690	A07p26810.2_BraZ1	1151.39	+	3218	5027	5190	0.9685935
A07	18499874	18502337	A07p26820.2_BraZ1	246.3	-	1228	2389	2463	0.9699553
A07	18506592	18510329	A07p26830.2_BraZ1	1186.29	+	1727	3289	3737	0.8801177
A07	18510589	18511719	A07p26840.2_BraZ1	960.75	-	156	928	1130	0.8212389
A07	18513455	18515854	A07p26850.2_BraZ1	13281	+	1097	1631	2399	0.6798666
A07	18520295	18521127	A07p26860.2_BraZ1	73.2	+	304	770	832	0.9254808
A07	18521569	18522226	A07p26870.2_BraZ1	483	+	111	347	657	0.5281583
A07	18522747	18524090	A07p26880.2_BraZ1	1083	+	75	534	1343	0.3976173
A07	18535997	18537458	A07p26890.2_BraZ1	729.125	+	573	1416	1461	0.9691992
A07	18538165	18540903	A07p26900.2_BraZ1	1150.87	-	2969	2591	2738	0.9463112
A07	18541476	18554163	A07p26910.2_BraZ1	631.2	-	5913	11294	12687	0.8902026
A07	18561841	18562886	A07p26920.2_BraZ1	738	+	771	1045	1045	1.0000000
A07	18565960	18566182	A07p26930.2_BraZ1	22.2	-	42	210	222	0.9459459
A07	18567867	18568708	A07p26940.2_BraZ1	696	+	155	645	841	0.7669441
A07	18569957	18571100	A07p26950.2_BraZ1	734.25	+	556	1138	1143	0.9956256
A07	18572375	18573263	A07p26960.2_BraZ1	88.8	+	529	722	888	0.8130631
A07	18579033	18580912	A07p26970.2_BraZ1	669.291	+	1134	1879	1879	1.0000000
A07	18581356	18582444	A07p26980.2_BraZ1	1011	+	574	1008	1088	0.9264706
A07	18583912	18588672	A07p26990.2_BraZ1	5908.5	+	4116	4760	4760	1.0000000
A07	18589553	18590833	A07p27000.2_BraZ1	477.025	-	925	1218	1280	0.9515625
A07	18591293	18592581	A07p27010.2_BraZ1	628.518	-	775	1288	1288	1.0000000
A07	18592788	18594675	A07p27020.2_BraZ1	904.132	+	2284	1887	1887	1.0000000
A07	18598015	18599815	A07p27030.2_BraZ1	180	+	1149	1800	1800	1.0000000
A07	18600316	18600712	A07p27040.2_BraZ1	312	-	266	396	396	1.0000000
A07	18601935	18603210	A07p27050.2_BraZ1	127.5	-	597	1275	1275	1.0000000
A07	18619059	18620499	A07p27060.2_BraZ1	504	+	746	1432	1440	0.9944444
A07	18621180	18624366	A07p27070.2_BraZ1	1518	+	1227	2994	3186	0.9397364
A07	18624817	18624973	A07p27080.2_BraZ1	15.6	-	266	156	156	1.0000000
A07	18625033	18626914	A07p27090.2_BraZ1	665.28	-	567	1246	1881	0.6624136
A07	18629842	18631516	A07p27100.2_BraZ1	855.155	+	572	1581	1674	0.9444444
A07	18632553	18633087	A07p27110.2_BraZ1	277.667	-	479	534	534	1.0000000
A07	18635817	18637359	A07p27120.2_BraZ1	489	-	118	1103	1542	0.7153048
A07	18637775	18640487	A07p27130.2_BraZ1	501.682	+	1585	2527	2712	0.9317847
A07	18642072	18642444	A07p27140.2_BraZ1	37.2	-	42	372	372	1.0000000
A07	18643158	18646749	A07p27150.2_BraZ1	2123.34	+	1601	3358	3591	0.9351156
A07	18648744	18650931	A07p27160.2_BraZ1	1136.62	+	456	2051	2187	0.9378144
A07	18651658	18653115	A07p27170.2_BraZ1	321	-	614	1195	1457	0.8201784
A07	18653641	18654042	A07p27180.2_BraZ1	20.1	-	168	401	401	1.0000000
A07	18659874	18660225	A07p27190.2_BraZ1	222	-	20	302	351	0.8603989
A07	18663496	18663848	A07p27200.2_BraZ1	213	-	3	50	352	0.1420455
A07	18666182	18666534	A07p27210.2_BraZ1	213	-	1	85	352	0.2414773
A07	18668866	18669218	A07p27220.2_BraZ1	213	-	33	352	352	1.0000000
A07	18675290	18677633	A07p27230.2_BraZ1	1024.65	+	1583	2286	2343	0.9756722
A07	18679737	18680985	A07p27240.2_BraZ1	1228	+	324	1106	1248	0.8862180
A07	18683195	18685024	A07p27250.2_BraZ1	1381.85	+	620	1746	1829	0.9546200
A07	18691372	18697887	A07p27260.2_BraZ1	2981.88	+	1167	5003	6515	0.7679202
A07	18700365	18701857	A07p27270.2_BraZ1	949.987	-	587	1492	1492	1.0000000
A07	18704077	18705226	A07p27280.2_BraZ1	114.9	+	141	1055	1149	0.9181897
A07	18709627	18711961	A07p27290.2_BraZ1	1306.17	+	110	1108	2334	0.4747215
A07	18712191	18712714	A07p27300.2_BraZ1	24	+	352	523	523	1.0000000
A07	18712339	18712548	A07p27310.2_BraZ1	153	-	210	209	209	1.0000000
A07	18712705	18715647	A07p27320.2_BraZ1	1011.52	-	1289	2942	2942	1.0000000
A07	18715980	18716169	A07p27330.2_BraZ1	18.9	+	273	189	189	1.0000000
A07	18726385	18727044	A07p27340.2_BraZ1	52.2	-	138	659	659	1.0000000
A07	18730309	18736481	A07p27350.2_BraZ1	2008.04	+	3140	5932	6172	0.9611147
A07	18736938	18737337	A07p27360.2_BraZ1	111	+	347	399	399	1.0000000
A07	18737501	18739799	A07p27370.2_BraZ1	229.8	-	720	2247	2298	0.9778068
A07	18740580	18742692	A07p27380.2_BraZ1	1009.96	-	915	2028	2112	0.9602273
A07	18745817	18748066	A07p27390.2_BraZ1	1469.81	+	901	2249	2249	1.0000000
A07	18748687	18750125	A07p27400.2_BraZ1	669.375	+	1122	1344	1438	0.9346314
A07	18750516	18754359	A07p27410.2_BraZ1	1890.56	-	1321	3733	3843	0.9713765
A07	18756034	18757384	A07p27420.2_BraZ1	135	+	418	1350	1350	1.0000000
A07	18760334	18760550	A07p27430.2_BraZ1	21.6	-	0	0	216	0.0000000
A07	18762145	18763378	A07p27440.2_BraZ1	122.7	+	1090	1233	1233	1.0000000
A07	18765337	18767507	A07p27450.2_BraZ1	1482.18	+	782	2069	2170	0.9534562
A07	18770525	18772076	A07p27460.2_BraZ1	811.789	+	238	1525	1551	0.9832366
A07	18772476	18774185	A07p27470.2_BraZ1	654.733	-	3533	1709	1709	1.0000000
A07	18777937	18778792	A07p27480.2_BraZ1	85.5	+	2055	855	855	1.0000000
A07	18785172	18785945	A07p27490.2_BraZ1	564	-	964	773	773	1.0000000
A07	18796438	18801429	A07p27500.2_BraZ1	3715.61	+	447	2616	4991	0.5241435
A07	18806727	18808481	A07p27510.2_BraZ1	411.4	+	2677	1754	1754	1.0000000
A07	18809120	18815508	A07p27520.2_BraZ1	1595.09	-	22720	6388	6388	1.0000000
A07	18816130	18821568	A07p27530.2_BraZ1	2786.15	-	5608	5064	5438	0.9312247
A07	18825749	18827741	A07p27540.2_BraZ1	1150.09	-	1051	1970	1992	0.9889558
A07	18829387	18832807	A07p27550.2_BraZ1	1802.35	-	370	2476	3420	0.7239766
A07	18834288	18835647	A07p27560.2_BraZ1	843	+	1324	1359	1359	1.0000000
A07	18835995	18839529	A07p27570.2_BraZ1	3303	-	986	3207	3534	0.9074703
A07	18840320	18842005	A07p27580.2_BraZ1	972	-	195	1453	1685	0.8623145
A07	18843231	18845339	A07p27590.2_BraZ1	2004	-	520	2026	2108	0.9611006
A07	18845673	18847136	A07p27600.2_BraZ1	1158.07	+	188	1389	1463	0.9494190
A07	18849251	18850709	A07p27610.2_BraZ1	145.8	-	42	679	1458	0.4657064
A07	18852807	18853410	A07p27620.2_BraZ1	60.3	+	163	579	603	0.9601990
A07	18856015	18857396	A07p27630.2_BraZ1	1011	-	408	1221	1381	0.8841419
A07	18864566	18865718	A07p27640.2_BraZ1	115.2	-	631	1152	1152	1.0000000
A07	18870268	18873330	A07p27650.2_BraZ1	3056.25	-	177	1278	3062	0.4173743
A07	18875897	18878718	A07p27660.2_BraZ1	1649.26	-	888	2489	2821	0.8823112
A07	18888731	18889592	A07p27670.2_BraZ1	86.1	+	106	568	861	0.6596980
A07	18894012	18895439	A07p27680.2_BraZ1	871.5	-	445	1321	1427	0.9257183
A07	18905337	18906342	A07p27690.2_BraZ1	1357.2	+	369	943	1005	0.9383085
A07	18907373	18917554	A07p27700.2_BraZ1	1875.47	-	4300	9045	10181	0.8884196
A07	18920871	18922236	A07p27710.2_BraZ1	136.5	+	259	1292	1365	0.9465201
A07	18922902	18924152	A07p27720.2_BraZ1	419.322	+	1516	1250	1250	1.0000000
A07	18924280	18929505	A07p27730.2_BraZ1	3446.89	-	2276	4466	5225	0.8547369
A07	18932007	18933987	A07p27740.2_BraZ1	1773	-	27	297	1980	0.1500000
A07	18935269	18935917	A07p27750.2_BraZ1	64.8	-	85	640	648	0.9876543
A07	18936765	18939680	A07p27760.2_BraZ1	2150	-	301	1355	2915	0.4648370
A07	18940862	18941336	A07p27770.2_BraZ1	47.4	+	107	377	474	0.7953587
A07	18942705	18944172	A07p27780.2_BraZ1	1112.57	-	966	1456	1467	0.9925017
A07	18944942	18946716	A07p27790.2_BraZ1	834.75	+	1636	1774	1774	1.0000000
A07	18948670	18950540	A07p27800.2_BraZ1	985	+	1399	1870	1870	1.0000000
A07	18951271	18953769	A07p27810.2_BraZ1	1071.9	+	2332	2498	2498	1.0000000
A07	18955906	18956774	A07p27820.2_BraZ1	350.75	+	708	809	868	0.9320276
A07	18957201	18957588	A07p27830.2_BraZ1	38.7	+	228	387	387	1.0000000
A07	18957954	18958359	A07p27840.2_BraZ1	40.5	-	184	405	405	1.0000000
A07	18961893	18967089	A07p27850.2_BraZ1	1125.29	-	2641	4247	5196	0.8173595
A07	18974348	18976599	A07p27860.2_BraZ1	874.703	-	2216	2251	2251	1.0000000
A07	18979733	18980825	A07p27870.2_BraZ1	109.2	-	520	1092	1092	1.0000000
A07	18983346	18983784	A07p27880.2_BraZ1	43.8	+	4	36	438	0.0821918
A07	18986971	18988036	A07p27890.2_BraZ1	106.5	+	400	1065	1065	1.0000000
A07	18988828	18990238	A07p27900.2_BraZ1	141	+	156	1064	1410	0.7546099
A07	18991496	18992666	A07p27910.2_BraZ1	1323.75	+	868	1170	1170	1.0000000
A07	18994578	18995362	A07p27920.2_BraZ1	71.1	-	239	730	784	0.9311224
A07	18999129	19001926	A07p27930.2_BraZ1	1884.8	-	586	2556	2797	0.9138362
A07	19003394	19005304	A07p27940.2_BraZ1	1304.73	-	1110	1896	1910	0.9926702
A07	19005804	19006586	A07p27950.2_BraZ1	258	-	617	782	782	1.0000000
A07	19014107	19015881	A07p27960.2_BraZ1	12138	+	1293	1774	1774	1.0000000
A07	19016979	19022132	A07p27970.2_BraZ1	3779.9	-	899	4507	5153	0.8746361
A07	19024692	19026329	A07p27980.2_BraZ1	587.25	+	371	1555	1637	0.9499084
A07	19031644	19031953	A07p27990.2_BraZ1	30.9	-	12	175	309	0.5663431
A07	19037915	19038406	A07p28000.2_BraZ1	284.812	-	535	491	491	1.0000000
A07	19046373	19046682	A07p28010.2_BraZ1	30.9	+	0	0	309	0.0000000
A07	19053291	19056363	A07p28020.2_BraZ1	977.5	-	2056	3072	3072	1.0000000
A07	19061748	19062099	A07p28030.2_BraZ1	35.1	-	248	351	351	1.0000000
A07	19064364	19065605	A07p28040.2_BraZ1	1077	+	134	978	1241	0.7880741
A07	19070216	19076638	A07p28050.2_BraZ1	3590.08	+	1980	5724	6422	0.8913111
A07	19077356	19078521	A07p28060.2_BraZ1	484.826	+	915	1165	1165	1.0000000
A07	19078862	19080161	A07p28070.2_BraZ1	129.9	+	2	153	1299	0.1177829
A07	19080210	19081987	A07p28080.2_BraZ1	28.0435	+	1217	1420	1777	0.7990996
A07	19081843	19082637	A07p28090.2_BraZ1	135	+	477	794	794	1.0000000
A07	19083266	19083986	A07p28100.2_BraZ1	72	+	313	720	720	1.0000000
A07	19084851	19086034	A07p28110.2_BraZ1	101.4	-	314	852	1183	0.7202029
A07	19086696	19092758	A07p28120.2_BraZ1	3172.44	-	4818	6062	6062	1.0000000
A07	19094113	19097882	A07p28130.2_BraZ1	2111.67	-	987	3503	3769	0.9294242
A07	19104754	19105465	A07p28140.2_BraZ1	71.1	-	0	0	711	0.0000000
A07	19111987	19117074	A07p28150.2_BraZ1	4200.95	-	725	3618	5087	0.7112247
A07	19118602	19119896	A07p28160.2_BraZ1	948	+	608	1294	1294	1.0000000
A07	19121181	19121712	A07p28170.2_BraZ1	53.1	+	22	179	531	0.3370998
A07	19121892	19123490	A07p28180.2_BraZ1	357.545	+	579	1426	1598	0.8923655
A07	19123630	19124758	A07p28190.2_BraZ1	682.125	-	427	1128	1128	1.0000000
A07	19125089	19125764	A07p28200.2_BraZ1	3283.5	+	157	663	675	0.9822222
A07	19126431	19128593	A07p28210.2_BraZ1	930.429	+	1538	2129	2162	0.9847364
A07	19128918	19138596	A07p28220.2_BraZ1	3896.63	-	4251	8606	9678	0.8892333
A07	19144520	19148845	A07p28230.2_BraZ1	2050.46	+	2624	4202	4325	0.9715607
A07	19149412	19151908	A07p28240.2_BraZ1	906.286	-	644	2040	2496	0.8173077
A07	19152631	19154006	A07p28250.2_BraZ1	942	+	318	1215	1375	0.8836364
A07	19154362	19156470	A07p28260.2_BraZ1	1153.38	-	1303	2108	2108	1.0000000
A07	19157111	19160411	A07p28270.2_BraZ1	1941.52	+	2287	3300	3300	1.0000000
A07	19161613	19167008	A07p28280.2_BraZ1	2724.8	+	3166	5237	5395	0.9707136
A07	19168582	19169501	A07p28290.2_BraZ1	906.75	+	325	919	919	1.0000000
A07	19170313	19177518	A07p28300.2_BraZ1	2965.68	+	2558	6804	7205	0.9443442
A07	19178302	19182121	A07p28310.2_BraZ1	1404.58	+	2478	3719	3819	0.9738151
A07	19182711	19184909	A07p28320.2_BraZ1	2097	+	1018	2179	2198	0.9913558
A07	19186512	19190470	A07p28330.2_BraZ1	2405.09	-	427	3151	3958	0.7961091
A07	19193684	19197643	A07p28340.2_BraZ1	2346.64	-	177	1855	3959	0.4685527
A07	19200859	19202123	A07p28350.2_BraZ1	735	-	933	1264	1264	1.0000000
A07	19202796	19204263	A07p28360.2_BraZ1	547.823	-	628	1450	1467	0.9884117
A07	19207121	19207283	A07p28370.2_BraZ1	16.2	+	222	162	162	1.0000000
A07	19207641	19209132	A07p28380.2_BraZ1	149.1	-	626	1402	1491	0.9403085
A07	19218137	19219054	A07p28390.2_BraZ1	465	+	780	917	917	1.0000000
A07	19221066	19222242	A07p28400.2_BraZ1	117.6	+	557	1176	1176	1.0000000
A07	19222946	19223162	A07p28410.2_BraZ1	21.6	-	277	216	216	1.0000000
A07	19224384	19226454	A07p28420.2_BraZ1	1134	-	1278	2013	2070	0.9724638
A07	19229242	19230790	A07p28430.2_BraZ1	221.85	+	445	1483	1548	0.9580103
A07	19230781	19231361	A07p28440.2_BraZ1	877.2	+	270	580	580	1.0000000
A07	19231603	19233529	A07p28450.2_BraZ1	864	-	757	1916	1926	0.9948079
A07	19236282	19237071	A07p28460.2_BraZ1	78.9	+	270	789	789	1.0000000
A07	19238336	19239701	A07p28470.2_BraZ1	1113	-	380	1336	1365	0.9787546
A07	19240667	19244783	A07p28480.2_BraZ1	1352.08	+	1911	3702	4116	0.8994169
A07	19247171	19249561	A07p28490.2_BraZ1	1696.75	+	1326	2358	2390	0.9866109
A07	19249974	19252281	A07p28500.2_BraZ1	1515.39	-	1571	2307	2307	1.0000000
A07	19254794	19256634	A07p28510.2_BraZ1	1065.09	-	692	1815	1840	0.9864131
A07	19261899	19267311	A07p28520.2_BraZ1	1995.55	+	2844	5342	5412	0.9870658
A07	19268003	19274355	A07p28530.2_BraZ1	2634.24	-	2753	6002	6352	0.9448993
A07	19276530	19277052	A07p28540.2_BraZ1	52.2	-	389	522	522	1.0000000
A07	19279954	19282062	A07p28550.2_BraZ1	1445.94	-	706	2108	2108	1.0000000
A07	19282527	19284303	A07p28560.2_BraZ1	177.6	-	1977	1776	1776	1.0000000
A07	19285047	19290408	A07p28570.2_BraZ1	2878.09	-	1216	4653	5361	0.8679351
A07	19291697	19291997	A07p28580.2_BraZ1	114	+	2	19	300	0.0633333
A07	19306522	19307920	A07p28590.2_BraZ1	139.8	+	552	1398	1398	1.0000000
A07	19309824	19310394	A07p28600.2_BraZ1	57	+	420	570	570	1.0000000
A07	19311082	19313072	A07p28610.2_BraZ1	1674	-	578	1934	1990	0.9718593
A07	19315733	19318947	A07p28620.2_BraZ1	1606.5	-	1217	3204	3214	0.9968886
A07	19325943	19326282	A07p28630.2_BraZ1	33.9	-	94	334	339	0.9852507
A07	19327436	19332320	A07p28640.2_BraZ1	1178.8	-	2458	4683	4884	0.9588452
A07	19333685	19338104	A07p28650.2_BraZ1	2402.28	-	2045	3955	4419	0.8949988
A07	19338888	19341333	A07p28660.2_BraZ1	979.486	-	1557	2389	2445	0.9770961
A07	19341891	19346026	A07p28670.2_BraZ1	2844.55	+	1069	3856	4135	0.9325272
A07	19346804	19348434	A07p28680.2_BraZ1	702	+	658	1380	1630	0.8466257
A07	19348825	19350130	A07p28690.2_BraZ1	687	-	567	1282	1305	0.9823755
A07	19351268	19352294	A07p28700.2_BraZ1	613.44	+	1074	1026	1026	1.0000000
A07	19357618	19358299	A07p28710.2_BraZ1	68.1	-	40	537	681	0.7885463
A07	19361207	19362435	A07p28720.2_BraZ1	768.5	+	1001	1215	1228	0.9894137
A07	19362769	19370202	A07p28730.2_BraZ1	2190.75	+	2796	6849	7433	0.9214315
A07	19371778	19374656	A07p28740.2_BraZ1	1648.38	+	1337	2862	2878	0.9944406
A07	19374844	19375573	A07p28750.2_BraZ1	382.5	+	1162	729	729	1.0000000
A07	19376333	19380024	A07p28760.2_BraZ1	967.909	-	2055	3618	3691	0.9802222
A07	19386924	19388416	A07p28770.2_BraZ1	855.13	+	810	1492	1492	1.0000000
A07	19388556	19390057	A07p28780.2_BraZ1	821.333	-	1495	1501	1501	1.0000000
A07	19392242	19393141	A07p28790.2_BraZ1	26.4	+	838	852	899	0.9477197
A07	19394023	19396103	A07p28800.2_BraZ1	1116.07	+	1954	2080	2080	1.0000000
A07	19396412	19397081	A07p28810.2_BraZ1	483.179	-	333	669	669	1.0000000
A07	19398253	19400972	A07p28820.2_BraZ1	1300.71	-	1078	2616	2719	0.9621184
A07	19402705	19403755	A07p28830.2_BraZ1	770	+	475	1050	1050	1.0000000
A07	19405142	19407454	A07p28840.2_BraZ1	1147.25	-	956	2281	2312	0.9865917
A07	19409948	19411808	A07p28850.2_BraZ1	1464	+	144	1498	1860	0.8053764
A07	19412858	19417269	A07p28860.2_BraZ1	2201.96	-	1296	3927	4411	0.8902743
A07	19418820	19427109	A07p28870.2_BraZ1	238.2	+	2311	4217	8289	0.5087465
A07	19427351	19427622	A07p28880.2_BraZ1	25.2	-	346	271	271	1.0000000
A07	19428027	19430858	A07p28890.2_BraZ1	1215.29	+	1401	2831	2831	1.0000000
A07	19431880	19435712	A07p28900.2_BraZ1	1917.66	+	2330	3823	3832	0.9976513
A07	19439598	19446480	A07p28910.2_BraZ1	2902.37	+	1987	6277	6882	0.9120895
A07	19451134	19453380	A07p28920.2_BraZ1	987.387	+	627	2114	2246	0.9412289
A07	19455456	19460188	A07p28930.2_BraZ1	2893.29	+	1598	4264	4732	0.9010989
A07	19460538	19465334	A07p28940.2_BraZ1	3039.11	-	1348	4668	4796	0.9733111
A07	19465930	19467910	A07p28950.2_BraZ1	120.6	+	887	1920	1980	0.9696970
A07	19469028	19472068	A07p28960.2_BraZ1	962.712	+	776	2569	3040	0.8450658
A07	19474084	19476854	A07p28970.2_BraZ1	1181.32	+	1919	2770	2770	1.0000000
A07	19478087	19478231	A07p28980.2_BraZ1	14.4	+	178	144	144	1.0000000
A07	19480508	19481410	A07p28990.2_BraZ1	822	+	328	792	902	0.8780488
A07	19481990	19484545	A07p29000.2_BraZ1	818.226	-	1469	2555	2555	1.0000000
A07	19485487	19487965	A07p29010.2_BraZ1	247.8	-	799	2369	2478	0.9560129
A07	19488732	19490848	A07p29020.2_BraZ1	932.885	-	478	1802	2116	0.8516068
A07	19491618	19492509	A07p29030.2_BraZ1	164	+	1220	891	891	1.0000000
A07	19500738	19502289	A07p29040.2_BraZ1	92.7	+	1029	1432	1551	0.9232753
A07	19503663	19504486	A07p29050.2_BraZ1	7048.5	+	477	823	823	1.0000000
A07	19504805	19506844	A07p29060.2_BraZ1	1085.83	-	1173	2039	2039	1.0000000
A07	19507456	19508710	A07p29070.2_BraZ1	10573.5	-	266	953	1254	0.7599681
A07	19510224	19522857	A07p29080.2_BraZ1	5790.7	+	594	6822	12633	0.5400143
A07	19523215	19525595	A07p29090.2_BraZ1	1334.85	-	699	2292	2380	0.9630252
A07	19528157	19528394	A07p29100.2_BraZ1	23.7	+	100	237	237	1.0000000
A07	19529393	19531876	A07p29110.2_BraZ1	1185.06	-	939	2359	2483	0.9500604
A07	19532570	19534343	A07p29120.2_BraZ1	690.3	+	1009	1756	1773	0.9904118
A07	19535052	19536029	A07p29130.2_BraZ1	784.857	-	145	413	977	0.4227226
A07	19539394	19540421	A07p29140.2_BraZ1	477	+	410	952	1027	0.9269717
A07	19541135	19541567	A07p29150.2_BraZ1	42.9	+	39	391	432	0.9050926
A07	19541796	19543217	A07p29160.2_BraZ1	426	+	1106	1274	1421	0.8965517
A07	19542072	19542595	A07p29170.2_BraZ1	330	+	151	376	523	0.7189292
A07	19545404	19545833	A07p29180.2_BraZ1	42.9	+	49	351	429	0.8181818
A07	19549377	19552287	A07p29190.2_BraZ1	1686.43	+	1078	2243	2910	0.7707904
A07	19553908	19556616	A07p29200.2_BraZ1	1223.4	+	1205	2515	2708	0.9287297
A07	19556845	19557469	A07p29210.2_BraZ1	426	-	329	624	624	1.0000000
A07	19559777	19562128	A07p29220.2_BraZ1	1371.73	+	1133	2293	2351	0.9753296
A07	19563084	19565680	A07p29230.2_BraZ1	1343.42	+	731	2572	2596	0.9907550
A07	19566081	19567863	A07p29240.2_BraZ1	661.648	+	1598	1782	1782	1.0000000
A07	19568448	19569100	A07p29250.2_BraZ1	462	+	179	652	652	1.0000000
A07	19573935	19575478	A07p29260.2_BraZ1	15732	+	510	1427	1543	0.9248218
A07	19585995	19594132	A07p29270.2_BraZ1	2039.35	-	4399	4743	8137	0.5828930
A07	19602791	19603782	A07p29280.2_BraZ1	626.714	+	550	958	991	0.9667003
A07	19604618	19607491	A07p29290.2_BraZ1	933.562	+	2234	2705	2873	0.9415246
A07	19608149	19612034	A07p29300.2_BraZ1	1747.61	-	1870	3623	3885	0.9325612
A07	19612542	19613621	A07p29310.2_BraZ1	470.609	+	777	993	1079	0.9202965
A07	19618271	19619620	A07p29320.2_BraZ1	367.015	-	850	1032	1349	0.7650111
A07	19628273	19629725	A07p29330.2_BraZ1	1332	+	618	1326	1452	0.9132231
A07	19630947	19632337	A07p29340.2_BraZ1	588	+	263	1290	1390	0.9280576
A07	19633730	19634346	A07p29350.2_BraZ1	303	-	2	116	616	0.1883117
A07	19636126	19636703	A07p29360.2_BraZ1	483	+	186	538	577	0.9324090
A07	19639222	19641039	A07p29370.2_BraZ1	1333.61	+	234	1395	1817	0.7677490
A07	19641333	19643034	A07p29380.2_BraZ1	1032.28	-	364	1339	1701	0.7871840
A07	19644987	19646070	A07p29390.2_BraZ1	888.675	-	485	1083	1083	1.0000000
A07	19648202	19649159	A07p29400.2_BraZ1	95.7	-	155	555	957	0.5799373
A07	19649752	19649863	A07p29410.2_BraZ1	11.1	-	0	0	111	0.0000000
A07	19651449	19652593	A07p29420.2_BraZ1	750	-	1026	1144	1144	1.0000000
A07	19654558	19654805	A07p29430.2_BraZ1	189	+	8	226	247	0.9149798
A07	19659121	19659439	A07p29440.2_BraZ1	31.8	-	63	243	318	0.7641509
A07	19665369	19666544	A07p29450.2_BraZ1	67.8	+	1264	1175	1175	1.0000000
A07	19667836	19668040	A07p29460.2_BraZ1	20.4	-	54	204	204	1.0000000
A07	19675370	19676333	A07p29470.2_BraZ1	654	+	366	908	963	0.9428868
A07	19677959	19678863	A07p29480.2_BraZ1	4927.5	+	278	844	904	0.9336283
A07	19679723	19681065	A07p29490.2_BraZ1	5304	+	1134	1342	1342	1.0000000
A07	19681769	19682509	A07p29500.2_BraZ1	729	-	573	740	740	1.0000000
A07	19683242	19684649	A07p29510.2_BraZ1	753.341	-	840	1302	1407	0.9253731
A07	19686712	19689124	A07p29520.2_BraZ1	1016.26	+	1140	2136	2412	0.8855721
A07	19690793	19694006	A07p29530.2_BraZ1	695	-	2832	3005	3213	0.9352630
A07	19712572	19715828	A07p29540.2_BraZ1	2018.5	+	1928	3244	3256	0.9963145
A07	19716262	19718282	A07p29550.2_BraZ1	1163.38	-	928	1898	2020	0.9396040
A07	19719309	19724285	A07p29560.2_BraZ1	2241.53	+	2812	4456	4976	0.8954984
A07	19725110	19725852	A07p29570.2_BraZ1	666	-	158	675	742	0.9097035
A07	19730273	19730936	A07p29580.2_BraZ1	300	+	139	486	663	0.7330317
A07	19736751	19739267	A07p29590.2_BraZ1	1477.44	+	1327	2500	2516	0.9936407
A07	19740300	19741356	A07p29600.2_BraZ1	105.6	-	477	1056	1056	1.0000000
A07	19747022	19747414	A07p29610.2_BraZ1	300	+	0	0	392	0.0000000
A07	19751489	19752480	A07p29620.2_BraZ1	96.3	-	405	991	991	1.0000000
A07	19758899	19759236	A07p29630.2_BraZ1	159	+	0	0	337	0.0000000
A07	19769231	19769846	A07p29640.2_BraZ1	459	-	166	588	615	0.9560975
A07	19770705	19772094	A07p29650.2_BraZ1	2950.71	+	16	574	1389	0.4132469
A07	19772056	19772802	A07p29660.2_BraZ1	1593.75	+	65	636	746	0.8525469
A07	19778378	19779411	A07p29670.2_BraZ1	317.812	+	1089	1033	1033	1.0000000
A07	19779736	19783207	A07p29680.2_BraZ1	1382.64	-	1182	3210	3471	0.9248055
A07	19791504	19791769	A07p29690.2_BraZ1	24.6	-	16	265	265	1.0000000
A07	19799722	19801440	A07p29700.2_BraZ1	1641	-	244	1703	1718	0.9912689
A07	19802412	19803666	A07p29710.2_BraZ1	125.4	-	287	1123	1254	0.8955343
A07	19805382	19805520	A07p29720.2_BraZ1	13.8	-	9	136	138	0.9855072
A07	19806286	19806700	A07p29730.2_BraZ1	41.4	-	60	338	414	0.8164251
A07	19812126	19812807	A07p29740.2_BraZ1	68.1	+	476	681	681	1.0000000
A07	19814024	19814390	A07p29750.2_BraZ1	36.6	+	335	366	366	1.0000000
A07	19816243	19817017	A07p29760.2_BraZ1	77.4	+	576	774	774	1.0000000
A07	19826821	19830358	A07p29770.2_BraZ1	2673.59	+	1336	3356	3537	0.9488267
A07	19832177	19832359	A07p29780.2_BraZ1	15	+	269	182	182	1.0000000
A07	19836952	19839662	A07p29790.2_BraZ1	2002.3	-	681	2422	2710	0.8937269
A07	19840268	19841071	A07p29800.2_BraZ1	251.16	-	648	803	803	1.0000000
A07	19843393	19844610	A07p29810.2_BraZ1	831.25	-	527	1217	1217	1.0000000
A07	19846896	19849842	A07p29820.2_BraZ1	1416	+	783	2390	2946	0.8112695
A07	19855385	19857328	A07p29830.2_BraZ1	1392	+	717	1678	1943	0.8636129
A07	19862895	19863317	A07p29840.2_BraZ1	216	+	184	422	422	1.0000000
A07	19866008	19866326	A07p29850.2_BraZ1	225	-	4	79	318	0.2484277
A07	19867809	19868130	A07p29860.2_BraZ1	228	-	26	310	321	0.9657321
A07	19874399	19874507	A07p29870.2_BraZ1	10.8	+	7	108	108	1.0000000
A07	19874535	19877211	A07p29880.2_BraZ1	679.129	+	526	2286	2676	0.8542601
A07	19880576	19889103	A07p29890.2_BraZ1	310.227	-	861	5260	8527	0.6168641
A07	19881106	19892066	A07p29900.2_BraZ1	138.615	-	1227	7110	10960	0.6487226
A07	19892060	19893489	A07p29910.2_BraZ1	23.7	-	93	1245	1429	0.8712386
A07	19893156	19896187	A07p29920.2_BraZ1	18	-	62	1293	3031	0.4265919
A07	19893854	19894595	A07p29930.2_BraZ1	645	-	13	383	741	0.5168691
A07	19894766	19896220	A07p29940.2_BraZ1	888	-	22	325	1454	0.2235213
A07	19900794	19901115	A07p29950.2_BraZ1	228	+	2	15	321	0.0467290
A07	19901552	19903012	A07p29960.2_BraZ1	838.5	-	2445	1460	1460	1.0000000
A07	19906607	19909445	A07p29970.2_BraZ1	1981.96	+	905	2496	2838	0.8794926
A07	19909563	19910019	A07p29980.2_BraZ1	225	+	399	456	456	1.0000000
A07	19911631	19912078	A07p29990.2_BraZ1	381	+	146	430	447	0.9619687
A07	19912852	19914284	A07p30000.2_BraZ1	857.737	-	440	1153	1432	0.8051676
A07	19919558	19921071	A07p30010.2_BraZ1	1146	-	1147	1513	1513	1.0000000
A07	19924079	19926284	A07p30020.2_BraZ1	284.812	-	3307	2205	2205	1.0000000
A07	19929451	19931450	A07p30030.2_BraZ1	965.005	+	790	1999	1999	1.0000000
A07	19932058	19939006	A07p30040.2_BraZ1	5527.83	-	839	4969	6948	0.7151698
A07	19944192	19945014	A07p30050.2_BraZ1	345.429	-	365	782	822	0.9513382
A07	19947750	19948182	A07p30060.2_BraZ1	43.2	+	214	416	432	0.9629630
A07	19955862	19957349	A07p30070.2_BraZ1	760.143	+	456	1487	1487	1.0000000
A07	19957967	19961653	A07p30080.2_BraZ1	1715	-	1119	3368	3686	0.9137276
A07	19962342	19962626	A07p30090.2_BraZ1	147	-	139	284	284	1.0000000
A07	19963194	19965267	A07p30100.2_BraZ1	1367.4	+	1590	1925	2073	0.9286059
A07	19967096	19968913	A07p30110.2_BraZ1	1067.62	-	360	1649	1817	0.9075399
A07	19969530	19973403	A07p30120.2_BraZ1	2448	+	755	3023	3873	0.7805319
A07	19973401	19973569	A07p30130.2_BraZ1	16.8	+	15	110	168	0.6547619
A07	19974371	19976320	A07p30140.2_BraZ1	947.368	-	759	1724	1949	0.8845562
A07	19978969	19981533	A07p30150.2_BraZ1	1301.68	-	483	1620	2564	0.6318253
A07	19982092	19982302	A07p30160.2_BraZ1	12.3	+	248	210	210	1.0000000
A07	19985455	19987468	A07p30170.2_BraZ1	201.3	-	576	1764	2013	0.8763040
A07	19990166	19994024	A07p30180.2_BraZ1	1026.87	+	1994	3699	3858	0.9587870
A07	19995099	19996406	A07p30190.2_BraZ1	726	+	700	1307	1307	1.0000000
A07	20000147	20000844	A07p30200.2_BraZ1	438	+	266	582	697	0.8350072
A07	20005444	20006002	A07p30210.2_BraZ1	55.8	-	172	556	558	0.9964158
A07	20007193	20007591	A07p30220.2_BraZ1	249	-	80	281	398	0.7060301
A07	20011170	20011479	A07p30230.2_BraZ1	30.9	+	7	90	309	0.2912621
A07	20013284	20013689	A07p30240.2_BraZ1	309	+	225	405	405	1.0000000
A07	20014586	20019284	A07p30250.2_BraZ1	3048.33	-	2236	4187	4698	0.8912303
A07	20028524	20030108	A07p30260.2_BraZ1	1347	+	4146	1572	1584	0.9924242
A07	20032425	20033532	A07p30270.2_BraZ1	110.7	-	118	989	1107	0.8934056
A07	20035587	20035782	A07p30280.2_BraZ1	19.5	-	279	195	195	1.0000000
A07	20037356	20040293	A07p30290.2_BraZ1	3684	+	1414	2925	2937	0.9959142
A07	20045724	20048038	A07p30300.2_BraZ1	1836	-	192	1854	2314	0.8012100
A07	20054457	20054824	A07p30310.2_BraZ1	26.4	-	1	120	367	0.3269755
A07	20054626	20056200	A07p30320.2_BraZ1	526.35	-	4	267	1574	0.1696315
A07	20060211	20061228	A07p30330.2_BraZ1	101.7	-	91	656	1017	0.6450344
A07	20062865	20063821	A07p30340.2_BraZ1	288.655	+	359	887	956	0.9278243
A07	20064139	20070222	A07p30350.2_BraZ1	2874.42	-	1801	5204	6083	0.8554989
A07	20077071	20081148	A07p30360.2_BraZ1	7791	+	617	2205	4077	0.5408388
A07	20081854	20082304	A07p30370.2_BraZ1	45	-	350	450	450	1.0000000
A07	20084577	20087352	A07p30380.2_BraZ1	3385	-	2585	2775	2775	1.0000000
A07	20088549	20090230	A07p30390.2_BraZ1	824.798	+	655	1647	1681	0.9797739
A07	20092006	20093672	A07p30400.2_BraZ1	10342.5	+	570	1629	1666	0.9777911
A07	20095267	20095807	A07p30410.2_BraZ1	54	+	104	494	540	0.9148148
A07	20101128	20101803	A07p30420.2_BraZ1	67.5	-	592	675	675	1.0000000
A07	20108822	20109455	A07p30430.2_BraZ1	63.3	-	1042	633	633	1.0000000
A07	20114289	20115202	A07p30440.2_BraZ1	1715.17	-	825	913	913	1.0000000
A07	20118986	20120784	A07p30450.2_BraZ1	1036.22	-	525	1671	1798	0.9293659
A07	20128411	20129275	A07p30460.2_BraZ1	86.4	-	209	838	864	0.9699074
A07	20133543	20134106	A07p30470.2_BraZ1	429	+	201	563	563	1.0000000
A07	20135550	20144080	A07p30480.2_BraZ1	15247.5	+	628	4851	8530	0.5686987
A07	20154135	20154693	A07p30490.2_BraZ1	55.8	-	54	244	558	0.4372760
A07	20161447	20162974	A07p30500.2_BraZ1	860	+	642	1373	1527	0.8991486
A07	20163931	20165216	A07p30510.2_BraZ1	473.1	-	670	1227	1285	0.9548638
A07	20168814	20170511	A07p30520.2_BraZ1	1123.08	+	132	1103	1697	0.6499705
A07	20174215	20177691	A07p30530.2_BraZ1	1052.91	+	2867	3466	3476	0.9971231
A07	20178362	20180212	A07p30540.2_BraZ1	473.455	-	1816	1850	1850	1.0000000
A07	20181851	20182846	A07p30550.2_BraZ1	873	+	743	995	995	1.0000000
A07	20186758	20187400	A07p30560.2_BraZ1	64.2	-	187	621	642	0.9672897
A07	20188960	20190928	A07p30570.2_BraZ1	680.127	+	2291	1968	1968	1.0000000
A07	20192289	20194784	A07p30580.2_BraZ1	1067.14	+	1502	2495	2495	1.0000000
A07	20195096	20200671	A07p30590.2_BraZ1	1026.6	-	5753	5499	5575	0.9863677
A07	20201477	20202349	A07p30600.2_BraZ1	243	-	880	872	872	1.0000000
A07	20203991	20204534	A07p30610.2_BraZ1	318	-	167	543	543	1.0000000
A07	20206664	20207379	A07p30620.2_BraZ1	585	+	404	694	715	0.9706294
A07	20220749	20223289	A07p30630.2_BraZ1	1050	+	1947	2540	2540	1.0000000
A07	20224357	20225426	A07p30640.2_BraZ1	540.166	+	788	1069	1069	1.0000000
A07	20227090	20228000	A07p30650.2_BraZ1	483	-	535	910	910	1.0000000
A07	20230013	20232075	A07p30660.2_BraZ1	1192.71	-	153	1587	2062	0.7696411
A07	20239589	20241515	A07p30670.2_BraZ1	1035	-	480	1838	1926	0.9543095
A07	20248161	20251232	A07p30680.2_BraZ1	1783.64	-	2509	3060	3071	0.9964181
A07	20253854	20254993	A07p30690.2_BraZ1	557.586	-	824	1139	1139	1.0000000
A07	20257301	20257649	A07p30700.2_BraZ1	243	-	80	348	348	1.0000000
A07	20260404	20261526	A07p30710.2_BraZ1	112.2	+	715	1116	1122	0.9946524
A07	20262229	20263464	A07p30720.2_BraZ1	786.24	+	559	1235	1235	1.0000000
A07	20272726	20273190	A07p30730.2_BraZ1	297	+	144	400	464	0.8620690
A07	20274196	20276209	A07p30740.2_BraZ1	201.3	+	1319	2013	2013	1.0000000
A07	20278665	20279343	A07p30750.2_BraZ1	31578.5	-	781	678	678	1.0000000
A07	20283455	20283782	A07p30760.2_BraZ1	32.7	-	0	0	327	0.0000000
A07	20290528	20291002	A07p30770.2_BraZ1	384	+	30	332	474	0.7004219
A07	20294545	20295827	A07p30780.2_BraZ1	817.778	-	198	897	1282	0.6996880
A07	20320110	20320623	A07p30790.2_BraZ1	363	-	18	306	513	0.5964912
A07	20322226	20323577	A07p30800.2_BraZ1	996	+	177	795	1351	0.5884530
A07	20327504	20327891	A07p30810.2_BraZ1	108	-	948	387	387	1.0000000
A07	20328328	20328778	A07p30820.2_BraZ1	219	-	269	450	450	1.0000000
A07	20329131	20330209	A07p30830.2_BraZ1	66.6	-	4	165	1078	0.1530612
A07	20332266	20333259	A07p30840.2_BraZ1	99.3	-	134	112	993	0.1127895
A07	20337996	20339517	A07p30850.2_BraZ1	807	+	836	1521	1521	1.0000000
A07	20346764	20346908	A07p30860.2_BraZ1	14.4	+	115	144	144	1.0000000
A07	20350514	20352783	A07p30870.2_BraZ1	1016.88	+	709	1896	2269	0.8356104
A07	20353813	20354428	A07p30880.2_BraZ1	61.5	-	137	550	615	0.8943089
A07	20363586	20365216	A07p30890.2_BraZ1	1357.36	+	867	1630	1630	1.0000000
A07	20365742	20366372	A07p30900.2_BraZ1	63	-	797	630	630	1.0000000
A07	20372057	20372597	A07p30910.2_BraZ1	54	-	38	374	540	0.6925926
A07	20384499	20385978	A07p30920.2_BraZ1	378	+	1451	1479	1479	1.0000000
A07	20387816	20391254	A07p30930.2_BraZ1	1613.62	+	1730	3418	3438	0.9941826
A07	20392021	20392344	A07p30940.2_BraZ1	162	-	218	323	323	1.0000000
A07	20392448	20394193	A07p30950.2_BraZ1	1027.69	+	970	1683	1745	0.9644699
A07	20397960	20398281	A07p30960.2_BraZ1	29.4	+	4	178	321	0.5545171
A07	20400341	20402039	A07p30970.2_BraZ1	381.429	-	878	1698	1698	1.0000000
A07	20407857	20408751	A07p30980.2_BraZ1	89.4	-	412	894	894	1.0000000
A07	20414629	20415649	A07p30990.2_BraZ1	102	-	370	1020	1020	1.0000000
A07	20416148	20416444	A07p31000.2_BraZ1	27.3	-	16	132	296	0.4459459
A07	20424459	20427290	A07p31010.2_BraZ1	1367.58	+	979	2686	2831	0.9487814
A07	20428253	20436782	A07p31020.2_BraZ1	1649.99	-	4757	8121	8529	0.9521632
A07	20443483	20446187	A07p31030.2_BraZ1	1836.04	+	1392	2702	2704	0.9992604
A07	20446710	20450606	A07p31040.2_BraZ1	327	-	569	1585	3896	0.4068275
A07	20451381	20452973	A07p31050.2_BraZ1	951	+	1572	1592	1592	1.0000000
A07	20453852	20454119	A07p31060.2_BraZ1	26.7	-	181	267	267	1.0000000
A07	20455426	20463323	A07p31070.2_BraZ1	2818.51	-	1732	3812	7897	0.4827150
A07	20465218	20467397	A07p31080.2_BraZ1	1174.91	-	1326	2008	2179	0.9215236
A07	20469099	20470932	A07p31090.2_BraZ1	183.3	+	736	1716	1833	0.9361702
A07	20472009	20472959	A07p31100.2_BraZ1	861	+	364	950	950	1.0000000
A07	20475621	20476074	A07p31110.2_BraZ1	321	+	168	453	453	1.0000000
A07	20476692	20478377	A07p31120.2_BraZ1	99.6	-	768	1679	1685	0.9964392
A07	20479008	20479490	A07p31130.2_BraZ1	32.4	+	342	482	482	1.0000000
A07	20479769	20480511	A07p31140.2_BraZ1	47.7	-	826	742	742	1.0000000
A07	20482357	20483616	A07p31150.2_BraZ1	1143	-	1076	1259	1259	1.0000000
A07	20486863	20487899	A07p31160.2_BraZ1	639	+	636	1036	1036	1.0000000
A07	20491727	20494852	A07p31170.2_BraZ1	1430.62	+	1189	2990	3125	0.9568000
A07	20496846	20498015	A07p31180.2_BraZ1	4725	+	227	947	1169	0.8100941
A07	20500283	20501035	A07p31190.2_BraZ1	669	-	215	752	752	1.0000000
A07	20503044	20503641	A07p31200.2_BraZ1	59.7	-	446	597	597	1.0000000
A07	20505304	20505676	A07p31210.2_BraZ1	37.2	-	647	372	372	1.0000000
A07	20506350	20509347	A07p31220.2_BraZ1	1461.99	+	2359	2948	2997	0.9836503
A07	20510074	20512683	A07p31230.2_BraZ1	1114.31	+	2429	2609	2609	1.0000000
A07	20513539	20514774	A07p31240.2_BraZ1	700.728	+	1251	1170	1235	0.9473684
A07	20515853	20517335	A07p31250.2_BraZ1	148.2	+	341	1458	1482	0.9838057
A07	20518101	20518809	A07p31260.2_BraZ1	70.8	+	395	708	708	1.0000000
A07	20520241	20522737	A07p31270.2_BraZ1	1786.09	+	582	2305	2496	0.9234776
A07	20523739	20525877	A07p31280.2_BraZ1	1602	-	1201	2138	2138	1.0000000
A07	20527970	20530457	A07p31290.2_BraZ1	248.7	-	348	1932	2487	0.7768396
A07	20531094	20531370	A07p31300.2_BraZ1	27.6	+	179	276	276	1.0000000
A07	20532784	20535922	A07p31310.2_BraZ1	313.8	-	339	2398	3138	0.7641810
A07	20538617	20542074	A07p31320.2_BraZ1	1689.04	-	2417	3317	3457	0.9595025
A07	20547661	20550934	A07p31330.2_BraZ1	824.828	-	1449	3163	3273	0.9663917
A07	20557722	20559227	A07p31340.2_BraZ1	1314	-	418	1469	1505	0.9760798
A07	20560108	20560405	A07p31350.2_BraZ1	29.4	+	45	209	297	0.7037037
A07	20565960	20567326	A07p31360.2_BraZ1	950.625	-	257	1211	1366	0.8865300
A07	20581801	20581993	A07p31370.2_BraZ1	19.2	-	220	192	192	1.0000000
A07	20582985	20583405	A07p31380.2_BraZ1	42	-	386	420	420	1.0000000
A07	20600185	20601331	A07p31390.2_BraZ1	114.6	+	1487	1146	1146	1.0000000
A07	20602629	20604126	A07p31400.2_BraZ1	149.7	-	98	750	1497	0.5010020
A07	20605565	20605877	A07p31410.2_BraZ1	225	+	54	202	312	0.6474359
A07	20606350	20607634	A07p31420.2_BraZ1	128.4	-	125	1011	1284	0.7873832
A07	20624867	20625235	A07p31430.2_BraZ1	282	+	32	148	368	0.4021739
A07	20627770	20629789	A07p31440.2_BraZ1	767.854	+	549	2019	2019	1.0000000
A07	20631484	20633654	A07p31450.2_BraZ1	1075.06	+	286	1241	2170	0.5718894
A07	20634132	20634642	A07p31460.2_BraZ1	296.471	-	173	510	510	1.0000000
A07	20641164	20644660	A07p31470.2_BraZ1	6558.75	-	2947	3355	3496	0.9596682
A07	20652985	20654703	A07p31480.2_BraZ1	1632	+	363	1302	1718	0.7578580
A07	20655240	20657702	A07p31490.2_BraZ1	1434	-	2026	2462	2462	1.0000000
A07	20658140	20659514	A07p31500.2_BraZ1	137.4	-	106	807	1374	0.5873362
A07	20661042	20661801	A07p31510.2_BraZ1	75.9	+	326	759	759	1.0000000
A07	20662359	20663249	A07p31520.2_BraZ1	213	-	161	821	890	0.9224719
A07	20666762	20669749	A07p31530.2_BraZ1	21164.1	+	1346	2983	2987	0.9986609
A07	20670319	20676456	A07p31540.2_BraZ1	2140.99	+	2113	6126	6137	0.9982076
A07	20676917	20678514	A07p31550.2_BraZ1	1410	-	804	1547	1597	0.9686913
A07	20679357	20701408	A07p31560.2_BraZ1	1883.45	+	11894	17161	22051	0.7782413
A07	20680537	20682852	A07p31570.2_BraZ1	442.015	-	2563	2315	2315	1.0000000
A07	20684215	20686072	A07p31580.2_BraZ1	952.105	-	1670	1857	1857	1.0000000
A07	20687060	20687809	A07p31590.2_BraZ1	447.429	+	0	0	749	0.0000000
A07	20695130	20696648	A07p31600.2_BraZ1	741	+	778	1415	1518	0.9321476
A07	20703956	20705332	A07p31610.2_BraZ1	1809	-	269	1295	1376	0.9411337
A07	20706187	20707240	A07p31620.2_BraZ1	95.1	-	170	1015	1053	0.9639126
A07	20708458	20709638	A07p31630.2_BraZ1	456	-	251	1064	1180	0.9016949
A07	20710551	20711670	A07p31640.2_BraZ1	450	-	1803	1119	1119	1.0000000
A07	20717782	20719428	A07p31650.2_BraZ1	1035.94	+	863	1607	1646	0.9763062
A07	20720677	20721260	A07p31660.2_BraZ1	468	+	31	336	583	0.5763294
A07	20721832	20724658	A07p31670.2_BraZ1	1704.86	-	1167	2621	2826	0.9274593
A07	20726493	20727203	A07p31680.2_BraZ1	633	-	248	710	710	1.0000000
A07	20728898	20730311	A07p31690.2_BraZ1	141.3	-	224	1209	1413	0.8556263
A07	20730560	20731349	A07p31700.2_BraZ1	231	-	224	668	789	0.8466413
A07	20731013	20732296	A07p31710.2_BraZ1	318.6	+	52	584	1283	0.4551832
A07	20733896	20738712	A07p31720.2_BraZ1	2999.25	+	2652	3939	4816	0.8178987
A07	20739664	20741772	A07p31730.2_BraZ1	1079.85	+	1142	2023	2108	0.9596774
A07	20742326	20743264	A07p31740.2_BraZ1	582	+	698	842	938	0.8976546
A07	20755288	20758922	A07p31750.2_BraZ1	1345.05	+	1997	3485	3634	0.9589983
A07	20759529	20759787	A07p31760.2_BraZ1	25.2	+	213	258	258	1.0000000
A07	20761339	20762705	A07p31770.2_BraZ1	796.76	+	894	1366	1366	1.0000000
A07	20765035	20766934	A07p31780.2_BraZ1	1728	+	535	1615	1899	0.8504476
A07	20769237	20772135	A07p31790.2_BraZ1	1015.64	+	2187	2898	2898	1.0000000
A07	20775402	20778337	A07p31800.2_BraZ1	1789.76	+	883	2745	2935	0.9352641
A07	20779104	20782510	A07p31810.2_BraZ1	1594.34	-	1706	2925	3406	0.8587787
A07	20783573	20784553	A07p31820.2_BraZ1	720	+	679	980	980	1.0000000
A07	20798726	20798885	A07p31830.2_BraZ1	15.9	+	113	159	159	1.0000000
A07	20801341	20806026	A07p31840.2_BraZ1	1347.78	-	3025	4662	4685	0.9950907
A07	20811974	20814531	A07p31850.2_BraZ1	2610	+	1587	2545	2557	0.9953070
A07	20818462	20819389	A07p31860.2_BraZ1	92.7	+	260	927	927	1.0000000
A07	20821337	20824576	A07p31870.2_BraZ1	1259.93	-	1148	2669	3239	0.8240197
A07	20826911	20827487	A07p31880.2_BraZ1	603	-	436	576	576	1.0000000
A07	20828037	20835620	A07p31890.2_BraZ1	2764.78	-	2731	7023	7583	0.9261506
A07	20837959	20838286	A07p31900.2_BraZ1	32.7	-	1205	327	327	1.0000000
A07	20839078	20842730	A07p31910.2_BraZ1	2724.81	+	512	3231	3652	0.8847207
A07	20851975	20854730	A07p31920.2_BraZ1	1724.29	+	922	2716	2755	0.9858439
A07	20856321	20857767	A07p31930.2_BraZ1	460.957	+	713	1372	1446	0.9488243
A07	20859412	20868275	A07p31940.2_BraZ1	1477.09	+	8723	8597	8863	0.9699876
A07	20861040	20862383	A07p31950.2_BraZ1	195	+	469	1099	1343	0.8183172
A07	20871272	20877251	A07p31960.2_BraZ1	465.564	+	3686	4110	5979	0.6874059
A07	20877247	20878444	A07p31970.2_BraZ1	347.368	+	660	1155	1197	0.9649123
A07	20880331	20882005	A07p31980.2_BraZ1	1128.21	+	720	1674	1674	1.0000000
A07	20884381	20885345	A07p31990.2_BraZ1	363	+	1396	964	964	1.0000000
A07	20886554	20887512	A07p32000.2_BraZ1	752.659	-	249	910	958	0.9498956
A07	20888269	20891578	A07p32010.2_BraZ1	939.901	-	1918	3309	3309	1.0000000
A07	20891531	20891736	A07p32020.2_BraZ1	120	-	221	205	205	1.0000000
A07	20892067	20892553	A07p32030.2_BraZ1	192	+	401	486	486	1.0000000
A07	20897553	20897790	A07p32040.2_BraZ1	23.4	+	158	237	237	1.0000000
A07	20898836	20900303	A07p32050.2_BraZ1	146.7	-	416	1318	1467	0.8984322
A07	20902321	20904355	A07p32060.2_BraZ1	203.4	-	259	1803	2034	0.8864307
A07	20905987	20909882	A07p32070.2_BraZ1	3375	-	1320	3768	3895	0.9673941
A07	20913009	20913495	A07p32080.2_BraZ1	246	+	241	427	486	0.8786008
A07	20913822	20914957	A07p32090.2_BraZ1	612	-	700	1104	1135	0.9726872
A07	20915634	20918909	A07p32100.2_BraZ1	1833.43	+	458	2274	3275	0.6943511
A07	20919291	20919675	A07p32110.2_BraZ1	38.4	-	523	384	384	1.0000000
A07	20921256	20925706	A07p32120.2_BraZ1	2009.05	+	2256	4379	4450	0.9840450
A07	20927056	20930009	A07p32130.2_BraZ1	1641.82	-	541	1771	2953	0.5997291
A07	20932191	20938989	A07p32140.2_BraZ1	3129.23	-	3815	6382	6798	0.9388055
A07	20945068	20946802	A07p32150.2_BraZ1	16128	-	621	1701	1734	0.9809688
A07	20951357	20953461	A07p32160.2_BraZ1	983.203	+	902	2014	2104	0.9572243
A07	20954524	20956066	A07p32170.2_BraZ1	4420.5	-	1547	1542	1542	1.0000000
A07	20957503	20964641	A07p32180.2_BraZ1	3298.03	+	6644	7043	7138	0.9866909
A07	20965651	20966665	A07p32190.2_BraZ1	101.4	-	257	958	1014	0.9447732
A07	20975994	20977611	A07p32200.2_BraZ1	161.7	-	607	1475	1617	0.9121830
A07	20984031	20985019	A07p32210.2_BraZ1	117	+	76	808	988	0.8178138
A07	20985439	20985886	A07p32220.2_BraZ1	321	+	232	447	447	1.0000000
A07	20987564	20988586	A07p32230.2_BraZ1	351	+	931	1003	1022	0.9814090
A07	20989870	20992628	A07p32240.2_BraZ1	1237.57	-	257	2301	2758	0.8343002
A07	20993720	20994454	A07p32250.2_BraZ1	282	+	500	715	734	0.9741144
A07	20995844	20997193	A07p32260.2_BraZ1	957.6	-	46	735	1349	0.5448480
A07	20998113	20998941	A07p32270.2_BraZ1	624	+	50	397	828	0.4794686
A07	21005459	21006894	A07p32280.2_BraZ1	1134.29	+	42	586	1435	0.4083624
A07	21007848	21008793	A07p32290.2_BraZ1	619.303	-	167	782	945	0.8275132
A07	21012106	21012640	A07p32300.2_BraZ1	219	-	105	492	534	0.9213483
A07	21018813	21020065	A07p32310.2_BraZ1	910.083	+	740	1252	1252	1.0000000
A07	21021625	21021933	A07p32320.2_BraZ1	17.4	+	379	308	308	1.0000000
A07	21022812	21024693	A07p32330.2_BraZ1	188.1	-	40	769	1881	0.4088251
A07	21027827	21030043	A07p32340.2_BraZ1	1959	-	596	1755	2216	0.7919675
A07	21035127	21035484	A07p32350.2_BraZ1	35.7	+	8	298	357	0.8347339
A07	21038002	21039688	A07p32360.2_BraZ1	1200.45	+	1222	1686	1686	1.0000000
A07	21040456	21041296	A07p32370.2_BraZ1	84	-	413	814	840	0.9690476
A07	21042817	21043456	A07p32380.2_BraZ1	63.9	+	251	625	639	0.9780908
A07	21043970	21045535	A07p32390.2_BraZ1	182	-	246	1405	1565	0.8977636
A07	21045535	21047913	A07p32400.2_BraZ1	81.25	-	736	2115	2378	0.8894029
A07	21051974	21054139	A07p32410.2_BraZ1	1000.66	-	170	1377	2165	0.6360277
A07	21062169	21062980	A07p32420.2_BraZ1	276	-	86	175	811	0.2157830
A07	21066208	21067420	A07p32430.2_BraZ1	121.2	+	34	426	1212	0.3514852
A07	21068687	21070547	A07p32440.2_BraZ1	1005.97	+	710	1817	1860	0.9768817
A07	21070653	21073719	A07p32450.2_BraZ1	2830.4	-	1303	3066	3066	1.0000000
A07	21082005	21082582	A07p32460.2_BraZ1	369	-	679	577	577	1.0000000
A07	21082958	21084738	A07p32470.2_BraZ1	801.5	+	452	1404	1780	0.7887641
A07	21089441	21091690	A07p32480.2_BraZ1	1570.67	-	901	2249	2249	1.0000000
A07	21092878	21098254	A07p32490.2_BraZ1	1878.75	-	1352	3776	5376	0.7023810
A07	21099897	21107145	A07p32500.2_BraZ1	2758	-	3782	6961	7248	0.9604028
A07	21107874	21111948	A07p32510.2_BraZ1	1925	-	879	3316	4074	0.8139421
A07	21108797	21109130	A07p32520.2_BraZ1	33.3	+	111	333	333	1.0000000
A07	21113379	21113834	A07p32530.2_BraZ1	384	-	72	331	455	0.7274725
A07	21113834	21115551	A07p32540.2_BraZ1	1160	-	877	1717	1717	1.0000000
A07	21116822	21118731	A07p32550.2_BraZ1	966.252	-	955	1909	1909	1.0000000
A07	21119740	21120121	A07p32560.2_BraZ1	240	-	248	381	381	1.0000000
A07	21121994	21122192	A07p32570.2_BraZ1	11.4	+	297	198	198	1.0000000
A07	21122393	21123599	A07p32580.2_BraZ1	666.667	-	634	1206	1206	1.0000000
A07	21124287	21124795	A07p32590.2_BraZ1	294	+	354	508	508	1.0000000
A07	21131203	21131809	A07p32600.2_BraZ1	60.6	-	624	606	606	1.0000000
A07	21138229	21144501	A07p32610.2_BraZ1	1893.82	+	1672	5586	6272	0.8906250
A07	21145462	21148647	A07p32620.2_BraZ1	1095.98	-	861	2739	3185	0.8599686
A07	21149745	21150016	A07p32630.2_BraZ1	237	-	548	271	271	1.0000000
A07	21152544	21154684	A07p32640.2_BraZ1	1245.97	-	305	1680	2140	0.7850468
A07	21175648	21176472	A07p32650.2_BraZ1	77.1	-	48	382	824	0.4635922
A07	21187371	21187722	A07p32660.2_BraZ1	35.1	+	124	351	351	1.0000000
A07	21190494	21192341	A07p32670.2_BraZ1	1385.1	+	216	1518	1847	0.8218733
A07	21192840	21194631	A07p32680.2_BraZ1	943.214	-	837	1791	1791	1.0000000
A07	21195527	21198653	A07p32690.2_BraZ1	1819.18	-	771	2897	3126	0.9267434
A07	21202081	21208726	A07p32700.2_BraZ1	1963.91	-	601	3611	6645	0.5434161
A07	21210074	21212553	A07p32710.2_BraZ1	1288.96	-	1247	2235	2479	0.9015732
A07	21212959	21214013	A07p32720.2_BraZ1	594	+	447	1054	1054	1.0000000
A07	21215330	21217963	A07p32730.2_BraZ1	1878.5	+	1304	2552	2633	0.9692366
A07	21229781	21232996	A07p32740.2_BraZ1	1858.07	+	591	2819	3215	0.8768274
A07	21233996	21235190	A07p32750.2_BraZ1	119.4	+	662	1193	1194	0.9991625
A07	21237013	21238904	A07p32760.2_BraZ1	998.25	-	786	1821	1891	0.9629825
A07	21247229	21249254	A07p32770.2_BraZ1	446.932	+	157	870	2025	0.4296296
A07	21249263	21250523	A07p32780.2_BraZ1	499.5	+	5	251	1260	0.1992064
A07	21254632	21261544	A07p32790.2_BraZ1	1123.69	+	3725	6479	6912	0.9373553
A07	21262582	21264878	A07p32800.2_BraZ1	1574.43	-	863	2276	2296	0.9912892
A07	21265980	21268017	A07p32810.2_BraZ1	203.7	+	555	1936	2037	0.9504173
A07	21268013	21268795	A07p32820.2_BraZ1	366	+	677	782	782	1.0000000
A07	21268841	21270177	A07p32830.2_BraZ1	540.6	-	1356	1336	1336	1.0000000
A07	21271960	21273242	A07p32840.2_BraZ1	1236.56	+	237	1225	1282	0.9555382
A07	21278841	21279144	A07p32850.2_BraZ1	30.3	+	128	303	303	1.0000000
A07	21279598	21280141	A07p32860.2_BraZ1	54.3	-	94	525	543	0.9668508
A07	21284845	21287266	A07p32870.2_BraZ1	7707	-	1920	2421	2421	1.0000000
A07	21288922	21291436	A07p32880.2_BraZ1	251.4	-	2877	2514	2514	1.0000000
A07	21293322	21294636	A07p32890.2_BraZ1	131.4	+	278	1305	1314	0.9931507
A07	21297986	21304346	A07p32900.2_BraZ1	2253.73	+	2181	5551	6360	0.8727987
A07	21304655	21306928	A07p32910.2_BraZ1	1132.83	-	2253	2273	2273	1.0000000
A07	21307321	21308191	A07p32920.2_BraZ1	510.136	+	555	870	870	1.0000000
A07	21308639	21310258	A07p32930.2_BraZ1	995.062	-	1288	1619	1619	1.0000000
A07	21310935	21311329	A07p32940.2_BraZ1	324	-	229	394	394	1.0000000
A07	21311397	21314905	A07p32950.2_BraZ1	3417	-	1317	3438	3508	0.9800456
A07	21315897	21316356	A07p32960.2_BraZ1	324	-	276	453	459	0.9869281
A07	21316761	21320238	A07p32970.2_BraZ1	1665	+	1982	3213	3477	0.9240725
A07	21320400	21322356	A07p32980.2_BraZ1	1336.19	-	183	1697	1956	0.8675869
A07	21324932	21325607	A07p32990.2_BraZ1	49.8	-	251	675	675	1.0000000
A07	21332864	21334317	A07p33000.2_BraZ1	1120	+	566	1448	1453	0.9965588
A07	21348982	21349640	A07p33010.2_BraZ1	348	-	673	658	658	1.0000000
A07	21354553	21357319	A07p33020.2_BraZ1	2280	-	1072	2566	2766	0.9276934
A07	21361151	21361921	A07p33030.2_BraZ1	453.75	+	208	756	770	0.9818182
A07	21363894	21364263	A07p33040.2_BraZ1	225	+	117	369	369	1.0000000
A07	21364682	21368036	A07p33050.2_BraZ1	115.385	-	2475	3302	3354	0.9844961
A07	21369437	21369797	A07p33060.2_BraZ1	222	+	37	188	360	0.5222222
A07	21370032	21372818	A07p33070.2_BraZ1	409.846	-	366	2172	2786	0.7796124
A07	21377455	21377701	A07p33080.2_BraZ1	24.6	-	117	218	246	0.8861789
A07	21377769	21378271	A07p33090.2_BraZ1	429	+	382	502	502	1.0000000
A07	21383466	21384915	A07p33100.2_BraZ1	144.9	-	101	930	1449	0.6418219
A07	21385864	21387514	A07p33110.2_BraZ1	992.292	+	584	1650	1650	1.0000000
A07	21393363	21393999	A07p33120.2_BraZ1	63.6	-	235	588	636	0.9245283
A07	21397874	21401559	A07p33130.2_BraZ1	1407.73	+	993	3272	3685	0.8879240
A07	21402293	21403429	A07p33140.2_BraZ1	710	-	330	840	1136	0.7394366
A07	21405154	21405928	A07p33150.2_BraZ1	340.174	-	75	600	774	0.7751938
A07	21409726	21411360	A07p33160.2_BraZ1	403.2	-	1097	1445	1634	0.8843330
A07	21411914	21416000	A07p33170.2_BraZ1	1888.54	-	476	2833	4086	0.6933431
A07	21416569	21417010	A07p33180.2_BraZ1	44.1	+	115	366	441	0.8299320
A07	21418528	21419858	A07p33190.2_BraZ1	766.5	+	550	1295	1330	0.9736842
A07	21420837	21422196	A07p33200.2_BraZ1	135.9	+	475	1310	1359	0.9639441
A07	21423687	21424567	A07p33210.2_BraZ1	542.305	+	983	880	880	1.0000000
A07	21425615	21426116	A07p33220.2_BraZ1	50.1	+	629	501	501	1.0000000
A07	21437800	21439829	A07p33230.2_BraZ1	1956	+	439	2029	2029	1.0000000
A07	21442803	21443239	A07p33240.2_BraZ1	348	+	585	436	436	1.0000000
A07	21443815	21444259	A07p33250.2_BraZ1	27.3	-	359	444	444	1.0000000
A07	21449349	21450495	A07p33260.2_BraZ1	180	-	452	1080	1146	0.9424084
A07	21452004	21454257	A07p33270.2_BraZ1	1222.2	+	1545	2253	2253	1.0000000
A07	21456175	21456424	A07p33280.2_BraZ1	24.9	-	33	224	249	0.8995984
A07	21470178	21472598	A07p33290.2_BraZ1	1068.57	+	955	2230	2420	0.9214876
A07	21477214	21478554	A07p33300.2_BraZ1	13261.5	-	244	1229	1340	0.9171642
A07	21486027	21488191	A07p33310.2_BraZ1	1500	+	772	1758	2164	0.8123845
A07	21490165	21491937	A07p33320.2_BraZ1	1571.43	+	883	1772	1772	1.0000000
A07	21492908	21493550	A07p33330.2_BraZ1	64.2	-	397	627	642	0.9766355
A07	21496280	21498914	A07p33340.2_BraZ1	1250.23	-	1458	2595	2634	0.9851936
A07	21500769	21501941	A07p33350.2_BraZ1	114.6	-	118	1123	1172	0.9581911
A07	21503299	21504928	A07p33360.2_BraZ1	6385.5	+	739	1629	1629	1.0000000
A07	21506550	21507088	A07p33370.2_BraZ1	177	-	290	538	538	1.0000000
A07	21508735	21514164	A07p33380.2_BraZ1	3502.18	-	3191	5356	5429	0.9865537
A07	21515942	21516490	A07p33390.2_BraZ1	390	-	735	548	548	1.0000000
A07	21517435	21520166	A07p33400.2_BraZ1	449.423	-	1768	2292	2731	0.8392530
A07	21528877	21529785	A07p33410.2_BraZ1	711	+	629	872	908	0.9603524
A07	21531819	21532023	A07p33420.2_BraZ1	20.4	+	266	204	204	1.0000000
A07	21537119	21537939	A07p33430.2_BraZ1	705	+	147	789	820	0.9621951
A07	21541800	21542341	A07p33440.2_BraZ1	453	-	513	541	541	1.0000000
A07	21547255	21547702	A07p33450.2_BraZ1	44.7	-	845	447	447	1.0000000
A07	21549563	21551435	A07p33460.2_BraZ1	187.2	-	593	1806	1872	0.9647436
A07	21556396	21557316	A07p33470.2_BraZ1	208.125	-	2655	920	920	1.0000000
A07	21562160	21566169	A07p33480.2_BraZ1	1550	-	1995	2869	4009	0.7156398
A07	21566711	21567828	A07p33490.2_BraZ1	858	+	308	991	1117	0.8871979
A07	21574254	21574974	A07p33500.2_BraZ1	395.571	-	194	720	720	1.0000000
A07	21578444	21579222	A07p33510.2_BraZ1	214.286	-	163	731	778	0.9395887
A07	21580586	21584903	A07p33520.2_BraZ1	1658.18	-	400	2516	4317	0.5828121
A07	21587756	21588143	A07p33530.2_BraZ1	330	+	382	387	387	1.0000000
A07	21590476	21590696	A07p33540.2_BraZ1	138	+	70	220	220	1.0000000
A07	21593569	21594941	A07p33550.2_BraZ1	7020.75	-	213	1123	1372	0.8185131
A07	21613399	21613567	A07p33560.2_BraZ1	16.8	+	34	168	168	1.0000000
A07	21616581	21617127	A07p33570.2_BraZ1	54.6	+	2	62	546	0.1135531
A07	21623137	21623631	A07p33580.2_BraZ1	296.4	-	460	494	494	1.0000000
A07	21625216	21626273	A07p33590.2_BraZ1	663.854	-	481	1057	1057	1.0000000
A07	21627944	21628564	A07p33600.2_BraZ1	461.053	+	445	620	620	1.0000000
A07	21630522	21631479	A07p33610.2_BraZ1	95.7	-	98	633	957	0.6614420
A07	21640556	21641851	A07p33620.2_BraZ1	603.5	-	409	1271	1295	0.9814672
A07	21643524	21645908	A07p33630.2_BraZ1	1324.8	+	1829	2384	2384	1.0000000
A07	21646612	21646965	A07p33640.2_BraZ1	261	+	268	343	353	0.9716714
A07	21648505	21649998	A07p33650.2_BraZ1	5307.75	+	1115	1398	1493	0.9363697
A07	21651652	21652473	A07p33660.2_BraZ1	361.765	-	225	821	821	1.0000000
A07	21655064	21655298	A07p33670.2_BraZ1	23.4	+	544	234	234	1.0000000
A07	21656717	21657089	A07p33680.2_BraZ1	37.2	-	7	52	372	0.1397849
A07	21663410	21664972	A07p33690.2_BraZ1	904.745	-	578	1507	1562	0.9647887
A07	21673310	21675024	A07p33700.2_BraZ1	8707.5	+	802	1600	1714	0.9334889
A07	21677033	21678109	A07p33710.2_BraZ1	10091.2	-	7	124	1076	0.1152416
A07	21682761	21684519	A07p33720.2_BraZ1	1254	-	1613	1605	1758	0.9129693
A07	21687050	21688744	A07p33730.2_BraZ1	325.125	-	1939	1694	1694	1.0000000
A07	21688920	21692129	A07p33740.2_BraZ1	3316.88	-	2647	3209	3209	1.0000000
A07	21694946	21695925	A07p33750.2_BraZ1	816	-	47	540	979	0.5515832
A07	21702807	21706233	A07p33760.2_BraZ1	2955	+	1011	3036	3426	0.8861646
A07	21708940	21711498	A07p33770.2_BraZ1	1318.5	-	2795	2558	2558	1.0000000
A07	21725843	21728033	A07p33780.2_BraZ1	785.68	-	1487	1992	2190	0.9095891
A07	21735073	21737024	A07p33790.2_BraZ1	849.286	+	984	1853	1951	0.9497694
A07	21742882	21744110	A07p33800.2_BraZ1	629.625	+	702	1228	1228	1.0000000
A07	21747113	21748381	A07p33810.2_BraZ1	1044	-	798	1146	1268	0.9037855
A07	21752201	21752481	A07p33820.2_BraZ1	39.4737	-	21	280	280	1.0000000
A07	21752297	21753238	A07p33830.2_BraZ1	219	-	170	694	941	0.7375133
A07	21753437	21755178	A07p33840.2_BraZ1	1105.89	-	657	1741	1741	1.0000000
A07	21757484	21759042	A07p33850.2_BraZ1	917.053	-	1629	1558	1558	1.0000000
A07	21761889	21762062	A07p33860.2_BraZ1	117	-	182	173	173	1.0000000
A07	21768581	21772772	A07p33870.2_BraZ1	652.5	+	1569	3988	4191	0.9515629
A07	21773448	21774070	A07p33880.2_BraZ1	350.659	-	121	417	622	0.6704180
A07	21776714	21776996	A07p33890.2_BraZ1	28.2	-	113	282	282	1.0000000
A07	21778393	21782705	A07p33900.2_BraZ1	2141.41	+	4239	4312	4312	1.0000000
A07	21788667	21792147	A07p33910.2_BraZ1	987	+	592	2058	3480	0.5913793
A07	21794605	21794988	A07p33920.2_BraZ1	312	+	7	126	383	0.3289817
A07	21796048	21797207	A07p33930.2_BraZ1	297	+	972	1159	1159	1.0000000
A07	21801341	21801764	A07p33940.2_BraZ1	42.3	-	57	423	423	1.0000000
A07	21806907	21808380	A07p33950.2_BraZ1	1002.27	+	462	1136	1473	0.7712152
A07	21809742	21811327	A07p33960.2_BraZ1	1062	-	742	1532	1585	0.9665615
A07	21825842	21831281	A07p33970.2_BraZ1	3117	+	1549	4535	5439	0.8337930
A07	21836752	21840270	A07p33980.2_BraZ1	1476.12	+	1210	3319	3518	0.9434338
A07	21840528	21840814	A07p33990.2_BraZ1	23.1	-	147	286	286	1.0000000
A07	21842401	21842843	A07p34000.2_BraZ1	237	+	89	442	442	1.0000000
A07	21843204	21844396	A07p34010.2_BraZ1	507	-	739	1192	1192	1.0000000
A07	21850472	21850741	A07p34020.2_BraZ1	21.6	+	79	220	269	0.8178439
A07	21853712	21858158	A07p34030.2_BraZ1	3342.86	+	1760	4324	4446	0.9725596
A07	21858397	21858980	A07p34040.2_BraZ1	41.1	-	265	583	583	1.0000000
A07	21859537	21862036	A07p34050.2_BraZ1	1825.09	-	1498	2499	2499	1.0000000
A07	21865556	21866355	A07p34060.2_BraZ1	554.4	-	356	799	799	1.0000000
A07	21866811	21867764	A07p34070.2_BraZ1	468.571	+	711	916	953	0.9611753
A07	21868428	21869201	A07p34080.2_BraZ1	486	-	84	638	773	0.8253558
A07	21876720	21877332	A07p34090.2_BraZ1	2685	+	68	289	612	0.4722222
A07	21877471	21878029	A07p34100.2_BraZ1	403.2	-	78	544	558	0.9749104
A07	21879232	21881744	A07p34110.2_BraZ1	12420	-	589	2427	2512	0.9661624
A07	21884530	21888408	A07p34120.2_BraZ1	1673.17	-	1233	3577	3878	0.9223827
A07	21903824	21907600	A07p34130.2_BraZ1	2948.44	+	1665	3285	3776	0.8699682
A07	21914216	21914847	A07p34140.2_BraZ1	219.857	-	71	568	631	0.9001585
A07	21916850	21917114	A07p34150.2_BraZ1	26.4	+	5	2	264	0.0075758
A07	21924359	21924716	A07p34160.2_BraZ1	261	+	125	357	357	1.0000000
A07	21924831	21925785	A07p34170.2_BraZ1	95.4	+	707	954	954	1.0000000
A07	21934968	21937250	A07p34180.2_BraZ1	1494	+	1465	2114	2282	0.9263804
A07	21942348	21943824	A07p34190.2_BraZ1	1209	+	587	1446	1476	0.9796748
A07	21949810	21950693	A07p34200.2_BraZ1	531	-	268	818	883	0.9263873
A07	21958042	21959044	A07p34210.2_BraZ1	100.2	+	680	948	1002	0.9461078
A07	21965372	21965798	A07p34220.2_BraZ1	42.6	+	230	426	426	1.0000000
A07	21967303	21971396	A07p34230.2_BraZ1	762	+	4443	4093	4093	1.0000000
A07	21971448	21972249	A07p34240.2_BraZ1	80.1	-	21	419	801	0.5230961
A07	21979902	21980938	A07p34250.2_BraZ1	804.316	-	6	292	1036	0.2818533
A07	21984371	21985566	A07p34260.2_BraZ1	467.5	-	37	586	1195	0.4903766
A07	21986054	21986769	A07p34270.2_BraZ1	504	+	497	715	715	1.0000000
A07	21993382	21996874	A07p34280.2_BraZ1	689.13	+	600	2822	3492	0.8081329
A07	22000405	22004862	A07p34290.2_BraZ1	441.15	+	314	1922	4457	0.4312318
A07	22002140	22003058	A07p34300.2_BraZ1	399	-	5	218	918	0.2374728
A07	22011436	22016275	A07p34310.2_BraZ1	788.741	-	2936	4837	4839	0.9995867
A07	22017837	22018866	A07p34320.2_BraZ1	102.9	+	588	1029	1029	1.0000000
A07	22019604	22021495	A07p34330.2_BraZ1	480	-	1418	1891	1891	1.0000000
A07	22025056	22025473	A07p34340.2_BraZ1	285	+	0	0	417	0.0000000
A07	22027478	22029319	A07p34350.2_BraZ1	701.901	+	1054	1770	1841	0.9614340
A07	22039299	22041260	A07p34360.2_BraZ1	1242	-	297	1651	1961	0.8419174
A07	22049102	22051497	A07p34370.2_BraZ1	1282.5	-	1967	2395	2395	1.0000000
A07	22051775	22053259	A07p34380.2_BraZ1	1266.31	+	1716	1484	1484	1.0000000
A07	22054216	22056978	A07p34390.2_BraZ1	1612.19	+	1135	2725	2762	0.9866039
A07	22057882	22060649	A07p34400.2_BraZ1	2656.8	-	772	2651	2767	0.9580773
A07	22066071	22067424	A07p34410.2_BraZ1	702.625	-	1365	1353	1353	1.0000000
A07	22073974	22077672	A07p34420.2_BraZ1	2038.86	+	536	2709	3698	0.7325581
A07	22084317	22090119	A07p34430.2_BraZ1	2357.43	+	1951	5263	5802	0.9071010
A07	22097764	22102811	A07p34440.2_BraZ1	5705.28	+	2166	4355	5047	0.8628889
A07	22108001	22111954	A07p34450.2_BraZ1	2025	+	1429	3716	3953	0.9400455
A07	22113307	22114017	A07p34460.2_BraZ1	411	+	274	572	710	0.8056338
A07	22115477	22115678	A07p34470.2_BraZ1	20.1	-	31	201	201	1.0000000
A07	22118820	22119868	A07p34480.2_BraZ1	357	+	308	777	1048	0.7414122
A07	22122468	22124737	A07p34490.2_BraZ1	1575	-	127	1672	2269	0.7368885
A07	22134549	22135987	A07p34500.2_BraZ1	1179	+	366	1406	1438	0.9777468
A07	22139591	22140929	A07p34510.2_BraZ1	756	+	115	959	1338	0.7167414
A07	22142353	22145629	A07p34520.2_BraZ1	905.357	-	483	2337	3276	0.7133700
A07	22148242	22150952	A07p34530.2_BraZ1	1555.6	-	949	2489	2710	0.9184502
A07	22152724	22153159	A07p34540.2_BraZ1	43.5	+	518	435	435	1.0000000
A07	22154176	22156306	A07p34550.2_BraZ1	213	+	1748	2130	2130	1.0000000
A07	22156947	22157634	A07p34560.2_BraZ1	267	+	650	687	687	1.0000000
A07	22159900	22160755	A07p34570.2_BraZ1	85.5	+	463	855	855	1.0000000
A07	22161841	22162939	A07p34580.2_BraZ1	109.8	+	2116	1098	1098	1.0000000
A07	22163609	22163954	A07p34590.2_BraZ1	300	-	265	345	345	1.0000000
A07	22168956	22170465	A07p34600.2_BraZ1	1244.92	-	30	765	1509	0.5069582
A07	22178031	22180152	A07p34610.2_BraZ1	1563	-	572	1858	2121	0.8760019
A07	22180748	22180877	A07p34620.2_BraZ1	12.9	+	11	129	129	1.0000000
A07	22184807	22185413	A07p34630.2_BraZ1	60.6	+	387	606	606	1.0000000
A07	22193801	22194163	A07p34640.2_BraZ1	213	+	1	114	362	0.3149171
A07	22194409	22196456	A07p34650.2_BraZ1	1454.59	+	215	1388	2047	0.6780655
A07	22197099	22198208	A07p34660.2_BraZ1	762.5	-	1127	1109	1109	1.0000000
A07	22198612	22202908	A07p34670.2_BraZ1	1893.51	-	1475	3808	4296	0.8864059
A07	22203221	22204932	A07p34680.2_BraZ1	488.842	+	633	1656	1711	0.9678550
A07	22204355	22205340	A07p34690.2_BraZ1	44.6053	+	391	985	985	1.0000000
A07	22205340	22205853	A07p34700.2_BraZ1	44.7158	+	93	477	513	0.9298246
A07	22208346	22210862	A07p34710.2_BraZ1	1270.96	-	1538	2437	2516	0.9686009
A07	22211858	22212724	A07p34720.2_BraZ1	411.868	+	0	0	866	0.0000000
A07	22224974	22229636	A07p34730.2_BraZ1	2443.7	-	845	3870	4662	0.8301159
A07	22230412	22230599	A07p34740.2_BraZ1	14.4	+	107	187	187	1.0000000
A07	22235191	22239025	A07p34750.2_BraZ1	2009.79	-	447	2566	3834	0.6692749
A07	22240256	22248238	A07p34760.2_BraZ1	4719.13	+	2368	7641	7982	0.9572788
A07	22250563	22256240	A07p34770.2_BraZ1	2545.77	+	2573	5607	5677	0.9876695
A07	22257650	22257950	A07p34780.2_BraZ1	30	-	230	300	300	1.0000000
A07	22258817	22259964	A07p34790.2_BraZ1	581.25	-	145	1079	1147	0.9407149
A07	22264807	22270202	A07p34800.2_BraZ1	2510.56	-	3629	5316	5395	0.9853568
A07	22271327	22273109	A07p34810.2_BraZ1	1305	+	482	1709	1782	0.9590348
A07	22274456	22275238	A07p34820.2_BraZ1	702	+	585	782	782	1.0000000
A07	22276454	22277597	A07p34830.2_BraZ1	114.3	-	706	1143	1143	1.0000000
A07	22280859	22282129	A07p34840.2_BraZ1	1076.4	-	789	1270	1270	1.0000000
A07	22297469	22298345	A07p34850.2_BraZ1	87.6	-	23	508	876	0.5799087
A07	22298431	22303019	A07p34860.2_BraZ1	958.682	+	2566	4201	4588	0.9156495
A07	22304521	22307887	A07p34870.2_BraZ1	1117.29	+	2276	3346	3366	0.9940583
A07	22316353	22321027	A07p34880.2_BraZ1	2734.46	+	4044	4674	4674	1.0000000
A07	22324041	22325085	A07p34890.2_BraZ1	104.4	+	158	852	1044	0.8160920
A07	22328449	22329335	A07p34900.2_BraZ1	426	+	296	886	886	1.0000000
A07	22331038	22334936	A07p34910.2_BraZ1	2616	-	1020	3104	3898	0.7963058
A07	22340189	22344220	A07p34920.2_BraZ1	1415.38	+	1536	3942	4031	0.9779211
A07	22345044	22348967	A07p34930.2_BraZ1	1070.16	-	972	3645	3923	0.9291359
A07	22349123	22353374	A07p34940.2_BraZ1	54	-	509	2694	4251	0.6337332
A07	22351204	22352438	A07p34950.2_BraZ1	2600	-	192	907	1234	0.7350081
A07	22357228	22360155	A07p34960.2_BraZ1	13423.5	+	427	2854	2927	0.9750598
A07	22362302	22364211	A07p34970.2_BraZ1	1044.71	+	628	1856	1909	0.9722368
A07	22365047	22365573	A07p34980.2_BraZ1	2737.5	-	271	455	526	0.8650190
A07	22369851	22370165	A07p34990.2_BraZ1	177	-	305	275	314	0.8757962
A07	22371892	22372672	A07p35000.2_BraZ1	76.2	-	83	725	780	0.9294872
A07	22373184	22373668	A07p35010.2_BraZ1	267	+	137	448	484	0.9256198
A07	22374303	22375915	A07p35020.2_BraZ1	1003.64	-	1000	1612	1612	1.0000000
A07	22389409	22393312	A07p35030.2_BraZ1	1138.82	+	1089	3594	3903	0.9208301
A07	22395081	22396505	A07p35040.2_BraZ1	1389	+	2869	1424	1424	1.0000000
A07	22398589	22400066	A07p35050.2_BraZ1	384.222	-	857	1449	1477	0.9810427
A07	22400951	22402660	A07p35060.2_BraZ1	894.6	-	457	1697	1709	0.9929783
A07	22403905	22404483	A07p35070.2_BraZ1	351	+	246	500	578	0.8650519
A07	22406122	22409107	A07p35080.2_BraZ1	1305	-	949	2832	2985	0.9487437
A07	22410658	22411331	A07p35090.2_BraZ1	1224	-	285	673	673	1.0000000
A07	22411953	22418388	A07p35100.2_BraZ1	3851.63	-	1540	5254	6435	0.8164724
A07	22420122	22423035	A07p35110.2_BraZ1	14916	+	1341	2569	2913	0.8819087
A07	22423651	22427128	A07p35120.2_BraZ1	2235.58	-	547	2610	3477	0.7506471
A07	22440640	22443016	A07p35130.2_BraZ1	511.238	+	1952	2290	2376	0.9638047
A07	22445741	22449528	A07p35140.2_BraZ1	2189.38	-	1546	3704	3787	0.9780829
A07	22449554	22450117	A07p35150.2_BraZ1	227.25	-	354	560	563	0.9946714
A07	22451256	22453339	A07p35160.2_BraZ1	1194	-	161	1420	2083	0.6817091
A07	22455143	22460941	A07p35170.2_BraZ1	3094.49	-	1069	3581	5798	0.6176268
A07	22463718	22469857	A07p35180.2_BraZ1	1489.77	+	526	3243	6139	0.5282620
A07	22476179	22478399	A07p35190.2_BraZ1	370.98	-	955	2220	2220	1.0000000
A07	22479858	22482414	A07p35200.2_BraZ1	793.76	+	1171	2234	2556	0.8740219
A07	22482837	22484749	A07p35210.2_BraZ1	928.125	-	1172	1859	1912	0.9722803
A07	22485525	22486870	A07p35220.2_BraZ1	350.077	-	914	1320	1345	0.9814126
A07	22488837	22492649	A07p35230.2_BraZ1	2207.18	+	2112	3812	3812	1.0000000
A07	22493237	22493789	A07p35240.2_BraZ1	55.2	-	181	552	552	1.0000000
A07	22495458	22500208	A07p35250.2_BraZ1	1562.52	+	2625	4607	4750	0.9698947
A07	22500490	22503943	A07p35260.2_BraZ1	2859.48	-	1968	3422	3453	0.9910223
A07	22505643	22509301	A07p35270.2_BraZ1	1397.41	+	1157	3118	3658	0.8523784
A07	22510999	22520996	A07p35280.2_BraZ1	2564.07	+	5234	8967	9997	0.8969691
A07	22522165	22524217	A07p35290.2_BraZ1	1704	-	491	1482	2052	0.7222222
A07	22526050	22529485	A07p35300.2_BraZ1	1119.25	-	711	2810	3435	0.8180495
A07	22534533	22537473	A07p35310.2_BraZ1	1112.57	+	2104	2908	2940	0.9891157
A07	22538074	22542317	A07p35320.2_BraZ1	1652.84	-	1420	4141	4243	0.9759604
A07	22545061	22551298	A07p35330.2_BraZ1	9652.5	+	2531	5772	6237	0.9254449
A07	22552041	22552751	A07p35340.2_BraZ1	489	-	406	710	710	1.0000000
A07	22553901	22554879	A07p35350.2_BraZ1	415.625	+	597	966	978	0.9877301
A07	22555934	22557488	A07p35360.2_BraZ1	155.4	-	395	1413	1554	0.9092664
A07	22560261	22563658	A07p35370.2_BraZ1	1832.55	+	634	2200	3397	0.6476303
A07	22564143	22565172	A07p35380.2_BraZ1	753.35	-	330	1029	1029	1.0000000
A07	22566941	22567604	A07p35390.2_BraZ1	573	-	104	642	663	0.9683258
A07	22568670	22569434	A07p35400.2_BraZ1	2027.25	-	651	764	764	1.0000000
A07	22570985	22572044	A07p35410.2_BraZ1	105.9	-	266	1059	1059	1.0000000
A07	22573378	22575255	A07p35420.2_BraZ1	1068.26	+	338	1560	1877	0.8311135
A07	22576297	22577065	A07p35430.2_BraZ1	76.8	-	208	722	768	0.9401042
A07	22588150	22591063	A07p35440.2_BraZ1	2838	+	343	2452	2913	0.8417439
A07	22594519	22594880	A07p35450.2_BraZ1	35.4	-	345	361	361	1.0000000
A07	22596307	22596661	A07p35460.2_BraZ1	35.4	-	387	354	354	1.0000000
A07	22598059	22598420	A07p35470.2_BraZ1	33.3	-	2	158	361	0.4376731
A07	22599822	22600186	A07p35480.2_BraZ1	35.4	-	74	314	364	0.8626373
A07	22601593	22601944	A07p35490.2_BraZ1	33.3	-	71	351	351	1.0000000
A07	22603344	22603708	A07p35500.2_BraZ1	35.4	-	351	364	364	1.0000000
A07	22605053	22605407	A07p35510.2_BraZ1	35.4	-	1244	354	354	1.0000000
A07	22606812	22607176	A07p35520.2_BraZ1	35.4	-	226	364	364	1.0000000
A07	22610305	22610659	A07p35530.2_BraZ1	35.4	-	72	354	354	1.0000000
A07	22612040	22612404	A07p35540.2_BraZ1	35.4	-	474	364	364	1.0000000
A07	22614620	22617578	A07p35550.2_BraZ1	1981.43	-	264	2238	2958	0.7565923
A07	22619568	22622705	A07p35560.2_BraZ1	2140.24	+	180	2041	3137	0.6506216
A07	22623538	22624473	A07p35570.2_BraZ1	840	+	88	455	935	0.4866310
A07	22629916	22630330	A07p35580.2_BraZ1	41.4	-	23	10	414	0.0241546
A07	22630841	22632872	A07p35590.2_BraZ1	1413.62	-	673	1957	2031	0.9635648
A07	22634237	22636287	A07p35600.2_BraZ1	1482.39	-	634	2029	2050	0.9897561
A07	22637176	22639139	A07p35610.2_BraZ1	757.484	-	778	1814	1963	0.9240957
A07	22642999	22643999	A07p35620.2_BraZ1	982.5	-	37	627	1000	0.6270000
A07	22643995	22644442	A07p35630.2_BraZ1	246	-	5	258	447	0.5771812
A07	22644988	22647545	A07p35640.2_BraZ1	1234.04	-	2359	2460	2557	0.9620649
A07	22649412	22652334	A07p35650.2_BraZ1	1948.96	+	799	2027	2922	0.6937029
A07	22654043	22655125	A07p35660.2_BraZ1	605	+	341	984	1082	0.9094270
A07	22657381	22659092	A07p35670.2_BraZ1	74.4	+	1531	1711	1711	1.0000000
A07	22676950	22677052	A07p35680.2_BraZ1	10.2	-	20	102	102	1.0000000
A07	22677270	22677732	A07p35690.2_BraZ1	46.2	-	17	268	462	0.5800866
A07	22679312	22680277	A07p35700.2_BraZ1	51.9	-	387	891	965	0.9233161
A07	22683152	22683383	A07p35710.2_BraZ1	23.1	+	30	231	231	1.0000000
A07	22683967	22684736	A07p35720.2_BraZ1	372	-	1	38	769	0.0494148
A07	22688669	22689669	A07p35730.2_BraZ1	299.25	+	525	977	1000	0.9770000
A07	22689669	22690248	A07p35740.2_BraZ1	333.25	+	21	333	579	0.5751295
A07	22691619	22693806	A07p35750.2_BraZ1	1306.25	+	726	2159	2187	0.9871971
A07	22694101	22695959	A07p35760.2_BraZ1	1136.57	-	1439	1858	1858	1.0000000
A07	22701285	22702555	A07p35770.2_BraZ1	782.062	+	170	1215	1270	0.9566929
A07	22707039	22707615	A07p35780.2_BraZ1	267	-	751	576	576	1.0000000
A07	22712959	22714337	A07p35790.2_BraZ1	672	-	424	1102	1378	0.7997097
A07	22716863	22718105	A07p35800.2_BraZ1	124.2	-	506	1242	1242	1.0000000
A07	22718439	22721100	A07p35810.2_BraZ1	1078.26	+	1780	2484	2661	0.9334837
A07	22721372	22723412	A07p35820.2_BraZ1	1028.35	-	745	2020	2040	0.9901960
A07	22726418	22727570	A07p35830.2_BraZ1	8823	-	1253	1152	1152	1.0000000
A07	22738507	22739755	A07p35840.2_BraZ1	1062	+	454	1248	1248	1.0000000
A07	22742449	22743558	A07p35850.2_BraZ1	4603.5	-	595	1109	1109	1.0000000
A07	22746048	22747665	A07p35860.2_BraZ1	888.477	-	587	1345	1617	0.8317873
A07	22748246	22750472	A07p35870.2_BraZ1	998.636	-	1140	2206	2226	0.9910153
A07	22769008	22769386	A07p35880.2_BraZ1	288	-	534	378	378	1.0000000
A07	22775950	22782676	A07p35890.2_BraZ1	2054.44	+	3587	6445	6726	0.9582219
A07	22794209	22797596	A07p35900.2_BraZ1	1326	+	915	2485	3387	0.7336876
A07	22798094	22803612	A07p35910.2_BraZ1	857.769	-	435	3071	5518	0.5565422
A07	22802405	22803612	A07p35920.2_BraZ1	813	-	24	577	1207	0.4780447
A07	22805245	22811811	A07p35930.2_BraZ1	3464.13	+	2694	6210	6566	0.9457813
A07	22812464	22813622	A07p35940.2_BraZ1	592.615	+	287	931	1158	0.8039724
A07	22814155	22816107	A07p35950.2_BraZ1	983.1	+	726	1750	1952	0.8965164
A07	22819021	22824365	A07p35960.2_BraZ1	1754.35	+	1879	5097	5344	0.9537799
A07	22824758	22825118	A07p35970.2_BraZ1	34.8	-	11	360	360	1.0000000
A07	22830698	22832864	A07p35980.2_BraZ1	1188.92	+	1691	2166	2166	1.0000000
A07	22851522	22852543	A07p35990.2_BraZ1	4725	-	471	1021	1021	1.0000000
A07	22854002	22854437	A07p36000.2_BraZ1	38.4	+	104	381	435	0.8758621
A07	22857489	22860218	A07p36010.2_BraZ1	2064	-	432	1851	2729	0.6782704
A07	22861433	22866834	A07p36020.2_BraZ1	996.667	-	2593	5240	5401	0.9701907
A07	22866935	22867226	A07p36030.2_BraZ1	29.1	+	73	196	291	0.6735395
A07	22867906	22868201	A07p36040.2_BraZ1	213	-	381	293	295	0.9932203
A07	22869383	22872776	A07p36050.2_BraZ1	1740.38	+	641	2893	3393	0.8526378
A07	22873705	22874017	A07p36060.2_BraZ1	31.2	-	10	312	312	1.0000000
A07	22876491	22880320	A07p36070.2_BraZ1	339	+	2077	3812	3829	0.9955602
A07	22884313	22887282	A07p36080.2_BraZ1	2496	+	817	2504	2969	0.8433816
A07	22888705	22889188	A07p36090.2_BraZ1	48.3	+	72	339	483	0.7018633
A07	22889694	22896212	A07p36100.2_BraZ1	2796.5	-	4609	6123	6518	0.9393986
A07	22897072	22897613	A07p36110.2_BraZ1	39	-	726	541	541	1.0000000
A07	22897634	22898465	A07p36120.2_BraZ1	63.3	-	1073	831	831	1.0000000
A07	22904741	22905317	A07p36130.2_BraZ1	57.6	+	489	555	576	0.9635417
A07	22907383	22907739	A07p36140.2_BraZ1	267	+	324	356	356	1.0000000
A07	22910136	22913684	A07p36150.2_BraZ1	1985.65	+	498	3234	3548	0.9114994
A07	22915652	22916354	A07p36160.2_BraZ1	70.2	+	468	702	702	1.0000000
A07	22916577	22919369	A07p36170.2_BraZ1	2147.25	-	986	2633	2792	0.9430516
A07	22922548	22923325	A07p36180.2_BraZ1	77.7	+	341	777	777	1.0000000
A07	22924112	22939865	A07p36190.2_BraZ1	6382.39	-	5989	15428	15753	0.9793690
A07	22940283	22941675	A07p36200.2_BraZ1	1038	+	691	1371	1392	0.9849138
A07	22942493	22943753	A07p36210.2_BraZ1	126	+	76	951	1260	0.7547619
A07	22948972	22949693	A07p36220.2_BraZ1	342	-	113	721	721	1.0000000
A07	22951769	22956026	A07p36230.2_BraZ1	3097.95	-	1230	4123	4257	0.9685224
A07	22960488	22961721	A07p36240.2_BraZ1	426	-	954	1233	1233	1.0000000
A07	22966476	22967526	A07p36250.2_BraZ1	105	-	1018	1050	1050	1.0000000
A07	22975239	22976402	A07p36260.2_BraZ1	273	-	381	937	1163	0.8056750
A07	22980011	22983372	A07p36270.2_BraZ1	1315.88	-	2719	3175	3361	0.9446594
A07	22984574	22986507	A07p36280.2_BraZ1	964.663	-	540	1651	1933	0.8541128
A07	22987431	22989446	A07p36290.2_BraZ1	16929	-	237	1742	2015	0.8645161
A07	22991671	22994290	A07p36300.2_BraZ1	1370	-	524	2065	2619	0.7884689
A07	22994977	22995623	A07p36310.2_BraZ1	53.1	+	0	0	646	0.0000000
A07	23001468	23010364	A07p36320.2_BraZ1	2517.07	-	6255	8896	8896	1.0000000
A07	23013767	23015751	A07p36330.2_BraZ1	478	-	37	632	1984	0.3185484
A07	23031954	23034725	A07p36340.2_BraZ1	926.444	+	6	247	2771	0.0891375
A07	23037115	23038406	A07p36350.2_BraZ1	1119	+	181	1189	1291	0.9209915
A07	23047041	23047781	A07p36360.2_BraZ1	282	+	618	717	740	0.9689189
A07	23048574	23052881	A07p36370.2_BraZ1	1236.65	-	1083	3905	4307	0.9066636
A07	23055204	23060453	A07p36380.2_BraZ1	2429.72	+	1568	4373	5249	0.8331110
A07	23061201	23061513	A07p36390.2_BraZ1	31.2	+	217	296	312	0.9487180
A07	23064260	23065473	A07p36400.2_BraZ1	614.856	+	727	1196	1213	0.9859852
A07	23065892	23067702	A07p36410.2_BraZ1	1366.88	-	777	1762	1810	0.9734806
A07	23074684	23076364	A07p36420.2_BraZ1	5142.5	+	223	1124	1680	0.6690476
A07	23077431	23078441	A07p36430.2_BraZ1	780	-	370	988	1010	0.9782178
A07	23079097	23081850	A07p36440.2_BraZ1	2148	-	278	2147	2753	0.7798765
A07	23085830	23086607	A07p36450.2_BraZ1	77.7	-	248	777	777	1.0000000
A07	23088400	23088799	A07p36460.2_BraZ1	39.9	+	223	399	399	1.0000000
A07	23088837	23088996	A07p36470.2_BraZ1	15.9	+	41	159	159	1.0000000
A07	23089148	23090429	A07p36480.2_BraZ1	28203.8	-	150	996	1281	0.7775176
A07	23091376	23092915	A07p36490.2_BraZ1	116.7	+	623	1252	1539	0.8135152
A07	23095785	23096562	A07p36500.2_BraZ1	77.7	-	58	483	777	0.6216216
A07	23098474	23100475	A07p36510.2_BraZ1	2174.67	+	1186	2001	2001	1.0000000
A07	23101843	23104811	A07p36520.2_BraZ1	2023.5	-	534	1932	2968	0.6509434
A07	23106699	23108002	A07p36530.2_BraZ1	1068	-	184	922	1303	0.7075979
A07	23112333	23113340	A07p36540.2_BraZ1	509.856	-	222	1007	1007	1.0000000
A07	23116704	23117971	A07p36550.2_BraZ1	628.421	+	604	1264	1267	0.9976322
A07	23118617	23119662	A07p36560.2_BraZ1	867	+	133	933	1045	0.8928230
A07	23124927	23126003	A07p36570.2_BraZ1	963	+	89	703	1076	0.6533457
A07	23128731	23129670	A07p36580.2_BraZ1	93.9	+	198	887	939	0.9446219
A07	23130147	23130333	A07p36590.2_BraZ1	18.6	+	28	151	186	0.8118280
A07	23130597	23133265	A07p36600.2_BraZ1	1632.52	-	1809	2439	2668	0.9141679
A07	23135024	23141260	A07p36610.2_BraZ1	1568.55	+	4232	6051	6236	0.9703336
A07	23142268	23144154	A07p36620.2_BraZ1	1436.86	-	1124	1880	1886	0.9968187
A07	23154754	23156945	A07p36630.2_BraZ1	1172.14	+	131	1651	2191	0.7535372
A07	23157437	23159792	A07p36640.2_BraZ1	2050.78	-	436	2138	2355	0.9078556
A07	23160278	23160609	A07p36650.2_BraZ1	267	-	291	331	331	1.0000000
A07	23161199	23162087	A07p36660.2_BraZ1	306	-	480	856	888	0.9639640
A07	23162538	23166534	A07p36670.2_BraZ1	2039.44	-	1250	3679	3996	0.9206707
A07	23171322	23172416	A07p36680.2_BraZ1	800.1	+	353	1094	1094	1.0000000
A07	23173987	23175816	A07p36690.2_BraZ1	957	+	1218	1782	1829	0.9743029
A07	23179278	23180482	A07p36700.2_BraZ1	1404	-	14	628	1204	0.5215947
A07	23180726	23181314	A07p36710.2_BraZ1	58.8	-	92	588	588	1.0000000
A07	23182425	23182746	A07p36720.2_BraZ1	32.1	+	2	89	321	0.2772586
A07	23182866	23183779	A07p36730.2_BraZ1	395.846	+	2	162	913	0.1774370
A07	23185500	23187404	A07p36740.2_BraZ1	1606.92	+	714	1845	1904	0.9690126
A07	23194421	23195911	A07p36750.2_BraZ1	345	+	294	1338	1490	0.8979866
A07	23201866	23204074	A07p36760.2_BraZ1	1517.48	+	593	2162	2208	0.9791667
A07	23206217	23206567	A07p36770.2_BraZ1	20.4	+	0	0	350	0.0000000
A07	23210262	23210859	A07p36780.2_BraZ1	59.7	-	883	597	597	1.0000000
A07	23218653	23221571	A07p36790.2_BraZ1	2757	+	569	2257	2918	0.7734750
A07	23223802	23226346	A07p36800.2_BraZ1	1772.73	-	1119	2200	2544	0.8647799
A07	23227307	23229591	A07p36810.2_BraZ1	1230.26	-	1120	2284	2284	1.0000000
A07	23242487	23243297	A07p36820.2_BraZ1	81	+	128	418	810	0.5160494
A07	23245032	23246232	A07p36830.2_BraZ1	120	-	1340	1200	1200	1.0000000
A07	23247214	23249093	A07p36840.2_BraZ1	1127.27	-	137	1464	1879	0.7791378
A07	23252353	23253272	A07p36850.2_BraZ1	501	-	58	468	919	0.5092492
A07	23253415	23253830	A07p36860.2_BraZ1	393	-	71	415	415	1.0000000
A07	23254278	23254530	A07p36870.2_BraZ1	25.2	-	38	240	252	0.9523810
A07	23256456	23257454	A07p36880.2_BraZ1	597	-	150	931	998	0.9328657
A07	23258547	23258754	A07p36890.2_BraZ1	20.7	+	393	207	207	1.0000000
A07	23259140	23262415	A07p36900.2_BraZ1	2442.6	-	1902	3243	3275	0.9902290
A07	23263872	23273487	A07p36910.2_BraZ1	1485.2	+	4318	8392	9615	0.8728029
A07	23273641	23275024	A07p36920.2_BraZ1	432.065	-	373	1228	1383	0.8879248
A07	23275878	23277229	A07p36930.2_BraZ1	1161	-	361	1308	1351	0.9681717
A07	23278589	23291331	A07p36940.2_BraZ1	1455.49	+	6523	11756	12742	0.9226181
A07	23282586	23282913	A07p36950.2_BraZ1	32.7	-	268	327	327	1.0000000
A07	23291380	23292689	A07p36960.2_BraZ1	859.455	-	1212	1309	1309	1.0000000
A07	23294890	23297701	A07p36970.2_BraZ1	1060.14	+	375	1677	2811	0.5965849
A07	23301357	23301873	A07p36980.2_BraZ1	51.6	-	93	267	516	0.5174419
A07	23303519	23306236	A07p36990.2_BraZ1	1567.41	-	1039	2400	2717	0.8833272
A07	23307415	23308871	A07p37000.2_BraZ1	901.25	-	644	1456	1456	1.0000000
A07	23309633	23312010	A07p37010.2_BraZ1	1078	+	1857	2377	2377	1.0000000
A07	23312735	23313895	A07p37020.2_BraZ1	108.6	+	466	1160	1160	1.0000000
A07	23322369	23324350	A07p37030.2_BraZ1	1239	+	166	1328	1981	0.6703685
A07	23331501	23332488	A07p37040.2_BraZ1	98.7	-	679	987	987	1.0000000
A07	23337127	23338942	A07p37050.2_BraZ1	998.735	+	396	1515	1815	0.8347107
A07	23340476	23342152	A07p37060.2_BraZ1	812.727	-	695	1482	1676	0.8842482
A07	23343750	23345699	A07p37070.2_BraZ1	1283.33	+	527	1826	1949	0.9368907
A07	23346784	23348382	A07p37080.2_BraZ1	930	+	1217	1558	1598	0.9749687
A07	23351894	23355764	A07p37090.2_BraZ1	1247.57	+	2203	3780	3870	0.9767442
A07	23357740	23358637	A07p37100.2_BraZ1	588	+	191	815	897	0.9085842
A07	23359677	23360643	A07p37110.2_BraZ1	628.05	+	1141	966	966	1.0000000
A07	23361553	23363409	A07p37120.2_BraZ1	1476	-	665	1740	1856	0.9375000
A07	23363683	23364793	A07p37130.2_BraZ1	591.404	-	750	900	1110	0.8108108
A07	23367762	23369338	A07p37140.2_BraZ1	803.906	+	292	1264	1576	0.8020304
A07	23369565	23370315	A07p37150.2_BraZ1	440	-	698	750	750	1.0000000
A07	23370749	23371866	A07p37160.2_BraZ1	256.725	+	785	1117	1117	1.0000000
A07	23376895	23377910	A07p37170.2_BraZ1	840	+	453	730	1015	0.7192118
A07	23383096	23383885	A07p37180.2_BraZ1	78.9	+	616	717	789	0.9087452
A07	23386250	23386982	A07p37190.2_BraZ1	5589	-	239	732	732	1.0000000
A07	23394274	23394985	A07p37200.2_BraZ1	71.1	-	66	291	711	0.4092827
A07	23403580	23405655	A07p37210.2_BraZ1	1195.47	-	1786	1835	2075	0.8843374
A07	23407006	23408716	A07p37220.2_BraZ1	1299.27	-	871	1612	1710	0.9426901
A07	23412567	23416494	A07p37230.2_BraZ1	1245	-	1933	3433	3927	0.8742042
A07	23418352	23418577	A07p37240.2_BraZ1	22.5	-	452	225	225	1.0000000
A07	23420255	23421987	A07p37250.2_BraZ1	826.667	+	1031	1715	1732	0.9901848
A07	23424253	23428689	A07p37260.2_BraZ1	1484.68	+	1065	3630	4436	0.8183048
A07	23429490	23431040	A07p37270.2_BraZ1	697.687	+	1795	1550	1550	1.0000000
A07	23431252	23431681	A07p37280.2_BraZ1	42.9	-	282	429	429	1.0000000
A07	23437213	23438122	A07p37290.2_BraZ1	90.9	+	383	909	909	1.0000000
A07	23440399	23446950	A07p37300.2_BraZ1	1413	-	875	3718	6551	0.5675470
A07	23456684	23458419	A07p37310.2_BraZ1	638.514	-	520	1714	1735	0.9878963
A07	23470235	23471337	A07p37320.2_BraZ1	498	+	1008	1102	1102	1.0000000
A07	23482042	23482306	A07p37330.2_BraZ1	26.4	+	16	252	264	0.9545454
A07	23492495	23493409	A07p37340.2_BraZ1	714	+	112	789	914	0.8632385
A07	23494291	23496137	A07p37350.2_BraZ1	137.7	-	165	1388	1846	0.7518960
A07	23499327	23500571	A07p37360.2_BraZ1	934.839	+	126	673	1244	0.5409968
A07	23502315	23503230	A07p37370.2_BraZ1	91.5	-	736	915	915	1.0000000
A07	23503314	23503668	A07p37380.2_BraZ1	261	-	83	253	354	0.7146893
A07	23513128	23516885	A07p37390.2_BraZ1	2923.62	-	631	2686	3757	0.7149321
A07	23532811	23536028	A07p37400.2_BraZ1	1612.22	+	314	1495	3217	0.4647187
A07	23537517	23538469	A07p37410.2_BraZ1	744.682	+	324	906	952	0.9516807
A07	23540592	23543983	A07p37420.2_BraZ1	1616.34	+	886	2564	3391	0.7561191
A07	23544889	23545328	A07p37430.2_BraZ1	267	+	68	241	439	0.5489749
A07	23545487	23546134	A07p37440.2_BraZ1	561	-	26	497	647	0.7681608
A07	23546876	23548994	A07p37450.2_BraZ1	1018.33	-	417	2021	2118	0.9542021
A07	23549371	23549863	A07p37460.2_BraZ1	49.2	+	22	56	492	0.1138211
A07	23554731	23555501	A07p37470.2_BraZ1	486	+	193	770	770	1.0000000
A07	23555710	23558415	A07p37480.2_BraZ1	1269.17	-	1053	2649	2705	0.9792976
A07	23563066	23563475	A07p37490.2_BraZ1	186	-	802	409	409	1.0000000
A07	23566382	23567766	A07p37500.2_BraZ1	1042.11	+	748	1384	1384	1.0000000
A07	23572072	23576250	A07p37510.2_BraZ1	1948.5	+	2654	4154	4178	0.9942556
A07	23576507	23581371	A07p37520.2_BraZ1	3470.19	-	1455	4817	4864	0.9903372
A07	23590414	23591277	A07p37530.2_BraZ1	768	+	423	863	863	1.0000000
A07	23591448	23592160	A07p37540.2_BraZ1	474.286	-	365	712	712	1.0000000
A07	23593183	23596854	A07p37550.2_BraZ1	2083.31	-	612	3268	3671	0.8902206
A07	23611320	23611551	A07p37560.2_BraZ1	23.1	-	37	168	231	0.7272727
A07	23613057	23614722	A07p37570.2_BraZ1	1296	-	252	1286	1665	0.7723724
A07	23639335	23640912	A07p37580.2_BraZ1	1062	+	227	857	1577	0.5434369
A07	23643412	23644088	A07p37590.2_BraZ1	201	-	26	456	676	0.6745562
A07	23644251	23646064	A07p37600.2_BraZ1	775.286	-	369	1638	1813	0.9034749
A07	23652029	23654767	A07p37610.2_BraZ1	1174.14	+	2694	2738	2738	1.0000000
A07	23657718	23657877	A07p37620.2_BraZ1	15.9	+	5	83	159	0.5220126
A07	23660582	23663196	A07p37630.2_BraZ1	1586.72	-	2195	2610	2614	0.9984698
A07	23664760	23665012	A07p37640.2_BraZ1	25.2	-	354	252	252	1.0000000
A07	23666985	23668530	A07p37650.2_BraZ1	154.5	+	417	1295	1545	0.8381877
A07	23670186	23671565	A07p37660.2_BraZ1	930.462	-	599	1369	1379	0.9927484
A07	23676789	23677221	A07p37670.2_BraZ1	43.2	+	23	244	432	0.5648148
A07	23680272	23680443	A07p37680.2_BraZ1	17.1	-	340	171	171	1.0000000
A07	23682561	23683196	A07p37690.2_BraZ1	298.667	-	0	0	635	0.0000000
A07	23684374	23685502	A07p37700.2_BraZ1	112.8	-	227	1128	1128	1.0000000
A07	23689318	23690174	A07p37710.2_BraZ1	69.9	-	740	856	856	1.0000000
A07	23690174	23690533	A07p37720.2_BraZ1	261	-	761	359	359	1.0000000
A07	23694767	23695901	A07p37730.2_BraZ1	113.4	-	265	958	1134	0.8447972
A07	23702829	23703219	A07p37740.2_BraZ1	59.4828	-	201	390	390	1.0000000
A07	23703865	23706250	A07p37750.2_BraZ1	1331.93	-	714	2383	2385	0.9991614
A07	23727960	23730015	A07p37760.2_BraZ1	1294.01	+	1497	2055	2055	1.0000000
A07	23731086	23731607	A07p37770.2_BraZ1	471	+	350	521	521	1.0000000
A07	23732605	23734849	A07p37780.2_BraZ1	223.8	+	1494	2244	2244	1.0000000
A07	23735898	23739455	A07p37790.2_BraZ1	2362.45	-	851	2992	3557	0.8411583
A07	23741491	23742963	A07p37800.2_BraZ1	1119	+	784	1418	1472	0.9633152
A07	23744190	23749248	A07p37810.2_BraZ1	2679.75	-	2118	4972	5058	0.9829972
A07	23750632	23752291	A07p37820.2_BraZ1	945	+	652	1610	1659	0.9704641
A07	23752604	23755692	A07p37830.2_BraZ1	1828.71	-	1204	3078	3088	0.9967617
A07	23773314	23775772	A07p37840.2_BraZ1	918.294	+	302	1856	2458	0.7550854
A07	23778236	23778524	A07p37850.2_BraZ1	28.8	+	237	288	288	1.0000000
A07	23782823	23785008	A07p37860.2_BraZ1	25680	+	1158	2146	2185	0.9821510
A07	23785582	23786589	A07p37870.2_BraZ1	660	-	161	829	1007	0.8232374
A07	23791037	23795230	A07p37880.2_BraZ1	567	-	4302	4154	4193	0.9906988
A07	23802665	23803646	A07p37890.2_BraZ1	98.1	+	8	342	981	0.3486238
A07	23816138	23817035	A07p37900.2_BraZ1	89.7	+	780	897	897	1.0000000
A07	23817682	23819020	A07p37910.2_BraZ1	453.871	-	201	1073	1338	0.8019432
A07	23820852	23821149	A07p37920.2_BraZ1	150	+	1	38	297	0.1279461
A07	23832210	23834431	A07p37930.2_BraZ1	1672.63	+	819	2131	2221	0.9594777
A07	23834595	23840341	A07p37940.2_BraZ1	1866.29	-	1713	5189	5746	0.9030630
A07	23843637	23845619	A07p37950.2_BraZ1	1227.27	+	1082	1982	1982	1.0000000
A07	23848397	23849206	A07p37960.2_BraZ1	288	+	1211	809	809	1.0000000
A07	23853178	23854525	A07p37970.2_BraZ1	1685	+	801	1347	1347	1.0000000
A07	23854886	23856308	A07p37980.2_BraZ1	333	-	1462	1422	1422	1.0000000
A07	23855125	23856076	A07p37990.2_BraZ1	276	-	1021	951	951	1.0000000
A07	23859852	23860373	A07p38000.2_BraZ1	273	-	100	399	521	0.7658349
A07	23865005	23870710	A07p38010.2_BraZ1	1610.4	-	4006	5479	5705	0.9603856
A07	23873332	23874609	A07p38020.2_BraZ1	331.5	+	28	824	1277	0.6452624
A07	23875429	23877207	A07p38030.2_BraZ1	4867.5	-	358	1433	1778	0.8059617
A07	23884712	23892044	A07p38040.2_BraZ1	1892.88	+	3547	7182	7332	0.9795417
A07	23887285	23888020	A07p38050.2_BraZ1	73.5	-	227	735	735	1.0000000
A07	23892290	23894663	A07p38060.2_BraZ1	237.3	+	430	2225	2373	0.9376317
A07	23894916	23897606	A07p38070.2_BraZ1	2376.48	-	1039	2604	2690	0.9680297
A07	23906384	23907993	A07p38080.2_BraZ1	1040.87	+	694	1420	1609	0.8825358
A07	23908217	23910048	A07p38090.2_BraZ1	1074.6	-	1271	1831	1831	1.0000000
A07	23910512	23911688	A07p38100.2_BraZ1	666	+	685	1176	1176	1.0000000
A07	23913799	23914798	A07p38110.2_BraZ1	477	+	834	999	999	1.0000000
A07	23918835	23921713	A07p38120.2_BraZ1	1726.4	+	1930	2878	2878	1.0000000
A07	23922636	23925614	A07p38130.2_BraZ1	2135.8	-	918	2618	2978	0.8791135
A07	23926760	23927725	A07p38140.2_BraZ1	618.545	-	614	965	965	1.0000000
A07	23928328	23931603	A07p38150.2_BraZ1	2062.03	-	2275	3241	3275	0.9896183
A07	23932900	23933292	A07p38160.2_BraZ1	183	-	385	392	392	1.0000000
A07	23933499	23934522	A07p38170.2_BraZ1	102.3	-	479	978	1023	0.9560117
A07	23939954	23940933	A07p38180.2_BraZ1	833.325	+	112	687	979	0.7017365
A07	23941671	23944066	A07p38190.2_BraZ1	1531.64	+	533	1851	2395	0.7728601
A07	23946320	23947324	A07p38200.2_BraZ1	457.543	+	899	1004	1004	1.0000000
A07	23947892	23953990	A07p38210.2_BraZ1	2041.1	+	3702	6094	6098	0.9993441
A07	23960155	23961608	A07p38220.2_BraZ1	758.919	+	90	544	1453	0.3743978
A07	23969072	23970580	A07p38230.2_BraZ1	799.395	+	137	1068	1508	0.7082228
A07	23973497	23974762	A07p38240.2_BraZ1	761.1	+	1046	1139	1265	0.9003953
A07	23975070	23976824	A07p38250.2_BraZ1	257.5	+	1013	1691	1754	0.9640821
A07	23990340	23991280	A07p38260.2_BraZ1	753.553	+	180	880	940	0.9361702
A07	23994313	23996934	A07p38270.2_BraZ1	898.061	-	604	2431	2621	0.9275086
A07	24001256	24002432	A07p38280.2_BraZ1	960.25	+	463	1093	1176	0.9294218
A07	24004752	24006895	A07p38290.2_BraZ1	1180.76	+	1755	2143	2143	1.0000000
A07	24012570	24013827	A07p38300.2_BraZ1	1107	-	300	940	1257	0.7478123
A07	24016105	24016592	A07p38310.2_BraZ1	243	-	201	487	487	1.0000000
A07	24023777	24025284	A07p38320.2_BraZ1	818.357	+	55	844	1507	0.5600531
A07	24030405	24030765	A07p38330.2_BraZ1	36	+	231	360	360	1.0000000
A07	24033659	24034007	A07p38340.2_BraZ1	258	+	75	278	348	0.7988506
A07	24036640	24037049	A07p38350.2_BraZ1	249	+	572	409	409	1.0000000
A07	24039683	24039974	A07p38360.2_BraZ1	183	+	7	203	291	0.6975945
A07	24040980	24041736	A07p38370.2_BraZ1	75.6	+	33	481	756	0.6362434
A07	24049197	24050123	A07p38380.2_BraZ1	360.531	+	463	924	926	0.9978402
A07	24050722	24054640	A07p38390.2_BraZ1	2368.8	+	2653	3855	3918	0.9839204
A07	24055267	24057047	A07p38400.2_BraZ1	1257.6	-	1662	1705	1780	0.9578652
A07	24061592	24062920	A07p38410.2_BraZ1	783	-	374	1064	1328	0.8012048
A07	24064105	24065501	A07p38420.2_BraZ1	793.929	-	564	1327	1396	0.9505731
A07	24066299	24067527	A07p38430.2_BraZ1	581.318	+	762	1228	1228	1.0000000
A07	24082311	24083277	A07p38440.2_BraZ1	96.6	+	265	824	966	0.8530021
A07	24086182	24087578	A07p38450.2_BraZ1	544.817	+	344	910	1396	0.6518624
A07	24224154	24225648	A07p38460.2_BraZ1	836.483	+	422	937	1494	0.6271754
A07	24226424	24227905	A07p38470.2_BraZ1	811.886	+	1139	1481	1481	1.0000000
A07	24228035	24228841	A07p38480.2_BraZ1	500.333	-	914	806	806	1.0000000
A07	24229770	24230308	A07p38490.2_BraZ1	372	-	418	538	538	1.0000000
A07	24285611	24287778	A07p38500.2_BraZ1	1207.68	+	428	1798	2167	0.8297185
A07	24289128	24289523	A07p38510.2_BraZ1	276	+	541	395	395	1.0000000
A07	24291048	24291940	A07p38520.2_BraZ1	22680	+	218	890	892	0.9977579
A07	24293167	24293702	A07p38530.2_BraZ1	320.817	+	223	535	535	1.0000000
A07	24296618	24297584	A07p38540.2_BraZ1	234	-	1292	966	966	1.0000000
A07	24298470	24299013	A07p38550.2_BraZ1	54.3	-	81	433	543	0.7974218
A07	24314917	24315693	A07p38560.2_BraZ1	468	-	553	776	776	1.0000000
A07	24316667	24318079	A07p38570.2_BraZ1	766.962	+	137	751	1412	0.5318697
A07	24318822	24319435	A07p38580.2_BraZ1	39.3	+	2	19	613	0.0309951
A07	24320199	24320484	A07p38590.2_BraZ1	28.5	-	10	169	285	0.5929825
A07	24328815	24330676	A07p38600.2_BraZ1	1185	+	1131	1861	1861	1.0000000
A07	24339009	24339824	A07p38610.2_BraZ1	430.312	-	415	815	815	1.0000000
A07	24341588	24345893	A07p38620.2_BraZ1	1958.58	-	1587	3975	4305	0.9233450
A07	24352069	24356708	A07p38630.2_BraZ1	2454.45	-	3816	4504	4639	0.9708989
A07	24357800	24358949	A07p38640.2_BraZ1	864	-	386	1141	1149	0.9930374
A07	24362853	24366666	A07p38650.2_BraZ1	1230.51	-	715	3302	3813	0.8659848
A07	24379328	24381628	A07p38660.2_BraZ1	1603.43	+	413	1269	2300	0.5517392
A07	24385968	24391832	A07p38670.2_BraZ1	1919.51	+	525	3642	5864	0.6210778
A07	24395364	24396330	A07p38680.2_BraZ1	168	+	453	966	966	1.0000000
A07	24399475	24400964	A07p38690.2_BraZ1	576	-	261	1383	1489	0.9288113
A07	24410789	24412050	A07p38700.2_BraZ1	1158	-	244	987	1261	0.7827122
A07	24413590	24414019	A07p38710.2_BraZ1	300	+	30	272	429	0.6340326
A07	24415601	24416534	A07p38720.2_BraZ1	4122	-	180	795	933	0.8520901
A07	24417773	24418779	A07p38730.2_BraZ1	768	-	272	975	1006	0.9691849
A07	24422295	24423133	A07p38740.2_BraZ1	705	-	30	320	838	0.3818616
A07	24426882	24428239	A07p38750.2_BraZ1	467.28	-	812	1269	1357	0.9351510
A07	24428537	24430484	A07p38760.2_BraZ1	194.7	+	1004	1947	1947	1.0000000
A07	24430720	24432060	A07p38770.2_BraZ1	904.554	-	1459	1286	1340	0.9597015
A07	24436277	24436640	A07p38780.2_BraZ1	36.3	-	184	249	363	0.6859504
A07	24440297	24441337	A07p38790.2_BraZ1	484.316	-	999	1040	1040	1.0000000
A07	24441851	24443654	A07p38800.2_BraZ1	180.3	-	526	1622	1803	0.8996118
A07	24459775	24460475	A07p38810.2_BraZ1	618	+	41	98	700	0.1400000
A07	24461330	24462075	A07p38820.2_BraZ1	1278	+	0	0	745	0.0000000
A07	24462666	24463366	A07p38830.2_BraZ1	618	+	0	0	700	0.0000000
A07	24464220	24464965	A07p38840.2_BraZ1	958.5	+	1	148	745	0.1986577
A07	24467433	24472804	A07p38850.2_BraZ1	3255.05	+	2643	5064	5371	0.9428412
A07	24473110	24477309	A07p38860.2_BraZ1	3364.6	-	1247	3853	4199	0.9175994
A07	24478274	24479645	A07p38870.2_BraZ1	137.1	-	704	1355	1371	0.9883297
A07	24481920	24486919	A07p38880.2_BraZ1	1091.12	+	1598	4656	4999	0.9313863
A07	24487874	24488171	A07p38890.2_BraZ1	237	+	0	0	297	0.0000000
A07	24490409	24491561	A07p38900.2_BraZ1	115.2	+	30	281	1152	0.2439236
A07	24493357	24495447	A07p38910.2_BraZ1	1340.74	+	1281	2037	2090	0.9746411
A07	24497092	24499162	A07p38920.2_BraZ1	1992	-	1063	1861	2070	0.8990338
A07	24500155	24500805	A07p38930.2_BraZ1	564	+	211	644	650	0.9907692
A07	24501141	24503262	A07p38940.2_BraZ1	1953	-	892	2121	2121	1.0000000
A07	24504515	24506927	A07p38950.2_BraZ1	241.2	-	1419	2389	2412	0.9904643
A07	24507357	24512059	A07p38960.2_BraZ1	4503.26	+	39	1322	4702	0.2811570
A07	24512806	24513270	A07p38970.2_BraZ1	381	-	13	230	464	0.4956897
A07	24517881	24520358	A07p38980.2_BraZ1	1072.44	+	1552	2476	2477	0.9995963
A07	24521014	24523134	A07p38990.2_BraZ1	1436.4	+	761	2120	2120	1.0000000
A07	24523494	24525081	A07p39000.2_BraZ1	1437	-	1372	1587	1587	1.0000000
A07	24526470	24527607	A07p39010.2_BraZ1	113.7	+	280	1018	1137	0.8953386
A07	24538376	24540356	A07p39020.2_BraZ1	828	+	1174	1935	1980	0.9772727
A07	24548822	24550143	A07p39030.2_BraZ1	1242	+	391	1189	1321	0.9000757
A07	24553711	24555873	A07p39040.2_BraZ1	1060.32	-	527	2061	2162	0.9532840
A07	24559187	24561261	A07p39050.2_BraZ1	1193.14	-	1391	2056	2074	0.9913211
A07	24565337	24569596	A07p39060.2_BraZ1	1710.34	-	3338	3989	4259	0.9366049
A07	24654131	24657249	A07p39070.2_BraZ1	18635.4	-	664	2950	3118	0.9461193
A07	24665670	24666129	A07p39080.2_BraZ1	303	+	398	459	459	1.0000000
A07	24669069	24671129	A07p39090.2_BraZ1	1884	-	143	1361	2060	0.6606796
A07	24683187	24684052	A07p39100.2_BraZ1	403.2	+	65	101	865	0.1167630
A07	24685025	24686378	A07p39110.2_BraZ1	2240	-	681	1353	1353	1.0000000
A07	24686810	24691194	A07p39120.2_BraZ1	828.391	-	3191	4277	4384	0.9755931
A07	24693523	24694265	A07p39130.2_BraZ1	2610	-	510	742	742	1.0000000
A07	24695116	24695920	A07p39140.2_BraZ1	80.4	-	163	675	804	0.8395522
A07	24701311	24704535	A07p39150.2_BraZ1	1401.45	+	1177	3130	3224	0.9708437
A07	24705155	24706329	A07p39160.2_BraZ1	890.3	-	310	1113	1174	0.9480409
A07	24706600	24710847	A07p39170.2_BraZ1	1619.06	+	1069	3683	4247	0.8672004
A07	24711397	24711916	A07p39180.2_BraZ1	50.4	-	246	519	519	1.0000000
A07	24715596	24716029	A07p39190.2_BraZ1	222	+	257	433	433	1.0000000
A07	24716166	24717449	A07p39200.2_BraZ1	889.728	+	285	1262	1283	0.9836321
A07	24721484	24725914	A07p39210.2_BraZ1	2829.6	+	1811	3856	4430	0.8704289
A07	24727037	24729080	A07p39220.2_BraZ1	1316.25	-	151	1113	2043	0.5447870
A07	24730035	24737302	A07p39230.2_BraZ1	3790	-	6969	7229	7267	0.9947709
A07	24740067	24741459	A07p39240.2_BraZ1	139.2	-	610	1392	1392	1.0000000
A07	24743839	24745657	A07p39250.2_BraZ1	882.9	+	2137	1818	1818	1.0000000
A07	24746253	24753415	A07p39260.2_BraZ1	2847.74	-	2675	6649	7162	0.9283720
A07	24756027	24763270	A07p39270.2_BraZ1	1323.51	-	2868	4966	7243	0.6856275
A07	24761359	24761746	A07p39280.2_BraZ1	38.7	-	0	0	387	0.0000000
A07	24769004	24771362	A07p39290.2_BraZ1	1351.27	+	300	1917	2358	0.8129771
A07	24774353	24776900	A07p39300.2_BraZ1	949.974	+	122	1300	2547	0.5104044
A07	24780005	24782260	A07p39310.2_BraZ1	1243.56	+	332	2013	2255	0.8926829
A07	24783363	24783624	A07p39320.2_BraZ1	26.1	+	236	261	261	1.0000000
A07	24786460	24788066	A07p39330.2_BraZ1	957.72	+	494	1024	1606	0.6376089
A07	24789112	24789553	A07p39340.2_BraZ1	44.1	-	150	441	441	1.0000000
A07	24790150	24794799	A07p39350.2_BraZ1	1679.23	+	2238	4565	4649	0.9819316
A07	24796047	24796615	A07p39360.2_BraZ1	501	+	153	485	568	0.8538733
A07	24802911	24803205	A07p39370.2_BraZ1	29.4	-	19	255	294	0.8673469
A07	24804903	24807006	A07p39380.2_BraZ1	1330.52	+	402	1409	2103	0.6699952
A07	24809775	24811080	A07p39390.2_BraZ1	558	+	173	1260	1305	0.9655172
A07	24816342	24817610	A07p39400.2_BraZ1	4452	+	291	1177	1268	0.9282334
A07	24819646	24821698	A07p39410.2_BraZ1	744.524	+	1121	2052	2052	1.0000000
A07	24824714	24828466	A07p39420.2_BraZ1	1431.31	-	1446	3659	3752	0.9752132
A07	24834448	24836136	A07p39430.2_BraZ1	1584	-	177	1589	1688	0.9413507
A07	24841676	24842286	A07p39440.2_BraZ1	114	-	232	604	610	0.9901639
A07	24842324	24845042	A07p39450.2_BraZ1	13095	-	978	2646	2718	0.9735099
A07	24856204	24857091	A07p39460.2_BraZ1	328.3	+	134	612	887	0.6899662
A07	24858968	24861494	A07p39470.2_BraZ1	1665.79	+	482	2488	2526	0.9849564
A07	24865168	24865871	A07p39480.2_BraZ1	290.333	-	241	703	703	1.0000000
A07	24870586	24872219	A07p39490.2_BraZ1	583.364	+	800	1552	1633	0.9503980
A07	24874546	24875198	A07p39500.2_BraZ1	357	-	951	652	652	1.0000000
A07	24875748	24876611	A07p39510.2_BraZ1	488.423	+	172	805	863	0.9327926
A07	24877515	24880305	A07p39520.2_BraZ1	1690.49	+	1752	2790	2790	1.0000000
A07	24881165	24882173	A07p39530.2_BraZ1	100.8	-	46	368	1008	0.3650794
A07	24884669	24885543	A07p39540.2_BraZ1	752	-	591	874	874	1.0000000
A07	24886333	24887025	A07p39550.2_BraZ1	477	-	261	692	692	1.0000000
A07	24889783	24890451	A07p39560.2_BraZ1	225	-	120	600	668	0.8982036
A07	24889963	24890451	A07p39570.2_BraZ1	285	-	97	488	488	1.0000000
A07	24894630	24895351	A07p39580.2_BraZ1	483	-	75	667	721	0.9251040
A07	24897101	24897800	A07p39590.2_BraZ1	477	-	588	607	699	0.8683834
A07	24904422	24904707	A07p39600.2_BraZ1	28.5	+	371	285	285	1.0000000
A07	24908963	24909724	A07p39610.2_BraZ1	264	+	473	729	761	0.9579501
A07	24909768	24910893	A07p39620.2_BraZ1	659.83	+	1009	1070	1125	0.9511111
A07	24915974	24918156	A07p39630.2_BraZ1	460.976	+	490	1368	2182	0.6269478
A07	24927323	24930018	A07p39640.2_BraZ1	1920.31	+	596	2226	2695	0.8259740
A07	24935921	24938242	A07p39650.2_BraZ1	1358.82	+	417	2004	2321	0.8634210
A07	24939016	24939966	A07p39660.2_BraZ1	606	-	169	917	950	0.9652631
A07	24941975	24942383	A07p39670.2_BraZ1	39.6	-	40	124	408	0.3039216
A07	24944026	24944910	A07p39680.2_BraZ1	488.893	-	275	849	884	0.9604073
A07	24965449	24967934	A07p39690.2_BraZ1	666.545	-	3946	2485	2485	1.0000000
A07	24971744	24977752	A07p39700.2_BraZ1	4490.98	+	2654	5915	6008	0.9845206
A07	24978707	24979370	A07p39710.2_BraZ1	588	-	474	520	663	0.7843137
A07	24980580	24983403	A07p39720.2_BraZ1	1817.73	-	323	2341	2823	0.8292596
A07	24986275	24987132	A07p39730.2_BraZ1	609.469	-	482	857	857	1.0000000
A07	24988380	24988990	A07p39740.2_BraZ1	132.75	-	155	595	610	0.9754099
A07	24989422	24991976	A07p39750.2_BraZ1	1752	-	533	2098	2554	0.8214566
A07	24995775	24996488	A07p39760.2_BraZ1	453	-	407	713	713	1.0000000
A07	24999508	25001081	A07p39770.2_BraZ1	1114.4	-	444	1542	1573	0.9802924
A07	25001573	25003342	A07p39780.2_BraZ1	9633	-	844	1741	1769	0.9841719
A07	25006113	25007499	A07p39790.2_BraZ1	138	+	313	1201	1386	0.8665224
A07	25012265	25014859	A07p39800.2_BraZ1	1612.87	+	2244	2592	2594	0.9992290
A07	25015982	25016516	A07p39810.2_BraZ1	53.4	+	343	468	534	0.8764045
A07	25017769	25018045	A07p39820.2_BraZ1	27.6	+	107	94	276	0.3405797
A07	25018752	25020699	A07p39830.2_BraZ1	194.7	+	183	719	1947	0.3692861
A07	25025218	25029801	A07p39840.2_BraZ1	1695	+	1898	4291	4583	0.9362863
A07	25033030	25034319	A07p39850.2_BraZ1	699.075	-	1440	1179	1289	0.9146625
A07	25035678	25038276	A07p39860.2_BraZ1	259.8	-	264	1919	2598	0.7386451
A07	25038719	25048763	A07p39870.2_BraZ1	3769.72	+	3420	8099	10044	0.8063521
A07	25049134	25051334	A07p39880.2_BraZ1	1020.57	-	2013	2160	2200	0.9818182
A07	25052633	25056008	A07p39890.2_BraZ1	1354.37	+	795	2977	3375	0.8820741
A07	25056904	25062603	A07p39900.2_BraZ1	2751.36	+	2190	5382	5699	0.9443762
A07	25062881	25064292	A07p39910.2_BraZ1	688.571	-	234	1386	1411	0.9822820
A07	25064644	25070520	A07p39920.2_BraZ1	2073.46	+	1459	4743	5876	0.8071818
A07	25075213	25075932	A07p39930.2_BraZ1	360	-	0	0	719	0.0000000
A07	25078425	25080838	A07p39940.2_BraZ1	681.5	-	153	1622	2413	0.6721923
A07	25083178	25084953	A07p39950.2_BraZ1	867.857	-	690	1768	1775	0.9960563
A07	25085777	25089095	A07p39960.2_BraZ1	1297.37	-	888	2902	3318	0.8746232
A07	25090060	25092805	A07p39970.2_BraZ1	1634	-	759	2518	2745	0.9173042
A07	25096168	25097006	A07p39980.2_BraZ1	810	+	1338	838	838	1.0000000
A07	25097510	25099329	A07p39990.2_BraZ1	1689	-	841	1375	1819	0.7559099
A07	25101402	25103156	A07p40000.2_BraZ1	1374.17	-	175	1405	1754	0.8010262
A07	25107696	25115411	A07p40010.2_BraZ1	1764	+	2424	6325	7715	0.8198315
A07	25116656	25121259	A07p40020.2_BraZ1	2420.13	-	2722	4180	4603	0.9081034
A07	25121566	25123798	A07p40030.2_BraZ1	223.2	-	672	2073	2232	0.9287634
A07	25124811	25125342	A07p40040.2_BraZ1	53.1	+	115	522	531	0.9830508
A07	25125488	25128323	A07p40050.2_BraZ1	1541.8	-	1992	2835	2835	1.0000000
A07	25130396	25130948	A07p40060.2_BraZ1	55.2	+	71	552	552	1.0000000
A07	25131618	25133688	A07p40070.2_BraZ1	207	-	417	1885	2070	0.9106280
A07	25135570	25136592	A07p40080.2_BraZ1	582.065	+	583	1022	1022	1.0000000
A07	25137377	25139191	A07p40090.2_BraZ1	655.491	+	847	1521	1814	0.8384785
A07	25141568	25141988	A07p40100.2_BraZ1	42	+	241	411	420	0.9785714
A07	25143459	25146144	A07p40110.2_BraZ1	1895.08	+	650	2353	2685	0.8763501
A07	25147907	25149722	A07p40120.2_BraZ1	1172.81	+	686	1658	1815	0.9134986
A07	25150559	25151600	A07p40130.2_BraZ1	759	+	638	1041	1041	1.0000000
A07	25152249	25154480	A07p40140.2_BraZ1	1240.91	-	705	1915	2231	0.8583595
A07	25156305	25159214	A07p40150.2_BraZ1	608.571	-	268	2100	2909	0.7218975
A07	25170650	25172643	A07p40160.2_BraZ1	1041.65	+	554	1749	1993	0.8775715
A07	25175157	25176721	A07p40170.2_BraZ1	1001.34	+	1080	1414	1564	0.9040921
A07	25178921	25180151	A07p40180.2_BraZ1	897	+	201	779	1230	0.6333333
A07	25180456	25183516	A07p40190.2_BraZ1	1917.78	-	791	1788	3060	0.5843138
A07	25194143	25196263	A07p40200.2_BraZ1	1399.81	+	772	1994	2120	0.9405661
A07	25196539	25197001	A07p40210.2_BraZ1	46.2	-	323	462	462	1.0000000
A07	25197414	25197816	A07p40220.2_BraZ1	40.2	+	111	395	402	0.9825870
A07	25198089	25199112	A07p40230.2_BraZ1	567	-	588	733	1023	0.7165200
A07	25199553	25200485	A07p40240.2_BraZ1	1522.12	+	419	773	932	0.8293992
A07	25200695	25203289	A07p40250.2_BraZ1	1950.76	-	296	1878	2594	0.7239784
A07	25205786	25206517	A07p40260.2_BraZ1	6417	-	363	731	731	1.0000000
A07	25206816	25208552	A07p40270.2_BraZ1	739.531	+	516	1590	1736	0.9158986
A07	25209177	25210420	A07p40280.2_BraZ1	7438.5	-	816	1241	1243	0.9983910
A07	25212064	25217649	A07p40290.2_BraZ1	1583.82	-	2920	5444	5585	0.9747538
A07	25218561	25225209	A07p40300.2_BraZ1	1837.38	+	1297	5850	6648	0.8799639
A07	25227820	25231478	A07p40310.2_BraZ1	1822.76	+	1517	3605	3658	0.9855112
A07	25234782	25236637	A07p40320.2_BraZ1	808.266	+	1148	1757	1855	0.9471698
A07	25237945	25238316	A07p40330.2_BraZ1	255	+	233	319	371	0.8598382
A07	25238589	25238907	A07p40340.2_BraZ1	31.8	-	189	318	318	1.0000000
A07	25240169	25242138	A07p40350.2_BraZ1	1002.51	-	1415	1912	1969	0.9710513
A07	25243398	25244844	A07p40360.2_BraZ1	144.6	+	134	1151	1446	0.7959889
A07	25246290	25250709	A07p40370.2_BraZ1	1524	-	851	3155	4419	0.7139624
A07	25275751	25277805	A07p40380.2_BraZ1	1448.02	+	575	1336	2054	0.6504382
A07	25280657	25282695	A07p40390.2_BraZ1	1024.47	+	1630	2038	2038	1.0000000
A07	25284270	25285602	A07p40400.2_BraZ1	133.2	+	1278	1332	1332	1.0000000
A07	25287003	25290301	A07p40410.2_BraZ1	1111.32	+	2343	3242	3298	0.9830200
A07	25300046	25301571	A07p40420.2_BraZ1	945.4	+	60	472	1525	0.3095082
A07	25302725	25304120	A07p40430.2_BraZ1	780	+	326	1309	1395	0.9383513
A07	25304592	25305604	A07p40440.2_BraZ1	434.625	-	7	256	1012	0.2529644
A07	25311848	25312589	A07p40450.2_BraZ1	432	+	122	694	741	0.9365722
A07	25313022	25314411	A07p40460.2_BraZ1	526.371	-	276	566	1389	0.4074874
A07	25315618	25321149	A07p40470.2_BraZ1	1891.43	-	817	3820	5531	0.6906527
A07	25322972	25334129	A07p40480.2_BraZ1	648.375	+	6774	9414	11157	0.8437752
A07	25336356	25337956	A07p40490.2_BraZ1	1282.91	+	548	1589	1600	0.9931250
A07	25340120	25341596	A07p40500.2_BraZ1	1209	+	433	1412	1476	0.9566396
A07	25343127	25352217	A07p40510.2_BraZ1	1659.24	+	8216	8080	9090	0.8888889
A07	25348195	25348864	A07p40520.2_BraZ1	66.9	-	918	669	669	1.0000000
A07	25355409	25356480	A07p40530.2_BraZ1	107.1	+	430	1071	1071	1.0000000
A07	25356921	25357642	A07p40540.2_BraZ1	291	-	75	633	721	0.8779473
A07	25363979	25364379	A07p40550.2_BraZ1	300	+	44	275	400	0.6875000
A07	25365677	25368030	A07p40560.2_BraZ1	1689	-	1217	2223	2353	0.9447514
A07	25371456	25378185	A07p40570.2_BraZ1	680.308	-	3857	6729	6729	1.0000000
A07	25379583	25383254	A07p40580.2_BraZ1	1599.75	+	979	2603	3671	0.7090711
A07	25384002	25385885	A07p40590.2_BraZ1	1343.12	+	1097	1508	1883	0.8008497
A07	25390108	25392128	A07p40600.2_BraZ1	1643.15	+	604	1964	2020	0.9722772
A07	25395491	25396533	A07p40610.2_BraZ1	435	+	1203	1001	1042	0.9606526
A07	25397524	25399012	A07p40620.2_BraZ1	456.545	+	899	1475	1488	0.9912634
A07	25406064	25409189	A07p40630.2_BraZ1	2858.48	+	466	2237	3125	0.7158400
A07	25415462	25417681	A07p40640.2_BraZ1	9535.5	+	1269	1921	2219	0.8657053
A07	25420663	25422569	A07p40650.2_BraZ1	2004	-	711	1906	1906	1.0000000
A07	25423900	25425567	A07p40660.2_BraZ1	534	+	899	1411	1667	0.8464307
A07	25426904	25427315	A07p40670.2_BraZ1	41.1	+	75	327	411	0.7956204
A07	25430323	25435000	A07p40680.2_BraZ1	2954.11	+	2860	4677	4677	1.0000000
A07	25436075	25436714	A07p40690.2_BraZ1	63.9	+	351	639	639	1.0000000
A07	25437570	25439845	A07p40700.2_BraZ1	1048.89	-	1334	2267	2275	0.9964835
A07	25442042	25442714	A07p40710.2_BraZ1	67.2	+	1980	672	672	1.0000000
A07	25443637	25444279	A07p40720.2_BraZ1	64.2	+	159	445	642	0.6931464
A07	25449168	25449860	A07p40730.2_BraZ1	534	-	1218	692	692	1.0000000
A07	25454860	25456368	A07p40740.2_BraZ1	957	+	574	1466	1508	0.9721485
A07	25457437	25457599	A07p40750.2_BraZ1	16.2	+	29	162	162	1.0000000
A07	25458697	25459947	A07p40760.2_BraZ1	441	-	996	1192	1250	0.9536000
A07	25460331	25463595	A07p40770.2_BraZ1	326.4	-	1488	2924	3264	0.8958333
A07	25469027	25469936	A07p40780.2_BraZ1	90.9	+	389	909	909	1.0000000
A07	25470776	25471188	A07p40790.2_BraZ1	300	+	374	412	412	1.0000000
A07	25471446	25474659	A07p40800.2_BraZ1	1943.91	-	925	2891	3213	0.8997821
A07	25475770	25477322	A07p40810.2_BraZ1	960.45	+	1029	1531	1552	0.9864691
A07	25477986	25479976	A07p40820.2_BraZ1	1081.18	+	406	1695	1990	0.8517588
A07	25480893	25481529	A07p40830.2_BraZ1	63.6	-	208	623	636	0.9795597
A07	25483736	25484492	A07p40840.2_BraZ1	75.6	+	403	756	756	1.0000000
A07	25485667	25486972	A07p40850.2_BraZ1	919.48	-	653	1305	1305	1.0000000
A07	25487455	25493130	A07p40860.2_BraZ1	3788.1	+	1903	4172	5675	0.7351542
A07	25495695	25496652	A07p40870.2_BraZ1	477.9	-	1601	957	957	1.0000000
A07	25497700	25499464	A07p40880.2_BraZ1	629.886	-	1574	1764	1764	1.0000000
A07	25501811	25502168	A07p40890.2_BraZ1	35.7	-	284	357	357	1.0000000
A07	25505298	25510214	A07p40900.2_BraZ1	2389.43	-	2831	4861	4916	0.9888120
A07	25512211	25513700	A07p40910.2_BraZ1	733.333	-	741	1422	1489	0.9550034
A07	25517625	25522850	A07p40920.2_BraZ1	2157.31	-	2063	4916	5225	0.9408612
A07	25533808	25537382	A07p40930.2_BraZ1	1961.32	-	1416	3161	3574	0.8844432
A07	25543926	25544412	A07p40940.2_BraZ1	48.6	+	54	348	486	0.7160494
A07	25546697	25547524	A07p40950.2_BraZ1	4347.5	+	327	809	827	0.9782346
A07	25548393	25550089	A07p40960.2_BraZ1	1280.67	-	363	1150	1696	0.6780660
A07	25554313	25554604	A07p40970.2_BraZ1	207	-	186	291	291	1.0000000
A07	25554716	25558865	A07p40980.2_BraZ1	2775.6	-	2007	3718	4149	0.8961195
A07	25567332	25567731	A07p40990.2_BraZ1	39.9	+	403	399	399	1.0000000
A07	25568219	25569062	A07p41000.2_BraZ1	654	-	299	794	843	0.9418743
A07	25570731	25571070	A07p41010.2_BraZ1	33.9	+	267	339	339	1.0000000
A07	25571907	25573478	A07p41020.2_BraZ1	751.5	-	1149	1443	1571	0.9185233
A07	25575151	25577928	A07p41030.2_BraZ1	1259.04	+	1934	2777	2777	1.0000000
A07	25578578	25580714	A07p41040.2_BraZ1	1067.87	+	2184	2136	2136	1.0000000
A07	25581120	25582955	A07p41050.2_BraZ1	1166.12	-	976	1835	1835	1.0000000
A07	25585272	25586769	A07p41060.2_BraZ1	1005.98	-	679	1412	1497	0.9432198
A07	25596124	25600520	A07p41070.2_BraZ1	3418.07	+	2147	4342	4396	0.9877161
A07	25601783	25605624	A07p41080.2_BraZ1	1222.77	+	1551	3543	3841	0.9224160
A07	25607927	25611893	A07p41090.2_BraZ1	1527.71	-	1970	3786	3966	0.9546142
A07	25612806	25613382	A07p41100.2_BraZ1	57.6	+	189	566	576	0.9826389
A07	25617853	25621048	A07p41110.2_BraZ1	1680.27	-	619	2523	3195	0.7896714
A07	25625003	25626737	A07p41120.2_BraZ1	997.981	+	700	1731	1734	0.9982699
A07	25628497	25629850	A07p41130.2_BraZ1	135.3	+	562	1344	1353	0.9933481
A07	25632016	25633054	A07p41140.2_BraZ1	103.8	+	650	1038	1038	1.0000000
A07	25633960	25636149	A07p41150.2_BraZ1	774	-	985	2189	2189	1.0000000
A07	25639027	25641018	A07p41160.2_BraZ1	1025.18	-	2000	1991	1991	1.0000000
A07	25645889	25647360	A07p41170.2_BraZ1	12454.5	+	331	1155	1471	0.7851802
A07	25649768	25659854	A07p41180.2_BraZ1	2775.34	+	7142	9915	10086	0.9830458
A07	25661574	25662956	A07p41190.2_BraZ1	862.095	-	889	1382	1382	1.0000000
A07	25668097	25671338	A07p41200.2_BraZ1	1814.12	-	1042	3184	3241	0.9824128
A07	25672111	25672988	A07p41210.2_BraZ1	612	+	703	877	877	1.0000000
A07	25673551	25675365	A07p41220.2_BraZ1	23016	-	723	1686	1814	0.9294377
A07	25675794	25680213	A07p41230.2_BraZ1	2205	+	841	2487	4419	0.5627970
A07	25681570	25683598	A07p41240.2_BraZ1	202.8	+	579	1713	2028	0.8446745
A07	25683809	25686059	A07p41250.2_BraZ1	1214.61	-	2630	2248	2250	0.9991111
A07	25686820	25687253	A07p41260.2_BraZ1	333	-	449	433	433	1.0000000
A07	25689113	25689335	A07p41270.2_BraZ1	22.2	-	16	187	222	0.8423423
A07	25699469	25700520	A07p41280.2_BraZ1	798	+	231	844	1051	0.8030447
A07	25700779	25703470	A07p41290.2_BraZ1	1970.86	-	758	2525	2691	0.9383129
A07	25705334	25707165	A07p41300.2_BraZ1	724.5	-	1283	1771	1831	0.9672310
A07	25719182	25721228	A07p41310.2_BraZ1	1614	+	215	1361	2046	0.6652004
A07	25723242	25725456	A07p41320.2_BraZ1	1524	-	1845	2214	2214	1.0000000
A07	25726341	25727295	A07p41330.2_BraZ1	94.5	-	350	952	954	0.9979036
A07	25728071	25728816	A07p41340.2_BraZ1	69.9	-	446	745	745	1.0000000
A07	25731495	25732188	A07p41350.2_BraZ1	69.3	-	177	693	693	1.0000000
A07	25735433	25736075	A07p41360.2_BraZ1	64.2	-	1450	642	642	1.0000000
A07	25737567	25740750	A07p41370.2_BraZ1	963	-	3446	3183	3183	1.0000000
A07	25742884	25743529	A07p41380.2_BraZ1	64.5	-	761	645	645	1.0000000
A07	25745764	25749026	A07p41390.2_BraZ1	1063.27	-	1869	2688	3262	0.8240343
A07	25747680	25748199	A07p41400.2_BraZ1	51.9	+	2	74	519	0.1425819
A07	25752210	25759648	A07p41410.2_BraZ1	1040.77	-	2083	6284	7438	0.8448508
A07	25756191	25756706	A07p41420.2_BraZ1	900	-	205	506	515	0.9825243
A07	25756743	25758023	A07p41430.2_BraZ1	435	-	180	915	1280	0.7148438
A07	25760212	25760683	A07p41440.2_BraZ1	225	-	571	471	471	1.0000000
A07	25762134	25762824	A07p41450.2_BraZ1	69	-	272	450	690	0.6521739
A07	25764239	25766370	A07p41460.2_BraZ1	1330.29	+	799	2095	2131	0.9831065
A07	25766747	25768162	A07p41470.2_BraZ1	648.788	-	731	1354	1415	0.9568905
A07	25769809	25773113	A07p41480.2_BraZ1	1927.75	-	1310	2748	3304	0.8317191
A07	25775585	25779267	A07p41490.2_BraZ1	2488.73	-	1553	3419	3682	0.9285714
A07	25780566	25783328	A07p41500.2_BraZ1	1178.83	-	1704	2716	2762	0.9833454
A07	25789269	25789481	A07p41510.2_BraZ1	20.7	+	0	0	212	0.0000000
A07	25792414	25794052	A07p41520.2_BraZ1	163.8	+	563	1462	1638	0.8925519
A07	25796527	25797714	A07p41530.2_BraZ1	687	+	872	1187	1187	1.0000000
A07	25799257	25805399	A07p41540.2_BraZ1	1894.01	+	5644	6000	6142	0.9768805
A07	25806727	25811419	A07p41550.2_BraZ1	21870	+	2349	4603	4692	0.9810315
A07	25817286	25817448	A07p41560.2_BraZ1	16.2	+	695	162	162	1.0000000
A07	25820379	25823323	A07p41570.2_BraZ1	1170.32	+	338	1627	2944	0.5526494
A07	25823988	25824858	A07p41580.2_BraZ1	87	-	733	870	870	1.0000000
A07	25825898	25826132	A07p41590.2_BraZ1	23.4	-	221	234	234	1.0000000
A07	25826483	25827103	A07p41600.2_BraZ1	525	-	287	620	620	1.0000000
A07	25828251	25829137	A07p41610.2_BraZ1	3519	-	7	196	886	0.2212190
A07	25831180	25831951	A07p41620.2_BraZ1	441	-	245	771	771	1.0000000
A07	25834672	25837737	A07p41630.2_BraZ1	1430.32	+	474	2659	3065	0.8675367
A07	25840607	25840874	A07p41640.2_BraZ1	26.7	+	43	239	267	0.8951311
A07	25847565	25849066	A07p41650.2_BraZ1	991.667	+	359	1452	1501	0.9673551
A07	25850423	25851470	A07p41660.2_BraZ1	795	+	295	1027	1047	0.9808978
A07	25852622	25853102	A07p41670.2_BraZ1	48	+	100	457	480	0.9520833
A07	25855285	25856780	A07p41680.2_BraZ1	702	+	218	1442	1495	0.9645485
A07	25857084	25864244	A07p41690.2_BraZ1	3019.19	-	3537	7074	7160	0.9879888
A07	25868335	25871329	A07p41700.2_BraZ1	1725.36	-	856	2955	2994	0.9869739
A07	25874304	25874530	A07p41710.2_BraZ1	18.9	+	22	184	226	0.8141593
A07	25878745	25880545	A07p41720.2_BraZ1	1106.02	+	968	1714	1800	0.9522222
A07	25881303	25885289	A07p41730.2_BraZ1	1129.07	-	2719	3986	3986	1.0000000
A07	25887825	25890806	A07p41740.2_BraZ1	1305.96	-	1005	2898	2981	0.9721570
A07	25892032	25894951	A07p41750.2_BraZ1	291.9	+	1187	2893	2919	0.9910929
A07	25895615	25899318	A07p41760.2_BraZ1	1490.4	+	2125	3534	3703	0.9543613
A07	25900022	25902032	A07p41770.2_BraZ1	1764	-	624	1693	2010	0.8422886
A07	25904386	25905958	A07p41780.2_BraZ1	1299	+	232	1244	1572	0.7913486
A07	25906901	25909252	A07p41790.2_BraZ1	1030.4	+	980	2179	2351	0.9268396
A07	25909750	25911633	A07p41800.2_BraZ1	1010.07	-	1009	1873	1883	0.9946893
A07	25913720	25914014	A07p41810.2_BraZ1	29.4	+	187	294	294	1.0000000
A07	25915214	25915424	A07p41820.2_BraZ1	21	+	120	193	210	0.9190476
A07	25915843	25919451	A07p41830.2_BraZ1	1301.68	-	1064	3078	3608	0.8531042
A07	25925354	25927631	A07p41840.2_BraZ1	1230	-	620	1927	2277	0.8462890
A07	25928705	25929101	A07p41850.2_BraZ1	276	-	192	396	396	1.0000000
A07	25930222	25931978	A07p41860.2_BraZ1	7910.25	+	797	1423	1756	0.8103645
A07	25934393	25935705	A07p41870.2_BraZ1	774.655	+	208	1103	1312	0.8407012
A07	25941096	25943000	A07p41880.2_BraZ1	863.571	-	1385	1875	1904	0.9847689
A07	25946680	25950106	A07p41890.2_BraZ1	1720.91	+	633	2649	3426	0.7732049
A07	25950733	25955567	A07p41900.2_BraZ1	2884.16	-	2430	4552	4834	0.9416632
A07	25957194	25960373	A07p41910.2_BraZ1	1167.56	+	2398	2681	3179	0.8433470
A07	25960883	25961637	A07p41920.2_BraZ1	562.917	-	860	719	754	0.9535809
A07	25962550	25962706	A07p41930.2_BraZ1	15.6	+	50	156	156	1.0000000
A07	25963393	25966514	A07p41940.2_BraZ1	1820	+	2045	3103	3121	0.9942326
A07	25967130	25967760	A07p41950.2_BraZ1	480	-	314	630	630	1.0000000
A07	25968758	25972065	A07p41960.2_BraZ1	1309.5	-	1527	3115	3307	0.9419413
A07	25973303	25981850	A07p41970.2_BraZ1	3894.35	-	1815	7504	8547	0.8779689
A07	25989501	25989819	A07p41980.2_BraZ1	31.8	+	134	312	318	0.9811321
A07	25991509	26006964	A07p41990.2_BraZ1	3272.66	+	5706	13105	15455	0.8479456
A07	25994884	25996750	A07p42000.2_BraZ1	186.6	+	228	764	1866	0.4094319
A07	26007149	26007827	A07p42010.2_BraZ1	67.8	+	86	614	678	0.9056047
A07	26008197	26009359	A07p42020.2_BraZ1	935.053	-	513	1082	1162	0.9311532
A07	26011120	26012751	A07p42030.2_BraZ1	351	-	0	0	1631	0.0000000
A07	26013502	26015419	A07p42040.2_BraZ1	1200	-	315	1464	1917	0.7636933
A07	26016465	26017900	A07p42050.2_BraZ1	1962	-	171	1144	1435	0.7972125
A07	26021754	26024226	A07p42060.2_BraZ1	1235.32	-	688	2379	2472	0.9623786
A07	26026007	26026445	A07p42070.2_BraZ1	43.8	+	426	438	438	1.0000000
A07	26026796	26027918	A07p42080.2_BraZ1	677.793	-	576	1122	1122	1.0000000
A07	26029840	26031443	A07p42090.2_BraZ1	1156.2	+	362	773	1603	0.4822208
A07	26038694	26039729	A07p42100.2_BraZ1	103.5	+	704	1035	1035	1.0000000
A07	26040824	26041680	A07p42110.2_BraZ1	1134	-	2	84	856	0.0981308
A07	26048072	26049155	A07p42120.2_BraZ1	104.1	+	636	1083	1083	1.0000000
A07	26049375	26050392	A07p42130.2_BraZ1	101.7	-	210	1000	1017	0.9832842
A07	26051902	26053638	A07p42140.2_BraZ1	1593	-	275	1470	1736	0.8467742
A07	26059575	26060877	A07p42150.2_BraZ1	130.2	-	591	1198	1302	0.9201229
A07	26062089	26071605	A07p42160.2_BraZ1	1934.22	+	4893	8798	9516	0.9245481
A07	26072338	26075996	A07p42170.2_BraZ1	2049	-	1307	3144	3658	0.8594860
A07	26074752	26077262	A07p42180.2_BraZ1	349.929	-	485	1705	2510	0.6792828
A07	26086132	26087005	A07p42190.2_BraZ1	87.3	-	682	814	873	0.9324170
A07	26089709	26093191	A07p42200.2_BraZ1	2302.29	-	1725	2819	3482	0.8095922
A07	26094255	26094899	A07p42210.2_BraZ1	195	+	49	488	644	0.7577640
A07	26096483	26104288	A07p42220.2_BraZ1	1074.88	-	3335	7421	7805	0.9508008
A07	26101374	26103091	A07p42230.2_BraZ1	1148.23	+	1422	1717	1717	1.0000000
A07	26105432	26106819	A07p42240.2_BraZ1	876	+	1287	1387	1387	1.0000000
A07	26107415	26109621	A07p42250.2_BraZ1	1305.56	+	1447	2206	2206	1.0000000
A07	26110426	26116837	A07p42260.2_BraZ1	2435.61	-	1902	5563	6411	0.8677273
A07	26117194	26118411	A07p42270.2_BraZ1	1092	+	241	1180	1217	0.9695974
A07	26118698	26121987	A07p42280.2_BraZ1	46968	-	792	3049	3289	0.9270295
A07	26122839	26124407	A07p42290.2_BraZ1	941.182	+	341	1218	1568	0.7767857
A07	26124825	26128698	A07p42300.2_BraZ1	1596.03	-	1433	3683	3873	0.9509424
A07	26130134	26130509	A07p42310.2_BraZ1	243	-	68	364	375	0.9706666
A07	26130824	26133212	A07p42320.2_BraZ1	238.8	-	456	2332	2388	0.9765494
A07	26135840	26139980	A07p42330.2_BraZ1	2526.75	+	590	3197	4140	0.7722222
A07	26140604	26140940	A07p42340.2_BraZ1	243	+	24	61	336	0.1815476
A07	26147205	26148386	A07p42350.2_BraZ1	726	-	652	1181	1181	1.0000000
A07	26148829	26150200	A07p42360.2_BraZ1	137.1	+	344	1353	1371	0.9868709
A07	26150627	26152442	A07p42370.2_BraZ1	1260	-	1033	1815	1815	1.0000000
A07	26153496	26155135	A07p42380.2_BraZ1	655.2	+	1164	1639	1639	1.0000000
A07	26163083	26165036	A07p42390.2_BraZ1	623.25	+	482	1610	1953	0.8243728
A07	26167721	26169417	A07p42400.2_BraZ1	820.904	+	946	1692	1696	0.9976415
A07	26174253	26175495	A07p42410.2_BraZ1	586.182	-	962	1090	1242	0.8776168
A07	26178668	26183266	A07p42420.2_BraZ1	402	+	2952	4074	4598	0.8860374
A07	26184574	26186564	A07p42430.2_BraZ1	1384.32	+	625	1953	1990	0.9814070
A07	26186663	26187754	A07p42440.2_BraZ1	799.783	-	240	1061	1091	0.9725023
A07	26191708	26191870	A07p42450.2_BraZ1	16.2	-	22	162	162	1.0000000
A07	26194609	26194991	A07p42460.2_BraZ1	273	-	135	382	382	1.0000000
A07	26201936	26203199	A07p42470.2_BraZ1	126.3	+	715	1263	1263	1.0000000
A07	26203429	26203828	A07p42480.2_BraZ1	104.211	-	429	399	399	1.0000000
A07	26204124	26207176	A07p42490.2_BraZ1	521.326	-	2690	3052	3052	1.0000000
A07	26207985	26210277	A07p42500.2_BraZ1	229.2	+	704	2139	2292	0.9332461
A07	26210901	26211678	A07p42510.2_BraZ1	699	-	728	739	777	0.9510940
A07	26212203	26214900	A07p42520.2_BraZ1	269.7	-	945	2697	2697	1.0000000
A07	26226257	26227634	A07p42530.2_BraZ1	1002	+	18	276	1377	0.2004357
A07	26230816	26232554	A07p42540.2_BraZ1	150	+	1144	1688	1738	0.9712313
A07	26233076	26234902	A07p42550.2_BraZ1	312	-	465	1665	1826	0.9118291
A07	26473685	26474648	A07p42560.2_BraZ1	702	+	1272	963	963	1.0000000
A07	26477821	26481411	A07p42570.2_BraZ1	1534.09	+	2298	3557	3590	0.9908078
A07	26481975	26482672	A07p42580.2_BraZ1	588	+	50	541	697	0.7761837
A07	26483242	26485539	A07p42590.2_BraZ1	1520.66	-	396	1974	2297	0.8593818
A07	26489054	26491459	A07p42600.2_BraZ1	2235	+	342	2391	2405	0.9941788
A07	26492067	26497261	A07p42610.2_BraZ1	2330.42	-	3923	5112	5194	0.9842126
A07	26507611	26510357	A07p42620.2_BraZ1	1781.24	+	571	2198	2746	0.8004370
A07	26510892	26513922	A07p42630.2_BraZ1	1811.12	-	517	2286	3030	0.7544554
A07	26515888	26517670	A07p42640.2_BraZ1	16074	-	255	1576	1782	0.8843995
A07	26519081	26520076	A07p42650.2_BraZ1	732	-	305	985	995	0.9899498
A07	26521706	26524633	A07p42660.2_BraZ1	2362.12	-	496	2538	2927	0.8670994
A07	26525992	26530242	A07p42670.2_BraZ1	1262.1	+	1445	3473	4250	0.8171765
A07	26530574	26531381	A07p42680.2_BraZ1	383.42	-	844	807	807	1.0000000
A07	26531833	26532999	A07p42690.2_BraZ1	493.95	-	728	1166	1166	1.0000000
A07	26534547	26535951	A07p42700.2_BraZ1	140.4	+	279	1404	1404	1.0000000
A07	26536248	26538816	A07p42710.2_BraZ1	1136.57	-	1752	2523	2568	0.9824767
A07	26539724	26539976	A07p42720.2_BraZ1	174	-	509	252	252	1.0000000
A07	26542069	26542660	A07p42730.2_BraZ1	59.1	+	98	591	591	1.0000000
A07	26543251	26543425	A07p42740.2_BraZ1	17.4	+	3	147	174	0.8448276
A07	26557411	26558235	A07p42750.2_BraZ1	648	+	337	824	824	1.0000000
A07	26560998	26562147	A07p42760.2_BraZ1	2021.25	-	978	1149	1149	1.0000000
A07	26564351	26567628	A07p42770.2_BraZ1	1503.41	-	2815	3247	3277	0.9908453
A07	26570098	26570810	A07p42780.2_BraZ1	636	-	85	597	712	0.8384832
A07	26571804	26572203	A07p42790.2_BraZ1	39.6	-	34	399	399	1.0000000
A07	26576915	26577829	A07p42800.2_BraZ1	9108	+	220	914	914	1.0000000
A07	26578319	26582322	A07p42810.2_BraZ1	1747.89	-	1334	3804	4003	0.9502873
A07	26585452	26587661	A07p42820.2_BraZ1	872.667	+	1265	2110	2209	0.9551833
A07	26588377	26589212	A07p42830.2_BraZ1	1224	+	711	835	835	1.0000000
A07	26591123	26591970	A07p42840.2_BraZ1	741	+	585	847	847	1.0000000
A07	26592436	26594139	A07p42850.2_BraZ1	632.4	-	1332	1703	1703	1.0000000
A07	26596402	26597472	A07p42860.2_BraZ1	93.9	+	779	1070	1070	1.0000000
A07	26598013	26599584	A07p42870.2_BraZ1	867.682	-	1617	1571	1571	1.0000000
A07	26600932	26603866	A07p42880.2_BraZ1	1567.5	-	2140	2934	2934	1.0000000
A07	26604422	26606552	A07p42890.2_BraZ1	1373.43	-	1023	2060	2130	0.9671361
A07	26606780	26606966	A07p42900.2_BraZ1	18.6	-	157	186	186	1.0000000
A07	26607414	26611134	A07p42910.2_BraZ1	1915.67	-	2544	3694	3720	0.9930108
A07	26613929	26617828	A07p42920.2_BraZ1	857.227	+	1897	3793	3899	0.9728135
A07	26618289	26619909	A07p42930.2_BraZ1	942	-	1172	1620	1620	1.0000000
A07	26622209	26622605	A07p42940.2_BraZ1	39.6	+	266	396	396	1.0000000
A07	26623343	26626116	A07p42950.2_BraZ1	1849.2	-	981	2544	2773	0.9174179
A07	26626819	26630725	A07p42960.2_BraZ1	1612.9	+	2608	3906	3906	1.0000000
A07	26632892	26635913	A07p42970.2_BraZ1	1274.72	-	1292	2743	3021	0.9079775
A07	26643304	26644213	A07p42980.2_BraZ1	90.9	+	364	909	909	1.0000000
A07	26647712	26647991	A07p42990.2_BraZ1	27.9	-	27	159	279	0.5698925
A07	26658402	26660019	A07p43000.2_BraZ1	161.7	+	482	1310	1617	0.8101422
A07	26663338	26664802	A07p43010.2_BraZ1	927.662	+	533	1426	1464	0.9740437
A07	26665680	26667082	A07p43020.2_BraZ1	7402.5	+	859	1378	1402	0.9828816
A07	26675466	26676003	A07p43030.2_BraZ1	240	+	504	537	537	1.0000000
A07	26678328	26678643	A07p43040.2_BraZ1	252	-	525	315	315	1.0000000
A07	26686551	26691678	A07p43050.2_BraZ1	3711.17	+	2734	4959	5127	0.9672323
A07	26692199	26694037	A07p43060.2_BraZ1	1121.74	-	1120	1833	1838	0.9972796
A07	26694759	26695258	A07p43070.2_BraZ1	432	+	268	499	499	1.0000000
A07	26698031	26698721	A07p43080.2_BraZ1	69	+	651	690	690	1.0000000
A07	26699140	26699517	A07p43090.2_BraZ1	171	+	693	377	377	1.0000000
A07	26704419	26704739	A07p43100.2_BraZ1	168	+	0	0	320	0.0000000
A07	26713777	26714812	A07p43110.2_BraZ1	103.5	+	1112	1035	1035	1.0000000
A07	26721428	26723220	A07p43120.2_BraZ1	1489.68	+	1128	1746	1792	0.9743304
A07	26724122	26726205	A07p43130.2_BraZ1	1561.6	-	524	1474	2083	0.7076332
A07	26729667	26731657	A07p43140.2_BraZ1	870	-	465	1820	1990	0.9145728
A07	26734347	26735998	A07p43150.2_BraZ1	476.28	+	1939	1651	1651	1.0000000
A07	26736303	26739178	A07p43160.2_BraZ1	928.937	-	206	1747	2875	0.6076522
A07	26753516	26756413	A07p43170.2_BraZ1	408	+	1352	2788	2897	0.9623749
A07	26756520	26757141	A07p43180.2_BraZ1	62.1	+	3	189	621	0.3043478
A07	26758757	26760584	A07p43190.2_BraZ1	1149.92	-	468	1572	1827	0.8604269
A07	26772877	26774277	A07p43200.2_BraZ1	1038	-	26	543	1400	0.3878571
A07	26780861	26781266	A07p43210.2_BraZ1	40.5	-	58	405	405	1.0000000
A07	26782067	26782854	A07p43220.2_BraZ1	1155	+	575	787	787	1.0000000
A07	26794967	26797378	A07p43230.2_BraZ1	1546.11	+	650	2323	2411	0.9635006
A07	26801039	26802353	A07p43240.2_BraZ1	984.176	+	197	1306	1314	0.9939117
A07	26805818	26806310	A07p43250.2_BraZ1	49.2	-	179	492	492	1.0000000
A07	26807603	26810197	A07p43260.2_BraZ1	433.929	-	1045	2537	2594	0.9780262
A07	26816626	26817043	A07p43270.2_BraZ1	41.7	+	73	193	417	0.4628297
A07	26823094	26823532	A07p43280.2_BraZ1	43.8	-	49	387	438	0.8835617
A07	26831483	26833148	A07p43290.2_BraZ1	166.5	-	233	1314	1665	0.7891892
A07	26837183	26840600	A07p43300.2_BraZ1	341.7	-	351	2615	3417	0.7652912
A07	26841920	26847106	A07p43310.2_BraZ1	2839.19	+	2016	5013	5186	0.9666409
A07	26848682	26851251	A07p43320.2_BraZ1	1620	-	1019	2556	2569	0.9949397
A07	26852421	26853205	A07p43330.2_BraZ1	471.13	-	245	784	784	1.0000000
A07	26853407	26854909	A07p43340.2_BraZ1	470.976	+	1342	1490	1502	0.9920107
A07	26858433	26860729	A07p43350.2_BraZ1	1392	+	550	2203	2296	0.9594948
A07	26863192	26863462	A07p43360.2_BraZ1	27	+	391	270	270	1.0000000
A07	26864364	26865024	A07p43370.2_BraZ1	66	-	227	536	660	0.8121212
A07	26865893	26869240	A07p43380.2_BraZ1	1225.16	-	1760	3330	3347	0.9949208
A07	26870893	26871368	A07p43390.2_BraZ1	161.603	-	64	440	475	0.9263158
A07	26876644	26877778	A07p43400.2_BraZ1	753.852	-	561	1134	1134	1.0000000
A07	26879317	26884147	A07p43410.2_BraZ1	2543.04	+	2040	4322	4830	0.8948240
A07	26887164	26888024	A07p43420.2_BraZ1	671.842	+	485	860	860	1.0000000
A07	26888327	26890979	A07p43430.2_BraZ1	135.9	-	1251	2450	2652	0.9238310
A07	26895055	26896621	A07p43440.2_BraZ1	978	+	662	1481	1566	0.9457216
A07	26899068	26899750	A07p43450.2_BraZ1	405	+	509	682	682	1.0000000
A07	26900051	26903095	A07p43460.2_BraZ1	2964	-	499	2378	3044	0.7812089
A07	26910871	26911223	A07p43470.2_BraZ1	243	+	477	352	352	1.0000000
A07	26913564	26913900	A07p43480.2_BraZ1	243	+	416	336	336	1.0000000
A07	26914288	26917581	A07p43490.2_BraZ1	594	-	1996	3218	3293	0.9772244
A07	26919525	26919862	A07p43500.2_BraZ1	240	+	76	337	337	1.0000000
A07	26923700	26924104	A07p43510.2_BraZ1	228	+	75	404	404	1.0000000
A07	26927153	26928374	A07p43520.2_BraZ1	7823.71	+	495	1221	1221	1.0000000
A07	26929057	26935240	A07p43530.2_BraZ1	2135.44	-	3299	6105	6183	0.9873847
A07	26935722	26937245	A07p43540.2_BraZ1	856.957	-	1442	1378	1523	0.9047931
A07	26943612	26945309	A07p43550.2_BraZ1	1186.25	+	1420	1697	1697	1.0000000
A07	26946387	26948294	A07p43560.2_BraZ1	1017.55	+	852	1903	1907	0.9979025
A07	26954773	26957379	A07p43570.2_BraZ1	1020.94	+	1264	2161	2606	0.8292402
A07	26960330	26961195	A07p43580.2_BraZ1	486	+	733	865	865	1.0000000
A07	26963069	26963614	A07p43590.2_BraZ1	201	-	461	545	545	1.0000000
A07	26964475	26965687	A07p43600.2_BraZ1	628.114	-	854	1212	1212	1.0000000
A07	26966219	26968511	A07p43610.2_BraZ1	4849.71	-	1925	2259	2292	0.9856021
A07	26969406	26970555	A07p43620.2_BraZ1	648.24	-	8	350	1149	0.3046127
A07	26971817	26974288	A07p43630.2_BraZ1	1413.39	+	1866	2471	2471	1.0000000
A07	26975232	26978088	A07p43640.2_BraZ1	175.84	+	108	1151	2856	0.4030112
A07	26978613	26980609	A07p43650.2_BraZ1	1047.41	+	942	1946	1996	0.9749499
A07	26981668	26983255	A07p43660.2_BraZ1	1524	-	31	85	1587	0.0535602
A07	26987247	26987601	A07p43670.2_BraZ1	35.4	-	0	0	354	0.0000000
A07	26987935	26988523	A07p43680.2_BraZ1	6636	+	89	461	588	0.7840136
A07	26992901	26994488	A07p43690.2_BraZ1	1524	-	3	18	1587	0.0113422
A07	27000502	27001035	A07p43700.2_BraZ1	52.8	-	169	520	533	0.9756098
A07	27003057	27003852	A07p43710.2_BraZ1	79.5	+	10	354	795	0.4452830
A07	27004791	27006178	A07p43720.2_BraZ1	921	-	505	1283	1387	0.9250180
A07	27007309	27008395	A07p43730.2_BraZ1	108.6	-	224	898	1086	0.8268877
A07	27012828	27013341	A07p43740.2_BraZ1	51.3	-	62	419	513	0.8167641
A07	27014140	27016229	A07p43750.2_BraZ1	1002.26	-	413	1934	2089	0.9258018
A07	27017742	27019144	A07p43760.2_BraZ1	1329	-	94	1162	1402	0.8288160
A07	27019637	27021037	A07p43770.2_BraZ1	1308	+	254	1327	1400	0.9478571
A07	27022854	27025148	A07p43780.2_BraZ1	1198.8	+	894	2248	2294	0.9799477
A07	27030279	27033802	A07p43790.2_BraZ1	1394	+	976	3098	3523	0.8793642
A07	27034156	27036275	A07p43800.2_BraZ1	746.667	-	931	2113	2119	0.9971685
A07	27041727	27044572	A07p43810.2_BraZ1	1355	-	499	2532	2845	0.8899824
A07	27046888	27048800	A07p43820.2_BraZ1	834.082	-	748	1858	1912	0.9717573
A07	27050134	27050878	A07p43830.2_BraZ1	603	-	121	627	744	0.8427419
A07	27053185	27053416	A07p43840.2_BraZ1	23.1	+	35	57	231	0.2467532
A07	27054440	27054833	A07p43850.2_BraZ1	39.3	+	125	251	393	0.6386768
A07	27055443	27056066	A07p43860.2_BraZ1	198.607	+	886	623	623	1.0000000
A07	27056960	27057635	A07p43870.2_BraZ1	67.5	-	214	613	675	0.9081482
A07	27059156	27059915	A07p43880.2_BraZ1	75.9	-	347	759	759	1.0000000
A07	27061432	27061861	A07p43890.2_BraZ1	42.9	-	63	370	429	0.8624709
A07	27064274	27065318	A07p43900.2_BraZ1	104.4	-	362	1044	1044	1.0000000
A07	27069384	27072249	A07p43910.2_BraZ1	6912	-	1557	2737	2865	0.9553229
A07	27073210	27075672	A07p43920.2_BraZ1	1143.93	+	1099	2427	2462	0.9857839
A07	27076122	27078674	A07p43930.2_BraZ1	1690.57	-	1528	2448	2552	0.9592476
A07	27079533	27083150	A07p43940.2_BraZ1	2196.1	-	1937	3529	3617	0.9756705
A07	27084151	27084530	A07p43950.2_BraZ1	30.9	+	528	379	379	1.0000000
A07	27086265	27086610	A07p43960.2_BraZ1	34.5	+	266	345	345	1.0000000
A07	27088554	27090436	A07p43970.2_BraZ1	186	+	1930	1882	1882	1.0000000
A07	27091242	27092293	A07p43980.2_BraZ1	376.615	+	1134	1051	1051	1.0000000
A07	27092686	27092992	A07p43990.2_BraZ1	30.6	-	306	306	306	1.0000000
A07	27094233	27097940	A07p44000.2_BraZ1	3456	-	1759	3670	3707	0.9900189
A07	27096966	27097457	A07p44010.2_BraZ1	246	-	541	491	491	1.0000000
A07	27100051	27102079	A07p44020.2_BraZ1	925.031	-	537	1930	2028	0.9516765
A07	27103949	27106434	A07p44030.2_BraZ1	1796.73	+	393	2436	2485	0.9802817
A07	27107346	27108447	A07p44040.2_BraZ1	110.1	-	464	1101	1101	1.0000000
A07	27121161	27124538	A07p44050.2_BraZ1	2415	+	978	2767	3377	0.8193663
A07	27125301	27128191	A07p44060.2_BraZ1	658.714	-	1634	2836	2890	0.9813149
A07	27130189	27132066	A07p44070.2_BraZ1	1152	-	661	1855	1877	0.9882792
A07	27133693	27136889	A07p44080.2_BraZ1	1612.87	-	602	2976	3196	0.9311640
A07	27138384	27141202	A07p44090.2_BraZ1	2433	+	681	2687	2818	0.9535131
A07	27141327	27144101	A07p44100.2_BraZ1	1364.31	-	1940	2774	2774	1.0000000
A07	27144498	27146011	A07p44110.2_BraZ1	480	+	1378	1513	1513	1.0000000
A07	27157346	27157925	A07p44120.2_BraZ1	57.9	+	179	579	579	1.0000000
A07	27162209	27164207	A07p44130.2_BraZ1	982.8	-	201	1447	1998	0.7242242
A07	27169995	27172517	A07p44140.2_BraZ1	1659	-	2170	2522	2522	1.0000000
A07	27173660	27177851	A07p44150.2_BraZ1	1620	-	3481	4191	4191	1.0000000
A07	27178658	27180675	A07p44160.2_BraZ1	1575	-	1421	1865	2017	0.9246405
A07	27182471	27182972	A07p44170.2_BraZ1	417	-	296	501	501	1.0000000
A07	27184555	27186504	A07p44180.2_BraZ1	1479	+	567	1868	1949	0.9584402
A07	27187180	27188448	A07p44190.2_BraZ1	714	+	904	1268	1268	1.0000000
A07	27188933	27190682	A07p44200.2_BraZ1	835.775	-	1748	1698	1749	0.9708405
A07	27191696	27193314	A07p44210.2_BraZ1	715	-	366	1478	1618	0.9134734
A07	27196485	27198435	A07p44220.2_BraZ1	4231.33	+	480	1869	1950	0.9584615
A07	27201261	27201426	A07p44230.2_BraZ1	16.5	+	213	165	165	1.0000000
A07	27203090	27203957	A07p44240.2_BraZ1	86.7	+	162	708	867	0.8166090
A07	27208989	27210318	A07p44250.2_BraZ1	132.9	+	93	841	1329	0.6328066
A07	27211503	27214673	A07p44260.2_BraZ1	971.333	-	1121	2810	3170	0.8864353
A07	27216961	27218779	A07p44270.2_BraZ1	1023.75	+	920	1751	1818	0.9631463
A07	27219027	27220682	A07p44280.2_BraZ1	827.818	-	204	1264	1655	0.7637462
A07	27222680	27226610	A07p44290.2_BraZ1	1767.48	-	1732	3343	3930	0.8506361
A07	27229029	27229434	A07p44300.2_BraZ1	40.5	+	224	361	405	0.8913580
A07	27235318	27238988	A07p44310.2_BraZ1	2895.57	+	1631	3627	3670	0.9882834
A07	27241730	27242832	A07p44320.2_BraZ1	705.05	+	204	986	1102	0.8947368
A07	27245777	27246245	A07p44330.2_BraZ1	46.8	+	18	247	468	0.5277778
A07	27248741	27249210	A07p44340.2_BraZ1	26.7	+	9	254	469	0.5415778
A07	27255632	27258080	A07p44350.2_BraZ1	1458.33	+	455	2332	2448	0.9526144
A07	27258772	27263554	A07p44360.2_BraZ1	3016.96	+	2012	4741	4782	0.9914262
A07	27263964	27266433	A07p44370.2_BraZ1	978	-	1797	2421	2469	0.9805589
A07	27267758	27269567	A07p44380.2_BraZ1	6171	-	702	1764	1809	0.9751244
A07	27271331	27273440	A07p44390.2_BraZ1	954.281	-	822	2059	2109	0.9762921
A07	27275212	27278144	A07p44400.2_BraZ1	1079.33	-	1597	2662	2932	0.9079127
A07	27279925	27282449	A07p44410.2_BraZ1	465.4	-	163	2020	2524	0.8003169
A07	27283860	27285890	A07p44420.2_BraZ1	1320	-	667	1845	2030	0.9088670
A07	27290746	27297653	A07p44430.2_BraZ1	5066.72	+	3666	6567	6907	0.9507746
A07	27298343	27299398	A07p44440.2_BraZ1	502.524	-	722	1055	1055	1.0000000
A07	27300341	27301128	A07p44450.2_BraZ1	717	+	506	787	787	1.0000000
A07	27301375	27303095	A07p44460.2_BraZ1	111.3	-	133	1303	1720	0.7575582
A07	27314912	27315497	A07p44470.2_BraZ1	58.5	+	162	560	585	0.9572650
A07	27317080	27317847	A07p44480.2_BraZ1	288.556	-	256	578	767	0.7535854
A07	27327762	27329961	A07p44490.2_BraZ1	1716	+	479	2054	2199	0.9340609
A07	27335643	27337631	A07p44500.2_BraZ1	1725	-	2537	1949	1988	0.9803823
A07	27344124	27347547	A07p44510.2_BraZ1	1045.89	+	709	3197	3423	0.9339761
A07	27348718	27350501	A07p44520.2_BraZ1	1448.18	-	1765	1729	1783	0.9697140
A07	27358572	27359652	A07p44530.2_BraZ1	108	-	123	1006	1080	0.9314815
A07	27364967	27367307	A07p44540.2_BraZ1	718.064	-	1090	1757	2340	0.7508547
A07	27375803	27381157	A07p44550.2_BraZ1	1987.16	+	1718	4978	5354	0.9297721
A07	27382305	27382645	A07p44560.2_BraZ1	32.1	-	5	40	340	0.1176471
A07	27394587	27394886	A07p44570.2_BraZ1	105	-	15	278	299	0.9297659
A07	27397578	27398343	A07p44580.2_BraZ1	76.5	-	40	425	765	0.5555556
A07	27398758	27399985	A07p44590.2_BraZ1	48.3	-	112	1088	1227	0.8867156
A07	27400152	27402484	A07p44600.2_BraZ1	366	-	2594	2332	2332	1.0000000
A07	27403701	27403986	A07p44610.2_BraZ1	28.5	-	27	285	285	1.0000000
A07	27404868	27409456	A07p44620.2_BraZ1	1556.35	-	2724	4446	4588	0.9690497
A07	27417182	27417680	A07p44630.2_BraZ1	189	+	226	498	498	1.0000000
A07	27418652	27420845	A07p44640.2_BraZ1	1242.54	+	583	1892	2193	0.8627451
A07	27424326	27426347	A07p44650.2_BraZ1	840	+	796	1931	2021	0.9554676
A07	27427259	27429036	A07p44660.2_BraZ1	796.204	-	1584	1777	1777	1.0000000
A07	27430080	27431683	A07p44670.2_BraZ1	1023	-	447	1553	1603	0.9688085
A07	27432802	27434107	A07p44680.2_BraZ1	816.75	-	313	1305	1305	1.0000000
A07	27435671	27437072	A07p44690.2_BraZ1	1011.79	-	215	1129	1401	0.8058529
A07	27441437	27444519	A07p44700.2_BraZ1	20768.5	+	1424	2948	3082	0.9565217
A07	27446281	27447824	A07p44710.2_BraZ1	1120.17	+	178	1391	1543	0.9014906
A07	27448011	27449464	A07p44720.2_BraZ1	911.429	-	669	1453	1453	1.0000000
A07	27452551	27453623	A07p44730.2_BraZ1	716.571	-	69	621	1072	0.5792910
A07	27454717	27455791	A07p44740.2_BraZ1	832.219	-	172	651	1074	0.6061453
A07	27459091	27459296	A07p44750.2_BraZ1	16.5	-	148	205	205	1.0000000
A07	27469041	27470054	A07p44760.2_BraZ1	731	-	334	709	1013	0.6999013
A07	27471728	27475903	A07p44770.2_BraZ1	1638	-	1233	3736	4175	0.8948503
A07	27478928	27479798	A07p44780.2_BraZ1	73.8	-	990	870	870	1.0000000
A07	27483689	27487074	A07p44790.2_BraZ1	6487	-	996	3129	3385	0.9243723
A07	27488931	27491116	A07p44800.2_BraZ1	1418.1	+	1145	2185	2185	1.0000000
A07	27492000	27493635	A07p44810.2_BraZ1	163.5	-	558	1560	1635	0.9541284
A07	27495393	27497620	A07p44820.2_BraZ1	9093.33	-	1033	2061	2227	0.9254603
A07	27499333	27502610	A07p44830.2_BraZ1	2007.28	-	828	3078	3277	0.9392737
A07	27504193	27508754	A07p44840.2_BraZ1	1677.98	-	1805	4221	4561	0.9254549
A07	27511253	27512332	A07p44850.2_BraZ1	846	+	383	882	1079	0.8174235
A07	27512677	27519883	A07p44860.2_BraZ1	4606.91	-	2284	5959	7206	0.8269498
A07	27524349	27528276	A07p44870.2_BraZ1	1906.42	+	667	3139	3927	0.7993379
A07	27528691	27534395	A07p44880.2_BraZ1	2684.39	+	2050	5111	5704	0.8960379
A07	27534664	27535937	A07p44890.2_BraZ1	817.826	-	288	1269	1273	0.9968578
A07	27542501	27544177	A07p44900.2_BraZ1	753.158	+	2045	1676	1676	1.0000000
A07	27544438	27546784	A07p44910.2_BraZ1	1317.43	-	769	2018	2346	0.8601875
A07	27550775	27551069	A07p44920.2_BraZ1	29.4	-	140	294	294	1.0000000
A07	27551990	27553899	A07p44930.2_BraZ1	946	-	2121	1855	1909	0.9717129
A07	27555647	27556343	A07p44940.2_BraZ1	69.6	+	558	696	696	1.0000000
A07	27556926	27558858	A07p44950.2_BraZ1	1285.66	-	1625	1932	1932	1.0000000
A07	27559844	27562008	A07p44960.2_BraZ1	1026.67	+	1541	2109	2164	0.9745841
A07	27564262	27567816	A07p44970.2_BraZ1	2632.7	+	2843	3554	3554	1.0000000
A07	27571206	27572960	A07p44980.2_BraZ1	1228.5	+	529	1618	1754	0.9224629
A07	27574821	27577451	A07p44990.2_BraZ1	1360	+	883	2535	2630	0.9638783
A07	27580187	27582121	A07p45000.2_BraZ1	758.55	+	668	1820	1934	0.9410548
A07	27583016	27597605	A07p45010.2_BraZ1	2913.88	-	5707	13440	14589	0.9212421
A07	27591302	27592618	A07p45020.2_BraZ1	840.981	+	269	1263	1316	0.9597265
A07	27603417	27604131	A07p45030.2_BraZ1	71.4	+	193	554	714	0.7759104
A07	27605690	27607257	A07p45040.2_BraZ1	735	+	450	924	1567	0.5896618
A07	27608528	27611386	A07p45050.2_BraZ1	1924	+	889	2430	2858	0.8502449
A07	27611719	27612621	A07p45060.2_BraZ1	465	-	350	889	902	0.9855876
A07	27618854	27622151	A07p45070.2_BraZ1	2736	-	242	2348	3297	0.7121626
A07	27625800	27626109	A07p45080.2_BraZ1	30.9	-	4	161	309	0.5210356
A07	27629983	27631011	A07p45090.2_BraZ1	777.857	+	601	1028	1028	1.0000000
A07	27631396	27632188	A07p45100.2_BraZ1	79.2	-	235	792	792	1.0000000
A07	27636446	27642714	A07p45110.2_BraZ1	3489.26	+	2469	5295	6268	0.8447671
A07	27643699	27645764	A07p45120.2_BraZ1	961.971	-	281	1655	2065	0.8014528
A07	27647823	27649038	A07p45130.2_BraZ1	121.5	+	272	1205	1215	0.9917696
A07	27651754	27654011	A07p45140.2_BraZ1	1653	+	673	2174	2257	0.9632255
A07	27657929	27659030	A07p45150.2_BraZ1	960	-	189	986	1101	0.8955495
A07	27665494	27667376	A07p45160.2_BraZ1	1115.89	-	410	1824	1882	0.9691817
A07	27670273	27670796	A07p45170.2_BraZ1	360	+	126	523	523	1.0000000
A07	27673113	27683993	A07p45180.2_BraZ1	1634.73	+	4895	10036	10880	0.9224265
A07	27684864	27685712	A07p45190.2_BraZ1	317.812	-	584	826	848	0.9740566
A07	27687575	27693928	A07p45200.2_BraZ1	861	+	4205	6091	6353	0.9587597
A07	27695257	27695368	A07p45210.2_BraZ1	11.1	-	6	39	111	0.3513514
A07	27695452	27698015	A07p45220.2_BraZ1	615.087	-	162	1542	2563	0.6016387
A07	27699159	27701226	A07p45230.2_BraZ1	750.17	-	453	1390	2067	0.6724722
A07	27702459	27706659	A07p45240.2_BraZ1	1776.02	-	637	2464	4200	0.5866666
A07	27715227	27718234	A07p45250.2_BraZ1	1700.65	+	347	2591	3007	0.8616561
A07	27719068	27722205	A07p45260.2_BraZ1	1288.39	+	1746	3137	3137	1.0000000
A07	27724932	27725682	A07p45270.2_BraZ1	465	+	506	750	750	1.0000000
A07	27730055	27730900	A07p45280.2_BraZ1	719.333	+	420	783	845	0.9266272
A07	27733555	27735459	A07p45290.2_BraZ1	865.92	+	681	1904	1904	1.0000000
A07	27735622	27739574	A07p45300.2_BraZ1	2165.62	-	1641	3673	3952	0.9294028
A07	27741518	27744498	A07p45310.2_BraZ1	1019.13	+	2182	2123	2980	0.7124161
A07	27750700	27751687	A07p45320.2_BraZ1	98.7	+	131	618	987	0.6261398
A07	27754656	27757003	A07p45330.2_BraZ1	1135.54	-	2023	2347	2347	1.0000000
A07	27771462	27774032	A07p45340.2_BraZ1	922.976	+	166	1954	2570	0.7603113
A07	27784490	27785456	A07p45350.2_BraZ1	96.6	+	66	762	966	0.7888198
A07	27788940	27789903	A07p45360.2_BraZ1	96.3	+	751	963	963	1.0000000
A07	27791080	27793613	A07p45370.2_BraZ1	1426.34	-	1365	2482	2533	0.9798658
A07	27797500	27799541	A07p45380.2_BraZ1	997.143	-	1419	2041	2041	1.0000000
A07	27800782	27803072	A07p45390.2_BraZ1	1771.79	+	506	1784	2290	0.7790393
A07	27809922	27810695	A07p45400.2_BraZ1	666	+	80	732	773	0.9469599
A07	27811776	27811895	A07p45410.2_BraZ1	10.2	-	175	119	119	1.0000000
A07	27811974	27817880	A07p45420.2_BraZ1	2538.91	-	3550	5819	5906	0.9852692
A07	27818987	27820164	A07p45430.2_BraZ1	811.429	+	582	1152	1177	0.9787596
A07	27821367	27823158	A07p45440.2_BraZ1	974.333	-	1475	1629	1791	0.9095477
A07	27825353	27826618	A07p45450.2_BraZ1	798.188	-	1926	1206	1265	0.9533597
A07	27828940	27833100	A07p45460.2_BraZ1	1319.77	+	2873	3792	4160	0.9115385
A07	27834045	27837034	A07p45470.2_BraZ1	1958.69	-	2020	2968	2989	0.9929742
A07	27848019	27850600	A07p45480.2_BraZ1	841.657	+	1158	2361	2581	0.9147617
A07	27851687	27854019	A07p45490.2_BraZ1	1240.73	+	614	2167	2332	0.9292453
A07	27855050	27859818	A07p45500.2_BraZ1	2852.91	+	4193	4766	4768	0.9995806
A07	27859992	27860801	A07p45510.2_BraZ1	510	-	689	745	809	0.9208900
A07	27862270	27864163	A07p45520.2_BraZ1	644.6	+	861	1893	1893	1.0000000
A07	27865127	27866018	A07p45530.2_BraZ1	89.1	-	678	891	891	1.0000000
A07	27871301	27873674	A07p45540.2_BraZ1	576.964	-	265	1827	2373	0.7699115
A07	27874141	27877411	A07p45550.2_BraZ1	537	-	558	1902	3270	0.5816514
A07	27878221	27879344	A07p45560.2_BraZ1	471.429	+	1273	1123	1123	1.0000000
A07	27882947	27884864	A07p45570.2_BraZ1	191.7	-	385	1453	1917	0.7579551
A07	27891290	27892662	A07p45580.2_BraZ1	7819.5	-	103	1062	1372	0.7740525
A07	27895482	27895898	A07p45590.2_BraZ1	321	+	141	202	416	0.4855769
A07	27897674	27899836	A07p45600.2_BraZ1	1136.57	+	1175	2021	2162	0.9347826
A07	27903248	27904801	A07p45610.2_BraZ1	966.868	-	1138	1550	1553	0.9980683
A07	27915860	27919324	A07p45620.2_BraZ1	832.615	-	2215	3200	3464	0.9237875
A07	27923715	27923892	A07p45630.2_BraZ1	17.7	+	182	177	177	1.0000000
A07	27924619	27925552	A07p45640.2_BraZ1	705	-	685	933	933	1.0000000
A07	27926659	27927584	A07p45650.2_BraZ1	3315	-	643	925	925	1.0000000
A07	27930054	27938723	A07p45660.2_BraZ1	1292.87	+	2998	7360	8669	0.8490022
A07	27941761	27945232	A07p45670.2_BraZ1	1198.66	-	2213	3093	3471	0.8910977
A07	27946015	27947371	A07p45680.2_BraZ1	6248	-	172	788	1356	0.5811210
A07	27948247	27949467	A07p45690.2_BraZ1	1048.66	-	222	1020	1220	0.8360656
A07	27949756	27952211	A07p45700.2_BraZ1	1078.79	-	783	2305	2455	0.9389002
A07	27953458	27956087	A07p45710.2_BraZ1	4698	+	522	2480	2629	0.9433244
A07	27956512	27961029	A07p45720.2_BraZ1	2549.93	-	1687	4435	4517	0.9818463
A07	27972109	27973737	A07p45730.2_BraZ1	925.38	+	634	1600	1628	0.9828010
A07	27974630	27975785	A07p45740.2_BraZ1	8379	+	305	1155	1155	1.0000000
A07	27976066	27978881	A07p45750.2_BraZ1	2434.93	-	705	2711	2815	0.9630551
A07	27980244	27982476	A07p45760.2_BraZ1	981	-	525	1613	2232	0.7226703
A07	27982735	27983822	A07p45770.2_BraZ1	358.714	+	649	878	1087	0.8077277
A07	27983880	27987072	A07p45780.2_BraZ1	913.75	+	1990	3090	3192	0.9680451
A07	27987458	27989675	A07p45790.2_BraZ1	993.778	+	1132	2185	2217	0.9855661
A07	27989800	27990022	A07p45800.2_BraZ1	22.2	-	289	222	222	1.0000000
A07	27990396	27992562	A07p45810.2_BraZ1	920	+	1422	2166	2166	1.0000000
A07	27993218	27994449	A07p45820.2_BraZ1	858.162	+	785	1231	1231	1.0000000
A07	27995320	27997121	A07p45830.2_BraZ1	924	+	700	1580	1801	0.8772904
A07	27998396	27998782	A07p45840.2_BraZ1	30	+	27	345	386	0.8937824
A07	28000424	28002278	A07p45850.2_BraZ1	1422	-	1356	1823	1854	0.9832794
A07	28003619	28005005	A07p45860.2_BraZ1	4200	-	1415	1386	1386	1.0000000
A07	28005290	28008895	A07p45870.2_BraZ1	1530.74	+	1783	3344	3605	0.9276006
A07	28009105	28010730	A07p45880.2_BraZ1	879.375	-	617	1625	1625	1.0000000
A07	28011425	28014665	A07p45890.2_BraZ1	1052.13	-	1774	3128	3240	0.9654321
A07	28015599	28015911	A07p45900.2_BraZ1	31.2	+	476	312	312	1.0000000
A07	28018702	28019281	A07p45910.2_BraZ1	57.9	-	282	579	579	1.0000000
A07	28021340	28022989	A07p45920.2_BraZ1	1365	-	614	1631	1649	0.9890843
A07	28028291	28029776	A07p45930.2_BraZ1	27183	-	489	1420	1485	0.9562290
A07	28031975	28033573	A07p45940.2_BraZ1	400.089	+	2347	1598	1598	1.0000000
A07	28034165	28036107	A07p45950.2_BraZ1	1359.43	-	563	1820	1942	0.9371782
A07	28037169	28043077	A07p45960.2_BraZ1	1995.16	+	3258	5816	5908	0.9844279
A07	28043889	28046269	A07p45970.2_BraZ1	1272.69	+	2058	2371	2380	0.9962185
A07	28047456	28051631	A07p45980.2_BraZ1	2368.46	+	1805	4079	4175	0.9770060
A07	28052193	28063755	A07p45990.2_BraZ1	4219.45	-	4450	10380	11562	0.8977686
A07	28066980	28071290	A07p46000.2_BraZ1	2091.65	+	3176	4258	4310	0.9879350
A07	28071466	28074783	A07p46010.2_BraZ1	1914.87	-	1253	3219	3317	0.9704552
A07	28077123	28079690	A07p46020.2_BraZ1	1374	-	576	2142	2567	0.8344371
A07	28084636	28091258	A07p46030.2_BraZ1	4846.7	-	1123	4188	6622	0.6324373
A07	28091992	28093623	A07p46040.2_BraZ1	661.648	-	1005	1631	1631	1.0000000
A07	28093939	28096443	A07p46050.2_BraZ1	1338.12	-	499	2444	2504	0.9760383
A07	28098634	28098909	A07p46060.2_BraZ1	384	-	250	275	275	1.0000000
A07	28099667	28102384	A07p46070.2_BraZ1	1521.59	-	2058	2717	2717	1.0000000
A07	28109714	28110399	A07p46080.2_BraZ1	423	+	291	542	685	0.7912409
A07	28112400	28113549	A07p46090.2_BraZ1	114.9	+	280	1093	1149	0.9512619
A07	28115579	28116140	A07p46100.2_BraZ1	399	-	372	561	561	1.0000000
A07	28116884	28118576	A07p46110.2_BraZ1	169.2	-	133	906	1692	0.5354610
A07	28119194	28122224	A07p46120.2_BraZ1	2265	-	1611	2950	3030	0.9735973
A07	28126731	28128086	A07p46130.2_BraZ1	923.029	+	1034	1355	1355	1.0000000
A07	28135307	28136531	A07p46140.2_BraZ1	122.4	-	721	1224	1224	1.0000000
A07	28137106	28137223	A07p46150.2_BraZ1	11.7	-	140	117	117	1.0000000
A07	28138326	28138761	A07p46160.2_BraZ1	43.5	+	147	435	435	1.0000000
A07	28140860	28144989	A07p46170.2_BraZ1	2344.43	-	1322	4092	4129	0.9910390
A07	28151561	28152405	A07p46180.2_BraZ1	741	-	411	830	844	0.9834123
A07	28162363	28163344	A07p46190.2_BraZ1	813	+	172	826	981	0.8419980
A07	28164590	28165845	A07p46200.2_BraZ1	437.333	+	554	1216	1255	0.9689243
A07	28166132	28172048	A07p46210.2_BraZ1	392.7	-	25421	5903	5916	0.9978026
A07	28173886	28176258	A07p46220.2_BraZ1	765.546	-	1432	2266	2372	0.9553120
A07	28176389	28177511	A07p46230.2_BraZ1	112.2	+	930	1122	1122	1.0000000
A07	28178248	28180532	A07p46240.2_BraZ1	925.921	+	1215	2231	2284	0.9767951
A07	28181083	28181320	A07p46250.2_BraZ1	23.7	-	68	237	237	1.0000000
A07	28181685	28186467	A07p46260.2_BraZ1	1395	-	1515	3571	4782	0.7467587
A07	28190276	28192074	A07p46270.2_BraZ1	1319.31	+	422	1697	1798	0.9438265
A07	28192389	28205109	A07p46280.2_BraZ1	6113.93	-	1682	9114	12720	0.7165095
A07	28206275	28206623	A07p46290.2_BraZ1	204	+	44	343	348	0.9856322
A07	28207110	28211380	A07p46300.2_BraZ1	1380	+	1809	3571	4270	0.8362998
A07	28208529	28208912	A07p46310.2_BraZ1	288	+	415	378	383	0.9869452
A07	28212147	28213816	A07p46320.2_BraZ1	2358	+	468	1211	1669	0.7255842
A07	28214980	28216561	A07p46330.2_BraZ1	637.5	+	926	1522	1581	0.9626818
A07	28217076	28225261	A07p46340.2_BraZ1	3869.16	-	1068	5377	8185	0.6569334
A07	28226781	28228732	A07p46350.2_BraZ1	1536	-	838	1899	1951	0.9733470
A07	28230145	28233143	A07p46360.2_BraZ1	943.02	+	1687	2927	2998	0.9763175
A07	28233497	28234679	A07p46370.2_BraZ1	381	-	576	1166	1182	0.9864636
A07	28235092	28238313	A07p46380.2_BraZ1	2299.61	+	1617	2889	3221	0.8969264
A07	28238725	28242486	A07p46390.2_BraZ1	1554	-	1973	3489	3761	0.9276788
A07	28244437	28247145	A07p46400.2_BraZ1	1254	+	1078	2449	2708	0.9043574
A07	28250811	28252398	A07p46410.2_BraZ1	1071	-	52	857	1587	0.5400126
A07	28255682	28260203	A07p46420.2_BraZ1	1498.68	-	2962	4235	4521	0.9367397
A07	28260911	28264647	A07p46430.2_BraZ1	2069.65	+	2673	3736	3736	1.0000000
A07	28265104	28267285	A07p46440.2_BraZ1	1551.79	-	722	2083	2181	0.9550665
A07	28269704	28271092	A07p46450.2_BraZ1	1114.29	-	105	953	1388	0.6865994
A07	28271895	28274269	A07p46460.2_BraZ1	192	+	1830	2343	2374	0.9869419
A07	28272731	28273341	A07p46470.2_BraZ1	136.8	-	316	610	610	1.0000000
A07	28274727	28276787	A07p46480.2_BraZ1	1089.31	-	1563	1995	2060	0.9684466
A07	28277156	28277745	A07p46490.2_BraZ1	219	-	479	575	589	0.9762309
A07	28278418	28280448	A07p46500.2_BraZ1	1074.91	-	689	1892	2030	0.9320197
A07	28281165	28285730	A07p46510.2_BraZ1	3307.89	-	1373	3802	4565	0.8328587
A07	28286670	28290404	A07p46520.2_BraZ1	2428.24	+	247	1345	3734	0.3602035
A07	28290910	28292801	A07p46530.2_BraZ1	945	-	358	1679	1891	0.8878900
A07	28296555	28299887	A07p46540.2_BraZ1	838.617	+	1201	3189	3332	0.9570828
A07	28300483	28304172	A07p46550.2_BraZ1	1386.53	-	1062	3082	3689	0.8354568
A07	28305637	28307639	A07p46560.2_BraZ1	1440.76	-	1097	2002	2002	1.0000000
A07	28309230	28313728	A07p46570.2_BraZ1	1859.31	-	3071	4333	4498	0.9633170
A07	28315396	28315681	A07p46580.2_BraZ1	28.5	+	197	285	285	1.0000000
A07	28315935	28318392	A07p46590.2_BraZ1	17055	-	501	2433	2457	0.9902320
A07	28318815	28321366	A07p46600.2_BraZ1	8912.5	-	498	2469	2551	0.9678558
A07	28323036	28327612	A07p46610.2_BraZ1	2062.78	+	2505	4503	4576	0.9840472
A07	28327758	28330705	A07p46620.2_BraZ1	715.312	-	731	2687	2947	0.9117747
A07	28331929	28332103	A07p46630.2_BraZ1	17.4	+	0	0	174	0.0000000
A07	28332786	28334663	A07p46640.2_BraZ1	1196.87	+	363	1664	1877	0.8865210
A07	28334888	28336764	A07p46650.2_BraZ1	1464	-	551	1845	1876	0.9834755
A07	28343398	28345604	A07p46660.2_BraZ1	1101.35	+	982	2146	2206	0.9728014
A07	28346245	28347143	A07p46670.2_BraZ1	67.2	-	571	898	898	1.0000000
A07	28348335	28351897	A07p46680.2_BraZ1	2403.5	+	398	2656	3562	0.7456485
A07	28352685	28353373	A07p46690.2_BraZ1	479.944	+	37	670	688	0.9738372
A07	28353746	28353988	A07p46700.2_BraZ1	141	-	189	242	242	1.0000000
A07	28355480	28356863	A07p46710.2_BraZ1	1233	+	294	1289	1383	0.9320318
A07	28357187	28357755	A07p46720.2_BraZ1	26.1	-	163	487	568	0.8573943
A07	28358069	28360091	A07p46730.2_BraZ1	1182	-	89	758	2022	0.3748764
A07	28361094	28362637	A07p46740.2_BraZ1	240	+	300	1366	1543	0.8852884
A07	28363719	28365311	A07p46750.2_BraZ1	818.804	+	1050	1592	1592	1.0000000
A07	28365559	28367013	A07p46760.2_BraZ1	903	-	666	1454	1454	1.0000000
A07	28375402	28378478	A07p46770.2_BraZ1	1362.07	+	723	2203	3076	0.7161899
A07	28378792	28380657	A07p46780.2_BraZ1	1043.62	-	677	1706	1865	0.9147453
A07	28381994	28385347	A07p46790.2_BraZ1	1890	-	1662	3323	3353	0.9910528
A07	28386488	28387316	A07p46800.2_BraZ1	82.8	-	146	731	828	0.8828502
A07	28390629	28391340	A07p46810.2_BraZ1	633	-	473	711	711	1.0000000
A07	28392244	28394804	A07p46820.2_BraZ1	1269.44	-	1154	2541	2560	0.9925781
A07	28395691	28395982	A07p46830.2_BraZ1	192	+	122	291	291	1.0000000
A07	28395893	28397014	A07p46840.2_BraZ1	399	-	97	718	1121	0.6404995
A07	28399650	28401091	A07p46850.2_BraZ1	837.942	+	17	179	1441	0.1242193
A07	28401142	28401445	A07p46860.2_BraZ1	30.3	-	310	303	303	1.0000000
A07	28401577	28402998	A07p46870.2_BraZ1	225	-	2011	1421	1421	1.0000000
A07	28406260	28406935	A07p46880.2_BraZ1	67.5	+	32	548	675	0.8118519
A07	28408863	28409816	A07p46890.2_BraZ1	729	-	198	894	953	0.9380903
A07	28410181	28412488	A07p46900.2_BraZ1	1523.52	+	3179	2307	2307	1.0000000
A07	28412731	28413804	A07p46910.2_BraZ1	7264	-	1230	1073	1073	1.0000000
A07	28415240	28416448	A07p46920.2_BraZ1	1106.75	+	417	1198	1208	0.9917219
A07	28417850	28418305	A07p46930.2_BraZ1	2425.5	+	470	455	455	1.0000000
A07	28419079	28421372	A07p46940.2_BraZ1	1032.04	+	1438	2278	2293	0.9934583
A07	28422147	28425954	A07p46950.2_BraZ1	2411.49	+	1060	3293	3807	0.8649855
A07	28426280	28428569	A07p46960.2_BraZ1	1173.59	-	1607	2287	2289	0.9991263
A07	28429510	28431167	A07p46970.2_BraZ1	152.4	+	396	1599	1657	0.9649970
A07	28431655	28433590	A07p46980.2_BraZ1	1198.31	-	676	1869	1935	0.9658915
A07	28434434	28436640	A07p46990.2_BraZ1	567.45	+	655	2086	2206	0.9456029
A07	28437268	28438792	A07p47000.2_BraZ1	1356	+	658	1524	1524	1.0000000
A07	28439095	28441284	A07p47010.2_BraZ1	1178.1	-	1739	2189	2189	1.0000000
A07	28441654	28442983	A07p47020.2_BraZ1	132.9	+	208	1191	1329	0.8961625
A07	28443872	28446589	A07p47030.2_BraZ1	1519.85	+	946	2527	2717	0.9300699
A07	28448901	28450847	A07p47040.2_BraZ1	1686	+	369	1786	1946	0.9177800
A07	28451662	28453168	A07p47050.2_BraZ1	1338	+	787	1506	1506	1.0000000
A07	28457690	28458218	A07p47060.2_BraZ1	52.8	-	18	352	528	0.6666667
A07	28461821	28463276	A07p47070.2_BraZ1	145.5	-	126	961	1455	0.6604811
A07	28464573	28465226	A07p47080.2_BraZ1	214.761	-	211	634	653	0.9709035
A07	28465910	28468026	A07p47090.2_BraZ1	45135	+	651	2092	2116	0.9886578
A07	28468766	28468996	A07p47100.2_BraZ1	18.6	+	58	171	230	0.7434782
A07	28469309	28472249	A07p47110.2_BraZ1	2102.69	-	1158	2937	2940	0.9989796
A07	28473353	28475614	A07p47120.2_BraZ1	1715.92	-	896	1867	2261	0.8257408
A07	28478438	28480236	A07p47130.2_BraZ1	387	-	749	1778	1798	0.9888765
A07	28481644	28483693	A07p47140.2_BraZ1	1688.28	+	696	1976	2049	0.9643729
A07	28483945	28485235	A07p47150.2_BraZ1	129	+	940	1290	1290	1.0000000
A07	28486353	28486944	A07p47160.2_BraZ1	59.1	+	61	490	591	0.8291032
A07	28488349	28489429	A07p47170.2_BraZ1	108	-	481	1034	1080	0.9574074
A07	28498584	28505300	A07p47180.2_BraZ1	2563.75	+	3189	6526	6716	0.9717094
A07	28509598	28510502	A07p47190.2_BraZ1	550.565	+	99	506	904	0.5597345
A07	28514371	28516704	A07p47200.2_BraZ1	1192	-	863	2167	2333	0.9288470
A07	28517317	28519508	A07p47210.2_BraZ1	1180.95	-	1461	2191	2191	1.0000000
A07	28523608	28525335	A07p47220.2_BraZ1	1042.36	+	959	1727	1727	1.0000000
A07	28527771	28528149	A07p47230.2_BraZ1	37.8	+	145	378	378	1.0000000
A07	28528306	28528723	A07p47240.2_BraZ1	339	-	466	417	417	1.0000000
A07	28529333	28530704	A07p47250.2_BraZ1	137.1	-	275	1302	1371	0.9496717
A07	28531285	28533495	A07p47260.2_BraZ1	1605.15	-	453	2092	2210	0.9466063
A07	28537078	28542700	A07p47270.2_BraZ1	835.579	+	1721	3645	5622	0.6483458
A07	28544262	28544892	A07p47280.2_BraZ1	63	-	172	572	630	0.9079365
A07	28545699	28550176	A07p47290.2_BraZ1	918	+	667	3417	4477	0.7632343
A07	28547677	28548310	A07p47300.2_BraZ1	154.8	-	87	633	633	1.0000000
A07	28548254	28549462	A07p47310.2_BraZ1	265.743	-	148	1055	1208	0.8733444
A07	28555840	28556578	A07p47320.2_BraZ1	636	-	14	449	738	0.6084011
A07	28566879	28568116	A07p47330.2_BraZ1	750.711	-	223	1032	1237	0.8342765
A07	28574993	28576498	A07p47340.2_BraZ1	1089	-	47	327	1505	0.2172758
A07	28577691	28577944	A07p47350.2_BraZ1	165	-	9	212	253	0.8379447
A07	28578602	28578865	A07p47360.2_BraZ1	24.9	-	199	263	263	1.0000000
A07	28582684	28585824	A07p47370.2_BraZ1	611.25	+	1745	2976	3140	0.9477707
A07	28588667	28591419	A07p47380.2_BraZ1	1497	+	1169	2432	2752	0.8837209
A07	28593640	28594501	A07p47390.2_BraZ1	86.1	+	70	587	861	0.6817654
A07	28594617	28601814	A07p47400.2_BraZ1	1415.25	-	4942	7145	7197	0.9927748
A07	28602012	28602691	A07p47410.2_BraZ1	448.2	-	448	679	679	1.0000000
A07	28604152	28605270	A07p47420.2_BraZ1	939	+	157	806	1118	0.7209302
A07	28605792	28606852	A07p47430.2_BraZ1	933	-	432	1060	1060	1.0000000
A08	5098	5461	A08p00010.2_BraZ1	273	-	91	363	363	1.0000000
A08	10422	11619	A08p00020.2_BraZ1	930	+	311	1108	1197	0.9256474
A08	13319	15292	A08p00030.2_BraZ1	969.429	+	0	0	1973	0.0000000
A08	16068	16600	A08p00040.2_BraZ1	33.9	-	0	0	532	0.0000000
A08	19333	21301	A08p00050.2_BraZ1	966.667	+	0	0	1968	0.0000000
A08	22078	27491	A08p00060.2_BraZ1	2958.59	-	764	2808	5413	0.5187511
A08	27444	29098	A08p00070.2_BraZ1	862.552	+	250	1635	1654	0.9885127
A08	34754	35833	A08p00080.2_BraZ1	900	-	16	272	1079	0.2520853
A08	35944	36151	A08p00090.2_BraZ1	114	-	133	207	207	1.0000000
A08	55731	61441	A08p00100.2_BraZ1	2501.83	+	2301	5551	5710	0.9721541
A08	62958	63893	A08p00110.2_BraZ1	1602	-	3	51	935	0.0545455
A08	64934	73162	A08p00120.2_BraZ1	2379.55	+	1693	5730	8228	0.6964025
A08	76577	77569	A08p00130.2_BraZ1	807	+	680	955	992	0.9627016
A08	78501	83772	A08p00140.2_BraZ1	2503.1	-	1998	4854	5271	0.9208879
A08	97302	98018	A08p00150.2_BraZ1	460.833	+	0	0	716	0.0000000
A08	99820	100070	A08p00160.2_BraZ1	186	+	46	228	250	0.9120000
A08	131304	131876	A08p00170.2_BraZ1	351	+	409	572	572	1.0000000
A08	138869	143239	A08p00180.2_BraZ1	966	+	1543	3948	4370	0.9034325
A08	145068	146037	A08p00190.2_BraZ1	96.9	-	295	766	969	0.7905056
A08	149228	153236	A08p00200.2_BraZ1	2050.59	+	1397	3527	4008	0.8799900
A08	154216	155995	A08p00210.2_BraZ1	1220.51	-	367	1452	1779	0.8161889
A08	156174	158052	A08p00220.2_BraZ1	187.8	+	580	1854	1878	0.9872205
A08	158227	158926	A08p00230.2_BraZ1	69.9	-	139	487	699	0.6967096
A08	161894	162952	A08p00240.2_BraZ1	975	-	155	975	1058	0.9215501
A08	163620	165633	A08p00250.2_BraZ1	796.258	-	977	1974	2013	0.9806259
A08	169611	170162	A08p00260.2_BraZ1	127.059	+	764	551	551	1.0000000
A08	170411	171255	A08p00270.2_BraZ1	484.765	+	524	844	844	1.0000000
A08	172289	174046	A08p00280.2_BraZ1	756.462	-	1069	1757	1757	1.0000000
A08	190959	192539	A08p00290.2_BraZ1	381	-	418	1028	1580	0.6506329
A08	193481	196102	A08p00300.2_BraZ1	1881.71	-	1211	2535	2621	0.9671881
A08	197363	199358	A08p00310.2_BraZ1	921.493	-	492	1853	1995	0.9288220
A08	201964	204520	A08p00320.2_BraZ1	1064.33	-	1141	2304	2556	0.9014084
A08	205563	206040	A08p00330.2_BraZ1	47.7	+	137	477	477	1.0000000
A08	206757	208309	A08p00340.2_BraZ1	891.48	+	529	1437	1552	0.9259021
A08	208401	209977	A08p00350.2_BraZ1	45.9	+	715	1519	1576	0.9638325
A08	211586	212108	A08p00360.2_BraZ1	52.2	+	643	522	522	1.0000000
A08	216354	217662	A08p00370.2_BraZ1	1003.75	+	187	1061	1308	0.8111621
A08	219822	221130	A08p00380.2_BraZ1	130.8	-	240	1110	1308	0.8486239
A08	221759	222053	A08p00390.2_BraZ1	29.4	-	66	246	294	0.8367347
A08	227456	230716	A08p00400.2_BraZ1	2179.2	+	1062	2925	3260	0.8972393
A08	232058	234238	A08p00410.2_BraZ1	1015.43	+	1020	2143	2180	0.9830275
A08	242676	253973	A08p00420.2_BraZ1	2383.89	+	7758	11202	11297	0.9915907
A08	254538	255253	A08p00430.2_BraZ1	143.163	+	273	486	715	0.6797203
A08	260615	261318	A08p00440.2_BraZ1	447	+	252	581	703	0.8264580
A08	262125	265854	A08p00450.2_BraZ1	2202.92	+	376	2386	3729	0.6398498
A08	271857	275444	A08p00460.2_BraZ1	349.8	+	491	2563	3587	0.7145247
A08	304826	307470	A08p00470.2_BraZ1	1483.5	+	1212	2078	2644	0.7859304
A08	310800	311449	A08p00480.2_BraZ1	264	+	1154	649	649	1.0000000
A08	315951	316964	A08p00490.2_BraZ1	556.364	+	85	757	1013	0.7472853
A08	327823	327997	A08p00500.2_BraZ1	17.4	+	282	174	174	1.0000000
A08	330614	331000	A08p00510.2_BraZ1	357	-	23	293	386	0.7590674
A08	331506	331993	A08p00520.2_BraZ1	90	+	103	403	487	0.8275154
A08	335073	335616	A08p00530.2_BraZ1	54.3	+	627	543	543	1.0000000
A08	336460	337566	A08p00540.2_BraZ1	551.111	+	124	896	1106	0.8101266
A08	352823	355590	A08p00550.2_BraZ1	18765	-	546	1584	2767	0.5724611
A08	358695	361183	A08p00560.2_BraZ1	1581.25	+	102	890	2488	0.3577170
A08	361720	365589	A08p00570.2_BraZ1	2456.4	-	1397	3414	3869	0.8823985
A08	374068	382415	A08p00580.2_BraZ1	4883.62	+	2194	5666	8347	0.6788068
A08	383242	384922	A08p00590.2_BraZ1	1238.3	+	222	1286	1680	0.7654762
A08	385369	385689	A08p00600.2_BraZ1	192.5	-	38	113	320	0.3531250
A08	385869	386757	A08p00610.2_BraZ1	795	+	68	818	888	0.9211712
A08	387324	388644	A08p00620.2_BraZ1	744.716	+	921	1275	1320	0.9659091
A08	389973	390915	A08p00630.2_BraZ1	94.2	+	914	942	942	1.0000000
A08	422564	423994	A08p00640.2_BraZ1	1312	-	45	513	1430	0.3587413
A08	446092	447854	A08p00650.2_BraZ1	242.188	+	1016	1729	1762	0.9812713
A08	448467	450480	A08p00660.2_BraZ1	902.88	-	1342	2013	2013	1.0000000
A08	451017	452465	A08p00670.2_BraZ1	831	+	1079	1448	1448	1.0000000
A08	453336	454353	A08p00680.2_BraZ1	329.333	-	80	366	1017	0.3598820
A08	456277	460942	A08p00690.2_BraZ1	1261.84	+	3564	4648	4665	0.9963558
A08	462207	462766	A08p00700.2_BraZ1	330.6	-	249	434	559	0.7763864
A08	464016	465180	A08p00710.2_BraZ1	116.4	-	1355	1164	1164	1.0000000
A08	466220	468635	A08p00720.2_BraZ1	1262.73	-	2697	2415	2415	1.0000000
A08	475998	476243	A08p00730.2_BraZ1	14.1	-	243	245	245	1.0000000
A08	478227	480015	A08p00740.2_BraZ1	178.8	+	1446	1780	1788	0.9955257
A08	489329	489686	A08p00750.2_BraZ1	35.7	+	253	357	357	1.0000000
A08	494231	496126	A08p00760.2_BraZ1	582.5	+	1104	1876	1895	0.9899736
A08	496873	504909	A08p00770.2_BraZ1	7350.88	-	5971	8036	8036	1.0000000
A08	505039	505216	A08p00780.2_BraZ1	17.7	+	12	83	177	0.4689265
A08	506417	508943	A08p00790.2_BraZ1	1407.18	-	1084	2456	2526	0.9722882
A08	513961	519720	A08p00800.2_BraZ1	761.143	-	3092	5758	5759	0.9998264
A08	521453	522951	A08p00810.2_BraZ1	1177.21	+	1022	1498	1498	1.0000000
A08	525178	526682	A08p00820.2_BraZ1	1308	+	504	1504	1504	1.0000000
A08	536612	537993	A08p00830.2_BraZ1	594	-	660	1170	1381	0.8472121
A08	545054	549731	A08p00840.2_BraZ1	2496.93	-	2586	4050	4677	0.8659397
A08	555247	556536	A08p00850.2_BraZ1	1705	-	53	530	1289	0.4111714
A08	558525	561711	A08p00860.2_BraZ1	21779.7	-	210	1478	3186	0.4639046
A08	566531	567679	A08p00870.2_BraZ1	348	-	1567	1148	1148	1.0000000
A08	568025	568568	A08p00880.2_BraZ1	54.3	-	101	484	543	0.8913444
A08	586929	587499	A08p00890.2_BraZ1	57	+	116	537	570	0.9421052
A08	589286	590507	A08p00900.2_BraZ1	122.1	-	1173	1221	1221	1.0000000
A08	598601	599171	A08p00910.2_BraZ1	57	+	40	395	570	0.6929824
A08	600927	601324	A08p00920.2_BraZ1	324	-	133	397	397	1.0000000
A08	604970	607393	A08p00930.2_BraZ1	1457.7	+	1291	2054	2423	0.8477095
A08	623728	625714	A08p00940.2_BraZ1	429	-	193	1197	1986	0.6027190
A08	642063	643690	A08p00950.2_BraZ1	1323	+	220	1464	1627	0.8998156
A08	659909	660975	A08p00960.2_BraZ1	5430	-	326	1040	1066	0.9756098
A08	664448	667159	A08p00970.2_BraZ1	1472.39	-	1924	2474	2711	0.9125784
A08	667501	669579	A08p00980.2_BraZ1	555.1	+	1332	1791	2078	0.8618864
A08	673901	675888	A08p00990.2_BraZ1	1371	+	427	1292	1987	0.6502265
A08	676650	676989	A08p01000.2_BraZ1	246	-	152	339	339	1.0000000
A08	682717	689197	A08p01010.2_BraZ1	543	+	5163	6480	6480	1.0000000
A08	689350	689717	A08p01020.2_BraZ1	147	-	482	367	367	1.0000000
A08	690475	690876	A08p01030.2_BraZ1	270	-	506	401	401	1.0000000
A08	694478	698739	A08p01040.2_BraZ1	2054.8	-	2002	3480	4261	0.8167097
A08	699577	703421	A08p01050.2_BraZ1	450.926	+	1664	3712	3844	0.9656608
A08	703987	705373	A08p01060.2_BraZ1	660	+	110	570	1386	0.4112554
A08	714518	719061	A08p01070.2_BraZ1	3224.59	+	2910	4481	4543	0.9863526
A08	719359	719800	A08p01080.2_BraZ1	44.1	+	1674	441	441	1.0000000
A08	724894	725441	A08p01090.2_BraZ1	255	-	1297	547	547	1.0000000
A08	728860	730322	A08p01100.2_BraZ1	75721.5	-	729	1395	1462	0.9541724
A08	734554	734873	A08p01110.2_BraZ1	82.6875	-	57	211	319	0.6614420
A08	736041	736158	A08p01120.2_BraZ1	11.7	-	58	117	117	1.0000000
A08	736998	737352	A08p01130.2_BraZ1	213	-	39	281	354	0.7937853
A08	738225	739410	A08p01140.2_BraZ1	63.8182	+	1033	1185	1185	1.0000000
A08	739507	740236	A08p01150.2_BraZ1	256.909	+	839	729	729	1.0000000
A08	740712	741228	A08p01160.2_BraZ1	51.6	-	396	458	516	0.8875969
A08	742337	755301	A08p01170.2_BraZ1	4757.48	-	404	3775	12964	0.2911910
A08	768939	769461	A08p01180.2_BraZ1	29.7	-	94	522	522	1.0000000
A08	779294	780218	A08p01190.2_BraZ1	92.4	-	472	924	924	1.0000000
A08	800178	801138	A08p01200.2_BraZ1	496.316	+	485	889	960	0.9260417
A08	801321	803182	A08p01210.2_BraZ1	1103.24	-	1107	1604	1861	0.8619022
A08	805962	806818	A08p01220.2_BraZ1	12420	+	684	856	856	1.0000000
A08	808273	808552	A08p01230.2_BraZ1	27.9	-	210	279	279	1.0000000
A08	812631	813006	A08p01240.2_BraZ1	37.5	-	76	373	375	0.9946667
A08	816802	818626	A08p01250.2_BraZ1	182.4	-	714	1796	1824	0.9846491
A08	819942	822882	A08p01260.2_BraZ1	1460.66	+	2113	2940	2940	1.0000000
A08	823780	825676	A08p01270.2_BraZ1	189.6	-	625	1837	1896	0.9688818
A08	828045	830558	A08p01280.2_BraZ1	1133.83	+	1429	2489	2513	0.9904497
A08	831487	832417	A08p01290.2_BraZ1	93	-	763	930	930	1.0000000
A08	835270	836074	A08p01300.2_BraZ1	465	+	541	804	804	1.0000000
A08	838281	840214	A08p01310.2_BraZ1	789	-	935	1933	1933	1.0000000
A08	848870	849706	A08p01320.2_BraZ1	399	+	517	836	836	1.0000000
A08	854740	856553	A08p01330.2_BraZ1	1155	-	225	1584	1813	0.8736900
A08	898133	901440	A08p01340.2_BraZ1	1099.09	+	774	2886	3307	0.8726943
A08	905618	906769	A08p01350.2_BraZ1	1217.67	+	826	1151	1151	1.0000000
A08	906933	908184	A08p01360.2_BraZ1	110.7	-	323	977	1251	0.7809752
A08	919036	922652	A08p01370.2_BraZ1	1147.18	+	1846	3566	3616	0.9861726
A08	927822	933769	A08p01380.2_BraZ1	874.703	-	2162	5593	5947	0.9404742
A08	942953	945201	A08p01390.2_BraZ1	1156.3	-	587	1676	2248	0.7455516
A08	946540	948429	A08p01400.2_BraZ1	10494	-	1024	1359	1889	0.7194282
A08	959331	959805	A08p01410.2_BraZ1	369	-	293	474	474	1.0000000
A08	964810	966641	A08p01420.2_BraZ1	685.826	+	1582	1802	1831	0.9841617
A08	967376	969601	A08p01430.2_BraZ1	1131.14	+	1147	2077	2225	0.9334831
A08	970081	973624	A08p01440.2_BraZ1	2035.77	-	1830	3482	3543	0.9827830
A08	981196	984316	A08p01450.2_BraZ1	1358.83	+	2962	3120	3120	1.0000000
A08	984863	985010	A08p01460.2_BraZ1	14.7	-	274	147	147	1.0000000
A08	986986	989005	A08p01470.2_BraZ1	754.8	-	411	1807	2019	0.8949975
A08	992452	992644	A08p01480.2_BraZ1	19.2	+	19	161	192	0.8385417
A08	993581	996550	A08p01490.2_BraZ1	1339.8	+	542	2343	2969	0.7891546
A08	996526	996901	A08p01500.2_BraZ1	35.1	+	67	261	375	0.6960000
A08	1000040	1000631	A08p01510.2_BraZ1	153.31	+	358	591	591	1.0000000
A08	1022396	1029642	A08p01520.2_BraZ1	64.8	+	4524	6548	7246	0.9036710
A08	1049806	1050218	A08p01530.2_BraZ1	162	-	14	282	412	0.6844660
A08	1050176	1051639	A08p01540.2_BraZ1	264	-	12	547	1463	0.3738893
A08	1052505	1054358	A08p01550.2_BraZ1	675.127	+	1524	1853	1853	1.0000000
A08	1060842	1061133	A08p01560.2_BraZ1	17.4	-	364	291	291	1.0000000
A08	1064405	1064776	A08p01570.2_BraZ1	282	-	159	371	371	1.0000000
A08	1077777	1077945	A08p01580.2_BraZ1	15.3	-	69	168	168	1.0000000
A08	1089574	1091249	A08p01590.2_BraZ1	866.792	-	244	1487	1675	0.8877612
A08	1104411	1106365	A08p01600.2_BraZ1	1782	-	8	32	1954	0.0163767
A08	1108128	1109839	A08p01610.2_BraZ1	1275	+	172	695	1711	0.4061952
A08	1110883	1111786	A08p01620.2_BraZ1	339	+	192	588	903	0.6511628
A08	1112211	1113919	A08p01630.2_BraZ1	884.542	-	255	1278	1708	0.7482436
A08	1115116	1118622	A08p01640.2_BraZ1	2547.75	-	280	2680	3506	0.7644039
A08	1122056	1123834	A08p01650.2_BraZ1	769.5	+	1175	1770	1778	0.9955006
A08	1130239	1131358	A08p01660.2_BraZ1	111.9	+	441	972	1119	0.8686327
A08	1138799	1140146	A08p01670.2_BraZ1	134.7	+	268	1347	1347	1.0000000
A08	1142201	1142519	A08p01680.2_BraZ1	31.8	+	366	318	318	1.0000000
A08	1142828	1143056	A08p01690.2_BraZ1	22.8	-	477	228	228	1.0000000
A08	1144729	1145842	A08p01700.2_BraZ1	1086	+	1013	1113	1113	1.0000000
A08	1146120	1147188	A08p01710.2_BraZ1	106.8	-	1169	1068	1068	1.0000000
A08	1147455	1148835	A08p01720.2_BraZ1	138	-	787	1380	1380	1.0000000
A08	1150960	1154863	A08p01730.2_BraZ1	1073.19	+	1353	2962	3903	0.7589034
A08	1155445	1157392	A08p01740.2_BraZ1	844.2	+	2850	1947	1947	1.0000000
A08	1159182	1160800	A08p01750.2_BraZ1	825	-	888	1618	1618	1.0000000
A08	1166260	1170524	A08p01760.2_BraZ1	1829.48	+	3525	4264	4264	1.0000000
A08	1174100	1176759	A08p01770.2_BraZ1	1919.81	-	1469	2593	2659	0.9751787
A08	1184518	1186726	A08p01780.2_BraZ1	1213.46	+	1169	2056	2208	0.9311594
A08	1186912	1188679	A08p01790.2_BraZ1	176.7	-	201	1598	1767	0.9043577
A08	1190301	1191740	A08p01800.2_BraZ1	780.355	-	1174	1439	1439	1.0000000
A08	1191823	1192557	A08p01810.2_BraZ1	272	+	351	734	734	1.0000000
A08	1194453	1196281	A08p01820.2_BraZ1	6053.4	+	783	1519	1828	0.8309628
A08	1211545	1212577	A08p01830.2_BraZ1	103.2	+	1579	1032	1032	1.0000000
A08	1212664	1212769	A08p01840.2_BraZ1	10.5	+	226	105	105	1.0000000
A08	1216231	1217170	A08p01850.2_BraZ1	173.25	+	254	868	939	0.9243876
A08	1219086	1221914	A08p01860.2_BraZ1	1696.25	-	1145	2755	2828	0.9741867
A08	1228123	1231373	A08p01870.2_BraZ1	560.25	-	3752	3250	3250	1.0000000
A08	1243311	1244626	A08p01880.2_BraZ1	1029	-	61	750	1315	0.5703422
A08	1269580	1272038	A08p01890.2_BraZ1	11984.7	-	1906	2302	2458	0.9365337
A08	1295572	1296142	A08p01900.2_BraZ1	56.1	+	113	437	570	0.7666667
A08	1306059	1307157	A08p01910.2_BraZ1	109.8	-	656	1025	1098	0.9335155
A08	1309658	1310795	A08p01920.2_BraZ1	113.7	+	415	1137	1137	1.0000000
A08	1311812	1311983	A08p01930.2_BraZ1	15.9	-	199	171	171	1.0000000
A08	1315754	1316861	A08p01940.2_BraZ1	110.7	+	1367	1107	1107	1.0000000
A08	1319294	1321177	A08p01950.2_BraZ1	1457.37	+	729	1867	1883	0.9915029
A08	1323584	1326255	A08p01960.2_BraZ1	1867.32	-	480	1900	2671	0.7113441
A08	1335056	1337503	A08p01970.2_BraZ1	1548.6	+	105	1236	2447	0.5051083
A08	1345169	1346215	A08p01980.2_BraZ1	810	+	35	410	1046	0.3919694
A08	1351541	1351703	A08p01990.2_BraZ1	16.2	+	154	162	162	1.0000000
A08	1359044	1361922	A08p02000.2_BraZ1	1241.04	+	192	1761	2878	0.6118832
A08	1368027	1370121	A08p02010.2_BraZ1	804.586	+	399	1799	2094	0.8591213
A08	1385041	1385612	A08p02020.2_BraZ1	495	+	12	261	571	0.4570928
A08	1386137	1386335	A08p02030.2_BraZ1	19.8	+	11	55	198	0.2777778
A08	1389678	1390575	A08p02040.2_BraZ1	7392	-	47	644	897	0.7179487
A08	1403563	1404278	A08p02050.2_BraZ1	5928	+	14	21	715	0.0293706
A08	1406655	1407765	A08p02060.2_BraZ1	787.143	-	99	448	1110	0.4036036
A08	1420289	1422313	A08p02070.2_BraZ1	1244.56	-	305	618	2024	0.3053360
A08	1428546	1428967	A08p02080.2_BraZ1	35.1	+	354	421	421	1.0000000
A08	1441192	1443551	A08p02090.2_BraZ1	669.783	+	1231	2296	2359	0.9732938
A08	1450793	1451238	A08p02100.2_BraZ1	258	-	411	445	445	1.0000000
A08	1458238	1458938	A08p02110.2_BraZ1	1228.5	-	209	683	700	0.9757143
A08	1464034	1464875	A08p02120.2_BraZ1	254.25	+	250	760	841	0.9036861
A08	1474802	1475603	A08p02130.2_BraZ1	2254	+	189	652	801	0.8139825
A08	1479315	1484206	A08p02140.2_BraZ1	1930.5	+	1310	4053	4891	0.8286649
A08	1480451	1480721	A08p02150.2_BraZ1	204	-	131	270	270	1.0000000
A08	1484635	1484905	A08p02160.2_BraZ1	204	-	11	234	270	0.8666667
A08	1486801	1487581	A08p02170.2_BraZ1	162	+	7	155	780	0.1987180
A08	1487969	1488239	A08p02180.2_BraZ1	204	-	18	260	270	0.9629630
A08	1488765	1489011	A08p02190.2_BraZ1	24.6	+	1049	246	246	1.0000000
A08	1491351	1493104	A08p02200.2_BraZ1	975.625	+	4159	1753	1753	1.0000000
A08	1493609	1494070	A08p02210.2_BraZ1	384	-	13	382	461	0.8286334
A08	1497615	1497769	A08p02220.2_BraZ1	12.9	+	11	49	154	0.3181818
A08	1501859	1502198	A08p02230.2_BraZ1	33.9	+	5	48	339	0.1415929
A08	1505092	1506067	A08p02240.2_BraZ1	588	+	35	109	975	0.1117949
A08	1518744	1522496	A08p02250.2_BraZ1	465.429	-	3652	3752	3752	1.0000000
A08	1522738	1523797	A08p02260.2_BraZ1	501.93	+	180	1003	1059	0.9471200
A08	1525264	1528196	A08p02270.2_BraZ1	1547.84	+	342	1712	2932	0.5839018
A08	1529501	1541211	A08p02280.2_BraZ1	1272	+	2448	9139	11710	0.7804441
A08	1543921	1544281	A08p02290.2_BraZ1	36	-	109	354	360	0.9833333
A08	1552762	1553006	A08p02300.2_BraZ1	23.7	+	39	218	244	0.8934426
A08	1561306	1564155	A08p02310.2_BraZ1	510	+	994	2761	2849	0.9691120
A08	1569198	1571595	A08p02320.2_BraZ1	1523.52	-	565	2006	2397	0.8368794
A08	1574551	1575521	A08p02330.2_BraZ1	278.32	+	677	970	970	1.0000000
A08	1577393	1579943	A08p02340.2_BraZ1	1509.6	+	371	1761	2550	0.6905882
A08	1580999	1583011	A08p02350.2_BraZ1	553.255	+	821	1702	2012	0.8459244
A08	1583192	1586080	A08p02360.2_BraZ1	1333.54	-	1435	2869	2888	0.9934211
A08	1589880	1594914	A08p02370.2_BraZ1	248.379	+	2404	4563	5034	0.9064362
A08	1595258	1595628	A08p02380.2_BraZ1	252	+	55	305	370	0.8243243
A08	1595754	1596348	A08p02390.2_BraZ1	43.8	-	360	594	594	1.0000000
A08	1602122	1603326	A08p02400.2_BraZ1	1805.79	+	539	1204	1204	1.0000000
A08	1619183	1620955	A08p02410.2_BraZ1	260.182	-	1111	1704	1772	0.9616253
A08	1620744	1621411	A08p02420.2_BraZ1	124.091	-	714	667	667	1.0000000
A08	1627062	1630689	A08p02430.2_BraZ1	2380.61	+	1878	3294	3627	0.9081886
A08	1634488	1637626	A08p02440.2_BraZ1	3015	-	3064	3072	3138	0.9789675
A08	1648903	1651367	A08p02450.2_BraZ1	502.333	-	1285	2385	2464	0.9679383
A08	1651476	1651695	A08p02460.2_BraZ1	21.9	-	66	219	219	1.0000000
A08	1653801	1655879	A08p02470.2_BraZ1	720.528	+	1121	2061	2078	0.9918191
A08	1671708	1672323	A08p02480.2_BraZ1	61.5	+	282	497	615	0.8081301
A08	1676295	1676947	A08p02490.2_BraZ1	300	+	65	551	652	0.8450920
A08	1686400	1687259	A08p02500.2_BraZ1	450	+	701	859	859	1.0000000
A08	1688100	1690557	A08p02510.2_BraZ1	1746	-	644	2193	2457	0.8925519
A08	1699856	1703748	A08p02520.2_BraZ1	2015.9	+	1872	3602	3892	0.9254882
A08	1717233	1721339	A08p02530.2_BraZ1	1636.25	+	583	2887	4106	0.7031174
A08	1726489	1730252	A08p02540.2_BraZ1	2787	+	1531	3553	3763	0.9441935
A08	1737407	1737997	A08p02550.2_BraZ1	240	-	462	590	590	1.0000000
A08	1738733	1740404	A08p02560.2_BraZ1	206.125	-	764	1664	1671	0.9958109
A08	1747308	1747503	A08p02570.2_BraZ1	19.5	+	30	195	195	1.0000000
A08	1751943	1753286	A08p02580.2_BraZ1	1093.67	+	192	995	1343	0.7408786
A08	1756038	1759212	A08p02590.2_BraZ1	1533.79	+	1400	2255	3174	0.7104600
A08	1760112	1760509	A08p02600.2_BraZ1	162	-	70	371	397	0.9345088
A08	1764837	1765919	A08p02610.2_BraZ1	897.25	-	205	703	1082	0.6497228
A08	1768393	1769819	A08p02620.2_BraZ1	585.265	-	677	1386	1426	0.9719495
A08	1778969	1782447	A08p02630.2_BraZ1	1701.6	+	1954	3087	3478	0.8875791
A08	1784385	1786255	A08p02640.2_BraZ1	730.8	+	1117	1841	1870	0.9844920
A08	1786255	1786589	A08p02650.2_BraZ1	213	+	312	274	334	0.8203593
A08	1788895	1789644	A08p02660.2_BraZ1	708	-	125	669	749	0.8931909
A08	1789469	1792205	A08p02670.2_BraZ1	618.244	+	1384	2368	2736	0.8654971
A08	1792724	1795965	A08p02680.2_BraZ1	1841.25	-	864	3204	3241	0.9885837
A08	1798079	1798554	A08p02690.2_BraZ1	345	+	41	122	475	0.2568421
A08	1799447	1802779	A08p02700.2_BraZ1	1208.47	+	2699	3332	3332	1.0000000
A08	1804527	1805133	A08p02710.2_BraZ1	60.6	-	330	606	606	1.0000000
A08	1807050	1810176	A08p02720.2_BraZ1	646.541	-	2166	3061	3126	0.9792067
A08	1812218	1813286	A08p02730.2_BraZ1	106.8	-	502	1068	1068	1.0000000
A08	1822962	1823541	A08p02740.2_BraZ1	213	-	589	579	579	1.0000000
A08	1827867	1829636	A08p02750.2_BraZ1	1227.99	+	763	1492	1769	0.8434144
A08	1830055	1830829	A08p02760.2_BraZ1	522	+	406	774	774	1.0000000
A08	1831190	1833067	A08p02770.2_BraZ1	818.043	-	870	1711	1877	0.9115610
A08	1833777	1836850	A08p02780.2_BraZ1	1667.21	+	671	2708	3073	0.8812236
A08	1837023	1839334	A08p02790.2_BraZ1	1684.76	-	383	1631	2311	0.7057551
A08	1839827	1841961	A08p02800.2_BraZ1	1419	-	1505	2054	2134	0.9625117
A08	1842718	1844270	A08p02810.2_BraZ1	603	+	338	1456	1552	0.9381443
A08	1851472	1852222	A08p02820.2_BraZ1	312	+	131	688	750	0.9173333
A08	1852480	1852801	A08p02830.2_BraZ1	237	+	336	321	321	1.0000000
A08	1853121	1853298	A08p02840.2_BraZ1	17.7	-	54	171	177	0.9661017
A08	1864128	1864869	A08p02850.2_BraZ1	74.1	-	357	741	741	1.0000000
A08	1871117	1871438	A08p02860.2_BraZ1	237	+	1217	321	321	1.0000000
A08	1875948	1876269	A08p02870.2_BraZ1	237	+	38	321	321	1.0000000
A08	1877916	1878271	A08p02880.2_BraZ1	324	+	15	221	355	0.6225352
A08	1880699	1881022	A08p02890.2_BraZ1	237	+	507	323	323	1.0000000
A08	1885837	1886349	A08p02900.2_BraZ1	402	+	236	512	512	1.0000000
A08	1888421	1889200	A08p02910.2_BraZ1	654	-	309	776	779	0.9961489
A08	1901979	1902596	A08p02920.2_BraZ1	504	+	758	617	617	1.0000000
A08	1913172	1914192	A08p02930.2_BraZ1	102	+	28	511	1020	0.5009804
A08	1917805	1918803	A08p02940.2_BraZ1	97.8	-	7	272	998	0.2725451
A08	1924733	1925090	A08p02950.2_BraZ1	35.7	+	101	357	357	1.0000000
A08	1929251	1930787	A08p02960.2_BraZ1	430.93	+	888	1445	1536	0.9407552
A08	1943759	1943978	A08p02970.2_BraZ1	21.9	+	7	127	219	0.5799087
A08	1943993	1944203	A08p02980.2_BraZ1	21	+	106	210	210	1.0000000
A08	1946481	1947513	A08p02990.2_BraZ1	639	+	785	1032	1032	1.0000000
A08	1948384	1952851	A08p03000.2_BraZ1	2056	-	1221	3162	4467	0.7078576
A08	1958572	1959439	A08p03010.2_BraZ1	86.7	-	285	864	867	0.9965398
A08	1962236	1963203	A08p03020.2_BraZ1	55.8	-	1179	967	967	1.0000000
A08	1971815	1973183	A08p03030.2_BraZ1	106.2	+	292	1127	1368	0.8238304
A08	1979117	2005014	A08p03040.2_BraZ1	561.959	-	12869	20823	25897	0.8040700
A08	1993939	1995190	A08p03050.2_BraZ1	177	+	718	1251	1251	1.0000000
A08	2002165	2003049	A08p03060.2_BraZ1	288.261	-	141	759	884	0.8585973
A08	2002860	2004830	A08p03070.2_BraZ1	414.157	-	1665	1970	1970	1.0000000
A08	2005014	2007336	A08p03080.2_BraZ1	1074.4	-	4331	2322	2322	1.0000000
A08	2009433	2009679	A08p03090.2_BraZ1	24.6	-	321	246	246	1.0000000
A08	2011484	2014143	A08p03100.2_BraZ1	1256.1	+	1353	2659	2659	1.0000000
A08	2015531	2024435	A08p03110.2_BraZ1	165.281	+	2197	7889	8904	0.8860063
A08	2024230	2025477	A08p03120.2_BraZ1	102.375	+	698	1171	1247	0.9390537
A08	2030374	2030689	A08p03130.2_BraZ1	31.5	+	18	218	315	0.6920635
A08	2049052	2049658	A08p03140.2_BraZ1	60.6	+	407	606	606	1.0000000
A08	2067342	2068329	A08p03150.2_BraZ1	244.4	-	72	672	987	0.6808510
A08	2068329	2069185	A08p03160.2_BraZ1	490.44	-	109	838	856	0.9789720
A08	2079402	2080116	A08p03170.2_BraZ1	52.2	+	393	690	714	0.9663866
A08	2080873	2082918	A08p03180.2_BraZ1	920.184	+	1688	2024	2045	0.9897311
A08	2084665	2085988	A08p03190.2_BraZ1	132.3	+	494	1062	1323	0.8027211
A08	2087095	2089064	A08p03200.2_BraZ1	1262.25	-	284	1349	1969	0.6851193
A08	2096545	2098185	A08p03210.2_BraZ1	1339.3	+	215	1283	1640	0.7823171
A08	2100429	2101877	A08p03220.2_BraZ1	1019.65	+	669	1366	1448	0.9433702
A08	2103186	2105118	A08p03230.2_BraZ1	1214.18	-	479	1320	1932	0.6832298
A08	2113773	2115567	A08p03240.2_BraZ1	971.374	+	266	1002	1794	0.5585284
A08	2117710	2119915	A08p03250.2_BraZ1	1813.3	-	8	69	2205	0.0312925
A08	2124682	2125657	A08p03260.2_BraZ1	198	-	303	942	975	0.9661539
A08	2127737	2128369	A08p03270.2_BraZ1	345.938	+	222	632	632	1.0000000
A08	2128760	2131803	A08p03280.2_BraZ1	1474.1	-	496	2091	3043	0.6871508
A08	2135058	2135516	A08p03290.2_BraZ1	180	+	1	44	458	0.0960699
A08	2135826	2137409	A08p03300.2_BraZ1	721.65	-	111	1103	1583	0.6967783
A08	2139045	2139330	A08p03310.2_BraZ1	201	-	0	0	285	0.0000000
A08	2144825	2148255	A08p03320.2_BraZ1	1004.32	+	757	2930	3430	0.8542274
A08	2151801	2153139	A08p03330.2_BraZ1	133.8	+	129	1032	1338	0.7713004
A08	2153829	2156101	A08p03340.2_BraZ1	1575	-	1326	2272	2272	1.0000000
A08	2160761	2161538	A08p03350.2_BraZ1	588	+	53	776	777	0.9987130
A08	2169256	2173490	A08p03360.2_BraZ1	1958.86	-	1058	3554	4234	0.8393953
A08	2174428	2178328	A08p03370.2_BraZ1	853.043	+	1613	3699	3900	0.9484615
A08	2179776	2182403	A08p03380.2_BraZ1	921.551	-	3081	2625	2627	0.9992387
A08	2195852	2198510	A08p03390.2_BraZ1	360	+	212	1918	2658	0.7215952
A08	2203494	2212259	A08p03400.2_BraZ1	1177	+	6789	8268	8765	0.9432972
A08	2236892	2237168	A08p03410.2_BraZ1	27.6	-	22	105	276	0.3804348
A08	2238458	2238913	A08p03420.2_BraZ1	264	-	383	455	455	1.0000000
A08	2242898	2244116	A08p03430.2_BraZ1	333	-	138	837	1218	0.6871921
A08	2248746	2251249	A08p03440.2_BraZ1	940.594	+	590	1984	2503	0.7926488
A08	2258310	2258912	A08p03450.2_BraZ1	218.7	-	207	575	602	0.9551495
A08	2259387	2259785	A08p03460.2_BraZ1	21.6	-	161	397	398	0.9974874
A08	2264977	2267445	A08p03470.2_BraZ1	1674.82	+	153	1536	2468	0.6223663
A08	2268455	2275360	A08p03480.2_BraZ1	3030.69	-	3358	5786	6905	0.8379435
A08	2279845	2286740	A08p03490.2_BraZ1	2540.12	+	5984	6861	6895	0.9950689
A08	2289915	2294082	A08p03500.2_BraZ1	1666.8	-	2388	3863	4167	0.9270458
A08	2294747	2296277	A08p03510.2_BraZ1	638.825	-	1230	1494	1530	0.9764706
A08	2297792	2305328	A08p03520.2_BraZ1	2850.38	+	2198	6806	7536	0.9031317
A08	2307338	2311439	A08p03530.2_BraZ1	1487.08	-	2950	4055	4101	0.9887832
A08	2317103	2319296	A08p03540.2_BraZ1	219.3	-	125	1205	2193	0.5494756
A08	2325600	2326579	A08p03550.2_BraZ1	353.523	+	136	912	979	0.9315628
A08	2334763	2337518	A08p03560.2_BraZ1	1035.91	+	481	1327	2755	0.4816697
A08	2338443	2338798	A08p03570.2_BraZ1	240	+	34	296	355	0.8338028
A08	2339889	2340998	A08p03580.2_BraZ1	638.182	+	570	1051	1109	0.9477006
A08	2341526	2343447	A08p03590.2_BraZ1	47129.5	-	743	1803	1921	0.9385737
A08	2347282	2359714	A08p03600.2_BraZ1	2394	-	4255	9299	12432	0.7479891
A08	2361023	2363041	A08p03610.2_BraZ1	378	+	1464	1987	2018	0.9846383
A08	2364851	2366159	A08p03620.2_BraZ1	237	+	1112	1308	1308	1.0000000
A08	2371128	2373779	A08p03630.2_BraZ1	945.835	+	2410	2651	2651	1.0000000
A08	2373979	2376902	A08p03640.2_BraZ1	1491.82	-	1052	2632	2923	0.9004447
A08	2379380	2380986	A08p03650.2_BraZ1	639.625	+	1097	1606	1606	1.0000000
A08	2381559	2383862	A08p03660.2_BraZ1	981.196	-	1727	2072	2303	0.8996961
A08	2384780	2384954	A08p03670.2_BraZ1	17.4	+	19	174	174	1.0000000
A08	2387401	2388757	A08p03680.2_BraZ1	135.6	+	283	1033	1356	0.7617994
A08	2392573	2392866	A08p03690.2_BraZ1	28.2	+	44	286	293	0.9761092
A08	2392999	2393623	A08p03700.2_BraZ1	510	+	17	336	624	0.5384616
A08	2394460	2394592	A08p03710.2_BraZ1	13.2	-	0	0	132	0.0000000
A08	2401318	2404139	A08p03720.2_BraZ1	1560.6	-	1777	2740	2821	0.9712868
A08	2412230	2413854	A08p03730.2_BraZ1	559.636	-	969	1601	1624	0.9858375
A08	2419595	2422599	A08p03740.2_BraZ1	2325.89	-	796	1961	3004	0.6527963
A08	2438565	2439322	A08p03750.2_BraZ1	6660	+	54	460	757	0.6076618
A08	2440244	2441853	A08p03760.2_BraZ1	1431	-	239	1609	1609	1.0000000
A08	2445317	2445862	A08p03770.2_BraZ1	264	-	321	545	545	1.0000000
A08	2450869	2451700	A08p03780.2_BraZ1	83.1	-	48	520	831	0.6257521
A08	2453145	2455841	A08p03790.2_BraZ1	1275	-	323	2255	2696	0.8364244
A08	2460040	2460344	A08p03800.2_BraZ1	201	-	0	0	304	0.0000000
A08	2466987	2468052	A08p03810.2_BraZ1	106.5	+	249	866	1065	0.8131455
A08	2469137	2470570	A08p03820.2_BraZ1	891	+	96	1045	1433	0.7292393
A08	2469875	2470095	A08p03830.2_BraZ1	132	+	7	220	220	1.0000000
A08	2471196	2477359	A08p03840.2_BraZ1	2547.04	-	3246	5886	6163	0.9550543
A08	2478358	2478730	A08p03850.2_BraZ1	27	-	299	372	372	1.0000000
A08	2479023	2479188	A08p03860.2_BraZ1	16.5	-	522	165	165	1.0000000
A08	2488903	2489362	A08p03870.2_BraZ1	162	+	228	459	459	1.0000000
A08	2489457	2489823	A08p03880.2_BraZ1	267	-	505	366	366	1.0000000
A08	2495951	2496539	A08p03890.2_BraZ1	180	-	61	237	588	0.4030612
A08	2496723	2498377	A08p03900.2_BraZ1	297	-	389	713	1654	0.4310762
A08	2499378	2499988	A08p03910.2_BraZ1	306	+	282	610	610	1.0000000
A08	2511284	2513643	A08p03920.2_BraZ1	1403	-	506	2282	2359	0.9673591
A08	2523068	2524975	A08p03930.2_BraZ1	1005.81	+	91	851	1907	0.4462506
A08	2525831	2527719	A08p03940.2_BraZ1	1428	-	1011	1857	1888	0.9835805
A08	2529704	2531665	A08p03950.2_BraZ1	417	-	1549	1961	1961	1.0000000
A08	2532846	2534118	A08p03960.2_BraZ1	127.2	-	79	705	1272	0.5542453
A08	2551644	2551974	A08p03970.2_BraZ1	33	-	0	0	330	0.0000000
A08	2562336	2563176	A08p03980.2_BraZ1	84	+	13	114	840	0.1357143
A08	2564153	2567086	A08p03990.2_BraZ1	1542.25	-	348	1848	2933	0.6300716
A08	2573969	2576746	A08p04000.2_BraZ1	1013.48	-	1007	2418	2777	0.8707238
A08	2583931	2584368	A08p04010.2_BraZ1	357	-	355	437	437	1.0000000
A08	2585211	2585529	A08p04020.2_BraZ1	31.8	-	279	318	318	1.0000000
A08	2586133	2593394	A08p04030.2_BraZ1	774.321	+	1998	6305	7261	0.8683377
A08	2596080	2597286	A08p04040.2_BraZ1	1026	+	87	773	1206	0.6409619
A08	2603671	2604049	A08p04050.2_BraZ1	37.8	+	115	245	378	0.6481481
A08	2605302	2606040	A08p04060.2_BraZ1	378	+	1	72	738	0.0975610
A08	2608287	2609152	A08p04070.2_BraZ1	636	+	407	865	865	1.0000000
A08	2620762	2621967	A08p04080.2_BraZ1	903	+	408	1176	1205	0.9759336
A08	2639140	2639332	A08p04090.2_BraZ1	19.2	+	1	116	192	0.6041667
A08	2640814	2641162	A08p04100.2_BraZ1	34.8	+	99	348	348	1.0000000
A08	2641621	2643823	A08p04110.2_BraZ1	220.2	+	428	1534	2202	0.6966394
A08	2655294	2656115	A08p04120.2_BraZ1	661.857	+	313	821	821	1.0000000
A08	2657059	2657819	A08p04130.2_BraZ1	7762.5	-	46	299	760	0.3934211
A08	2660989	2661889	A08p04140.2_BraZ1	90	-	95	732	900	0.8133333
A08	2665814	2667215	A08p04150.2_BraZ1	140.1	-	525	1334	1401	0.9521770
A08	2689693	2691098	A08p04160.2_BraZ1	468	+	6	205	1405	0.1459075
A08	2692577	2693693	A08p04170.2_BraZ1	111.6	-	253	972	1116	0.8709677
A08	2696509	2697567	A08p04180.2_BraZ1	165	+	914	1058	1058	1.0000000
A08	2701657	2702486	A08p04190.2_BraZ1	202.5	-	2415	829	829	1.0000000
A08	2705535	2706395	A08p04200.2_BraZ1	184.889	-	139	710	860	0.8255814
A08	2707733	2708048	A08p04210.2_BraZ1	31.5	-	120	315	315	1.0000000
A08	2708115	2708726	A08p04220.2_BraZ1	45.6	+	160	468	611	0.7659575
A08	2709465	2710737	A08p04230.2_BraZ1	331.2	-	417	1110	1272	0.8726415
A08	2709778	2709999	A08p04240.2_BraZ1	171	-	141	221	221	1.0000000
A08	2711080	2713362	A08p04250.2_BraZ1	1407.62	-	1164	2170	2282	0.9509202
A08	2716387	2716579	A08p04260.2_BraZ1	19.2	-	143	192	192	1.0000000
A08	2716673	2717055	A08p04270.2_BraZ1	1228.5	+	305	382	382	1.0000000
A08	2721835	2722808	A08p04280.2_BraZ1	393	+	1507	973	973	1.0000000
A08	2725330	2727553	A08p04290.2_BraZ1	981.214	-	988	2008	2223	0.9032838
A08	2730818	2732075	A08p04300.2_BraZ1	2425.71	-	382	618	1257	0.4916468
A08	2743134	2743499	A08p04310.2_BraZ1	246	+	42	237	365	0.6493151
A08	2747559	2748848	A08p04320.2_BraZ1	558.9	-	455	1026	1289	0.7959659
A08	2749889	2755164	A08p04330.2_BraZ1	570	-	248	2238	5275	0.4242654
A08	2757066	2757300	A08p04340.2_BraZ1	23.4	-	84	234	234	1.0000000
A08	2759502	2760769	A08p04350.2_BraZ1	1664.44	+	714	1082	1267	0.8539858
A08	2764093	2764513	A08p04360.2_BraZ1	42	+	428	420	420	1.0000000
A08	2766140	2767106	A08p04370.2_BraZ1	759	-	24	598	966	0.6190476
A08	2787181	2790769	A08p04380.2_BraZ1	768	-	169	1966	3588	0.5479376
A08	2802403	2803031	A08p04390.2_BraZ1	207	+	198	580	628	0.9235669
A08	2811652	2813392	A08p04400.2_BraZ1	1244.76	-	161	1223	1740	0.7028736
A08	2826094	2828024	A08p04410.2_BraZ1	626.266	+	951	1930	1930	1.0000000
A08	2836617	2840561	A08p04420.2_BraZ1	2465	+	345	2330	3944	0.5907708
A08	2846538	2847614	A08p04430.2_BraZ1	984	-	127	776	1076	0.7211896
A08	2848358	2848550	A08p04440.2_BraZ1	19.2	+	368	192	192	1.0000000
A08	2854591	2854888	A08p04450.2_BraZ1	29.7	+	39	223	297	0.7508417
A08	2870200	2871278	A08p04460.2_BraZ1	726.857	-	0	0	1078	0.0000000
A08	2879108	2880074	A08p04470.2_BraZ1	411	-	670	966	966	1.0000000
A08	2887793	2888228	A08p04480.2_BraZ1	351	-	426	435	435	1.0000000
A08	2889043	2889664	A08p04490.2_BraZ1	62.1	-	188	583	621	0.9388084
A08	2894197	2894659	A08p04500.2_BraZ1	46.2	+	0	0	462	0.0000000
A08	2895403	2895904	A08p04510.2_BraZ1	50.1	-	4	81	501	0.1616766
A08	2907086	2909777	A08p04520.2_BraZ1	1769.54	+	1014	1979	2691	0.7354143
A08	2910368	2923000	A08p04530.2_BraZ1	589.091	-	264	4121	12632	0.3262350
A08	2925938	2928778	A08p04540.2_BraZ1	1599.23	-	1386	2564	2840	0.9028169
A08	2930862	2932324	A08p04550.2_BraZ1	271.575	+	404	1000	1462	0.6839945
A08	2933145	2936136	A08p04560.2_BraZ1	1306.62	-	1041	2971	2991	0.9933133
A08	2939294	2939945	A08p04570.2_BraZ1	65.1	-	732	651	651	1.0000000
A08	2947965	2948290	A08p04580.2_BraZ1	231	+	93	325	325	1.0000000
A08	2953914	2956608	A08p04590.2_BraZ1	1482.33	+	720	2429	2694	0.9016333
A08	2957131	2957549	A08p04600.2_BraZ1	162	+	522	418	418	1.0000000
A08	2958167	2959668	A08p04610.2_BraZ1	1380.68	-	733	1438	1501	0.9580280
A08	2971613	2971887	A08p04620.2_BraZ1	180	-	240	274	274	1.0000000
A08	2976865	2977345	A08p04630.2_BraZ1	48	+	118	480	480	1.0000000
A08	2987973	2990522	A08p04640.2_BraZ1	1244.82	+	1519	2549	2549	1.0000000
A08	2996397	2997687	A08p04650.2_BraZ1	129	-	1482	1290	1290	1.0000000
A08	3002363	3003568	A08p04660.2_BraZ1	621	-	325	1205	1205	1.0000000
A08	3004081	3004228	A08p04670.2_BraZ1	14.7	-	250	147	147	1.0000000
A08	3004631	3005558	A08p04680.2_BraZ1	538.667	-	1830	927	927	1.0000000
A08	3009726	3012416	A08p04690.2_BraZ1	1426.43	+	1416	2588	2690	0.9620818
A08	3012567	3012957	A08p04700.2_BraZ1	14.1	+	228	390	390	1.0000000
A08	3013526	3014140	A08p04710.2_BraZ1	492	-	427	614	614	1.0000000
A08	3028812	3029106	A08p04720.2_BraZ1	29.4	-	4	16	294	0.0544218
A08	3031484	3054468	A08p04730.2_BraZ1	246	-	11590	22422	22984	0.9755482
A08	3040352	3042673	A08p04740.2_BraZ1	718.588	+	465	2267	2321	0.9767342
A08	3043441	3045320	A08p04750.2_BraZ1	624.65	+	624	1871	1879	0.9957424
A08	3049885	3051099	A08p04760.2_BraZ1	220.5	-	589	1201	1214	0.9892916
A08	3066391	3066778	A08p04770.2_BraZ1	38.7	-	33	203	387	0.5245478
A08	3068197	3069713	A08p04780.2_BraZ1	36	+	1930	1516	1516	1.0000000
A08	3068590	3069199	A08p04790.2_BraZ1	60.9	-	944	609	609	1.0000000
A08	3084584	3086733	A08p04800.2_BraZ1	824.571	-	743	1992	2149	0.9269428
A08	3093571	3094375	A08p04810.2_BraZ1	407.071	+	1177	804	804	1.0000000
A08	3095660	3096215	A08p04820.2_BraZ1	471	-	678	555	555	1.0000000
A08	3103332	3103713	A08p04830.2_BraZ1	38.1	-	101	367	381	0.9632546
A08	3105257	3105416	A08p04840.2_BraZ1	15.9	+	199	159	159	1.0000000
A08	3112914	3113261	A08p04850.2_BraZ1	120	+	1035	347	347	1.0000000
A08	3115120	3115782	A08p04860.2_BraZ1	436.5	+	860	662	662	1.0000000
A08	3117055	3117634	A08p04870.2_BraZ1	57.9	+	108	320	579	0.5526770
A08	3118245	3133166	A08p04880.2_BraZ1	1809	+	1232	7912	14921	0.5302594
A08	3135912	3136136	A08p04890.2_BraZ1	20.1	+	202	224	224	1.0000000
A08	3137567	3138652	A08p04900.2_BraZ1	576.783	+	1026	1085	1085	1.0000000
A08	3142165	3142801	A08p04910.2_BraZ1	420	+	314	636	636	1.0000000
A08	3150287	3151342	A08p04920.2_BraZ1	513	-	746	1037	1055	0.9829384
A08	3162495	3163877	A08p04930.2_BraZ1	402	-	1879	1382	1382	1.0000000
A08	3162861	3163173	A08p04940.2_BraZ1	31.2	+	806	312	312	1.0000000
A08	3168680	3172686	A08p04950.2_BraZ1	1387.71	-	2699	4006	4006	1.0000000
A08	3174179	3174494	A08p04960.2_BraZ1	31.5	-	243	315	315	1.0000000
A08	3185558	3187305	A08p04970.2_BraZ1	1530	-	1419	1747	1747	1.0000000
A08	3200335	3200529	A08p04980.2_BraZ1	18.9	-	44	194	194	1.0000000
A08	3200673	3201258	A08p04990.2_BraZ1	153	-	117	572	585	0.9777778
A08	3214151	3220336	A08p05000.2_BraZ1	3272.4	+	1198	4619	6185	0.7468068
A08	3222265	3224549	A08p05010.2_BraZ1	2004	-	709	2120	2284	0.9281961
A08	3233547	3234931	A08p05020.2_BraZ1	811.862	-	227	990	1384	0.7153179
A08	3242390	3243393	A08p05030.2_BraZ1	391.696	-	943	1003	1003	1.0000000
A08	3243930	3247492	A08p05040.2_BraZ1	1640.47	+	2302	3436	3562	0.9646266
A08	3251617	3256772	A08p05050.2_BraZ1	3028.15	+	506	3524	5155	0.6836082
A08	3285894	3286870	A08p05060.2_BraZ1	888	+	506	976	976	1.0000000
A08	3288815	3290486	A08p05070.2_BraZ1	945	+	984	1624	1671	0.9718731
A08	3290750	3293392	A08p05080.2_BraZ1	1977.13	-	153	1734	2642	0.6563210
A08	3294169	3298224	A08p05090.2_BraZ1	2316.08	-	2046	3605	4055	0.8890259
A08	3298416	3299446	A08p05100.2_BraZ1	100.5	-	949	1030	1030	1.0000000
A08	3300146	3300945	A08p05110.2_BraZ1	516	-	360	799	799	1.0000000
A08	3304350	3304584	A08p05120.2_BraZ1	23.4	-	5	35	234	0.1495727
A08	3327451	3327553	A08p05130.2_BraZ1	10.2	+	163	102	102	1.0000000
A08	3331343	3331634	A08p05140.2_BraZ1	180	+	229	291	291	1.0000000
A08	3334539	3338638	A08p05150.2_BraZ1	528	-	537	1354	4099	0.3303245
A08	3337926	3338924	A08p05160.2_BraZ1	299.25	-	230	898	998	0.8997996
A08	3342536	3343083	A08p05170.2_BraZ1	468	+	96	468	547	0.8555759
A08	3345037	3345283	A08p05180.2_BraZ1	198	+	288	246	246	1.0000000
A08	3346369	3347227	A08p05190.2_BraZ1	1070.14	-	1312	858	858	1.0000000
A08	3349298	3350452	A08p05200.2_BraZ1	1071	-	362	1126	1154	0.9757366
A08	3355270	3355387	A08p05210.2_BraZ1	11.7	+	1	49	117	0.4188034
A08	3356331	3356448	A08p05220.2_BraZ1	11.7	+	0	0	117	0.0000000
A08	3378244	3382434	A08p05230.2_BraZ1	1030.52	+	3658	4105	4190	0.9797136
A08	3382788	3383486	A08p05240.2_BraZ1	2587.2	-	863	698	698	1.0000000
A08	3388882	3395678	A08p05250.2_BraZ1	310.227	+	1448	5272	6796	0.7757505
A08	3396136	3407040	A08p05260.2_BraZ1	1280.4	-	5543	10344	10904	0.9486427
A08	3397462	3402904	A08p05270.2_BraZ1	361.818	+	3640	5442	5442	1.0000000
A08	3399399	3400224	A08p05280.2_BraZ1	276	+	539	825	825	1.0000000
A08	3403427	3404653	A08p05290.2_BraZ1	814.455	-	44	922	1226	0.7520391
A08	3405097	3406205	A08p05300.2_BraZ1	546.75	-	539	985	1108	0.8889892
A08	3407280	3408192	A08p05310.2_BraZ1	391.227	+	701	912	912	1.0000000
A08	3408633	3410796	A08p05320.2_BraZ1	911.786	-	973	1522	2163	0.7036523
A08	3419480	3419885	A08p05330.2_BraZ1	249	+	38	405	405	1.0000000
A08	3424812	3428704	A08p05340.2_BraZ1	3850	-	135	1494	3892	0.3838643
A08	3430235	3431852	A08p05350.2_BraZ1	343.838	+	253	1356	1617	0.8385900
A08	3435294	3437315	A08p05360.2_BraZ1	977.4	-	508	1726	2021	0.8540326
A08	3439424	3440312	A08p05370.2_BraZ1	813.75	+	1612	888	888	1.0000000
A08	3457514	3457920	A08p05380.2_BraZ1	249	+	60	278	406	0.6847290
A08	3459739	3460388	A08p05390.2_BraZ1	267.304	+	2	238	649	0.3667180
A08	3460441	3462353	A08p05400.2_BraZ1	272.935	+	998	1881	1912	0.9837866
A08	3462800	3467417	A08p05410.2_BraZ1	768.491	-	6638	4584	4617	0.9928525
A08	3469794	3470949	A08p05420.2_BraZ1	114.3	-	81	728	1155	0.6303030
A08	3471649	3473420	A08p05430.2_BraZ1	538.239	-	299	885	1771	0.4997177
A08	3474186	3480018	A08p05440.2_BraZ1	614.714	+	6591	5789	5832	0.9926269
A08	3480357	3480806	A08p05450.2_BraZ1	265.645	-	612	449	449	1.0000000
A08	3494116	3494904	A08p05460.2_BraZ1	758.143	-	8855	788	788	1.0000000
A08	3496633	3496991	A08p05470.2_BraZ1	279	+	385	358	358	1.0000000
A08	3505919	3530433	A08p05480.2_BraZ1	1242.3	+	477	6392	24514	0.2607490
A08	3572779	3573187	A08p05490.2_BraZ1	312	-	80	345	408	0.8455882
A08	3575801	3579110	A08p05500.2_BraZ1	1952.48	-	388	2173	3309	0.6566939
A08	3584836	3585370	A08p05510.2_BraZ1	53.4	-	34	201	534	0.3764045
A08	3592247	3598550	A08p05520.2_BraZ1	234	-	6444	6303	6303	1.0000000
A08	3600517	3600787	A08p05530.2_BraZ1	27	-	250	270	270	1.0000000
A08	3601394	3601613	A08p05540.2_BraZ1	11.4	-	241	219	219	1.0000000
A08	3606074	3607658	A08p05550.2_BraZ1	9416.25	+	434	1507	1584	0.9513889
A08	3611409	3611517	A08p05560.2_BraZ1	10.8	-	66	108	108	1.0000000
A08	3611938	3615284	A08p05570.2_BraZ1	3240	+	1287	3014	3346	0.9007770
A08	3620985	3623211	A08p05580.2_BraZ1	1040.81	-	217	1534	2226	0.6891285
A08	3630554	3631564	A08p05590.2_BraZ1	3336	-	30	286	1010	0.2831683
A08	3646658	3647176	A08p05600.2_BraZ1	483	+	457	518	518	1.0000000
A08	3649883	3652112	A08p05610.2_BraZ1	1257	+	68	939	2229	0.4212652
A08	3660618	3662249	A08p05620.2_BraZ1	936.545	+	567	1513	1631	0.9276518
A08	3679598	3680377	A08p05630.2_BraZ1	124.95	-	266	598	779	0.7676508
A08	3682693	3683431	A08p05640.2_BraZ1	72.3	+	307	738	738	1.0000000
A08	3683598	3684711	A08p05650.2_BraZ1	823.44	-	208	745	1113	0.6693621
A08	3690766	3690937	A08p05660.2_BraZ1	17.1	-	0	0	171	0.0000000
A08	3691357	3692486	A08p05670.2_BraZ1	687.75	+	8	55	1129	0.0487157
A08	3701027	3702271	A08p05680.2_BraZ1	6228	-	21	410	1244	0.3295820
A08	3707278	3708379	A08p05690.2_BraZ1	214	-	266	1044	1101	0.9482289
A08	3718124	3719306	A08p05700.2_BraZ1	930	-	418	1182	1182	1.0000000
A08	3720064	3721728	A08p05710.2_BraZ1	1057.18	+	596	1318	1664	0.7920673
A08	3727006	3728467	A08p05720.2_BraZ1	3300	+	1941	1461	1461	1.0000000
A08	3728669	3729999	A08p05730.2_BraZ1	125.4	-	323	1241	1330	0.9330827
A08	3734905	3735875	A08p05740.2_BraZ1	525	-	0	0	970	0.0000000
A08	3746159	3748595	A08p05750.2_BraZ1	1557	+	238	1527	2436	0.6268473
A08	3761278	3762679	A08p05760.2_BraZ1	663.104	+	241	1212	1401	0.8650963
A08	3775521	3775809	A08p05770.2_BraZ1	28.8	+	20	258	288	0.8958333
A08	3780557	3787672	A08p05780.2_BraZ1	297.273	+	698	3771	7115	0.5300070
A08	3790603	3791236	A08p05790.2_BraZ1	63.3	-	65	423	633	0.6682464
A08	3804869	3805145	A08p05800.2_BraZ1	27.6	-	154	258	276	0.9347826
A08	3819996	3820127	A08p05810.2_BraZ1	10.2	+	10	131	131	1.0000000
A08	3820254	3820585	A08p05820.2_BraZ1	279	-	284	331	331	1.0000000
A08	3844560	3847921	A08p05830.2_BraZ1	945	-	654	2200	3361	0.6545671
A08	3866941	3868592	A08p05840.2_BraZ1	542.25	+	283	1362	1651	0.8249546
A08	3875490	3875867	A08p05850.2_BraZ1	249	-	10	202	377	0.5358090
A08	3885560	3886552	A08p05860.2_BraZ1	340	-	505	960	992	0.9677419
A08	3888027	3888343	A08p05870.2_BraZ1	222	+	851	316	316	1.0000000
A08	3889417	3890459	A08p05880.2_BraZ1	768	+	1340	1042	1042	1.0000000
A08	3893028	3894150	A08p05890.2_BraZ1	1185.75	+	1493	1122	1122	1.0000000
A08	3899720	3900098	A08p05900.2_BraZ1	282	-	662	378	378	1.0000000
A08	3911225	3913201	A08p05910.2_BraZ1	1044	-	1732	1976	1976	1.0000000
A08	3916399	3918406	A08p05920.2_BraZ1	1156.12	+	170	1301	2007	0.6482312
A08	3924613	3925500	A08p05930.2_BraZ1	858	+	596	887	887	1.0000000
A08	3926748	3927265	A08p05940.2_BraZ1	303	-	244	503	517	0.9729207
A08	3929269	3930304	A08p05950.2_BraZ1	252	-	839	1035	1035	1.0000000
A08	3940153	3940282	A08p05960.2_BraZ1	12.9	+	282	129	129	1.0000000
A08	3943641	3945940	A08p05970.2_BraZ1	734.4	+	6687	2299	2299	1.0000000
A08	3947950	3948447	A08p05980.2_BraZ1	246	+	61	352	497	0.7082495
A08	3948929	3949258	A08p05990.2_BraZ1	240	-	66	300	329	0.9118541
A08	3951313	3951535	A08p06000.2_BraZ1	22.2	-	230	222	222	1.0000000
A08	3958631	3961407	A08p06010.2_BraZ1	1064.25	-	193	1809	2776	0.6516570
A08	3963063	3964476	A08p06020.2_BraZ1	1171.5	+	249	1008	1413	0.7133758
A08	3972463	3973429	A08p06030.2_BraZ1	282	+	1	58	966	0.0600414
A08	3982155	3983121	A08p06040.2_BraZ1	282	+	4	46	966	0.0476190
A08	3985220	3986501	A08p06050.2_BraZ1	128.1	-	547	1281	1281	1.0000000
A08	3987121	3987626	A08p06060.2_BraZ1	47.4	-	500	505	505	1.0000000
A08	3990702	3992450	A08p06070.2_BraZ1	1254.29	+	563	1650	1748	0.9439359
A08	3992565	3992703	A08p06080.2_BraZ1	13.8	+	102	138	138	1.0000000
A08	3995233	3997825	A08p06090.2_BraZ1	405	-	1251	2400	2592	0.9259259
A08	3997825	3998126	A08p06100.2_BraZ1	258	-	12	248	301	0.8239202
A08	4001800	4002027	A08p06110.2_BraZ1	174	-	144	227	227	1.0000000
A08	4002449	4002872	A08p06120.2_BraZ1	39.6	+	56	423	423	1.0000000
A08	4007252	4008931	A08p06130.2_BraZ1	834	+	981	1607	1679	0.9571173
A08	4013193	4014956	A08p06140.2_BraZ1	885	-	597	1601	1763	0.9081112
A08	4028227	4030104	A08p06150.2_BraZ1	1534.88	+	175	1189	1877	0.6334577
A08	4030490	4032114	A08p06160.2_BraZ1	1003.75	-	731	1544	1624	0.9507389
A08	4033947	4034964	A08p06170.2_BraZ1	336	+	742	1017	1017	1.0000000
A08	4039915	4041150	A08p06180.2_BraZ1	435.48	+	1814	1235	1235	1.0000000
A08	4041971	4043683	A08p06190.2_BraZ1	1058.91	-	342	1407	1712	0.8218458
A08	4065095	4065617	A08p06200.2_BraZ1	52.2	+	103	430	522	0.8237548
A08	4073499	4073751	A08p06210.2_BraZ1	25.2	-	27	226	252	0.8968254
A08	4075602	4077323	A08p06220.2_BraZ1	762.982	-	2584	1721	1721	1.0000000
A08	4098242	4101414	A08p06230.2_BraZ1	1174.15	+	718	2918	3172	0.9199243
A08	4107159	4107627	A08p06240.2_BraZ1	46.8	+	21	366	468	0.7820513
A08	4120216	4120393	A08p06250.2_BraZ1	17.7	-	90	177	177	1.0000000
A08	4147369	4148412	A08p06260.2_BraZ1	7517.25	+	30	533	1043	0.5110259
A08	4175602	4175954	A08p06270.2_BraZ1	192	-	529	352	352	1.0000000
A08	4179476	4180582	A08p06280.2_BraZ1	8736	-	71	660	1106	0.5967450
A08	4201662	4203173	A08p06290.2_BraZ1	689.706	-	959	1511	1511	1.0000000
A08	4203683	4204186	A08p06300.2_BraZ1	303	-	436	503	503	1.0000000
A08	4204174	4204553	A08p06310.2_BraZ1	177	-	597	379	379	1.0000000
A08	4208133	4208981	A08p06320.2_BraZ1	726	+	1554	848	848	1.0000000
A08	4210883	4213846	A08p06330.2_BraZ1	2421	+	3049	2963	2963	1.0000000
A08	4214194	4217434	A08p06340.2_BraZ1	1097.25	+	6407	3240	3240	1.0000000
A08	4218286	4219136	A08p06350.2_BraZ1	343.75	-	746	850	850	1.0000000
A08	4218850	4220480	A08p06360.2_BraZ1	1986	-	771	1630	1630	1.0000000
A08	4221382	4223081	A08p06370.2_BraZ1	1013.18	-	239	1399	1699	0.8234255
A08	4231362	4231570	A08p06380.2_BraZ1	150	-	6	174	208	0.8365384
A08	4252595	4254940	A08p06390.2_BraZ1	2265	+	428	2151	2345	0.9172708
A08	4255137	4256333	A08p06400.2_BraZ1	722.948	-	116	871	1196	0.7282609
A08	4259042	4259677	A08p06410.2_BraZ1	300.346	-	1024	635	635	1.0000000
A08	4261713	4262811	A08p06420.2_BraZ1	619.239	+	442	941	1098	0.8570127
A08	4264085	4264358	A08p06430.2_BraZ1	27.3	+	33	121	273	0.4432234
A08	4283467	4283665	A08p06440.2_BraZ1	19.8	-	222	198	198	1.0000000
A08	4284581	4287106	A08p06450.2_BraZ1	1387.04	+	343	1565	2525	0.6198020
A08	4291644	4291794	A08p06460.2_BraZ1	15	+	336	150	150	1.0000000
A08	4297831	4298149	A08p06470.2_BraZ1	300	+	433	318	318	1.0000000
A08	4306059	4310705	A08p06480.2_BraZ1	1313	-	2324	4063	4646	0.8745157
A08	4333028	4335766	A08p06490.2_BraZ1	1740.24	-	864	1641	2738	0.5993426
A08	4351145	4356307	A08p06500.2_BraZ1	2943.89	+	1201	4068	5162	0.7880666
A08	4363349	4365003	A08p06510.2_BraZ1	66.9	-	17	377	1654	0.2279323
A08	4372851	4374141	A08p06520.2_BraZ1	129	+	2426	1244	1290	0.9643411
A08	4377908	4378333	A08p06530.2_BraZ1	357	+	306	425	425	1.0000000
A08	4378301	4379197	A08p06540.2_BraZ1	86.4	+	186	896	896	1.0000000
A08	4383584	4384685	A08p06550.2_BraZ1	110.1	+	425	1017	1101	0.9237057
A08	4391170	4395507	A08p06560.2_BraZ1	1701.86	+	848	2863	4337	0.6601337
A08	4397392	4398323	A08p06570.2_BraZ1	300	+	1217	931	931	1.0000000
A08	4408187	4410040	A08p06580.2_BraZ1	1019.7	-	1616	1853	1853	1.0000000
A08	4421318	4421896	A08p06590.2_BraZ1	486	+	338	578	578	1.0000000
A08	4422009	4453682	A08p06600.2_BraZ1	4825.45	-	14224	27652	31673	0.8730465
A08	4435091	4435638	A08p06610.2_BraZ1	432	+	265	547	547	1.0000000
A08	4454889	4456908	A08p06620.2_BraZ1	6058	+	540	1784	2019	0.8836057
A08	4461152	4465289	A08p06630.2_BraZ1	2610	-	4370	3922	4137	0.9480300
A08	4465856	4466216	A08p06640.2_BraZ1	34.8	+	41	360	360	1.0000000
A08	4473299	4475318	A08p06650.2_BraZ1	863.52	-	2447	1857	2019	0.9197623
A08	4494542	4497065	A08p06660.2_BraZ1	702.667	+	2923	2523	2523	1.0000000
A08	4502477	4503532	A08p06670.2_BraZ1	969	-	34	731	1055	0.6928910
A08	4503868	4504060	A08p06680.2_BraZ1	19.2	-	39	192	192	1.0000000
A08	4518951	4519267	A08p06690.2_BraZ1	177	-	613	316	316	1.0000000
A08	4525777	4526062	A08p06700.2_BraZ1	28.5	+	717	285	285	1.0000000
A08	4529326	4532325	A08p06710.2_BraZ1	993.241	+	2720	2741	2999	0.9139713
A08	4545945	4546251	A08p06720.2_BraZ1	30.6	+	263	306	306	1.0000000
A08	4551079	4556837	A08p06730.2_BraZ1	312	-	4410	5758	5758	1.0000000
A08	4567807	4568277	A08p06740.2_BraZ1	381	+	3	86	470	0.1829787
A08	4569569	4571268	A08p06750.2_BraZ1	4515	+	1937	1694	1699	0.9970571
A08	4596249	4596440	A08p06760.2_BraZ1	11.1	+	158	191	191	1.0000000
A08	4598419	4598533	A08p06770.2_BraZ1	11.4	+	55	83	114	0.7280702
A08	4600819	4601656	A08p06780.2_BraZ1	588	+	1030	837	837	1.0000000
A08	4602353	4603397	A08p06790.2_BraZ1	750.711	-	994	998	1044	0.9559387
A08	4608990	4609375	A08p06800.2_BraZ1	303	+	320	385	385	1.0000000
A08	4610456	4612239	A08p06810.2_BraZ1	927	+	774	1655	1783	0.9282109
A08	4622059	4622443	A08p06820.2_BraZ1	38.4	+	380	384	384	1.0000000
A08	4635354	4638193	A08p06830.2_BraZ1	1299.1	+	1254	2422	2839	0.8531173
A08	4662014	4664468	A08p06840.2_BraZ1	1413.14	+	1138	2249	2454	0.9164629
A08	4687074	4689258	A08p06850.2_BraZ1	1027.3	+	785	1737	2184	0.7953297
A08	4707175	4707916	A08p06860.2_BraZ1	74.1	-	465	741	741	1.0000000
A08	4716079	4719145	A08p06870.2_BraZ1	1221.8	+	557	1440	3066	0.4696673
A08	4728837	4730353	A08p06880.2_BraZ1	1074.91	-	247	1258	1516	0.8298153
A08	4745307	4745472	A08p06890.2_BraZ1	16.5	-	188	165	165	1.0000000
A08	4746820	4747084	A08p06900.2_BraZ1	16.5	+	0	0	264	0.0000000
A08	4753893	4754205	A08p06910.2_BraZ1	31.2	+	102	272	312	0.8717949
A08	4761187	4762770	A08p06920.2_BraZ1	771.652	-	114	911	1583	0.5754896
A08	4774111	4776665	A08p06930.2_BraZ1	1196.9	-	1145	1891	2554	0.7404072
A08	4782545	4783697	A08p06940.2_BraZ1	114.3	-	2	120	1152	0.1041667
A08	4786708	4790469	A08p06950.2_BraZ1	198	-	516	1720	3761	0.4573252
A08	4806822	4807823	A08p06960.2_BraZ1	417	-	1	76	1001	0.0759241
A08	4815427	4820811	A08p06970.2_BraZ1	964.688	-	3725	4353	5384	0.8085067
A08	4822279	4823276	A08p06980.2_BraZ1	1280	+	341	997	997	1.0000000
A08	4849330	4851225	A08p06990.2_BraZ1	899.6	+	285	1050	1895	0.5540897
A08	4852816	4853231	A08p07000.2_BraZ1	315	+	10	24	415	0.0578313
A08	4855017	4855281	A08p07010.2_BraZ1	132	-	0	0	264	0.0000000
A08	4855618	4855780	A08p07020.2_BraZ1	16.2	-	25	162	162	1.0000000
A08	4860679	4861012	A08p07030.2_BraZ1	33.3	+	10	68	333	0.2042042
A08	4865451	4867269	A08p07040.2_BraZ1	59049	-	153	830	1818	0.4565457
A08	4892818	4894530	A08p07050.2_BraZ1	1393.52	+	228	1391	1712	0.8125000
A08	4911054	4911776	A08p07060.2_BraZ1	451.097	-	199	722	722	1.0000000
A08	4914800	4916369	A08p07070.2_BraZ1	305.1	-	287	910	1569	0.5799872
A08	4917184	4917523	A08p07080.2_BraZ1	33.9	-	245	339	339	1.0000000
A08	4935786	4938270	A08p07090.2_BraZ1	248.4	-	145	656	2484	0.2640902
A08	4940248	4944010	A08p07100.2_BraZ1	205.92	-	5955	3762	3762	1.0000000
A08	4944121	4944839	A08p07110.2_BraZ1	453	-	355	718	718	1.0000000
A08	4950442	4950588	A08p07120.2_BraZ1	12.3	-	61	146	146	1.0000000
A08	4951030	4953374	A08p07130.2_BraZ1	1821.27	-	296	1740	2344	0.7423208
A08	4954140	4955110	A08p07140.2_BraZ1	246	-	392	970	970	1.0000000
A08	4957126	4958311	A08p07150.2_BraZ1	117.9	+	60	467	1185	0.3940928
A08	4965803	4965960	A08p07160.2_BraZ1	10.5	+	721	157	157	1.0000000
A08	4970895	4972289	A08p07170.2_BraZ1	5728.5	-	511	1287	1394	0.9232424
A08	4978342	4979215	A08p07180.2_BraZ1	4428	-	19	268	873	0.3069874
A08	4992015	4996307	A08p07190.2_BraZ1	1514.29	+	1886	3766	4292	0.8774464
A08	4997227	4998015	A08p07200.2_BraZ1	485	+	76	736	788	0.9340101
A08	5003829	5016281	A08p07210.2_BraZ1	7586.86	-	1297	6826	12452	0.5481851
A08	5025773	5027830	A08p07220.2_BraZ1	915.47	-	295	1175	2057	0.5712202
A08	5049279	5051533	A08p07230.2_BraZ1	1333.12	+	382	1830	2254	0.8118899
A08	5059878	5060877	A08p07240.2_BraZ1	502.5	-	530	967	999	0.9679680
A08	5063234	5064272	A08p07250.2_BraZ1	103.8	-	103	1010	1038	0.9730250
A08	5071132	5071459	A08p07260.2_BraZ1	32.7	+	0	0	327	0.0000000
A08	5072623	5072967	A08p07270.2_BraZ1	20.1	-	55	342	344	0.9941860
A08	5073189	5073823	A08p07280.2_BraZ1	4335.75	-	344	611	634	0.9637224
A08	5083024	5083363	A08p07290.2_BraZ1	252	+	278	339	339	1.0000000
A08	5087935	5088641	A08p07300.2_BraZ1	326.063	+	24	213	706	0.3016997
A08	5119965	5120100	A08p07310.2_BraZ1	13.5	-	142	135	135	1.0000000
A08	5120886	5121936	A08p07320.2_BraZ1	3505.5	-	1085	1050	1050	1.0000000
A08	5139065	5139800	A08p07330.2_BraZ1	73.5	+	38	281	735	0.3823129
A08	5140067	5142079	A08p07340.2_BraZ1	983.944	-	508	1024	2012	0.5089463
A08	5142465	5142741	A08p07350.2_BraZ1	27.6	+	37	247	276	0.8949276
A08	5148588	5150073	A08p07360.2_BraZ1	485.739	+	464	1094	1485	0.7367004
A08	5159317	5159582	A08p07370.2_BraZ1	20.1	+	376	265	265	1.0000000
A08	5168240	5168486	A08p07380.2_BraZ1	24.6	+	329	246	246	1.0000000
A08	5170723	5172371	A08p07390.2_BraZ1	150	-	790	1648	1648	1.0000000
A08	5172152	5176194	A08p07400.2_BraZ1	264	-	1596	3962	4042	0.9802078
A08	5178953	5179866	A08p07410.2_BraZ1	4683	+	344	809	913	0.8860898
A08	5196836	5200151	A08p07420.2_BraZ1	1334.13	+	599	2384	3315	0.7191554
A08	5210611	5210821	A08p07430.2_BraZ1	15.3	+	329	210	210	1.0000000
A08	5215420	5217459	A08p07440.2_BraZ1	1461	-	807	2039	2039	1.0000000
A08	5222244	5230512	A08p07450.2_BraZ1	559.44	+	7177	7793	8268	0.9425496
A08	5231466	5233386	A08p07460.2_BraZ1	313.2	+	145	1606	1920	0.8364583
A08	5270492	5277173	A08p07470.2_BraZ1	2666.79	+	199	2747	6681	0.4111660
A08	5284211	5285933	A08p07480.2_BraZ1	172.2	-	209	931	1722	0.5406504
A08	5287458	5289043	A08p07490.2_BraZ1	286.8	-	50	880	1585	0.5552050
A08	5293337	5293706	A08p07500.2_BraZ1	36.9	+	355	369	369	1.0000000
A08	5316156	5317385	A08p07510.2_BraZ1	417	-	1045	1229	1229	1.0000000
A08	5318439	5318909	A08p07520.2_BraZ1	222	+	0	0	470	0.0000000
A08	5320121	5322401	A08p07530.2_BraZ1	1892.22	+	366	1747	2280	0.7662281
A08	5322620	5323117	A08p07540.2_BraZ1	287.455	-	195	497	497	1.0000000
A08	5325280	5328119	A08p07550.2_BraZ1	1517.25	+	712	1973	2839	0.6949630
A08	5337112	5337372	A08p07560.2_BraZ1	17.7	-	320	260	260	1.0000000
A08	5340810	5343088	A08p07570.2_BraZ1	963.327	-	61	863	2278	0.3788411
A08	5344413	5344668	A08p07580.2_BraZ1	25.5	-	429	255	255	1.0000000
A08	5351659	5352163	A08p07590.2_BraZ1	50.4	+	252	504	504	1.0000000
A08	5375059	5375539	A08p07600.2_BraZ1	373.5	+	593	480	480	1.0000000
A08	5384535	5385332	A08p07610.2_BraZ1	600	+	925	797	797	1.0000000
A08	5388691	5388904	A08p07620.2_BraZ1	21.3	+	246	213	213	1.0000000
A08	5390469	5391412	A08p07630.2_BraZ1	580.32	-	700	711	943	0.7539766
A08	5403173	5405642	A08p07640.2_BraZ1	1339.86	+	151	1445	2469	0.5852572
A08	5423678	5424175	A08p07650.2_BraZ1	318	+	115	366	497	0.7364185
A08	5438291	5439108	A08p07660.2_BraZ1	363.545	+	93	598	817	0.7319462
A08	5440745	5441386	A08p07670.2_BraZ1	468	+	650	641	641	1.0000000
A08	5444330	5446295	A08p07680.2_BraZ1	303	-	1743	1965	1965	1.0000000
A08	5452519	5452995	A08p07690.2_BraZ1	357	-	354	476	476	1.0000000
A08	5471931	5472273	A08p07700.2_BraZ1	215.25	-	278	342	342	1.0000000
A08	5472282	5472855	A08p07710.2_BraZ1	57.3	-	227	573	573	1.0000000
A08	5495499	5495625	A08p07720.2_BraZ1	12.6	+	159	126	126	1.0000000
A08	5510082	5523896	A08p07730.2_BraZ1	1843.26	-	16483	13293	13814	0.9622846
A08	5529338	5529713	A08p07740.2_BraZ1	37.5	+	336	375	375	1.0000000
A08	5532571	5532853	A08p07750.2_BraZ1	28.2	-	312	282	282	1.0000000
A08	5545160	5546276	A08p07760.2_BraZ1	492.375	+	829	1116	1116	1.0000000
A08	5550726	5551742	A08p07770.2_BraZ1	744	+	433	1010	1016	0.9940945
A08	5552171	5552498	A08p07780.2_BraZ1	32.7	+	379	327	327	1.0000000
A08	5552757	5554021	A08p07790.2_BraZ1	877.5	+	383	1058	1264	0.8370253
A08	5554670	5556529	A08p07800.2_BraZ1	628.306	-	385	1786	1859	0.9607316
A08	5563213	5565498	A08p07810.2_BraZ1	1288.12	-	425	1858	2285	0.8131291
A08	5576078	5577446	A08p07820.2_BraZ1	1122	-	325	867	1368	0.6337720
A08	5594796	5596150	A08p07830.2_BraZ1	1173	+	5	278	1354	0.2053176
A08	5599400	5599778	A08p07840.2_BraZ1	177	+	663	378	378	1.0000000
A08	5614258	5614817	A08p07850.2_BraZ1	269.28	+	31	398	559	0.7119857
A08	5616941	5617404	A08p07860.2_BraZ1	150	+	565	463	463	1.0000000
A08	5650069	5650378	A08p07870.2_BraZ1	30.9	+	301	309	309	1.0000000
A08	5654456	5674000	A08p07880.2_BraZ1	1830	+	7389	16040	19544	0.8207123
A08	5687622	5689098	A08p07890.2_BraZ1	755.571	-	2199	1476	1476	1.0000000
A08	5692875	5693371	A08p07900.2_BraZ1	255	+	754	496	496	1.0000000
A08	5696013	5696316	A08p07910.2_BraZ1	30.3	-	603	303	303	1.0000000
A08	5698448	5698757	A08p07920.2_BraZ1	30.9	+	113	309	309	1.0000000
A08	5699802	5700164	A08p07930.2_BraZ1	276	-	304	362	362	1.0000000
A08	5701282	5702057	A08p07940.2_BraZ1	570	+	546	775	775	1.0000000
A08	5703544	5703886	A08p07950.2_BraZ1	34.2	-	293	342	342	1.0000000
A08	5716037	5716238	A08p07960.2_BraZ1	20.1	+	242	201	201	1.0000000
A08	5718054	5718756	A08p07970.2_BraZ1	307.5	+	942	702	702	1.0000000
A08	5726173	5726632	A08p07980.2_BraZ1	45.9	+	19	91	459	0.1982571
A08	5728562	5728859	A08p07990.2_BraZ1	1738.5	-	1465	297	297	1.0000000
A08	5730401	5734597	A08p08000.2_BraZ1	513	+	6284	4196	4196	1.0000000
A08	5737522	5737690	A08p08010.2_BraZ1	16.8	+	216	168	168	1.0000000
A08	5744553	5747985	A08p08020.2_BraZ1	1910.3	-	385	2507	3432	0.7304779
A08	5751964	5752222	A08p08030.2_BraZ1	25.8	-	722	258	258	1.0000000
A08	5757446	5757767	A08p08040.2_BraZ1	270	-	714	321	321	1.0000000
A08	5766218	5768106	A08p08050.2_BraZ1	939	+	1152	1888	1888	1.0000000
A08	5771236	5772525	A08p08060.2_BraZ1	433.44	-	148	902	1289	0.6997672
A08	5777391	5778632	A08p08070.2_BraZ1	534	-	185	874	1241	0.7042707
A08	5785923	5792072	A08p08080.2_BraZ1	182.1	+	6720	6149	6149	1.0000000
A08	5790032	5791284	A08p08090.2_BraZ1	47.1	+	1336	1252	1252	1.0000000
A08	5803966	5822080	A08p08100.2_BraZ1	519	+	5886	16406	18114	0.9057083
A08	5824902	5826246	A08p08110.2_BraZ1	863.571	+	37	771	1344	0.5736607
A08	5826827	5827451	A08p08120.2_BraZ1	282	+	470	624	624	1.0000000
A08	5827661	5828019	A08p08130.2_BraZ1	237	+	492	358	358	1.0000000
A08	5842053	5845008	A08p08140.2_BraZ1	1087.53	-	110	2423	2955	0.8199661
A08	5849258	5849636	A08p08150.2_BraZ1	37.8	-	39	378	378	1.0000000
A08	5861894	5863209	A08p08160.2_BraZ1	606.375	+	281	1276	1315	0.9703422
A08	5863515	5865284	A08p08170.2_BraZ1	1339.09	-	64	951	1769	0.5375919
A08	5906363	5907581	A08p08180.2_BraZ1	121.8	-	692	1218	1218	1.0000000
A08	5908694	5912639	A08p08190.2_BraZ1	363.3	+	4810	3945	3945	1.0000000
A08	5919610	5919994	A08p08200.2_BraZ1	38.4	-	374	384	384	1.0000000
A08	5927543	5930803	A08p08210.2_BraZ1	1293.72	+	104	1056	3260	0.3239264
A08	5933767	5935617	A08p08220.2_BraZ1	432	-	855	1727	1850	0.9335135
A08	5936859	5937555	A08p08230.2_BraZ1	603	-	213	696	696	1.0000000
A08	6001384	6001951	A08p08240.2_BraZ1	56.7	+	22	128	567	0.2257496
A08	6005546	6006356	A08p08250.2_BraZ1	66.6	+	0	0	810	0.0000000
A08	6007661	6008709	A08p08260.2_BraZ1	2427.75	+	781	1048	1048	1.0000000
A08	6010103	6010670	A08p08270.2_BraZ1	56.7	+	21	70	567	0.1234568
A08	6014313	6015123	A08p08280.2_BraZ1	81	+	0	0	810	0.0000000
A08	6015704	6016371	A08p08290.2_BraZ1	630	+	484	667	667	1.0000000
A08	6016952	6017286	A08p08300.2_BraZ1	135	+	94	334	334	1.0000000
A08	6017749	6024359	A08p08310.2_BraZ1	5076.8	+	36989	6610	6610	1.0000000
A08	6025123	6025958	A08p08320.2_BraZ1	513	-	1083	835	835	1.0000000
A08	6025971	6028300	A08p08330.2_BraZ1	2385	-	3667	2329	2329	1.0000000
A08	6028347	6030305	A08p08340.2_BraZ1	441.464	+	1657	1958	1958	1.0000000
A08	6033218	6033726	A08p08350.2_BraZ1	2736	+	177	508	508	1.0000000
A08	6034397	6035206	A08p08360.2_BraZ1	544.5	-	631	809	809	1.0000000
A08	6038293	6039399	A08p08370.2_BraZ1	876	+	533	950	1106	0.8589512
A08	6040990	6041421	A08p08380.2_BraZ1	306	+	378	431	431	1.0000000
A08	6042289	6042721	A08p08390.2_BraZ1	43.2	-	194	432	432	1.0000000
A08	6042744	6043308	A08p08400.2_BraZ1	243	-	138	496	564	0.8794326
A08	6053954	6054218	A08p08410.2_BraZ1	26.4	+	254	264	264	1.0000000
A08	6054950	6057448	A08p08420.2_BraZ1	1244.77	-	298	970	2498	0.3883106
A08	6057895	6058919	A08p08430.2_BraZ1	463.68	-	428	1024	1024	1.0000000
A08	6061410	6063900	A08p08440.2_BraZ1	249	-	129	1316	2490	0.5285140
A08	6064415	6067603	A08p08450.2_BraZ1	2669.35	-	43	955	3188	0.2995608
A08	6074007	6092335	A08p08460.2_BraZ1	2018.1	+	58596	16784	18328	0.9157573
A08	6103112	6104802	A08p08470.2_BraZ1	479.886	-	108	769	1690	0.4550296
A08	6105799	6107283	A08p08480.2_BraZ1	954	+	1338	1484	1484	1.0000000
A08	6112062	6116778	A08p08490.2_BraZ1	2302.98	+	1351	3058	4716	0.6484309
A08	6125659	6125858	A08p08500.2_BraZ1	12.9	+	365	199	199	1.0000000
A08	6128041	6129876	A08p08510.2_BraZ1	2476.33	+	332	1835	1835	1.0000000
A08	6132248	6133049	A08p08520.2_BraZ1	80.1	-	177	801	801	1.0000000
A08	6134000	6136591	A08p08530.2_BraZ1	2943	+	669	2591	2591	1.0000000
A08	6136960	6137401	A08p08540.2_BraZ1	44.1	-	1138	441	441	1.0000000
A08	6151035	6151323	A08p08550.2_BraZ1	207	-	857	288	288	1.0000000
A08	6155303	6155576	A08p08560.2_BraZ1	27.3	-	236	273	273	1.0000000
A08	6159187	6160839	A08p08570.2_BraZ1	1500	-	40	520	1652	0.3147700
A08	6186410	6188293	A08p08580.2_BraZ1	1647	+	4445	1883	1883	1.0000000
A08	6191367	6197906	A08p08590.2_BraZ1	1544.38	-	3008	5602	6539	0.8567059
A08	6296544	6297815	A08p08600.2_BraZ1	1233	+	164	1144	1271	0.9000787
A08	6324855	6325056	A08p08610.2_BraZ1	17.7	+	46	201	201	1.0000000
A08	6398152	6398601	A08p08620.2_BraZ1	41.1	+	353	449	449	1.0000000
A08	6464186	6464561	A08p08630.2_BraZ1	391.5	-	201	375	375	1.0000000
A08	6464549	6464963	A08p08640.2_BraZ1	499.5	-	225	414	414	1.0000000
A08	6491413	6491968	A08p08650.2_BraZ1	270	-	676	555	555	1.0000000
A08	6497818	6498505	A08p08660.2_BraZ1	267.474	-	401	687	687	1.0000000
A08	6499383	6499488	A08p08670.2_BraZ1	10.5	-	204	105	105	1.0000000
A08	6500079	6500445	A08p08680.2_BraZ1	36.6	-	372	366	366	1.0000000
A08	6503280	6505637	A08p08690.2_BraZ1	1112.4	+	324	1847	2357	0.7836233
A08	6506315	6506741	A08p08700.2_BraZ1	258	-	642	426	426	1.0000000
A08	6565623	6566253	A08p08710.2_BraZ1	384	+	782	630	630	1.0000000
A08	6575296	6577203	A08p08720.2_BraZ1	44.1	+	6000	1907	1907	1.0000000
A08	6600083	6600218	A08p08730.2_BraZ1	13.5	+	70	135	135	1.0000000
A08	6602779	6603127	A08p08740.2_BraZ1	225	-	307	348	348	1.0000000
A08	7062558	7062930	A08p08750.2_BraZ1	37.2	-	43	372	372	1.0000000
A08	7335493	7335865	A08p08760.2_BraZ1	37.2	-	112	372	372	1.0000000
A08	7402086	7402458	A08p08770.2_BraZ1	37.2	-	163	372	372	1.0000000
A08	7520749	7531226	A08p08780.2_BraZ1	4473	-	892	5487	10477	0.5237186
A08	7559660	7560243	A08p08790.2_BraZ1	360	+	141	583	583	1.0000000
A08	7560905	7561590	A08p08800.2_BraZ1	216	+	7	199	685	0.2905110
A08	7576260	7576854	A08p08810.2_BraZ1	648	+	75	564	594	0.9494950
A08	7962778	7963372	A08p08820.2_BraZ1	222	+	50	475	594	0.7996633
A08	8205101	8205473	A08p08830.2_BraZ1	37.2	-	61	372	372	1.0000000
A08	9052274	9052646	A08p08840.2_BraZ1	37.2	-	55	288	372	0.7741935
A08	9135490	9135862	A08p08850.2_BraZ1	37.2	+	4	206	372	0.5537634
A08	9586714	9587050	A08p08860.2_BraZ1	33.6	-	171	336	336	1.0000000
A08	9587855	9588065	A08p08870.2_BraZ1	180	+	374	210	210	1.0000000
A08	9635678	9638414	A08p08880.2_BraZ1	1197	-	2118	2669	2736	0.9755117
A08	12994578	13006676	A08p08890.2_BraZ1	2058	+	1903	7299	12098	0.6033229
A08	13024175	13024445	A08p08900.2_BraZ1	27	-	0	0	270	0.0000000
A08	13028877	13039401	A08p08910.2_BraZ1	27472.5	+	666	6368	10524	0.6050931
A08	13040411	13041307	A08p08920.2_BraZ1	104	+	19	750	896	0.8370536
A08	13041711	13042299	A08p08930.2_BraZ1	300	-	13	524	588	0.8911564
A08	13042230	13042852	A08p08940.2_BraZ1	716	+	5	335	622	0.5385852
A08	13043151	13044426	A08p08950.2_BraZ1	226	+	24	815	1275	0.6392157
A08	13043709	13047945	A08p08960.2_BraZ1	3782.25	+	103	2098	4236	0.4952786
A08	13054835	13055868	A08p08970.2_BraZ1	352.5	-	123	1033	1033	1.0000000
A08	13056039	13058513	A08p08980.2_BraZ1	1080	-	112	1201	2474	0.4854487
A08	13058687	13059714	A08p08990.2_BraZ1	252	-	18	872	1027	0.8490750
A08	13093511	13094555	A08p09000.2_BraZ1	104	+	6	404	1044	0.3869732
A08	13094567	13095146	A08p09010.2_BraZ1	300	-	5	275	579	0.4749568
A08	13095077	13095699	A08p09020.2_BraZ1	716	+	0	0	622	0.0000000
A08	13095998	13098488	A08p09030.2_BraZ1	447.5	+	21	948	2490	0.3807229
A08	13102715	13105191	A08p09040.2_BraZ1	1509	-	11	438	2476	0.1768982
A08	13209507	13209807	A08p09050.2_BraZ1	30	+	4	43	300	0.1433333
A08	13214371	13215265	A08p09060.2_BraZ1	89.4	-	0	0	894	0.0000000
A08	13222014	13222906	A08p09070.2_BraZ1	57.3	-	64	720	892	0.8071749
A08	13230438	13231332	A08p09080.2_BraZ1	89.4	-	8	248	894	0.2774049
A08	14763850	14765114	A08p09090.2_BraZ1	897	-	150	1078	1264	0.8528481
A08	14767385	14770498	A08p09100.2_BraZ1	1536	+	1941	3113	3113	1.0000000
A08	14773018	14773333	A08p09110.2_BraZ1	201	-	236	315	315	1.0000000
A08	14789967	14790707	A08p09120.2_BraZ1	954	-	481	740	740	1.0000000
A08	14808891	14811126	A08p09130.2_BraZ1	1644.52	+	631	2041	2235	0.9131991
A08	14813799	14813949	A08p09140.2_BraZ1	15	+	284	150	150	1.0000000
A08	14821906	14822239	A08p09150.2_BraZ1	33.3	-	11	162	333	0.4864865
A08	14823450	14825065	A08p09160.2_BraZ1	1186.07	-	320	1326	1615	0.8210526
A08	14832182	14833359	A08p09170.2_BraZ1	1062	-	159	1109	1177	0.9422260
A08	14848573	14848762	A08p09180.2_BraZ1	18.9	+	51	135	189	0.7142857
A08	14850154	14859567	A08p09190.2_BraZ1	6356.25	-	184	3003	9413	0.3190269
A08	14882188	14882594	A08p09200.2_BraZ1	255	-	1958	406	406	1.0000000
A08	14882403	14882701	A08p09210.2_BraZ1	207	-	2140	298	298	1.0000000
A08	14883121	14883316	A08p09220.2_BraZ1	19.5	-	302	195	195	1.0000000
A08	14884021	14906468	A08p09230.2_BraZ1	1397.14	-	15661	20516	22447	0.9139751
A08	14908362	14911447	A08p09240.2_BraZ1	474	+	906	2720	3085	0.8816856
A08	14909428	14909739	A08p09250.2_BraZ1	228	-	129	311	311	1.0000000
A08	14920564	14921276	A08p09260.2_BraZ1	61.2	+	732	712	712	1.0000000
A08	14934319	15024122	A08p09270.2_BraZ1	204	-	59974	88051	89803	0.9804906
A08	14974189	14975667	A08p09280.2_BraZ1	918	-	28	800	1478	0.5412720
A08	14978997	14979412	A08p09290.2_BraZ1	150	+	293	415	415	1.0000000
A08	14989402	14990509	A08p09300.2_BraZ1	548.833	-	102	731	1107	0.6603433
A08	14993002	14995900	A08p09310.2_BraZ1	345	-	1067	2835	2898	0.9782609
A08	15028223	15031260	A08p09320.2_BraZ1	270	+	3699	3037	3037	1.0000000
A08	15039057	15041162	A08p09330.2_BraZ1	582.931	-	1191	2010	2105	0.9548693
A08	15045132	15047178	A08p09340.2_BraZ1	1914.75	-	6	241	2046	0.1177908
A08	15050571	15051226	A08p09350.2_BraZ1	1062	+	448	655	655	1.0000000
A08	15057091	15060055	A08p09360.2_BraZ1	170.4	+	16457	2964	2964	1.0000000
A08	15060349	15060929	A08p09370.2_BraZ1	1400	-	2393	580	580	1.0000000
A08	15060815	15062542	A08p09380.2_BraZ1	4950	-	9242	1727	1727	1.0000000
A08	15062584	15064659	A08p09390.2_BraZ1	1524	-	4220	2075	2075	1.0000000
A08	15066375	15066608	A08p09400.2_BraZ1	144	+	192	233	233	1.0000000
A08	15069569	15069719	A08p09410.2_BraZ1	15	-	110	150	150	1.0000000
A08	15070853	15072099	A08p09420.2_BraZ1	969.143	+	367	1124	1246	0.9020867
A08	15072487	15073523	A08p09430.2_BraZ1	622.673	-	510	1036	1036	1.0000000
A08	15078651	15084671	A08p09440.2_BraZ1	270	+	4067	6020	6020	1.0000000
A08	15085322	15088164	A08p09450.2_BraZ1	1432.83	-	961	2616	2842	0.9204785
A08	15119967	15121000	A08p09460.2_BraZ1	86.1	+	382	1033	1033	1.0000000
A08	15164364	15165544	A08p09470.2_BraZ1	894	+	588	1180	1180	1.0000000
A08	15166628	15166961	A08p09480.2_BraZ1	222	-	196	333	333	1.0000000
A08	15169163	15170375	A08p09490.2_BraZ1	435	-	546	1212	1212	1.0000000
A08	15177765	15178796	A08p09500.2_BraZ1	324	-	547	402	1031	0.3899127
A08	15191959	15200558	A08p09510.2_BraZ1	1802.97	+	4771	7244	8599	0.8424236
A08	15205420	15207561	A08p09520.2_BraZ1	820.286	+	246	1509	2141	0.7048109
A08	15208388	15211342	A08p09530.2_BraZ1	2871	-	285	2544	2954	0.8612052
A08	15229688	15231155	A08p09540.2_BraZ1	146.7	-	97	1137	1467	0.7750511
A08	15235891	15238196	A08p09550.2_BraZ1	1224.69	-	637	1735	2305	0.7527115
A08	15245147	15246630	A08p09560.2_BraZ1	460	-	1416	1483	1483	1.0000000
A08	15248514	15251001	A08p09570.2_BraZ1	248.7	-	345	1060	2487	0.4262163
A08	15255746	15256463	A08p09580.2_BraZ1	71.7	+	179	717	717	1.0000000
A08	15264360	15266036	A08p09590.2_BraZ1	1440	+	342	1351	1676	0.8060859
A08	15269854	15272012	A08p09600.2_BraZ1	1411.2	+	965	1828	2158	0.8470806
A08	15272792	15274902	A08p09610.2_BraZ1	1752.16	-	337	1568	2110	0.7431279
A08	15286397	15286962	A08p09620.2_BraZ1	360	-	830	565	565	1.0000000
A08	15288289	15288839	A08p09630.2_BraZ1	29.4	+	336	550	550	1.0000000
A08	15294397	15294815	A08p09640.2_BraZ1	234	-	148	418	418	1.0000000
A08	15314505	15315566	A08p09650.2_BraZ1	4529.25	+	1954	1061	1061	1.0000000
A08	15316345	15316480	A08p09660.2_BraZ1	13.5	+	43	135	135	1.0000000
A08	15317401	15319142	A08p09670.2_BraZ1	1187.21	+	151	408	1741	0.2343481
A08	15325654	15326558	A08p09680.2_BraZ1	516	+	196	887	904	0.9811947
A08	15326803	15333503	A08p09690.2_BraZ1	1023.65	-	568	3462	6700	0.5167164
A08	15338531	15338666	A08p09700.2_BraZ1	13.5	-	80	135	135	1.0000000
A08	15339423	15341095	A08p09710.2_BraZ1	57.9	-	2026	1634	1672	0.9772727
A08	15343427	15355213	A08p09720.2_BraZ1	1173.71	-	3088	8281	11786	0.7026133
A08	15348676	15348934	A08p09730.2_BraZ1	192	+	0	0	258	0.0000000
A08	15350839	15351236	A08p09740.2_BraZ1	207	+	289	397	397	1.0000000
A08	15354991	15355598	A08p09750.2_BraZ1	13.8	-	213	607	607	1.0000000
A08	15362880	15365045	A08p09760.2_BraZ1	1488	-	64	869	2165	0.4013857
A08	15367357	15367594	A08p09770.2_BraZ1	23.7	-	19	110	237	0.4641350
A08	15389349	15389662	A08p09780.2_BraZ1	153	+	137	313	313	1.0000000
A08	15398587	15398903	A08p09790.2_BraZ1	261	+	154	316	316	1.0000000
A08	15403435	15403751	A08p09800.2_BraZ1	261	+	175	316	316	1.0000000
A08	15405634	15405953	A08p09810.2_BraZ1	285	+	404	319	319	1.0000000
A08	15412672	15412924	A08p09820.2_BraZ1	25.2	+	138	252	252	1.0000000
A08	15415578	15415897	A08p09830.2_BraZ1	616	+	49	319	319	1.0000000
A08	15418569	15418821	A08p09840.2_BraZ1	25.2	+	418	252	252	1.0000000
A08	15421520	15421772	A08p09850.2_BraZ1	25.2	+	595	252	252	1.0000000
A08	15427360	15427612	A08p09860.2_BraZ1	25.2	+	316	252	252	1.0000000
A08	15429899	15430218	A08p09870.2_BraZ1	264	+	30	290	319	0.9090909
A08	15432481	15432800	A08p09880.2_BraZ1	276	+	97	304	319	0.9529781
A08	15456290	15456549	A08p09890.2_BraZ1	210	+	10	254	259	0.9806950
A08	15456773	15457545	A08p09900.2_BraZ1	132.75	+	17	416	772	0.5388601
A08	15466871	15469078	A08p09910.2_BraZ1	477	+	2606	2192	2207	0.9932035
A08	15469927	15470316	A08p09920.2_BraZ1	356	+	225	389	389	1.0000000
A08	15472576	15475662	A08p09930.2_BraZ1	1335.25	+	7834	2622	3086	0.8496435
A08	15481417	15481840	A08p09940.2_BraZ1	42.3	+	228	423	423	1.0000000
A08	15488668	15491429	A08p09950.2_BraZ1	951.385	+	483	1910	2761	0.6917784
A08	15496862	15499223	A08p09960.2_BraZ1	2103.33	+	215	1516	2361	0.6421008
A08	15499675	15499885	A08p09970.2_BraZ1	13.2	+	18	178	210	0.8476191
A08	15507151	15509234	A08p09980.2_BraZ1	936.767	-	301	1265	2083	0.6072972
A08	15510860	15511006	A08p09990.2_BraZ1	13.5	-	98	146	146	1.0000000
A08	15511311	15512929	A08p10000.2_BraZ1	153	-	731	1545	1618	0.9548826
A08	15516128	15516470	A08p10010.2_BraZ1	726	+	225	342	342	1.0000000
A08	15516725	15516843	A08p10020.2_BraZ1	10.5	+	88	118	118	1.0000000
A08	15530647	15533073	A08p10030.2_BraZ1	1841.03	-	174	1258	2426	0.5185490
A08	15540331	15540514	A08p10040.2_BraZ1	159	+	54	176	183	0.9617487
A08	15543405	15549540	A08p10050.2_BraZ1	1279.77	-	1037	4117	6135	0.6710677
A08	15567720	15569022	A08p10060.2_BraZ1	130.2	+	13042	1302	1302	1.0000000
A08	15601333	15601507	A08p10070.2_BraZ1	12.3	+	0	0	174	0.0000000
A08	15602138	15603001	A08p10080.2_BraZ1	611.8	-	927	779	863	0.9026651
A08	15623240	15624362	A08p10090.2_BraZ1	780	-	133	1041	1122	0.9278075
A08	15638119	15639962	A08p10100.2_BraZ1	22202.5	+	626	1688	1843	0.9158980
A08	15640647	15640887	A08p10110.2_BraZ1	24	+	89	240	240	1.0000000
A08	15641701	15643053	A08p10120.2_BraZ1	696.15	+	81	577	1352	0.4267752
A08	15656854	15659964	A08p10130.2_BraZ1	1095	-	1847	2882	3110	0.9266881
A08	15665743	15666583	A08p10140.2_BraZ1	84	+	74	721	840	0.8583333
A08	15675200	15675781	A08p10150.2_BraZ1	378	-	354	548	581	0.9432014
A08	15683046	15683316	A08p10160.2_BraZ1	27	+	18	200	270	0.7407407
A08	15683599	15684358	A08p10170.2_BraZ1	490.226	-	5	343	759	0.4519104
A08	15697310	15697685	A08p10180.2_BraZ1	5610	+	1124	375	375	1.0000000
A08	15698003	15698477	A08p10190.2_BraZ1	172.446	+	2053	474	474	1.0000000
A08	15727422	15728183	A08p10200.2_BraZ1	1862.25	+	37	669	761	0.8791065
A08	15753891	15758425	A08p10210.2_BraZ1	488.75	+	4536	4046	4534	0.8923688
A08	15761938	15763062	A08p10220.2_BraZ1	825.125	+	539	1119	1124	0.9955516
A08	15767658	15775310	A08p10230.2_BraZ1	672	+	1032	5211	7652	0.6809984
A08	15775481	15776113	A08p10240.2_BraZ1	474	+	161	548	632	0.8670886
A08	15777452	15777947	A08p10250.2_BraZ1	321	+	5	358	495	0.7232323
A08	15786774	15787050	A08p10260.2_BraZ1	27.6	+	39	141	276	0.5108696
A08	15789062	15790476	A08p10270.2_BraZ1	493.714	-	111	1061	1414	0.7503536
A08	15791094	15791569	A08p10280.2_BraZ1	399	+	84	446	475	0.9389474
A08	15793939	15794362	A08p10290.2_BraZ1	393	-	0	0	423	0.0000000
A08	15797013	15797672	A08p10300.2_BraZ1	639	-	2	110	659	0.1669196
A08	15802998	15805577	A08p10310.2_BraZ1	1122	+	59	1354	2579	0.5250097
A08	15806849	15807275	A08p10320.2_BraZ1	354	-	2	141	426	0.3309859
A08	15811953	15812251	A08p10330.2_BraZ1	16.2	+	30	191	298	0.6409396
A08	15815610	15817024	A08p10340.2_BraZ1	279.158	+	0	0	1414	0.0000000
A08	15816584	15817493	A08p10350.2_BraZ1	411.667	-	36	242	909	0.2662266
A08	15819698	15820364	A08p10360.2_BraZ1	66.6	-	17	452	666	0.6786787
A08	15836502	15837753	A08p10370.2_BraZ1	489	-	1586	1251	1251	1.0000000
A08	15837815	15846589	A08p10380.2_BraZ1	833.506	+	1827	6218	8774	0.7086847
A08	15841494	15841875	A08p10390.2_BraZ1	264	-	300	235	381	0.6167979
A08	15850779	15853502	A08p10400.2_BraZ1	759.812	-	6519	2723	2723	1.0000000
A08	15875767	15876315	A08p10410.2_BraZ1	370.875	+	53	486	548	0.8868613
A08	15882443	15885885	A08p10420.2_BraZ1	858	-	2077	3278	3442	0.9523533
A08	15903933	15904803	A08p10430.2_BraZ1	222	+	12	175	870	0.2011494
A08	15904024	15904383	A08p10440.2_BraZ1	198	+	0	0	359	0.0000000
A08	15906326	15915141	A08p10450.2_BraZ1	5049.65	-	278	3645	8815	0.4134997
A08	15940386	15940825	A08p10460.2_BraZ1	177	+	727	439	439	1.0000000
A08	15941045	15941528	A08p10470.2_BraZ1	114.562	+	509	483	483	1.0000000
A08	15941777	15942520	A08p10480.2_BraZ1	306.25	+	53	369	743	0.4966353
A08	15949213	15949533	A08p10490.2_BraZ1	228	-	1	19	320	0.0593750
A08	15958736	15958898	A08p10500.2_BraZ1	16.2	-	0	0	162	0.0000000
A08	15959243	15959375	A08p10510.2_BraZ1	13.2	+	1	45	132	0.3409091
A08	15963370	15964879	A08p10520.2_BraZ1	150.9	+	80	722	1509	0.4784625
A08	15983785	15987421	A08p10530.2_BraZ1	2817.09	+	427	2481	3636	0.6823432
A08	15998056	15998296	A08p10540.2_BraZ1	24	+	37	110	240	0.4583333
A08	16000410	16000837	A08p10550.2_BraZ1	1921.5	-	73	416	427	0.9742389
A08	16001647	16001906	A08p10560.2_BraZ1	171	-	171	259	259	1.0000000
A08	16005614	16007539	A08p10570.2_BraZ1	1308	+	520	1872	1925	0.9724675
A08	16014947	16015725	A08p10580.2_BraZ1	142.308	+	296	759	778	0.9755784
A08	16016532	16017854	A08p10590.2_BraZ1	687.273	-	365	1136	1322	0.8593041
A08	16031767	16034297	A08p10600.2_BraZ1	250.2	+	4	151	2530	0.0596838
A08	16035317	16037554	A08p10610.2_BraZ1	636.848	-	710	2153	2237	0.9624497
A08	16041617	16044362	A08p10620.2_BraZ1	331.5	+	2545	2745	2745	1.0000000
A08	16045363	16047671	A08p10630.2_BraZ1	1272.82	+	890	2163	2308	0.9371750
A08	16055084	16057718	A08p10640.2_BraZ1	966.636	-	516	1928	2634	0.7319666
A08	16084285	16086620	A08p10650.2_BraZ1	1033.5	-	363	1428	2335	0.6115631
A08	16090964	16091454	A08p10660.2_BraZ1	200.571	+	113	490	490	1.0000000
A08	16092100	16092334	A08p10670.2_BraZ1	11.7	-	1	47	234	0.2008547
A08	16093354	16093643	A08p10680.2_BraZ1	204	-	69	289	289	1.0000000
A08	16097144	16098845	A08p10690.2_BraZ1	1186.55	-	114	948	1701	0.5573192
A08	16100375	16102707	A08p10700.2_BraZ1	710.616	-	684	1828	2332	0.7838765
A08	16107832	16109697	A08p10710.2_BraZ1	213	+	1508	1737	1865	0.9313673
A08	16112151	16114386	A08p10720.2_BraZ1	192	+	744	2087	2235	0.9337808
A08	16115401	16117626	A08p10730.2_BraZ1	5049.78	+	1137	2092	2225	0.9402247
A08	16128842	16131417	A08p10740.2_BraZ1	1290.9	-	584	2575	2575	1.0000000
A08	16138449	16139619	A08p10750.2_BraZ1	570.375	+	6	152	1170	0.1299145
A08	16144449	16144698	A08p10760.2_BraZ1	24.9	+	11	88	249	0.3534136
A08	16148658	16151018	A08p10770.2_BraZ1	1465.9	-	611	1558	2360	0.6601695
A08	16155395	16156110	A08p10780.2_BraZ1	273	+	880	715	715	1.0000000
A08	16158154	16160148	A08p10790.2_BraZ1	493.714	-	506	1443	1994	0.7236710
A08	16164539	16166866	A08p10800.2_BraZ1	1014	-	209	1103	2327	0.4740009
A08	16177477	16178134	A08p10810.2_BraZ1	246	-	293	657	657	1.0000000
A08	16178237	16178436	A08p10820.2_BraZ1	123	-	91	199	199	1.0000000
A08	16186899	16189481	A08p10830.2_BraZ1	1397.25	+	354	1929	2582	0.7470953
A08	16210062	16211899	A08p10840.2_BraZ1	1150.65	+	19	311	1837	0.1692978
A08	16217342	16223752	A08p10850.2_BraZ1	2954.52	+	1628	4125	6410	0.6435257
A08	16224815	16234036	A08p10860.2_BraZ1	207.3	+	6605	8338	9221	0.9042403
A08	16230756	16231101	A08p10870.2_BraZ1	34.5	-	79	345	345	1.0000000
A08	16231567	16233322	A08p10880.2_BraZ1	733.429	+	232	1116	1755	0.6358975
A08	16234735	16235413	A08p10890.2_BraZ1	67.8	-	1188	678	678	1.0000000
A08	16237453	16238080	A08p10900.2_BraZ1	561	+	51	589	627	0.9393939
A08	16238968	16239446	A08p10910.2_BraZ1	402	-	17	312	478	0.6527197
A08	16239401	16241893	A08p10920.2_BraZ1	1483.2	-	347	1908	2492	0.7656501
A08	16242761	16243211	A08p10930.2_BraZ1	45	+	52	186	450	0.4133333
A08	16257655	16258638	A08p10940.2_BraZ1	846	-	436	942	983	0.9582909
A08	16259106	16260859	A08p10950.2_BraZ1	231	+	2766	1753	1753	1.0000000
A08	16263939	16264284	A08p10960.2_BraZ1	34.5	-	0	0	345	0.0000000
A08	16270640	16270955	A08p10970.2_BraZ1	31.5	+	361	315	315	1.0000000
A08	16274194	16277999	A08p10980.2_BraZ1	1462.08	+	3422	3777	3805	0.9926413
A08	16287355	16295125	A08p10990.2_BraZ1	2137.71	+	1842	5767	7770	0.7422137
A08	16300469	16303369	A08p11000.2_BraZ1	1596.6	-	540	2536	2900	0.8744828
A08	16315221	16316433	A08p11010.2_BraZ1	735.56	-	288	997	1212	0.8226073
A08	16322199	16325460	A08p11020.2_BraZ1	1897.71	-	445	2246	3261	0.6887458
A08	16339099	16339464	A08p11030.2_BraZ1	156	-	264	365	365	1.0000000
A08	16341796	16343662	A08p11040.2_BraZ1	104362	+	670	1866	1866	1.0000000
A08	16344699	16347309	A08p11050.2_BraZ1	1836	-	919	2610	2610	1.0000000
A08	16351394	16352538	A08p11060.2_BraZ1	180	+	1017	977	1144	0.8540210
A08	16364061	16365412	A08p11070.2_BraZ1	1739	-	915	1351	1351	1.0000000
A08	16367504	16370289	A08p11080.2_BraZ1	2138.69	-	380	1827	2785	0.6560144
A08	16370789	16372962	A08p11090.2_BraZ1	2100	+	64	1268	2173	0.5835251
A08	16373272	16394175	A08p11100.2_BraZ1	1189.33	-	13110	20249	20903	0.9687126
A08	16376484	16433344	A08p11110.2_BraZ1	351	+	34065	54846	56860	0.9645796
A08	16390496	16390853	A08p11120.2_BraZ1	35.7	+	58	152	357	0.4257703
A08	16396430	16396754	A08p11130.2_BraZ1	32.4	-	321	324	324	1.0000000
A08	16401381	16401927	A08p11140.2_BraZ1	432	+	25	447	546	0.8186813
A08	16423285	16424413	A08p11150.2_BraZ1	636	-	738	1128	1128	1.0000000
A08	16456914	16457295	A08p11160.2_BraZ1	38.1	+	7	48	381	0.1259843
A08	16457492	16457657	A08p11170.2_BraZ1	12	-	89	165	165	1.0000000
A08	16484705	16485086	A08p11180.2_BraZ1	38.1	+	1	48	381	0.1259843
A08	16485334	16485529	A08p11190.2_BraZ1	19.5	-	106	195	195	1.0000000
A08	16490286	16491233	A08p11200.2_BraZ1	827.368	+	10	389	947	0.4107709
A08	16504581	16505821	A08p11210.2_BraZ1	516.053	-	679	1240	1240	1.0000000
A08	16509023	16509314	A08p11220.2_BraZ1	29.1	+	145	291	291	1.0000000
A08	16515049	16517270	A08p11230.2_BraZ1	1242.62	+	115	1035	2221	0.4660063
A08	16520021	16521143	A08p11240.2_BraZ1	2014.44	-	92	785	1122	0.6996435
A08	16526328	16535040	A08p11250.2_BraZ1	975	-	5328	8285	8712	0.9509872
A08	16553650	16554465	A08p11260.2_BraZ1	816.667	-	394	726	815	0.8907976
A08	16561382	16563033	A08p11270.2_BraZ1	991.2	+	1365	1629	1651	0.9866747
A08	16579786	16582938	A08p11280.2_BraZ1	781	+	626	2807	3152	0.8905457
A08	16583019	16583956	A08p11290.2_BraZ1	46.5	-	262	937	937	1.0000000
A08	16583824	16587221	A08p11300.2_BraZ1	225.3	-	1497	2444	3397	0.7194583
A08	16587192	16587545	A08p11310.2_BraZ1	261	-	439	353	353	1.0000000
A08	16588603	16590631	A08p11320.2_BraZ1	42	-	382	1326	2028	0.6538461
A08	16589119	16594240	A08p11330.2_BraZ1	245.7	-	564	3164	5121	0.6178481
A08	16599885	16603163	A08p11340.2_BraZ1	1884.58	-	2537	3278	3278	1.0000000
A08	16631629	16633784	A08p11350.2_BraZ1	1526.13	-	315	1880	2155	0.8723898
A08	16634681	16638648	A08p11360.2_BraZ1	21595.3	+	1431	3820	3967	0.9629443
A08	16639036	16640354	A08p11370.2_BraZ1	231	+	1346	1318	1318	1.0000000
A08	16640429	16641071	A08p11380.2_BraZ1	64.2	-	345	642	642	1.0000000
A08	16644684	16647754	A08p11390.2_BraZ1	1257.23	+	1126	2811	3070	0.9156352
A08	16648520	16651004	A08p11400.2_BraZ1	1188.68	-	1724	2479	2484	0.9979871
A08	16661503	16664280	A08p11410.2_BraZ1	2709	-	261	1247	2777	0.4490457
A08	16675719	16678563	A08p11420.2_BraZ1	1891.27	+	515	1744	2844	0.6132208
A08	16680799	16681141	A08p11430.2_BraZ1	34.2	+	161	342	342	1.0000000
A08	16683635	16683944	A08p11440.2_BraZ1	30.9	-	542	309	309	1.0000000
A08	16687232	16690382	A08p11450.2_BraZ1	1689.6	+	194	988	3150	0.3136508
A08	16690865	16693327	A08p11460.2_BraZ1	1220.65	-	1348	1990	2462	0.8082860
A08	16694915	16695297	A08p11470.2_BraZ1	34.8	+	384	382	382	1.0000000
A08	16702581	16704650	A08p11480.2_BraZ1	938.875	+	365	1871	2069	0.9043016
A08	16706591	16707001	A08p11490.2_BraZ1	174	+	309	410	410	1.0000000
A08	16710358	16710682	A08p11500.2_BraZ1	32.4	-	191	324	324	1.0000000
A08	16712688	16714011	A08p11510.2_BraZ1	132.3	-	70	415	1323	0.3136810
A08	16748565	16749888	A08p11520.2_BraZ1	132.3	+	13	120	1323	0.0907030
A08	16759533	16760237	A08p11530.2_BraZ1	279	+	865	669	704	0.9502841
A08	16760355	16762290	A08p11540.2_BraZ1	951.818	-	179	1002	1935	0.5178295
A08	16778119	16780770	A08p11550.2_BraZ1	1705.46	+	1116	1797	2651	0.6778574
A08	16781911	16784356	A08p11560.2_BraZ1	1704.87	-	356	1755	2445	0.7177914
A08	16787349	16788038	A08p11570.2_BraZ1	309	-	130	637	689	0.9245283
A08	16789488	16789905	A08p11580.2_BraZ1	315	-	541	417	417	1.0000000
A08	16813173	16813549	A08p11590.2_BraZ1	744	+	449	376	376	1.0000000
A08	16816734	16817324	A08p11600.2_BraZ1	301.692	-	871	590	590	1.0000000
A08	16819114	16820852	A08p11610.2_BraZ1	330.667	-	942	1481	1738	0.8521289
A08	16823731	16824078	A08p11620.2_BraZ1	150	+	489	347	347	1.0000000
A08	16832404	16841269	A08p11630.2_BraZ1	1116.73	-	6620	8724	8865	0.9840947
A08	16841607	16842765	A08p11640.2_BraZ1	115.8	-	180	947	1158	0.8177893
A08	16846583	16848567	A08p11650.2_BraZ1	265.2	+	170	1672	1984	0.8427419
A08	16854716	16855787	A08p11660.2_BraZ1	369.288	-	65	742	1071	0.6928105
A08	16856966	16858529	A08p11670.2_BraZ1	156.3	+	235	1369	1563	0.8758797
A08	16864502	16864742	A08p11680.2_BraZ1	24	-	664	240	240	1.0000000
A08	16868226	16869655	A08p11690.2_BraZ1	453	-	1398	1429	1429	1.0000000
A08	16871025	16871373	A08p11700.2_BraZ1	34.8	-	91	254	348	0.7298850
A08	16873124	16873872	A08p11710.2_BraZ1	708	+	59	666	748	0.8903743
A08	16886303	16888560	A08p11720.2_BraZ1	1215.98	-	545	2159	2257	0.9565795
A08	16892310	16897766	A08p11730.2_BraZ1	1018.43	-	3126	4709	5456	0.8630865
A08	16915058	16917176	A08p11740.2_BraZ1	1251.38	-	439	1321	2118	0.6237016
A08	16918181	16920011	A08p11750.2_BraZ1	183	-	242	1450	1830	0.7923498
A08	16921825	16923436	A08p11760.2_BraZ1	9108	-	311	890	1611	0.5524519
A08	16924534	16925819	A08p11770.2_BraZ1	126	+	11	218	1285	0.1696498
A08	16935575	16937494	A08p11780.2_BraZ1	1278	+	0	0	1919	0.0000000
A08	16940136	16941501	A08p11790.2_BraZ1	136.5	-	357	1175	1365	0.8608059
A08	16942277	16943257	A08p11800.2_BraZ1	556.875	-	395	980	980	1.0000000
A08	16943466	16944429	A08p11810.2_BraZ1	186	-	203	518	963	0.5379024
A08	16945472	16947496	A08p11820.2_BraZ1	47.4	-	2117	2023	2024	0.9995059
A08	16948126	16949172	A08p11830.2_BraZ1	830.455	-	1	39	1046	0.0372849
A08	16957270	16957840	A08p11840.2_BraZ1	381	-	240	570	570	1.0000000
A08	16962249	16964124	A08p11850.2_BraZ1	1623.13	-	1040	1844	1875	0.9834667
A08	16975444	16976723	A08p11860.2_BraZ1	448.971	+	239	893	1279	0.6982017
A08	16977165	16980164	A08p11870.2_BraZ1	1494.43	-	772	2943	2999	0.9813271
A08	16982244	16983604	A08p11880.2_BraZ1	504	+	534	1151	1360	0.8463235
A08	16992530	16993427	A08p11890.2_BraZ1	432	+	66	378	897	0.4214047
A08	16997553	16997968	A08p11900.2_BraZ1	339	+	469	415	415	1.0000000
A08	17010479	17011199	A08p11910.2_BraZ1	1560.94	-	697	720	720	1.0000000
A08	17020221	17025704	A08p11920.2_BraZ1	1872.75	-	3819	5483	5483	1.0000000
A08	17038758	17044722	A08p11930.2_BraZ1	946.714	-	6704	5964	5964	1.0000000
A08	17046587	17047323	A08p11940.2_BraZ1	420	-	4	144	736	0.1956522
A08	17053133	17053412	A08p11950.2_BraZ1	27.9	-	10	134	279	0.4802867
A08	17072042	17072794	A08p11960.2_BraZ1	378	+	54	589	752	0.7832447
A08	17073903	17075961	A08p11970.2_BraZ1	39	+	147	1470	2058	0.7142857
A08	17076182	17076731	A08p11980.2_BraZ1	436.5	-	87	424	549	0.7723133
A08	17079778	17083797	A08p11990.2_BraZ1	10305	-	1496	3914	4019	0.9738741
A08	17091335	17095753	A08p12000.2_BraZ1	1159.69	+	2963	4388	4418	0.9932096
A08	17096973	17101826	A08p12010.2_BraZ1	2619.87	-	2350	4523	4853	0.9320008
A08	17106447	17108635	A08p12020.2_BraZ1	1292.98	+	347	1876	2188	0.8574040
A08	17110000	17111702	A08p12030.2_BraZ1	168.3	+	1340	1599	1702	0.9394830
A08	17112809	17117069	A08p12040.2_BraZ1	1904.28	-	502	3075	4260	0.7218310
A08	17126301	17128365	A08p12050.2_BraZ1	480	+	1106	1823	2064	0.8832364
A08	17130411	17131540	A08p12060.2_BraZ1	489	+	26	655	1129	0.5801594
A08	17131006	17134599	A08p12070.2_BraZ1	483	-	418	2616	3593	0.7280824
A08	17136283	17136811	A08p12080.2_BraZ1	52.8	+	0	0	528	0.0000000
A08	17140673	17141852	A08p12090.2_BraZ1	117.9	+	258	988	1179	0.8379983
A08	17151581	17152417	A08p12100.2_BraZ1	434	+	326	692	836	0.8277512
A08	17153139	17153865	A08p12110.2_BraZ1	642	-	275	725	726	0.9986226
A08	17160981	17166005	A08p12120.2_BraZ1	107.4	+	2903	4673	5024	0.9301354
A08	17171220	17171373	A08p12130.2_BraZ1	15.3	-	9	110	153	0.7189543
A08	17171530	17173711	A08p12140.2_BraZ1	1015.45	-	1250	2159	2181	0.9899129
A08	17180330	17180519	A08p12150.2_BraZ1	18.9	+	547	189	189	1.0000000
A08	17185169	17191319	A08p12160.2_BraZ1	1465.85	-	5994	5468	6150	0.8891057
A08	17203921	17205463	A08p12170.2_BraZ1	154.2	+	29	363	1542	0.2354086
A08	17207797	17221243	A08p12180.2_BraZ1	396	-	7514	10665	13446	0.7931727
A08	17234775	17241158	A08p12190.2_BraZ1	466.161	-	3809	6383	6383	1.0000000
A08	17242367	17243336	A08p12200.2_BraZ1	96.9	+	94	648	969	0.6687307
A08	17272217	17272346	A08p12210.2_BraZ1	12.9	-	43	129	129	1.0000000
A08	17272526	17275259	A08p12220.2_BraZ1	2246.66	+	221	1907	2733	0.6977680
A08	17276547	17277066	A08p12230.2_BraZ1	51.9	-	315	519	519	1.0000000
A08	17278741	17279933	A08p12240.2_BraZ1	960	+	226	1084	1192	0.9093960
A08	17280668	17282331	A08p12250.2_BraZ1	1497	-	1186	1658	1663	0.9969934
A08	17290315	17292102	A08p12260.2_BraZ1	1101.24	+	202	985	1787	0.5512031
A08	17293449	17296857	A08p12270.2_BraZ1	1382.4	-	353	2208	3408	0.6478873
A08	17303807	17304029	A08p12280.2_BraZ1	22.2	+	459	222	222	1.0000000
A08	17306579	17307908	A08p12290.2_BraZ1	360	-	1620	1329	1329	1.0000000
A08	17307263	17307679	A08p12300.2_BraZ1	189	-	641	416	416	1.0000000
A08	17314512	17320194	A08p12310.2_BraZ1	943.636	+	6145	5682	5682	1.0000000
A08	17340747	17342906	A08p12320.2_BraZ1	573.414	+	201	1318	2159	0.6104678
A08	17372518	17373269	A08p12330.2_BraZ1	1374	+	176	602	751	0.8015979
A08	17374116	17375847	A08p12340.2_BraZ1	935.64	+	980	1494	1731	0.8630849
A08	17377214	17377778	A08p12350.2_BraZ1	249.667	+	570	544	564	0.9645390
A08	17377963	17379304	A08p12360.2_BraZ1	134.1	-	82	548	1341	0.4086502
A08	17384794	17386154	A08p12370.2_BraZ1	664	-	584	1191	1360	0.8757353
A08	17386290	17386578	A08p12380.2_BraZ1	28.8	-	24	240	288	0.8333333
A08	17386754	17388707	A08p12390.2_BraZ1	459	+	352	947	1953	0.4848950
A08	17391611	17398818	A08p12400.2_BraZ1	757.938	-	647	4038	7207	0.5602886
A08	17413326	17414360	A08p12410.2_BraZ1	81.3	-	481	845	1034	0.8172147
A08	17415026	17415622	A08p12420.2_BraZ1	1140	+	679	596	596	1.0000000
A08	17416111	17425868	A08p12430.2_BraZ1	3292.8	-	1540	4203	9757	0.4307677
A08	17419417	17420757	A08p12440.2_BraZ1	148.5	+	20	307	1340	0.2291045
A08	17427205	17429677	A08p12450.2_BraZ1	1910.81	+	614	2105	2472	0.8515372
A08	17430653	17434165	A08p12460.2_BraZ1	673.909	-	946	2449	3512	0.6973234
A08	17441388	17441599	A08p12470.2_BraZ1	120	+	41	211	211	1.0000000
A08	17445763	17449118	A08p12480.2_BraZ1	2285.36	+	1577	3147	3355	0.9380030
A08	17449451	17450144	A08p12490.2_BraZ1	69.3	-	254	693	693	1.0000000
A08	17456440	17458284	A08p12500.2_BraZ1	192	-	70	1271	1844	0.6892624
A08	17459480	17461958	A08p12510.2_BraZ1	1168.28	+	1966	2478	2478	1.0000000
A08	17463482	17463903	A08p12520.2_BraZ1	408	-	338	421	421	1.0000000
A08	17470888	17472231	A08p12530.2_BraZ1	983.478	+	1721	1343	1343	1.0000000
A08	17477141	17479414	A08p12540.2_BraZ1	63.6	-	312	2148	2273	0.9450066
A08	17481559	17481748	A08p12550.2_BraZ1	18.9	-	2	144	189	0.7619048
A08	17483518	17485051	A08p12560.2_BraZ1	153.3	-	43	751	1533	0.4898891
A08	17491531	17492728	A08p12570.2_BraZ1	2492.1	-	97	1083	1197	0.9047619
A08	17495341	17496469	A08p12580.2_BraZ1	659.75	+	540	1128	1128	1.0000000
A08	17498852	17500096	A08p12590.2_BraZ1	518.75	-	867	1244	1244	1.0000000
A08	17506874	17507597	A08p12600.2_BraZ1	72.3	-	129	547	723	0.7565699
A08	17508972	17509751	A08p12610.2_BraZ1	276	+	588	779	779	1.0000000
A08	17518202	17518716	A08p12620.2_BraZ1	246	+	20	148	514	0.2879377
A08	17522418	17523050	A08p12630.2_BraZ1	300	+	411	632	632	1.0000000
A08	17529887	17531339	A08p12640.2_BraZ1	145.2	-	69	1005	1452	0.6921487
A08	17537933	17539390	A08p12650.2_BraZ1	1212.75	+	124	1194	1457	0.8194921
A08	17544521	17546853	A08p12660.2_BraZ1	1182.18	+	856	2144	2332	0.9193825
A08	17548254	17548416	A08p12670.2_BraZ1	16.2	-	92	126	162	0.7777778
A08	17551097	17552976	A08p12680.2_BraZ1	505.227	-	335	1518	1879	0.8078765
A08	17561918	17563333	A08p12690.2_BraZ1	447	+	55	1131	1415	0.7992933
A08	17567907	17568051	A08p12700.2_BraZ1	14.4	+	205	144	144	1.0000000
A08	17570194	17572609	A08p12710.2_BraZ1	605.38	-	738	2057	2415	0.8517599
A08	17584287	17584889	A08p12720.2_BraZ1	519	+	103	494	602	0.8205980
A08	17586165	17590140	A08p12730.2_BraZ1	2299.58	+	1565	3689	3975	0.9280503
A08	17590609	17591206	A08p12740.2_BraZ1	59.7	+	520	597	597	1.0000000
A08	17591681	17591846	A08p12750.2_BraZ1	16.5	+	62	165	165	1.0000000
A08	17592776	17594769	A08p12760.2_BraZ1	144	-	821	1787	1993	0.8966382
A08	17595508	17596546	A08p12770.2_BraZ1	504	-	164	889	1038	0.8564547
A08	17598410	17598626	A08p12780.2_BraZ1	21.6	+	3	51	216	0.2361111
A08	17599578	17599952	A08p12790.2_BraZ1	246	+	88	374	374	1.0000000
A08	17600931	17601337	A08p12800.2_BraZ1	339	+	196	406	406	1.0000000
A08	17603555	17604998	A08p12810.2_BraZ1	243	+	955	1443	1443	1.0000000
A08	17605637	17606027	A08p12820.2_BraZ1	39	+	66	345	390	0.8846154
A08	17606137	17607035	A08p12830.2_BraZ1	750	-	79	799	898	0.8897550
A08	17608549	17609482	A08p12840.2_BraZ1	300	-	254	852	933	0.9131833
A08	17614643	17615391	A08p12850.2_BraZ1	663	+	41	317	748	0.4237968
A08	17619093	17619501	A08p12860.2_BraZ1	667.5	-	370	402	408	0.9852941
A08	17626626	17627285	A08p12870.2_BraZ1	552	+	90	399	659	0.6054628
A08	17635204	17637467	A08p12880.2_BraZ1	1043.78	+	1189	2146	2263	0.9482987
A08	17637957	17640151	A08p12890.2_BraZ1	1880.42	-	684	1959	2194	0.8928897
A08	17642384	17642921	A08p12900.2_BraZ1	53.7	-	249	487	537	0.9068902
A08	17644306	17646326	A08p12910.2_BraZ1	856.22	-	1061	1958	2020	0.9693069
A08	17654122	17654260	A08p12920.2_BraZ1	13.8	-	60	138	138	1.0000000
A08	17660152	17663841	A08p12930.2_BraZ1	1387.41	-	669	3223	3689	0.8736785
A08	17688636	17690227	A08p12940.2_BraZ1	190	+	266	487	1591	0.3060968
A08	17693666	17694072	A08p12950.2_BraZ1	354	-	842	406	406	1.0000000
A08	17696702	17697792	A08p12960.2_BraZ1	457.011	-	91	782	1090	0.7174312
A08	17705344	17705653	A08p12970.2_BraZ1	300	+	202	309	309	1.0000000
A08	17705644	17706053	A08p12980.2_BraZ1	288	+	167	409	409	1.0000000
A08	17709099	17709909	A08p12990.2_BraZ1	336	+	206	721	810	0.8901235
A08	17715242	17716220	A08p13000.2_BraZ1	378	+	1022	978	978	1.0000000
A08	17720155	17721587	A08p13010.2_BraZ1	1133.36	+	227	1057	1432	0.7381285
A08	17728350	17729693	A08p13020.2_BraZ1	602.188	+	874	1277	1343	0.9508563
A08	17729881	17730657	A08p13030.2_BraZ1	630	-	421	776	776	1.0000000
A08	17735055	17735268	A08p13040.2_BraZ1	21.3	+	187	213	213	1.0000000
A08	17738845	17739173	A08p13050.2_BraZ1	32.1	+	39	268	328	0.8170732
A08	17745557	17747377	A08p13060.2_BraZ1	912	-	635	1760	1820	0.9670330
A08	17754057	17756063	A08p13070.2_BraZ1	868.389	+	919	1948	2006	0.9710867
A08	17757949	17759878	A08p13080.2_BraZ1	970.133	+	539	1309	1929	0.6785899
A08	17776204	17778945	A08p13090.2_BraZ1	1511.71	-	79	1850	2741	0.6749362
A08	17779814	17786418	A08p13100.2_BraZ1	208	+	5205	6397	6604	0.9686553
A08	17789822	17797290	A08p13110.2_BraZ1	4099.2	+	979	5193	7468	0.6953669
A08	17800550	17800958	A08p13120.2_BraZ1	40.8	+	36	204	408	0.5000000
A08	17813186	17817389	A08p13130.2_BraZ1	1515	-	755	2696	4203	0.6414466
A08	17820440	17820587	A08p13140.2_BraZ1	11.7	-	192	147	147	1.0000000
A08	17824477	17825994	A08p13150.2_BraZ1	995.211	+	35	689	1517	0.4541859
A08	17859274	17863796	A08p13160.2_BraZ1	1155	+	57	399	4522	0.0882353
A08	17871900	17876136	A08p13170.2_BraZ1	1471.71	-	408	2427	4236	0.5729462
A08	17885948	17887473	A08p13180.2_BraZ1	2539.69	+	404	1525	1525	1.0000000
A08	17917227	17921756	A08p13190.2_BraZ1	1155	+	0	0	4529	0.0000000
A08	17924749	17925850	A08p13200.2_BraZ1	810	+	1315	1101	1101	1.0000000
A08	17927101	17929879	A08p13210.2_BraZ1	824.727	-	1486	2741	2778	0.9866810
A08	17930704	17931264	A08p13220.2_BraZ1	153.474	-	47	560	560	1.0000000
A08	17945736	17946507	A08p13230.2_BraZ1	77.1	+	8	219	771	0.2840467
A08	17953355	17958907	A08p13240.2_BraZ1	1413.83	-	236	1560	5552	0.2809798
A08	17955694	17958454	A08p13250.2_BraZ1	519	+	95	347	2760	0.1257246
A08	17961812	17962025	A08p13260.2_BraZ1	21.3	+	162	213	213	1.0000000
A08	17970388	17971221	A08p13270.2_BraZ1	305	+	257	833	833	1.0000000
A08	17974062	17975385	A08p13280.2_BraZ1	132.3	-	403	1285	1323	0.9712774
A08	17977809	17979213	A08p13290.2_BraZ1	1242.47	+	564	1377	1404	0.9807692
A08	17981325	17983337	A08p13300.2_BraZ1	1644.75	+	336	1365	2012	0.6784294
A08	17989777	17993018	A08p13310.2_BraZ1	1992.6	+	736	2550	3241	0.7867942
A08	17993604	17994710	A08p13320.2_BraZ1	738.158	+	425	1106	1106	1.0000000
A08	17995280	17996520	A08p13330.2_BraZ1	613.846	+	218	968	1240	0.7806451
A08	17999418	18000849	A08p13340.2_BraZ1	143.1	-	135	1252	1431	0.8749126
A08	18007215	18009510	A08p13350.2_BraZ1	606	-	1493	2174	2295	0.9472767
A08	18020809	18022957	A08p13360.2_BraZ1	582	+	236	1637	2148	0.7621043
A08	18027515	18030042	A08p13370.2_BraZ1	383.333	-	616	2257	2527	0.8931540
A08	18030667	18032611	A08p13380.2_BraZ1	2093	+	284	1757	1944	0.9038066
A08	18048727	18049187	A08p13390.2_BraZ1	183.75	-	49	460	460	1.0000000
A08	18050381	18050687	A08p13400.2_BraZ1	30.6	+	1	28	306	0.0915033
A08	18062324	18062633	A08p13410.2_BraZ1	30.9	+	237	309	309	1.0000000
A08	18072417	18072726	A08p13420.2_BraZ1	30.9	+	3	59	309	0.1909385
A08	18083911	18085322	A08p13430.2_BraZ1	1311	-	78	539	1411	0.3819986
A08	18087023	18088379	A08p13440.2_BraZ1	134.7	-	34	59	1356	0.0435103
A08	18096529	18103874	A08p13450.2_BraZ1	2694.31	-	1425	4805	7345	0.6541865
A08	18109515	18110406	A08p13460.2_BraZ1	89.1	-	240	720	891	0.8080808
A08	18116659	18121410	A08p13470.2_BraZ1	372	-	3617	4548	4751	0.9572722
A08	18121461	18127042	A08p13480.2_BraZ1	993.937	-	3838	4671	5581	0.8369468
A08	18129534	18129873	A08p13490.2_BraZ1	33.9	+	198	339	339	1.0000000
A08	18141934	18142225	A08p13500.2_BraZ1	190.929	+	26	262	291	0.9003437
A08	18146647	18146896	A08p13510.2_BraZ1	24.9	+	1	150	249	0.6024097
A08	18147420	18147984	A08p13520.2_BraZ1	56.4	+	171	445	564	0.7890071
A08	18148732	18149587	A08p13530.2_BraZ1	471	-	882	855	855	1.0000000
A08	18160332	18162111	A08p13540.2_BraZ1	5790	+	8	274	1779	0.1540191
A08	18163416	18164530	A08p13550.2_BraZ1	348.91	+	619	1105	1114	0.9919210
A08	18165533	18166777	A08p13560.2_BraZ1	344	-	761	1167	1244	0.9381029
A08	18168365	18169576	A08p13570.2_BraZ1	824.571	-	1180	1182	1211	0.9760528
A08	18176451	18177545	A08p13580.2_BraZ1	564	+	218	618	1094	0.5648994
A08	18180235	18183627	A08p13590.2_BraZ1	1659.9	+	546	2769	3392	0.8163325
A08	18187420	18187594	A08p13600.2_BraZ1	17.4	+	269	174	174	1.0000000
A08	18196482	18200057	A08p13610.2_BraZ1	394.364	-	2666	3575	3575	1.0000000
A08	18212871	18213145	A08p13620.2_BraZ1	225	+	11	262	274	0.9562044
A08	18213390	18214120	A08p13630.2_BraZ1	177	+	2	126	730	0.1726027
A08	18215857	18217043	A08p13640.2_BraZ1	369	+	663	1139	1186	0.9603710
A08	18217466	18219107	A08p13650.2_BraZ1	634.952	+	1552	1641	1641	1.0000000
A08	18219753	18221335	A08p13660.2_BraZ1	261.905	+	1465	1582	1582	1.0000000
A08	18223251	18225217	A08p13670.2_BraZ1	324.467	-	48	601	1966	0.3056968
A08	18225286	18225730	A08p13680.2_BraZ1	44.4	+	8	367	444	0.8265766
A08	18227601	18230355	A08p13690.2_BraZ1	797.143	+	1309	2754	2754	1.0000000
A08	18236998	18237438	A08p13700.2_BraZ1	1062	+	285	440	440	1.0000000
A08	18240036	18242271	A08p13710.2_BraZ1	631.125	+	1073	2235	2235	1.0000000
A08	18243262	18244171	A08p13720.2_BraZ1	726	+	508	909	909	1.0000000
A08	18260852	18261689	A08p13730.2_BraZ1	83.7	+	181	811	837	0.9689367
A08	18262307	18263209	A08p13740.2_BraZ1	395.846	+	0	0	902	0.0000000
A08	18267307	18270633	A08p13750.2_BraZ1	2114.87	-	1193	2228	3326	0.6698737
A08	18273976	18274393	A08p13760.2_BraZ1	41.7	-	0	0	417	0.0000000
A08	18286502	18288548	A08p13770.2_BraZ1	1932	+	1195	1940	2046	0.9481916
A08	18292266	18293299	A08p13780.2_BraZ1	446.25	+	748	1033	1033	1.0000000
A08	18299811	18300411	A08p13790.2_BraZ1	60	+	45	287	600	0.4783333
A08	18309986	18310400	A08p13800.2_BraZ1	41.4	+	2	104	414	0.2512077
A08	18312322	18312631	A08p13810.2_BraZ1	30.9	-	547	309	309	1.0000000
A08	18313600	18316304	A08p13820.2_BraZ1	1435.16	-	363	2111	2704	0.7806953
A08	18323989	18328351	A08p13830.2_BraZ1	2322.55	+	1359	2641	4362	0.6054562
A08	18345310	18345832	A08p13840.2_BraZ1	52.2	+	45	363	522	0.6954023
A08	18351329	18351539	A08p13850.2_BraZ1	21	+	34	210	210	1.0000000
A08	18352182	18353379	A08p13860.2_BraZ1	385.527	+	724	1172	1197	0.9791145
A08	18356191	18357023	A08p13870.2_BraZ1	741	+	58	644	832	0.7740384
A08	18359764	18360494	A08p13880.2_BraZ1	313.5	-	775	730	730	1.0000000
A08	18367355	18368097	A08p13890.2_BraZ1	418.5	-	644	742	742	1.0000000
A08	18368098	18368329	A08p13900.2_BraZ1	23.1	-	444	231	231	1.0000000
A08	18371572	18372283	A08p13910.2_BraZ1	369	+	353	711	711	1.0000000
A08	18372376	18373007	A08p13920.2_BraZ1	428.8	+	49	298	631	0.4722663
A08	18372999	18373964	A08p13930.2_BraZ1	165	+	0	0	965	0.0000000
A08	18376689	18377388	A08p13940.2_BraZ1	69.9	-	56	309	699	0.4420601
A08	18389503	18389959	A08p13950.2_BraZ1	45.6	+	105	369	456	0.8092105
A08	18391195	18397416	A08p13960.2_BraZ1	834	-	21168	5964	6221	0.9586883
A08	18408581	18409588	A08p13970.2_BraZ1	285.37	+	698	1007	1007	1.0000000
A08	18416813	18417221	A08p13980.2_BraZ1	40.8	+	92	408	408	1.0000000
A08	18422732	18428666	A08p13990.2_BraZ1	3188.21	+	876	2383	5934	0.4015841
A08	18430742	18431941	A08p14000.2_BraZ1	879	+	777	1199	1199	1.0000000
A08	18432590	18435457	A08p14010.2_BraZ1	2120.84	-	474	1732	2867	0.6041158
A08	18436735	18438827	A08p14020.2_BraZ1	354	-	2072	2092	2092	1.0000000
A08	18447796	18449053	A08p14030.2_BraZ1	78.6	+	159	750	1257	0.5966587
A08	18452754	18454830	A08p14040.2_BraZ1	207.6	+	252	1567	2076	0.7548169
A08	18455243	18456512	A08p14050.2_BraZ1	999.429	+	242	1148	1269	0.9046493
A08	18456754	18459269	A08p14060.2_BraZ1	1272.48	-	880	1709	2515	0.6795229
A08	18463001	18463980	A08p14070.2_BraZ1	615	-	347	979	979	1.0000000
A08	18468173	18469262	A08p14080.2_BraZ1	531.807	-	221	1042	1089	0.9568411
A08	18481894	18483317	A08p14090.2_BraZ1	40.2	+	1968	1423	1423	1.0000000
A08	18487859	18488580	A08p14100.2_BraZ1	351	+	231	721	721	1.0000000
A08	18488012	18488790	A08p14110.2_BraZ1	213	+	250	778	778	1.0000000
A08	18489830	18490214	A08p14120.2_BraZ1	38.4	+	10	84	384	0.2187500
A08	18492118	18493017	A08p14130.2_BraZ1	273	+	165	799	899	0.8887653
A08	18495847	18496814	A08p14140.2_BraZ1	264	+	124	659	967	0.6814892
A08	18514089	18514425	A08p14150.2_BraZ1	33.6	-	15	215	336	0.6398810
A08	18520024	18521898	A08p14160.2_BraZ1	405	+	710	1614	1874	0.8612593
A08	18524541	18524886	A08p14170.2_BraZ1	34.5	-	31	141	345	0.4086956
A08	18533710	18536722	A08p14180.2_BraZ1	142.8	-	415	2492	3012	0.8273572
A08	18537904	18540359	A08p14190.2_BraZ1	1105.5	+	1305	2329	2455	0.9486762
A08	18539828	18540914	A08p14200.2_BraZ1	231.25	+	52	710	1086	0.6537753
A08	18545410	18547129	A08p14210.2_BraZ1	675	+	733	1658	1719	0.9645143
A08	18547484	18547730	A08p14220.2_BraZ1	24.6	-	206	246	246	1.0000000
A08	18548893	18550870	A08p14230.2_BraZ1	850	-	1709	1977	1977	1.0000000
A08	18558724	18559940	A08p14240.2_BraZ1	722	-	118	1055	1216	0.8675987
A08	18563157	18563292	A08p14250.2_BraZ1	13.5	-	24	135	135	1.0000000
A08	18563295	18563925	A08p14260.2_BraZ1	63	-	53	401	630	0.6365079
A08	18570152	18572135	A08p14270.2_BraZ1	675.684	-	765	1315	1983	0.6631367
A08	18579305	18583408	A08p14280.2_BraZ1	1861.56	-	2015	4006	4103	0.9763588
A08	18586273	18586450	A08p14290.2_BraZ1	17.7	-	88	177	177	1.0000000
A08	18587818	18590349	A08p14300.2_BraZ1	1473.53	+	1959	2343	2531	0.9257210
A08	18591025	18592118	A08p14310.2_BraZ1	735	-	1777	1093	1093	1.0000000
A08	18592792	18592933	A08p14320.2_BraZ1	14.1	+	198	127	141	0.9007092
A08	18594455	18594872	A08p14330.2_BraZ1	41.7	-	0	0	417	0.0000000
A08	18596054	18596955	A08p14340.2_BraZ1	6226.88	-	311	863	901	0.9578246
A08	18598706	18598958	A08p14350.2_BraZ1	15.9	+	1765	252	252	1.0000000
A08	18602519	18602714	A08p14360.2_BraZ1	19.5	-	148	195	195	1.0000000
A08	18608826	18615471	A08p14370.2_BraZ1	1329.61	+	1471	5346	6645	0.8045146
A08	18621724	18623900	A08p14380.2_BraZ1	822.391	-	3236	2176	2176	1.0000000
A08	18633002	18633185	A08p14390.2_BraZ1	18.3	-	333	183	183	1.0000000
A08	18637538	18637835	A08p14400.2_BraZ1	150	-	1257	297	297	1.0000000
A08	18639293	18640589	A08p14410.2_BraZ1	129.6	-	232	870	1296	0.6712963
A08	18657660	18661738	A08p14420.2_BraZ1	833.226	-	1929	3965	4078	0.9722903
A08	18663818	18664016	A08p14430.2_BraZ1	19.8	-	64	198	198	1.0000000
A08	18669422	18669946	A08p14440.2_BraZ1	288	-	243	524	524	1.0000000
A08	18671244	18671754	A08p14450.2_BraZ1	405	-	0	0	510	0.0000000
A08	18675711	18678187	A08p14460.2_BraZ1	1153.91	-	1022	1849	2476	0.7467690
A08	18679504	18681207	A08p14470.2_BraZ1	694.829	+	10547	1703	1703	1.0000000
A08	18682361	18682658	A08p14480.2_BraZ1	29.7	+	75	270	297	0.9090909
A08	18693006	18693474	A08p14490.2_BraZ1	46.8	+	4	154	468	0.3290598
A08	18695456	18695983	A08p14500.2_BraZ1	213	-	85	318	527	0.6034155
A08	18696171	18697169	A08p14510.2_BraZ1	328.125	-	810	936	998	0.9378757
A08	18701412	18701887	A08p14520.2_BraZ1	372	-	150	475	475	1.0000000
A08	18703611	18704020	A08p14530.2_BraZ1	321	-	352	409	409	1.0000000
A08	18704936	18705678	A08p14540.2_BraZ1	72.6	-	234	742	742	1.0000000
A08	18705662	18707133	A08p14550.2_BraZ1	644.211	-	1362	1437	1471	0.9768865
A08	18709619	18710290	A08p14560.2_BraZ1	285.333	-	0	0	671	0.0000000
A08	18713630	18715810	A08p14570.2_BraZ1	1293.75	+	839	2089	2180	0.9582569
A08	18716672	18716933	A08p14580.2_BraZ1	174	+	273	261	261	1.0000000
A08	18717692	18718799	A08p14590.2_BraZ1	405.462	-	510	1107	1107	1.0000000
A08	18724758	18747207	A08p14600.2_BraZ1	1260	-	1066	7353	22449	0.3275424
A08	18761193	18763992	A08p14610.2_BraZ1	1164.12	+	913	2634	2799	0.9410504
A08	18764289	18765478	A08p14620.2_BraZ1	671.556	-	778	1189	1189	1.0000000
A08	18768759	18770399	A08p14630.2_BraZ1	1566	-	361	1358	1640	0.8280488
A08	18771446	18773849	A08p14640.2_BraZ1	1701	-	614	2185	2403	0.9092801
A08	18780435	18782161	A08p14650.2_BraZ1	957.158	+	630	1514	1726	0.8771726
A08	18782660	18783191	A08p14660.2_BraZ1	53.1	+	215	497	531	0.9359699
A08	18784674	18786942	A08p14670.2_BraZ1	226.8	-	148	996	2268	0.4391534
A08	18787512	18790539	A08p14680.2_BraZ1	1548.25	+	438	2259	3027	0.7462835
A08	18794068	18795280	A08p14690.2_BraZ1	121.2	+	97	1154	1212	0.9521452
A08	18800182	18804660	A08p14700.2_BraZ1	3052.9	+	117	1011	4478	0.2257704
A08	18805173	18812891	A08p14710.2_BraZ1	5009.62	-	7	63	7718	0.0081627
A08	18815494	18822527	A08p14720.2_BraZ1	2379	-	1657	5826	7033	0.8283805
A08	18816219	18818338	A08p14730.2_BraZ1	535.543	+	465	1887	2119	0.8905144
A08	18827389	18827720	A08p14740.2_BraZ1	21.6	-	25	211	331	0.6374623
A08	18832413	18841299	A08p14750.2_BraZ1	3785	+	33	303	8886	0.0340986
A08	18841793	18842321	A08p14760.2_BraZ1	3360	-	0	0	528	0.0000000
A08	18847887	18848415	A08p14770.2_BraZ1	3360	+	0	0	528	0.0000000
A08	18848910	18886090	A08p14780.2_BraZ1	4015.21	-	11206	24072	37180	0.6474448
A08	18856096	18857705	A08p14790.2_BraZ1	112.2	-	0	0	1609	0.0000000
A08	18890443	18891132	A08p14800.2_BraZ1	733.5	-	1210	689	689	1.0000000
A08	18891622	18893038	A08p14810.2_BraZ1	670.286	-	891	1416	1416	1.0000000
A08	18896260	18901693	A08p14820.2_BraZ1	1758.39	+	2882	5279	5433	0.9716547
A08	18901930	18903008	A08p14830.2_BraZ1	633.889	-	761	1078	1078	1.0000000
A08	18903116	18918889	A08p14840.2_BraZ1	164.407	-	3912	10718	15773	0.6795156
A08	18919648	18920963	A08p14850.2_BraZ1	7068	-	525	1043	1315	0.7931559
A08	18928283	18929126	A08p14860.2_BraZ1	84.3	-	99	484	843	0.5741400
A08	18933948	18934701	A08p14870.2_BraZ1	75.3	+	168	707	753	0.9389110
A08	18939349	18939998	A08p14880.2_BraZ1	324	-	612	649	649	1.0000000
A08	18944380	18945545	A08p14890.2_BraZ1	115.8	+	618	1165	1165	1.0000000
A08	18949582	18950705	A08p14900.2_BraZ1	936	+	231	1069	1123	0.9519145
A08	18955170	18957054	A08p14910.2_BraZ1	985.922	+	318	1608	1884	0.8535032
A08	18957446	18958560	A08p14920.2_BraZ1	597.125	-	449	1093	1114	0.9811490
A08	18961562	18963218	A08p14930.2_BraZ1	66.9	-	9	313	1656	0.1890097
A08	18964029	18964770	A08p14940.2_BraZ1	45.3	+	6	17	741	0.0229420
A08	18965575	18967340	A08p14950.2_BraZ1	1638.41	-	56	842	1765	0.4770538
A08	18968889	18970032	A08p14960.2_BraZ1	596.283	+	604	1143	1143	1.0000000
A08	18971233	18973655	A08p14970.2_BraZ1	1252.14	-	424	1944	2422	0.8026425
A08	18978236	18979936	A08p14980.2_BraZ1	906.286	+	1096	1633	1700	0.9605882
A08	18988209	18989684	A08p14990.2_BraZ1	1153.19	+	458	1223	1475	0.8291525
A08	19000039	19003178	A08p15000.2_BraZ1	792.939	-	361	2208	3139	0.7034087
A08	19009429	19010297	A08p15010.2_BraZ1	299.75	+	817	752	868	0.8663595
A08	19021221	19022363	A08p15020.2_BraZ1	4898.25	-	536	997	1142	0.8730298
A08	19023600	19026842	A08p15030.2_BraZ1	1785	-	1138	2952	3242	0.9105490
A08	19029887	19030735	A08p15040.2_BraZ1	642	+	763	848	848	1.0000000
A08	19034883	19036627	A08p15050.2_BraZ1	1380.6	-	586	1015	1744	0.5819954
A08	19054999	19055295	A08p15060.2_BraZ1	15	-	39	293	296	0.9898649
A08	19055634	19055915	A08p15070.2_BraZ1	207	+	24	207	281	0.7366548
A08	19060540	19061190	A08p15080.2_BraZ1	57.9	+	80	550	650	0.8461539
A08	19065063	19065237	A08p15090.2_BraZ1	17.4	-	383	174	174	1.0000000
A08	19072445	19074964	A08p15100.2_BraZ1	1860.49	+	312	1632	2519	0.6478761
A08	19088876	19090257	A08p15110.2_BraZ1	646.875	+	310	1313	1381	0.9507603
A08	19093464	19094385	A08p15120.2_BraZ1	783	+	405	921	921	1.0000000
A08	19094943	19096605	A08p15130.2_BraZ1	1257.14	-	1420	1662	1662	1.0000000
A08	19100262	19102007	A08p15140.2_BraZ1	705	-	426	1565	1745	0.8968481
A08	19104317	19105512	A08p15150.2_BraZ1	7627.5	+	751	1195	1195	1.0000000
A08	19107076	19108091	A08p15160.2_BraZ1	897	-	902	992	1015	0.9773399
A08	19108987	19109798	A08p15170.2_BraZ1	402	-	83	683	811	0.8421702
A08	19115014	19115332	A08p15180.2_BraZ1	31.8	+	73	318	318	1.0000000
A08	19116121	19119882	A08p15190.2_BraZ1	1488.86	+	350	2993	3761	0.7957990
A08	19127946	19129151	A08p15200.2_BraZ1	345	+	1025	1205	1205	1.0000000
A08	19132227	19133498	A08p15210.2_BraZ1	407.579	+	1333	1271	1271	1.0000000
A08	19137118	19138480	A08p15220.2_BraZ1	3094.67	+	15	247	1362	0.1813510
A08	19141750	19142037	A08p15230.2_BraZ1	28.5	+	0	0	287	0.0000000
A08	19142544	19142649	A08p15240.2_BraZ1	10.5	+	50	105	105	1.0000000
A08	19143617	19148445	A08p15250.2_BraZ1	1283.5	+	239	2039	4828	0.4223281
A08	19159231	19160515	A08p15260.2_BraZ1	2244	+	64	403	1284	0.3138629
A08	19166753	19169017	A08p15270.2_BraZ1	19240	-	258	1885	2264	0.8325972
A08	19173842	19174129	A08p15280.2_BraZ1	28.5	+	0	0	287	0.0000000
A08	19175715	19178840	A08p15290.2_BraZ1	1420.23	+	16	611	3125	0.1955200
A08	19183592	19184954	A08p15300.2_BraZ1	3235.33	+	16	141	1362	0.1035242
A08	19187773	19188236	A08p15310.2_BraZ1	138	+	440	463	463	1.0000000
A08	19188470	19188785	A08p15320.2_BraZ1	189	+	223	315	315	1.0000000
A08	19193455	19194480	A08p15330.2_BraZ1	980	-	21	259	1025	0.2526829
A08	19202997	19203495	A08p15340.2_BraZ1	420	+	19	248	498	0.4979920
A08	19205399	19206049	A08p15350.2_BraZ1	58.2	-	0	0	650	0.0000000
A08	19210558	19211717	A08p15360.2_BraZ1	842.857	+	69	723	1159	0.6238136
A08	19223153	19224431	A08p15370.2_BraZ1	1188	+	904	1171	1278	0.9162754
A08	19227013	19227389	A08p15380.2_BraZ1	309	+	300	376	376	1.0000000
A08	19228922	19230234	A08p15390.2_BraZ1	1179	+	59	846	1312	0.6448171
A08	19231801	19233114	A08p15400.2_BraZ1	1173	+	132	948	1313	0.7220107
A08	19240026	19241394	A08p15410.2_BraZ1	2460	+	70	1135	1368	0.8296784
A08	19242311	19247144	A08p15420.2_BraZ1	2750.32	+	2490	4251	4833	0.8795779
A08	19247230	19248098	A08p15430.2_BraZ1	786	-	1327	868	868	1.0000000
A08	19259805	19260426	A08p15440.2_BraZ1	159	+	254	621	621	1.0000000
A08	19262349	19262797	A08p15450.2_BraZ1	44.7	+	88	436	448	0.9732143
A08	19263377	19263728	A08p15460.2_BraZ1	192	-	0	0	351	0.0000000
A08	19271832	19272156	A08p15470.2_BraZ1	32.4	-	675	324	324	1.0000000
A08	19275365	19280164	A08p15480.2_BraZ1	1708	+	1879	4637	4799	0.9662430
A08	19281100	19283043	A08p15490.2_BraZ1	1151.3	-	405	1387	1943	0.7138446
A08	19286633	19286972	A08p15500.2_BraZ1	33.9	+	59	229	339	0.6755162
A08	19289216	19289494	A08p15510.2_BraZ1	24.9	+	81	274	278	0.9856115
A08	19289790	19290057	A08p15520.2_BraZ1	26.7	-	10	54	267	0.2022472
A08	19297740	19298302	A08p15530.2_BraZ1	234	-	129	553	562	0.9839858
A08	19300875	19301592	A08p15540.2_BraZ1	231	-	442	717	717	1.0000000
A08	19301852	19302500	A08p15550.2_BraZ1	64.8	-	201	310	648	0.4783951
A08	19314114	19314938	A08p15560.2_BraZ1	654	-	468	801	824	0.9720874
A08	19315919	19316250	A08p15570.2_BraZ1	18	+	278	331	331	1.0000000
A08	19322019	19324237	A08p15580.2_BraZ1	1637.18	-	1482	2204	2218	0.9936880
A08	19331684	19331987	A08p15590.2_BraZ1	30.3	+	127	303	303	1.0000000
A08	19335471	19335711	A08p15600.2_BraZ1	24	+	2	70	240	0.2916667
A08	19355293	19357638	A08p15610.2_BraZ1	1068.57	+	129	1524	2345	0.6498934
A08	19359647	19361696	A08p15620.2_BraZ1	1698	-	119	1199	2049	0.5851635
A08	19367907	19375549	A08p15630.2_BraZ1	1367.14	-	5077	7233	7642	0.9464800
A08	19381600	19381729	A08p15640.2_BraZ1	12.9	+	229	129	129	1.0000000
A08	19392935	19394774	A08p15650.2_BraZ1	168.3	+	172	1297	1839	0.7052746
A08	19396504	19397974	A08p15660.2_BraZ1	10920	+	419	1428	1470	0.9714286
A08	19398807	19399042	A08p15670.2_BraZ1	19.2	+	180	235	235	1.0000000
A08	19422355	19425337	A08p15680.2_BraZ1	1720.17	+	1636	2982	2982	1.0000000
A08	19426934	19427930	A08p15690.2_BraZ1	1073.5	+	876	996	996	1.0000000
A08	19428244	19429339	A08p15700.2_BraZ1	2520	+	36	445	1095	0.4063927
A08	19430133	19431568	A08p15710.2_BraZ1	381	-	879	1435	1435	1.0000000
A08	19441771	19442353	A08p15720.2_BraZ1	58.2	+	24	275	582	0.4725086
A08	19450294	19452970	A08p15730.2_BraZ1	17289	+	227	795	2676	0.2970852
A08	19462681	19464282	A08p15740.2_BraZ1	1299	+	157	512	1601	0.3198001
A08	19466562	19467480	A08p15750.2_BraZ1	91.8	+	83	523	918	0.5697168
A08	19467795	19468062	A08p15760.2_BraZ1	26.7	+	29	87	267	0.3258427
A08	19468150	19470499	A08p15770.2_BraZ1	234.9	+	336	1520	2349	0.6470839
A08	19473046	19473340	A08p15780.2_BraZ1	29.4	-	582	294	294	1.0000000
A08	19474443	19474719	A08p15790.2_BraZ1	27.6	-	266	276	276	1.0000000
A08	19476872	19477273	A08p15800.2_BraZ1	204	-	0	0	401	0.0000000
A08	19478513	19479402	A08p15810.2_BraZ1	86.4	+	59	522	889	0.5871766
A08	19481874	19483500	A08p15820.2_BraZ1	1488	-	436	1472	1626	0.9052891
A08	19490302	19492243	A08p15830.2_BraZ1	5064.38	-	20	868	1941	0.4471922
A08	19496119	19497730	A08p15840.2_BraZ1	1067.12	+	470	1491	1611	0.9255121
A08	19499782	19501081	A08p15850.2_BraZ1	129.9	-	335	1299	1299	1.0000000
A08	19510606	19512134	A08p15860.2_BraZ1	1248.98	+	237	1138	1528	0.7447644
A08	19513223	19514429	A08p15870.2_BraZ1	120.6	-	581	1198	1206	0.9933665
A08	19517625	19518103	A08p15880.2_BraZ1	279	+	96	203	478	0.4246862
A08	19518252	19519548	A08p15890.2_BraZ1	496	-	247	1238	1296	0.9552469
A08	19525789	19526752	A08p15900.2_BraZ1	96.3	+	144	823	963	0.8546210
A08	19527305	19528497	A08p15910.2_BraZ1	1101	-	105	1093	1192	0.9169463
A08	19534105	19535871	A08p15920.2_BraZ1	831	+	696	1713	1766	0.9699887
A08	19544262	19545133	A08p15930.2_BraZ1	386.893	+	6	222	871	0.2548794
A08	19546134	19548894	A08p15940.2_BraZ1	1293.41	+	913	2334	2760	0.8456522
A08	19549621	19550869	A08p15950.2_BraZ1	765	+	958	1248	1248	1.0000000
A08	19553370	19560474	A08p15960.2_BraZ1	588.261	+	627	3859	7104	0.5432151
A08	19564354	19567094	A08p15970.2_BraZ1	1191.82	+	319	1712	2740	0.6248175
A08	19579637	19580192	A08p15980.2_BraZ1	55.5	-	689	555	555	1.0000000
A08	19581309	19581642	A08p15990.2_BraZ1	33.3	+	47	308	333	0.9249249
A08	19584306	19586082	A08p16000.2_BraZ1	1122.3	-	761	1626	1776	0.9155405
A08	19586525	19586738	A08p16010.2_BraZ1	138	+	177	213	213	1.0000000
A08	19588441	19589603	A08p16020.2_BraZ1	87.6	+	780	1162	1162	1.0000000
A08	19589603	19590612	A08p16030.2_BraZ1	741	+	427	1009	1009	1.0000000
A08	19593192	19593949	A08p16040.2_BraZ1	600	+	426	757	757	1.0000000
A08	19594374	19596880	A08p16050.2_BraZ1	1325.37	-	363	2077	2506	0.8288109
A08	19597363	19597974	A08p16060.2_BraZ1	21	-	278	611	611	1.0000000
A08	19602089	19603428	A08p16070.2_BraZ1	402.182	+	514	1223	1339	0.9133682
A08	19604298	19606738	A08p16080.2_BraZ1	1667.34	-	872	2163	2440	0.8864754
A08	19616209	19616794	A08p16090.2_BraZ1	438	-	379	585	585	1.0000000
A08	19623472	19623921	A08p16100.2_BraZ1	117	-	331	449	449	1.0000000
A08	19630752	19632178	A08p16110.2_BraZ1	349.706	+	239	1309	1426	0.9179523
A08	19643107	19645155	A08p16120.2_BraZ1	1605.41	+	931	1888	2048	0.9218750
A08	19645159	19645294	A08p16130.2_BraZ1	13.5	+	126	135	135	1.0000000
A08	19648828	19650750	A08p16140.2_BraZ1	1764	+	252	1561	1922	0.8121748
A08	19655893	19656156	A08p16150.2_BraZ1	156	+	196	263	263	1.0000000
A08	19658426	19660610	A08p16160.2_BraZ1	1093.26	-	1739	2184	2184	1.0000000
A08	19661210	19663189	A08p16170.2_BraZ1	194.1	+	333	1809	1979	0.9140980
A08	19664367	19665169	A08p16180.2_BraZ1	169.826	+	295	791	802	0.9862843
A08	19666333	19666663	A08p16190.2_BraZ1	216	+	0	0	330	0.0000000
A08	19666492	19667910	A08p16200.2_BraZ1	252	+	0	0	1418	0.0000000
A08	19671572	19674019	A08p16210.2_BraZ1	1452.52	+	292	1868	2447	0.7633837
A08	19675387	19675717	A08p16220.2_BraZ1	16.5	-	329	330	330	1.0000000
A08	19683355	19684493	A08p16230.2_BraZ1	162	+	173	881	1138	0.7741652
A08	19693281	19694860	A08p16240.2_BraZ1	29.1	+	494	1549	1579	0.9810007
A08	19696842	19701193	A08p16250.2_BraZ1	1202.35	-	323	2521	4351	0.5794070
A08	19710646	19713276	A08p16260.2_BraZ1	1107.91	-	148	1227	2630	0.4665399
A08	19729121	19730536	A08p16270.2_BraZ1	5364	+	1297	1415	1415	1.0000000
A08	19732089	19732230	A08p16280.2_BraZ1	14.1	-	142	141	141	1.0000000
A08	19737376	19746968	A08p16290.2_BraZ1	4686.63	+	5283	8551	9592	0.8914720
A08	19751331	19751541	A08p16300.2_BraZ1	21	-	429	210	210	1.0000000
A08	19752700	19753530	A08p16310.2_BraZ1	436	+	724	830	830	1.0000000
A08	19764029	19765674	A08p16320.2_BraZ1	865.831	+	1048	1645	1645	1.0000000
A08	19765988	19767114	A08p16330.2_BraZ1	513	-	1223	1126	1126	1.0000000
A08	19778297	19778909	A08p16340.2_BraZ1	61.2	+	35	417	612	0.6813725
A08	19781852	19782896	A08p16350.2_BraZ1	104.4	+	477	1044	1044	1.0000000
A08	19784363	19785221	A08p16360.2_BraZ1	85.8	+	156	772	858	0.8997669
A08	19787895	19790575	A08p16370.2_BraZ1	1462.8	+	1294	2278	2680	0.8500000
A08	19791204	19793952	A08p16380.2_BraZ1	1235.45	-	3032	2723	2748	0.9909025
A08	19797658	19798429	A08p16390.2_BraZ1	312	+	682	771	771	1.0000000
A08	19800631	19801971	A08p16400.2_BraZ1	766.65	-	305	1120	1340	0.8358209
A08	19802167	19802362	A08p16410.2_BraZ1	19.5	-	59	186	195	0.9538462
A08	19804797	19805174	A08p16420.2_BraZ1	204	-	250	377	377	1.0000000
A08	19807034	19808871	A08p16430.2_BraZ1	114.9	-	113	1110	1837	0.6042461
A08	19810853	19812347	A08p16440.2_BraZ1	622.952	-	278	1327	1494	0.8882195
A08	19816245	19817420	A08p16450.2_BraZ1	652.625	+	38	602	1175	0.5123404
A08	19819037	19824120	A08p16460.2_BraZ1	1227	-	4243	5021	5083	0.9878025
A08	19828338	19830527	A08p16470.2_BraZ1	5214.84	-	246	1284	2189	0.5865692
A08	19846877	19847131	A08p16480.2_BraZ1	18.9	-	24	201	254	0.7913386
A08	19861634	19864848	A08p16490.2_BraZ1	9187.93	+	1844	3205	3214	0.9971998
A08	19867530	19868250	A08p16500.2_BraZ1	351	+	219	647	720	0.8986111
A08	19870476	19872755	A08p16510.2_BraZ1	4167	-	1147	2131	2279	0.9350592
A08	19875006	19875298	A08p16520.2_BraZ1	138	-	444	292	292	1.0000000
A08	19878121	19878944	A08p16530.2_BraZ1	438	+	628	823	823	1.0000000
A08	19879784	19880354	A08p16540.2_BraZ1	57	-	193	565	570	0.9912280
A08	19899019	19899919	A08p16550.2_BraZ1	261	+	0	0	900	0.0000000
A08	19904318	19913244	A08p16560.2_BraZ1	1420.16	+	3071	8330	8926	0.9332288
A08	19906189	19907651	A08p16570.2_BraZ1	45.9	+	190	1197	1462	0.8187414
A08	19914377	19914754	A08p16580.2_BraZ1	2254	-	92	355	377	0.9416445
A08	19917709	19919566	A08p16590.2_BraZ1	1488	+	669	1539	1857	0.8287560
A08	19920291	19920843	A08p16600.2_BraZ1	339	-	0	0	552	0.0000000
A08	19923415	19924579	A08p16610.2_BraZ1	116.4	-	132	672	1164	0.5773196
A08	19925341	19926062	A08p16620.2_BraZ1	822	-	77	489	721	0.6782247
A08	19927787	19928768	A08p16630.2_BraZ1	522.429	+	230	981	981	1.0000000
A08	19929328	19929448	A08p16640.2_BraZ1	12	+	87	120	120	1.0000000
A08	19932087	19932589	A08p16650.2_BraZ1	143.5	-	934	502	502	1.0000000
A08	19932572	19935775	A08p16660.2_BraZ1	970.907	-	2634	3203	3203	1.0000000
A08	19951775	19955023	A08p16670.2_BraZ1	2988	+	752	2731	3248	0.8408251
A08	19957183	19962350	A08p16680.2_BraZ1	1367.5	+	2510	4883	5167	0.9450358
A08	19963386	19964820	A08p16690.2_BraZ1	143.4	+	372	1248	1434	0.8702929
A08	19965855	19967942	A08p16700.2_BraZ1	649.6	-	978	1829	2087	0.8763776
A08	19969315	19969615	A08p16710.2_BraZ1	30	+	36	300	300	1.0000000
A08	19969807	19971240	A08p16720.2_BraZ1	85.8	+	0	0	1433	0.0000000
A08	19971247	19974125	A08p16730.2_BraZ1	155.1	+	118	1083	2878	0.3763030
A08	19976468	19976888	A08p16740.2_BraZ1	261	+	1	63	420	0.1500000
A08	19976723	19978767	A08p16750.2_BraZ1	109.8	+	164	1084	2044	0.5303327
A08	19978400	19980766	A08p16760.2_BraZ1	122.7	+	110	1424	2366	0.6018597
A08	19981446	19982312	A08p16770.2_BraZ1	396	-	28	431	866	0.4976905
A08	19984313	19985632	A08p16780.2_BraZ1	2106	-	8	600	1319	0.4548901
A08	19985521	19986957	A08p16790.2_BraZ1	2808	-	0	0	1436	0.0000000
A08	19988003	19988991	A08p16800.2_BraZ1	926.795	+	633	988	988	1.0000000
A08	19989642	19990460	A08p16810.2_BraZ1	577.778	+	212	760	818	0.9290953
A08	19995916	19996828	A08p16820.2_BraZ1	91.2	+	325	912	912	1.0000000
A08	20003341	20003812	A08p16830.2_BraZ1	47.1	+	99	388	471	0.8237792
A08	20004797	20007952	A08p16840.2_BraZ1	1324.4	+	3035	3155	3155	1.0000000
A08	20013313	20013715	A08p16850.2_BraZ1	40.2	+	440	402	402	1.0000000
A08	20014874	20029769	A08p16860.2_BraZ1	1794.12	-	9218	13096	14895	0.8792212
A08	20030561	20032398	A08p16870.2_BraZ1	1136.2	-	322	1100	1837	0.5988024
A08	20034946	20035501	A08p16880.2_BraZ1	55.5	-	116	291	555	0.5243243
A08	20041340	20042169	A08p16890.2_BraZ1	372	+	172	745	829	0.8986731
A08	20046854	20048453	A08p16900.2_BraZ1	159.9	+	440	1399	1599	0.8749218
A08	20052744	20053351	A08p16910.2_BraZ1	183	+	619	607	607	1.0000000
A08	20055101	20056196	A08p16920.2_BraZ1	109.5	-	476	1095	1095	1.0000000
A08	20059554	20062909	A08p16930.2_BraZ1	2077.21	+	225	2015	3355	0.6005961
A08	20064679	20083688	A08p16940.2_BraZ1	3806.71	+	12141	15504	19009	0.8156136
A08	20066140	20066818	A08p16950.2_BraZ1	67.8	+	102	660	678	0.9734513
A08	20090493	20091084	A08p16960.2_BraZ1	501	-	730	591	591	1.0000000
A08	20093902	20095908	A08p16970.2_BraZ1	1053	-	543	1722	2006	0.8584247
A08	20100899	20101001	A08p16980.2_BraZ1	10.2	+	178	102	102	1.0000000
A08	20103929	20107783	A08p16990.2_BraZ1	2448.6	-	1333	3540	3854	0.9185262
A08	20107986	20108203	A08p17000.2_BraZ1	15	-	293	217	217	1.0000000
A08	20114460	20118963	A08p17010.2_BraZ1	1553.24	+	1389	3925	4503	0.8716411
A08	20119935	20120394	A08p17020.2_BraZ1	45.9	-	45	459	459	1.0000000
A08	20123508	20138515	A08p17030.2_BraZ1	1052.83	-	8102	14187	15007	0.9453588
A08	20125293	20126427	A08p17040.2_BraZ1	113.4	-	958	1134	1134	1.0000000
A08	20142126	20143260	A08p17050.2_BraZ1	682.187	+	332	1103	1134	0.9726632
A08	20144536	20145166	A08p17060.2_BraZ1	63	+	291	630	630	1.0000000
A08	20145688	20148209	A08p17070.2_BraZ1	1431	-	1457	2408	2521	0.9551765
A08	20149326	20149540	A08p17080.2_BraZ1	168	+	298	214	214	1.0000000
A08	20151934	20152203	A08p17090.2_BraZ1	210	-	384	269	269	1.0000000
A08	20152879	20154916	A08p17100.2_BraZ1	823.273	-	845	1831	2037	0.8988709
A08	20174378	20175604	A08p17110.2_BraZ1	1035	+	1221	1226	1226	1.0000000
A08	20183665	20184707	A08p17120.2_BraZ1	417	+	704	1042	1042	1.0000000
A08	20188287	20193796	A08p17130.2_BraZ1	576.522	+	2307	5315	5509	0.9647849
A08	20202318	20206906	A08p17140.2_BraZ1	3966.3	-	1782	4204	4588	0.9163034
A08	20222030	20222569	A08p17150.2_BraZ1	388.8	-	675	539	539	1.0000000
A08	20223256	20236051	A08p17160.2_BraZ1	1419.59	-	3288	8384	12795	0.6552560
A08	20237193	20240521	A08p17170.2_BraZ1	1753.23	-	581	2601	3328	0.7815505
A08	20243181	20244550	A08p17180.2_BraZ1	362.769	-	859	1369	1369	1.0000000
A08	20245029	20245500	A08p17190.2_BraZ1	207	-	346	471	471	1.0000000
A08	20246277	20254656	A08p17200.2_BraZ1	2320.14	+	4175	8020	8379	0.9571548
A08	20255667	20259927	A08p17210.2_BraZ1	2577.14	-	2112	4007	4260	0.9406103
A08	20260438	20261190	A08p17220.2_BraZ1	330	+	852	752	752	1.0000000
A08	20262071	20262836	A08p17230.2_BraZ1	76.5	-	199	765	765	1.0000000
A08	20267264	20267541	A08p17240.2_BraZ1	23.4	-	450	277	277	1.0000000
A08	20272064	20272262	A08p17250.2_BraZ1	19.8	-	9	90	198	0.4545455
A08	20278007	20278364	A08p17260.2_BraZ1	21.6	+	4	184	357	0.5154062
A08	20285525	20286317	A08p17270.2_BraZ1	79.2	-	85	736	792	0.9292929
A08	20287093	20287572	A08p17280.2_BraZ1	36.9	-	157	410	479	0.8559499
A08	20289801	20290914	A08p17290.2_BraZ1	111.3	+	390	1104	1113	0.9919137
A08	20290998	20292143	A08p17300.2_BraZ1	741	-	273	982	1145	0.8576419
A08	20293174	20293864	A08p17310.2_BraZ1	69	-	507	690	690	1.0000000
A08	20299538	20302693	A08p17320.2_BraZ1	566.176	-	885	2790	3155	0.8843106
A08	20306155	20307927	A08p17330.2_BraZ1	13419	-	512	1573	1772	0.8876975
A08	20310251	20314101	A08p17340.2_BraZ1	3087.31	-	688	3082	3850	0.8005195
A08	20315612	20317719	A08p17350.2_BraZ1	966.827	+	1360	2010	2107	0.9539630
A08	20318054	20318234	A08p17360.2_BraZ1	18	+	97	180	180	1.0000000
A08	20318789	20324833	A08p17370.2_BraZ1	2759.57	-	534	4324	6044	0.7154202
A08	20331055	20335034	A08p17380.2_BraZ1	2247	+	545	3264	3979	0.8203066
A08	20336056	20337572	A08p17390.2_BraZ1	906.667	+	1101	1515	1516	0.9993404
A08	20337927	20339695	A08p17400.2_BraZ1	713.488	-	415	1689	1768	0.9553167
A08	20351225	20352022	A08p17410.2_BraZ1	435	-	13	322	797	0.4040151
A08	20366778	20376532	A08p17420.2_BraZ1	898.56	+	5511	9036	9754	0.9263892
A08	20378078	20378573	A08p17430.2_BraZ1	408	-	0	0	495	0.0000000
A08	20379427	20380837	A08p17440.2_BraZ1	141	+	1296	1410	1410	1.0000000
A08	20385343	20386165	A08p17450.2_BraZ1	82.2	-	27	503	822	0.6119221
A08	20389710	20392863	A08p17460.2_BraZ1	1467.56	-	410	1872	3153	0.5937203
A08	20404623	20409867	A08p17470.2_BraZ1	1450.96	-	2289	4211	5244	0.8030130
A08	20416974	20425497	A08p17480.2_BraZ1	289.698	-	8772	8495	8523	0.9967148
A08	20425825	20426560	A08p17490.2_BraZ1	73.5	-	540	735	735	1.0000000
A08	20431020	20431683	A08p17500.2_BraZ1	47.7	-	444	663	663	1.0000000
A08	20434944	20436129	A08p17510.2_BraZ1	118.5	+	49	835	1185	0.7046413
A08	20443850	20445610	A08p17520.2_BraZ1	1003.91	-	151	1050	1760	0.5965909
A08	20446736	20449351	A08p17530.2_BraZ1	1193.73	-	1213	2579	2615	0.9862333
A08	20456535	20459415	A08p17540.2_BraZ1	2229.3	-	1348	2831	2880	0.9829861
A08	20472803	20476001	A08p17550.2_BraZ1	2059.64	+	1214	2989	3198	0.9346467
A08	20477038	20478418	A08p17560.2_BraZ1	680.263	-	301	1344	1380	0.9739130
A08	20483040	20484437	A08p17570.2_BraZ1	583.846	-	1012	1397	1397	1.0000000
A08	20486177	20487647	A08p17580.2_BraZ1	688	+	630	1406	1470	0.9564626
A08	20488534	20489740	A08p17590.2_BraZ1	120.6	-	318	1192	1206	0.9883914
A08	20494188	20495397	A08p17600.2_BraZ1	120.9	-	1648	1205	1209	0.9966915
A08	20495860	20497200	A08p17610.2_BraZ1	276	+	2190	1321	1340	0.9858209
A08	20499394	20500791	A08p17620.2_BraZ1	1004.63	+	861	1397	1397	1.0000000
A08	20501868	20503629	A08p17630.2_BraZ1	635.143	+	725	1441	1761	0.8182850
A08	20506085	20507873	A08p17640.2_BraZ1	354	-	3339	1788	1788	1.0000000
A08	20507746	20509819	A08p17650.2_BraZ1	2565	-	1785	1354	2073	0.6531597
A08	20513604	20515115	A08p17660.2_BraZ1	1020	+	646	1048	1511	0.6935804
A08	20515512	20517289	A08p17670.2_BraZ1	1605	-	606	775	1777	0.4361283
A08	20523054	20523621	A08p17680.2_BraZ1	56.7	+	132	355	567	0.6261023
A08	20526014	20527320	A08p17690.2_BraZ1	1224	-	142	968	1306	0.7411945
A08	20531391	20531568	A08p17700.2_BraZ1	17.7	-	32	177	177	1.0000000
A08	20534177	20534336	A08p17710.2_BraZ1	15.9	-	110	159	159	1.0000000
A08	20535025	20537040	A08p17720.2_BraZ1	300	-	1470	1830	2015	0.9081886
A08	20542687	20544163	A08p17730.2_BraZ1	147.6	+	908	1226	1476	0.8306233
A08	20551964	20552318	A08p17740.2_BraZ1	35.4	+	481	354	354	1.0000000
A08	20552721	20553252	A08p17750.2_BraZ1	53.1	-	333	531	531	1.0000000
A08	20560372	20566122	A08p17760.2_BraZ1	2156.13	-	1575	4110	5750	0.7147826
A08	20576229	20576364	A08p17770.2_BraZ1	13.5	-	31	135	135	1.0000000
A08	20584244	20585021	A08p17780.2_BraZ1	77.7	+	70	534	777	0.6872587
A08	20597293	20597773	A08p17790.2_BraZ1	48	+	406	480	480	1.0000000
A08	20601488	20601728	A08p17800.2_BraZ1	24	-	44	196	240	0.8166667
A08	20605932	20606749	A08p17810.2_BraZ1	4531.5	+	34	542	817	0.6634027
A08	20613219	20614186	A08p17820.2_BraZ1	501	+	1278	967	967	1.0000000
A08	20615345	20617606	A08p17830.2_BraZ1	1091.61	+	1379	2146	2261	0.9491376
A08	20624634	20625872	A08p17840.2_BraZ1	7666.5	-	90	733	1238	0.5920840
A08	20633726	20635368	A08p17850.2_BraZ1	157.5	+	310	1292	1642	0.7868453
A08	20639712	20647160	A08p17860.2_BraZ1	11528.6	+	1050	6025	7448	0.8089420
A08	20648055	20648562	A08p17870.2_BraZ1	297	+	325	507	507	1.0000000
A08	20649249	20650468	A08p17880.2_BraZ1	845.25	-	485	1183	1219	0.9704676
A08	20651340	20652776	A08p17890.2_BraZ1	3420	+	655	1436	1436	1.0000000
A08	20658330	20659767	A08p17900.2_BraZ1	780	+	22	349	1437	0.2428671
A08	20666334	20666689	A08p17910.2_BraZ1	240	+	15	216	355	0.6084507
A08	20669445	20669914	A08p17920.2_BraZ1	246	+	19	86	469	0.1833689
A08	20671552	20674720	A08p17930.2_BraZ1	1322.57	+	536	2752	3168	0.8686869
A08	20675727	20676709	A08p17940.2_BraZ1	733.125	-	277	909	982	0.9256619
A08	20679221	20681823	A08p17950.2_BraZ1	18731.8	-	1602	2602	2602	1.0000000
A08	20682296	20690660	A08p17960.2_BraZ1	17527.7	+	1461	3650	8364	0.4363941
A08	20691870	20696146	A08p17970.2_BraZ1	632.083	-	1366	3494	4276	0.8171188
A08	20694258	20694681	A08p17980.2_BraZ1	42.3	+	2	98	423	0.2316785
A08	20716860	20718301	A08p17990.2_BraZ1	435	-	470	1389	1441	0.9639140
A08	20729400	20730161	A08p18000.2_BraZ1	543	+	494	761	761	1.0000000
A08	20730668	20732330	A08p18010.2_BraZ1	166.2	-	220	916	1662	0.5511432
A08	20736024	20736336	A08p18020.2_BraZ1	31.2	+	345	312	312	1.0000000
A08	20738825	20739025	A08p18030.2_BraZ1	14.7	+	69	200	200	1.0000000
A08	20745646	20746480	A08p18040.2_BraZ1	83.4	-	565	834	834	1.0000000
A08	20752603	20752876	A08p18050.2_BraZ1	117	-	88	147	273	0.5384616
A08	20754315	20756602	A08p18060.2_BraZ1	1263	+	681	2151	2287	0.9405335
A08	20761312	20771327	A08p18070.2_BraZ1	3481.64	-	3448	8868	10015	0.8854718
A08	20774386	20776324	A08p18080.2_BraZ1	847.875	+	184	1253	1938	0.6465428
A08	20776941	20777284	A08p18090.2_BraZ1	144	-	45	242	343	0.7055393
A08	20783261	20783657	A08p18100.2_BraZ1	300	-	12	169	396	0.4267677
A08	20819853	20821074	A08p18110.2_BraZ1	122.1	+	203	1023	1221	0.8378378
A08	20830080	20830936	A08p18120.2_BraZ1	543	+	3	231	856	0.2698598
A08	20840512	20842020	A08p18130.2_BraZ1	906.848	+	132	1235	1508	0.8189655
A08	20844918	20845443	A08p18140.2_BraZ1	52.5	+	8	377	525	0.7180952
A08	20848465	20850428	A08p18150.2_BraZ1	1143.03	+	1391	1899	1963	0.9673969
A08	20856351	20861381	A08p18160.2_BraZ1	9707.25	-	395	2268	5030	0.4508946
A08	20865533	20867419	A08p18170.2_BraZ1	1073.8	+	669	1820	1886	0.9650053
A08	20880821	20882812	A08p18180.2_BraZ1	1026.67	+	232	1205	1991	0.6052235
A08	20900018	20900825	A08p18190.2_BraZ1	285	+	0	0	807	0.0000000
A08	20902814	20905308	A08p18200.2_BraZ1	1799.87	+	668	2328	2494	0.9334403
A08	20907799	20910404	A08p18210.2_BraZ1	1500.19	+	521	2171	2605	0.8333973
A08	20911515	20912274	A08p18220.2_BraZ1	75.9	-	492	759	759	1.0000000
A08	20913166	20913940	A08p18230.2_BraZ1	77.4	-	104	663	774	0.8565891
A08	20919150	20920792	A08p18240.2_BraZ1	605.214	-	167	1176	1642	0.7161998
A08	20923276	20924887	A08p18250.2_BraZ1	922.909	+	1243	1611	1611	1.0000000
A08	20932349	20935149	A08p18260.2_BraZ1	17712	+	1337	2664	2800	0.9514286
A08	20939638	20939956	A08p18270.2_BraZ1	243	-	410	318	318	1.0000000
A08	20942538	20943864	A08p18280.2_BraZ1	1149	+	101	888	1326	0.6696833
A08	20947071	20948400	A08p18290.2_BraZ1	806.421	-	320	1199	1329	0.9021821
A08	20954785	20956779	A08p18300.2_BraZ1	21266	+	17	656	1994	0.3289870
A08	20958902	20959049	A08p18310.2_BraZ1	14.7	+	552	147	147	1.0000000
A08	20959275	20959416	A08p18320.2_BraZ1	14.1	-	264	141	141	1.0000000
A08	20961320	20961887	A08p18330.2_BraZ1	387	-	413	567	567	1.0000000
A08	20964441	20965282	A08p18340.2_BraZ1	762	-	66	493	841	0.5862069
A08	20969086	20969368	A08p18350.2_BraZ1	17.1	+	390	282	282	1.0000000
A08	20984552	20985247	A08p18360.2_BraZ1	2625	-	575	695	695	1.0000000
A08	20986872	20987046	A08p18370.2_BraZ1	17.4	-	0	0	174	0.0000000
A08	20987540	20988241	A08p18380.2_BraZ1	360	+	0	0	701	0.0000000
A08	20988373	20988913	A08p18390.2_BraZ1	465	+	77	277	540	0.5129629
A08	20990918	20991749	A08p18400.2_BraZ1	83.1	-	184	800	831	0.9626955
A08	20995440	20995681	A08p18410.2_BraZ1	174	-	244	241	241	1.0000000
A08	20995843	20997488	A08p18420.2_BraZ1	488.37	-	215	1102	1645	0.6699088
A08	21002670	21005319	A08p18430.2_BraZ1	1570.35	+	492	1999	2649	0.7546244
A08	21006412	21008398	A08p18440.2_BraZ1	198.6	-	64	948	1986	0.4773414
A08	21010532	21011828	A08p18450.2_BraZ1	129.6	-	297	1269	1296	0.9791667
A08	21013189	21014155	A08p18460.2_BraZ1	95.7	-	46	626	966	0.6480331
A08	21015432	21018414	A08p18470.2_BraZ1	1667.87	-	365	2309	2982	0.7743126
A08	21019468	21021365	A08p18480.2_BraZ1	1739.52	+	644	1664	1897	0.8771745
A08	21021651	21022991	A08p18490.2_BraZ1	1148.51	-	102	930	1340	0.6940299
A08	21023538	21024946	A08p18500.2_BraZ1	737.429	-	317	1225	1408	0.8700284
A08	21026267	21026555	A08p18510.2_BraZ1	28.8	-	92	196	288	0.6805556
A08	21027955	21028279	A08p18520.2_BraZ1	32.4	-	178	313	324	0.9660494
A08	21032535	21032856	A08p18530.2_BraZ1	32.1	+	24	107	321	0.3333333
A08	21033329	21033644	A08p18540.2_BraZ1	31.5	-	152	315	315	1.0000000
A08	21044680	21045723	A08p18550.2_BraZ1	876	+	1426	1043	1043	1.0000000
A08	21049573	21049897	A08p18560.2_BraZ1	32.4	+	3	36	324	0.1111111
A08	21058396	21059532	A08p18570.2_BraZ1	591	-	848	1048	1136	0.9225352
A08	21065032	21066025	A08p18580.2_BraZ1	63.3	+	300	899	993	0.9053373
A08	21072536	21074612	A08p18590.2_BraZ1	207.6	+	406	1750	2076	0.8429673
A08	21076573	21077638	A08p18600.2_BraZ1	106.5	-	700	1065	1065	1.0000000
A08	21078238	21078823	A08p18610.2_BraZ1	483	+	500	585	585	1.0000000
A08	21080544	21081647	A08p18620.2_BraZ1	352.736	-	1036	1103	1103	1.0000000
A08	21083089	21083955	A08p18630.2_BraZ1	789	-	89	573	866	0.6616628
A08	21087864	21089170	A08p18640.2_BraZ1	751.886	-	404	1236	1306	0.9464012
A08	21090136	21092439	A08p18650.2_BraZ1	1104	+	1097	2207	2303	0.9583153
A08	21093096	21096060	A08p18660.2_BraZ1	1114.21	-	1562	2858	2964	0.9642375
A08	21098517	21099259	A08p18670.2_BraZ1	270.614	-	111	502	742	0.6765499
A08	21105920	21106349	A08p18680.2_BraZ1	42.9	-	34	275	429	0.6410257
A08	21111437	21114797	A08p18690.2_BraZ1	1625.26	-	728	1755	3360	0.5223214
A08	21116791	21117124	A08p18700.2_BraZ1	33.3	-	569	333	333	1.0000000
A08	21117451	21118875	A08p18710.2_BraZ1	927	-	285	1162	1424	0.8160113
A08	21125594	21125741	A08p18720.2_BraZ1	14.7	-	151	147	147	1.0000000
A08	21125765	21126977	A08p18730.2_BraZ1	665.913	-	415	938	1212	0.7739274
A08	21130739	21132251	A08p18740.2_BraZ1	151.2	-	181	554	1512	0.3664021
A08	21138708	21140133	A08p18750.2_BraZ1	142.5	-	244	1219	1425	0.8554386
A08	21142828	21145238	A08p18760.2_BraZ1	1372.72	+	842	2242	2410	0.9302905
A08	21146080	21148004	A08p18770.2_BraZ1	955.08	+	542	1886	1924	0.9802495
A08	21148326	21153138	A08p18780.2_BraZ1	2520	-	1174	4032	4812	0.8379052
A08	21155466	21155775	A08p18790.2_BraZ1	30.9	+	385	309	309	1.0000000
A08	21164159	21166933	A08p18800.2_BraZ1	1714.19	-	786	2329	2774	0.8395818
A08	21167752	21171766	A08p18810.2_BraZ1	2550.17	-	1039	2809	4014	0.6998007
A08	21175513	21175847	A08p18820.2_BraZ1	192	+	355	334	334	1.0000000
A08	21177558	21177740	A08p18830.2_BraZ1	126	-	382	182	182	1.0000000
A08	21178379	21178760	A08p18840.2_BraZ1	38.1	-	69	294	381	0.7716535
A08	21186813	21187611	A08p18850.2_BraZ1	79.8	-	367	798	798	1.0000000
A08	21193500	21196865	A08p18860.2_BraZ1	2181.38	-	983	3278	3365	0.9741456
A08	21198693	21200163	A08p18870.2_BraZ1	147	-	6	217	1470	0.1476191
A08	21202587	21202883	A08p18880.2_BraZ1	280	-	20	296	296	1.0000000
A08	21204626	21207012	A08p18890.2_BraZ1	1312.32	+	824	1976	2386	0.8281643
A08	21207214	21207713	A08p18900.2_BraZ1	106.909	+	526	499	499	1.0000000
A08	21208616	21209221	A08p18910.2_BraZ1	339	+	405	605	605	1.0000000
A08	21214866	21217358	A08p18920.2_BraZ1	11370	-	861	1897	2492	0.7612360
A08	21225541	21226509	A08p18930.2_BraZ1	4693.5	-	448	967	968	0.9989669
A08	21227923	21228168	A08p18940.2_BraZ1	201	+	360	245	245	1.0000000
A08	21234804	21235551	A08p18950.2_BraZ1	74.7	-	272	722	747	0.9665328
A08	21236185	21236830	A08p18960.2_BraZ1	667.5	-	456	645	645	1.0000000
A08	21238184	21238484	A08p18970.2_BraZ1	30	+	61	142	300	0.4733333
A08	21244939	21245533	A08p18980.2_BraZ1	336	+	6	19	594	0.0319865
A08	21247069	21247768	A08p18990.2_BraZ1	31.2	+	113	403	699	0.5765379
A08	21247747	21249975	A08p19000.2_BraZ1	1048.09	+	211	1900	2228	0.8527828
A08	21253215	21253502	A08p19010.2_BraZ1	20.4	+	3	169	287	0.5888502
A08	21265777	21267803	A08p19020.2_BraZ1	1803	+	348	1336	2026	0.6594275
A08	21268501	21269208	A08p19030.2_BraZ1	273.675	-	418	707	707	1.0000000
A08	21270100	21273535	A08p19040.2_BraZ1	906.818	-	2132	3285	3435	0.9563318
A08	21284597	21285948	A08p19050.2_BraZ1	1071.64	-	96	829	1351	0.6136196
A08	21287488	21289487	A08p19060.2_BraZ1	559.625	-	1104	1877	1999	0.9389695
A08	21292441	21294155	A08p19070.2_BraZ1	1473	+	70	793	1714	0.4626604
A08	21295554	21297003	A08p19080.2_BraZ1	144.9	+	205	1166	1449	0.8046929
A08	21297815	21299440	A08p19090.2_BraZ1	9842	+	66	260	1625	0.1600000
A08	21299820	21301746	A08p19100.2_BraZ1	192.6	-	303	1421	1926	0.7377986
A08	21303776	21304397	A08p19110.2_BraZ1	61.8	+	54	394	621	0.6344606
A08	21318066	21319483	A08p19120.2_BraZ1	641.829	-	801	1266	1417	0.8934368
A08	21320219	21320663	A08p19130.2_BraZ1	44.4	-	309	444	444	1.0000000
A08	21321467	21324333	A08p19140.2_BraZ1	1614.58	-	1226	2666	2866	0.9302163
A08	21326582	21329804	A08p19150.2_BraZ1	1598.42	-	3118	3222	3222	1.0000000
A08	21332073	21332844	A08p19160.2_BraZ1	77.1	+	191	691	771	0.8962386
A08	21335219	21336383	A08p19170.2_BraZ1	710.849	-	190	868	1164	0.7457045
A08	21338973	21341690	A08p19180.2_BraZ1	1525.22	-	1945	2709	2717	0.9970556
A08	21342535	21343616	A08p19190.2_BraZ1	3228.75	+	7	123	1081	0.1137835
A08	21344270	21346155	A08p19200.2_BraZ1	851	+	24	239	1885	0.1267904
A08	21353588	21356524	A08p19210.2_BraZ1	1182.32	+	1836	2930	2936	0.9979564
A08	21358216	21361315	A08p19220.2_BraZ1	522	+	2164	3041	3099	0.9812843
A08	21362323	21364312	A08p19230.2_BraZ1	198.3	+	659	1855	1989	0.9326295
A08	21370222	21370420	A08p19240.2_BraZ1	19.8	-	100	198	198	1.0000000
A08	21371992	21372124	A08p19250.2_BraZ1	13.2	+	158	132	132	1.0000000
A08	21383013	21383653	A08p19260.2_BraZ1	260.7	-	183	640	640	1.0000000
A08	21385437	21385641	A08p19270.2_BraZ1	20.4	-	331	204	204	1.0000000
A08	21385946	21387496	A08p19280.2_BraZ1	1333.45	-	233	1363	1550	0.8793548
A08	21391063	21392839	A08p19290.2_BraZ1	844.714	+	676	1776	1776	1.0000000
A08	21393782	21394338	A08p19300.2_BraZ1	177	-	607	556	556	1.0000000
A08	21399501	21399759	A08p19310.2_BraZ1	25.8	+	57	236	258	0.9147287
A08	21406294	21406617	A08p19320.2_BraZ1	276	+	37	323	323	1.0000000
A08	21408416	21410301	A08p19330.2_BraZ1	2175	+	1378	1408	1885	0.7469496
A08	21420336	21422590	A08p19340.2_BraZ1	897.863	+	163	1577	2254	0.6996451
A08	21446195	21446300	A08p19350.2_BraZ1	10.5	-	0	0	105	0.0000000
A08	21448183	21466485	A08p19360.2_BraZ1	2952.67	+	7778	15366	18302	0.8395804
A08	21467815	21468109	A08p19370.2_BraZ1	29.4	+	606	294	294	1.0000000
A08	21468940	21469132	A08p19380.2_BraZ1	19.2	-	454	192	192	1.0000000
A08	21469155	21469856	A08p19390.2_BraZ1	324	-	1122	701	701	1.0000000
A08	21472514	21473318	A08p19400.2_BraZ1	50.7	+	423	769	804	0.9564677
A08	21474878	21480918	A08p19410.2_BraZ1	1399.88	+	4205	5115	6040	0.8468543
A08	21486820	21489923	A08p19420.2_BraZ1	1713.6	-	1976	2988	3103	0.9629391
A08	21495738	21498154	A08p19430.2_BraZ1	908.069	+	423	2002	2416	0.8286424
A08	21498970	21502535	A08p19440.2_BraZ1	1474.6	+	1471	3311	3565	0.9287518
A08	21512387	21513138	A08p19450.2_BraZ1	624	-	139	727	751	0.9680426
A08	21515662	21520490	A08p19460.2_BraZ1	1536.74	+	2635	4529	4828	0.9380696
A08	21520905	21526082	A08p19470.2_BraZ1	2041.26	-	620	4356	5177	0.8414140
A08	21527110	21530430	A08p19480.2_BraZ1	2060.53	-	1680	3189	3320	0.9605421
A08	21531850	21532339	A08p19490.2_BraZ1	48.9	+	451	489	489	1.0000000
A08	21533456	21534842	A08p19500.2_BraZ1	138.6	+	685	1386	1386	1.0000000
A08	21535498	21536899	A08p19510.2_BraZ1	140.1	+	774	1401	1401	1.0000000
A08	21537905	21538263	A08p19520.2_BraZ1	25.8	+	654	358	358	1.0000000
A08	21538706	21544097	A08p19530.2_BraZ1	1704.37	-	2225	4284	5391	0.7946578
A08	21546732	21547023	A08p19540.2_BraZ1	29.1	-	98	255	291	0.8762887
A08	21548458	21551143	A08p19550.2_BraZ1	36	-	1223	2685	2685	1.0000000
A08	21551664	21554553	A08p19560.2_BraZ1	288.9	-	1367	2644	2889	0.9151956
A08	21564456	21565553	A08p19570.2_BraZ1	545.143	-	973	1097	1097	1.0000000
A08	21568664	21569501	A08p19580.2_BraZ1	8784	+	38	338	837	0.4038232
A08	21571263	21574440	A08p19590.2_BraZ1	1741.12	+	1283	3126	3177	0.9839471
A08	21577614	21578540	A08p19600.2_BraZ1	432	+	16	411	926	0.4438445
A08	21579022	21580566	A08p19610.2_BraZ1	893.333	-	37	460	1544	0.2979275
A08	21589967	21592310	A08p19620.2_BraZ1	1908	+	460	2246	2343	0.9586001
A08	21593096	21595081	A08p19630.2_BraZ1	939.021	-	118	1766	1985	0.8896725
A08	21596374	21597387	A08p19640.2_BraZ1	489	-	63	605	1013	0.5972359
A08	21600531	21604695	A08p19650.2_BraZ1	1693.53	+	923	2822	4164	0.6777138
A08	21609007	21609502	A08p19660.2_BraZ1	49.5	-	125	495	495	1.0000000
A08	21611793	21613290	A08p19670.2_BraZ1	149.7	+	892	1353	1497	0.9038076
A08	21615413	21618539	A08p19680.2_BraZ1	2388.94	+	783	2609	3126	0.8346129
A08	21619070	21623170	A08p19690.2_BraZ1	717.554	+	1252	3569	4100	0.8704878
A08	21623870	21628694	A08p19700.2_BraZ1	1630.41	-	639	3271	4824	0.6780680
A08	21636796	21641127	A08p19710.2_BraZ1	2258.18	+	849	4023	4331	0.9288848
A08	21644686	21649886	A08p19720.2_BraZ1	2461.97	+	1029	4602	5200	0.8850000
A08	21650458	21650587	A08p19730.2_BraZ1	12.9	-	1	37	129	0.2868217
A08	21651159	21654114	A08p19740.2_BraZ1	295.5	+	353	2412	2955	0.8162436
A08	21654508	21655098	A08p19750.2_BraZ1	269.727	-	131	590	590	1.0000000
A08	21655855	21660073	A08p19760.2_BraZ1	2589.66	+	2247	3987	4218	0.9452347
A08	21662076	21664850	A08p19770.2_BraZ1	1528.71	+	1294	2577	2774	0.9289834
A08	21665625	21667734	A08p19780.2_BraZ1	1296	+	289	430	2109	0.2038881
A08	21683204	21683639	A08p19790.2_BraZ1	43.5	+	79	329	435	0.7563218
A08	21692104	21693567	A08p19800.2_BraZ1	617.5	-	641	1444	1463	0.9870130
A08	21700902	21701926	A08p19810.2_BraZ1	202.381	+	624	953	1024	0.9306641
A08	21701423	21702827	A08p19820.2_BraZ1	456.25	+	789	1345	1404	0.9579772
A08	21704507	21705518	A08p19830.2_BraZ1	428.478	-	761	1011	1011	1.0000000
A08	21719759	21724552	A08p19840.2_BraZ1	2382.69	+	236	2821	4793	0.5885667
A08	21729347	21729494	A08p19850.2_BraZ1	14.7	-	337	147	147	1.0000000
A08	21729651	21731140	A08p19860.2_BraZ1	247	-	1112	1489	1489	1.0000000
A08	21732115	21732607	A08p19870.2_BraZ1	49.2	-	19	139	492	0.2825203
A08	21741094	21741229	A08p19880.2_BraZ1	13.5	+	208	135	135	1.0000000
A08	21745303	21745882	A08p19890.2_BraZ1	57.9	+	5	229	579	0.3955095
A08	21748715	21750044	A08p19900.2_BraZ1	733.333	-	348	1281	1329	0.9638826
A08	21764853	21765822	A08p19910.2_BraZ1	251.333	-	182	928	969	0.9576883
A08	21776061	21776754	A08p19920.2_BraZ1	69.3	-	30	97	693	0.1399711
A08	21784502	21787007	A08p19930.2_BraZ1	1730.78	-	1122	2113	2505	0.8435130
A08	21791233	21795722	A08p19940.2_BraZ1	1777.62	-	1380	4400	4489	0.9801738
A08	21792053	21792652	A08p19950.2_BraZ1	288	+	49	574	599	0.9582638
A08	21797093	21799006	A08p19960.2_BraZ1	885	+	1385	1908	1913	0.9973863
A08	21799472	21803691	A08p19970.2_BraZ1	2482.97	-	767	3428	4219	0.8125148
A08	21804849	21807542	A08p19980.2_BraZ1	1223.39	-	1363	2553	2693	0.9480134
A08	21810953	21811274	A08p19990.2_BraZ1	231	+	332	321	321	1.0000000
A08	21812659	21812980	A08p20000.2_BraZ1	231	+	3	244	321	0.7601246
A08	21815246	21815567	A08p20010.2_BraZ1	231	+	52	321	321	1.0000000
A08	21816969	21817290	A08p20020.2_BraZ1	231	+	30	321	321	1.0000000
A08	21818684	21819005	A08p20030.2_BraZ1	231	+	733	321	321	1.0000000
A08	21820413	21820734	A08p20040.2_BraZ1	231	+	419	321	321	1.0000000
A08	21822120	21822441	A08p20050.2_BraZ1	213.889	+	439	321	321	1.0000000
A08	21823847	21824168	A08p20060.2_BraZ1	231	+	141	293	321	0.9127726
A08	21825549	21825870	A08p20070.2_BraZ1	231	+	199	321	321	1.0000000
A08	21830964	21831618	A08p20080.2_BraZ1	564	-	88	315	654	0.4816514
A08	21831919	21834923	A08p20090.2_BraZ1	573.6	-	2760	3003	3004	0.9996671
A08	21838092	21840388	A08p20100.2_BraZ1	1156.09	+	348	1819	2296	0.7922474
A08	21841352	21851742	A08p20110.2_BraZ1	5571.47	-	1864	6902	10390	0.6642926
A08	21858755	21860837	A08p20120.2_BraZ1	1269	-	85	1540	2082	0.7396734
A08	21864864	21865953	A08p20130.2_BraZ1	108.9	-	1084	1089	1089	1.0000000
A08	21871411	21872794	A08p20140.2_BraZ1	310.8	+	78	1157	1383	0.8365871
A08	21872756	21873502	A08p20150.2_BraZ1	212.5	+	1	26	746	0.0348525
A08	21875566	21876895	A08p20160.2_BraZ1	840	+	1298	1329	1329	1.0000000
A08	21877190	21878738	A08p20170.2_BraZ1	154.8	-	862	1537	1548	0.9928941
A08	21886246	21887598	A08p20180.2_BraZ1	933	+	382	1185	1352	0.8764793
A08	21889050	21890564	A08p20190.2_BraZ1	1872.67	-	930	1514	1514	1.0000000
A08	21895487	21897535	A08p20200.2_BraZ1	988.615	+	851	1987	2048	0.9702148
A08	21898178	21903116	A08p20210.2_BraZ1	2658.94	-	2952	4801	4938	0.9722559
A08	21915056	21916876	A08p20220.2_BraZ1	1197.26	-	187	1057	1820	0.5807692
A08	21929396	21930751	A08p20230.2_BraZ1	119.1	+	112	304	1355	0.2243542
A08	21932691	21934330	A08p20240.2_BraZ1	610.776	+	1058	1639	1639	1.0000000
A08	21934801	21937655	A08p20250.2_BraZ1	1607.43	+	1024	2854	2854	1.0000000
A08	21938126	21939045	A08p20260.2_BraZ1	343.375	+	534	919	919	1.0000000
A08	21941115	21942235	A08p20270.2_BraZ1	17544	-	424	1054	1120	0.9410715
A08	21944184	21946576	A08p20280.2_BraZ1	1179.49	-	488	1910	2392	0.7984950
A08	21955678	21956101	A08p20290.2_BraZ1	42.3	-	291	423	423	1.0000000
A08	21963763	21964350	A08p20300.2_BraZ1	555	-	5	88	587	0.1499148
A08	21965689	21966322	A08p20310.2_BraZ1	114.667	+	250	633	633	1.0000000
A08	21966380	21966764	A08p20320.2_BraZ1	114.111	+	95	384	384	1.0000000
A08	21966966	21967254	A08p20330.2_BraZ1	28.8	-	61	288	288	1.0000000
A08	21972236	21978159	A08p20340.2_BraZ1	1015.2	-	333	1078	5923	0.1820024
A08	21984946	21987480	A08p20350.2_BraZ1	1132.5	+	204	1778	2534	0.7016575
A08	21988654	21989566	A08p20360.2_BraZ1	91.2	+	216	823	912	0.9024123
A08	21995849	22012790	A08p20370.2_BraZ1	2124.39	-	10366	14771	16941	0.8719084
A08	22026151	22026429	A08p20380.2_BraZ1	189	-	12	249	278	0.8956835
A08	22027720	22029737	A08p20390.2_BraZ1	928.846	+	900	1964	2017	0.9737234
A08	22032855	22032960	A08p20400.2_BraZ1	10.5	+	0	0	105	0.0000000
A08	22035870	22038398	A08p20410.2_BraZ1	1576.39	-	398	1456	2528	0.5759494
A08	22039946	22042393	A08p20420.2_BraZ1	993.032	-	406	1433	2447	0.5856150
A08	22043149	22043596	A08p20430.2_BraZ1	252	+	531	447	447	1.0000000
A08	22044574	22045823	A08p20440.2_BraZ1	95	-	1312	1249	1249	1.0000000
A08	22047385	22052752	A08p20450.2_BraZ1	2667.86	+	3270	5039	5367	0.9388858
A08	22053225	22054891	A08p20460.2_BraZ1	696.96	-	1801	1666	1666	1.0000000
A08	22059140	22060218	A08p20470.2_BraZ1	645.333	+	689	1078	1078	1.0000000
A08	22068566	22070597	A08p20480.2_BraZ1	993.874	+	1449	2021	2031	0.9950763
A08	22073342	22075324	A08p20490.2_BraZ1	742.957	-	960	1913	1982	0.9651867
A08	22078718	22078997	A08p20500.2_BraZ1	4590	-	488	279	279	1.0000000
A08	22081416	22085283	A08p20510.2_BraZ1	552	+	808	1642	3867	0.4246186
A08	22091101	22091251	A08p20520.2_BraZ1	15	-	6	118	150	0.7866667
A08	22101409	22102473	A08p20530.2_BraZ1	716.625	+	5	101	1064	0.0949248
A08	22115505	22116565	A08p20540.2_BraZ1	659.75	+	0	0	1060	0.0000000
A08	22129594	22130634	A08p20550.2_BraZ1	790.4	+	151	623	1040	0.5990385
A08	22132677	22137315	A08p20560.2_BraZ1	1512.25	-	420	2163	4638	0.4663648
A08	22142566	22145097	A08p20570.2_BraZ1	984	+	210	1444	2531	0.5705255
A08	22145707	22146025	A08p20580.2_BraZ1	31.8	+	270	318	318	1.0000000
A08	22152880	22153852	A08p20590.2_BraZ1	225.313	+	563	972	972	1.0000000
A08	22154583	22155196	A08p20600.2_BraZ1	5544	-	202	606	613	0.9885808
A08	22155849	22156224	A08p20610.2_BraZ1	37.5	+	94	278	375	0.7413333
A08	22157329	22160026	A08p20620.2_BraZ1	1146.78	+	1048	2670	2697	0.9899889
A08	22161431	22163244	A08p20630.2_BraZ1	2201.62	-	1161	1243	1813	0.6856040
A08	22185334	22185754	A08p20640.2_BraZ1	42	+	97	420	420	1.0000000
A08	22187098	22189077	A08p20650.2_BraZ1	1075.11	+	2216	1979	1979	1.0000000
A08	22189079	22189455	A08p20660.2_BraZ1	156	+	333	376	376	1.0000000
A08	22190487	22192598	A08p20670.2_BraZ1	777.214	+	910	2082	2111	0.9862624
A08	22192723	22192867	A08p20680.2_BraZ1	14.4	+	63	144	144	1.0000000
A08	22193920	22201143	A08p20690.2_BraZ1	1570.8	+	1109	3101	7223	0.4293230
A08	22203037	22204782	A08p20700.2_BraZ1	356.906	+	1684	1721	1745	0.9862464
A08	22205298	22208850	A08p20710.2_BraZ1	1617	+	1640	3222	3552	0.9070946
A08	22209603	22211172	A08p20720.2_BraZ1	1027.33	-	945	1569	1569	1.0000000
A08	22217217	22217575	A08p20730.2_BraZ1	216	+	0	0	358	0.0000000
A08	22218521	22218728	A08p20740.2_BraZ1	14.1	+	72	187	207	0.9033816
A08	22219695	22221007	A08p20750.2_BraZ1	32226	+	770	1308	1312	0.9969512
A08	22221467	22223459	A08p20760.2_BraZ1	1107.24	-	1539	1992	1992	1.0000000
A08	22224239	22225993	A08p20770.2_BraZ1	901.565	+	1458	1680	1754	0.9578107
A08	22237492	22238925	A08p20780.2_BraZ1	999	+	237	1207	1433	0.8422889
A08	22248228	22250265	A08p20790.2_BraZ1	203.4	+	493	1928	2037	0.9464899
A08	22251378	22252133	A08p20800.2_BraZ1	663	+	350	650	755	0.8609272
A08	22254827	22255549	A08p20810.2_BraZ1	493.619	-	2	274	722	0.3795014
A08	22255610	22256168	A08p20820.2_BraZ1	173.333	-	1	60	558	0.1075269
A08	22258352	22261633	A08p20830.2_BraZ1	108490	-	544	2864	3281	0.8729046
A08	22264937	22266093	A08p20840.2_BraZ1	648	+	1309	1156	1156	1.0000000
A08	22266831	22267908	A08p20850.2_BraZ1	107.7	-	376	989	1077	0.9182916
A08	22269039	22272511	A08p20860.2_BraZ1	1490.63	-	903	2928	3472	0.8433180
A08	22274697	22275237	A08p20870.2_BraZ1	279	+	902	540	540	1.0000000
A08	22277228	22278217	A08p20880.2_BraZ1	909	-	117	787	989	0.7957533
A08	22279353	22281015	A08p20890.2_BraZ1	1089.64	-	1009	1475	1662	0.8874850
A08	22285359	22285734	A08p20900.2_BraZ1	37.5	-	131	347	375	0.9253333
A08	22289950	22290784	A08p20910.2_BraZ1	83.4	+	50	623	834	0.7470024
A08	22294791	22297869	A08p20920.2_BraZ1	1547.79	-	948	2920	3078	0.9486679
A08	22303369	22305158	A08p20930.2_BraZ1	693.78	-	865	1715	1789	0.9586361
A08	22306678	22306934	A08p20940.2_BraZ1	195	+	126	256	256	1.0000000
A08	22307187	22307476	A08p20950.2_BraZ1	213	+	729	289	289	1.0000000
A08	22309249	22309723	A08p20960.2_BraZ1	303	+	40	387	474	0.8164557
A08	22310142	22312759	A08p20970.2_BraZ1	1221	+	1279	2532	2617	0.9675201
A08	22319155	22320515	A08p20980.2_BraZ1	672	-	477	1299	1360	0.9551471
A08	22321061	22321367	A08p20990.2_BraZ1	30.6	-	286	306	306	1.0000000
A08	22321984	22323461	A08p21000.2_BraZ1	2747.25	+	557	1477	1477	1.0000000
A08	22324847	22326151	A08p21010.2_BraZ1	1230	+	197	1209	1304	0.9271472
A08	22326638	22333401	A08p21020.2_BraZ1	5270.85	-	1080	3289	6763	0.4863226
A08	22335902	22337324	A08p21030.2_BraZ1	762.45	+	1665	1422	1422	1.0000000
A08	22338345	22340462	A08p21040.2_BraZ1	1761	+	1615	2117	2117	1.0000000
A08	22340850	22341668	A08p21050.2_BraZ1	630	-	446	818	818	1.0000000
A08	22348132	22348918	A08p21060.2_BraZ1	482.5	+	33	446	786	0.5674300
A08	22349709	22350911	A08p21070.2_BraZ1	1131	+	1034	1202	1202	1.0000000
A08	22351650	22351872	A08p21080.2_BraZ1	22.2	-	280	222	222	1.0000000
A08	22359132	22359392	A08p21090.2_BraZ1	192	+	34	203	260	0.7807692
A08	22361937	22363156	A08p21100.2_BraZ1	58.8	+	1020	1067	1219	0.8753076
A08	22366330	22366660	A08p21110.2_BraZ1	237	+	34	330	330	1.0000000
A08	22377467	22377809	A08p21120.2_BraZ1	240	+	158	342	342	1.0000000
A08	22385643	22385971	A08p21130.2_BraZ1	102.96	+	529	328	328	1.0000000
A08	22388990	22393452	A08p21140.2_BraZ1	1707.42	+	1340	3589	4462	0.8043478
A08	22394050	22395960	A08p21150.2_BraZ1	1228.21	-	1950	1890	1910	0.9895288
A08	22396925	22399955	A08p21160.2_BraZ1	1236	-	2215	2895	3030	0.9554455
A08	22400821	22402239	A08p21170.2_BraZ1	325.582	+	733	1343	1418	0.9471086
A08	22404179	22405409	A08p21180.2_BraZ1	874.943	+	447	1208	1230	0.9821138
A08	22406063	22407257	A08p21190.2_BraZ1	6228	-	66	884	1194	0.7403685
A08	22407687	22409015	A08p21200.2_BraZ1	689.5	-	732	1328	1328	1.0000000
A08	22408748	22408934	A08p21210.2_BraZ1	129	-	137	186	186	1.0000000
A08	22411064	22412109	A08p21220.2_BraZ1	252	-	471	870	1045	0.8325359
A08	22423506	22424917	A08p21230.2_BraZ1	1073.37	+	126	805	1411	0.5705174
A08	22425726	22426252	A08p21240.2_BraZ1	321.75	-	5	199	526	0.3783270
A08	22431724	22433023	A08p21250.2_BraZ1	129.9	-	178	1148	1299	0.8837568
A08	22447200	22449379	A08p21260.2_BraZ1	1121.42	+	544	1986	2179	0.9114273
A08	22455306	22460992	A08p21270.2_BraZ1	316.566	+	948	4461	5686	0.7845586
A08	22461850	22463193	A08p21280.2_BraZ1	693.9	+	1068	1343	1343	1.0000000
A08	22464564	22466689	A08p21290.2_BraZ1	1579.09	+	585	1918	2125	0.9025882
A08	22469834	22470163	A08p21300.2_BraZ1	20.7	-	29	205	329	0.6231003
A08	22470819	22473362	A08p21310.2_BraZ1	1075.18	-	356	2274	2543	0.8942194
A08	22473979	22475212	A08p21320.2_BraZ1	187.922	-	1009	1233	1233	1.0000000
A08	22476246	22478549	A08p21330.2_BraZ1	1241.85	-	796	2112	2303	0.9170647
A08	22481727	22482041	A08p21340.2_BraZ1	237	-	167	314	314	1.0000000
A08	22489412	22493470	A08p21350.2_BraZ1	3450.6	+	1566	3873	4058	0.9544110
A08	22493936	22496058	A08p21360.2_BraZ1	885.15	-	615	2010	2122	0.9472196
A08	22497521	22502534	A08p21370.2_BraZ1	589.75	+	3522	4825	5013	0.9624975
A08	22503193	22504169	A08p21380.2_BraZ1	1260.15	-	815	976	976	1.0000000
A08	22506534	22507550	A08p21390.2_BraZ1	448.8	-	844	1016	1016	1.0000000
A08	22509161	22510142	A08p21400.2_BraZ1	5304	-	307	967	981	0.9857289
A08	22512921	22513307	A08p21410.2_BraZ1	3120	+	116	374	386	0.9689119
A08	22513540	22515205	A08p21420.2_BraZ1	7852	-	147	1299	1665	0.7801802
A08	22516218	22517628	A08p21430.2_BraZ1	576.45	+	580	1410	1410	1.0000000
A08	22519100	22520150	A08p21440.2_BraZ1	6402	+	244	844	1050	0.8038095
A08	22520987	22522495	A08p21450.2_BraZ1	800.1	-	1008	1508	1508	1.0000000
A08	22523397	22529357	A08p21460.2_BraZ1	782.609	-	427	2018	5960	0.3385906
A08	22527465	22528045	A08p21470.2_BraZ1	318	+	0	0	580	0.0000000
A08	22537253	22539148	A08p21480.2_BraZ1	1023.04	-	560	1760	1895	0.9287599
A08	22548713	22548929	A08p21490.2_BraZ1	13.5	+	35	216	216	1.0000000
A08	22549191	22551577	A08p21500.2_BraZ1	4040.08	+	864	2148	2386	0.9002514
A08	22557435	22557648	A08p21510.2_BraZ1	21.3	-	77	207	213	0.9718310
A08	22560217	22562958	A08p21520.2_BraZ1	1476.6	-	493	2349	2741	0.8569865
A08	22567944	22568487	A08p21530.2_BraZ1	54.3	+	73	543	543	1.0000000
A08	22570339	22570856	A08p21540.2_BraZ1	285	+	190	517	517	1.0000000
A08	22572655	22573108	A08p21550.2_BraZ1	45.3	+	86	413	453	0.9116998
A08	22575587	22577057	A08p21560.2_BraZ1	832.571	+	319	1193	1470	0.8115646
A08	22578676	22578838	A08p21570.2_BraZ1	16.2	-	7	131	162	0.8086420
A08	22581883	22583082	A08p21580.2_BraZ1	831.6	+	4	76	1199	0.0633862
A08	22587314	22588937	A08p21590.2_BraZ1	9763.5	+	111	856	1623	0.5274184
A08	22589685	22591785	A08p21600.2_BraZ1	5393.25	+	908	1667	2100	0.7938095
A08	22593411	22594721	A08p21610.2_BraZ1	838.04	+	917	1310	1310	1.0000000
A08	22595482	22596777	A08p21620.2_BraZ1	85.44	+	1151	1295	1295	1.0000000
A08	22597941	22601377	A08p21630.2_BraZ1	1856.62	-	1339	3243	3436	0.9438300
A08	22607340	22609296	A08p21640.2_BraZ1	195.6	+	380	1601	1956	0.8185071
A08	22609927	22612876	A08p21650.2_BraZ1	24816.4	+	459	2599	2949	0.8813157
A08	22614717	22615200	A08p21660.2_BraZ1	48.3	-	29	100	483	0.2070393
A08	22625613	22630612	A08p21670.2_BraZ1	2684.66	-	1241	4583	4999	0.9167833
A08	22637327	22641639	A08p21680.2_BraZ1	1053	+	747	2028	4312	0.4703154
A08	22638925	22639357	A08p21690.2_BraZ1	885	-	0	0	432	0.0000000
A08	22641829	22643506	A08p21700.2_BraZ1	273	-	1277	1677	1677	1.0000000
A08	22644163	22646354	A08p21710.2_BraZ1	982.8	+	856	2111	2191	0.9634870
A08	22650279	22651799	A08p21720.2_BraZ1	1536	+	655	1362	1520	0.8960527
A08	22652516	22653030	A08p21730.2_BraZ1	369	-	50	450	514	0.8754864
A08	22656341	22658450	A08p21740.2_BraZ1	1053.73	+	144	1754	2109	0.8316738
A08	22661403	22661676	A08p21750.2_BraZ1	27.3	-	40	187	273	0.6849817
A08	22662459	22663939	A08p21760.2_BraZ1	1053.75	+	592	1410	1480	0.9527027
A08	22665152	22668506	A08p21770.2_BraZ1	2266.9	+	652	2360	3354	0.7036374
A08	22674275	22681684	A08p21780.2_BraZ1	15222	+	2413	5413	7409	0.7305979
A08	22707854	22709232	A08p21790.2_BraZ1	722.057	-	869	1378	1378	1.0000000
A08	22711297	22712603	A08p21800.2_BraZ1	606	-	1377	1306	1306	1.0000000
A08	22718047	22719622	A08p21810.2_BraZ1	157.5	+	576	1574	1575	0.9993651
A08	22719767	22720394	A08p21820.2_BraZ1	62.7	-	105	347	627	0.5534290
A08	22732769	22733832	A08p21830.2_BraZ1	677.167	+	0	0	1063	0.0000000
A08	22738299	22738660	A08p21840.2_BraZ1	207	+	46	206	361	0.5706371
A08	22741878	22744067	A08p21850.2_BraZ1	1498.5	+	135	1172	2189	0.5354043
A08	22760636	22761986	A08p21860.2_BraZ1	135	+	233	637	1350	0.4718519
A08	22764148	22765483	A08p21870.2_BraZ1	133.5	-	131	1137	1335	0.8516854
A08	22765775	22767368	A08p21880.2_BraZ1	1509	+	815	1593	1593	1.0000000
A08	22768146	22769948	A08p21890.2_BraZ1	883.244	-	2666	1700	1802	0.9433962
A08	22771998	22773487	A08p21900.2_BraZ1	936.783	+	488	1450	1489	0.9738079
A08	22773742	22775266	A08p21910.2_BraZ1	604.167	-	641	1329	1524	0.8720472
A08	22776875	22777443	A08p21920.2_BraZ1	369	+	389	546	568	0.9612676
A08	22778032	22779021	A08p21930.2_BraZ1	561	+	136	867	989	0.8766431
A08	22780080	22781277	A08p21940.2_BraZ1	119.7	+	915	1187	1197	0.9916458
A08	22782027	22786545	A08p21950.2_BraZ1	570.833	+	306	1202	4518	0.2660469
A08	22787526	22788678	A08p21960.2_BraZ1	432	+	974	1152	1152	1.0000000
A08	22789805	22792426	A08p21970.2_BraZ1	1459.09	+	1760	2621	2621	1.0000000
A08	22792987	22793917	A08p21980.2_BraZ1	405	-	241	832	930	0.8946236
A08	22799830	22801462	A08p21990.2_BraZ1	812.842	+	996	1612	1632	0.9877451
A08	22802228	22803358	A08p22000.2_BraZ1	906.818	+	263	1086	1130	0.9610620
A08	22803625	22804303	A08p22010.2_BraZ1	67.8	-	56	449	678	0.6622419
A08	22816192	22819041	A08p22020.2_BraZ1	1634.37	-	846	2580	2849	0.9055809
A08	22819755	22821366	A08p22030.2_BraZ1	161.1	-	79	1304	1611	0.8094351
A08	22827351	22830306	A08p22040.2_BraZ1	983.32	-	486	2443	2955	0.8267344
A08	22840681	22841420	A08p22050.2_BraZ1	419.909	+	898	739	739	1.0000000
A08	22841923	22844699	A08p22060.2_BraZ1	1590	-	1550	2127	2776	0.7662104
A08	22845257	22847252	A08p22070.2_BraZ1	198.3	+	2550	1995	1995	1.0000000
A08	22848102	22849072	A08p22080.2_BraZ1	2598.75	+	575	811	970	0.8360825
A08	22849770	22852347	A08p22090.2_BraZ1	1311.24	-	1123	2473	2577	0.9596430
A08	22854206	22854848	A08p22100.2_BraZ1	264	+	638	642	642	1.0000000
A08	22856404	22856786	A08p22110.2_BraZ1	231	+	289	382	382	1.0000000
A08	22861966	22862777	A08p22120.2_BraZ1	309	-	327	787	811	0.9704069
A08	22864169	22864604	A08p22130.2_BraZ1	231	+	112	433	435	0.9954023
A08	22874679	22875089	A08p22140.2_BraZ1	315	-	38	308	410	0.7512195
A08	22877845	22878457	A08p22150.2_BraZ1	435	+	518	612	612	1.0000000
A08	22880349	22880754	A08p22160.2_BraZ1	225	+	327	405	405	1.0000000
A08	22887113	22887587	A08p22170.2_BraZ1	47.4	-	53	381	474	0.8037975
A08	22889506	22893408	A08p22180.2_BraZ1	1860.7	+	2314	3793	3902	0.9720656
A08	22894219	22896818	A08p22190.2_BraZ1	1601.26	-	2007	2599	2599	1.0000000
A08	22899039	22900368	A08p22200.2_BraZ1	132.9	+	176	978	1329	0.7358916
A08	22904496	22905370	A08p22210.2_BraZ1	423	+	148	874	874	1.0000000
A08	22905634	22906241	A08p22220.2_BraZ1	396	-	98	603	607	0.9934102
A08	22906549	22907681	A08p22230.2_BraZ1	527.727	-	412	990	1132	0.8745583
A08	22911017	22912220	A08p22240.2_BraZ1	618	-	973	1203	1203	1.0000000
A08	22915003	22915358	A08p22250.2_BraZ1	300	+	2	145	355	0.4084507
A08	22916341	22917814	A08p22260.2_BraZ1	1281	-	141	1256	1473	0.8526816
A08	22933108	22934782	A08p22270.2_BraZ1	948.389	+	692	1498	1674	0.8948626
A08	22935570	22936977	A08p22280.2_BraZ1	1411.8	-	210	1118	1407	0.7945985
A08	22938331	22940992	A08p22290.2_BraZ1	2047.07	-	1837	2610	2661	0.9808342
A08	22952139	22952857	A08p22300.2_BraZ1	426.667	+	16	511	718	0.7116992
A08	22954269	22956532	A08p22310.2_BraZ1	869.318	-	798	2028	2263	0.8961555
A08	22956813	22959676	A08p22320.2_BraZ1	1045.09	-	1784	2863	2863	1.0000000
A08	22974544	22975327	A08p22330.2_BraZ1	123	-	836	783	783	1.0000000
A08	22980464	22983222	A08p22340.2_BraZ1	1044	+	463	1573	2758	0.5703408
A08	22984122	22987567	A08p22350.2_BraZ1	2025.4	-	1157	2892	3445	0.8394775
A08	22990402	22991957	A08p22360.2_BraZ1	693.441	-	1434	1555	1555	1.0000000
A08	22992496	22997406	A08p22370.2_BraZ1	2441.57	+	2618	4728	4910	0.9629328
A08	22998367	22998586	A08p22380.2_BraZ1	21.9	-	1	131	219	0.5981735
A08	23001290	23002352	A08p22390.2_BraZ1	459	-	503	1062	1062	1.0000000
A08	23004754	23006408	A08p22400.2_BraZ1	1159.24	+	324	1418	1654	0.8573156
A08	23007406	23010778	A08p22410.2_BraZ1	1618.5	-	1106	3198	3372	0.9483986
A08	23012260	23012996	A08p22420.2_BraZ1	923	+	250	736	736	1.0000000
A08	23013542	23015597	A08p22430.2_BraZ1	205.5	-	143	1591	2055	0.7742093
A08	23016784	23017249	A08p22440.2_BraZ1	45.3	+	460	465	465	1.0000000
A08	23017980	23018604	A08p22450.2_BraZ1	62.4	-	239	624	624	1.0000000
A08	23019427	23021288	A08p22460.2_BraZ1	1349.68	-	542	1818	1861	0.9768941
A08	23026028	23026479	A08p22470.2_BraZ1	225	+	268	451	451	1.0000000
A08	23026939	23027658	A08p22480.2_BraZ1	295.312	-	191	679	719	0.9443672
A08	23036809	23038485	A08p22490.2_BraZ1	1506	-	839	1630	1676	0.9725537
A08	23041607	23041736	A08p22500.2_BraZ1	12.3	-	274	129	129	1.0000000
A08	23041930	23042191	A08p22510.2_BraZ1	26.1	+	192	261	261	1.0000000
A08	23043577	23043679	A08p22520.2_BraZ1	10.2	-	116	97	102	0.9509804
A08	23043986	23046949	A08p22530.2_BraZ1	1864.64	+	867	2659	2963	0.8974013
A08	23048342	23049190	A08p22540.2_BraZ1	83.1	+	44	458	848	0.5400943
A08	23050149	23050548	A08p22550.2_BraZ1	192.913	-	122	399	399	1.0000000
A08	23051462	23059550	A08p22560.2_BraZ1	4922.8	+	1931	6177	8088	0.7637240
A08	23060251	23062280	A08p22570.2_BraZ1	559.091	-	1555	2026	2029	0.9985214
A08	23063908	23065976	A08p22580.2_BraZ1	992.87	+	834	2031	2068	0.9821083
A08	23066124	23066715	A08p22590.2_BraZ1	522	-	220	591	591	1.0000000
A08	23067980	23075479	A08p22600.2_BraZ1	1735.08	+	2165	6926	7499	0.9235898
A08	23080681	23081668	A08p22610.2_BraZ1	98.7	+	81	700	987	0.7092199
A08	23097219	23105628	A08p22620.2_BraZ1	366	+	2653	5557	8409	0.6608396
A08	23112671	23114767	A08p22630.2_BraZ1	1050.22	-	2944	2096	2096	1.0000000
A08	23116132	23117716	A08p22640.2_BraZ1	917.333	-	517	1578	1584	0.9962121
A08	23122769	23124579	A08p22650.2_BraZ1	1064.35	-	1199	1810	1810	1.0000000
A08	23125591	23129527	A08p22660.2_BraZ1	1154.71	-	1721	3916	3936	0.9949187
A08	23135702	23137663	A08p22670.2_BraZ1	267	-	1999	1961	1961	1.0000000
A08	23138615	23138807	A08p22680.2_BraZ1	19.2	-	266	192	192	1.0000000
A08	23142591	23144051	A08p22690.2_BraZ1	1155	-	49	69	1460	0.0472603
A08	23144938	23145244	A08p22700.2_BraZ1	18.9	-	148	306	306	1.0000000
A08	23147886	23148212	A08p22710.2_BraZ1	249	-	341	326	326	1.0000000
A08	23161040	23165137	A08p22720.2_BraZ1	17860.5	+	1659	3902	4097	0.9524042
A08	23165863	23166344	A08p22730.2_BraZ1	2250	-	351	475	481	0.9875260
A08	23166862	23167280	A08p22740.2_BraZ1	330	-	46	395	418	0.9449761
A08	23173620	23176970	A08p22750.2_BraZ1	6193.67	+	1099	3199	3350	0.9549254
A08	23177667	23178129	A08p22760.2_BraZ1	64.8	-	425	462	462	1.0000000
A08	23178644	23180911	A08p22770.2_BraZ1	1737.5	-	419	1820	2267	0.8028231
A08	23184526	23186111	A08p22780.2_BraZ1	1244.7	+	223	1110	1585	0.7003155
A08	23186401	23187079	A08p22790.2_BraZ1	67.8	-	599	608	678	0.8967552
A08	23190009	23191104	A08p22800.2_BraZ1	13177.5	+	350	1043	1095	0.9525114
A08	23194391	23203460	A08p22810.2_BraZ1	980	-	5024	8885	9069	0.9797111
A08	23197302	23201002	A08p22820.2_BraZ1	186.629	+	1438	3658	3700	0.9886487
A08	23213541	23214054	A08p22830.2_BraZ1	51.3	-	85	388	513	0.7563353
A08	23215972	23217234	A08p22840.2_BraZ1	387.671	+	486	1247	1262	0.9881141
A08	23218215	23221053	A08p22850.2_BraZ1	2062.13	+	592	2614	2838	0.9210712
A08	23222261	23223051	A08p22860.2_BraZ1	1370.77	+	415	790	790	1.0000000
A08	23223552	23227041	A08p22870.2_BraZ1	1366.82	-	1442	3344	3489	0.9584408
A08	23230452	23236760	A08p22880.2_BraZ1	732.375	+	1064	4428	6308	0.7019657
A08	23238754	23240027	A08p22890.2_BraZ1	698.486	+	1559	1273	1273	1.0000000
A08	23240542	23241430	A08p22900.2_BraZ1	88.8	-	352	874	888	0.9842342
A08	23245028	23246052	A08p22910.2_BraZ1	87.3	-	9	91	1024	0.0888672
A08	23246888	23247646	A08p22920.2_BraZ1	261.333	-	123	657	758	0.8667546
A08	23247016	23247463	A08p22930.2_BraZ1	147	-	106	389	447	0.8702461
A08	23247729	23247921	A08p22940.2_BraZ1	19.2	-	54	192	192	1.0000000
A08	23250279	23253293	A08p22950.2_BraZ1	662.02	+	1716	2989	3014	0.9917054
A08	23253854	23259046	A08p22960.2_BraZ1	2997	-	2212	4807	5192	0.9258475
A08	23259930	23262143	A08p22970.2_BraZ1	464.511	-	1690	1839	2213	0.8309987
A08	23263880	23264273	A08p22980.2_BraZ1	39	+	337	355	393	0.9033079
A08	23266460	23268701	A08p22990.2_BraZ1	1037.85	+	1508	2241	2241	1.0000000
A08	23269448	23270864	A08p23000.2_BraZ1	141.6	-	966	1416	1416	1.0000000
A08	23276377	23278101	A08p23010.2_BraZ1	1205.45	+	666	1537	1724	0.8915313
A08	23278639	23279603	A08p23020.2_BraZ1	293.25	-	509	964	964	1.0000000
A08	23280235	23280665	A08p23030.2_BraZ1	348	+	231	430	430	1.0000000
A08	23281260	23282516	A08p23040.2_BraZ1	1113	+	487	1157	1256	0.9211783
A08	23283626	23285981	A08p23050.2_BraZ1	1641.62	+	920	2355	2355	1.0000000
A08	23287646	23288227	A08p23060.2_BraZ1	465	-	147	581	581	1.0000000
A08	23292701	23293575	A08p23070.2_BraZ1	213	+	876	874	874	1.0000000
A08	23294883	23295075	A08p23080.2_BraZ1	18.6	+	51	192	192	1.0000000
A08	23299282	23302486	A08p23090.2_BraZ1	1247.23	+	795	2697	3204	0.8417603
A08	23303846	23310642	A08p23100.2_BraZ1	2777.18	+	1265	5871	6796	0.8638905
A08	23315564	23321015	A08p23110.2_BraZ1	1017.9	+	1101	1715	5451	0.3146212
A08	23316997	23318367	A08p23120.2_BraZ1	216.75	+	0	0	1370	0.0000000
A08	23318567	23318900	A08p23130.2_BraZ1	252	-	0	0	333	0.0000000
A08	23321834	23322101	A08p23140.2_BraZ1	171	+	306	267	267	1.0000000
A08	23322155	23322504	A08p23150.2_BraZ1	297	+	548	349	349	1.0000000
A08	23325146	23325706	A08p23160.2_BraZ1	720	+	0	0	560	0.0000000
A08	23335146	23338999	A08p23170.2_BraZ1	1477.13	+	2144	3853	3853	1.0000000
A08	23339610	23340242	A08p23180.2_BraZ1	254.4	-	489	632	632	1.0000000
A08	23341064	23341639	A08p23190.2_BraZ1	369	-	296	575	575	1.0000000
A08	23341650	23342261	A08p23200.2_BraZ1	237	-	526	611	611	1.0000000
A08	23349289	23350602	A08p23210.2_BraZ1	935.133	-	41	750	1313	0.5712110
A08	23352391	23359245	A08p23220.2_BraZ1	2155.61	-	2402	6180	6854	0.9016632
A08	23361448	23362268	A08p23230.2_BraZ1	327	+	33	395	820	0.4817073
A08	23361982	23362889	A08p23240.2_BraZ1	204	+	281	607	907	0.6692392
A08	23363275	23363428	A08p23250.2_BraZ1	15.3	-	52	153	153	1.0000000
A08	23366089	23367130	A08p23260.2_BraZ1	417	+	1717	1035	1041	0.9942363
A08	23369091	23370903	A08p23270.2_BraZ1	452.344	-	20	421	1812	0.2323399
A08	23371706	23372604	A08p23280.2_BraZ1	606	+	0	0	898	0.0000000
A08	23377185	23378694	A08p23290.2_BraZ1	1195.43	+	443	1468	1509	0.9728297
A08	23380780	23381448	A08p23300.2_BraZ1	294.75	+	186	617	668	0.9236527
A08	23382823	23383272	A08p23310.2_BraZ1	202.125	-	359	449	449	1.0000000
A08	23383394	23383622	A08p23320.2_BraZ1	21.9	-	2	14	228	0.0614035
A08	23383755	23386332	A08p23330.2_BraZ1	470.11	+	135	564	2577	0.2188591
A08	23386875	23387468	A08p23340.2_BraZ1	57	+	54	430	593	0.7251265
A08	23390694	23392594	A08p23350.2_BraZ1	953.143	+	712	1900	1900	1.0000000
A08	23393931	23394492	A08p23360.2_BraZ1	56.1	-	31	391	561	0.6969697
A08	23395254	23396821	A08p23370.2_BraZ1	636.513	+	805	1560	1567	0.9955329
A08	23398825	23400352	A08p23380.2_BraZ1	205.8	-	1788	1527	1527	1.0000000
A08	23402545	23406482	A08p23390.2_BraZ1	2320.61	+	1356	3568	3937	0.9062738
A08	23407277	23408433	A08p23400.2_BraZ1	704.273	-	1221	1156	1156	1.0000000
A08	23411278	23414444	A08p23410.2_BraZ1	1330.48	+	736	2690	3166	0.8496525
A08	23416069	23419797	A08p23420.2_BraZ1	2903.75	-	705	1711	3728	0.4589592
A08	23423125	23424937	A08p23430.2_BraZ1	790.772	-	320	1725	1812	0.9519867
A08	23426518	23427498	A08p23440.2_BraZ1	294	+	181	818	980	0.8346938
A08	23428123	23431852	A08p23450.2_BraZ1	862.279	-	1960	3480	3729	0.9332260
A08	23433217	23436193	A08p23460.2_BraZ1	1907.43	-	559	2512	2976	0.8440861
A08	23438533	23439747	A08p23470.2_BraZ1	4536	-	381	1131	1214	0.9316310
A08	23448166	23449018	A08p23480.2_BraZ1	85.2	+	324	534	852	0.6267605
A08	23455349	23456126	A08p23490.2_BraZ1	77.7	+	44	413	777	0.5315315
A08	23462850	23464732	A08p23500.2_BraZ1	324	-	1236	1757	1882	0.9335813
A08	23475394	23476150	A08p23510.2_BraZ1	75.6	+	118	499	756	0.6600529
A08	23477142	23481826	A08p23520.2_BraZ1	1752.8	+	753	2231	4684	0.4763023
A08	23484333	23484618	A08p23530.2_BraZ1	28.5	-	49	285	285	1.0000000
A08	23484635	23484764	A08p23540.2_BraZ1	12.9	-	31	129	129	1.0000000
A08	23485131	23487836	A08p23550.2_BraZ1	482.391	+	2104	2197	2705	0.8121997
A08	23488931	23490681	A08p23560.2_BraZ1	1184	-	1347	1750	1750	1.0000000
A08	23497139	23498008	A08p23570.2_BraZ1	646.425	-	55	528	869	0.6075949
A08	23506073	23509315	A08p23580.2_BraZ1	1806.49	+	3112	3242	3242	1.0000000
A08	23510546	23514050	A08p23590.2_BraZ1	740.182	-	2525	3504	3504	1.0000000
A08	23520643	23521807	A08p23600.2_BraZ1	804	-	374	1152	1164	0.9896907
A08	23524248	23524560	A08p23610.2_BraZ1	31.2	-	194	312	312	1.0000000
A08	23527756	23529073	A08p23620.2_BraZ1	906.048	-	171	1005	1317	0.7630979
A08	23530208	23537281	A08p23630.2_BraZ1	2171.43	-	2399	6344	7073	0.8969320
A08	23538363	23539319	A08p23640.2_BraZ1	543	-	250	936	956	0.9790795
A08	23539880	23540611	A08p23650.2_BraZ1	766.5	-	51	550	731	0.7523940
A08	23541482	23542435	A08p23660.2_BraZ1	507	-	7	100	953	0.1049318
A08	23546659	23548284	A08p23670.2_BraZ1	695.374	+	27	346	1625	0.2129231
A08	23549576	23551157	A08p23680.2_BraZ1	306	+	816	1581	1581	1.0000000
A08	23558998	23559999	A08p23690.2_BraZ1	210	-	85	725	1001	0.7242757
A08	23561917	23563311	A08p23700.2_BraZ1	2622	+	923	1394	1394	1.0000000
A08	23564844	23566140	A08p23710.2_BraZ1	78	-	5795	1296	1296	1.0000000
A08	23570602	23575737	A08p23720.2_BraZ1	1318.24	+	3152	4801	5135	0.9349562
A08	23578236	23579655	A08p23730.2_BraZ1	28388.2	+	68	849	1419	0.5983087
A08	23581061	23582547	A08p23740.2_BraZ1	865.231	+	865	1264	1486	0.8506057
A08	23582913	23585885	A08p23750.2_BraZ1	1845.25	-	1428	2972	2972	1.0000000
A08	23594748	23595381	A08p23760.2_BraZ1	63.3	+	165	586	633	0.9257504
A08	23600362	23602411	A08p23770.2_BraZ1	1060.96	-	1269	2049	2049	1.0000000
A08	23603438	23604627	A08p23780.2_BraZ1	637.5	-	1005	1189	1189	1.0000000
A08	23605918	23611051	A08p23790.2_BraZ1	2667.93	+	2159	4737	5133	0.9228522
A08	23612289	23615199	A08p23800.2_BraZ1	1219.64	-	2270	2910	2910	1.0000000
A08	23616046	23617044	A08p23810.2_BraZ1	329.755	-	770	998	998	1.0000000
A08	23624397	23624652	A08p23820.2_BraZ1	25.5	-	0	0	255	0.0000000
A08	23630010	23631360	A08p23830.2_BraZ1	634.25	-	274	1211	1350	0.8970370
A08	23632922	23633582	A08p23840.2_BraZ1	66	-	208	637	660	0.9651515
A08	23634186	23637048	A08p23850.2_BraZ1	1824	-	1196	2673	2862	0.9339623
A08	23638380	23639402	A08p23860.2_BraZ1	1440	-	69	406	1022	0.3972603
A08	23641517	23642738	A08p23870.2_BraZ1	122.1	+	87	851	1221	0.6969697
A08	23645303	23649409	A08p23880.2_BraZ1	6415.5	+	6809	4065	4106	0.9900146
A08	23651766	23654569	A08p23890.2_BraZ1	2188.19	-	1416	2761	2803	0.9850160
A08	23655335	23656889	A08p23900.2_BraZ1	325	-	1261	1500	1554	0.9652510
A08	23656815	23657378	A08p23910.2_BraZ1	306.25	+	413	519	563	0.9218472
A08	23658177	23659431	A08p23920.2_BraZ1	1173	-	216	1178	1254	0.9393939
A08	23664581	23668179	A08p23930.2_BraZ1	2278.43	+	1549	3506	3598	0.9744303
A08	23673022	23673337	A08p23940.2_BraZ1	31.5	-	11	107	315	0.3396825
A08	23685691	23686177	A08p23950.2_BraZ1	48.6	+	136	486	486	1.0000000
A08	23699890	23701336	A08p23960.2_BraZ1	6300	+	208	1237	1446	0.8554633
A08	23703517	23704593	A08p23970.2_BraZ1	894.667	-	904	1076	1076	1.0000000
A08	23707746	23711106	A08p23980.2_BraZ1	1512	-	895	2128	3360	0.6333333
A08	23713466	23715905	A08p23990.2_BraZ1	243.9	-	304	1715	2439	0.7031570
A08	23717770	23718038	A08p24000.2_BraZ1	171	+	0	0	268	0.0000000
A08	23718092	23718441	A08p24010.2_BraZ1	297	+	79	272	349	0.7793697
A08	23720582	23738861	A08p24020.2_BraZ1	5469.77	+	6553	15012	18279	0.8212703
A08	23725868	23729041	A08p24030.2_BraZ1	621.409	-	2444	3173	3173	1.0000000
A08	23741760	23742443	A08p24040.2_BraZ1	642	+	345	608	683	0.8901904
A08	23744437	23748838	A08p24050.2_BraZ1	2461.66	+	1180	4100	4401	0.9316065
A08	23750518	23751682	A08p24060.2_BraZ1	864.5	-	89	530	1164	0.4553265
A08	23755499	23759358	A08p24070.2_BraZ1	989.4	+	683	2622	3859	0.6794506
A08	23759970	23766027	A08p24080.2_BraZ1	604.239	-	1800	4515	6057	0.7454185
A08	23771898	23778219	A08p24090.2_BraZ1	1629.75	+	1933	4115	6321	0.6510046
A08	23779792	23782458	A08p24100.2_BraZ1	770.44	+	181	1293	2666	0.4849963
A08	23782812	23786727	A08p24110.2_BraZ1	1809.05	-	2425	3593	3915	0.9177522
A08	23789358	23790429	A08p24120.2_BraZ1	107.1	-	515	1022	1071	0.9542484
A08	23792274	23794082	A08p24130.2_BraZ1	1244.83	-	965	1644	1808	0.9092920
A08	23795144	23795553	A08p24140.2_BraZ1	258	+	449	409	409	1.0000000
A08	23798191	23799157	A08p24150.2_BraZ1	96.6	-	395	966	966	1.0000000
A08	23800495	23801335	A08p24160.2_BraZ1	84	-	609	840	840	1.0000000
A08	23803493	23805201	A08p24170.2_BraZ1	1107	-	907	1667	1708	0.9759953
A08	23807467	23808772	A08p24180.2_BraZ1	130.5	-	238	1199	1305	0.9187739
A08	23809472	23811592	A08p24190.2_BraZ1	1028.73	-	1666	2120	2120	1.0000000
A08	23813295	23816579	A08p24200.2_BraZ1	1245.93	-	2024	3067	3284	0.9339221
A08	23819826	23820009	A08p24210.2_BraZ1	18.3	+	135	183	183	1.0000000
A08	23823125	23823296	A08p24220.2_BraZ1	17.1	+	59	171	171	1.0000000
A08	23824259	23825241	A08p24230.2_BraZ1	643.636	+	393	914	982	0.9307536
A08	23826544	23826769	A08p24240.2_BraZ1	22.5	-	0	0	225	0.0000000
A08	23838600	23839392	A08p24250.2_BraZ1	79.2	+	47	555	792	0.7007576
A08	23845440	23847502	A08p24260.2_BraZ1	1125	-	497	1791	2062	0.8685742
A08	23847944	23849820	A08p24270.2_BraZ1	878.732	-	1169	1876	1876	1.0000000
A08	23851100	23853243	A08p24280.2_BraZ1	765.06	+	1023	1824	2143	0.8511432
A08	23853477	23855912	A08p24290.2_BraZ1	861.577	-	2288	2417	2435	0.9926078
A08	23858499	23858876	A08p24300.2_BraZ1	237	+	405	377	377	1.0000000
A08	23861117	23863041	A08p24310.2_BraZ1	343	-	957	1473	1924	0.7655925
A08	23862338	23862708	A08p24320.2_BraZ1	234	+	133	346	370	0.9351351
A08	23863481	23863811	A08p24330.2_BraZ1	237	+	176	330	330	1.0000000
A08	23866583	23868067	A08p24340.2_BraZ1	796.571	-	1340	1367	1484	0.9211590
A08	23868724	23873112	A08p24350.2_BraZ1	799.871	+	2670	4317	4388	0.9838195
A08	23873770	23873994	A08p24360.2_BraZ1	64.8	-	132	224	224	1.0000000
A08	23874271	23875905	A08p24370.2_BraZ1	406.35	-	1120	1632	1634	0.9987760
A08	23877768	23878915	A08p24380.2_BraZ1	456	-	1042	1147	1147	1.0000000
A08	23885213	23885453	A08p24390.2_BraZ1	24	-	0	0	240	0.0000000
A08	23889803	23890364	A08p24400.2_BraZ1	56.1	-	9	174	561	0.3101604
A08	23896191	23901014	A08p24410.2_BraZ1	2475	-	1616	4472	4823	0.9272237
A08	23906410	23906581	A08p24420.2_BraZ1	17.1	+	119	171	171	1.0000000
A08	23907495	23907979	A08p24430.2_BraZ1	384	-	147	460	484	0.9504132
A08	23910603	23913182	A08p24440.2_BraZ1	327	+	1613	2477	2579	0.9604498
A08	23913902	23914505	A08p24450.2_BraZ1	60.3	-	396	593	603	0.9834163
A08	23921761	23923078	A08p24460.2_BraZ1	1179	+	290	541	1317	0.4107821
A08	23931352	23933867	A08p24470.2_BraZ1	1960.71	+	881	2170	2515	0.8628231
A08	23934847	23935931	A08p24480.2_BraZ1	798	+	403	1028	1084	0.9483395
A08	23937080	23943735	A08p24490.2_BraZ1	4959.37	-	2159	6198	6655	0.9313298
A08	23945668	23950493	A08p24500.2_BraZ1	7105.84	+	1524	4419	4825	0.9158549
A08	23952470	23953190	A08p24510.2_BraZ1	72	+	157	674	720	0.9361111
A08	23956544	23958968	A08p24520.2_BraZ1	1428.51	+	514	2220	2424	0.9158416
A08	23959372	23961259	A08p24530.2_BraZ1	1179.08	-	225	1461	1887	0.7742448
A08	23962286	23963781	A08p24540.2_BraZ1	5717.33	+	209	1211	1495	0.8100334
A08	23968662	23969115	A08p24550.2_BraZ1	45.3	+	781	453	453	1.0000000
A08	23969935	23971484	A08p24560.2_BraZ1	1648.89	+	302	1250	1549	0.8069723
A08	23971790	23972159	A08p24570.2_BraZ1	36.9	-	5	147	369	0.3983740
A08	23972801	23973062	A08p24580.2_BraZ1	126	-	53	261	261	1.0000000
A08	23974488	23975856	A08p24590.2_BraZ1	735.778	+	211	1145	1368	0.8369883
A08	23976326	23978803	A08p24600.2_BraZ1	2340.45	-	576	2394	2477	0.9664917
A08	23987697	23989012	A08p24610.2_BraZ1	372	+	218	919	1315	0.6988593
A08	23991330	23991570	A08p24620.2_BraZ1	24	+	1	20	240	0.0833333
A08	23998373	24001676	A08p24630.2_BraZ1	6222	+	580	2095	3303	0.6342719
A08	24002105	24003484	A08p24640.2_BraZ1	716.429	-	427	1291	1379	0.9361857
A08	24003828	24005094	A08p24650.2_BraZ1	126.6	-	401	482	1266	0.3807267
A08	24006158	24006974	A08p24660.2_BraZ1	642	-	511	816	816	1.0000000
A08	24014308	24019815	A08p24670.2_BraZ1	2339.18	+	4448	5507	5507	1.0000000
A08	24020349	24022877	A08p24680.2_BraZ1	777.143	-	1693	2450	2528	0.9691456
A08	24023464	24024407	A08p24690.2_BraZ1	275.786	+	386	943	943	1.0000000
A08	24025946	24027192	A08p24700.2_BraZ1	849.333	-	178	964	1246	0.7736757
A08	24030875	24031654	A08p24710.2_BraZ1	324	-	966	779	779	1.0000000
A08	24033666	24035562	A08p24720.2_BraZ1	1521	-	507	1687	1896	0.8897679
A08	24037842	24039066	A08p24730.2_BraZ1	122.4	-	178	1190	1224	0.9722222
A08	24040188	24043122	A08p24740.2_BraZ1	1290.41	-	1797	2934	2934	1.0000000
A08	24044661	24047371	A08p24750.2_BraZ1	1638.29	-	1614	2633	2710	0.9715867
A08	24048375	24048585	A08p24760.2_BraZ1	13.5	-	36	154	210	0.7333333
A08	24053381	24055225	A08p24770.2_BraZ1	564.571	+	482	1812	1844	0.9826464
A08	24055416	24057160	A08p24780.2_BraZ1	832.349	-	1321	1639	1744	0.9397936
A08	24068346	24069534	A08p24790.2_BraZ1	599.857	-	436	1171	1188	0.9856902
A08	24077880	24080883	A08p24800.2_BraZ1	1627.15	+	2059	2981	3003	0.9926740
A08	24081661	24082535	A08p24810.2_BraZ1	467.514	-	848	874	874	1.0000000
A08	24083769	24084870	A08p24820.2_BraZ1	110.1	+	771	1101	1101	1.0000000
A08	24087604	24087922	A08p24830.2_BraZ1	31.8	-	450	318	318	1.0000000
A08	24095877	24100586	A08p24840.2_BraZ1	1839.6	+	745	2643	4709	0.5612656
A08	24115220	24115742	A08p24850.2_BraZ1	52.2	-	107	409	522	0.7835249
A08	24128678	24129709	A08p24860.2_BraZ1	523.304	-	212	1010	1031	0.9796314
A08	24130404	24132513	A08p24870.2_BraZ1	1409.4	-	762	1946	2109	0.9227122
A08	24134511	24135827	A08p24880.2_BraZ1	8814.75	-	433	1204	1316	0.9148936
A08	24140937	24142772	A08p24890.2_BraZ1	1358.28	-	1724	1835	1835	1.0000000
A08	24143036	24144038	A08p24900.2_BraZ1	473.087	-	1045	1002	1002	1.0000000
A08	24145178	24147766	A08p24910.2_BraZ1	1314.35	-	594	2335	2588	0.9022411
A08	24149733	24150453	A08p24920.2_BraZ1	72	+	152	646	720	0.8972222
A08	24151851	24161363	A08p24930.2_BraZ1	1460.61	-	4807	8836	9512	0.9289319
A08	24164144	24167441	A08p24940.2_BraZ1	4608.5	+	1381	2819	3297	0.8550197
A08	24167941	24168304	A08p24950.2_BraZ1	162	-	24	115	363	0.3168044
A08	24168813	24169464	A08p24960.2_BraZ1	46.8	+	1488	651	651	1.0000000
A08	24170437	24178050	A08p24970.2_BraZ1	6336	+	3965	7021	7613	0.9222383
A08	24180576	24184756	A08p24980.2_BraZ1	10179.8	+	3906	4052	4180	0.9693780
A08	24185394	24187071	A08p24990.2_BraZ1	837.31	-	1530	1677	1677	1.0000000
A08	24187798	24189393	A08p25000.2_BraZ1	1034.53	+	50	1038	1595	0.6507837
A08	24192887	24193471	A08p25010.2_BraZ1	266.75	-	64	520	584	0.8904110
A08	24194053	24197715	A08p25020.2_BraZ1	1369.5	-	143	2358	3662	0.6439104
A08	24202958	24204191	A08p25030.2_BraZ1	1209	+	142	479	1233	0.3884834
A08	24223725	24225473	A08p25040.2_BraZ1	1073.86	+	170	939	1748	0.5371854
A08	24237814	24238732	A08p25050.2_BraZ1	91.8	+	725	918	918	1.0000000
A08	24243108	24243363	A08p25060.2_BraZ1	25.5	-	149	255	255	1.0000000
A08	24247173	24247434	A08p25070.2_BraZ1	26.1	+	30	261	261	1.0000000
A08	24249075	24251086	A08p25080.2_BraZ1	4509	-	838	1864	2011	0.9269021
A08	24254433	24255165	A08p25090.2_BraZ1	312	-	698	732	732	1.0000000
A08	24264414	24264693	A08p25100.2_BraZ1	27.9	+	1	39	279	0.1397849
A08	24271882	24274090	A08p25110.2_BraZ1	12673.5	+	0	0	2208	0.0000000
A08	24274608	24275073	A08p25120.2_BraZ1	387	+	0	0	465	0.0000000
A08	24277158	24277263	A08p25130.2_BraZ1	10.5	-	0	0	105	0.0000000
A08	24282898	24285106	A08p25140.2_BraZ1	12673.5	+	1	51	2208	0.0230978
A08	24285623	24286088	A08p25150.2_BraZ1	387	+	4	244	465	0.5247312
A08	24293936	24296144	A08p25160.2_BraZ1	13419	+	0	0	2208	0.0000000
A08	24307334	24309513	A08p25170.2_BraZ1	1717.88	+	124	1167	2179	0.5355667
A08	24309973	24320203	A08p25180.2_BraZ1	1085.33	+	5315	7893	10230	0.7715542
A08	24321567	24322922	A08p25190.2_BraZ1	8160	-	393	1134	1355	0.8369004
A08	24323993	24326466	A08p25200.2_BraZ1	1495.23	+	1394	2473	2473	1.0000000
A08	24341458	24343048	A08p25210.2_BraZ1	1283.29	+	164	1224	1590	0.7698113
A08	24347208	24348280	A08p25220.2_BraZ1	726	+	21	958	1072	0.8936567
A08	24355058	24357091	A08p25230.2_BraZ1	1728	-	823	1965	2033	0.9665519
A08	24361329	24361876	A08p25240.2_BraZ1	267	+	412	547	547	1.0000000
A08	24362375	24366943	A08p25250.2_BraZ1	2865.89	-	1226	4453	4568	0.9748248
A08	24369943	24371005	A08p25260.2_BraZ1	677.167	+	20	581	1062	0.5470810
A08	24371086	24372349	A08p25270.2_BraZ1	5616	+	0	0	1263	0.0000000
A08	24382129	24383707	A08p25280.2_BraZ1	157.8	+	243	1211	1578	0.7674271
A08	24387491	24388001	A08p25290.2_BraZ1	51	+	235	510	510	1.0000000
A08	24389815	24390289	A08p25300.2_BraZ1	47.4	+	47	266	474	0.5611814
A08	24390772	24391151	A08p25310.2_BraZ1	264	-	256	379	379	1.0000000
A08	24391623	24392829	A08p25320.2_BraZ1	120.6	+	311	1188	1206	0.9850746
A08	24394018	24394318	A08p25330.2_BraZ1	30	+	275	292	300	0.9733334
A08	24394524	24394764	A08p25340.2_BraZ1	24	+	290	240	240	1.0000000
A08	24399596	24400186	A08p25350.2_BraZ1	177	-	103	581	590	0.9847457
A08	24401025	24402930	A08p25360.2_BraZ1	369.6	-	299	856	1905	0.4493438
A08	24410050	24412450	A08p25370.2_BraZ1	1303.08	+	183	1491	2400	0.6212500
A08	24425392	24427098	A08p25380.2_BraZ1	1378.67	+	320	1174	1706	0.6881595
A08	24447552	24448554	A08p25390.2_BraZ1	774.286	+	147	925	1002	0.9231537
A08	24467633	24468203	A08p25400.2_BraZ1	405	+	12	344	570	0.6035088
A08	24476146	24477722	A08p25410.2_BraZ1	153.3	+	1424	1576	1576	1.0000000
A08	24478174	24478988	A08p25420.2_BraZ1	163.2	-	1084	814	814	1.0000000
A08	24480275	24482661	A08p25430.2_BraZ1	1168.66	-	998	2132	2386	0.8935457
A08	24487758	24489019	A08p25440.2_BraZ1	888.478	-	295	1179	1261	0.9349722
A08	24492360	24493521	A08p25450.2_BraZ1	116.1	+	698	1042	1161	0.8975021
A08	24494005	24496910	A08p25460.2_BraZ1	2616.67	-	1652	2905	2905	1.0000000
A08	24497930	24500369	A08p25470.2_BraZ1	1902.99	-	405	2304	2439	0.9446495
A08	24500822	24501628	A08p25480.2_BraZ1	663	-	201	702	806	0.8709677
A08	24502064	24504888	A08p25490.2_BraZ1	1461.5	-	1122	2792	2824	0.9886686
A08	24506267	24509527	A08p25500.2_BraZ1	632.5	-	473	1799	3260	0.5518405
A08	24523991	24534668	A08p25510.2_BraZ1	3441.25	+	1862	6471	10677	0.6060691
A08	24539302	24541742	A08p25520.2_BraZ1	1040	+	109	1203	2440	0.4930328
A08	24543413	24546611	A08p25530.2_BraZ1	1283.25	+	1982	2465	3198	0.7707943
A08	24547219	24548878	A08p25540.2_BraZ1	165.9	-	377	1223	1659	0.7371911
A08	24549436	24557358	A08p25550.2_BraZ1	1881.29	-	17	212	7922	0.0267609
A08	24558222	24561850	A08p25560.2_BraZ1	971.511	-	122	878	3628	0.2420066
A08	24568983	24570888	A08p25570.2_BraZ1	1036.84	+	510	1883	1905	0.9884514
A08	24571745	24572425	A08p25580.2_BraZ1	423	-	699	680	680	1.0000000
A08	24575512	24575698	A08p25590.2_BraZ1	18.6	+	128	186	186	1.0000000
A08	24578541	24584982	A08p25600.2_BraZ1	1597.11	+	2738	6127	6441	0.9512498
A08	24585361	24586441	A08p25610.2_BraZ1	565.435	-	536	1080	1080	1.0000000
A08	24586682	24586934	A08p25620.2_BraZ1	25.2	+	23	252	252	1.0000000
A08	24587415	24588700	A08p25630.2_BraZ1	577.769	+	215	859	1285	0.6684825
A08	24592970	24595543	A08p25640.2_BraZ1	1439.06	-	626	2015	2573	0.7831326
A08	24597569	24597965	A08p25650.2_BraZ1	39.6	+	25	375	396	0.9469697
A08	24599121	24599559	A08p25660.2_BraZ1	43.8	+	20	331	438	0.7557077
A08	24600027	24606096	A08p25670.2_BraZ1	1092.36	-	1699	4591	6069	0.7564673
A08	24608164	24609091	A08p25680.2_BraZ1	92.7	-	160	812	927	0.8759439
A08	24611078	24612083	A08p25690.2_BraZ1	861	+	387	992	1005	0.9870647
A08	24621261	24622922	A08p25700.2_BraZ1	835.154	+	168	1489	1661	0.8964479
A08	24624150	24627348	A08p25710.2_BraZ1	1557	-	846	2942	3198	0.9199499
A08	24636463	24638936	A08p25720.2_BraZ1	712.53	-	745	2423	2473	0.9797816
A08	24640483	24640892	A08p25730.2_BraZ1	252	-	423	409	409	1.0000000
A08	24641505	24642203	A08p25740.2_BraZ1	375.375	-	762	698	698	1.0000000
A08	24642689	24643070	A08p25750.2_BraZ1	249	-	224	381	381	1.0000000
A08	24644142	24644347	A08p25760.2_BraZ1	53.8235	-	88	205	205	1.0000000
A08	24645373	24650002	A08p25770.2_BraZ1	894.205	+	3082	4557	4629	0.9844459
A08	24651512	24653184	A08p25780.2_BraZ1	501.882	+	332	1648	1672	0.9856459
A08	24660144	24660984	A08p25790.2_BraZ1	84	+	1119	840	840	1.0000000
A08	24661627	24662607	A08p25800.2_BraZ1	480	-	411	974	980	0.9938775
A08	24664991	24666143	A08p25810.2_BraZ1	115.2	-	715	1031	1152	0.8949653
A08	24666499	24674759	A08p25820.2_BraZ1	3835.54	-	7372	8205	8260	0.9933414
A08	24675896	24677240	A08p25830.2_BraZ1	134.4	-	272	1045	1344	0.7775298
A08	24680184	24680483	A08p25840.2_BraZ1	216	+	0	0	299	0.0000000
A08	24681922	24683137	A08p25850.2_BraZ1	120.6	+	195	1109	1215	0.9127572
A08	24683940	24685182	A08p25860.2_BraZ1	695.576	+	345	1000	1242	0.8051530
A08	24688218	24688995	A08p25870.2_BraZ1	77.7	+	66	666	777	0.8571429
A08	24706932	24708212	A08p25880.2_BraZ1	789	-	290	1271	1280	0.9929687
A08	24710649	24711786	A08p25890.2_BraZ1	113.7	-	350	1129	1137	0.9929640
A08	24712537	24713701	A08p25900.2_BraZ1	116.4	+	83	901	1164	0.7740550
A08	24714979	24716377	A08p25910.2_BraZ1	636.192	+	815	1398	1398	1.0000000
A08	24716661	24722644	A08p25920.2_BraZ1	4756.8	+	5561	5983	5983	1.0000000
A08	24724637	24725250	A08p25930.2_BraZ1	537	-	279	613	613	1.0000000
A08	24728603	24729491	A08p25940.2_BraZ1	88.8	+	102	557	888	0.6272523
A08	24732019	24735585	A08p25950.2_BraZ1	1509.22	-	1287	2839	3566	0.7961301
A08	24736605	24738639	A08p25960.2_BraZ1	1794	+	397	1635	2034	0.8038348
A08	24739142	24739364	A08p25970.2_BraZ1	22.2	-	6	146	222	0.6576577
A08	24741295	24741628	A08p25980.2_BraZ1	33.3	-	45	333	333	1.0000000
A08	24743714	24747378	A08p25990.2_BraZ1	1738.52	-	3242	3664	3664	1.0000000
A08	24748703	24752067	A08p26000.2_BraZ1	1520.86	-	1032	2914	3364	0.8662307
A08	24755477	24756272	A08p26010.2_BraZ1	79.5	+	29	277	795	0.3484277
A08	24756651	24757091	A08p26020.2_BraZ1	225	-	432	440	440	1.0000000
A08	24760592	24765500	A08p26030.2_BraZ1	52057.2	-	2027	4649	4908	0.9472290
A08	24766659	24768231	A08p26040.2_BraZ1	157.2	+	923	1572	1572	1.0000000
A08	24774531	24780691	A08p26050.2_BraZ1	12660	+	629	3673	6160	0.5962662
A08	24782611	24784234	A08p26060.2_BraZ1	162.3	+	1580	1623	1623	1.0000000
A08	24787708	24789207	A08p26070.2_BraZ1	873	+	871	1499	1499	1.0000000
A08	24790330	24792883	A08p26080.2_BraZ1	983.333	+	828	2299	2553	0.9005092
A08	24802135	24810036	A08p26090.2_BraZ1	851.4	+	500	2385	7901	0.3018605
A08	24804017	24804624	A08p26100.2_BraZ1	207	+	2	233	607	0.3838550
A08	24804734	24805312	A08p26110.2_BraZ1	210	+	0	0	578	0.0000000
A08	24815158	24818765	A08p26120.2_BraZ1	3525	-	344	3200	3607	0.8871639
A08	24825611	24826869	A08p26130.2_BraZ1	994.56	-	155	994	1258	0.7901431
A08	24829317	24831492	A08p26140.2_BraZ1	1147.23	+	1207	2099	2175	0.9650575
A08	24832461	24834471	A08p26150.2_BraZ1	1397.25	-	1795	2010	2010	1.0000000
A08	24837610	24838015	A08p26160.2_BraZ1	249	-	412	405	405	1.0000000
A08	24838694	24838868	A08p26170.2_BraZ1	17.4	-	245	174	174	1.0000000
A08	24839291	24839459	A08p26180.2_BraZ1	16.8	-	93	168	168	1.0000000
A08	24840576	24844566	A08p26190.2_BraZ1	2405.5	-	479	3059	3990	0.7666667
A08	24848178	24848597	A08p26200.2_BraZ1	168	-	84	419	419	1.0000000
A08	24848588	24849299	A08p26210.2_BraZ1	142.35	-	526	711	711	1.0000000
A08	24849637	24850288	A08p26220.2_BraZ1	459	-	417	651	651	1.0000000
A08	24851344	24852096	A08p26230.2_BraZ1	498	+	598	752	752	1.0000000
A08	24853219	24854485	A08p26240.2_BraZ1	927	+	217	1189	1266	0.9391785
A08	24855004	24856813	A08p26250.2_BraZ1	370.857	-	1007	1809	1809	1.0000000
A08	24857397	24858032	A08p26260.2_BraZ1	54.5	-	316	635	635	1.0000000
A08	24863524	24864220	A08p26270.2_BraZ1	69.6	+	209	696	696	1.0000000
A08	24864723	24866165	A08p26280.2_BraZ1	612.068	+	129	1066	1442	0.7392510
A08	24868264	24870718	A08p26290.2_BraZ1	1474.64	+	554	1892	2454	0.7709861
A08	24871139	24873637	A08p26300.2_BraZ1	1565.19	-	1085	2436	2498	0.9751801
A08	24875782	24878625	A08p26310.2_BraZ1	1567.43	-	2007	2842	2843	0.9996483
A08	24880932	24882495	A08p26320.2_BraZ1	1224.94	+	547	1541	1563	0.9859245
A08	24883409	24885857	A08p26330.2_BraZ1	1006.86	+	883	2308	2448	0.9428105
A08	24886292	24888932	A08p26340.2_BraZ1	264	+	327	2298	2640	0.8704545
A08	24889995	24893622	A08p26350.2_BraZ1	778.586	+	2427	3501	3627	0.9652606
A08	24894614	24896333	A08p26360.2_BraZ1	1107	+	741	1710	1719	0.9947644
A08	24897532	24898873	A08p26370.2_BraZ1	134.1	+	368	1297	1341	0.9671887
A08	24899464	24904313	A08p26380.2_BraZ1	2238.51	-	855	2770	4849	0.5712518
A08	24909411	24910751	A08p26390.2_BraZ1	729	+	835	1340	1340	1.0000000
A08	24911643	24917937	A08p26400.2_BraZ1	3139.38	-	2232	5205	6294	0.8269781
A08	24921497	24923477	A08p26410.2_BraZ1	847.222	-	1959	1980	1980	1.0000000
A08	24923933	24924323	A08p26420.2_BraZ1	39	+	542	390	390	1.0000000
A08	24924486	24924711	A08p26430.2_BraZ1	22.5	+	492	225	225	1.0000000
A08	24931154	24931541	A08p26440.2_BraZ1	288	-	604	387	387	1.0000000
A08	24932326	24932476	A08p26450.2_BraZ1	15	+	409	150	150	1.0000000
A08	24941304	24941672	A08p26460.2_BraZ1	195	+	573	368	368	1.0000000
A08	24950296	24954104	A08p26470.2_BraZ1	1696.59	-	1253	3556	3808	0.9338235
A08	24954658	24955692	A08p26480.2_BraZ1	572.5	-	336	1034	1034	1.0000000
A08	24958788	24959569	A08p26490.2_BraZ1	702	-	850	781	781	1.0000000
A08	24985002	24986051	A08p26500.2_BraZ1	536.5	+	164	1039	1049	0.9904671
A08	24988392	24988933	A08p26510.2_BraZ1	177	+	662	541	541	1.0000000
A08	24989382	24990450	A08p26520.2_BraZ1	840	+	852	1068	1068	1.0000000
A08	24991554	24993461	A08p26530.2_BraZ1	1009.25	+	655	1907	1907	1.0000000
A08	24994311	24995652	A08p26540.2_BraZ1	509.062	-	555	1332	1341	0.9932886
A08	24997424	24998127	A08p26550.2_BraZ1	493.281	-	655	658	703	0.9359886
A08	24998448	24998674	A08p26560.2_BraZ1	18.6	-	206	226	226	1.0000000
A08	24999057	25000013	A08p26570.2_BraZ1	7150	+	264	815	956	0.8525105
A08	25000357	25000903	A08p26580.2_BraZ1	54.6	+	201	546	546	1.0000000
A08	25004063	25005645	A08p26590.2_BraZ1	1320.65	+	1353	1515	1582	0.9576486
A08	25006411	25007403	A08p26600.2_BraZ1	624	+	149	873	992	0.8800403
A08	25008448	25009002	A08p26610.2_BraZ1	393	-	9	171	554	0.3086643
A08	25017072	25022798	A08p26620.2_BraZ1	888.696	-	4334	5295	5726	0.9247293
A08	25023826	25024150	A08p26630.2_BraZ1	246	+	272	324	324	1.0000000
A08	25025643	25027332	A08p26640.2_BraZ1	680.464	+	1261	1637	1689	0.9692125
A08	25027668	25029066	A08p26650.2_BraZ1	681.353	-	1124	1398	1398	1.0000000
A08	25034251	25035773	A08p26660.2_BraZ1	15057	+	447	1453	1522	0.9546649
A08	25042772	25043291	A08p26670.2_BraZ1	51.9	+	225	519	519	1.0000000
A08	25044375	25044701	A08p26680.2_BraZ1	210	-	229	326	326	1.0000000
A08	25048569	25050380	A08p26690.2_BraZ1	868.966	+	1526	1811	1811	1.0000000
A08	25051784	25053374	A08p26700.2_BraZ1	1233	+	931	1529	1590	0.9616352
A08	25054739	25055696	A08p26710.2_BraZ1	95.7	+	128	740	957	0.7732497
A08	25057129	25058694	A08p26720.2_BraZ1	106.8	+	444	1564	1565	0.9993610
A08	25059404	25062032	A08p26730.2_BraZ1	1502.96	-	1314	2599	2628	0.9889650
A08	25063028	25064549	A08p26740.2_BraZ1	1014	+	680	1506	1521	0.9901381
A08	25066702	25068715	A08p26750.2_BraZ1	1105.65	+	1115	1970	2013	0.9786388
A08	25070830	25071893	A08p26760.2_BraZ1	852	-	235	489	1063	0.4600188
A08	25079079	25087041	A08p26770.2_BraZ1	4526.91	+	1436	4851	7962	0.6092690
A08	25087724	25088924	A08p26780.2_BraZ1	8547	-	101	647	1200	0.5391667
A08	25090346	25092388	A08p26790.2_BraZ1	450.563	+	784	1984	2042	0.9715965
A08	25092611	25097604	A08p26800.2_BraZ1	2366.17	-	1216	4664	4993	0.9341078
A08	25101829	25103478	A08p26810.2_BraZ1	990.6	+	590	1569	1649	0.9514858
A08	25103981	25104809	A08p26820.2_BraZ1	404.429	-	450	828	828	1.0000000
A08	25105308	25107359	A08p26830.2_BraZ1	1306.8	-	717	1856	2051	0.9049245
A08	25108517	25111776	A08p26840.2_BraZ1	1515.77	-	1963	3259	3259	1.0000000
A08	25116204	25129998	A08p26850.2_BraZ1	4472.59	+	2763	11833	13794	0.8578367
A08	25130370	25130827	A08p26860.2_BraZ1	363	-	530	457	457	1.0000000
A08	25132506	25137075	A08p26870.2_BraZ1	2121.82	+	190	2235	4569	0.4891661
A08	25137952	25140266	A08p26880.2_BraZ1	1389.44	-	943	2294	2314	0.9913570
A08	25140975	25143788	A08p26890.2_BraZ1	1702.46	-	1548	2715	2813	0.9651617
A08	25144962	25148110	A08p26900.2_BraZ1	1610.92	-	719	2951	3148	0.9374206
A08	25150205	25151770	A08p26910.2_BraZ1	856.406	+	1070	1499	1565	0.9578274
A08	25152777	25153170	A08p26920.2_BraZ1	39.3	+	44	169	393	0.4300255
A08	25154382	25156316	A08p26930.2_BraZ1	738	-	258	1804	1934	0.9327818
A08	25159661	25163095	A08p26940.2_BraZ1	1113.2	-	2549	3434	3434	1.0000000
A08	25165029	25166577	A08p26950.2_BraZ1	1149	+	273	1291	1548	0.8339793
A08	25167283	25167655	A08p26960.2_BraZ1	37.2	-	284	372	372	1.0000000
A08	25169565	25172577	A08p26970.2_BraZ1	20727	-	1481	2822	3012	0.9369190
A08	25173159	25173342	A08p26980.2_BraZ1	18.3	+	102	183	183	1.0000000
A08	25174971	25175580	A08p26990.2_BraZ1	318.411	-	602	609	609	1.0000000
A08	25177026	25179829	A08p27000.2_BraZ1	1981.61	+	1097	2503	2803	0.8929718
A08	25180561	25186965	A08p27010.2_BraZ1	1619.15	-	2573	6219	6404	0.9711118
A08	25190350	25192400	A08p27020.2_BraZ1	4380	-	1068	2050	2050	1.0000000
A08	25192882	25194028	A08p27030.2_BraZ1	499.32	+	470	1129	1146	0.9851658
A08	25194520	25199938	A08p27040.2_BraZ1	2192.48	-	801	3638	5418	0.6714655
A08	25201705	25206031	A08p27050.2_BraZ1	1830	+	2616	3884	4326	0.8978271
A08	25206228	25207610	A08p27060.2_BraZ1	1860.48	-	275	1363	1382	0.9862518
A08	25208840	25209020	A08p27070.2_BraZ1	18	+	25	14	180	0.0777778
A08	25209381	25218497	A08p27080.2_BraZ1	4076.45	-	2595	8041	9116	0.8820755
A08	25220647	25222358	A08p27090.2_BraZ1	5100.38	-	312	1510	1711	0.8825248
A08	25225464	25234007	A08p27100.2_BraZ1	4598.75	-	3298	8228	8543	0.9631277
A08	25239386	25240107	A08p27110.2_BraZ1	360.918	-	93	631	721	0.8751734
A08	25242277	25245739	A08p27120.2_BraZ1	1998.24	-	1032	2992	3462	0.8642403
A08	25269094	25273193	A08p27130.2_BraZ1	2063.21	+	1055	3453	4099	0.8424006
A08	25277117	25280040	A08p27140.2_BraZ1	1264.09	-	433	2646	2923	0.9052343
A08	25284599	25286487	A08p27150.2_BraZ1	895.272	-	960	1734	1888	0.9184322
A08	25293785	25295395	A08p27160.2_BraZ1	1096.2	+	249	1282	1610	0.7962733
A08	25297841	25300462	A08p27170.2_BraZ1	79663.5	-	574	2434	2621	0.9286532
A08	25303854	25311046	A08p27180.2_BraZ1	2947.91	-	1785	6274	7192	0.8723582
A08	25316223	25317444	A08p27190.2_BraZ1	122.1	-	298	1200	1221	0.9828010
A08	25323820	25324641	A08p27200.2_BraZ1	26.1	+	547	821	821	1.0000000
A08	25325898	25329676	A08p27210.2_BraZ1	1936.96	+	1051	3406	3778	0.9015352
A08	25330959	25332052	A08p27220.2_BraZ1	667.34	-	575	1047	1093	0.9579140
A08	25334982	25337660	A08p27230.2_BraZ1	1500	+	976	2512	2678	0.9380134
A08	25338843	25339072	A08p27240.2_BraZ1	17.1	+	76	229	229	1.0000000
A08	25342440	25343367	A08p27250.2_BraZ1	834	+	470	927	927	1.0000000
A08	25349538	25349988	A08p27260.2_BraZ1	45	+	585	450	450	1.0000000
A08	25352528	25353917	A08p27270.2_BraZ1	1305.28	+	543	1329	1389	0.9568034
A08	25354588	25355866	A08p27280.2_BraZ1	792.72	+	352	897	1278	0.7018780
A08	25356213	25356844	A08p27290.2_BraZ1	369.882	-	323	587	631	0.9302694
A08	25359553	25361030	A08p27300.2_BraZ1	900.068	-	315	1372	1477	0.9289100
A08	25362487	25364534	A08p27310.2_BraZ1	795.667	+	751	1769	2047	0.8641915
A08	25364975	25366224	A08p27320.2_BraZ1	492	-	214	898	1249	0.7189752
A08	25388706	25390533	A08p27330.2_BraZ1	1484.57	+	143	526	1827	0.2879037
A08	25394075	25395197	A08p27340.2_BraZ1	112.2	-	88	879	1122	0.7834225
A08	25401407	25403273	A08p27350.2_BraZ1	1024.77	-	629	1575	1866	0.8440514
A08	25421823	25422262	A08p27360.2_BraZ1	42.3	+	61	141	439	0.3211845
A08	25424207	25426610	A08p27370.2_BraZ1	1702.97	+	810	2396	2403	0.9970870
A08	25428693	25429488	A08p27380.2_BraZ1	467.457	+	530	753	795	0.9471698
A08	25431727	25433141	A08p27390.2_BraZ1	840	-	963	1342	1414	0.9490806
A08	25442032	25442836	A08p27400.2_BraZ1	80.4	-	44	557	804	0.6927861
A08	25444282	25447855	A08p27410.2_BraZ1	1121.33	-	1841	3567	3573	0.9983208
A08	25449972	25450620	A08p27420.2_BraZ1	251.804	+	65	477	648	0.7361111
A08	25451559	25452877	A08p27430.2_BraZ1	112.2	-	228	1293	1318	0.9810319
A08	25454744	25455062	A08p27440.2_BraZ1	31.8	+	278	318	318	1.0000000
A08	25455822	25456536	A08p27450.2_BraZ1	71.4	-	81	317	714	0.4439776
A08	25457810	25458656	A08p27460.2_BraZ1	84.6	-	322	846	846	1.0000000
A08	25459273	25460916	A08p27470.2_BraZ1	1566	-	673	1594	1643	0.9701765
A08	25462721	25462964	A08p27480.2_BraZ1	24.3	+	2	78	243	0.3209876
A08	25463524	25488122	A08p27490.2_BraZ1	759.3	+	12195	23016	24598	0.9356858
A08	25489169	25490715	A08p27500.2_BraZ1	911.429	+	1018	1390	1546	0.8990945
A08	25492226	25492680	A08p27510.2_BraZ1	378	+	7	231	454	0.5088106
A08	25493267	25496037	A08p27520.2_BraZ1	1701	+	999	2724	2770	0.9833935
A08	25497142	25498640	A08p27530.2_BraZ1	1069.97	-	390	1339	1498	0.8938585
A08	25502025	25504025	A08p27540.2_BraZ1	1070.11	-	805	1901	2000	0.9505000
A08	25508337	25508526	A08p27550.2_BraZ1	18.9	-	50	180	189	0.9523810
A08	25516973	25518058	A08p27560.2_BraZ1	574.219	+	0	0	1085	0.0000000
A08	25528020	25528290	A08p27570.2_BraZ1	27	+	122	204	270	0.7555556
A08	25528780	25529203	A08p27580.2_BraZ1	42.3	+	70	423	423	1.0000000
A08	25533069	25534096	A08p27590.2_BraZ1	662.87	+	1254	1027	1027	1.0000000
A08	25535066	25535816	A08p27600.2_BraZ1	474.95	-	39	537	750	0.7160000
A08	25537384	25538425	A08p27610.2_BraZ1	104.1	+	0	0	1041	0.0000000
A08	25542677	25543118	A08p27620.2_BraZ1	42.6	-	247	441	441	1.0000000
A08	25545273	25545438	A08p27630.2_BraZ1	16.5	+	232	165	165	1.0000000
A08	25545811	25546228	A08p27640.2_BraZ1	41.7	-	479	417	417	1.0000000
A08	25547128	25547662	A08p27650.2_BraZ1	53.4	-	162	534	534	1.0000000
A08	25548974	25549547	A08p27660.2_BraZ1	57.3	-	558	573	573	1.0000000
A08	25550469	25551368	A08p27670.2_BraZ1	13018.5	-	322	899	899	1.0000000
A08	25554504	25557268	A08p27680.2_BraZ1	1803.12	+	664	2689	2764	0.9728654
A08	25560291	25561925	A08p27690.2_BraZ1	9483	-	552	1502	1634	0.9192166
A08	25564074	25567726	A08p27700.2_BraZ1	2150.22	+	1355	3516	3652	0.9627602
A08	25568688	25569214	A08p27710.2_BraZ1	1749	+	160	501	526	0.9524715
A08	25571478	25573620	A08p27720.2_BraZ1	214.2	-	1582	2142	2142	1.0000000
A08	25584968	25586938	A08p27730.2_BraZ1	632.195	+	812	1911	1970	0.9700508
A08	25587272	25589522	A08p27740.2_BraZ1	1239.17	-	1182	2250	2250	1.0000000
A08	25589773	25590053	A08p27750.2_BraZ1	17.4	-	92	273	280	0.9750000
A08	25592508	25593927	A08p27760.2_BraZ1	141.9	+	211	1356	1419	0.9556025
A08	25597152	25598125	A08p27770.2_BraZ1	420	-	198	895	973	0.9198356
A08	25598289	25598658	A08p27780.2_BraZ1	36.9	-	55	366	369	0.9918699
A08	25603666	25603987	A08p27790.2_BraZ1	32.1	-	13	248	321	0.7725857
A08	25613352	25614284	A08p27800.2_BraZ1	786	-	23	224	932	0.2403433
A08	25616322	25620915	A08p27810.2_BraZ1	420	-	1462	4363	4593	0.9499238
A08	25629438	25631013	A08p27820.2_BraZ1	157.5	+	373	1251	1575	0.7942857
A08	25631843	25633762	A08p27830.2_BraZ1	1599	-	611	1788	1919	0.9317353
A08	25636029	25637043	A08p27840.2_BraZ1	381.663	-	315	985	1014	0.9714004
A08	25637313	25638267	A08p27850.2_BraZ1	95.4	+	69	734	954	0.7693920
A08	25639983	25640499	A08p27860.2_BraZ1	51.6	-	34	393	516	0.7616279
A08	25642778	25644210	A08p27870.2_BraZ1	888.618	-	866	1369	1432	0.9560056
A08	25645594	25649710	A08p27880.2_BraZ1	2447.55	+	818	3530	4116	0.8576288
A08	25655952	25656477	A08p27890.2_BraZ1	52.5	+	86	524	525	0.9980952
A08	25658172	25659435	A08p27900.2_BraZ1	126	-	570	1263	1263	1.0000000
A08	25661598	25662513	A08p27910.2_BraZ1	516	-	205	763	915	0.8338798
A08	25663234	25665914	A08p27920.2_BraZ1	1225.77	-	718	2553	2680	0.9526119
A08	25666308	25666726	A08p27930.2_BraZ1	40.8	+	70	194	418	0.4641148
A08	25667994	25668695	A08p27940.2_BraZ1	486	-	807	701	701	1.0000000
A08	25669131	25670676	A08p27950.2_BraZ1	499.902	-	1350	1545	1545	1.0000000
A08	25671085	25672662	A08p27960.2_BraZ1	830.206	+	903	1577	1577	1.0000000
A08	25674842	25675287	A08p27970.2_BraZ1	357	-	124	401	445	0.9011236
A08	25677317	25677933	A08p27980.2_BraZ1	162	-	86	368	616	0.5974026
A08	25680911	25682399	A08p27990.2_BraZ1	192	-	151	974	1488	0.6545699
A08	25681747	25684240	A08p28000.2_BraZ1	159	-	517	2287	2493	0.9173687
A08	25686191	25687198	A08p28010.2_BraZ1	168.75	-	193	929	1007	0.9225422
A08	25687486	25688054	A08p28020.2_BraZ1	98.2857	+	156	552	568	0.9718310
A08	25688651	25690187	A08p28030.2_BraZ1	153.6	+	437	1510	1536	0.9830729
A08	25691563	25691674	A08p28040.2_BraZ1	11.1	+	16	111	111	1.0000000
A08	25697650	25699526	A08p28050.2_BraZ1	1103.18	+	431	1686	1876	0.8987207
A08	25701857	25703506	A08p28060.2_BraZ1	949.571	+	1339	1649	1649	1.0000000
A08	25706384	25708587	A08p28070.2_BraZ1	1059.5	+	2559	2185	2203	0.9918293
A08	25713212	25713923	A08p28080.2_BraZ1	648	+	289	624	711	0.8776371
A08	25714099	25714710	A08p28090.2_BraZ1	381	-	344	611	611	1.0000000
A08	25715177	25717999	A08p28100.2_BraZ1	1767.05	+	1808	2822	2822	1.0000000
A08	25718366	25719946	A08p28110.2_BraZ1	1377	-	634	1580	1580	1.0000000
A08	25721491	25725026	A08p28120.2_BraZ1	817.103	-	3206	3527	3535	0.9977369
A08	25726663	25727203	A08p28130.2_BraZ1	2452.5	-	282	540	540	1.0000000
A08	25729992	25733073	A08p28140.2_BraZ1	21956	-	1082	3081	3081	1.0000000
A08	25733633	25737954	A08p28150.2_BraZ1	616	+	9117	4321	4321	1.0000000
A08	25739425	25739978	A08p28160.2_BraZ1	483	-	2013	553	553	1.0000000
A08	25741757	25743456	A08p28170.2_BraZ1	1290	-	4263	1699	1699	1.0000000
A08	25750335	25756530	A08p28180.2_BraZ1	4629.72	-	3500	6042	6195	0.9753026
A08	25759776	25760981	A08p28190.2_BraZ1	116.7	-	1035	1204	1205	0.9991701
A08	25762149	25762329	A08p28200.2_BraZ1	18	+	26	173	180	0.9611111
A08	25764729	25765573	A08p28210.2_BraZ1	68.4	-	0	0	844	0.0000000
A08	25768796	25769012	A08p28220.2_BraZ1	21.6	+	0	0	216	0.0000000
A08	25773045	25774678	A08p28230.2_BraZ1	745.771	-	104	966	1633	0.5915493
A08	25777483	25779124	A08p28240.2_BraZ1	904.286	-	249	1141	1641	0.6953077
A08	25782793	25783045	A08p28250.2_BraZ1	25.2	+	450	252	252	1.0000000
A08	25790862	25791699	A08p28260.2_BraZ1	83.7	+	192	760	837	0.9080048
A08	25793677	25794069	A08p28270.2_BraZ1	954	+	274	392	392	1.0000000
A08	25796002	25797388	A08p28280.2_BraZ1	138.6	+	215	907	1386	0.6544012
A08	25798061	25798235	A08p28290.2_BraZ1	17.4	+	35	174	174	1.0000000
A08	25800986	25803491	A08p28300.2_BraZ1	1699.29	-	854	2446	2505	0.9764471
A08	25807138	25807450	A08p28310.2_BraZ1	30.9	-	55	312	312	1.0000000
A08	25813159	25813724	A08p28320.2_BraZ1	165	-	68	250	565	0.4424779
A08	25816867	25817392	A08p28330.2_BraZ1	51.9	+	47	428	525	0.8152381
A08	25822581	25823136	A08p28340.2_BraZ1	55.5	-	186	501	555	0.9027027
A08	25826721	25831677	A08p28350.2_BraZ1	1622.88	-	3543	4772	4956	0.9628733
A08	25831625	25831854	A08p28360.2_BraZ1	135	+	213	229	229	1.0000000
A08	25837758	25838916	A08p28370.2_BraZ1	975	+	67	437	1158	0.3773748
A08	25839506	25840191	A08p28380.2_BraZ1	61.2	-	698	685	685	1.0000000
A08	25840971	25841655	A08p28390.2_BraZ1	68.4	+	311	684	684	1.0000000
A08	25847141	25847477	A08p28400.2_BraZ1	33.6	-	2	84	336	0.2500000
A08	25853313	25856103	A08p28410.2_BraZ1	2325.48	+	1582	2762	2790	0.9899642
A08	25856343	25856530	A08p28420.2_BraZ1	108	-	251	187	187	1.0000000
A08	25859840	25862498	A08p28430.2_BraZ1	1661.7	+	932	2035	2658	0.7656133
A08	25866532	25868200	A08p28440.2_BraZ1	12178.5	+	314	1441	1668	0.8639089
A08	25870878	25872550	A08p28450.2_BraZ1	1392.3	+	368	1423	1672	0.8510765
A08	25874484	25883435	A08p28460.2_BraZ1	1444.48	-	5172	8567	8951	0.9570997
A08	25888636	25888795	A08p28470.2_BraZ1	15.9	+	48	87	159	0.5471698
A08	25888968	25897822	A08p28480.2_BraZ1	7178.04	+	8088	6712	8854	0.7580755
A08	25900248	25900887	A08p28490.2_BraZ1	63.9	+	6	177	639	0.2769953
A08	25902071	25902293	A08p28500.2_BraZ1	22.2	-	270	222	222	1.0000000
A08	25912424	25912887	A08p28510.2_BraZ1	381	+	400	463	463	1.0000000
A08	25913843	25914719	A08p28520.2_BraZ1	753	-	300	876	876	1.0000000
A08	25917880	25919272	A08p28530.2_BraZ1	672.75	+	1257	1392	1392	1.0000000
A08	25923229	25924039	A08p28540.2_BraZ1	81	+	270	805	810	0.9938272
A08	25926808	25927786	A08p28550.2_BraZ1	97.8	-	721	978	978	1.0000000
A08	25928215	25928614	A08p28560.2_BraZ1	39.9	-	127	326	399	0.8170426
A08	25929959	25930664	A08p28570.2_BraZ1	70.5	-	278	705	705	1.0000000
A08	25934855	25936683	A08p28580.2_BraZ1	645.643	+	968	1534	1828	0.8391685
A08	25943725	25946308	A08p28590.2_BraZ1	1257.79	+	799	2398	2583	0.9283779
A08	25947857	25952258	A08p28600.2_BraZ1	933.4	-	1383	3699	4401	0.8404908
A08	25958266	25959188	A08p28610.2_BraZ1	537	-	424	922	922	1.0000000
A08	25960728	25963990	A08p28620.2_BraZ1	1072.5	-	622	2736	3262	0.8387492
A08	25964971	25966777	A08p28630.2_BraZ1	1057.24	+	1143	1806	1806	1.0000000
A08	25967362	25970789	A08p28640.2_BraZ1	1472.56	-	1438	3069	3427	0.8955355
A08	25971441	25972101	A08p28650.2_BraZ1	381	-	447	660	660	1.0000000
A08	25973836	25976806	A08p28660.2_BraZ1	1193.78	+	1936	2964	2970	0.9979798
A08	25977122	25978958	A08p28670.2_BraZ1	588	-	822	1548	1836	0.8431373
A08	25984324	25987645	A08p28680.2_BraZ1	2301	+	1029	3287	3321	0.9897621
A08	25987950	25988058	A08p28690.2_BraZ1	10.8	-	68	108	108	1.0000000
A08	25989194	25993245	A08p28700.2_BraZ1	2011.54	+	918	3768	4051	0.9301407
A08	25993683	25997682	A08p28710.2_BraZ1	3055.2	-	996	3569	3999	0.8924731
A08	26001021	26001269	A08p28720.2_BraZ1	165	+	299	248	248	1.0000000
A08	26001858	26006220	A08p28730.2_BraZ1	2947.96	+	1049	3119	4362	0.7150390
A08	26006928	26009038	A08p28740.2_BraZ1	1266	-	469	1732	2110	0.8208531
A08	26010630	26010939	A08p28750.2_BraZ1	30.9	-	295	309	309	1.0000000
A08	26011270	26015408	A08p28760.2_BraZ1	2413.43	-	870	3493	4138	0.8441276
A08	26021116	26022241	A08p28770.2_BraZ1	688.097	-	436	1085	1125	0.9644445
A08	26029112	26040980	A08p28780.2_BraZ1	1015.61	+	4788	10139	11868	0.8543141
A08	26038480	26038888	A08p28790.2_BraZ1	40.8	-	458	408	408	1.0000000
A08	26050234	26051718	A08p28800.2_BraZ1	1110	-	437	1112	1484	0.7493262
A08	26060406	26064363	A08p28810.2_BraZ1	1176	-	730	3176	3957	0.8026283
A08	26064550	26065051	A08p28820.2_BraZ1	183	-	50	413	501	0.8243513
A08	26071909	26072855	A08p28830.2_BraZ1	86.1	-	980	946	946	1.0000000
A08	26074177	26076129	A08p28840.2_BraZ1	781.073	-	1261	1952	1952	1.0000000
A08	26077778	26079853	A08p28850.2_BraZ1	1326	-	557	1244	2075	0.5995181
A08	26083092	26084838	A08p28860.2_BraZ1	1170	+	430	1683	1746	0.9639176
A08	26087274	26087841	A08p28870.2_BraZ1	439.269	+	400	495	567	0.8730159
A08	26090209	26091717	A08p28880.2_BraZ1	74.4	+	3361	1481	1508	0.9820955
A08	26092217	26102550	A08p28890.2_BraZ1	3063.84	-	3654	8580	10333	0.8303494
A08	26103796	26104774	A08p28900.2_BraZ1	525	+	538	978	978	1.0000000
A08	26105988	26109419	A08p28910.2_BraZ1	1756.51	+	1690	3057	3431	0.8909939
A08	26109859	26110382	A08p28920.2_BraZ1	327.6	+	114	165	523	0.3154876
A08	26111019	26114725	A08p28930.2_BraZ1	2310.93	+	703	3149	3706	0.8497032
A08	26115986	26117075	A08p28940.2_BraZ1	108.9	+	126	1079	1089	0.9908172
A08	26118447	26120858	A08p28950.2_BraZ1	1654.98	-	706	2216	2411	0.9191207
A08	26121796	26123516	A08p28960.2_BraZ1	549.077	-	1172	1686	1720	0.9802325
A08	26124486	26126809	A08p28970.2_BraZ1	1234.3	+	1124	2323	2323	1.0000000
A08	26127319	26127805	A08p28980.2_BraZ1	2640	+	237	486	486	1.0000000
A08	26128362	26129668	A08p28990.2_BraZ1	973.125	-	631	1243	1306	0.9517611
A08	26130123	26131732	A08p29000.2_BraZ1	59.1	-	1207	1609	1609	1.0000000
A08	26131949	26132483	A08p29010.2_BraZ1	53.4	+	388	534	534	1.0000000
A08	26133645	26135025	A08p29020.2_BraZ1	579.229	+	646	1380	1380	1.0000000
A08	26136377	26137238	A08p29030.2_BraZ1	594	-	37	344	861	0.3995354
A08	26139220	26140418	A08p29040.2_BraZ1	393.75	+	755	1198	1198	1.0000000
A08	26141467	26142016	A08p29050.2_BraZ1	237	+	355	492	549	0.8961748
A08	26142504	26143925	A08p29060.2_BraZ1	914.25	+	211	1255	1421	0.8831809
A08	26144519	26144879	A08p29070.2_BraZ1	156	-	181	360	360	1.0000000
A08	26145748	26150185	A08p29080.2_BraZ1	23154.4	+	420	2646	4437	0.5963489
A08	26151692	26156146	A08p29090.2_BraZ1	8891.76	+	921	3109	4454	0.6980243
A08	26156275	26156771	A08p29100.2_BraZ1	252.5	+	258	496	496	1.0000000
A08	26157916	26158336	A08p29110.2_BraZ1	867.857	-	245	413	420	0.9833333
A08	26159183	26160151	A08p29120.2_BraZ1	369	+	687	968	968	1.0000000
A08	26161014	26162586	A08p29130.2_BraZ1	525	-	1154	1572	1572	1.0000000
A08	26164162	26170577	A08p29140.2_BraZ1	605.238	-	7600	6335	6415	0.9875292
A08	26176560	26179276	A08p29150.2_BraZ1	833	-	1220	2643	2716	0.9731222
A08	26180478	26181123	A08p29160.2_BraZ1	64.5	-	265	645	645	1.0000000
A08	26183080	26185616	A08p29170.2_BraZ1	1360.77	+	635	2152	2536	0.8485804
A08	26186976	26188670	A08p29180.2_BraZ1	1014	+	256	1079	1694	0.6369539
A08	26190051	26191372	A08p29190.2_BraZ1	1208.08	+	236	1174	1321	0.8887207
A08	26191997	26193280	A08p29200.2_BraZ1	1020.09	+	988	1283	1283	1.0000000
A08	26193994	26195973	A08p29210.2_BraZ1	1000.94	+	1092	1979	1979	1.0000000
A08	26196817	26199825	A08p29220.2_BraZ1	2313.88	+	2065	2808	3008	0.9335107
A08	26200545	26201621	A08p29230.2_BraZ1	477.931	-	858	1076	1076	1.0000000
A08	26201690	26213238	A08p29240.2_BraZ1	744.188	+	4998	9025	11548	0.7815206
A08	26216277	26217521	A08p29250.2_BraZ1	685.021	+	879	1244	1244	1.0000000
A08	26219792	26225950	A08p29260.2_BraZ1	3809.25	+	1775	5780	6158	0.9386165
A08	26226539	26229562	A08p29270.2_BraZ1	934.621	-	930	2769	3023	0.9159775
A08	26231249	26235665	A08p29280.2_BraZ1	2220.92	-	1127	3374	4416	0.7640399
A08	26238164	26238518	A08p29290.2_BraZ1	35.4	+	11	169	354	0.4774011
A08	26242897	26244166	A08p29300.2_BraZ1	126.9	+	225	1191	1269	0.9385343
A08	26249125	26249878	A08p29310.2_BraZ1	171	+	241	721	753	0.9575033
A08	26249974	26250355	A08p29320.2_BraZ1	213	+	379	381	381	1.0000000
A08	26250743	26251151	A08p29330.2_BraZ1	40.8	+	295	400	408	0.9803922
A08	26252129	26252390	A08p29340.2_BraZ1	26.1	-	134	261	261	1.0000000
A08	26253872	26254127	A08p29350.2_BraZ1	25.5	-	8	86	255	0.3372549
A08	26256072	26256978	A08p29360.2_BraZ1	90.6	-	534	906	906	1.0000000
A08	26266441	26266663	A08p29370.2_BraZ1	22.2	+	299	222	222	1.0000000
A08	26267700	26268714	A08p29380.2_BraZ1	564	-	956	1014	1014	1.0000000
A08	26268682	26269004	A08p29390.2_BraZ1	207	-	483	322	322	1.0000000
A08	26270027	26270663	A08p29400.2_BraZ1	63.6	-	74	262	636	0.4119497
A08	26282773	26295256	A08p29410.2_BraZ1	4327.2	+	3681	9972	12483	0.7988464
A08	26298617	26300377	A08p29420.2_BraZ1	652.47	+	467	1461	1760	0.8301136
A08	26301157	26305985	A08p29430.2_BraZ1	1510.61	-	424	2833	4828	0.5867854
A08	26304419	26305352	A08p29440.2_BraZ1	337.5	-	0	0	933	0.0000000
A08	26310742	26313106	A08p29450.2_BraZ1	888.069	+	1116	2292	2364	0.9695432
A08	26314003	26315850	A08p29460.2_BraZ1	726	-	1462	1847	1847	1.0000000
A08	26320753	26322856	A08p29470.2_BraZ1	3411	+	784	1640	2103	0.7798383
A08	26325055	26326448	A08p29480.2_BraZ1	687.946	-	1106	1393	1393	1.0000000
A08	26327961	26328954	A08p29490.2_BraZ1	99.3	-	281	973	993	0.9798590
A08	26330698	26331160	A08p29500.2_BraZ1	201	+	107	443	462	0.9588745
A08	26333891	26335798	A08p29510.2_BraZ1	1156.28	+	550	1844	1907	0.9669638
A08	26336774	26338482	A08p29520.2_BraZ1	933.12	+	658	1708	1708	1.0000000
A08	26339379	26340999	A08p29530.2_BraZ1	1065.7	+	97	672	1620	0.4148148
A08	26341333	26342275	A08p29540.2_BraZ1	249.321	+	266	877	942	0.9309978
A08	26343159	26343366	A08p29550.2_BraZ1	20.7	-	350	207	207	1.0000000
A08	26343982	26344429	A08p29560.2_BraZ1	44.7	+	4	183	447	0.4093960
A08	26346160	26346943	A08p29570.2_BraZ1	78.3	+	538	783	783	1.0000000
A08	26349788	26351540	A08p29580.2_BraZ1	1024.14	-	910	1300	1752	0.7420091
A08	26353524	26356678	A08p29590.2_BraZ1	1695.43	-	664	1770	3154	0.5611922
A08	26366534	26368259	A08p29600.2_BraZ1	276	+	714	1725	1725	1.0000000
A08	26375802	26376581	A08p29610.2_BraZ1	699	+	524	779	779	1.0000000
A08	26378701	26381062	A08p29620.2_BraZ1	236.1	-	345	2142	2361	0.9072427
A08	26381364	26382395	A08p29630.2_BraZ1	555.5	+	486	1031	1031	1.0000000
A08	26382534	26384469	A08p29640.2_BraZ1	469.222	+	232	1893	1935	0.9782946
A08	26387105	26388630	A08p29650.2_BraZ1	675	+	642	1443	1525	0.9462295
A08	26391277	26392935	A08p29660.2_BraZ1	6484.5	-	135	722	1658	0.4354644
A08	26396037	26398512	A08p29670.2_BraZ1	1621.2	+	897	2207	2475	0.8917172
A08	26401162	26415878	A08p29680.2_BraZ1	1267.44	+	7394	14165	14716	0.9625577
A08	26405929	26408082	A08p29690.2_BraZ1	1370.53	-	759	1808	2153	0.8397585
A08	26411064	26412513	A08p29700.2_BraZ1	144.9	-	115	1254	1449	0.8654245
A08	26416712	26420085	A08p29710.2_BraZ1	1200.5	-	942	2453	3373	0.7272457
A08	26422614	26427400	A08p29720.2_BraZ1	1477.77	-	2090	4661	4786	0.9738821
A08	26429991	26431071	A08p29730.2_BraZ1	108	-	193	920	1080	0.8518519
A08	26451171	26453065	A08p29740.2_BraZ1	1611	+	54	753	1894	0.3975713
A08	26453781	26455997	A08p29750.2_BraZ1	1144.28	+	463	1743	2216	0.7865524
A08	26459629	26461480	A08p29760.2_BraZ1	185.1	+	645	1737	1851	0.9384117
A08	26461741	26463690	A08p29770.2_BraZ1	638.029	-	1089	1949	1949	1.0000000
A08	26464314	26466232	A08p29780.2_BraZ1	1278.41	+	480	1820	1918	0.9489051
A08	26466304	26467685	A08p29790.2_BraZ1	657	-	489	1354	1381	0.9804490
A08	26468150	26470952	A08p29800.2_BraZ1	1354.65	-	539	1969	2802	0.7027124
A08	26471860	26474280	A08p29810.2_BraZ1	1204.36	-	673	2045	2420	0.8450413
A08	26475288	26475648	A08p29820.2_BraZ1	36	-	119	360	360	1.0000000
A08	26476490	26478605	A08p29830.2_BraZ1	628.714	-	1273	2054	2115	0.9711584
A08	26480544	26483913	A08p29840.2_BraZ1	1527.91	-	1365	3319	3369	0.9851588
A08	26487063	26488599	A08p29850.2_BraZ1	501.757	-	206	1013	1536	0.6595052
A08	26491785	26493222	A08p29860.2_BraZ1	841.043	-	487	1405	1437	0.9777314
A08	26495879	26496331	A08p29870.2_BraZ1	423	+	210	452	452	1.0000000
A08	26498728	26499319	A08p29880.2_BraZ1	59.1	+	153	587	591	0.9932318
A08	26499470	26499800	A08p29890.2_BraZ1	33	+	273	330	330	1.0000000
A08	26502901	26504500	A08p29900.2_BraZ1	159.9	+	66082	1599	1599	1.0000000
A08	26512331	26514188	A08p29910.2_BraZ1	185.7	-	380	1710	1857	0.9208401
A08	26520363	26520639	A08p29920.2_BraZ1	15	-	30	215	276	0.7789855
A08	26520728	26523965	A08p29930.2_BraZ1	595.406	-	144	1037	3237	0.3203584
A08	26527126	26529831	A08p29940.2_BraZ1	1215	-	558	2127	2705	0.7863216
A08	26530982	26533997	A08p29950.2_BraZ1	1459.91	-	3216	2866	3015	0.9505804
A08	26614175	26615771	A08p29960.2_BraZ1	159.6	-	215	805	1596	0.5043859
A08	26620567	26625567	A08p29970.2_BraZ1	2616.23	+	772	3074	5000	0.6148000
A08	26627500	26629081	A08p29980.2_BraZ1	158.1	-	589	1029	1581	0.6508539
A08	26633511	26634844	A08p29990.2_BraZ1	635.06	-	65	811	1333	0.6084021
A08	26635558	26636206	A08p30000.2_BraZ1	492	-	208	609	648	0.9398148
A08	26637026	26637413	A08p30010.2_BraZ1	38.7	+	201	387	387	1.0000000
A08	26637844	26638238	A08p30020.2_BraZ1	31.8	-	1	39	394	0.0989848
A08	26638998	26639851	A08p30030.2_BraZ1	42.9	+	838	853	853	1.0000000
A08	26643320	26646701	A08p30040.2_BraZ1	1371.85	+	2878	3381	3381	1.0000000
A08	26648300	26649621	A08p30050.2_BraZ1	1224	+	945	1321	1321	1.0000000
A08	26650879	26652049	A08p30060.2_BraZ1	1071	+	582	1170	1170	1.0000000
A08	26653680	26654148	A08p30070.2_BraZ1	46.8	+	555	456	468	0.9743590
A08	26654215	26654363	A08p30080.2_BraZ1	12.9	+	296	148	148	1.0000000
A08	26656048	26657320	A08p30090.2_BraZ1	127.2	+	653	1272	1272	1.0000000
A08	26657715	26659544	A08p30100.2_BraZ1	1530	-	1501	1829	1829	1.0000000
A08	26663254	26664278	A08p30110.2_BraZ1	445.424	+	440	1024	1024	1.0000000
A08	26665213	26666419	A08p30120.2_BraZ1	605.909	-	700	1206	1206	1.0000000
A08	26670208	26673661	A08p30130.2_BraZ1	1665.88	+	1209	2976	3453	0.8618593
A08	26683094	26684481	A08p30140.2_BraZ1	1044.87	+	643	1321	1387	0.9524153
A08	26686978	26688320	A08p30150.2_BraZ1	1008	-	1212	1342	1342	1.0000000
A08	26689003	26689901	A08p30160.2_BraZ1	280.8	-	1751	898	898	1.0000000
A08	26691635	26692085	A08p30170.2_BraZ1	45	+	95	409	450	0.9088889
A08	26693864	26694356	A08p30180.2_BraZ1	49.2	+	2	157	492	0.3191057
A08	26696778	26698573	A08p30190.2_BraZ1	1272.87	+	1188	1610	1795	0.8969359
A08	26698849	26700142	A08p30200.2_BraZ1	610.393	-	1091	1293	1293	1.0000000
A08	26702687	26705152	A08p30210.2_BraZ1	12853.5	+	327	1997	2465	0.8101420
A08	26705963	26707673	A08p30220.2_BraZ1	820.455	+	1240	1710	1710	1.0000000
A08	26708354	26710978	A08p30230.2_BraZ1	1753.23	-	1479	2618	2624	0.9977134
A08	26722511	26724561	A08p30240.2_BraZ1	1022.17	+	1512	1710	2050	0.8341463
A08	26725429	26726222	A08p30250.2_BraZ1	365.297	-	797	793	793	1.0000000
A08	26734026	26734542	A08p30260.2_BraZ1	51.6	+	300	516	516	1.0000000
A08	26737824	26739105	A08p30270.2_BraZ1	128.1	-	143	815	1281	0.6362217
A08	26746462	26747920	A08p30280.2_BraZ1	613.648	+	645	1424	1458	0.9766804
A08	26754163	26755315	A08p30290.2_BraZ1	510	+	273	1059	1152	0.9192708
A08	26759786	26760774	A08p30300.2_BraZ1	1053	+	644	979	988	0.9908907
A08	26764550	26766799	A08p30310.2_BraZ1	1179.39	+	860	2226	2249	0.9897732
A08	26770238	26772156	A08p30320.2_BraZ1	861.867	+	708	1822	1918	0.9499478
A08	26774559	26776210	A08p30330.2_BraZ1	10567.8	+	658	1315	1651	0.7964870
A08	26778063	26779677	A08p30340.2_BraZ1	978.714	+	680	1557	1614	0.9646840
A08	26780119	26781973	A08p30350.2_BraZ1	1157.1	-	948	1831	1854	0.9875944
A08	26783544	26788877	A08p30360.2_BraZ1	1436.84	-	2909	5239	5333	0.9823739
A08	26800422	26808333	A08p30370.2_BraZ1	54015	+	3287	5976	7911	0.7554039
A08	26802119	26803682	A08p30380.2_BraZ1	999	-	184	368	1563	0.2354447
A08	26804114	26804606	A08p30390.2_BraZ1	49.2	-	301	492	492	1.0000000
A08	26809339	26811022	A08p30400.2_BraZ1	168.3	-	510	1410	1683	0.8377897
A08	26814015	26815860	A08p30410.2_BraZ1	7008	-	1475	1842	1845	0.9983740
A08	26818727	26819352	A08p30420.2_BraZ1	376.071	+	185	587	625	0.9392000
A08	26820847	26821337	A08p30430.2_BraZ1	387.429	-	220	329	490	0.6714286
A08	26825236	26825828	A08p30440.2_BraZ1	738	+	418	592	592	1.0000000
A08	26825784	26827260	A08p30450.2_BraZ1	1357.63	+	1500	1476	1476	1.0000000
A08	26827888	26828470	A08p30460.2_BraZ1	276	+	26	432	582	0.7422680
A08	26830473	26831032	A08p30470.2_BraZ1	585	-	1230	559	559	1.0000000
A08	26832629	26834452	A08p30480.2_BraZ1	575.75	+	1638	1802	1823	0.9884805
A08	26835924	26836341	A08p30490.2_BraZ1	41.7	+	517	417	417	1.0000000
A08	26838179	26838556	A08p30500.2_BraZ1	204	-	322	377	377	1.0000000
A08	26851565	26852430	A08p30510.2_BraZ1	606.375	+	342	811	865	0.9375722
A08	26856174	26867539	A08p30520.2_BraZ1	107.7	+	3610	9185	11365	0.8081830
A08	26868275	26868735	A08p30530.2_BraZ1	369	+	16	90	460	0.1956522
A08	26871095	26871546	A08p30540.2_BraZ1	360	+	75	446	451	0.9889135
A08	26873556	26873871	A08p30550.2_BraZ1	31.5	+	168	315	315	1.0000000
A08	26874859	26875861	A08p30560.2_BraZ1	100.2	+	584	1002	1002	1.0000000
A08	26877427	26880379	A08p30570.2_BraZ1	2607	-	1102	2952	2952	1.0000000
A08	26880625	26880733	A08p30580.2_BraZ1	10.8	-	116	108	108	1.0000000
A08	26885048	26887100	A08p30590.2_BraZ1	845.416	-	1455	2052	2052	1.0000000
A08	26889522	26892014	A08p30600.2_BraZ1	1426.87	+	974	2460	2492	0.9871589
A08	26892284	26894168	A08p30610.2_BraZ1	1385.57	-	1428	1884	1884	1.0000000
A08	26895190	26895918	A08p30620.2_BraZ1	645	+	657	728	728	1.0000000
A08	26896498	26899352	A08p30630.2_BraZ1	2037	-	9717	2807	2854	0.9835319
A08	26903935	26915133	A08p30640.2_BraZ1	1621.01	+	5832	9216	11198	0.8230041
A08	26906866	26907788	A08p30650.2_BraZ1	516	-	49	740	922	0.8026031
A08	26908988	26910003	A08p30660.2_BraZ1	5502	-	8	486	1015	0.4788177
A08	26915691	26916945	A08p30670.2_BraZ1	828	+	318	1157	1254	0.9226475
A08	26917167	26917670	A08p30680.2_BraZ1	123.632	+	314	471	503	0.9363817
A08	26918043	26918503	A08p30690.2_BraZ1	300	-	772	460	460	1.0000000
A08	26919887	26935806	A08p30700.2_BraZ1	1037.79	+	5537	12163	15919	0.7640556
A08	26926459	26926983	A08p30710.2_BraZ1	330	+	10	20	524	0.0381679
A08	26937524	26940291	A08p30720.2_BraZ1	1877.14	+	1904	2767	2767	1.0000000
A08	26940692	26941250	A08p30730.2_BraZ1	55.8	-	418	558	558	1.0000000
A08	26945346	26948490	A08p30740.2_BraZ1	1207.9	-	1616	3121	3144	0.9926845
A08	26948490	26948754	A08p30750.2_BraZ1	234	-	194	264	264	1.0000000
A08	26951054	26951758	A08p30760.2_BraZ1	636	-	6	217	704	0.3082386
A08	26964366	26970502	A08p30770.2_BraZ1	914.185	+	1926	5071	6136	0.8264341
A08	26972016	26973498	A08p30780.2_BraZ1	693.433	+	1639	1482	1482	1.0000000
A08	26974417	26990380	A08p30790.2_BraZ1	11165.9	+	7465	14144	15963	0.8860490
A08	26978887	26981371	A08p30800.2_BraZ1	1205.23	+	640	2287	2484	0.9206924
A08	26982286	26984709	A08p30810.2_BraZ1	1333.45	+	628	2244	2423	0.9261246
A08	26990508	26995175	A08p30820.2_BraZ1	317.625	-	4369	4667	4667	1.0000000
A08	26993473	26993887	A08p30830.2_BraZ1	252	-	387	414	414	1.0000000
A08	26997664	26999082	A08p30840.2_BraZ1	8824.5	+	1375	1418	1418	1.0000000
A08	26999519	27000832	A08p30850.2_BraZ1	399	-	532	1311	1313	0.9984767
A08	27001403	27005283	A08p30860.2_BraZ1	1639.03	-	662	3382	3880	0.8716495
A08	27006239	27014056	A08p30870.2_BraZ1	2792.5	-	5206	7737	7817	0.9897659
A08	27015236	27015760	A08p30880.2_BraZ1	447	-	326	524	524	1.0000000
A08	27016515	27016829	A08p30890.2_BraZ1	24.6	-	252	314	314	1.0000000
A08	27018313	27018912	A08p30900.2_BraZ1	441	-	530	599	599	1.0000000
A08	27019718	27020285	A08p30910.2_BraZ1	486	-	593	567	567	1.0000000
A08	27021189	27021713	A08p30920.2_BraZ1	230.526	-	320	524	524	1.0000000
A08	27023497	27024244	A08p30930.2_BraZ1	474	-	1008	747	747	1.0000000
A08	27027301	27029814	A08p30940.2_BraZ1	1737.45	+	916	2366	2513	0.9415042
A08	27035598	27036075	A08p30950.2_BraZ1	47.7	+	171	456	477	0.9559748
A08	27039956	27043137	A08p30960.2_BraZ1	1101.22	+	1001	3177	3181	0.9987425
A08	27045016	27045858	A08p30970.2_BraZ1	438	-	571	842	842	1.0000000
A08	27047375	27050921	A08p30980.2_BraZ1	2077.78	-	1850	3499	3546	0.9867457
A08	27053426	27053863	A08p30990.2_BraZ1	174	+	2188	437	437	1.0000000
A08	27054625	27055042	A08p31000.2_BraZ1	41.7	-	414	417	417	1.0000000
A08	27059459	27062608	A08p31010.2_BraZ1	1927.64	-	599	1433	3149	0.4550651
A08	27066686	27069619	A08p31020.2_BraZ1	651.633	-	1130	1949	2933	0.6645073
A08	27076612	27081289	A08p31030.2_BraZ1	2207.04	+	1437	4367	4677	0.9337182
A08	27083885	27084062	A08p31040.2_BraZ1	17.7	+	0	0	177	0.0000000
A08	27088195	27090516	A08p31050.2_BraZ1	1723.25	+	238	1242	2321	0.5351142
A08	27092834	27093291	A08p31060.2_BraZ1	348	+	167	457	457	1.0000000
A08	27102397	27104271	A08p31070.2_BraZ1	909	+	318	1285	1874	0.6856990
A08	27106142	27109574	A08p31080.2_BraZ1	1232.07	-	2286	3323	3432	0.9682401
A08	27110703	27111692	A08p31090.2_BraZ1	912	+	354	989	989	1.0000000
A08	27112116	27113480	A08p31100.2_BraZ1	780	-	286	1159	1364	0.8497068
A08	27118072	27118968	A08p31110.2_BraZ1	552	-	576	727	896	0.8113839
A08	27119928	27122144	A08p31120.2_BraZ1	1554	-	811	1821	2216	0.8217509
A08	27126635	27128255	A08p31130.2_BraZ1	1443	+	1071	1620	1620	1.0000000
A08	27132142	27133334	A08p31140.2_BraZ1	796.923	-	500	1192	1192	1.0000000
A08	27138333	27140096	A08p31150.2_BraZ1	9630	-	1421	1763	1763	1.0000000
A08	27142798	27147899	A08p31160.2_BraZ1	1408.75	+	2141	5075	5101	0.9949030
A08	27148643	27150036	A08p31170.2_BraZ1	760	+	62	574	1393	0.4120603
A08	27157503	27163410	A08p31180.2_BraZ1	1298.36	+	2789	4678	5907	0.7919418
A08	27163843	27165457	A08p31190.2_BraZ1	1073	-	482	1181	1614	0.7317224
A08	27168720	27169585	A08p31200.2_BraZ1	275.625	-	179	843	865	0.9745665
A08	27170585	27172079	A08p31210.2_BraZ1	305.143	+	1036	1465	1494	0.9805890
A08	27180492	27181861	A08p31220.2_BraZ1	990	+	54	1012	1369	0.7392257
A08	27184143	27186086	A08p31230.2_BraZ1	1700.81	-	282	1588	1943	0.8172929
A08	27187487	27189812	A08p31240.2_BraZ1	1127.1	+	49	987	2325	0.4245161
A08	27192105	27192993	A08p31250.2_BraZ1	88.8	+	353	797	888	0.8975225
A08	27194586	27195546	A08p31260.2_BraZ1	96	+	620	960	960	1.0000000
A08	27204198	27207339	A08p31270.2_BraZ1	2041.93	-	614	2965	3141	0.9439669
A08	27214299	27214838	A08p31280.2_BraZ1	474	+	327	539	539	1.0000000
A08	27215425	27215905	A08p31290.2_BraZ1	48	+	65	372	480	0.7750000
A08	27219443	27220877	A08p31300.2_BraZ1	1275	+	180	1169	1434	0.8152022
A08	27227040	27227673	A08p31310.2_BraZ1	63.3	-	31	247	633	0.3902054
A08	27230648	27231581	A08p31320.2_BraZ1	623.2	+	612	933	933	1.0000000
A08	27232352	27234266	A08p31330.2_BraZ1	1245	-	1482	1914	1914	1.0000000
A08	27235202	27236753	A08p31340.2_BraZ1	989	-	712	1538	1551	0.9916183
A08	27240794	27242035	A08p31350.2_BraZ1	606	+	705	1042	1241	0.8396454
A08	27242327	27242544	A08p31360.2_BraZ1	204	+	69	217	217	1.0000000
A08	27244943	27245293	A08p31370.2_BraZ1	324	+	95	350	350	1.0000000
A08	27245615	27248225	A08p31380.2_BraZ1	1448.71	-	640	2255	2610	0.8639847
A08	27250228	27255285	A08p31390.2_BraZ1	2149.88	-	1326	4708	5057	0.9309868
A08	27255285	27255607	A08p31400.2_BraZ1	237	-	78	322	322	1.0000000
A08	27255963	27256632	A08p31410.2_BraZ1	633	-	18	314	669	0.4693573
A08	27257946	27259300	A08p31420.2_BraZ1	669.404	-	443	1223	1354	0.9032496
A08	27263473	27266820	A08p31430.2_BraZ1	2191.75	+	1519	3169	3347	0.9468181
A08	27268211	27271199	A08p31440.2_BraZ1	1027.2	+	26	669	2988	0.2238956
A08	27273631	27276181	A08p31450.2_BraZ1	1001.12	-	1470	2439	2550	0.9564706
A08	27277106	27278113	A08p31460.2_BraZ1	330	-	758	1007	1007	1.0000000
A08	27278623	27285635	A08p31470.2_BraZ1	2810.28	+	2798	6822	7012	0.9729036
A08	27289329	27295020	A08p31480.2_BraZ1	3130.62	-	1832	5374	5691	0.9442980
A08	27295644	27301860	A08p31490.2_BraZ1	388.421	+	4679	6177	6216	0.9937259
A08	27303536	27306362	A08p31500.2_BraZ1	1986.57	+	689	2658	2826	0.9405520
A08	27307165	27327292	A08p31510.2_BraZ1	4352.53	+	16500	19853	20127	0.9863864
A08	27327768	27330004	A08p31520.2_BraZ1	1308.24	+	837	2188	2236	0.9785331
A08	27332727	27334051	A08p31530.2_BraZ1	726.455	+	1016	1324	1324	1.0000000
A08	27334944	27336837	A08p31540.2_BraZ1	14157	-	1642	1893	1893	1.0000000
A08	27338469	27341859	A08p31550.2_BraZ1	1267.66	-	1477	3254	3390	0.9598820
A08	27344224	27345867	A08p31560.2_BraZ1	155.4	+	351	1606	1643	0.9774802
A08	27346131	27346591	A08p31570.2_BraZ1	375	+	307	460	460	1.0000000
A08	27346948	27355751	A08p31580.2_BraZ1	3365.72	-	2310	8298	8803	0.9426332
A08	27363411	27364113	A08p31590.2_BraZ1	70.2	+	433	702	702	1.0000000
A08	27364690	27367257	A08p31600.2_BraZ1	3704.5	-	1956	2567	2567	1.0000000
A08	27372530	27373364	A08p31610.2_BraZ1	504	+	497	834	834	1.0000000
A08	27373562	27376166	A08p31620.2_BraZ1	954	-	966	2578	2604	0.9900154
A08	27376849	27377582	A08p31630.2_BraZ1	207	+	44	528	733	0.7203274
A08	27380709	27383120	A08p31640.2_BraZ1	2061.43	-	1056	2381	2411	0.9875571
A08	27384966	27385074	A08p31650.2_BraZ1	10.8	+	167	108	108	1.0000000
A08	27386450	27387602	A08p31660.2_BraZ1	115.2	-	352	900	1152	0.7812500
A08	27389315	27393371	A08p31670.2_BraZ1	2886	+	3136	3975	4056	0.9800296
A08	27394784	27395387	A08p31680.2_BraZ1	60.3	-	74	289	603	0.4792703
A08	27398587	27399912	A08p31690.2_BraZ1	112.5	+	760	1309	1325	0.9879245
A08	27403500	27405026	A08p31700.2_BraZ1	963.692	+	361	1394	1526	0.9134994
A08	27406752	27409866	A08p31710.2_BraZ1	942.419	+	1357	2900	3114	0.9312781
A08	27411068	27413351	A08p31720.2_BraZ1	487.143	+	678	2224	2283	0.9741568
A08	27414386	27415891	A08p31730.2_BraZ1	1013.23	+	437	1484	1505	0.9860465
A08	27416344	27417574	A08p31740.2_BraZ1	461.276	-	1177	1230	1230	1.0000000
A08	27420289	27421042	A08p31750.2_BraZ1	75.3	-	24	194	753	0.2576361
A08	27427775	27428408	A08p31760.2_BraZ1	63.3	-	171	630	633	0.9952607
A08	27432919	27433911	A08p31770.2_BraZ1	8572.5	-	84	657	992	0.6622984
A08	27437065	27440752	A08p31780.2_BraZ1	1446.47	+	1800	3559	3687	0.9652835
A08	27441076	27441241	A08p31790.2_BraZ1	16.5	+	330	165	165	1.0000000
A08	27441391	27444501	A08p31800.2_BraZ1	1042.75	+	1891	3062	3110	0.9845659
A08	27447763	27448699	A08p31810.2_BraZ1	93.6	-	673	936	936	1.0000000
A08	27455788	27456198	A08p31820.2_BraZ1	264	-	1	113	410	0.2756098
A08	27462673	27464990	A08p31830.2_BraZ1	522	+	1503	1606	2317	0.6931377
A08	27465912	27468727	A08p31840.2_BraZ1	16890	+	778	1703	2815	0.6049734
A08	27469067	27470319	A08p31850.2_BraZ1	1002.21	-	482	1252	1252	1.0000000
A08	27475895	27478666	A08p31860.2_BraZ1	2181	+	1110	2770	2771	0.9996391
A08	27481826	27482420	A08p31870.2_BraZ1	59.4	-	85	594	594	1.0000000
A08	27486147	27486790	A08p31880.2_BraZ1	294	-	504	643	643	1.0000000
A08	27488743	27489232	A08p31890.2_BraZ1	48.9	+	490	489	489	1.0000000
A08	27490627	27491764	A08p31900.2_BraZ1	113.7	+	914	1137	1137	1.0000000
A08	27493013	27496475	A08p31910.2_BraZ1	2339.02	-	1297	3245	3462	0.9373195
A08	27497697	27498760	A08p31920.2_BraZ1	588	+	594	1063	1063	1.0000000
A08	27499084	27505485	A08p31930.2_BraZ1	2583.64	-	4355	6340	6401	0.9904702
A08	27508303	27511630	A08p31940.2_BraZ1	1902	+	877	2964	3327	0.8908927
A08	27514597	27516140	A08p31950.2_BraZ1	899.64	+	663	1391	1543	0.9014906
A08	27516853	27519904	A08p31960.2_BraZ1	1805.5	-	615	1791	3051	0.5870206
A08	27523715	27525887	A08p31970.2_BraZ1	1451.63	-	1007	2103	2172	0.9682320
A08	27532014	27533957	A08p31980.2_BraZ1	1131.74	+	228	1456	1943	0.7493567
A08	27536728	27537424	A08p31990.2_BraZ1	69.6	+	22	377	696	0.5416667
A08	27538237	27540348	A08p32000.2_BraZ1	1561.27	+	1224	1834	2111	0.8687826
A08	27542267	27544673	A08p32010.2_BraZ1	1248.07	+	1505	2395	2406	0.9954281
A08	27545564	27547626	A08p32020.2_BraZ1	911.419	+	582	1841	2062	0.8928225
A08	27548957	27550892	A08p32030.2_BraZ1	1775.42	+	409	1708	1935	0.8826873
A08	27551075	27551720	A08p32040.2_BraZ1	64.5	-	269	645	645	1.0000000
A08	27554147	27554801	A08p32050.2_BraZ1	65.4	-	110	654	654	1.0000000
A08	27555880	27556504	A08p32060.2_BraZ1	62.4	-	233	564	624	0.9038461
A08	27558824	27559471	A08p32070.2_BraZ1	49.8	+	320	647	647	1.0000000
A08	27560792	27562214	A08p32080.2_BraZ1	812.562	+	633	1355	1422	0.9528832
A08	27563049	27565027	A08p32090.2_BraZ1	878.344	-	1240	1978	1978	1.0000000
A08	27566088	27570471	A08p32100.2_BraZ1	976.628	+	3196	4339	4383	0.9899612
A08	27571741	27573018	A08p32110.2_BraZ1	75.9	+	54	793	1277	0.6209867
A08	27573434	27574018	A08p32120.2_BraZ1	163.875	+	241	584	584	1.0000000
A08	27575341	27576768	A08p32130.2_BraZ1	1179	-	170	1260	1427	0.8829713
A08	27579890	27581944	A08p32140.2_BraZ1	1118	-	296	1163	2054	0.5662123
A08	27582567	27585470	A08p32150.2_BraZ1	1393.79	-	2945	2891	2903	0.9958664
A08	27586349	27587454	A08p32160.2_BraZ1	568.356	-	980	1105	1105	1.0000000
A08	27588804	27591513	A08p32170.2_BraZ1	1642.86	-	982	2706	2709	0.9988926
A08	27593371	27593940	A08p32180.2_BraZ1	52.5	+	367	569	569	1.0000000
A08	27595304	27597183	A08p32190.2_BraZ1	969.525	-	1318	1850	1879	0.9845663
A08	27597737	27599061	A08p32200.2_BraZ1	993	-	1180	1324	1324	1.0000000
A08	27601048	27602487	A08p32210.2_BraZ1	762.026	+	84	480	1439	0.3335650
A08	27604513	27604936	A08p32220.2_BraZ1	42.3	-	35	164	423	0.3877068
A08	27606751	27606937	A08p32230.2_BraZ1	18.6	-	16	153	186	0.8225806
A08	27607811	27609215	A08p32240.2_BraZ1	780.327	-	1269	1404	1404	1.0000000
A08	27611449	27613551	A08p32250.2_BraZ1	1452	+	682	1957	2102	0.9310181
A08	27617939	27619583	A08p32260.2_BraZ1	164.4	+	236	1031	1644	0.6271290
A08	27622808	27625631	A08p32270.2_BraZ1	1769.38	+	2177	2823	2823	1.0000000
A08	27627030	27629459	A08p32280.2_BraZ1	1203.6	+	1605	2274	2429	0.9361877
A08	27629919	27633331	A08p32290.2_BraZ1	2301.82	-	1414	3297	3412	0.9662954
A08	27645908	27646349	A08p32300.2_BraZ1	44.1	+	33	325	441	0.7369614
A08	27662507	27665353	A08p32310.2_BraZ1	2367.45	+	1071	2780	2846	0.9768096
A08	27665446	27669770	A08p32320.2_BraZ1	1542.5	-	2211	3998	4324	0.9246069
A08	27670466	27675579	A08p32330.2_BraZ1	1535.91	+	927	3755	5113	0.7344025
A08	27677878	27687534	A08p32340.2_BraZ1	1187.73	+	2244	6797	9656	0.7039146
A08	27688854	27691533	A08p32350.2_BraZ1	1315.04	+	675	2426	2679	0.9055618
A08	27692019	27692286	A08p32360.2_BraZ1	26.7	+	847	267	267	1.0000000
A08	27697697	27698570	A08p32370.2_BraZ1	87.3	-	193	872	873	0.9988545
A08	27700602	27701118	A08p32380.2_BraZ1	288	+	506	447	516	0.8662791
A08	27701798	27703803	A08p32390.2_BraZ1	790.86	-	689	1718	2005	0.8568578
A08	27704509	27705501	A08p32400.2_BraZ1	633	+	463	992	992	1.0000000
A08	27706259	27706505	A08p32410.2_BraZ1	24.6	+	146	246	246	1.0000000
A08	27707178	27711667	A08p32420.2_BraZ1	2392	-	3370	4486	4489	0.9993317
A08	27712858	27713319	A08p32430.2_BraZ1	370	+	540	461	461	1.0000000
A08	27713302	27715438	A08p32440.2_BraZ1	1789.3	+	2499	2136	2136	1.0000000
A08	27716995	27717533	A08p32450.2_BraZ1	450	-	311	538	538	1.0000000
A08	27719755	27721089	A08p32460.2_BraZ1	1269	+	212	1248	1334	0.9355322
A08	27721573	27722795	A08p32470.2_BraZ1	7260	-	246	1129	1222	0.9238952
A08	27723881	27724226	A08p32480.2_BraZ1	282	-	91	345	345	1.0000000
A08	27731292	27733693	A08p32490.2_BraZ1	594.415	+	2149	2387	2401	0.9941691
A08	27734573	27737007	A08p32500.2_BraZ1	7936	-	7	130	2434	0.0534100
A08	27735842	27736286	A08p32510.2_BraZ1	44.4	+	0	0	444	0.0000000
A08	27740792	27741709	A08p32520.2_BraZ1	7936	-	25	91	917	0.0992366
A08	27746731	27747787	A08p32530.2_BraZ1	105.6	+	112	850	1056	0.8049242
A08	27750181	27752839	A08p32540.2_BraZ1	265.8	-	1026	2658	2658	1.0000000
A08	27753951	27756185	A08p32550.2_BraZ1	1453.71	-	514	2116	2234	0.9471800
A08	27762758	27765375	A08p32560.2_BraZ1	1449.72	+	180	1557	2617	0.5949560
A08	27771592	27772135	A08p32570.2_BraZ1	54.3	-	621	543	543	1.0000000
A08	27774367	27778561	A08p32580.2_BraZ1	3014.38	+	3464	4174	4194	0.9952313
A08	27779273	27786920	A08p32590.2_BraZ1	2595	+	43167	5507	7647	0.7201517
A08	27784960	27785366	A08p32600.2_BraZ1	309	+	317	388	406	0.9556651
A08	27787755	27788733	A08p32610.2_BraZ1	97.8	-	402	753	978	0.7699386
A08	27789779	27790904	A08p32620.2_BraZ1	879.048	-	106	971	1125	0.8631111
A08	27795624	27798176	A08p32630.2_BraZ1	1454.73	-	551	2457	2552	0.9627743
A08	27799348	27800226	A08p32640.2_BraZ1	804	-	139	804	878	0.9157175
A08	27800698	27802003	A08p32650.2_BraZ1	881.4	+	1021	1305	1305	1.0000000
A08	27802428	27803368	A08p32660.2_BraZ1	580.5	+	178	940	940	1.0000000
A08	27804577	27807694	A08p32670.2_BraZ1	1367.04	-	1537	3112	3117	0.9983959
A08	27813640	27813823	A08p32680.2_BraZ1	18.3	+	0	0	183	0.0000000
A08	27815381	27816484	A08p32690.2_BraZ1	592.8	+	136	1074	1103	0.9737081
A08	27819576	27820248	A08p32700.2_BraZ1	67.2	+	263	584	672	0.8690476
A08	27820990	27821215	A08p32710.2_BraZ1	22.5	-	410	225	225	1.0000000
A08	27823373	27823975	A08p32720.2_BraZ1	264	-	365	602	602	1.0000000
A08	27825525	27826763	A08p32730.2_BraZ1	838.5	-	749	1165	1238	0.9410339
A08	27831361	27832649	A08p32740.2_BraZ1	767.419	+	424	1242	1288	0.9642857
A08	27837789	27838887	A08p32750.2_BraZ1	93.6	-	501	1098	1098	1.0000000
A08	27839883	27843985	A08p32760.2_BraZ1	2227.83	-	1707	3941	4102	0.9607509
A08	27845451	27847907	A08p32770.2_BraZ1	2370	-	1081	2243	2456	0.9132736
A08	27848914	27856580	A08p32780.2_BraZ1	2265.79	-	4029	7395	7666	0.9646491
A08	27857501	27860145	A08p32790.2_BraZ1	9558	-	189	1777	2644	0.6720877
A08	27872480	27872834	A08p32800.2_BraZ1	21	+	250	354	354	1.0000000
A08	27873743	27876282	A08p32810.2_BraZ1	1208.33	+	2063	2487	2539	0.9795195
A08	27877536	27877824	A08p32820.2_BraZ1	28.8	+	510	288	288	1.0000000
A08	27880111	27880378	A08p32830.2_BraZ1	26.7	+	239	267	267	1.0000000
A08	27882861	27887477	A08p32840.2_BraZ1	1915.71	-	1318	3669	4616	0.7948440
A08	27890325	27891411	A08p32850.2_BraZ1	108.6	+	1324	1086	1086	1.0000000
A08	27893605	27898141	A08p32860.2_BraZ1	950.697	+	2149	4251	4536	0.9371693
A08	27899151	27899577	A08p32870.2_BraZ1	42.6	+	575	426	426	1.0000000
A08	27899923	27902138	A08p32880.2_BraZ1	987.137	-	1047	2032	2215	0.9173815
A08	27905324	27906515	A08p32890.2_BraZ1	702.444	+	1077	1191	1191	1.0000000
A08	27911967	27913387	A08p32900.2_BraZ1	853.65	-	2007	1420	1420	1.0000000
A08	27921340	27926263	A08p32910.2_BraZ1	229.5	-	6912	4923	4923	1.0000000
A08	27937317	27940365	A08p32920.2_BraZ1	1874.07	+	1494	2847	3048	0.9340551
A08	27943264	27946971	A08p32930.2_BraZ1	1045.48	+	2842	3707	3707	1.0000000
A08	27947222	27948699	A08p32940.2_BraZ1	4158	-	1395	1477	1477	1.0000000
A08	27948794	27951672	A08p32950.2_BraZ1	7533	-	1297	2771	2878	0.9628214
A08	27952732	27955235	A08p32960.2_BraZ1	1642.85	-	2409	2503	2503	1.0000000
A08	27956240	27958784	A08p32970.2_BraZ1	1108.64	-	1303	2544	2544	1.0000000
A08	27961212	27962313	A08p32980.2_BraZ1	110.1	-	2120	1101	1101	1.0000000
A08	27963040	27965145	A08p32990.2_BraZ1	1584	-	1394	1824	2105	0.8665083
A08	27968273	27969811	A08p33000.2_BraZ1	966.214	-	214	1328	1538	0.8634591
A08	27972682	27973942	A08p33010.2_BraZ1	680.448	+	399	1260	1260	1.0000000
A08	27974448	27975446	A08p33020.2_BraZ1	822	-	304	993	998	0.9949900
A08	27976463	27977633	A08p33030.2_BraZ1	117	-	334	1029	1170	0.8794872
A08	27984031	27987639	A08p33040.2_BraZ1	1369.44	+	1909	3498	3608	0.9695122
A08	27988038	27991822	A08p33050.2_BraZ1	1406.2	-	2678	3643	3784	0.9627379
A08	27992954	27994885	A08p33060.2_BraZ1	231	-	1573	1931	1931	1.0000000
A08	27998043	28003516	A08p33070.2_BraZ1	1490.91	+	3848	5325	5473	0.9729581
A08	28004188	28005657	A08p33080.2_BraZ1	670.122	+	1075	1469	1469	1.0000000
A08	28006673	28007643	A08p33090.2_BraZ1	469.2	-	350	970	970	1.0000000
A08	28008533	28009452	A08p33100.2_BraZ1	645	-	330	919	919	1.0000000
A08	28011615	28012113	A08p33110.2_BraZ1	49.8	-	3	43	498	0.0863454
A08	28014367	28015347	A08p33120.2_BraZ1	528	-	698	980	980	1.0000000
A08	28018747	28019272	A08p33130.2_BraZ1	52.5	+	514	525	525	1.0000000
A08	28020051	28021160	A08p33140.2_BraZ1	681	+	1064	1109	1109	1.0000000
A08	28021832	28025039	A08p33150.2_BraZ1	1008.41	+	1345	2998	3207	0.9348301
A08	28025495	28025789	A08p33160.2_BraZ1	213	+	81	294	294	1.0000000
A08	28026346	28028770	A08p33170.2_BraZ1	324	+	2008	2424	2424	1.0000000
A08	28032845	28035814	A08p33180.2_BraZ1	1470.71	+	1338	2654	2969	0.8939037
A08	28036113	28039050	A08p33190.2_BraZ1	1663.27	-	1486	2857	2937	0.9727613
A08	28039688	28041036	A08p33200.2_BraZ1	984	-	527	1348	1348	1.0000000
A08	28043100	28048753	A08p33210.2_BraZ1	1606.99	+	2582	5455	5653	0.9649743
A08	28049832	28052040	A08p33220.2_BraZ1	1100.32	+	1501	2160	2208	0.9782609
A08	28055184	28058489	A08p33230.2_BraZ1	1759.5	+	1371	1860	3305	0.5627837
A08	28059101	28060932	A08p33240.2_BraZ1	1064.18	-	1357	1831	1831	1.0000000
A08	28063716	28064945	A08p33250.2_BraZ1	729	-	285	655	1229	0.5329536
A08	28067563	28068592	A08p33260.2_BraZ1	648	-	282	1019	1029	0.9902818
A08	28068845	28069540	A08p33270.2_BraZ1	22.5	+	530	695	695	1.0000000
A08	28071013	28073659	A08p33280.2_BraZ1	1852.71	+	1585	2545	2646	0.9618292
A08	28074303	28077242	A08p33290.2_BraZ1	618.8	+	1323	2837	2939	0.9652943
A08	28077536	28078124	A08p33300.2_BraZ1	58.8	-	338	526	588	0.8945578
A08	28080708	28083652	A08p33310.2_BraZ1	1643.33	+	1612	2944	2944	1.0000000
A08	28084111	28084771	A08p33320.2_BraZ1	303	-	463	660	660	1.0000000
A08	28085121	28088039	A08p33330.2_BraZ1	1587.86	-	1331	2894	2918	0.9917752
A08	28093044	28096849	A08p33340.2_BraZ1	899.834	+	761	3054	3805	0.8026281
A08	28100810	28102392	A08p33350.2_BraZ1	1323	+	717	1582	1582	1.0000000
A08	28102794	28103820	A08p33360.2_BraZ1	497.7	-	416	1026	1026	1.0000000
A08	28105833	28111059	A08p33370.2_BraZ1	1999.51	+	2628	5174	5226	0.9900498
A08	28111795	28115841	A08p33380.2_BraZ1	1866	-	818	3467	4046	0.8568957
A08	28121779	28122713	A08p33390.2_BraZ1	207	-	204	595	934	0.6370450
A08	28123818	28127789	A08p33400.2_BraZ1	1483.03	+	762	3612	3971	0.9095945
A08	28130387	28131531	A08p33410.2_BraZ1	800.609	+	402	1113	1144	0.9729021
A08	28132662	28137958	A08p33420.2_BraZ1	2025.23	+	1907	5236	5296	0.9886707
A08	28139079	28139539	A08p33430.2_BraZ1	375	+	8	172	460	0.3739130
A08	28140895	28141681	A08p33440.2_BraZ1	78.6	-	147	631	786	0.8027990
A08	28144181	28148363	A08p33450.2_BraZ1	14661	-	588	3665	4182	0.8763750
A08	28149805	28151110	A08p33460.2_BraZ1	1233	-	586	1305	1305	1.0000000
A08	28152133	28155699	A08p33470.2_BraZ1	1789.71	+	859	3297	3566	0.9245653
A08	28156425	28156983	A08p33480.2_BraZ1	55.8	-	145	558	558	1.0000000
A08	28157886	28159945	A08p33490.2_BraZ1	644.392	+	1268	2056	2059	0.9985430
A08	28160864	28173004	A08p33500.2_BraZ1	803.75	-	8800	11917	12140	0.9816310
A08	28166967	28167417	A08p33510.2_BraZ1	45	-	816	450	450	1.0000000
A08	28174157	28178333	A08p33520.2_BraZ1	2551.4	-	838	3415	4176	0.8177682
A08	28184821	28196452	A08p33530.2_BraZ1	965.8	+	2404	6366	11631	0.5473304
A08	28189504	28190469	A08p33540.2_BraZ1	165	-	0	0	965	0.0000000
A08	28190469	28191091	A08p33550.2_BraZ1	132.136	-	48	367	622	0.5900322
A08	28191187	28191894	A08p33560.2_BraZ1	207	-	24	288	707	0.4073550
A08	28198805	28200091	A08p33570.2_BraZ1	730.143	+	123	1162	1286	0.9035770
A08	28202630	28204541	A08p33580.2_BraZ1	456	+	500	1030	1911	0.5389848
A08	28204950	28205361	A08p33590.2_BraZ1	195	-	236	411	411	1.0000000
A08	28205428	28206822	A08p33600.2_BraZ1	396	-	364	1357	1394	0.9734577
A08	28208667	28211641	A08p33610.2_BraZ1	1403.88	-	886	2852	2974	0.9589778
A08	28213029	28214980	A08p33620.2_BraZ1	594.214	+	679	1909	1951	0.9784726
A08	28215887	28218019	A08p33630.2_BraZ1	1626	+	1987	2132	2132	1.0000000
A08	28218405	28222883	A08p33640.2_BraZ1	2557.94	-	4092	4478	4478	1.0000000
A08	28223752	28225801	A08p33650.2_BraZ1	204.9	+	642	1996	2049	0.9741337
A08	28226048	28230846	A08p33660.2_BraZ1	2927.54	-	2610	4664	4798	0.9720717
A08	28231427	28235301	A08p33670.2_BraZ1	2762.68	+	1599	3234	3874	0.8347961
A08	28235768	28235943	A08p33680.2_BraZ1	18.4286	+	204	175	175	1.0000000
A08	28236080	28237056	A08p33690.2_BraZ1	615	-	737	976	976	1.0000000
A08	28239236	28240135	A08p33700.2_BraZ1	660	-	242	855	899	0.9510567
A08	28241887	28242181	A08p33710.2_BraZ1	29.4	+	118	277	294	0.9421769
A08	28246134	28248101	A08p33720.2_BraZ1	2292	+	1618	1967	1967	1.0000000
A08	28248876	28252708	A08p33730.2_BraZ1	2504.59	+	1388	3798	3832	0.9911274
A08	28253548	28253833	A08p33740.2_BraZ1	28.5	+	434	285	285	1.0000000
A08	28254843	28256607	A08p33750.2_BraZ1	397.571	+	1346	1745	1764	0.9892290
A08	28257966	28260827	A08p33760.2_BraZ1	1295	+	160	1396	2861	0.4879413
A08	28261631	28262339	A08p33770.2_BraZ1	268.333	-	433	673	708	0.9505650
A08	28264687	28264960	A08p33780.2_BraZ1	27.3	-	4	93	273	0.3406594
A08	28266636	28268105	A08p33790.2_BraZ1	714	+	1099	1469	1469	1.0000000
A08	28268526	28268834	A08p33800.2_BraZ1	252	+	645	308	308	1.0000000
A08	28269445	28270055	A08p33810.2_BraZ1	198	+	528	610	610	1.0000000
A08	28270079	28272896	A08p33820.2_BraZ1	1623.56	+	3270	2817	2817	1.0000000
A08	28273501	28275009	A08p33830.2_BraZ1	401.077	+	1608	1508	1508	1.0000000
A08	28275390	28277104	A08p33840.2_BraZ1	785.487	-	1527	1714	1714	1.0000000
A08	28277142	28278155	A08p33850.2_BraZ1	286.125	+	697	1013	1013	1.0000000
A08	28279160	28280833	A08p33860.2_BraZ1	1299.96	-	839	1673	1673	1.0000000
A08	28283024	28289577	A08p33870.2_BraZ1	2930.38	-	2061	6230	6553	0.9507096
A08	28292102	28294482	A08p33880.2_BraZ1	1398.29	+	1425	2233	2380	0.9382353
A08	28294733	28295530	A08p33890.2_BraZ1	381	-	91	569	797	0.7139272
A08	28295963	28296598	A08p33900.2_BraZ1	1295	+	357	635	635	1.0000000
A08	28297231	28311479	A08p33910.2_BraZ1	5015.19	-	6494	13705	14248	0.9618894
A08	28312243	28319120	A08p33920.2_BraZ1	3215.4	+	2567	6564	6877	0.9544860
A08	28320119	28321652	A08p33930.2_BraZ1	153.3	-	238	1411	1533	0.9204175
A08	28323894	28326846	A08p33940.2_BraZ1	2168.27	+	553	2266	2952	0.7676152
A08	28327671	28332313	A08p33950.2_BraZ1	1611.3	+	4889	4642	4642	1.0000000
A08	28337485	28339789	A08p33960.2_BraZ1	12942	+	567	2098	2304	0.9105903
A08	28341293	28344977	A08p33970.2_BraZ1	1416.28	-	1944	3628	3684	0.9847991
A08	28349348	28349753	A08p33980.2_BraZ1	40.5	+	449	405	405	1.0000000
A08	28350196	28351752	A08p33990.2_BraZ1	565.646	-	751	1556	1556	1.0000000
A08	28351851	28352341	A08p34000.2_BraZ1	234	-	224	490	490	1.0000000
A08	28352114	28354067	A08p34010.2_BraZ1	195.3	+	574	1919	1953	0.9825909
A08	28355145	28356536	A08p34020.2_BraZ1	1029.07	+	805	1391	1391	1.0000000
A08	28356891	28361107	A08p34030.2_BraZ1	2250	-	2769	4134	4216	0.9805503
A08	28362031	28362658	A08p34040.2_BraZ1	408.586	-	659	627	627	1.0000000
A08	28363426	28364608	A08p34050.2_BraZ1	631.429	+	1133	1182	1182	1.0000000
A08	28365163	28375222	A08p34060.2_BraZ1	1199.95	-	6526	10041	10059	0.9982105
A08	28376072	28377076	A08p34070.2_BraZ1	780	+	429	1004	1004	1.0000000
A08	28378245	28383993	A08p34080.2_BraZ1	3394.77	+	1329	4431	5748	0.7708768
A08	28384587	28385727	A08p34090.2_BraZ1	114	+	750	1140	1140	1.0000000
A08	28386052	28389497	A08p34100.2_BraZ1	1981.8	-	1656	3387	3445	0.9831640
A08	28395670	28397668	A08p34110.2_BraZ1	768.25	-	1683	1998	1998	1.0000000
A08	28400540	28401122	A08p34120.2_BraZ1	58.2	+	381	582	582	1.0000000
A08	28402536	28404701	A08p34130.2_BraZ1	1825.86	-	1077	2156	2165	0.9958429
A08	28405864	28409059	A08p34140.2_BraZ1	2434.56	+	1679	3104	3195	0.9715180
A08	28409366	28410116	A08p34150.2_BraZ1	75	-	258	746	750	0.9946667
A08	28412909	28414344	A08p34160.2_BraZ1	721.538	+	1295	1435	1435	1.0000000
A08	28414827	28417989	A08p34170.2_BraZ1	323.714	+	1470	3147	3162	0.9952562
A08	28418542	28419471	A08p34180.2_BraZ1	538.816	-	90	808	929	0.8697524
A08	28422864	28423752	A08p34190.2_BraZ1	603	-	87	710	888	0.7995495
A08	28425790	28427089	A08p34200.2_BraZ1	456.143	+	1116	1299	1299	1.0000000
A08	28427993	28429603	A08p34210.2_BraZ1	1405.05	+	1868	1610	1610	1.0000000
A08	28430380	28433045	A08p34220.2_BraZ1	2292	+	1880	2665	2665	1.0000000
A08	28434536	28437752	A08p34230.2_BraZ1	1445	-	2003	3186	3216	0.9906716
A08	28438565	28439363	A08p34240.2_BraZ1	163.929	+	419	595	798	0.7456141
A08	28444086	28452161	A08p34250.2_BraZ1	1462.89	+	1523	6876	8075	0.8515170
A08	28452453	28453188	A08p34260.2_BraZ1	73.5	-	278	652	735	0.8870748
A08	28453796	28456409	A08p34270.2_BraZ1	1066.72	-	617	2073	2613	0.7933410
A08	28457309	28459101	A08p34280.2_BraZ1	924.5	+	1500	1783	1792	0.9949777
A08	28459809	28460285	A08p34290.2_BraZ1	243.341	-	401	476	476	1.0000000
A08	28460817	28463712	A08p34300.2_BraZ1	1636.87	+	2394	2851	2895	0.9848014
A08	28464758	28465178	A08p34310.2_BraZ1	42	-	106	363	420	0.8642857
A08	28466821	28469502	A08p34320.2_BraZ1	1281.95	-	57	1222	2681	0.4558001
A08	28472307	28472887	A08p34330.2_BraZ1	297	+	421	580	580	1.0000000
A08	28473905	28474514	A08p34340.2_BraZ1	60.6	-	332	593	609	0.9737274
A08	28476545	28477184	A08p34350.2_BraZ1	243	-	677	639	639	1.0000000
A08	28477835	28481389	A08p34360.2_BraZ1	1736.3	+	1722	3445	3554	0.9693303
A08	28482046	28483931	A08p34370.2_BraZ1	1094.58	+	1313	1873	1885	0.9936339
A08	28484525	28487033	A08p34380.2_BraZ1	1409.21	+	1101	2439	2508	0.9724880
A08	28488597	28490979	A08p34390.2_BraZ1	1085.44	+	2344	2382	2382	1.0000000
A08	28492968	28495271	A08p34400.2_BraZ1	980.333	-	1229	2303	2303	1.0000000
A08	28496214	28496445	A08p34410.2_BraZ1	23.1	-	2	27	231	0.1168831
A08	28496449	28496713	A08p34420.2_BraZ1	26.4	-	0	0	264	0.0000000
A08	28499164	28500563	A08p34430.2_BraZ1	877.241	+	1099	1399	1399	1.0000000
A08	28501205	28502293	A08p34440.2_BraZ1	897	-	392	1044	1088	0.9595588
A08	28503615	28505969	A08p34450.2_BraZ1	33703.7	-	814	2352	2354	0.9991504
A08	28507668	28512829	A08p34460.2_BraZ1	40323.8	-	2685	5095	5161	0.9872118
A08	28513458	28515918	A08p34470.2_BraZ1	246	-	923	2285	2460	0.9288618
A08	28517160	28522120	A08p34480.2_BraZ1	2798.33	+	2864	4960	4960	1.0000000
A08	28525537	28533006	A08p34490.2_BraZ1	1699.07	-	1736	5294	7469	0.7087964
A08	28538522	28540183	A08p34500.2_BraZ1	845.091	-	1046	1559	1661	0.9385912
A08	28542388	28543949	A08p34510.2_BraZ1	736.63	+	613	1561	1561	1.0000000
A08	28546102	28546942	A08p34520.2_BraZ1	453	+	595	840	840	1.0000000
A08	28549702	28551515	A08p34530.2_BraZ1	1377	+	413	1622	1813	0.8946497
A08	28552063	28553043	A08p34540.2_BraZ1	909	-	281	904	980	0.9224490
A08	28554090	28555480	A08p34550.2_BraZ1	619.773	+	1202	1390	1390	1.0000000
A08	28556072	28557474	A08p34560.2_BraZ1	491.963	+	1002	1402	1402	1.0000000
A08	28558717	28559538	A08p34570.2_BraZ1	46.2	+	914	821	821	1.0000000
A08	28560004	28561005	A08p34580.2_BraZ1	712.727	-	140	946	1001	0.9450549
A08	28562037	28562784	A08p34590.2_BraZ1	240.933	-	54	747	747	1.0000000
A08	28564049	28566034	A08p34600.2_BraZ1	912.857	+	1636	1985	1985	1.0000000
A08	28567054	28568038	A08p34610.2_BraZ1	687	+	104	715	984	0.7266260
A08	28568636	28568996	A08p34620.2_BraZ1	267	+	101	335	360	0.9305556
A08	28569046	28571869	A08p34630.2_BraZ1	1568.25	+	855	2593	2823	0.9185264
A08	28572471	28574228	A08p34640.2_BraZ1	1617	-	529	1757	1757	1.0000000
A08	28575635	28575977	A08p34650.2_BraZ1	34.2	-	77	342	342	1.0000000
A08	28575986	28576331	A08p34660.2_BraZ1	34.5	-	153	333	345	0.9652174
A08	28577415	28577721	A08p34670.2_BraZ1	30.6	-	88	306	306	1.0000000
A08	28581645	28583022	A08p34680.2_BraZ1	5064	-	419	1272	1377	0.9237473
A08	28583399	28584987	A08p34690.2_BraZ1	1185	-	438	1585	1588	0.9981108
A08	28584659	28588072	A08p34700.2_BraZ1	3815.63	-	1575	3061	3413	0.8968650
A08	28589742	28590195	A08p34710.2_BraZ1	45.3	+	166	453	453	1.0000000
A08	28591193	28593270	A08p34720.2_BraZ1	1525.51	-	1022	1985	2077	0.9557053
A08	28594477	28596205	A08p34730.2_BraZ1	622.545	+	767	1598	1728	0.9247685
A08	28596685	28598652	A08p34740.2_BraZ1	1053	-	1250	1967	1967	1.0000000
A08	28598709	28600913	A08p34750.2_BraZ1	37.8	-	1053	1900	2204	0.8620690
A08	28601289	28601551	A08p34760.2_BraZ1	168	-	0	0	262	0.0000000
A08	28605829	28608661	A08p34770.2_BraZ1	2554.29	+	1447	2805	2832	0.9904661
A08	28614393	28617618	A08p34780.2_BraZ1	495	-	2308	3225	3225	1.0000000
A08	28618736	28618868	A08p34790.2_BraZ1	13.2	+	306	132	132	1.0000000
A08	28619123	28620806	A08p34800.2_BraZ1	705	-	1205	1634	1683	0.9708853
A08	28621802	28624340	A08p34810.2_BraZ1	17604	+	1194	2454	2538	0.9669031
A08	28625077	28626390	A08p34820.2_BraZ1	1230	-	694	1313	1313	1.0000000
A08	28627574	28628477	A08p34830.2_BraZ1	90.3	+	569	903	903	1.0000000
A08	28629824	28630535	A08p34840.2_BraZ1	506.025	+	366	704	711	0.9901547
A08	28631144	28633052	A08p34850.2_BraZ1	774	-	1923	1908	1908	1.0000000
A08	28634454	28635432	A08p34860.2_BraZ1	97.8	+	1329	978	978	1.0000000
A08	28638319	28640163	A08p34870.2_BraZ1	17797.5	+	680	1684	1844	0.9132321
A08	28640648	28643422	A08p34880.2_BraZ1	1031.15	+	72	1192	2774	0.4297044
A08	28645076	28645831	A08p34890.2_BraZ1	513	-	740	755	755	1.0000000
A08	28650731	28652321	A08p34900.2_BraZ1	159	-	802	1590	1590	1.0000000
A08	28655471	28656777	A08p34910.2_BraZ1	425.074	-	162	998	1306	0.7641654
A08	28659082	28659775	A08p34920.2_BraZ1	473.162	+	11	336	693	0.4848485
A08	28669230	28669698	A08p34930.2_BraZ1	46.8	-	57	212	468	0.4529915
A08	28671611	28672157	A08p34940.2_BraZ1	54.6	+	128	540	546	0.9890110
A08	28675230	28680215	A08p34950.2_BraZ1	1522.45	+	1648	4860	4985	0.9749248
A08	28682571	28684153	A08p34960.2_BraZ1	975.938	-	343	1107	1582	0.6997471
A08	28687148	28687983	A08p34970.2_BraZ1	747	-	252	751	835	0.8994012
A08	28688524	28690785	A08p34980.2_BraZ1	1044.4	-	1130	2191	2261	0.9690403
A08	28693492	28693636	A08p34990.2_BraZ1	13.8	+	10	62	144	0.4305556
A08	28699386	28700989	A08p35000.2_BraZ1	970.509	-	1448	1603	1603	1.0000000
A08	28702210	28703485	A08p35010.2_BraZ1	127.5	+	660	1275	1275	1.0000000
A08	28707063	28709570	A08p35020.2_BraZ1	1126.27	-	1921	2507	2507	1.0000000
A08	28710665	28712246	A08p35030.2_BraZ1	158.1	+	455	1581	1581	1.0000000
A08	28712804	28714361	A08p35040.2_BraZ1	1185	-	752	1557	1557	1.0000000
A08	28715640	28717132	A08p35050.2_BraZ1	494.1	+	289	1487	1492	0.9966488
A08	28717132	28718721	A08p35060.2_BraZ1	5271	-	298	1308	1589	0.8231592
A08	28720510	28722092	A08p35070.2_BraZ1	1509	-	392	1568	1582	0.9911504
A08	28722585	28724357	A08p35080.2_BraZ1	817.217	-	507	1761	1772	0.9937923
A08	28725234	28726197	A08p35090.2_BraZ1	96.3	-	486	963	963	1.0000000
A08	28726832	28728828	A08p35100.2_BraZ1	1406.7	-	828	1996	1996	1.0000000
A08	28729487	28731503	A08p35110.2_BraZ1	1706.1	+	792	2007	2016	0.9955357
A08	28732335	28733712	A08p35120.2_BraZ1	1179	-	561	1377	1377	1.0000000
A08	28735168	28735833	A08p35130.2_BraZ1	237	-	391	665	665	1.0000000
A08	28736939	28739837	A08p35140.2_BraZ1	902.571	-	3080	2898	2898	1.0000000
A08	28741485	28743256	A08p35150.2_BraZ1	768.75	-	222	968	1771	0.5465838
A08	28751441	28752749	A08p35160.2_BraZ1	130.8	+	209	1221	1308	0.9334862
A08	28753348	28755301	A08p35170.2_BraZ1	1361.05	-	1241	1719	1953	0.8801844
A08	28756689	28758053	A08p35180.2_BraZ1	1170	+	816	1363	1364	0.9992669
A08	28758542	28758932	A08p35190.2_BraZ1	39	+	236	390	390	1.0000000
A08	28759519	28761736	A08p35200.2_BraZ1	1078.67	-	730	2122	2217	0.9571493
A08	28762053	28762581	A08p35210.2_BraZ1	52.8	+	601	528	528	1.0000000
A08	28766502	28768770	A08p35220.2_BraZ1	1773	+	1945	2268	2268	1.0000000
A08	28769146	28770322	A08p35230.2_BraZ1	377.438	-	1262	1176	1176	1.0000000
A08	28772679	28772901	A08p35240.2_BraZ1	22.2	-	109	217	222	0.9774775
A08	28774081	28775796	A08p35250.2_BraZ1	178.5	+	1547	1715	1715	1.0000000
A08	28776057	28777910	A08p35260.2_BraZ1	908.471	+	1403	1853	1853	1.0000000
A08	28778095	28781946	A08p35270.2_BraZ1	2910	-	2382	3461	3851	0.8987276
A08	28784200	28786207	A08p35280.2_BraZ1	165	+	1570	2007	2007	1.0000000
A08	28786491	28788503	A08p35290.2_BraZ1	1046.25	-	1486	2012	2012	1.0000000
A08	28790444	28791902	A08p35300.2_BraZ1	6169.5	+	1035	1458	1458	1.0000000
A08	28792149	28792578	A08p35310.2_BraZ1	221.4	-	483	429	429	1.0000000
A08	28799393	28799960	A08p35320.2_BraZ1	56.7	-	70	370	567	0.6525573
A08	28806040	28807906	A08p35330.2_BraZ1	182.4	+	1397	1866	1866	1.0000000
A08	28810079	28810640	A08p35340.2_BraZ1	56.1	+	292	561	561	1.0000000
A08	28812453	28812954	A08p35350.2_BraZ1	339	-	1	55	501	0.1097804
A08	28813787	28816138	A08p35360.2_BraZ1	977.786	+	2007	2351	2351	1.0000000
A08	28816760	28819033	A08p35370.2_BraZ1	1525	-	1270	2251	2273	0.9903212
A08	28822317	28824685	A08p35380.2_BraZ1	1766.53	+	1036	1962	2368	0.8285473
A08	28825098	28826119	A08p35390.2_BraZ1	792	-	557	921	1021	0.9020568
A08	28827431	28828860	A08p35400.2_BraZ1	765.6	+	677	1393	1429	0.9748076
A08	28831690	28833326	A08p35410.2_BraZ1	1221.75	+	674	1605	1636	0.9810513
A08	28834898	28840864	A08p35420.2_BraZ1	2892.2	-	1249	3791	5966	0.6354342
A08	28841485	28842857	A08p35430.2_BraZ1	947.571	-	468	1372	1372	1.0000000
A08	28854709	28856860	A08p35440.2_BraZ1	1255.28	+	532	2151	2151	1.0000000
A08	28858293	28860349	A08p35450.2_BraZ1	470.909	-	1397	1982	2056	0.9640078
A08	28863252	28865508	A08p35460.2_BraZ1	225.6	+	166	1578	2256	0.6994681
A08	28871357	28873545	A08p35470.2_BraZ1	1191.53	+	561	2159	2188	0.9867459
A08	28874533	28876363	A08p35480.2_BraZ1	153	-	556	1536	1830	0.8393443
A08	28880388	28881156	A08p35490.2_BraZ1	657	-	335	768	768	1.0000000
A08	28882692	28883139	A08p35500.2_BraZ1	44.7	+	302	447	447	1.0000000
A08	28886027	28888667	A08p35510.2_BraZ1	264	+	2108	2592	2640	0.9818182
A08	28898174	28899540	A08p35520.2_BraZ1	1132.68	+	43	425	1366	0.3111274
A08	28901555	28902942	A08p35530.2_BraZ1	5397.6	-	836	1387	1387	1.0000000
A08	28903723	28906402	A08p35540.2_BraZ1	267.9	-	236	1502	2679	0.5606570
A08	28907247	28908992	A08p35550.2_BraZ1	1644	+	495	1620	1745	0.9283668
A08	28909074	28911028	A08p35560.2_BraZ1	1293.83	-	969	1794	1954	0.9181167
A08	28913634	28915071	A08p35570.2_BraZ1	1218	+	1292	1437	1437	1.0000000
A08	28917298	28918347	A08p35580.2_BraZ1	351	+	68	510	1049	0.4861773
A08	28922360	28926050	A08p35590.2_BraZ1	1746.93	-	2808	3690	3690	1.0000000
A08	28937596	28938001	A08p35600.2_BraZ1	40.5	-	113	405	405	1.0000000
A08	28941659	28942073	A08p35610.2_BraZ1	41.4	+	58	413	414	0.9975845
A08	28947841	28948219	A08p35620.2_BraZ1	37.8	-	315	378	378	1.0000000
A08	28951566	28953198	A08p35630.2_BraZ1	568.421	+	1690	1632	1632	1.0000000
A08	28953858	28954204	A08p35640.2_BraZ1	34.2	+	307	346	346	1.0000000
A08	28954918	28955560	A08p35650.2_BraZ1	64.2	-	432	576	642	0.8971962
A08	28956195	28958515	A08p35660.2_BraZ1	231.3	-	2395	2106	2320	0.9077586
A08	28960943	28962890	A08p35670.2_BraZ1	888	+	974	1842	1947	0.9460708
A08	28964360	28965083	A08p35680.2_BraZ1	72.3	+	263	722	723	0.9986169
A08	28967060	28970433	A08p35690.2_BraZ1	747.382	+	2270	3178	3373	0.9421880
A08	28971434	28975551	A08p35700.2_BraZ1	2248.2	+	2324	4074	4117	0.9895555
A08	28977980	28980489	A08p35710.2_BraZ1	1054.51	+	1597	2440	2509	0.9724990
A08	28980830	28982595	A08p35720.2_BraZ1	658.761	-	1096	1414	1765	0.8011332
A08	28984060	28988423	A08p35730.2_BraZ1	1242.21	+	2402	4309	4363	0.9876232
A08	28988899	28989448	A08p35740.2_BraZ1	216	+	525	549	549	1.0000000
A08	28989731	28990868	A08p35750.2_BraZ1	599.513	-	498	1111	1137	0.9771328
A08	28991857	28993933	A08p35760.2_BraZ1	1493.66	+	1787	2076	2076	1.0000000
A08	28994234	28996973	A08p35770.2_BraZ1	1374.58	-	2147	2739	2739	1.0000000
A08	28997356	29000049	A08p35780.2_BraZ1	1283.48	+	1574	2690	2693	0.9988860
A08	29000285	29004762	A08p35790.2_BraZ1	1797.73	-	2395	4362	4477	0.9743131
A08	29006523	29008377	A08p35800.2_BraZ1	1510.48	+	415	1734	1854	0.9352751
A08	29009012	29012195	A08p35810.2_BraZ1	985.043	-	2457	3056	3183	0.9601005
A08	29013863	29016253	A08p35820.2_BraZ1	1063.62	+	1796	2390	2390	1.0000000
A08	29016690	29018408	A08p35830.2_BraZ1	655.306	-	1073	1718	1718	1.0000000
A08	29019353	29021310	A08p35840.2_BraZ1	1220.62	+	779	1869	1957	0.9550332
A08	29025801	29030521	A08p35850.2_BraZ1	3132.76	-	1395	4392	4720	0.9305085
A08	29037269	29037989	A08p35860.2_BraZ1	103.5	-	187	533	720	0.7402778
A08	29043354	29044335	A08p35870.2_BraZ1	909	-	452	981	981	1.0000000
A08	29045104	29049275	A08p35880.2_BraZ1	910.191	-	1820	3961	4171	0.9496524
A08	29057754	29062589	A08p35890.2_BraZ1	1414.5	+	760	4182	4835	0.8649431
A08	29065331	29074336	A08p35900.2_BraZ1	592	-	514	3915	9005	0.4347585
A08	29074755	29075822	A08p35910.2_BraZ1	519.75	+	363	1010	1067	0.9465792
A08	29075968	29076319	A08p35920.2_BraZ1	35.1	-	412	351	351	1.0000000
A08	29078201	29079734	A08p35930.2_BraZ1	153.3	-	243	1001	1533	0.6529680
A08	29081155	29081428	A08p35940.2_BraZ1	27.3	-	29	175	273	0.6410257
A08	29082316	29085826	A08p35950.2_BraZ1	18600	-	901	3056	3510	0.8706553
A08	29092637	29093021	A08p35960.2_BraZ1	38.4	+	79	118	384	0.3072917
A08	29093393	29096128	A08p35970.2_BraZ1	883.107	-	983	2559	2735	0.9356490
A08	29097732	29098002	A08p35980.2_BraZ1	219	-	271	270	270	1.0000000
A08	29098417	29099195	A08p35990.2_BraZ1	402	-	467	778	778	1.0000000
A08	29099733	29101003	A08p36000.2_BraZ1	714	-	720	1270	1270	1.0000000
A08	29101753	29102952	A08p36010.2_BraZ1	196.138	-	357	1001	1199	0.8348624
A08	29103732	29104713	A08p36020.2_BraZ1	98.1	-	180	761	981	0.7757390
A08	29105278	29106636	A08p36030.2_BraZ1	687.905	-	462	1161	1358	0.8549337
A08	29111489	29112383	A08p36040.2_BraZ1	603.5	-	561	894	894	1.0000000
A08	29127778	29128632	A08p36050.2_BraZ1	744	+	772	854	854	1.0000000
A08	29137787	29138468	A08p36060.2_BraZ1	606	+	324	681	681	1.0000000
A08	29139183	29143945	A08p36070.2_BraZ1	3129.76	-	2237	4608	4762	0.9676607
A08	29144948	29145183	A08p36080.2_BraZ1	17.7	-	0	0	235	0.0000000
A08	29147616	29151082	A08p36090.2_BraZ1	946.67	+	2278	3195	3466	0.9218119
A08	29153216	29153990	A08p36100.2_BraZ1	43.8	+	953	674	774	0.8708010
A08	29154140	29161816	A08p36110.2_BraZ1	2466	-	888	4213	7676	0.5488536
A08	29162860	29163971	A08p36120.2_BraZ1	1047	-	639	1111	1111	1.0000000
A08	29170979	29173996	A08p36130.2_BraZ1	2595.62	+	621	2677	3017	0.8873053
A08	29178171	29179386	A08p36140.2_BraZ1	121.5	+	671	1011	1215	0.8320988
A08	29180476	29181583	A08p36150.2_BraZ1	897	-	350	1107	1107	1.0000000
A08	29182142	29182433	A08p36160.2_BraZ1	28.2	+	88	272	291	0.9347079
A08	29182556	29183623	A08p36170.2_BraZ1	868.696	-	184	923	1067	0.8650422
A08	29184768	29186946	A08p36180.2_BraZ1	773.217	+	338	1160	2178	0.5325987
A08	29187392	29187572	A08p36190.2_BraZ1	18	-	0	0	180	0.0000000
A08	29189107	29191747	A08p36200.2_BraZ1	1033.52	-	308	1453	2640	0.5503788
A08	29192751	29194709	A08p36210.2_BraZ1	546	-	2488	1958	1958	1.0000000
A08	29196126	29196321	A08p36220.2_BraZ1	19.5	+	10	91	195	0.4666667
A08	29197244	29198204	A08p36230.2_BraZ1	96	-	131	751	960	0.7822917
A08	29203353	29206365	A08p36240.2_BraZ1	1332.24	+	591	2475	3012	0.8217131
A08	29207387	29207654	A08p36250.2_BraZ1	26.7	+	419	267	267	1.0000000
A08	29208685	29210465	A08p36260.2_BraZ1	1168.5	+	893	1780	1780	1.0000000
A08	29211161	29213149	A08p36270.2_BraZ1	794.475	-	841	1833	1988	0.9220322
A08	29213836	29214283	A08p36280.2_BraZ1	44.7	-	147	424	447	0.9485459
A08	29215198	29218681	A08p36290.2_BraZ1	1498.59	-	1603	3443	3483	0.9885157
A08	29220070	29222070	A08p36300.2_BraZ1	807.07	+	1242	2000	2000	1.0000000
A08	29223145	29229460	A08p36310.2_BraZ1	3199.97	+	1878	5784	6315	0.9159145
A08	29230247	29235384	A08p36320.2_BraZ1	1995.02	+	2008	4760	5137	0.9266109
A08	29236576	29238632	A08p36330.2_BraZ1	922.072	+	891	1936	2056	0.9416342
A08	29245198	29247856	A08p36340.2_BraZ1	647.314	+	2309	2549	2658	0.9589917
A08	29249033	29249366	A08p36350.2_BraZ1	102	+	284	333	333	1.0000000
A08	29251180	29258209	A08p36360.2_BraZ1	2851.77	+	3614	6922	7029	0.9847773
A08	29260707	29262896	A08p36370.2_BraZ1	1336.87	+	649	1841	2189	0.8410233
A08	29266504	29266630	A08p36380.2_BraZ1	12.6	+	206	126	126	1.0000000
A08	29267449	29272454	A08p36390.2_BraZ1	1115.71	-	3576	4472	5005	0.8935065
A08	29276636	29277211	A08p36400.2_BraZ1	410.625	-	8	240	575	0.4173913
A08	29278499	29279679	A08p36410.2_BraZ1	1017	+	350	866	1180	0.7338983
A08	29285313	29287584	A08p36420.2_BraZ1	1596	+	177	1569	2271	0.6908851
A08	29287878	29289355	A08p36430.2_BraZ1	2699.62	-	552	1477	1477	1.0000000
A08	29291659	29294908	A08p36440.2_BraZ1	2133.47	+	1070	2941	3249	0.9052016
A08	29297221	29297602	A08p36450.2_BraZ1	267	-	4	147	381	0.3858268
A08	29300720	29301656	A08p36460.2_BraZ1	549.205	+	52	691	936	0.7382479
A08	29305905	29307761	A08p36470.2_BraZ1	925.091	+	1129	1856	1856	1.0000000
A08	29309794	29312815	A08p36480.2_BraZ1	1429.64	-	1485	2786	3021	0.9222112
A08	29313288	29316529	A08p36490.2_BraZ1	1649.38	-	1447	3089	3241	0.9531009
A08	29317415	29318603	A08p36500.2_BraZ1	551.132	+	748	1188	1188	1.0000000
A08	29318841	29324361	A08p36510.2_BraZ1	3057.43	-	3579	5460	5520	0.9891304
A08	29328270	29328900	A08p36520.2_BraZ1	61.8	-	440	630	630	1.0000000
A08	29336989	29338448	A08p36530.2_BraZ1	537.971	-	1635	1326	1459	0.9088417
A08	29339772	29340934	A08p36540.2_BraZ1	761.595	+	909	1162	1162	1.0000000
A08	29344535	29346328	A08p36550.2_BraZ1	16180.5	+	462	1752	1793	0.9771333
A08	29348799	29353447	A08p36560.2_BraZ1	2495.82	+	597	3816	4648	0.8209983
A08	29353859	29357013	A08p36570.2_BraZ1	2271	-	1033	3112	3154	0.9866835
A08	29358120	29359893	A08p36580.2_BraZ1	1002	+	780	1765	1773	0.9954879
A08	29361506	29375363	A08p36590.2_BraZ1	3900	+	6385	10737	13857	0.7748430
A08	29362022	29362379	A08p36600.2_BraZ1	35.7	+	3	96	357	0.2689076
A08	29362880	29363789	A08p36610.2_BraZ1	90.9	+	386	870	909	0.9570957
A08	29366423	29366870	A08p36620.2_BraZ1	44.7	+	365	447	447	1.0000000
A08	29377412	29378787	A08p36630.2_BraZ1	249	+	62	863	1375	0.6276364
A08	29379224	29391657	A08p36640.2_BraZ1	3075.21	-	5745	10871	12433	0.8743666
A08	29381090	29381795	A08p36650.2_BraZ1	573	-	205	393	705	0.5574468
A08	29382432	29384307	A08p36660.2_BraZ1	987	-	1457	1875	1875	1.0000000
A08	29392843	29394902	A08p36670.2_BraZ1	3313.64	+	2106	2059	2059	1.0000000
A08	29395359	29397801	A08p36680.2_BraZ1	244.2	-	2087	2382	2442	0.9754300
A08	29399932	29400669	A08p36690.2_BraZ1	507	-	8	319	737	0.4328358
A08	29401860	29402506	A08p36700.2_BraZ1	58.8	-	113	397	646	0.6145511
A08	29404528	29405617	A08p36710.2_BraZ1	570	+	119	925	1089	0.8494031
A08	29406679	29407183	A08p36720.2_BraZ1	50.4	+	41	371	504	0.7361111
A08	29408269	29409702	A08p36730.2_BraZ1	823.784	-	952	1396	1433	0.9741800
A08	29410841	29414686	A08p36740.2_BraZ1	2210	+	1810	3293	3845	0.8564369
A08	29415434	29418770	A08p36750.2_BraZ1	333.6	+	192	1162	3336	0.3483213
A08	29419403	29420561	A08p36760.2_BraZ1	115.8	-	135	898	1158	0.7754750
A08	29422187	29423350	A08p36770.2_BraZ1	516	+	1012	1163	1163	1.0000000
A08	29427300	29428888	A08p36780.2_BraZ1	953.167	+	397	1208	1588	0.7607053
A08	29431199	29434425	A08p36790.2_BraZ1	2044.1	+	1497	3066	3226	0.9504030
A08	29434679	29436577	A08p36800.2_BraZ1	1043.28	-	1971	1898	1898	1.0000000
A08	29438441	29441863	A08p36810.2_BraZ1	1013.98	-	1739	3333	3422	0.9739918
A08	29444347	29446315	A08p36820.2_BraZ1	1033.32	+	1940	1968	1968	1.0000000
A08	29446592	29448494	A08p36830.2_BraZ1	6825	-	1922	1902	1902	1.0000000
A08	29450871	29452419	A08p36840.2_BraZ1	1344	+	793	1539	1548	0.9941860
A08	29456454	29459440	A08p36850.2_BraZ1	15230.2	-	1443	2986	2986	1.0000000
A08	29462327	29463058	A08p36860.2_BraZ1	246	+	730	731	731	1.0000000
A08	29466402	29467994	A08p36870.2_BraZ1	665.029	+	1482	1592	1592	1.0000000
A08	29469560	29474465	A08p36880.2_BraZ1	787.279	+	3424	4853	4905	0.9893986
A08	29476114	29479319	A08p36890.2_BraZ1	1470.36	+	1284	2963	3205	0.9244930
A08	29480569	29483581	A08p36900.2_BraZ1	1206.6	+	1815	3012	3012	1.0000000
A08	29484120	29486320	A08p36910.2_BraZ1	1363.15	+	926	2200	2200	1.0000000
A08	29488049	29488826	A08p36920.2_BraZ1	1072.29	-	100	758	777	0.9755470
A08	29490947	29496849	A08p36930.2_BraZ1	1950.55	+	3079	5649	5902	0.9571332
A08	29497218	29500183	A08p36940.2_BraZ1	2458.69	-	881	2826	2965	0.9531198
A08	29500611	29502094	A08p36950.2_BraZ1	739.369	+	618	1398	1483	0.9426838
A08	29502883	29504242	A08p36960.2_BraZ1	135.9	-	412	1272	1359	0.9359823
A08	29508236	29509683	A08p36970.2_BraZ1	486.087	-	843	1447	1447	1.0000000
A08	29510175	29515996	A08p36980.2_BraZ1	2800.04	+	1976	5219	5821	0.8965814
A08	29516507	29518043	A08p36990.2_BraZ1	837	+	485	1514	1536	0.9856771
A08	29518522	29519328	A08p37000.2_BraZ1	495	+	422	806	806	1.0000000
A08	29520221	29522035	A08p37010.2_BraZ1	845	+	1545	1788	1814	0.9856670
A08	29523972	29525696	A08p37020.2_BraZ1	1191.05	-	671	1579	1724	0.9158933
A08	29528516	29530992	A08p37030.2_BraZ1	1632.8	-	659	2097	2476	0.8469305
A08	29531655	29532622	A08p37040.2_BraZ1	495	-	130	816	967	0.8438470
A08	29533186	29534549	A08p37050.2_BraZ1	562.5	-	431	1275	1363	0.9354365
A08	29535184	29535926	A08p37060.2_BraZ1	660	-	164	676	742	0.9110512
A08	29537087	29540763	A08p37070.2_BraZ1	1038.8	+	2809	3628	3676	0.9869424
A08	29542084	29543307	A08p37080.2_BraZ1	902.2	-	296	1186	1223	0.9697465
A08	29551180	29551849	A08p37090.2_BraZ1	66.9	+	674	669	669	1.0000000
A08	29552662	29553292	A08p37100.2_BraZ1	63	+	594	586	630	0.9301587
A08	29553840	29555186	A08p37110.2_BraZ1	1153.86	-	311	1015	1346	0.7540862
A08	29555917	29559233	A08p37120.2_BraZ1	1729.3	-	2009	3316	3316	1.0000000
A08	29562370	29564442	A08p37130.2_BraZ1	725.2	-	82	762	2072	0.3677606
A08	29568229	29570842	A08p37140.2_BraZ1	261.3	+	3667	2613	2613	1.0000000
A08	29571487	29573876	A08p37150.2_BraZ1	1394.91	-	1476	2377	2389	0.9949770
A08	29574330	29577387	A08p37160.2_BraZ1	1393.2	+	723	2298	3057	0.7517174
A08	29581092	29582851	A08p37170.2_BraZ1	1071.6	+	1638	1759	1759	1.0000000
A08	29583054	29584723	A08p37180.2_BraZ1	218.312	-	353	783	1669	0.4691432
A08	29588857	29589054	A08p37190.2_BraZ1	123	-	146	197	197	1.0000000
A08	29592380	29593918	A08p37200.2_BraZ1	1387.31	-	2	19	1538	0.0123537
A08	29595248	29596623	A08p37210.2_BraZ1	532.353	+	102	393	1375	0.2858182
A08	29598310	29598809	A08p37220.2_BraZ1	330.667	+	190	291	499	0.5831664
A08	29599793	29601334	A08p37230.2_BraZ1	3427.5	-	5	290	1541	0.1881895
A08	29602663	29604039	A08p37240.2_BraZ1	532.353	+	49	558	1376	0.4055233
A08	29604530	29605040	A08p37250.2_BraZ1	51	-	71	290	510	0.5686275
A08	29605605	29608486	A08p37260.2_BraZ1	1328.14	-	2199	2820	2881	0.9788268
A08	29608974	29610469	A08p37270.2_BraZ1	967.909	+	907	1495	1495	1.0000000
A08	29611003	29613892	A08p37280.2_BraZ1	1541.33	-	1079	2485	2889	0.8601592
A08	29614344	29615814	A08p37290.2_BraZ1	147	+	1160	1470	1470	1.0000000
A08	29616417	29621990	A08p37300.2_BraZ1	652.846	+	2369	5248	5573	0.9416831
A08	29619866	29620283	A08p37310.2_BraZ1	41.1	+	159	417	417	1.0000000
A08	29622722	29625754	A08p37320.2_BraZ1	1325.25	-	1875	3032	3032	1.0000000
A08	29626197	29628580	A08p37330.2_BraZ1	6174	-	1732	2377	2383	0.9974822
A08	29631601	29636731	A08p37340.2_BraZ1	2242.74	+	2493	5122	5130	0.9984406
A08	29637946	29640069	A08p37350.2_BraZ1	1008.72	+	1395	2040	2123	0.9609044
A08	29641319	29642298	A08p37360.2_BraZ1	791.605	+	712	979	979	1.0000000
A08	29643432	29644709	A08p37370.2_BraZ1	435.6	-	1234	1226	1277	0.9600626
A08	29645703	29647539	A08p37380.2_BraZ1	3307.5	+	1412	1836	1836	1.0000000
A08	29648924	29649884	A08p37390.2_BraZ1	96	-	197	738	960	0.7687500
A08	29652561	29656458	A08p37400.2_BraZ1	2470.24	+	2482	3860	3897	0.9905055
A08	29656766	29659400	A08p37410.2_BraZ1	258.9	-	2007	2581	2634	0.9798785
A08	29662718	29666684	A08p37420.2_BraZ1	1362.06	+	1622	3950	3966	0.9959657
A08	29667492	29671688	A08p37430.2_BraZ1	2782.61	+	2274	4074	4196	0.9709247
A08	29672015	29678626	A08p37440.2_BraZ1	25605	-	1741	2723	6611	0.4118893
A08	29679775	29680827	A08p37450.2_BraZ1	657	-	395	1052	1052	1.0000000
A08	29690699	29694134	A08p37460.2_BraZ1	1394.85	-	629	3162	3435	0.9205240
A08	29695375	29695570	A08p37470.2_BraZ1	19.5	+	441	195	195	1.0000000
A08	29698458	29701354	A08p37480.2_BraZ1	1372.86	-	271	2601	2896	0.8981354
A08	29705050	29709171	A08p37490.2_BraZ1	1929.75	-	1544	3950	4121	0.9585052
A08	29709974	29710491	A08p37500.2_BraZ1	429	+	214	497	517	0.9613153
A08	29712440	29716966	A08p37510.2_BraZ1	1303.5	+	2331	4157	4526	0.9184710
A08	29718749	29721784	A08p37520.2_BraZ1	2775	+	1448	2772	3035	0.9133443
A08	29722683	29723645	A08p37530.2_BraZ1	576	-	985	962	962	1.0000000
A08	29724822	29725492	A08p37540.2_BraZ1	408	+	660	670	670	1.0000000
A08	29726003	29735008	A08p37550.2_BraZ1	3214.41	-	4647	7906	9005	0.8779567
A08	29735143	29735491	A08p37560.2_BraZ1	176.327	-	776	348	348	1.0000000
A08	29735473	29736185	A08p37570.2_BraZ1	932.571	-	1128	712	712	1.0000000
A08	29738739	29741629	A08p37580.2_BraZ1	3147.86	-	1891	2791	2890	0.9657440
A08	29746008	29747002	A08p37590.2_BraZ1	522.194	-	338	994	994	1.0000000
A08	29751106	29753187	A08p37600.2_BraZ1	2735.11	+	739	1614	2081	0.7755886
A08	29753702	29758033	A08p37610.2_BraZ1	3487.29	-	1592	3625	4331	0.8369892
A08	29759930	29762996	A08p37620.2_BraZ1	306.6	-	694	3020	3066	0.9849967
A08	29765435	29766350	A08p37630.2_BraZ1	91.5	+	720	915	915	1.0000000
A08	29767017	29769527	A08p37640.2_BraZ1	1611.56	-	918	2491	2510	0.9924303
A08	29772942	29774654	A08p37650.2_BraZ1	1200.54	+	777	1703	1712	0.9947430
A08	29781766	29782704	A08p37660.2_BraZ1	711	-	237	833	938	0.8880597
A08	29783833	29785011	A08p37670.2_BraZ1	419.129	-	974	1178	1178	1.0000000
A08	29787573	29791153	A08p37680.2_BraZ1	564	-	1740	3543	3580	0.9896648
A08	29797755	29800434	A08p37690.2_BraZ1	1014.53	+	1176	2617	2679	0.9768570
A08	29804046	29806672	A08p37700.2_BraZ1	1073.1	-	2447	2597	2626	0.9889566
A08	29808654	29810878	A08p37710.2_BraZ1	566.95	-	1883	2124	2224	0.9550360
A08	29812073	29818412	A08p37720.2_BraZ1	2525.22	-	2404	4538	6339	0.7158858
A08	29819480	29822225	A08p37730.2_BraZ1	1453.6	-	2159	2715	2745	0.9890710
A08	29823462	29824118	A08p37740.2_BraZ1	315	-	10	153	656	0.2332317
A08	29828837	29830362	A08p37750.2_BraZ1	4248	+	838	1525	1525	1.0000000
A08	29830783	29831939	A08p37760.2_BraZ1	656.2	+	1851	1156	1156	1.0000000
A08	29833117	29834548	A08p37770.2_BraZ1	1254	-	1886	1431	1431	1.0000000
A08	29836383	29836957	A08p37780.2_BraZ1	396	+	175	563	574	0.9808362
A08	29837207	29841583	A08p37790.2_BraZ1	1190.96	-	4440	4376	4376	1.0000000
A08	29842677	29845636	A08p37800.2_BraZ1	968.923	+	366	2027	2959	0.6850287
A08	29847136	29848796	A08p37810.2_BraZ1	738.426	+	269	1522	1660	0.9168675
A08	29849534	29852474	A08p37820.2_BraZ1	1326.39	+	1267	2921	2940	0.9935374
A08	29853163	29855451	A08p37830.2_BraZ1	1131.35	+	808	2156	2288	0.9423077
A08	29856575	29856899	A08p37840.2_BraZ1	32.4	+	125	324	324	1.0000000
A08	29859258	29859888	A08p37850.2_BraZ1	63	+	76	221	630	0.3507937
A08	29868865	29870898	A08p37860.2_BraZ1	1830	+	990	2033	2033	1.0000000
A08	29871425	29871818	A08p37870.2_BraZ1	37.5	-	338	393	393	1.0000000
A08	29875745	29878794	A08p37880.2_BraZ1	1371.17	+	1525	2711	3049	0.8891440
A08	29880236	29881610	A08p37890.2_BraZ1	7369.5	+	1383	1374	1374	1.0000000
A08	29881845	29886699	A08p37900.2_BraZ1	2275.31	-	1488	3998	4854	0.8236506
A08	29889232	29890666	A08p37910.2_BraZ1	6492.86	-	385	1434	1434	1.0000000
A08	29892577	29893809	A08p37920.2_BraZ1	705.5	-	575	1232	1232	1.0000000
A08	29897339	29900494	A08p37930.2_BraZ1	1078.52	+	1838	3155	3155	1.0000000
A08	29901818	29902058	A08p37940.2_BraZ1	24	+	86	240	240	1.0000000
A08	29904398	29906973	A08p37950.2_BraZ1	837.9	+	959	2574	2575	0.9996117
A08	29910398	29912248	A08p37960.2_BraZ1	1425	-	556	1434	1850	0.7751352
A08	29921291	29924226	A08p37970.2_BraZ1	2439	-	2258	2935	2935	1.0000000
A08	29924543	29926408	A08p37980.2_BraZ1	800.269	-	1860	1865	1865	1.0000000
A08	29927729	29928026	A08p37990.2_BraZ1	29.4	+	107	297	297	1.0000000
A08	29930512	29930830	A08p38000.2_BraZ1	31.8	+	8	195	318	0.6132075
A08	29931239	29932902	A08p38010.2_BraZ1	1056.53	-	933	1663	1663	1.0000000
A08	29934999	29935567	A08p38020.2_BraZ1	385.722	-	502	568	568	1.0000000
A08	29940099	29941674	A08p38030.2_BraZ1	1293	+	999	1555	1575	0.9873016
A08	29944031	29946060	A08p38040.2_BraZ1	1682	-	1252	2024	2029	0.9975357
A08	29948697	29950409	A08p38050.2_BraZ1	14620.5	+	234	1446	1712	0.8446262
A08	29953201	29955167	A08p38060.2_BraZ1	1449.92	+	1542	1966	1966	1.0000000
A08	29956105	29962771	A08p38070.2_BraZ1	1260	+	3393	6043	6666	0.9065406
A08	29957420	29957828	A08p38080.2_BraZ1	40.8	+	118	408	408	1.0000000
A08	29963747	29965271	A08p38090.2_BraZ1	1933.71	-	620	1464	1524	0.9606299
A08	29966142	29968694	A08p38100.2_BraZ1	1544.18	+	462	2358	2552	0.9239812
A08	29970275	29972498	A08p38110.2_BraZ1	222.3	+	859	2223	2223	1.0000000
A08	29973661	29974233	A08p38120.2_BraZ1	267	+	784	572	572	1.0000000
A08	29976711	29977038	A08p38130.2_BraZ1	32.7	+	12	133	327	0.4067278
A08	29979742	29980075	A08p38140.2_BraZ1	33.3	+	558	333	333	1.0000000
A08	29980384	29982625	A08p38150.2_BraZ1	958.974	-	1723	2241	2241	1.0000000
A08	29984315	29985545	A08p38160.2_BraZ1	789	+	994	1230	1230	1.0000000
A08	29986603	29987578	A08p38170.2_BraZ1	97.5	-	460	975	975	1.0000000
A08	29990551	29995296	A08p38180.2_BraZ1	1091.21	-	2507	4522	4745	0.9530032
A08	29996057	30002376	A08p38190.2_BraZ1	2907.5	+	4250	6271	6319	0.9924039
A08	30003108	30005379	A08p38200.2_BraZ1	1470.74	-	712	2261	2271	0.9955966
A08	30006446	30008864	A08p38210.2_BraZ1	2166.61	-	881	2279	2418	0.9425145
A08	30009584	30011976	A08p38220.2_BraZ1	1265	-	1494	2392	2392	1.0000000
A08	30013121	30013651	A08p38230.2_BraZ1	219	-	346	530	530	1.0000000
A08	30015047	30016289	A08p38240.2_BraZ1	617.553	+	1982	1203	1242	0.9685990
A08	30017056	30018888	A08p38250.2_BraZ1	552	+	2404	1771	1832	0.9667031
A08	30020295	30020790	A08p38260.2_BraZ1	47.7	-	715	495	495	1.0000000
A08	30021676	30021832	A08p38270.2_BraZ1	15.6	+	10	120	156	0.7692308
A08	30022645	30024263	A08p38280.2_BraZ1	117.6	+	617	1531	1618	0.9462299
A08	30025250	30030545	A08p38290.2_BraZ1	2096.59	+	1597	4335	5295	0.8186969
A08	30032139	30033888	A08p38300.2_BraZ1	741.818	-	789	1669	1749	0.9542596
A08	30035215	30038492	A08p38310.2_BraZ1	987.609	+	2611	3211	3277	0.9798597
A08	30042999	30043494	A08p38320.2_BraZ1	49.5	+	285	495	495	1.0000000
A08	30046113	30049305	A08p38330.2_BraZ1	2436.34	-	562	2833	3192	0.8875313
A08	30051015	30056075	A08p38340.2_BraZ1	2831.96	+	2662	4992	5060	0.9865612
A08	30056649	30061742	A08p38350.2_BraZ1	2624.2	+	537	3168	5093	0.6220303
A08	30064993	30067351	A08p38360.2_BraZ1	1025.88	+	995	2028	2358	0.8600509
A08	30068257	30069651	A08p38370.2_BraZ1	842.154	-	502	1394	1394	1.0000000
A08	30071030	30072215	A08p38380.2_BraZ1	621.714	-	865	1185	1185	1.0000000
A08	30072553	30075007	A08p38390.2_BraZ1	985.091	+	2115	2285	2454	0.9311329
A08	30075495	30076734	A08p38400.2_BraZ1	750.273	-	466	1196	1239	0.9652946
A08	30077333	30079774	A08p38410.2_BraZ1	1025.14	+	556	2292	2441	0.9389594
A08	30080679	30084323	A08p38420.2_BraZ1	1701.99	-	2063	3418	3644	0.9379802
A08	30085298	30097595	A08p38430.2_BraZ1	1215.02	+	3555	5567	12297	0.4527120
A08	30099779	30105956	A08p38440.2_BraZ1	792.647	+	125	1266	6177	0.2049539
A08	30106660	30109540	A08p38450.2_BraZ1	1034.06	-	1428	2878	2880	0.9993055
A08	30111240	30113338	A08p38460.2_BraZ1	356.786	+	816	1458	2098	0.6949475
A08	30114646	30117063	A08p38470.2_BraZ1	2088	+	720	2286	2417	0.9458006
A08	30117552	30120274	A08p38480.2_BraZ1	2559	-	466	2331	2722	0.8563556
A08	30122349	30123814	A08p38490.2_BraZ1	1094.32	+	1064	1465	1465	1.0000000
A08	30130208	30131459	A08p38500.2_BraZ1	3114.38	+	1251	1251	1251	1.0000000
A08	30132095	30132757	A08p38510.2_BraZ1	456.857	-	344	662	662	1.0000000
A08	30134001	30134604	A08p38520.2_BraZ1	59.4	+	823	603	603	1.0000000
A08	30135439	30136711	A08p38530.2_BraZ1	1032	-	1026	1189	1272	0.9347484
A08	30136945	30138840	A08p38540.2_BraZ1	1322.25	+	545	1347	1895	0.7108179
A08	30139254	30145008	A08p38550.2_BraZ1	2043.41	-	3417	5591	5754	0.9716719
A08	30146346	30150194	A08p38560.2_BraZ1	2964	-	428	2244	3848	0.5831601
A08	30151160	30152728	A08p38570.2_BraZ1	3686.57	-	546	1429	1568	0.9113520
A08	30152858	30154407	A08p38580.2_BraZ1	561.043	+	353	1276	1549	0.8237573
A08	30155627	30157303	A08p38590.2_BraZ1	1074.62	+	892	1676	1676	1.0000000
A08	30157632	30159189	A08p38600.2_BraZ1	903	-	726	1548	1557	0.9942197
A08	30159980	30161360	A08p38610.2_BraZ1	1062	+	1041	1380	1380	1.0000000
A08	30162037	30163328	A08p38620.2_BraZ1	594.92	-	534	1240	1291	0.9604957
A08	30165254	30166176	A08p38630.2_BraZ1	678.652	+	243	871	922	0.9446855
A08	30166351	30168393	A08p38640.2_BraZ1	1064.76	-	974	2042	2042	1.0000000
A08	30169280	30169620	A08p38650.2_BraZ1	234	-	334	309	340	0.9088235
A08	30171164	30171620	A08p38660.2_BraZ1	45.6	-	99	456	456	1.0000000
A08	30174073	30178589	A08p38670.2_BraZ1	2672.46	+	1806	4324	4516	0.9574845
A08	30179109	30180324	A08p38680.2_BraZ1	121.5	-	324	1108	1215	0.9119341
A08	30181234	30185074	A08p38690.2_BraZ1	1548.03	-	2664	3840	3840	1.0000000
A08	30185758	30187273	A08p38700.2_BraZ1	600	-	567	1477	1515	0.9749175
A08	30187683	30189961	A08p38710.2_BraZ1	720.865	+	1518	2278	2278	1.0000000
A08	30190428	30192405	A08p38720.2_BraZ1	408.85	-	1408	1844	1977	0.9327263
A08	30194533	30197291	A08p38730.2_BraZ1	1343.71	-	1343	2758	2758	1.0000000
A08	30198999	30202783	A08p38740.2_BraZ1	1902.79	-	3289	3784	3784	1.0000000
A08	30203568	30205047	A08p38750.2_BraZ1	147.9	-	749	1475	1479	0.9972955
A08	30205249	30206609	A08p38760.2_BraZ1	473.455	+	1397	1360	1360	1.0000000
A08	30207155	30214468	A08p38770.2_BraZ1	1696.38	-	5409	7172	7313	0.9807193
A08	30215056	30216657	A08p38780.2_BraZ1	1023.22	-	466	1564	1601	0.9768894
A08	30219718	30221412	A08p38790.2_BraZ1	1362	+	1541	1694	1694	1.0000000
A08	30224596	30226930	A08p38800.2_BraZ1	673.393	+	2531	2334	2334	1.0000000
A08	30228494	30230128	A08p38810.2_BraZ1	2757.86	+	892	1634	1634	1.0000000
A08	30230305	30235465	A08p38820.2_BraZ1	3262.86	-	2119	4690	5160	0.9089147
A08	30236273	30238338	A08p38830.2_BraZ1	905.804	-	2193	1980	2065	0.9588377
A08	30241831	30243265	A08p38840.2_BraZ1	1365	+	827	1332	1434	0.9288703
A08	30243791	30245153	A08p38850.2_BraZ1	1025.38	-	1062	1214	1362	0.8913363
A08	30245932	30249926	A08p38860.2_BraZ1	1793.45	+	2090	3813	3994	0.9546821
A08	30250565	30254268	A08p38870.2_BraZ1	1441.1	-	2616	3602	3703	0.9727248
A08	30261562	30264169	A08p38880.2_BraZ1	1617.87	+	1474	2562	2607	0.9827388
A08	30268033	30268300	A08p38890.2_BraZ1	26.7	+	52	267	267	1.0000000
A08	30269632	30273106	A08p38900.2_BraZ1	1300.29	+	680	2979	3474	0.8575130
A08	30275981	30279111	A08p38910.2_BraZ1	1392.14	+	1375	2740	3130	0.8753994
A08	30280079	30282180	A08p38920.2_BraZ1	656.97	+	1467	2101	2101	1.0000000
A08	30283399	30284731	A08p38930.2_BraZ1	882.45	+	655	1149	1332	0.8626126
A08	30285879	30287535	A08p38940.2_BraZ1	1104	+	158	831	1656	0.5018116
A08	30288332	30289377	A08p38950.2_BraZ1	507	-	93	881	1045	0.8430622
A08	30294858	30297753	A08p38960.2_BraZ1	1293.65	+	1423	2803	2895	0.9682211
A08	30300242	30300636	A08p38970.2_BraZ1	312	-	0	0	394	0.0000000
A08	30301372	30301510	A08p38980.2_BraZ1	13.8	-	50	138	138	1.0000000
A08	30301614	30302736	A08p38990.2_BraZ1	112.2	+	900	1085	1122	0.9670232
A08	30304374	30308352	A08p39000.2_BraZ1	2288	+	3890	3978	3978	1.0000000
A08	30308674	30310898	A08p39010.2_BraZ1	13104	-	2102	2224	2224	1.0000000
A08	30311698	30314084	A08p39020.2_BraZ1	1269	+	1268	2176	2386	0.9119866
A08	30314534	30316886	A08p39030.2_BraZ1	235.2	+	2160	2352	2352	1.0000000
A08	30317312	30319428	A08p39040.2_BraZ1	1938	+	694	1990	2116	0.9404537
A08	30320793	30326561	A08p39050.2_BraZ1	1924.68	+	5433	5752	5768	0.9972261
A08	30327371	30328964	A08p39060.2_BraZ1	1188	-	1181	1593	1593	1.0000000
A08	30329803	30332374	A08p39070.2_BraZ1	11922.8	+	1545	2571	2571	1.0000000
A08	30333602	30336120	A08p39080.2_BraZ1	2238	+	1552	2256	2518	0.8959492
A08	30338884	30340248	A08p39090.2_BraZ1	396	-	46	870	1364	0.6378299
A08	30341320	30342942	A08p39100.2_BraZ1	858.852	+	850	1622	1622	1.0000000
A08	30344465	30347371	A08p39110.2_BraZ1	28200	+	886	2891	2906	0.9948382
A08	30348855	30352066	A08p39120.2_BraZ1	1162.91	+	1745	3030	3211	0.9436313
A08	30352944	30358729	A08p39130.2_BraZ1	2995.04	+	2036	5625	5785	0.9723423
A08	30359854	30360985	A08p39140.2_BraZ1	855.5	+	508	1131	1131	1.0000000
A08	30362259	30363575	A08p39150.2_BraZ1	656.413	+	629	1316	1316	1.0000000
A08	30364714	30367240	A08p39160.2_BraZ1	1242.62	-	1224	2493	2526	0.9869359
A08	30368036	30370043	A08p39170.2_BraZ1	200.7	+	545	1858	2007	0.9257599
A08	30370124	30370367	A08p39180.2_BraZ1	24.3	+	34	186	243	0.7654321
A08	30373438	30375318	A08p39190.2_BraZ1	987	-	404	1588	1880	0.8446808
A08	30378728	30379320	A08p39200.2_BraZ1	387	+	18	328	592	0.5540541
A08	30381474	30383798	A08p39210.2_BraZ1	1242	+	692	2322	2324	0.9991394
A08	30385505	30386087	A08p39220.2_BraZ1	58.2	+	1504	582	582	1.0000000
A08	30388191	30392192	A08p39230.2_BraZ1	2480.28	+	2724	3722	4001	0.9302675
A08	30395266	30396962	A08p39240.2_BraZ1	462	+	966	1617	1696	0.9534198
A08	30396043	30396678	A08p39250.2_BraZ1	494.062	-	720	635	635	1.0000000
A08	30397689	30398082	A08p39260.2_BraZ1	39.3	+	228	393	393	1.0000000
A08	30410712	30411009	A08p39270.2_BraZ1	261	+	487	297	297	1.0000000
A08	30411647	30412685	A08p39280.2_BraZ1	424	+	686	1038	1038	1.0000000
A08	30413432	30422733	A08p39290.2_BraZ1	3962.44	-	1534	5559	9301	0.5976776
A08	30424458	30425000	A08p39300.2_BraZ1	255	+	248	542	542	1.0000000
A08	30426074	30432530	A08p39310.2_BraZ1	1189.2	-	4493	6264	6456	0.9702602
A08	30434853	30437606	A08p39320.2_BraZ1	1209.92	+	1680	1990	2753	0.7228478
A08	30438459	30439344	A08p39330.2_BraZ1	411	-	571	885	885	1.0000000
A08	30440219	30441194	A08p39340.2_BraZ1	660	-	503	848	975	0.8697436
A08	30442108	30442594	A08p39350.2_BraZ1	48.6	-	564	486	486	1.0000000
A08	30443503	30446256	A08p39360.2_BraZ1	1726.37	-	922	2658	2753	0.9654922
A08	30448031	30449988	A08p39370.2_BraZ1	945.086	+	1258	1822	1957	0.9310169
A08	30450732	30450933	A08p39380.2_BraZ1	20.1	+	84	190	201	0.9452736
A08	30451146	30453745	A08p39390.2_BraZ1	1860	+	893	2545	2599	0.9792228
A08	30454153	30455248	A08p39400.2_BraZ1	556.875	+	876	1095	1095	1.0000000
A08	30455922	30457469	A08p39410.2_BraZ1	1041.43	-	815	1547	1547	1.0000000
A08	30459788	30460888	A08p39420.2_BraZ1	488.423	+	1165	1100	1100	1.0000000
A08	30463299	30471692	A08p39430.2_BraZ1	3939.23	+	1923	7756	8393	0.9241034
A08	30472173	30472814	A08p39440.2_BraZ1	483	+	413	641	641	1.0000000
A08	30473855	30474851	A08p39450.2_BraZ1	444	+	495	946	996	0.9497992
A08	30475365	30475902	A08p39460.2_BraZ1	53.7	+	289	537	537	1.0000000
A08	30477277	30478054	A08p39470.2_BraZ1	77.7	+	2	8	777	0.0102960
A08	30479643	30481205	A08p39480.2_BraZ1	667.5	-	96	952	1562	0.6094750
A08	30489891	30490437	A08p39490.2_BraZ1	54.6	+	421	546	546	1.0000000
A08	30490573	30494767	A08p39500.2_BraZ1	1754.67	-	2458	4150	4194	0.9895088
A08	30494756	30497880	A08p39510.2_BraZ1	760.308	-	2360	3124	3124	1.0000000
A08	30498253	30500403	A08p39520.2_BraZ1	1296.51	-	802	2130	2150	0.9906977
A08	30501537	30505647	A08p39530.2_BraZ1	2169.74	+	1398	3707	4110	0.9019465
A08	30506492	30511315	A08p39540.2_BraZ1	1877.5	-	1101	4152	4823	0.8608750
A08	30512492	30513658	A08p39550.2_BraZ1	816	+	96	1019	1166	0.8739280
A08	30517761	30518379	A08p39560.2_BraZ1	274.909	-	538	618	618	1.0000000
A08	30519469	30522879	A08p39570.2_BraZ1	1502.52	-	1249	3359	3410	0.9850440
A08	30524078	30526867	A08p39580.2_BraZ1	1509	+	1360	2789	2789	1.0000000
A08	30527711	30531469	A08p39590.2_BraZ1	1141.92	-	720	3251	3758	0.8650878
A08	30533513	30535853	A08p39600.2_BraZ1	1490.7	+	492	2173	2340	0.9286325
A08	30536838	30538562	A08p39610.2_BraZ1	854.449	+	368	1483	1724	0.8602088
A08	30539788	30540247	A08p39620.2_BraZ1	45.9	+	705	459	459	1.0000000
A08	30540820	30544892	A08p39630.2_BraZ1	2846.71	+	2017	3615	4072	0.8877701
A08	30547639	30548305	A08p39640.2_BraZ1	66.6	+	345	580	666	0.8708709
A08	30549952	30551155	A08p39650.2_BraZ1	120.3	-	1258	1203	1203	1.0000000
A08	30553649	30554862	A08p39660.2_BraZ1	626.946	+	2538	1213	1213	1.0000000
A08	30560520	30562002	A08p39670.2_BraZ1	921.3	+	456	831	1482	0.5607287
A08	30564818	30566360	A08p39680.2_BraZ1	984.375	-	624	1542	1542	1.0000000
A08	30567482	30569226	A08p39690.2_BraZ1	755.798	+	153	624	1744	0.3577982
A08	30572845	30574174	A08p39700.2_BraZ1	873.409	-	781	1248	1329	0.9390519
A08	30574767	30575292	A08p39710.2_BraZ1	52.5	-	181	525	525	1.0000000
A08	30575954	30576659	A08p39720.2_BraZ1	70.5	-	16	366	705	0.5191489
A08	30579896	30581571	A08p39730.2_BraZ1	1293.6	+	386	1584	1675	0.9456716
A08	30582589	30584346	A08p39740.2_BraZ1	819.231	+	1148	1757	1757	1.0000000
A08	30584584	30586402	A08p39750.2_BraZ1	181.8	-	266	1638	1818	0.9009901
A08	30586668	30588943	A08p39760.2_BraZ1	1714.26	+	913	2174	2275	0.9556044
A08	30589445	30590735	A08p39770.2_BraZ1	129	+	55	523	1290	0.4054264
A08	30591077	30592265	A08p39780.2_BraZ1	118.8	-	901	1188	1188	1.0000000
A08	30594736	30595078	A08p39790.2_BraZ1	34.2	-	122	278	342	0.8128655
A08	30597685	30599041	A08p39800.2_BraZ1	135.6	+	437	1356	1356	1.0000000
A08	30599553	30600227	A08p39810.2_BraZ1	761.4	+	383	634	674	0.9406528
A08	30600620	30603135	A08p39820.2_BraZ1	230.4	-	1513	2435	2515	0.9681908
A08	30607051	30610928	A08p39830.2_BraZ1	1314	+	568	2860	3877	0.7376838
A08	30615073	30615319	A08p39840.2_BraZ1	24.6	-	89	246	246	1.0000000
A08	30615365	30615497	A08p39850.2_BraZ1	13.2	+	88	132	132	1.0000000
A08	30615785	30621470	A08p39860.2_BraZ1	2352.82	-	2913	5304	5685	0.9329816
A08	30623386	30624118	A08p39870.2_BraZ1	73.2	-	100	717	732	0.9795082
A08	30626449	30626834	A08p39880.2_BraZ1	207	-	312	385	385	1.0000000
A08	30626937	30631257	A08p39890.2_BraZ1	2542.4	-	495	1870	4320	0.4328704
A08	30631384	30633936	A08p39900.2_BraZ1	507.5	-	1762	2552	2552	1.0000000
A08	30634189	30635934	A08p39910.2_BraZ1	8946	+	336	1217	1745	0.6974212
A08	30636657	30640757	A08p39920.2_BraZ1	2001.55	-	1097	3686	4100	0.8990244
A08	30642019	30647136	A08p39930.2_BraZ1	2413.42	-	3683	5027	5117	0.9824116
A08	30649275	30651602	A08p39940.2_BraZ1	1037.96	+	1953	2327	2327	1.0000000
A08	30652434	30653251	A08p39950.2_BraZ1	623.409	+	750	817	817	1.0000000
A08	30653588	30655612	A08p39960.2_BraZ1	1143.99	+	1622	2001	2024	0.9886364
A08	30656600	30656966	A08p39970.2_BraZ1	36.6	+	31	323	366	0.8825136
A08	30657713	30659131	A08p39980.2_BraZ1	744.545	+	511	1127	1418	0.7947814
A08	30660134	30662148	A08p39990.2_BraZ1	1731	-	456	1570	2014	0.7795432
A08	30666693	30668253	A08p40000.2_BraZ1	1392.54	+	110	1012	1560	0.6487179
A08	30669259	30670184	A08p40010.2_BraZ1	1846.25	+	633	919	925	0.9935135
A08	30671357	30671909	A08p40020.2_BraZ1	55.2	-	582	552	552	1.0000000
A08	30672456	30673594	A08p40030.2_BraZ1	309.6	-	1405	1138	1138	1.0000000
A08	30676618	30678705	A08p40040.2_BraZ1	1674.67	+	968	2063	2087	0.9885002
A08	30679144	30680570	A08p40050.2_BraZ1	1173	+	565	1416	1426	0.9929874
A08	30681275	30684530	A08p40060.2_BraZ1	548.471	+	2249	3255	3255	1.0000000
A08	30685795	30686074	A08p40070.2_BraZ1	27	+	6	114	279	0.4086021
A08	30687120	30689274	A08p40080.2_BraZ1	815.571	-	1894	2118	2154	0.9832869
A08	30689761	30694404	A08p40090.2_BraZ1	2914.18	-	1823	4547	4643	0.9793237
A08	30697825	30699304	A08p40100.2_BraZ1	147.9	-	939	1479	1479	1.0000000
A08	30699655	30701207	A08p40110.2_BraZ1	769.406	-	789	1549	1552	0.9980670
A08	30701972	30704335	A08p40120.2_BraZ1	1015.57	-	2135	2363	2363	1.0000000
A08	30708635	30709630	A08p40130.2_BraZ1	774	-	576	931	995	0.9356784
A08	30711232	30718299	A08p40140.2_BraZ1	916.773	-	3053	6215	7067	0.8794397
A08	30716237	30717539	A08p40150.2_BraZ1	195	-	831	1244	1302	0.9554532
A08	30719743	30720808	A08p40160.2_BraZ1	106.5	-	245	353	1065	0.3314554
A08	30725606	30728325	A08p40170.2_BraZ1	880.5	-	727	2633	2719	0.9683707
A08	30730834	30731659	A08p40180.2_BraZ1	295.314	-	269	825	825	1.0000000
A08	30736801	30737538	A08p40190.2_BraZ1	456	+	46	488	737	0.6621438
A08	30738217	30738544	A08p40200.2_BraZ1	32.7	+	0	0	327	0.0000000
A08	30738602	30738800	A08p40210.2_BraZ1	19.8	-	1	10	198	0.0505050
A08	30740338	30741176	A08p40220.2_BraZ1	486	+	88	538	838	0.6420048
A09	9749	10286	A09p00010.2_BraZ1	53.7	-	88	537	537	1.0000000
A09	10803	13331	A09p00020.2_BraZ1	1722.52	+	436	2336	2528	0.9240506
A09	13709	16081	A09p00030.2_BraZ1	573.333	-	1027	2222	2372	0.9367622
A09	16086	17416	A09p00040.2_BraZ1	1188	+	367	1317	1330	0.9902256
A09	18130	25013	A09p00050.2_BraZ1	3517.94	-	1936	6188	6883	0.8990266
A09	25370	26058	A09p00060.2_BraZ1	61.8	+	435	688	688	1.0000000
A09	26256	26675	A09p00070.2_BraZ1	195	-	663	419	419	1.0000000
A09	27932	32915	A09p00080.2_BraZ1	808.056	+	1101	3581	4983	0.7186434
A09	28917	29846	A09p00090.2_BraZ1	432	-	336	929	929	1.0000000
A09	37182	37818	A09p00100.2_BraZ1	63.6	+	107	458	636	0.7201258
A09	38381	40546	A09p00110.2_BraZ1	1062.62	+	794	2136	2165	0.9866051
A09	41190	42493	A09p00120.2_BraZ1	129.3	-	249	1097	1303	0.8419033
A09	43456	44680	A09p00130.2_BraZ1	846.229	-	1141	1200	1224	0.9803922
A09	49092	51508	A09p00140.2_BraZ1	1641.94	+	2934	2416	2416	1.0000000
A09	53122	53260	A09p00150.2_BraZ1	13.8	-	185	138	138	1.0000000
A09	53534	55223	A09p00160.2_BraZ1	168.9	-	419	1410	1689	0.8348135
A09	61632	64221	A09p00170.2_BraZ1	689.841	-	699	2043	2589	0.7891077
A09	66679	66979	A09p00180.2_BraZ1	30	+	195	300	300	1.0000000
A09	131082	132390	A09p00190.2_BraZ1	1846.88	-	1205	1308	1308	1.0000000
A09	133012	134583	A09p00200.2_BraZ1	896.966	-	678	1429	1571	0.9096117
A09	136754	138140	A09p00210.2_BraZ1	669	-	380	1031	1386	0.7438672
A09	141925	143921	A09p00220.2_BraZ1	675	+	308	1451	1996	0.7269539
A09	146167	146608	A09p00230.2_BraZ1	44.1	+	217	441	441	1.0000000
A09	146861	148312	A09p00240.2_BraZ1	15400	-	926	1451	1451	1.0000000
A09	149107	152318	A09p00250.2_BraZ1	1934.47	+	668	2787	3211	0.8679539
A09	154092	155581	A09p00260.2_BraZ1	8424	+	1087	1478	1489	0.9926125
A09	157709	160116	A09p00270.2_BraZ1	1683.69	+	208	1305	2407	0.5421687
A09	166617	169673	A09p00280.2_BraZ1	1975.92	+	425	2067	3056	0.6763743
A09	173537	174919	A09p00290.2_BraZ1	923.423	+	173	1228	1382	0.8885673
A09	177818	179491	A09p00300.2_BraZ1	1225.12	-	669	1658	1673	0.9910341
A09	180689	183322	A09p00310.2_BraZ1	81.3	+	1166	2270	2633	0.8621345
A09	184909	187460	A09p00320.2_BraZ1	34734	+	1027	2507	2551	0.9827518
A09	188377	190434	A09p00330.2_BraZ1	25459.2	+	117	1333	2057	0.6480311
A09	191065	191470	A09p00340.2_BraZ1	231	-	15	56	405	0.1382716
A09	195380	197236	A09p00350.2_BraZ1	44520	+	146	483	1856	0.2602371
A09	197641	200700	A09p00360.2_BraZ1	1261.07	-	1277	3057	3059	0.9993462
A09	229655	232251	A09p00370.2_BraZ1	1537.2	-	475	1787	2596	0.6883667
A09	233588	234873	A09p00380.2_BraZ1	10327.5	-	292	1253	1285	0.9750973
A09	237723	238424	A09p00390.2_BraZ1	6120	-	207	587	701	0.8373752
A09	243634	246519	A09p00400.2_BraZ1	3272.5	+	212	2276	2885	0.7889081
A09	248710	256895	A09p00410.2_BraZ1	5365.05	+	539	3320	8185	0.4056200
A09	257530	262491	A09p00420.2_BraZ1	789.389	-	1343	4291	4961	0.8649466
A09	261328	266713	A09p00430.2_BraZ1	1387.76	-	1194	4024	5385	0.7472609
A09	270081	272245	A09p00440.2_BraZ1	1491.49	+	614	1848	2164	0.8539741
A09	273762	275656	A09p00450.2_BraZ1	1938	-	424	958	1894	0.5058078
A09	278446	285660	A09p00460.2_BraZ1	2485.1	-	2659	6876	7214	0.9531466
A09	287011	287936	A09p00470.2_BraZ1	341.25	-	485	925	925	1.0000000
A09	288486	290513	A09p00480.2_BraZ1	1071.47	+	615	2007	2027	0.9901332
A09	290922	292035	A09p00490.2_BraZ1	738.939	-	338	1113	1113	1.0000000
A09	296049	298600	A09p00500.2_BraZ1	1184.03	+	1103	2388	2551	0.9361035
A09	299360	304373	A09p00510.2_BraZ1	637.053	-	1291	3678	5013	0.7336924
A09	305410	307596	A09p00520.2_BraZ1	1339.26	+	1389	2186	2186	1.0000000
A09	308649	311358	A09p00530.2_BraZ1	1405.76	-	1790	2669	2709	0.9852344
A09	313074	317274	A09p00540.2_BraZ1	2387.83	-	1363	3677	4200	0.8754762
A09	319903	322504	A09p00550.2_BraZ1	1469.54	-	1541	2601	2601	1.0000000
A09	323223	324588	A09p00560.2_BraZ1	1073.17	+	835	1329	1365	0.9736264
A09	488177	489542	A09p00570.2_BraZ1	930.17	+	384	1135	1365	0.8315018
A09	490423	498731	A09p00580.2_BraZ1	1339	-	1871	5396	8308	0.6494945
A09	500973	502871	A09p00590.2_BraZ1	1136.37	-	853	1795	1898	0.9457324
A09	504621	507645	A09p00600.2_BraZ1	1181.83	-	1852	2988	3024	0.9880952
A09	507950	514321	A09p00610.2_BraZ1	2221.94	+	4568	6351	6371	0.9968608
A09	521277	522983	A09p00620.2_BraZ1	798.261	-	1658	1706	1706	1.0000000
A09	523865	524921	A09p00630.2_BraZ1	105.6	-	312	889	1056	0.8418561
A09	525558	528149	A09p00640.2_BraZ1	1471.21	-	1076	2274	2591	0.8776534
A09	537086	538226	A09p00650.2_BraZ1	12739.5	+	938	1140	1140	1.0000000
A09	538978	540050	A09p00660.2_BraZ1	648.818	+	171	1022	1072	0.9533582
A09	540841	541530	A09p00670.2_BraZ1	618	-	651	689	689	1.0000000
A09	543243	543372	A09p00680.2_BraZ1	12.9	+	194	129	129	1.0000000
A09	547206	554892	A09p00690.2_BraZ1	4146.12	+	1805	7007	7686	0.9116576
A09	559144	560287	A09p00700.2_BraZ1	464.625	-	783	1111	1143	0.9720035
A09	561957	562860	A09p00710.2_BraZ1	90.3	+	13	305	903	0.3377630
A09	567689	570329	A09p00720.2_BraZ1	1046.06	+	1432	2640	2640	1.0000000
A09	571298	573324	A09p00730.2_BraZ1	980.679	-	699	1717	2026	0.8474827
A09	576438	578736	A09p00740.2_BraZ1	1933.88	+	871	2194	2298	0.9547433
A09	580116	581888	A09p00750.2_BraZ1	1374	+	434	1434	1772	0.8092551
A09	584286	585732	A09p00760.2_BraZ1	144.6	+	215	1180	1446	0.8160443
A09	587109	587919	A09p00770.2_BraZ1	288	-	0	0	810	0.0000000
A09	589025	589485	A09p00780.2_BraZ1	287.182	-	283	460	460	1.0000000
A09	592149	594138	A09p00790.2_BraZ1	1329.43	-	1205	1973	1989	0.9919558
A09	594794	596333	A09p00800.2_BraZ1	153.9	+	664	1539	1539	1.0000000
A09	596588	599414	A09p00810.2_BraZ1	282.6	+	691	2635	2826	0.9324133
A09	599863	601537	A09p00820.2_BraZ1	13198.5	+	748	1574	1674	0.9402629
A09	602053	607634	A09p00830.2_BraZ1	2379	-	3683	5532	5581	0.9912202
A09	609912	610713	A09p00840.2_BraZ1	422.182	-	564	801	801	1.0000000
A09	610962	612898	A09p00850.2_BraZ1	1204.37	+	724	1936	1936	1.0000000
A09	616539	618214	A09p00860.2_BraZ1	1539	-	499	1424	1675	0.8501493
A09	770311	771499	A09p00870.2_BraZ1	1047	-	482	1088	1188	0.9158249
A09	776622	780807	A09p00880.2_BraZ1	1765.69	+	1501	3682	4185	0.8798088
A09	787939	788836	A09p00890.2_BraZ1	89.7	+	265	833	897	0.9286510
A09	795118	797028	A09p00900.2_BraZ1	1317.5	+	622	1910	1910	1.0000000
A09	797274	798307	A09p00910.2_BraZ1	738	-	741	1033	1033	1.0000000
A09	803295	807788	A09p00920.2_BraZ1	3119.85	+	1523	3999	4493	0.8900512
A09	813568	813970	A09p00930.2_BraZ1	40.2	+	37	177	402	0.4402985
A09	816096	816443	A09p00940.2_BraZ1	279	+	287	347	347	1.0000000
A09	817311	818807	A09p00950.2_BraZ1	742.118	+	691	1496	1496	1.0000000
A09	819328	821452	A09p00960.2_BraZ1	1126.7	-	571	2099	2124	0.9882298
A09	825628	835157	A09p00970.2_BraZ1	4681.92	+	2931	7343	9529	0.7705950
A09	837939	839398	A09p00980.2_BraZ1	1017.16	-	356	1382	1459	0.9472241
A09	842412	843108	A09p00990.2_BraZ1	69.6	+	77	368	696	0.5287356
A09	848881	850886	A09p01000.2_BraZ1	1033.76	+	573	1675	2005	0.8354115
A09	861119	862622	A09p01010.2_BraZ1	984.107	+	563	1467	1503	0.9760479
A09	865319	866078	A09p01020.2_BraZ1	75.9	-	174	445	759	0.5862978
A09	866721	868479	A09p01030.2_BraZ1	589.056	+	717	1600	1758	0.9101251
A09	872672	873605	A09p01040.2_BraZ1	93.3	+	366	884	933	0.9474812
A09	877409	878863	A09p01050.2_BraZ1	630.585	+	1540	1454	1454	1.0000000
A09	879540	879756	A09p01060.2_BraZ1	21.6	+	0	0	216	0.0000000
A09	947297	949239	A09p01070.2_BraZ1	684	-	531	1633	1942	0.8408857
A09	954293	955583	A09p01080.2_BraZ1	129	+	364	1152	1290	0.8930233
A09	966256	968657	A09p01090.2_BraZ1	1054.35	-	2305	2401	2401	1.0000000
A09	973003	977973	A09p01100.2_BraZ1	951.579	-	3475	4887	4970	0.9832998
A09	981204	984022	A09p01110.2_BraZ1	752.156	-	1967	2818	2818	1.0000000
A09	984808	987151	A09p01120.2_BraZ1	234.3	+	910	2332	2343	0.9953052
A09	987220	987613	A09p01130.2_BraZ1	38.1	-	88	364	393	0.9262087
A09	988140	988444	A09p01140.2_BraZ1	246	-	0	0	304	0.0000000
A09	988444	988779	A09p01150.2_BraZ1	213	-	2	34	335	0.1014925
A09	991616	992900	A09p01160.2_BraZ1	781.889	+	487	1248	1284	0.9719626
A09	994669	996622	A09p01170.2_BraZ1	978.145	+	1799	1953	1953	1.0000000
A09	997111	998865	A09p01180.2_BraZ1	804.75	-	1237	1754	1754	1.0000000
A09	1001424	1004541	A09p01190.2_BraZ1	1809	+	1691	3117	3117	1.0000000
A09	1004924	1005938	A09p01200.2_BraZ1	735	-	695	1014	1014	1.0000000
A09	1013413	1014618	A09p01210.2_BraZ1	8340.75	-	32	373	1205	0.3095436
A09	1038993	1040379	A09p01220.2_BraZ1	840	-	424	1044	1386	0.7532467
A09	1053711	1056814	A09p01230.2_BraZ1	1331.16	+	2072	3065	3103	0.9877538
A09	1058219	1060349	A09p01240.2_BraZ1	213	-	502	1905	2130	0.8943662
A09	1061466	1064393	A09p01250.2_BraZ1	2283.75	-	851	2782	2927	0.9504612
A09	1067648	1069336	A09p01260.2_BraZ1	13731	+	808	1584	1688	0.9383886
A09	1071772	1075220	A09p01270.2_BraZ1	1182	-	1586	2957	3448	0.8575986
A09	1076948	1079548	A09p01280.2_BraZ1	1720.5	+	14	491	2600	0.1888462
A09	1082798	1089400	A09p01290.2_BraZ1	3313.41	-	1405	5694	6602	0.8624659
A09	1090006	1091374	A09p01300.2_BraZ1	297.868	+	842	1368	1368	1.0000000
A09	1091383	1092354	A09p01310.2_BraZ1	258	+	490	971	971	1.0000000
A09	1092353	1092853	A09p01320.2_BraZ1	431.25	+	179	500	500	1.0000000
A09	1094525	1096296	A09p01330.2_BraZ1	1011.71	-	1974	1771	1771	1.0000000
A09	1100155	1101475	A09p01340.2_BraZ1	1236	+	788	1320	1320	1.0000000
A09	1103809	1105468	A09p01350.2_BraZ1	165.9	+	632	1603	1659	0.9662447
A09	1108844	1110908	A09p01360.2_BraZ1	1596	-	590	1567	2064	0.7592054
A09	1118130	1119289	A09p01370.2_BraZ1	693.84	-	403	1075	1159	0.9275237
A09	1121549	1124610	A09p01380.2_BraZ1	2681.1	-	210	2071	3061	0.6765763
A09	1126806	1131697	A09p01390.2_BraZ1	2295.26	+	2845	4665	4891	0.9537927
A09	1132845	1134158	A09p01400.2_BraZ1	210	-	1237	1313	1313	1.0000000
A09	1134277	1138828	A09p01410.2_BraZ1	1998.14	+	946	2930	4551	0.6438146
A09	1139111	1139573	A09p01420.2_BraZ1	46.2	+	495	462	462	1.0000000
A09	1139876	1142033	A09p01430.2_BraZ1	1527	-	597	1731	2157	0.8025035
A09	1142407	1143287	A09p01440.2_BraZ1	159	-	317	848	880	0.9636363
A09	1143488	1147557	A09p01450.2_BraZ1	2082.72	+	2497	4069	4069	1.0000000
A09	1148375	1150462	A09p01460.2_BraZ1	328.425	-	1254	2087	2087	1.0000000
A09	1154968	1158126	A09p01470.2_BraZ1	703.8	+	2814	3158	3158	1.0000000
A09	1164077	1165790	A09p01480.2_BraZ1	1347.33	+	98	986	1713	0.5755984
A09	1200564	1200942	A09p01490.2_BraZ1	228	+	1038	378	378	1.0000000
A09	1204567	1205117	A09p01500.2_BraZ1	339	-	13	325	550	0.5909091
A09	1206010	1206568	A09p01510.2_BraZ1	55.8	-	6	275	558	0.4928315
A09	1208266	1213982	A09p01520.2_BraZ1	4266.02	+	2148	4901	5716	0.8574178
A09	1216065	1218042	A09p01530.2_BraZ1	197.7	+	278	1243	1977	0.6287304
A09	1218830	1229522	A09p01540.2_BraZ1	2625	+	3068	6154	10692	0.5755705
A09	1230389	1232542	A09p01550.2_BraZ1	604.125	+	2181	2153	2153	1.0000000
A09	1232748	1236758	A09p01560.2_BraZ1	2281.5	+	1194	3637	4010	0.9069825
A09	1237522	1239508	A09p01570.2_BraZ1	198.6	+	885	1690	1986	0.8509567
A09	1243143	1245528	A09p01580.2_BraZ1	921.079	+	1517	2385	2385	1.0000000
A09	1250986	1252285	A09p01590.2_BraZ1	5556.21	-	1401	1299	1299	1.0000000
A09	1253554	1254109	A09p01600.2_BraZ1	55.5	+	174	555	555	1.0000000
A09	1258332	1263193	A09p01610.2_BraZ1	2476.31	+	1942	4716	4861	0.9701707
A09	1265776	1269585	A09p01620.2_BraZ1	1874.18	+	561	2896	3809	0.7603046
A09	1271667	1274265	A09p01630.2_BraZ1	1489.3	-	361	2032	2598	0.7821401
A09	1279253	1281744	A09p01640.2_BraZ1	1655.5	-	32	246	2491	0.0987555
A09	1283360	1291606	A09p01650.2_BraZ1	1536.47	-	827	5130	8246	0.6221198
A09	1307317	1309848	A09p01660.2_BraZ1	1719	+	722	1364	2531	0.5389174
A09	1312265	1314415	A09p01670.2_BraZ1	3036	-	1005	2117	2150	0.9846511
A09	1315536	1317810	A09p01680.2_BraZ1	951	+	1695	1973	2274	0.8676341
A09	1319431	1321772	A09p01690.2_BraZ1	808.588	+	1163	2281	2341	0.9743699
A09	1323020	1325487	A09p01700.2_BraZ1	235.8	+	536	2169	2467	0.8792055
A09	1325943	1326396	A09p01710.2_BraZ1	45.3	+	295	453	453	1.0000000
A09	1386844	1387258	A09p01720.2_BraZ1	117.5	-	21	391	414	0.9444444
A09	1388277	1388721	A09p01730.2_BraZ1	285	-	471	444	444	1.0000000
A09	1389991	1393510	A09p01740.2_BraZ1	1292.01	+	1583	3332	3519	0.9468599
A09	1397451	1399210	A09p01750.2_BraZ1	1674	+	163	1470	1759	0.8357021
A09	1401338	1403390	A09p01760.2_BraZ1	8745	-	2316	2052	2052	1.0000000
A09	1406899	1409341	A09p01770.2_BraZ1	880.312	+	2016	2354	2442	0.9639640
A09	1410161	1411343	A09p01780.2_BraZ1	118.2	+	407	1077	1182	0.9111675
A09	1413401	1418899	A09p01790.2_BraZ1	2940	-	442	2931	5498	0.5331029
A09	1419418	1425773	A09p01800.2_BraZ1	2489.66	-	1009	5177	6355	0.8146341
A09	1427143	1428464	A09p01810.2_BraZ1	641.952	+	1096	1321	1321	1.0000000
A09	1429698	1431593	A09p01820.2_BraZ1	1383	+	555	1499	1895	0.7910290
A09	1433855	1438854	A09p01830.2_BraZ1	7177.93	+	909	2134	4999	0.4268854
A09	1439149	1440456	A09p01840.2_BraZ1	160.3	-	1215	1307	1307	1.0000000
A09	1442067	1443134	A09p01850.2_BraZ1	678.3	-	289	976	1067	0.9147142
A09	1444788	1445946	A09p01860.2_BraZ1	640	-	309	1077	1158	0.9300518
A09	1447390	1453967	A09p01870.2_BraZ1	1803.23	+	3005	5574	6577	0.8474988
A09	1454668	1456612	A09p01880.2_BraZ1	654.733	-	1974	1944	1944	1.0000000
A09	1458249	1461083	A09p01890.2_BraZ1	1502.02	+	2022	2791	2834	0.9848271
A09	1468035	1469395	A09p01900.2_BraZ1	632.348	+	311	1240	1360	0.9117647
A09	1469609	1470958	A09p01910.2_BraZ1	365.5	-	703	1349	1349	1.0000000
A09	1471440	1472889	A09p01920.2_BraZ1	144.9	+	278	1091	1449	0.7529331
A09	1474260	1476238	A09p01930.2_BraZ1	1139.48	+	1101	1955	1978	0.9883721
A09	1476768	1479373	A09p01940.2_BraZ1	1806	+	943	2195	2605	0.8426104
A09	1480908	1486278	A09p01950.2_BraZ1	1560.92	+	1477	4593	5370	0.8553073
A09	1486464	1490286	A09p01960.2_BraZ1	15975	-	935	3459	3822	0.9050236
A09	1495071	1495572	A09p01970.2_BraZ1	50.1	-	684	501	501	1.0000000
A09	1497440	1498541	A09p01980.2_BraZ1	109.2	-	289	1101	1101	1.0000000
A09	1500827	1501788	A09p01990.2_BraZ1	341.6	-	348	878	961	0.9136316
A09	1502288	1502993	A09p02000.2_BraZ1	471.706	+	234	670	705	0.9503546
A09	1503539	1506103	A09p02010.2_BraZ1	1325.45	-	3095	2564	2564	1.0000000
A09	1507749	1510034	A09p02020.2_BraZ1	1173.07	+	794	1630	2285	0.7133479
A09	1510453	1511691	A09p02030.2_BraZ1	840	-	17	445	1238	0.3594507
A09	1514141	1514948	A09p02040.2_BraZ1	80.7	-	7	438	807	0.5427510
A09	1518307	1525976	A09p02050.2_BraZ1	2155.63	-	3942	7476	7669	0.9748337
A09	1535138	1536530	A09p02060.2_BraZ1	966	+	1284	1357	1392	0.9748563
A09	1539304	1540329	A09p02070.2_BraZ1	356.053	+	850	1025	1025	1.0000000
A09	1542510	1544151	A09p02080.2_BraZ1	2415.93	+	1758	1641	1641	1.0000000
A09	1544529	1547584	A09p02090.2_BraZ1	819	-	1026	2746	3055	0.8988543
A09	1571953	1574391	A09p02100.2_BraZ1	1320.17	-	1644	2392	2438	0.9811321
A09	1583437	1587835	A09p02110.2_BraZ1	1608.75	+	1471	4045	4398	0.9197363
A09	1588952	1589558	A09p02120.2_BraZ1	60.6	+	210	606	606	1.0000000
A09	1589932	1591276	A09p02130.2_BraZ1	134.4	+	132	949	1344	0.7061012
A09	1592575	1594192	A09p02140.2_BraZ1	161.7	+	829	1470	1617	0.9090909
A09	1594514	1596058	A09p02150.2_BraZ1	572.927	-	1647	1544	1544	1.0000000
A09	1597159	1598752	A09p02160.2_BraZ1	159.3	+	504	1593	1593	1.0000000
A09	1599467	1602525	A09p02170.2_BraZ1	4084.89	+	1315	3052	3058	0.9980379
A09	1605244	1606432	A09p02180.2_BraZ1	118.8	+	181	1066	1188	0.8973064
A09	1607914	1610438	A09p02190.2_BraZ1	1366.53	-	1630	2468	2524	0.9778130
A09	1610678	1610894	A09p02200.2_BraZ1	21.6	-	270	216	216	1.0000000
A09	1614671	1616490	A09p02210.2_BraZ1	8580	-	410	1621	1819	0.8911490
A09	1618193	1619477	A09p02220.2_BraZ1	821.1	+	522	1246	1284	0.9704050
A09	1620315	1621704	A09p02230.2_BraZ1	869.4	+	236	1314	1389	0.9460043
A09	1622254	1626759	A09p02240.2_BraZ1	2467.79	-	1908	4407	4505	0.9782464
A09	1628513	1631453	A09p02250.2_BraZ1	1214.18	+	1358	1981	2940	0.6738095
A09	1631919	1634142	A09p02260.2_BraZ1	1107.69	-	950	2118	2223	0.9527665
A09	1635593	1637512	A09p02270.2_BraZ1	1111.25	-	1219	1915	1919	0.9979156
A09	1637820	1638906	A09p02280.2_BraZ1	497.964	+	440	1023	1086	0.9419889
A09	1639130	1641971	A09p02290.2_BraZ1	2167.16	-	1881	2814	2841	0.9904963
A09	1643709	1645448	A09p02300.2_BraZ1	1316	+	505	1590	1739	0.9143186
A09	1645508	1646794	A09p02310.2_BraZ1	537	-	278	1219	1286	0.9479005
A09	1648278	1651243	A09p02320.2_BraZ1	19200	-	656	2657	2965	0.8961214
A09	1652171	1656054	A09p02330.2_BraZ1	2053.62	+	2037	3729	3883	0.9603400
A09	1665248	1666367	A09p02340.2_BraZ1	14841	+	228	1115	1119	0.9964254
A09	1666429	1667205	A09p02350.2_BraZ1	207	+	174	396	776	0.5103093
A09	1668277	1669193	A09p02360.2_BraZ1	2085	-	63	565	916	0.6168122
A09	1670991	1672593	A09p02370.2_BraZ1	937.5	-	170	1008	1602	0.6292135
A09	1674775	1675168	A09p02380.2_BraZ1	39.3	-	8	110	393	0.2798982
A09	1675762	1676881	A09p02390.2_BraZ1	497.25	-	359	863	1119	0.7712243
A09	1678086	1680061	A09p02400.2_BraZ1	1328.96	+	346	1595	1975	0.8075950
A09	1681610	1683752	A09p02410.2_BraZ1	1643	+	252	1811	2142	0.8454715
A09	1684635	1686036	A09p02420.2_BraZ1	774.682	-	240	955	1401	0.6816559
A09	1690792	1692238	A09p02430.2_BraZ1	659.368	+	440	1412	1446	0.9764869
A09	1734252	1735563	A09p02440.2_BraZ1	1062	+	280	1311	1311	1.0000000
A09	1740003	1741614	A09p02450.2_BraZ1	720	+	859	1507	1611	0.9354438
A09	1742429	1743933	A09p02460.2_BraZ1	843	+	734	1221	1504	0.8118351
A09	1745159	1746695	A09p02470.2_BraZ1	918	+	351	898	1536	0.5846354
A09	1747601	1747727	A09p02480.2_BraZ1	12.6	-	10	84	126	0.6666667
A09	1747876	1749216	A09p02490.2_BraZ1	625.333	-	264	1153	1340	0.8604478
A09	1754042	1761284	A09p02500.2_BraZ1	8930.5	+	645	3327	7242	0.4594035
A09	1773500	1774174	A09p02510.2_BraZ1	363	-	384	674	674	1.0000000
A09	1776130	1777383	A09p02520.2_BraZ1	1146	-	329	1253	1253	1.0000000
A09	1778095	1779026	A09p02530.2_BraZ1	1452	-	371	930	931	0.9989259
A09	1783398	1786986	A09p02540.2_BraZ1	2123.2	-	1533	3504	3588	0.9765886
A09	1790555	1793489	A09p02550.2_BraZ1	1620.48	-	1603	2880	2934	0.9815951
A09	1793549	1793654	A09p02560.2_BraZ1	10.5	-	37	94	105	0.8952381
A09	1796864	1799369	A09p02570.2_BraZ1	1398	-	1598	2258	2505	0.9013972
A09	1808107	1809570	A09p02580.2_BraZ1	877.773	+	376	1362	1463	0.9309638
A09	1815269	1818317	A09p02590.2_BraZ1	304.8	-	302	2125	3048	0.6971785
A09	1820728	1823266	A09p02600.2_BraZ1	2592.33	-	1157	2504	2538	0.9866036
A09	1823739	1826383	A09p02610.2_BraZ1	4016.67	-	397	2078	2644	0.7859304
A09	1827465	1828161	A09p02620.2_BraZ1	69.6	-	372	655	696	0.9410920
A09	1834492	1836070	A09p02630.2_BraZ1	4185	-	1318	1570	1578	0.9949303
A09	1838022	1839123	A09p02640.2_BraZ1	495	+	194	847	1101	0.7693006
A09	1841217	1841420	A09p02650.2_BraZ1	19.2	+	1461	203	203	1.0000000
A09	1841737	1842402	A09p02660.2_BraZ1	189	-	3789	665	665	1.0000000
A09	1842456	1842965	A09p02670.2_BraZ1	150	-	3090	509	509	1.0000000
A09	1842456	1843913	A09p02680.2_BraZ1	234	-	5772	1457	1457	1.0000000
A09	1846479	1858058	A09p02690.2_BraZ1	6106.42	+	2188	7217	11579	0.6232835
A09	1860148	1861597	A09p02700.2_BraZ1	891	+	819	1047	1449	0.7225673
A09	1862802	1863783	A09p02710.2_BraZ1	76.5	-	284	552	981	0.5626912
A09	1868140	1869930	A09p02720.2_BraZ1	1452	+	131	1452	1790	0.8111732
A09	1870584	1870731	A09p02730.2_BraZ1	14.7	+	92	147	147	1.0000000
A09	1871765	1872091	A09p02740.2_BraZ1	228	-	304	326	326	1.0000000
A09	1874757	1876467	A09p02750.2_BraZ1	824.553	+	815	1603	1710	0.9374269
A09	1876542	1877859	A09p02760.2_BraZ1	924	-	584	1296	1317	0.9840547
A09	1878376	1885495	A09p02770.2_BraZ1	1232.7	+	3561	6210	7119	0.8723135
A09	1887455	1887826	A09p02780.2_BraZ1	30.6	+	132	371	371	1.0000000
A09	1887895	1890602	A09p02790.2_BraZ1	635.455	+	501	1942	2707	0.7173994
A09	1891502	1892628	A09p02800.2_BraZ1	100.5	-	629	1126	1126	1.0000000
A09	1896156	1897095	A09p02810.2_BraZ1	463.393	-	77	722	939	0.7689031
A09	1899887	1902920	A09p02820.2_BraZ1	1344.25	-	748	3023	3033	0.9967029
A09	1906184	1907035	A09p02830.2_BraZ1	864	+	237	827	851	0.9717979
A09	1908604	1910197	A09p02840.2_BraZ1	3306.6	-	115	1054	1593	0.6616447
A09	1911468	1913076	A09p02850.2_BraZ1	3078	-	159	1261	1608	0.7842040
A09	1914041	1914842	A09p02860.2_BraZ1	80.1	-	244	694	801	0.8664170
A09	1915199	1918166	A09p02870.2_BraZ1	1377.07	-	1427	2495	2967	0.8409168
A09	1920962	1922892	A09p02880.2_BraZ1	1047.73	+	811	1359	1930	0.7041451
A09	1923901	1926364	A09p02890.2_BraZ1	1307.44	+	414	1129	2463	0.4583841
A09	1927716	1928112	A09p02900.2_BraZ1	39.6	-	2297	361	396	0.9116161
A09	1929770	1931135	A09p02910.2_BraZ1	136.5	-	0	0	1365	0.0000000
A09	1933768	1935613	A09p02920.2_BraZ1	1014.29	+	93	464	1845	0.2514905
A09	1936963	1937359	A09p02930.2_BraZ1	39.6	-	38	143	396	0.3611111
A09	1939018	1941103	A09p02940.2_BraZ1	208.5	-	3	192	2085	0.0920863
A09	1942490	1944998	A09p02950.2_BraZ1	1609.7	+	228	1519	2508	0.6056619
A09	1947878	1949696	A09p02960.2_BraZ1	181.8	+	634	1700	1818	0.9350935
A09	1950839	1962858	A09p02970.2_BraZ1	1993.09	+	4023	11342	12019	0.9436725
A09	1963877	1964633	A09p02980.2_BraZ1	75.6	-	364	721	756	0.9537037
A09	1978788	1980762	A09p02990.2_BraZ1	197.4	+	270	1544	1974	0.7821682
A09	1988877	1993002	A09p03000.2_BraZ1	648	+	1599	3469	4125	0.8409697
A09	1988953	1989810	A09p03010.2_BraZ1	405	+	226	585	857	0.6826138
A09	2021410	2021900	A09p03020.2_BraZ1	399	-	9	74	490	0.1510204
A09	2028037	2029304	A09p03030.2_BraZ1	1108.8	-	568	1254	1267	0.9897395
A09	2030457	2032762	A09p03040.2_BraZ1	1275	-	524	1387	2305	0.6017354
A09	2037942	2038501	A09p03050.2_BraZ1	352.5	-	508	559	559	1.0000000
A09	2041349	2043539	A09p03060.2_BraZ1	1098	-	554	494	2190	0.2255708
A09	2045146	2047393	A09p03070.2_BraZ1	1175.55	+	1242	2138	2247	0.9514909
A09	2048263	2048849	A09p03080.2_BraZ1	36.3	+	468	585	586	0.9982935
A09	2049610	2050197	A09p03090.2_BraZ1	510	+	668	587	587	1.0000000
A09	2050355	2053110	A09p03100.2_BraZ1	1118.27	-	1187	2668	2755	0.9684210
A09	2054390	2055386	A09p03110.2_BraZ1	846	-	419	911	996	0.9146586
A09	2056953	2062401	A09p03120.2_BraZ1	2604.1	-	2190	4516	5448	0.8289281
A09	2064530	2065813	A09p03130.2_BraZ1	510.288	-	744	1283	1283	1.0000000
A09	2067745	2068895	A09p03140.2_BraZ1	736.615	+	747	1150	1150	1.0000000
A09	2069418	2070543	A09p03150.2_BraZ1	317.926	-	277	1120	1125	0.9955556
A09	2071156	2071821	A09p03160.2_BraZ1	543	+	447	665	665	1.0000000
A09	2073279	2074512	A09p03170.2_BraZ1	123.3	+	681	1233	1233	1.0000000
A09	2075416	2078032	A09p03180.2_BraZ1	709.211	-	847	2486	2616	0.9503058
A09	2078753	2081472	A09p03190.2_BraZ1	1763.14	+	1199	2454	2719	0.9025377
A09	2081822	2085376	A09p03200.2_BraZ1	1162.67	-	1487	2809	3554	0.7903770
A09	2088769	2090223	A09p03210.2_BraZ1	837	+	722	1413	1454	0.9718019
A09	2091848	2093066	A09p03220.2_BraZ1	1131	-	742	1180	1218	0.9688013
A09	2095189	2097899	A09p03230.2_BraZ1	1230.18	-	1660	2710	2710	1.0000000
A09	2098706	2099618	A09p03240.2_BraZ1	396	-	13	122	912	0.1337719
A09	2111451	2112363	A09p03250.2_BraZ1	396	-	21	271	912	0.2971491
A09	2112668	2114656	A09p03260.2_BraZ1	840	-	753	1941	1988	0.9763582
A09	2115980	2132608	A09p03270.2_BraZ1	1764.42	+	5795	11254	16628	0.6768102
A09	2121918	2122254	A09p03280.2_BraZ1	33.6	+	2	79	336	0.2351190
A09	2125320	2125656	A09p03290.2_BraZ1	33.6	+	0	0	336	0.0000000
A09	2134429	2136765	A09p03300.2_BraZ1	900	+	1017	2097	2336	0.8976883
A09	2141259	2141858	A09p03310.2_BraZ1	528	+	192	561	599	0.9365609
A09	2143747	2144065	A09p03320.2_BraZ1	31.8	-	481	318	318	1.0000000
A09	2144582	2147576	A09p03330.2_BraZ1	1383.85	+	1018	2562	2994	0.8557114
A09	2152171	2152567	A09p03340.2_BraZ1	39.6	+	5	62	396	0.1565657
A09	2158725	2159612	A09p03350.2_BraZ1	567	+	266	701	887	0.7903044
A09	2161847	2162899	A09p03360.2_BraZ1	798	+	330	966	1052	0.9182510
A09	2163348	2163657	A09p03370.2_BraZ1	30.9	-	274	309	309	1.0000000
A09	2165827	2167411	A09p03380.2_BraZ1	158.4	+	227	929	1584	0.5864899
A09	2172610	2174923	A09p03390.2_BraZ1	6116.25	+	265	1484	2313	0.6415910
A09	2180882	2181768	A09p03400.2_BraZ1	570	+	315	750	886	0.8465011
A09	2188670	2190015	A09p03410.2_BraZ1	1889.25	-	720	1345	1345	1.0000000
A09	2203429	2205920	A09p03420.2_BraZ1	1069.7	+	853	2359	2491	0.9470092
A09	2209795	2212922	A09p03430.2_BraZ1	3045	+	529	2899	3127	0.9270867
A09	2214640	2217110	A09p03440.2_BraZ1	992.425	+	667	2243	2470	0.9080971
A09	2217383	2220174	A09p03450.2_BraZ1	108	+	901	2275	2791	0.8151200
A09	2232553	2235738	A09p03460.2_BraZ1	2034	+	585	2914	3185	0.9149137
A09	2236692	2237668	A09p03470.2_BraZ1	280.333	+	423	976	976	1.0000000
A09	2241704	2242685	A09p03480.2_BraZ1	98.1	+	30	501	981	0.5107034
A09	2246984	2248046	A09p03490.2_BraZ1	106.2	-	168	909	1062	0.8559322
A09	2251744	2252883	A09p03500.2_BraZ1	381.462	+	555	1139	1139	1.0000000
A09	2254229	2270417	A09p03510.2_BraZ1	2749.72	-	7059	14786	16188	0.9133927
A09	2265665	2266019	A09p03520.2_BraZ1	336	-	22	119	354	0.3361582
A09	2271343	2271685	A09p03530.2_BraZ1	34.2	+	38	254	342	0.7426901
A09	2273890	2275468	A09p03540.2_BraZ1	157.8	+	535	1565	1578	0.9917617
A09	2276264	2276648	A09p03550.2_BraZ1	38.4	-	443	384	384	1.0000000
A09	2276891	2277618	A09p03560.2_BraZ1	462	-	663	727	727	1.0000000
A09	2279962	2281510	A09p03570.2_BraZ1	154.8	+	180	1248	1548	0.8062016
A09	2284555	2286733	A09p03580.2_BraZ1	217.8	+	838	2077	2178	0.9536272
A09	2287369	2288827	A09p03590.2_BraZ1	145.8	+	53	731	1458	0.5013717
A09	2289368	2289473	A09p03600.2_BraZ1	10.5	+	77	105	105	1.0000000
A09	2289583	2307868	A09p03610.2_BraZ1	1255.09	+	6162	15700	18285	0.8586273
A09	2293304	2294657	A09p03620.2_BraZ1	1449	+	181	1091	1353	0.8063563
A09	2308336	2310940	A09p03630.2_BraZ1	1506	-	460	1765	2604	0.6778034
A09	2315738	2316154	A09p03640.2_BraZ1	351	+	23	224	416	0.5384616
A09	2318044	2318905	A09p03650.2_BraZ1	86.1	-	152	837	861	0.9721254
A09	2320087	2321967	A09p03660.2_BraZ1	1656	-	3136	1535	1880	0.8164893
A09	2328470	2329736	A09p03670.2_BraZ1	126.6	+	88	920	1266	0.7266983
A09	2334573	2335114	A09p03680.2_BraZ1	279	-	44	477	541	0.8817006
A09	2344141	2351000	A09p03690.2_BraZ1	3538.07	-	2231	5545	6859	0.8084269
A09	2356884	2357586	A09p03700.2_BraZ1	363	-	140	689	702	0.9814815
A09	2361154	2362638	A09p03710.2_BraZ1	963.474	+	204	1356	1484	0.9137467
A09	2375033	2375330	A09p03720.2_BraZ1	29.7	+	22	237	297	0.7979798
A09	2383152	2384085	A09p03730.2_BraZ1	93	-	69	737	933	0.7899250
A09	2388753	2388979	A09p03740.2_BraZ1	147	+	250	226	226	1.0000000
A09	2389499	2390044	A09p03750.2_BraZ1	31.8	+	169	545	545	1.0000000
A09	2390447	2391576	A09p03760.2_BraZ1	6696	-	551	998	1129	0.8839681
A09	2489103	2494295	A09p03770.2_BraZ1	4389	-	331	2677	5192	0.5156009
A09	2498549	2498705	A09p03780.2_BraZ1	15.6	+	17	156	156	1.0000000
A09	2506072	2506604	A09p03790.2_BraZ1	50.7	+	61	532	532	1.0000000
A09	2508683	2510041	A09p03800.2_BraZ1	912.975	+	346	1343	1358	0.9889544
A09	2512770	2516400	A09p03810.2_BraZ1	2251.84	-	712	2973	3630	0.8190083
A09	2517212	2518692	A09p03820.2_BraZ1	581	+	1134	1388	1480	0.9378378
A09	2519249	2520159	A09p03830.2_BraZ1	687	-	548	906	910	0.9956044
A09	2520903	2522461	A09p03840.2_BraZ1	888.1	+	717	1412	1558	0.9062901
A09	2523197	2524314	A09p03850.2_BraZ1	651.677	-	804	1117	1117	1.0000000
A09	2526323	2527988	A09p03860.2_BraZ1	919.286	-	836	1665	1665	1.0000000
A09	2529336	2529510	A09p03870.2_BraZ1	17.4	-	162	174	174	1.0000000
A09	2532954	2533914	A09p03880.2_BraZ1	888	+	166	883	960	0.9197916
A09	2534410	2535471	A09p03890.2_BraZ1	456.126	-	909	1061	1061	1.0000000
A09	2536321	2537302	A09p03900.2_BraZ1	98.1	-	127	882	981	0.8990825
A09	2538178	2539279	A09p03910.2_BraZ1	660.938	-	317	1084	1101	0.9845595
A09	2540126	2542095	A09p03920.2_BraZ1	1192.09	+	1039	1953	1969	0.9918740
A09	2543835	2545003	A09p03930.2_BraZ1	768	-	392	1118	1168	0.9571918
A09	2546705	2548058	A09p03940.2_BraZ1	135.3	-	426	1286	1353	0.9504804
A09	2549684	2551121	A09p03950.2_BraZ1	143.7	-	868	1437	1437	1.0000000
A09	2551607	2555386	A09p03960.2_BraZ1	722.98	-	1255	2887	3779	0.7639587
A09	2556495	2558153	A09p03970.2_BraZ1	918.72	-	1119	1658	1658	1.0000000
A09	2560468	2563043	A09p03980.2_BraZ1	1591.71	-	2314	2540	2575	0.9864078
A09	2564267	2567955	A09p03990.2_BraZ1	2499.74	-	2275	3688	3688	1.0000000
A09	2584006	2586600	A09p04000.2_BraZ1	1339.75	+	421	2227	2594	0.8585197
A09	2588635	2590656	A09p04010.2_BraZ1	804	+	1106	1841	2021	0.9109352
A09	2595351	2598911	A09p04020.2_BraZ1	690.857	+	1530	3046	3560	0.8556180
A09	2599438	2599738	A09p04030.2_BraZ1	30	+	0	0	300	0.0000000
A09	2599582	2600210	A09p04040.2_BraZ1	378	+	0	0	628	0.0000000
A09	2604569	2608020	A09p04050.2_BraZ1	2058.48	+	2082	3366	3451	0.9753695
A09	2618019	2620431	A09p04060.2_BraZ1	1133.63	+	565	1970	2412	0.8167496
A09	2623834	2626013	A09p04070.2_BraZ1	1295.04	-	449	1764	2179	0.8095456
A09	2628493	2628898	A09p04080.2_BraZ1	40.5	+	54	330	405	0.8148148
A09	2629997	2632432	A09p04090.2_BraZ1	1497	-	295	1592	2435	0.6537988
A09	2640849	2642319	A09p04100.2_BraZ1	652.435	+	478	1242	1470	0.8448980
A09	2645480	2651211	A09p04110.2_BraZ1	2800.62	+	2011	5170	5731	0.9021114
A09	2652395	2654491	A09p04120.2_BraZ1	870.678	+	1567	2096	2096	1.0000000
A09	2655239	2657480	A09p04130.2_BraZ1	224.1	-	723	2097	2241	0.9357430
A09	2658954	2659733	A09p04140.2_BraZ1	61.5	-	427	779	779	1.0000000
A09	2661186	2661345	A09p04150.2_BraZ1	102	-	61	159	159	1.0000000
A09	2661294	2662600	A09p04160.2_BraZ1	876	-	430	1284	1306	0.9831547
A09	2663086	2663758	A09p04170.2_BraZ1	537	-	259	672	672	1.0000000
A09	2665304	2665808	A09p04180.2_BraZ1	258.331	-	511	504	504	1.0000000
A09	2671947	2673222	A09p04190.2_BraZ1	127.5	+	1712	1275	1275	1.0000000
A09	2673730	2675622	A09p04200.2_BraZ1	1500	-	401	1870	1892	0.9883721
A09	2678486	2681694	A09p04210.2_BraZ1	1247.08	-	1253	3111	3208	0.9697631
A09	2683510	2683969	A09p04220.2_BraZ1	45.9	-	20	272	459	0.5925926
A09	2690950	2693601	A09p04230.2_BraZ1	1179.47	-	1496	2207	2651	0.8325160
A09	2694977	2696904	A09p04240.2_BraZ1	783	+	808	1888	1927	0.9797613
A09	2700377	2701346	A09p04250.2_BraZ1	96.9	-	127	833	969	0.8596491
A09	2701777	2703503	A09p04260.2_BraZ1	1153.18	-	757	1598	1726	0.9258401
A09	2705173	2706044	A09p04270.2_BraZ1	213	+	1152	871	871	1.0000000
A09	2706434	2708637	A09p04280.2_BraZ1	1089	-	1158	2163	2203	0.9818429
A09	2710283	2712301	A09p04290.2_BraZ1	1499.2	+	84	843	2018	0.4177403
A09	2713265	2716859	A09p04300.2_BraZ1	3866.49	+	1763	3534	3594	0.9833055
A09	2724888	2725867	A09p04310.2_BraZ1	585	+	11	516	979	0.5270684
A09	2733079	2735957	A09p04320.2_BraZ1	717.62	-	837	2470	2878	0.8582349
A09	2737531	2740208	A09p04330.2_BraZ1	1744.96	-	205	2000	2677	0.7471049
A09	2742203	2743962	A09p04340.2_BraZ1	1351.61	+	184	1532	1759	0.8709494
A09	2744839	2747751	A09p04350.2_BraZ1	21175	+	680	2577	2912	0.8849588
A09	2750958	2754499	A09p04360.2_BraZ1	2292.3	+	1500	2920	3541	0.8246258
A09	2758494	2760207	A09p04370.2_BraZ1	171.3	-	304	1376	1713	0.8032691
A09	2765137	2766349	A09p04380.2_BraZ1	121.2	-	207	491	1212	0.4051155
A09	2771367	2771982	A09p04390.2_BraZ1	61.5	+	316	615	615	1.0000000
A09	2772415	2776244	A09p04400.2_BraZ1	1814.34	-	1232	3411	3829	0.8908331
A09	2778129	2780407	A09p04410.2_BraZ1	7890.38	+	1078	2278	2278	1.0000000
A09	2780988	2781556	A09p04420.2_BraZ1	489	+	181	568	568	1.0000000
A09	2781869	2785627	A09p04430.2_BraZ1	618.364	+	1512	3431	3758	0.9129856
A09	2789250	2790608	A09p04440.2_BraZ1	540.6	+	605	1172	1358	0.8630339
A09	2790882	2792523	A09p04450.2_BraZ1	864.167	-	545	1498	1641	0.9128580
A09	2794771	2795971	A09p04460.2_BraZ1	1411.2	-	1006	1197	1200	0.9975000
A09	2797996	2799849	A09p04470.2_BraZ1	863.895	-	1284	1840	1853	0.9929844
A09	2801775	2802303	A09p04480.2_BraZ1	209.1	-	643	528	528	1.0000000
A09	2804187	2805950	A09p04490.2_BraZ1	883.65	+	1514	1763	1763	1.0000000
A09	2806622	2808719	A09p04500.2_BraZ1	589.636	-	1572	2097	2097	1.0000000
A09	2810199	2810986	A09p04510.2_BraZ1	423	+	259	696	787	0.8843710
A09	2811458	2811685	A09p04520.2_BraZ1	159	-	316	227	227	1.0000000
A09	2813695	2815180	A09p04530.2_BraZ1	561.45	-	1090	1485	1485	1.0000000
A09	2817882	2819251	A09p04540.2_BraZ1	809.364	-	113	927	1369	0.6771366
A09	2822452	2823000	A09p04550.2_BraZ1	243.659	+	204	548	548	1.0000000
A09	2824260	2824791	A09p04560.2_BraZ1	53.1	+	843	531	531	1.0000000
A09	2827588	2828673	A09p04570.2_BraZ1	574.219	+	0	0	1085	0.0000000
A09	2834824	2838733	A09p04580.2_BraZ1	1606.62	+	1871	3698	3909	0.9460220
A09	2841497	2841885	A09p04590.2_BraZ1	246	+	602	388	388	1.0000000
A09	2843726	2847550	A09p04600.2_BraZ1	30456	+	1032	3657	3824	0.9563285
A09	2847828	2848275	A09p04610.2_BraZ1	249	-	385	447	447	1.0000000
A09	2849247	2850978	A09p04620.2_BraZ1	964.174	-	874	1612	1731	0.9312536
A09	2854806	2855294	A09p04630.2_BraZ1	402	-	162	488	488	1.0000000
A09	2855988	2856334	A09p04640.2_BraZ1	225	+	21	312	346	0.9017341
A09	2861838	2862117	A09p04650.2_BraZ1	27	+	25	279	279	1.0000000
A09	2865080	2866676	A09p04660.2_BraZ1	1497	+	155	1255	1596	0.7863408
A09	2928616	2929824	A09p04670.2_BraZ1	647.062	-	108	482	1208	0.3990066
A09	2933066	2935521	A09p04680.2_BraZ1	1989	-	536	1848	2455	0.7527495
A09	2937484	2937979	A09p04690.2_BraZ1	49.5	-	45	395	495	0.7979798
A09	2940844	2943565	A09p04700.2_BraZ1	2030	-	1034	2394	2721	0.8798236
A09	2949112	2956105	A09p04710.2_BraZ1	2657.6	-	1031	4540	6993	0.6492206
A09	2962944	2964098	A09p04720.2_BraZ1	296.25	+	948	1154	1154	1.0000000
A09	2973503	2974185	A09p04730.2_BraZ1	303.545	-	0	0	682	0.0000000
A09	2974955	2975213	A09p04740.2_BraZ1	25.8	+	26	79	258	0.3062015
A09	2976983	2983445	A09p04750.2_BraZ1	1702.58	+	3074	5852	6462	0.9056020
A09	2978249	2978755	A09p04760.2_BraZ1	222	-	35	201	506	0.3972332
A09	2988987	2993731	A09p04770.2_BraZ1	2010.02	+	2961	4744	4744	1.0000000
A09	2998761	2999244	A09p04780.2_BraZ1	48.3	+	67	480	483	0.9937888
A09	3000802	3002480	A09p04790.2_BraZ1	559.895	+	266	1496	1678	0.8915375
A09	3013732	3015641	A09p04800.2_BraZ1	1013.73	+	227	1415	1909	0.7412258
A09	3018333	3021040	A09p04810.2_BraZ1	674	-	1308	2362	2707	0.8725526
A09	3022279	3028333	A09p04820.2_BraZ1	651	-	497	2425	6054	0.4005616
A09	3023479	3025896	A09p04830.2_BraZ1	276	+	303	1174	2417	0.4857261
A09	3029445	3035097	A09p04840.2_BraZ1	1188.71	-	299	2904	5652	0.5138004
A09	3030471	3033497	A09p04850.2_BraZ1	201	-	172	1563	3026	0.5165235
A09	3036653	3037547	A09p04860.2_BraZ1	89.4	+	41	615	894	0.6879194
A09	3038249	3043343	A09p04870.2_BraZ1	201	-	331	1803	5094	0.3539458
A09	3043402	3043978	A09p04880.2_BraZ1	57.6	-	0	0	576	0.0000000
A09	3050385	3052031	A09p04890.2_BraZ1	243.6	-	963	1470	1646	0.8930741
A09	3057423	3057639	A09p04900.2_BraZ1	21.6	+	17	154	216	0.7129630
A09	3058964	3061973	A09p04910.2_BraZ1	612	-	1287	2922	3009	0.9710867
A09	3062055	3062406	A09p04920.2_BraZ1	35.1	+	237	351	351	1.0000000
A09	3079232	3080236	A09p04930.2_BraZ1	364.706	-	123	807	1004	0.8037848
A09	3080922	3081221	A09p04940.2_BraZ1	132	+	149	299	299	1.0000000
A09	3082143	3082807	A09p04950.2_BraZ1	46.2	-	659	664	664	1.0000000
A09	3083517	3085935	A09p04960.2_BraZ1	959.9	+	1353	2390	2418	0.9884202
A09	3087576	3088034	A09p04970.2_BraZ1	267	+	221	457	458	0.9978166
A09	3089464	3092263	A09p04980.2_BraZ1	1603.64	+	1070	2779	2799	0.9928546
A09	3092952	3095485	A09p04990.2_BraZ1	3550	+	597	2097	2533	0.8278721
A09	3096374	3098633	A09p05000.2_BraZ1	1548.24	-	422	1690	2259	0.7481186
A09	3100606	3102328	A09p05010.2_BraZ1	1101.65	-	835	1434	1722	0.8327526
A09	3105726	3106793	A09p05020.2_BraZ1	604.544	+	840	1067	1067	1.0000000
A09	3107281	3108822	A09p05030.2_BraZ1	677.143	+	246	1419	1541	0.9208306
A09	3109143	3111710	A09p05040.2_BraZ1	1240.31	-	959	2540	2567	0.9894819
A09	3112806	3116758	A09p05050.2_BraZ1	831.6	-	939	2677	3952	0.6773785
A09	3119991	3122226	A09p05060.2_BraZ1	1346.27	+	259	1776	2235	0.7946309
A09	3122969	3200509	A09p05070.2_BraZ1	603.792	+	20184	69841	77540	0.9007093
A09	3194533	3195703	A09p05080.2_BraZ1	117	+	632	1170	1170	1.0000000
A09	3202087	3203822	A09p05090.2_BraZ1	304.5	+	824	1710	1735	0.9855908
A09	3204275	3205320	A09p05100.2_BraZ1	551	-	189	1045	1045	1.0000000
A09	3205845	3206768	A09p05110.2_BraZ1	3888	+	484	923	923	1.0000000
A09	3208209	3210291	A09p05120.2_BraZ1	1514.78	+	481	2030	2082	0.9750240
A09	3212986	3216296	A09p05130.2_BraZ1	1431.78	+	2535	3279	3310	0.9906344
A09	3216755	3217567	A09p05140.2_BraZ1	314.579	+	1312	812	812	1.0000000
A09	3217863	3219992	A09p05150.2_BraZ1	882	-	1824	2129	2129	1.0000000
A09	3223057	3226833	A09p05160.2_BraZ1	10543.2	+	1874	3745	3776	0.9917902
A09	3230039	3230960	A09p05170.2_BraZ1	392	+	138	653	921	0.7090120
A09	3235721	3238053	A09p05180.2_BraZ1	1344	+	1080	2192	2332	0.9399657
A09	3240745	3243932	A09p05190.2_BraZ1	1522.8	+	499	2846	3187	0.8930028
A09	3245562	3248703	A09p05200.2_BraZ1	313.5	+	1279	3053	3141	0.9719834
A09	3249443	3251541	A09p05210.2_BraZ1	1082.17	-	1001	2098	2098	1.0000000
A09	3251805	3253301	A09p05220.2_BraZ1	803.7	-	606	1496	1496	1.0000000
A09	3254560	3256845	A09p05230.2_BraZ1	1450.03	-	665	2166	2285	0.9479212
A09	3258190	3259631	A09p05240.2_BraZ1	197.5	-	1183	1441	1441	1.0000000
A09	3265345	3266639	A09p05250.2_BraZ1	58.2	+	0	0	1294	0.0000000
A09	3267114	3271490	A09p05260.2_BraZ1	1426.16	+	1564	3737	4376	0.8539762
A09	3277205	3278309	A09p05270.2_BraZ1	105	+	201	964	1104	0.8731884
A09	3280807	3282731	A09p05280.2_BraZ1	1100.16	+	953	1892	1924	0.9833680
A09	3283004	3284496	A09p05290.2_BraZ1	1422	-	456	1482	1492	0.9932976
A09	3285458	3286850	A09p05300.2_BraZ1	447	+	373	1223	1392	0.8785920
A09	3287800	3290129	A09p05310.2_BraZ1	1308.97	+	1418	2305	2329	0.9896951
A09	3290815	3296505	A09p05320.2_BraZ1	1673.31	+	2795	5667	5690	0.9959578
A09	3297314	3301154	A09p05330.2_BraZ1	1923.62	-	1606	3840	3840	1.0000000
A09	3301242	3303214	A09p05340.2_BraZ1	959.679	+	1829	1924	1972	0.9756593
A09	3304258	3306673	A09p05350.2_BraZ1	924.067	+	1593	2408	2415	0.9971014
A09	3307574	3310916	A09p05360.2_BraZ1	3093	+	1010	3035	3342	0.9081388
A09	3311771	3312303	A09p05370.2_BraZ1	456	-	395	532	532	1.0000000
A09	3312934	3313419	A09p05380.2_BraZ1	249	-	398	485	485	1.0000000
A09	3316912	3317263	A09p05390.2_BraZ1	35.1	+	177	345	351	0.9829060
A09	3318414	3320307	A09p05400.2_BraZ1	865.2	+	1157	1893	1893	1.0000000
A09	3321687	3323171	A09p05410.2_BraZ1	376.8	+	651	1417	1484	0.9548517
A09	3325084	3325201	A09p05420.2_BraZ1	11.7	-	83	117	117	1.0000000
A09	3326421	3326894	A09p05430.2_BraZ1	261	+	206	413	473	0.8731501
A09	3332783	3332989	A09p05440.2_BraZ1	14.7	-	0	0	206	0.0000000
A09	3334563	3338254	A09p05450.2_BraZ1	868.036	+	1217	3529	3691	0.9561095
A09	3338348	3340171	A09p05460.2_BraZ1	433.662	+	859	1823	1823	1.0000000
A09	3342326	3345007	A09p05470.2_BraZ1	2176.83	-	743	2394	2681	0.8929504
A09	3349794	3351000	A09p05480.2_BraZ1	120.6	+	284	989	1206	0.8200663
A09	3354978	3355824	A09p05490.2_BraZ1	84.6	-	370	544	846	0.6430260
A09	3362605	3363243	A09p05500.2_BraZ1	330	-	454	638	638	1.0000000
A09	3364173	3364974	A09p05510.2_BraZ1	80.1	-	69	576	801	0.7191011
A09	3366779	3374650	A09p05520.2_BraZ1	1719.64	-	3153	5745	7871	0.7298946
A09	3379628	3381491	A09p05530.2_BraZ1	1031.84	-	123	1296	1863	0.6956522
A09	3384822	3384978	A09p05540.2_BraZ1	15.6	+	239	156	156	1.0000000
A09	3386229	3387399	A09p05550.2_BraZ1	630	-	78	514	1170	0.4393162
A09	3387532	3388494	A09p05560.2_BraZ1	880	-	4	403	962	0.4189189
A09	3390058	3392451	A09p05570.2_BraZ1	123	+	184	1193	2393	0.4985374
A09	3390626	3391145	A09p05580.2_BraZ1	51.9	+	23	163	519	0.3140655
A09	3394161	3394806	A09p05590.2_BraZ1	64.5	-	104	591	645	0.9162791
A09	3395276	3400105	A09p05600.2_BraZ1	2530.8	-	2425	4784	4829	0.9906813
A09	3408039	3408447	A09p05610.2_BraZ1	324	-	208	408	408	1.0000000
A09	3414231	3414776	A09p05620.2_BraZ1	80.625	-	218	520	545	0.9541284
A09	3415818	3417048	A09p05630.2_BraZ1	123	+	61	973	1230	0.7910569
A09	3422896	3424597	A09p05640.2_BraZ1	2727	+	379	1203	1701	0.7072310
A09	3426620	3427241	A09p05650.2_BraZ1	31.2	-	132	621	621	1.0000000
A09	3428412	3431505	A09p05660.2_BraZ1	1680	-	1483	2724	3093	0.8806983
A09	3447807	3447948	A09p05670.2_BraZ1	14.1	+	0	0	141	0.0000000
A09	3451264	3454368	A09p05680.2_BraZ1	2402.67	+	2480	3104	3104	1.0000000
A09	3455083	3459717	A09p05690.2_BraZ1	2895.24	-	2056	4462	4634	0.9628831
A09	3460713	3464940	A09p05700.2_BraZ1	1224.09	-	1621	4094	4227	0.9685356
A09	3466018	3466961	A09p05710.2_BraZ1	336	-	387	685	943	0.7264051
A09	3468026	3469993	A09p05720.2_BraZ1	11676	+	1971	1967	1967	1.0000000
A09	3472692	3475022	A09p05730.2_BraZ1	1188.29	+	644	2300	2330	0.9871244
A09	3475368	3476334	A09p05740.2_BraZ1	398.328	+	254	966	966	1.0000000
A09	3476735	3478652	A09p05750.2_BraZ1	876.571	-	794	1861	1917	0.9707877
A09	3479067	3479900	A09p05760.2_BraZ1	589.185	+	0	0	833	0.0000000
A09	3480018	3481154	A09p05770.2_BraZ1	317.333	+	43	860	1136	0.7570422
A09	3488842	3489103	A09p05780.2_BraZ1	26.1	+	1	4	261	0.0153257
A09	3494921	3495161	A09p05790.2_BraZ1	24	+	262	240	240	1.0000000
A09	3505264	3506479	A09p05800.2_BraZ1	986.087	+	246	810	1215	0.6666667
A09	3512079	3514626	A09p05810.2_BraZ1	1173.46	-	1222	2417	2547	0.9489596
A09	3515779	3516508	A09p05820.2_BraZ1	72.9	+	147	722	729	0.9903978
A09	3516660	3520248	A09p05830.2_BraZ1	2055.83	-	1416	3367	3588	0.9384058
A09	3521207	3522533	A09p05840.2_BraZ1	819	-	1010	1326	1326	1.0000000
A09	3523954	3524555	A09p05850.2_BraZ1	306	-	584	601	601	1.0000000
A09	3526539	3530628	A09p05860.2_BraZ1	2006.1	+	1238	4082	4089	0.9982881
A09	3531198	3531435	A09p05870.2_BraZ1	23.7	-	146	237	237	1.0000000
A09	3532990	3534485	A09p05880.2_BraZ1	651	-	850	1469	1495	0.9826087
A09	3536252	3539512	A09p05890.2_BraZ1	51.3	-	1609	3062	3260	0.9392638
A09	3539824	3540070	A09p05900.2_BraZ1	24.6	-	19	184	246	0.7479675
A09	3541086	3546486	A09p05910.2_BraZ1	3392.5	-	2633	5131	5400	0.9501852
A09	3547309	3547438	A09p05920.2_BraZ1	12.9	+	76	129	129	1.0000000
A09	3549277	3552627	A09p05930.2_BraZ1	1572.35	+	319	2428	3350	0.7247761
A09	3553905	3554655	A09p05940.2_BraZ1	552	+	224	470	750	0.6266667
A09	3555195	3557084	A09p05950.2_BraZ1	915.652	-	276	1645	1889	0.8708311
A09	3559967	3561740	A09p05960.2_BraZ1	867.5	+	232	1243	1773	0.7010716
A09	3563189	3564936	A09p05970.2_BraZ1	900.833	+	187	1569	1747	0.8981110
A09	3566384	3567266	A09p05980.2_BraZ1	88.2	+	134	721	882	0.8174603
A09	3571980	3573276	A09p05990.2_BraZ1	548.063	+	612	1290	1296	0.9953704
A09	3580665	3581529	A09p06000.2_BraZ1	86.4	-	34	536	864	0.6203704
A09	3583197	3584740	A09p06010.2_BraZ1	599.85	+	549	1537	1543	0.9961115
A09	3585425	3586427	A09p06020.2_BraZ1	100.2	-	89	798	1002	0.7964072
A09	3588386	3589055	A09p06030.2_BraZ1	55.2857	+	518	669	669	1.0000000
A09	3589111	3590263	A09p06040.2_BraZ1	537.086	+	865	1144	1152	0.9930556
A09	3591995	3594739	A09p06050.2_BraZ1	1102.69	-	582	2433	2744	0.8866618
A09	3596065	3597009	A09p06060.2_BraZ1	516	+	107	791	944	0.8379237
A09	3598081	3599358	A09p06070.2_BraZ1	356.664	-	560	1215	1277	0.9514487
A09	3600592	3604302	A09p06080.2_BraZ1	128.7	+	1821	3519	3710	0.9485175
A09	3607097	3607568	A09p06090.2_BraZ1	47.1	+	34	204	471	0.4331210
A09	3609857	3610958	A09p06100.2_BraZ1	532.167	-	457	1101	1101	1.0000000
A09	3617796	3618321	A09p06110.2_BraZ1	52.5	+	123	525	525	1.0000000
A09	3620105	3621366	A09p06120.2_BraZ1	954	+	689	1241	1261	0.9841396
A09	3621952	3622605	A09p06130.2_BraZ1	507	-	545	653	653	1.0000000
A09	3629320	3631894	A09p06140.2_BraZ1	1568.21	+	994	2561	2574	0.9949495
A09	3640987	3641641	A09p06150.2_BraZ1	65.4	+	261	654	654	1.0000000
A09	3643585	3645115	A09p06160.2_BraZ1	153	-	172	1062	1530	0.6941177
A09	3646268	3647224	A09p06170.2_BraZ1	491.4	+	0	0	956	0.0000000
A09	3649650	3651789	A09p06180.2_BraZ1	1134	+	1230	2139	2139	1.0000000
A09	3655678	3656564	A09p06190.2_BraZ1	393.75	-	436	886	886	1.0000000
A09	3658070	3660742	A09p06200.2_BraZ1	1567.5	-	1172	2551	2672	0.9547155
A09	3673027	3675615	A09p06210.2_BraZ1	1219.92	+	911	2230	2588	0.8616692
A09	3688754	3688880	A09p06220.2_BraZ1	12.6	-	24	126	126	1.0000000
A09	3689219	3689749	A09p06230.2_BraZ1	2247.75	-	10	251	530	0.4735849
A09	3691002	3693513	A09p06240.2_BraZ1	1219.43	+	1417	2511	2511	1.0000000
A09	3695413	3699012	A09p06250.2_BraZ1	2118.37	+	1623	3502	3599	0.9730481
A09	3699644	3701054	A09p06260.2_BraZ1	2112.5	+	269	1278	1410	0.9063830
A09	3701775	3702949	A09p06270.2_BraZ1	745.2	+	4	127	1174	0.1081772
A09	3704258	3706495	A09p06280.2_BraZ1	2290.4	-	1516	2237	2237	1.0000000
A09	3709269	3710951	A09p06290.2_BraZ1	1722	+	1476	1682	1682	1.0000000
A09	3711618	3718391	A09p06300.2_BraZ1	2037.66	+	2450	5204	6773	0.7683449
A09	3718951	3720196	A09p06310.2_BraZ1	124.5	-	135	237	1245	0.1903614
A09	3723997	3725362	A09p06320.2_BraZ1	555	-	722	1364	1365	0.9992674
A09	3730544	3732548	A09p06330.2_BraZ1	1851	+	666	1975	2004	0.9855289
A09	3737006	3737601	A09p06340.2_BraZ1	58.2	-	377	595	595	1.0000000
A09	3738110	3738305	A09p06350.2_BraZ1	19.5	+	3	100	195	0.5128205
A09	3743471	3744062	A09p06360.2_BraZ1	59.1	-	214	591	591	1.0000000
A09	3745068	3746823	A09p06370.2_BraZ1	1027	+	937	1755	1755	1.0000000
A09	3747954	3748326	A09p06380.2_BraZ1	37.2	+	98	362	372	0.9731183
A09	3755599	3756225	A09p06390.2_BraZ1	540	+	189	626	626	1.0000000
A09	3764287	3765056	A09p06400.2_BraZ1	54.3	-	286	769	769	1.0000000
A09	3765808	3766399	A09p06410.2_BraZ1	59.1	+	1	44	591	0.0744501
A09	3768268	3772699	A09p06420.2_BraZ1	1907.45	-	1641	4106	4431	0.9266531
A09	3773821	3773995	A09p06430.2_BraZ1	13.2	-	120	174	174	1.0000000
A09	3776879	3778032	A09p06440.2_BraZ1	135.929	-	690	1153	1153	1.0000000
A09	3780730	3782769	A09p06450.2_BraZ1	919.643	-	577	1930	2039	0.9465424
A09	3784926	3785566	A09p06460.2_BraZ1	534	+	216	640	640	1.0000000
A09	3785816	3787575	A09p06470.2_BraZ1	674.325	-	1531	1759	1759	1.0000000
A09	3788533	3794024	A09p06480.2_BraZ1	2353.76	+	1758	5039	5491	0.9176835
A09	3795774	3796632	A09p06490.2_BraZ1	85.8	+	305	858	858	1.0000000
A09	3796891	3798252	A09p06500.2_BraZ1	282	+	782	1298	1361	0.9537105
A09	3798839	3800409	A09p06510.2_BraZ1	1041	-	254	1192	1570	0.7592357
A09	3812317	3813088	A09p06520.2_BraZ1	696	+	41	601	771	0.7795072
A09	3815230	3815821	A09p06530.2_BraZ1	59.1	+	0	0	591	0.0000000
A09	3817547	3818386	A09p06540.2_BraZ1	374.625	-	625	839	839	1.0000000
A09	3821154	3821523	A09p06550.2_BraZ1	36.9	-	64	302	369	0.8184282
A09	3823828	3826861	A09p06560.2_BraZ1	1396.63	+	1501	2901	3033	0.9564787
A09	3827106	3827567	A09p06570.2_BraZ1	396	+	369	461	461	1.0000000
A09	3833017	3840205	A09p06580.2_BraZ1	3998.55	+	2451	7033	7188	0.9784363
A09	3841474	3844113	A09p06590.2_BraZ1	1031.49	+	615	2495	2639	0.9454339
A09	3845612	3850781	A09p06600.2_BraZ1	1400.25	+	2933	5007	5169	0.9686593
A09	3853187	3853544	A09p06610.2_BraZ1	35.7	+	158	357	357	1.0000000
A09	3853750	3854302	A09p06620.2_BraZ1	264	+	196	487	552	0.8822464
A09	3855069	3856739	A09p06630.2_BraZ1	11970	-	874	1670	1670	1.0000000
A09	3860332	3860647	A09p06640.2_BraZ1	31.5	-	43	292	315	0.9269841
A09	3861976	3862198	A09p06650.2_BraZ1	22.2	-	96	210	222	0.9459459
A09	3862315	3864696	A09p06660.2_BraZ1	1250.31	+	1852	2342	2381	0.9836203
A09	3865315	3866209	A09p06670.2_BraZ1	89.4	-	391	894	894	1.0000000
A09	3871937	3874546	A09p06680.2_BraZ1	895.714	+	432	2489	2609	0.9540054
A09	3879239	3881860	A09p06690.2_BraZ1	814.333	+	393	2200	2621	0.8393743
A09	3885263	3887823	A09p06700.2_BraZ1	925.128	+	505	2195	2560	0.8574219
A09	3890603	3892492	A09p06710.2_BraZ1	382.462	+	1025	1816	1889	0.9613552
A09	3891907	3900187	A09p06720.2_BraZ1	1016.65	+	3923	7843	8280	0.9472222
A09	3907957	3909453	A09p06730.2_BraZ1	484.776	+	1499	1485	1496	0.9926471
A09	3910505	3913174	A09p06740.2_BraZ1	2090.95	+	997	2669	2669	1.0000000
A09	3913605	3915040	A09p06750.2_BraZ1	511.5	-	1263	1435	1435	1.0000000
A09	3916823	3918845	A09p06760.2_BraZ1	1348.43	-	1651	2022	2022	1.0000000
A09	3925432	3926901	A09p06770.2_BraZ1	1401	+	49	660	1469	0.4492852
A09	3927558	3929173	A09p06780.2_BraZ1	1002	-	844	785	1615	0.4860681
A09	3932413	3933886	A09p06790.2_BraZ1	909	+	194	488	1473	0.3312967
A09	3938032	3943016	A09p06800.2_BraZ1	1244.87	+	3293	4465	4984	0.8958668
A09	3941200	3942230	A09p06810.2_BraZ1	101.1	-	98	604	1030	0.5864078
A09	3946443	3948886	A09p06820.2_BraZ1	1408.91	+	707	2192	2443	0.8972574
A09	3951140	3951440	A09p06830.2_BraZ1	25.5	+	37	244	300	0.8133333
A09	3951727	3951892	A09p06840.2_BraZ1	16.5	+	477	165	165	1.0000000
A09	3952766	3954282	A09p06850.2_BraZ1	939	+	90	830	1516	0.5474934
A09	3954754	3955146	A09p06860.2_BraZ1	192	-	5	39	392	0.0994898
A09	3956061	3958333	A09p06870.2_BraZ1	1866	-	501	1660	2272	0.7306338
A09	3963396	3964769	A09p06880.2_BraZ1	906	+	15	492	1373	0.3583394
A09	3968571	3970338	A09p06890.2_BraZ1	966.286	+	427	1533	1767	0.8675721
A09	3973441	3973849	A09p06900.2_BraZ1	40.8	-	178	408	408	1.0000000
A09	3990859	3993790	A09p06910.2_BraZ1	1659.27	+	166	1772	2931	0.6045718
A09	3994935	3996225	A09p06920.2_BraZ1	129	-	78	672	1290	0.5209302
A09	4036457	4036724	A09p06930.2_BraZ1	26.7	-	0	0	267	0.0000000
A09	4038757	4039537	A09p06940.2_BraZ1	78	-	258	780	780	1.0000000
A09	4039626	4039767	A09p06950.2_BraZ1	14.1	+	58	141	141	1.0000000
A09	4040958	4041725	A09p06960.2_BraZ1	690	+	281	767	767	1.0000000
A09	4042004	4045936	A09p06970.2_BraZ1	1935.99	-	942	3926	3932	0.9984741
A09	4046361	4047230	A09p06980.2_BraZ1	621	+	539	856	869	0.9850402
A09	4047691	4051648	A09p06990.2_BraZ1	2359.64	-	3606	3923	3957	0.9914076
A09	4052532	4055194	A09p07000.2_BraZ1	1272.96	-	705	2509	2662	0.9425244
A09	4055825	4057374	A09p07010.2_BraZ1	348	+	1062	1532	1549	0.9890252
A09	4058923	4060292	A09p07020.2_BraZ1	567.679	+	187	844	1369	0.6165084
A09	4062012	4062643	A09p07030.2_BraZ1	3625.2	+	302	631	631	1.0000000
A09	4065230	4068211	A09p07040.2_BraZ1	1421.93	-	609	2404	2981	0.8064408
A09	4070104	4070619	A09p07050.2_BraZ1	923	-	258	491	515	0.9533980
A09	4080242	4081415	A09p07060.2_BraZ1	117.3	-	161	933	1173	0.7953964
A09	4086123	4086804	A09p07070.2_BraZ1	68.1	+	295	672	681	0.9867842
A09	4096107	4097977	A09p07080.2_BraZ1	715.85	+	0	0	1870	0.0000000
A09	4101203	4102842	A09p07090.2_BraZ1	312	+	0	0	1639	0.0000000
A09	4111723	4113593	A09p07100.2_BraZ1	715.85	+	0	0	1870	0.0000000
A09	4116815	4127163	A09p07110.2_BraZ1	2383.67	+	2694	7660	10348	0.7402397
A09	4129233	4131553	A09p07120.2_BraZ1	1194.21	+	1023	2075	2320	0.8943965
A09	4131790	4134690	A09p07130.2_BraZ1	1702.8	-	2042	2858	2900	0.9855173
A09	4135672	4137209	A09p07140.2_BraZ1	353.58	+	1568	1537	1537	1.0000000
A09	4137678	4139391	A09p07150.2_BraZ1	899.646	-	661	1687	1713	0.9848220
A09	4140408	4141510	A09p07160.2_BraZ1	460.465	-	569	957	1102	0.8684211
A09	4142616	4143624	A09p07170.2_BraZ1	100.8	+	249	929	1008	0.9216270
A09	4145970	4151840	A09p07180.2_BraZ1	1937.31	-	3302	5705	5870	0.9718910
A09	4160927	4162551	A09p07190.2_BraZ1	1524	+	534	958	1624	0.5899015
A09	4165580	4165961	A09p07200.2_BraZ1	38.1	-	292	381	381	1.0000000
A09	4166646	4167015	A09p07210.2_BraZ1	36.9	-	139	369	369	1.0000000
A09	4169551	4170950	A09p07220.2_BraZ1	623.687	+	1206	1399	1399	1.0000000
A09	4171385	4173137	A09p07230.2_BraZ1	175.2	-	942	1744	1752	0.9954338
A09	4182447	4182726	A09p07240.2_BraZ1	234	-	143	279	279	1.0000000
A09	4185029	4187523	A09p07250.2_BraZ1	861	-	999	2194	2494	0.8797113
A09	4190787	4191426	A09p07260.2_BraZ1	63.9	+	260	639	639	1.0000000
A09	4193223	4193358	A09p07270.2_BraZ1	13.5	+	282	135	135	1.0000000
A09	4193857	4195364	A09p07280.2_BraZ1	639.503	-	862	1504	1507	0.9980093
A09	4196738	4199091	A09p07290.2_BraZ1	1236.17	+	1148	2353	2353	1.0000000
A09	4199429	4200382	A09p07300.2_BraZ1	435.938	-	553	926	953	0.9716684
A09	4204903	4205554	A09p07310.2_BraZ1	65.1	-	241	651	651	1.0000000
A09	4213947	4217948	A09p07320.2_BraZ1	3253.8	-	2166	3977	4001	0.9940015
A09	4352749	4353517	A09p07330.2_BraZ1	76.8	-	85	719	768	0.9361979
A09	4356422	4357332	A09p07340.2_BraZ1	1428	-	600	910	910	1.0000000
A09	4357721	4363006	A09p07350.2_BraZ1	2383.84	+	2173	4735	5285	0.8959319
A09	4364137	4364278	A09p07360.2_BraZ1	14.1	-	0	0	141	0.0000000
A09	4366500	4367839	A09p07370.2_BraZ1	579	+	497	1184	1339	0.8842420
A09	4371217	4371838	A09p07380.2_BraZ1	204	+	36	477	621	0.7681159
A09	4372722	4373491	A09p07390.2_BraZ1	75.3	+	136	675	769	0.8777633
A09	4378058	4379375	A09p07400.2_BraZ1	711.818	-	194	1058	1317	0.8033409
A09	4386419	4387568	A09p07410.2_BraZ1	890.063	+	614	1113	1149	0.9686684
A09	4396351	4399884	A09p07420.2_BraZ1	175.125	-	722	3120	3533	0.8831022
A09	4400107	4414535	A09p07430.2_BraZ1	2241.22	-	4536	12013	14428	0.8326171
A09	4412597	4413333	A09p07440.2_BraZ1	165	-	182	736	736	1.0000000
A09	4417174	4417814	A09p07450.2_BraZ1	483	-	182	517	640	0.8078125
A09	4418575	4419812	A09p07460.2_BraZ1	820.714	-	717	1237	1237	1.0000000
A09	4420144	4422751	A09p07470.2_BraZ1	1197	+	1227	2577	2607	0.9884925
A09	4423505	4426353	A09p07480.2_BraZ1	1769.14	-	481	2516	2848	0.8834270
A09	4426713	4428143	A09p07490.2_BraZ1	594	+	914	1430	1430	1.0000000
A09	4428531	4429885	A09p07500.2_BraZ1	160.457	-	599	1354	1354	1.0000000
A09	4430313	4434060	A09p07510.2_BraZ1	1524.13	-	1031	3436	3747	0.9170003
A09	4438468	4439995	A09p07520.2_BraZ1	600	-	697	1380	1527	0.9037328
A09	4440342	4443884	A09p07530.2_BraZ1	1706.12	-	2608	3541	3542	0.9997177
A09	4444162	4444974	A09p07540.2_BraZ1	5754	+	484	812	812	1.0000000
A09	4444974	4450282	A09p07550.2_BraZ1	285	+	3989	5268	5308	0.9924642
A09	4445914	4450919	A09p07560.2_BraZ1	1788.11	+	3671	4965	5005	0.9920080
A09	4451322	4453340	A09p07570.2_BraZ1	726.124	+	1243	1973	2018	0.9777007
A09	4454382	4456509	A09p07580.2_BraZ1	1154.31	-	1790	2077	2127	0.9764927
A09	4457610	4458645	A09p07590.2_BraZ1	103.5	-	625	1035	1035	1.0000000
A09	4462409	4465276	A09p07600.2_BraZ1	2514	+	555	2380	2867	0.8301360
A09	4467681	4469936	A09p07610.2_BraZ1	1336.74	+	1482	2227	2255	0.9875832
A09	4470451	4472624	A09p07620.2_BraZ1	1428	-	618	2010	2173	0.9249885
A09	4476521	4478465	A09p07630.2_BraZ1	194.4	+	529	1845	1944	0.9490741
A09	4478928	4479150	A09p07640.2_BraZ1	22.2	-	132	222	222	1.0000000
A09	4481818	4483138	A09p07650.2_BraZ1	3222	-	283	1288	1320	0.9757576
A09	4491768	4494443	A09p07660.2_BraZ1	839.538	-	624	2207	2675	0.8250467
A09	4495030	4497133	A09p07670.2_BraZ1	1144	-	981	1980	2103	0.9415121
A09	4498451	4500268	A09p07680.2_BraZ1	979.364	+	1048	1808	1817	0.9950468
A09	4503305	4506708	A09p07690.2_BraZ1	1986.5	+	310	2216	3403	0.6511901
A09	4511526	4515663	A09p07700.2_BraZ1	1904.38	+	1571	3479	4137	0.8409476
A09	4516510	4517116	A09p07710.2_BraZ1	60.6	-	81	417	606	0.6881188
A09	4522427	4522774	A09p07720.2_BraZ1	246	+	0	0	347	0.0000000
A09	4523387	4523576	A09p07730.2_BraZ1	18.9	-	221	189	189	1.0000000
A09	4526197	4527445	A09p07740.2_BraZ1	124.8	+	1526	1248	1248	1.0000000
A09	4528402	4529606	A09p07750.2_BraZ1	667	-	161	856	1204	0.7109634
A09	4529901	4530315	A09p07760.2_BraZ1	41.4	-	24	346	414	0.8357488
A09	4533871	4535516	A09p07770.2_BraZ1	891.771	+	1452	1645	1645	1.0000000
A09	4536199	4537087	A09p07780.2_BraZ1	86.1	-	835	861	888	0.9695946
A09	4537638	4539562	A09p07790.2_BraZ1	904.227	+	1002	1807	1924	0.9391892
A09	4540453	4542898	A09p07800.2_BraZ1	1675.46	-	1168	2316	2445	0.9472393
A09	4545374	4545707	A09p07810.2_BraZ1	33.3	-	113	279	333	0.8378378
A09	4546196	4547635	A09p07820.2_BraZ1	781	+	1010	1424	1439	0.9895761
A09	4548697	4550635	A09p07830.2_BraZ1	1239	-	1086	1543	1938	0.7961816
A09	4558966	4562618	A09p07840.2_BraZ1	2082.5	+	719	2568	3652	0.7031763
A09	4566054	4568076	A09p07850.2_BraZ1	1755	-	1082	1977	2022	0.9777448
A09	4568863	4571212	A09p07860.2_BraZ1	210	-	2229	2273	2349	0.9676458
A09	4573348	4573660	A09p07870.2_BraZ1	31.2	+	118	312	312	1.0000000
A09	4579612	4582992	A09p07880.2_BraZ1	485	+	1232	2926	3380	0.8656805
A09	4587549	4588935	A09p07890.2_BraZ1	1193.5	-	15	594	1386	0.4285714
A09	4591677	4593108	A09p07900.2_BraZ1	1344	-	1300	1431	1431	1.0000000
A09	4596015	4597002	A09p07910.2_BraZ1	98.7	-	380	987	987	1.0000000
A09	4598005	4601101	A09p07920.2_BraZ1	1740.43	-	1850	3091	3096	0.9983850
A09	4602293	4612129	A09p07930.2_BraZ1	551.25	-	1628	5798	9836	0.5894673
A09	4605166	4606591	A09p07940.2_BraZ1	2241	+	411	1071	1425	0.7515789
A09	4612745	4614705	A09p07950.2_BraZ1	1007.33	-	512	1853	1960	0.9454082
A09	4615515	4617823	A09p07960.2_BraZ1	240	+	806	2173	2308	0.9415078
A09	4619095	4621015	A09p07970.2_BraZ1	1179	+	722	1529	1920	0.7963542
A09	4627466	4628348	A09p07980.2_BraZ1	735	+	504	789	882	0.8945578
A09	4631116	4631716	A09p07990.2_BraZ1	60	+	81	476	600	0.7933334
A09	4632685	4632990	A09p08000.2_BraZ1	282	-	144	305	305	1.0000000
A09	4643137	4644298	A09p08010.2_BraZ1	996	+	860	1161	1161	1.0000000
A09	4644981	4645667	A09p08020.2_BraZ1	358.147	+	612	686	686	1.0000000
A09	4645906	4646101	A09p08030.2_BraZ1	19.5	-	248	195	195	1.0000000
A09	4649405	4650754	A09p08040.2_BraZ1	959.318	-	65	297	1349	0.2201631
A09	4673515	4673926	A09p08050.2_BraZ1	41.1	-	56	280	411	0.6812652
A09	4675113	4675521	A09p08060.2_BraZ1	40.8	-	517	408	408	1.0000000
A09	4680391	4680550	A09p08070.2_BraZ1	15.9	-	260	159	159	1.0000000
A09	4682668	4683076	A09p08080.2_BraZ1	40.8	-	196	396	408	0.9705882
A09	4683966	4685782	A09p08090.2_BraZ1	2111.25	+	898	1811	1816	0.9972467
A09	4689419	4690211	A09p08100.2_BraZ1	408	-	426	697	792	0.8800505
A09	4696633	4698644	A09p08110.2_BraZ1	9145	+	972	1781	2011	0.8856291
A09	4702786	4703021	A09p08120.2_BraZ1	204	-	408	235	235	1.0000000
A09	4703638	4714416	A09p08130.2_BraZ1	3033.12	-	5820	10594	10778	0.9829282
A09	4720553	4722188	A09p08140.2_BraZ1	552.9	-	2024	1635	1635	1.0000000
A09	4727314	4730224	A09p08150.2_BraZ1	1095	-	522	2052	2910	0.7051547
A09	4733530	4733659	A09p08160.2_BraZ1	12.9	-	219	129	129	1.0000000
A09	4735584	4737886	A09p08170.2_BraZ1	1839	-	110	1443	2302	0.6268462
A09	4742455	4742626	A09p08180.2_BraZ1	17.1	+	105	171	171	1.0000000
A09	4743419	4743672	A09p08190.2_BraZ1	204	+	43	253	253	1.0000000
A09	4745194	4745402	A09p08200.2_BraZ1	177	+	245	208	208	1.0000000
A09	4757056	4760085	A09p08210.2_BraZ1	1584	+	670	2398	3029	0.7916804
A09	4761615	4764152	A09p08220.2_BraZ1	664.342	+	611	2292	2537	0.9034293
A09	4765414	4766146	A09p08230.2_BraZ1	73.2	+	314	732	732	1.0000000
A09	4768299	4771110	A09p08240.2_BraZ1	1302.37	-	2187	2743	2811	0.9758093
A09	4773798	4776523	A09p08250.2_BraZ1	1229.6	+	1065	2319	2725	0.8510092
A09	4777222	4778754	A09p08260.2_BraZ1	599.057	-	1020	1532	1532	1.0000000
A09	4781655	4783287	A09p08270.2_BraZ1	615	+	258	1527	1632	0.9356618
A09	4784176	4788523	A09p08280.2_BraZ1	3847.44	-	267	2294	4347	0.5277203
A09	4791020	4795661	A09p08290.2_BraZ1	3858.75	-	189	1594	4641	0.3434605
A09	4803723	4806977	A09p08300.2_BraZ1	1415.62	+	2281	3254	3254	1.0000000
A09	4808265	4808553	A09p08310.2_BraZ1	28.8	+	397	288	288	1.0000000
A09	4811601	4811937	A09p08320.2_BraZ1	33.6	+	400	336	336	1.0000000
A09	4813484	4814975	A09p08330.2_BraZ1	1023	-	381	1400	1491	0.9389671
A09	4818491	4820290	A09p08340.2_BraZ1	424.643	-	1073	1758	1799	0.9772096
A09	4824066	4825950	A09p08350.2_BraZ1	969.458	+	1794	1839	1884	0.9761146
A09	4826681	4830051	A09p08360.2_BraZ1	546	-	3205	3370	3370	1.0000000
A09	4830793	4832275	A09p08370.2_BraZ1	147.9	+	909	1393	1482	0.9399460
A09	4832504	4833430	A09p08380.2_BraZ1	339.3	-	1225	926	926	1.0000000
A09	4833839	4834637	A09p08390.2_BraZ1	364.378	-	738	798	798	1.0000000
A09	4835176	4840741	A09p08400.2_BraZ1	1278.96	+	3944	5406	5565	0.9714286
A09	4841016	4842583	A09p08410.2_BraZ1	632.4	-	940	1518	1567	0.9687300
A09	4845920	4846217	A09p08420.2_BraZ1	29.7	+	201	297	297	1.0000000
A09	4846794	4847154	A09p08430.2_BraZ1	1722	+	222	350	360	0.9722222
A09	4852909	4853291	A09p08440.2_BraZ1	303	+	431	382	382	1.0000000
A09	4856728	4857067	A09p08450.2_BraZ1	249	+	69	329	339	0.9705015
A09	4858334	4858807	A09p08460.2_BraZ1	39	-	88	393	473	0.8308668
A09	4860602	4860935	A09p08470.2_BraZ1	33.3	+	47	297	333	0.8918919
A09	4863244	4865654	A09p08480.2_BraZ1	1075.77	-	902	2040	2410	0.8464730
A09	4869450	4869981	A09p08490.2_BraZ1	53.1	-	11	276	531	0.5197740
A09	4877413	4878355	A09p08500.2_BraZ1	94.2	-	167	910	942	0.9660297
A09	4878517	4880982	A09p08510.2_BraZ1	1283.48	-	677	2127	2465	0.8628803
A09	4881484	4884968	A09p08520.2_BraZ1	1564.05	-	1148	2886	3484	0.8283582
A09	4886091	4886727	A09p08530.2_BraZ1	63.6	+	404	636	636	1.0000000
A09	4889285	4889908	A09p08540.2_BraZ1	306	-	585	564	623	0.9052969
A09	4892422	4894195	A09p08550.2_BraZ1	1158	+	403	1540	1773	0.8685843
A09	4895208	4898634	A09p08560.2_BraZ1	136.5	-	783	3040	3426	0.8873321
A09	4895776	4896136	A09p08570.2_BraZ1	34.8	-	148	360	360	1.0000000
A09	4901654	4904779	A09p08580.2_BraZ1	1886.7	+	854	3067	3125	0.9814400
A09	4905185	4907020	A09p08590.2_BraZ1	875.556	-	551	1544	1835	0.8414169
A09	4909487	4911016	A09p08600.2_BraZ1	1455	-	1252	1515	1529	0.9908437
A09	4912619	4919008	A09p08610.2_BraZ1	3095.68	-	3446	6049	6389	0.9467835
A09	4920402	4921915	A09p08620.2_BraZ1	692.014	-	928	1431	1513	0.9458030
A09	4923264	4926381	A09p08630.2_BraZ1	1809.44	-	812	2226	3117	0.7141482
A09	4928564	4930107	A09p08640.2_BraZ1	693.9	-	690	1510	1543	0.9786131
A09	4930987	4932584	A09p08650.2_BraZ1	151.5	-	529	1448	1597	0.9067001
A09	4936415	4937542	A09p08660.2_BraZ1	434.691	-	923	1118	1127	0.9920142
A09	4938368	4938938	A09p08670.2_BraZ1	309	-	454	570	570	1.0000000
A09	4939286	4940027	A09p08680.2_BraZ1	554.286	+	298	741	741	1.0000000
A09	4940231	4943700	A09p08690.2_BraZ1	1382.32	-	1847	3469	3469	1.0000000
A09	4944347	4946019	A09p08700.2_BraZ1	828	+	359	1460	1672	0.8732057
A09	4949383	4951375	A09p08710.2_BraZ1	459	-	22	370	1992	0.1857430
A09	4954243	4956615	A09p08720.2_BraZ1	1001.85	+	343	1706	2372	0.7192243
A09	4970080	4973135	A09p08730.2_BraZ1	1716.72	-	592	2709	3055	0.8867431
A09	4973586	4976803	A09p08740.2_BraZ1	1431.14	+	1085	2892	3217	0.8989742
A09	4977392	4979312	A09p08750.2_BraZ1	1487.83	+	802	1920	1920	1.0000000
A09	5063010	5063137	A09p08760.2_BraZ1	12.6	+	0	0	127	0.0000000
A09	5063862	5073115	A09p08770.2_BraZ1	4396	-	4868	9250	9253	0.9996758
A09	5076978	5078385	A09p08780.2_BraZ1	140.7	-	446	1407	1407	1.0000000
A09	5080176	5081681	A09p08790.2_BraZ1	321.281	-	936	1487	1505	0.9880399
A09	5082543	5084986	A09p08800.2_BraZ1	1533	+	258	1672	2443	0.6844044
A09	5085491	5088265	A09p08810.2_BraZ1	1260	-	1133	2596	2774	0.9358327
A09	5090214	5092024	A09p08820.2_BraZ1	15687	+	350	1719	1810	0.9497238
A09	5095528	5096689	A09p08830.2_BraZ1	959.318	+	261	1080	1161	0.9302326
A09	5099302	5102462	A09p08840.2_BraZ1	2688.46	+	331	2553	3160	0.8079114
A09	5102867	5106217	A09p08850.2_BraZ1	1090.58	-	1030	3182	3350	0.9498507
A09	5107945	5110497	A09p08860.2_BraZ1	12240	-	865	2293	2552	0.8985110
A09	5111703	5114254	A09p08870.2_BraZ1	1216.29	-	1502	2497	2551	0.9788318
A09	5115179	5116895	A09p08880.2_BraZ1	171.6	+	999	1716	1716	1.0000000
A09	5117500	5117967	A09p08890.2_BraZ1	285	-	77	451	467	0.9657388
A09	5120412	5121018	A09p08900.2_BraZ1	60.6	+	191	606	606	1.0000000
A09	5122993	5123325	A09p08910.2_BraZ1	240	-	154	332	332	1.0000000
A09	5136900	5138720	A09p08920.2_BraZ1	979.036	+	1180	1820	1820	1.0000000
A09	5138928	5139624	A09p08930.2_BraZ1	492.054	-	527	696	696	1.0000000
A09	5140088	5141351	A09p08940.2_BraZ1	126.3	+	330	1176	1263	0.9311164
A09	5143323	5144682	A09p08950.2_BraZ1	135.9	-	837	1359	1359	1.0000000
A09	5147259	5148068	A09p08960.2_BraZ1	320.139	-	1235	809	809	1.0000000
A09	5148808	5149045	A09p08970.2_BraZ1	23.7	-	247	237	237	1.0000000
A09	5150689	5151776	A09p08980.2_BraZ1	483.446	+	489	1073	1087	0.9871205
A09	5153444	5155338	A09p08990.2_BraZ1	986.795	-	1261	1867	1894	0.9857445
A09	5159396	5164252	A09p09000.2_BraZ1	1992.29	+	1982	4575	4856	0.9421334
A09	5165417	5169227	A09p09010.2_BraZ1	381	+	142	1286	3810	0.3375328
A09	5169771	5172056	A09p09020.2_BraZ1	1692	-	790	2176	2285	0.9522976
A09	5173140	5173907	A09p09030.2_BraZ1	279	+	225	632	767	0.8239896
A09	5175711	5178124	A09p09040.2_BraZ1	1382.97	+	636	2274	2413	0.9423953
A09	5180239	5184586	A09p09050.2_BraZ1	1960.97	+	1296	3814	4347	0.8773867
A09	5185380	5186441	A09p09060.2_BraZ1	298.467	-	607	1061	1061	1.0000000
A09	5187065	5189008	A09p09070.2_BraZ1	1227	+	868	1611	1943	0.8291302
A09	5190434	5191209	A09p09080.2_BraZ1	484.105	+	571	775	775	1.0000000
A09	5192182	5194299	A09p09090.2_BraZ1	858.49	+	1654	2091	2117	0.9877185
A09	5199788	5201251	A09p09100.2_BraZ1	56.7	+	240	1057	1463	0.7224880
A09	5203061	5204744	A09p09110.2_BraZ1	168.3	-	908	1683	1683	1.0000000
A09	5210526	5212988	A09p09120.2_BraZ1	976.25	-	519	2345	2462	0.9524776
A09	5213937	5217132	A09p09130.2_BraZ1	2254.99	-	1224	3171	3195	0.9924883
A09	5219272	5219711	A09p09140.2_BraZ1	288	-	0	0	439	0.0000000
A09	5223228	5225700	A09p09150.2_BraZ1	1416.53	+	1724	2472	2472	1.0000000
A09	5226002	5228170	A09p09160.2_BraZ1	1242.92	-	2254	2118	2168	0.9769373
A09	5229824	5230355	A09p09170.2_BraZ1	53.1	+	56	252	531	0.4745763
A09	5234136	5235654	A09p09180.2_BraZ1	765	+	852	1499	1518	0.9874835
A09	5235820	5236829	A09p09190.2_BraZ1	483	-	1067	1009	1009	1.0000000
A09	5239046	5241768	A09p09200.2_BraZ1	327	+	2259	2698	2722	0.9911830
A09	5242546	5243733	A09p09210.2_BraZ1	821.5	-	643	1157	1187	0.9747262
A09	5244076	5257012	A09p09220.2_BraZ1	30.9	-	1261	8347	12936	0.6452535
A09	5258964	5260571	A09p09230.2_BraZ1	1281	+	293	834	1607	0.5189795
A09	5261538	5263537	A09p09240.2_BraZ1	923	-	52	868	1999	0.4342171
A09	5268333	5268804	A09p09250.2_BraZ1	47.1	-	378	471	471	1.0000000
A09	5275026	5280180	A09p09260.2_BraZ1	3019.46	+	1534	4676	5154	0.9072565
A09	5286742	5288755	A09p09270.2_BraZ1	1146	+	1223	2013	2013	1.0000000
A09	5293436	5295884	A09p09280.2_BraZ1	1360.8	+	986	2077	2448	0.8484477
A09	5296869	5297193	A09p09290.2_BraZ1	32.4	+	548	324	324	1.0000000
A09	5299896	5301012	A09p09300.2_BraZ1	663.3	+	2018	1116	1116	1.0000000
A09	5301613	5303101	A09p09310.2_BraZ1	980	+	521	1441	1488	0.9684139
A09	5303757	5305123	A09p09320.2_BraZ1	116.643	+	1050	1366	1366	1.0000000
A09	5305843	5309692	A09p09330.2_BraZ1	1496.45	-	1083	3653	3849	0.9490777
A09	5311188	5312097	A09p09340.2_BraZ1	90.9	-	211	863	909	0.9493949
A09	5313133	5314392	A09p09350.2_BraZ1	254.126	-	1197	1259	1259	1.0000000
A09	5314759	5316198	A09p09360.2_BraZ1	938.957	-	707	1325	1439	0.9207783
A09	5316866	5320116	A09p09370.2_BraZ1	1829.82	-	1678	3152	3250	0.9698461
A09	5320921	5322068	A09p09380.2_BraZ1	888	+	817	1125	1147	0.9808195
A09	5325307	5326264	A09p09390.2_BraZ1	95.7	+	112	531	957	0.5548589
A09	5330761	5330980	A09p09400.2_BraZ1	16.2	-	45	176	219	0.8036529
A09	5343481	5345355	A09p09410.2_BraZ1	1114.35	+	112	769	1874	0.4103522
A09	5346685	5348173	A09p09420.2_BraZ1	678	+	639	1429	1488	0.9603494
A09	5348888	5349326	A09p09430.2_BraZ1	43.8	-	163	438	438	1.0000000
A09	5363521	5364268	A09p09440.2_BraZ1	74.7	-	90	733	747	0.9812584
A09	5378284	5378710	A09p09450.2_BraZ1	41.1	-	51	278	426	0.6525822
A09	5380100	5383522	A09p09460.2_BraZ1	1209.47	-	1188	3090	3422	0.9029807
A09	5385663	5386098	A09p09470.2_BraZ1	159	-	100	435	435	1.0000000
A09	5394864	5395632	A09p09480.2_BraZ1	76.8	+	128	754	768	0.9817708
A09	5400118	5401973	A09p09490.2_BraZ1	824.896	-	535	1846	1855	0.9951482
A09	5405422	5406722	A09p09500.2_BraZ1	76.8	-	362	1288	1300	0.9907692
A09	5409774	5410285	A09p09510.2_BraZ1	2115	+	379	511	511	1.0000000
A09	5411024	5413994	A09p09520.2_BraZ1	2265.69	-	696	2522	2970	0.8491582
A09	5414809	5415403	A09p09530.2_BraZ1	59.4	-	82	488	594	0.8215488
A09	5415850	5417299	A09p09540.2_BraZ1	144.9	-	376	1208	1449	0.8336784
A09	5421237	5422095	A09p09550.2_BraZ1	85.8	-	391	667	858	0.7773893
A09	5429245	5429671	A09p09560.2_BraZ1	42.6	-	82	333	426	0.7816901
A09	5439441	5440713	A09p09570.2_BraZ1	914.827	+	1249	1272	1272	1.0000000
A09	5443673	5446738	A09p09580.2_BraZ1	28243.5	+	967	2821	3065	0.9203915
A09	5447832	5449206	A09p09590.2_BraZ1	137.4	+	311	1213	1374	0.8828239
A09	5450468	5450944	A09p09600.2_BraZ1	324	+	61	281	476	0.5903361
A09	5451498	5455394	A09p09610.2_BraZ1	2581.39	+	1067	3356	3896	0.8613963
A09	5461689	5463062	A09p09620.2_BraZ1	1089	+	127	1048	1373	0.7632921
A09	5469410	5471008	A09p09630.2_BraZ1	1401.03	-	107	1308	1598	0.8185232
A09	5475298	5476484	A09p09640.2_BraZ1	746.7	-	349	978	1186	0.8246205
A09	5477530	5478364	A09p09650.2_BraZ1	83.4	-	181	794	834	0.9520383
A09	5481202	5482767	A09p09660.2_BraZ1	778.8	-	1543	1385	1565	0.8849840
A09	5484263	5484514	A09p09670.2_BraZ1	138	+	71	251	251	1.0000000
A09	5487617	5488949	A09p09680.2_BraZ1	133.2	-	188	1214	1332	0.9114114
A09	5490921	5491770	A09p09690.2_BraZ1	363	+	496	849	849	1.0000000
A09	5493100	5494030	A09p09700.2_BraZ1	552	+	120	907	930	0.9752688
A09	5494862	5495764	A09p09710.2_BraZ1	410.294	-	652	902	902	1.0000000
A09	5496513	5497952	A09p09720.2_BraZ1	810.328	+	718	1319	1439	0.9166088
A09	5498272	5499126	A09p09730.2_BraZ1	494.455	-	542	854	854	1.0000000
A09	5503410	5505529	A09p09740.2_BraZ1	865.444	+	261	1590	2119	0.7503539
A09	5506108	5506394	A09p09750.2_BraZ1	201	-	24	139	286	0.4860140
A09	5507066	5508582	A09p09760.2_BraZ1	800.222	-	625	1438	1516	0.9485488
A09	5511977	5512673	A09p09770.2_BraZ1	69.6	+	122	696	696	1.0000000
A09	5516980	5519236	A09p09780.2_BraZ1	1571.08	+	600	1975	2256	0.8754433
A09	5524255	5525060	A09p09790.2_BraZ1	711	+	142	665	805	0.8260869
A09	5528506	5529066	A09p09800.2_BraZ1	235	+	196	560	560	1.0000000
A09	5529227	5530529	A09p09810.2_BraZ1	949	+	325	1286	1302	0.9877112
A09	5530849	5532318	A09p09820.2_BraZ1	930	-	227	1267	1469	0.8624915
A09	5569277	5569894	A09p09830.2_BraZ1	516	+	5	149	617	0.2414911
A09	5571144	5571775	A09p09840.2_BraZ1	192	+	202	631	631	1.0000000
A09	5571924	5573430	A09p09850.2_BraZ1	963	+	1155	1495	1506	0.9926959
A09	5575395	5577693	A09p09860.2_BraZ1	229.8	+	4597	2298	2298	1.0000000
A09	5581550	5582399	A09p09870.2_BraZ1	84.9	+	525	849	849	1.0000000
A09	5583213	5585869	A09p09880.2_BraZ1	2004.17	-	306	1530	2656	0.5760542
A09	5587414	5590996	A09p09890.2_BraZ1	1742.55	-	1243	3392	3582	0.9469570
A09	5592372	5594060	A09p09900.2_BraZ1	815.771	+	356	1688	1688	1.0000000
A09	5595061	5596636	A09p09910.2_BraZ1	157.5	+	293	1550	1575	0.9841270
A09	5599052	5605551	A09p09920.2_BraZ1	622.826	+	1996	5064	6499	0.7791968
A09	5601483	5603988	A09p09930.2_BraZ1	250.5	+	247	1231	2505	0.4914172
A09	5608898	5609438	A09p09940.2_BraZ1	54	+	20	240	540	0.4444444
A09	5610333	5610507	A09p09950.2_BraZ1	17.4	-	109	173	174	0.9942529
A09	5611069	5613113	A09p09960.2_BraZ1	935	-	1054	2039	2044	0.9975538
A09	5613923	5615478	A09p09970.2_BraZ1	1350	+	469	1535	1555	0.9871383
A09	5617023	5617332	A09p09980.2_BraZ1	30.9	+	401	309	309	1.0000000
A09	5619743	5620115	A09p09990.2_BraZ1	37.2	-	115	372	372	1.0000000
A09	5620902	5621700	A09p10000.2_BraZ1	642	-	283	726	798	0.9097744
A09	5627823	5629563	A09p10010.2_BraZ1	1393.52	+	105	1466	1740	0.8425288
A09	5631548	5631836	A09p10020.2_BraZ1	28.8	+	4	52	288	0.1805556
A09	5631876	5632478	A09p10030.2_BraZ1	264	+	0	0	602	0.0000000
A09	5632642	5633002	A09p10040.2_BraZ1	231	+	0	0	360	0.0000000
A09	5636356	5637115	A09p10050.2_BraZ1	168	+	65	353	759	0.4650856
A09	5637196	5638790	A09p10060.2_BraZ1	324	+	0	0	1594	0.0000000
A09	5640593	5649342	A09p10070.2_BraZ1	2459.65	+	4550	7516	8749	0.8590696
A09	5646982	5647850	A09p10080.2_BraZ1	5166	-	652	738	868	0.8502304
A09	5649744	5650008	A09p10090.2_BraZ1	26.4	-	96	264	264	1.0000000
A09	5650912	5652067	A09p10100.2_BraZ1	1043.8	-	100	906	1155	0.7844156
A09	5652836	5656471	A09p10110.2_BraZ1	1657.87	+	1145	3278	3635	0.9017882
A09	5656694	5659274	A09p10120.2_BraZ1	258	-	1359	2422	2580	0.9387597
A09	5662439	5663078	A09p10130.2_BraZ1	63.9	+	506	639	639	1.0000000
A09	5663422	5664830	A09p10140.2_BraZ1	611.348	-	1758	1408	1408	1.0000000
A09	5666246	5668479	A09p10150.2_BraZ1	1561.48	-	142	1426	2233	0.6386028
A09	5670470	5673554	A09p10160.2_BraZ1	2883	+	2146	3014	3084	0.9773022
A09	5679319	5680975	A09p10170.2_BraZ1	1723.17	+	1794	1656	1656	1.0000000
A09	5682154	5688582	A09p10180.2_BraZ1	1071	-	1047	4551	6428	0.7079962
A09	5692516	5696896	A09p10190.2_BraZ1	1077.03	+	3253	4258	4380	0.9721461
A09	5711406	5711706	A09p10200.2_BraZ1	30	-	6	78	300	0.2600000
A09	5717879	5718407	A09p10210.2_BraZ1	52.8	-	61	302	528	0.5719697
A09	5728190	5729087	A09p10220.2_BraZ1	516	+	1304	897	897	1.0000000
A09	5729642	5732942	A09p10230.2_BraZ1	1433.13	-	1227	3107	3300	0.9415151
A09	5733584	5740796	A09p10240.2_BraZ1	2431.03	-	3458	6579	7212	0.9122296
A09	5747007	5748831	A09p10250.2_BraZ1	9386	+	1519	1824	1824	1.0000000
A09	5749067	5753932	A09p10260.2_BraZ1	1257.75	-	1255	3859	4865	0.7932169
A09	5763156	5764593	A09p10270.2_BraZ1	143.7	-	834	1425	1437	0.9916493
A09	5766060	5766565	A09p10280.2_BraZ1	34.2	-	439	505	505	1.0000000
A09	5774363	5776876	A09p10290.2_BraZ1	1242.6	+	1084	2433	2513	0.9681655
A09	5777926	5779150	A09p10300.2_BraZ1	122.4	+	181	970	1224	0.7924837
A09	5783514	5784571	A09p10310.2_BraZ1	957	+	62	310	1057	0.2932829
A09	5784950	5787368	A09p10320.2_BraZ1	1361.38	-	4517	2418	2418	1.0000000
A09	5790323	5792602	A09p10330.2_BraZ1	1321.82	-	1820	2162	2279	0.9486617
A09	5800964	5804274	A09p10340.2_BraZ1	1633.9	+	754	3031	3310	0.9157100
A09	5804552	5805104	A09p10350.2_BraZ1	55.2	-	51	417	552	0.7554348
A09	5806275	5806958	A09p10360.2_BraZ1	46.8	-	49	620	683	0.9077599
A09	5808985	5810681	A09p10370.2_BraZ1	1007.47	-	266	1542	1696	0.9091981
A09	5815063	5815192	A09p10380.2_BraZ1	12.9	-	225	129	129	1.0000000
A09	5816728	5818195	A09p10390.2_BraZ1	510.394	+	683	1343	1467	0.9154738
A09	5818371	5818565	A09p10400.2_BraZ1	13.5	+	27	36	194	0.1855670
A09	5818798	5821561	A09p10410.2_BraZ1	1277.42	+	1084	2755	2763	0.9971046
A09	5823345	5827010	A09p10420.2_BraZ1	1676.35	+	1616	3599	3665	0.9819918
A09	5828533	5833903	A09p10430.2_BraZ1	3167.63	+	1322	4702	5370	0.8756052
A09	5833982	5835048	A09p10440.2_BraZ1	685.875	-	158	942	1066	0.8836773
A09	5842152	5842911	A09p10450.2_BraZ1	75.9	+	62	475	759	0.6258234
A09	5853192	5853589	A09p10460.2_BraZ1	339	-	232	397	397	1.0000000
A09	5856146	5858013	A09p10470.2_BraZ1	800.125	-	235	1620	1867	0.8677022
A09	5860843	5861588	A09p10480.2_BraZ1	396.579	+	473	745	745	1.0000000
A09	5862155	5863843	A09p10490.2_BraZ1	852.5	-	1146	1688	1688	1.0000000
A09	5865176	5866707	A09p10500.2_BraZ1	977.786	-	297	959	1531	0.6263880
A09	5873428	5874052	A09p10510.2_BraZ1	5670	-	158	605	624	0.9695513
A09	5876704	5877097	A09p10520.2_BraZ1	303	-	247	393	393	1.0000000
A09	5877886	5878757	A09p10530.2_BraZ1	7155	-	200	778	871	0.8932262
A09	5879778	5880908	A09p10540.2_BraZ1	891.48	-	461	1130	1130	1.0000000
A09	5883327	5886096	A09p10550.2_BraZ1	1503.37	+	626	2591	2769	0.9357169
A09	5886894	5896134	A09p10560.2_BraZ1	3212.27	+	2856	8576	9240	0.9281386
A09	5896615	5899164	A09p10570.2_BraZ1	1323.08	-	618	2009	2549	0.7881522
A09	5899706	5901578	A09p10580.2_BraZ1	1305	+	219	1704	1872	0.9102564
A09	5902467	5908766	A09p10590.2_BraZ1	658.401	-	2588	6225	6299	0.9882521
A09	5909033	5910811	A09p10600.2_BraZ1	1221.95	+	436	1724	1778	0.9696288
A09	5914772	5915693	A09p10610.2_BraZ1	92.1	+	107	921	921	1.0000000
A09	5918471	5918873	A09p10620.2_BraZ1	40.2	+	372	402	402	1.0000000
A09	5919501	5921417	A09p10630.2_BraZ1	898.702	+	1147	1916	1916	1.0000000
A09	5921976	5922665	A09p10640.2_BraZ1	347.826	-	209	689	689	1.0000000
A09	5922966	5931562	A09p10650.2_BraZ1	3565.42	+	1426	7172	8596	0.8343415
A09	5932921	5936906	A09p10660.2_BraZ1	1150.23	-	1449	3890	3985	0.9761606
A09	5938113	5939990	A09p10670.2_BraZ1	1024.83	-	1037	1857	1877	0.9893447
A09	5943210	5949374	A09p10680.2_BraZ1	3268.57	+	949	5210	6164	0.8452303
A09	5967621	5968440	A09p10690.2_BraZ1	81.9	-	71	503	819	0.6141636
A09	5982697	5982877	A09p10700.2_BraZ1	15.3	-	310	180	180	1.0000000
A09	5986291	5988337	A09p10710.2_BraZ1	1468.55	+	123	1680	2046	0.8211144
A09	5993800	5994094	A09p10720.2_BraZ1	29.4	+	208	245	294	0.8333333
A09	5995587	5998343	A09p10730.2_BraZ1	1292.5	+	417	1914	2756	0.6944848
A09	5999389	6000591	A09p10740.2_BraZ1	495	-	299	1165	1202	0.9692180
A09	6002476	6004854	A09p10750.2_BraZ1	1449.09	-	474	2142	2378	0.9007570
A09	6010121	6010456	A09p10760.2_BraZ1	243	+	323	335	335	1.0000000
A09	6022417	6024635	A09p10770.2_BraZ1	1040.27	-	531	1727	2218	0.7786294
A09	6032919	6034641	A09p10780.2_BraZ1	586.929	+	666	1584	1722	0.9198606
A09	6039550	6041465	A09p10790.2_BraZ1	765	-	1536	1915	1915	1.0000000
A09	6045095	6046193	A09p10800.2_BraZ1	109.2	-	112	998	1098	0.9089253
A09	6048499	6049723	A09p10810.2_BraZ1	122.4	-	22	476	1224	0.3888889
A09	6050836	6052786	A09p10820.2_BraZ1	867.808	-	420	1724	1950	0.8841026
A09	6054560	6064286	A09p10830.2_BraZ1	4859.63	-	1432	6751	9726	0.6941189
A09	6066828	6067261	A09p10840.2_BraZ1	264	-	218	433	433	1.0000000
A09	6076326	6077081	A09p10850.2_BraZ1	2142	+	2152	755	755	1.0000000
A09	6082136	6082604	A09p10860.2_BraZ1	46.8	+	46	378	468	0.8076923
A09	6088161	6093024	A09p10870.2_BraZ1	1780.75	+	942	4283	4863	0.8807321
A09	6093461	6094098	A09p10880.2_BraZ1	62.7	-	57	440	637	0.6907378
A09	6096126	6098661	A09p10890.2_BraZ1	2445	+	148	1697	2535	0.6694280
A09	6099859	6110593	A09p10900.2_BraZ1	5155.98	+	550	4466	10734	0.4160611
A09	6111367	6115186	A09p10910.2_BraZ1	1391.7	+	1620	3730	3819	0.9766955
A09	6116535	6120350	A09p10920.2_BraZ1	1370.48	+	1420	3049	3815	0.7992136
A09	6125114	6125240	A09p10930.2_BraZ1	12.6	+	22	126	126	1.0000000
A09	6125522	6128118	A09p10940.2_BraZ1	1087.5	+	529	1977	2596	0.7615563
A09	6134265	6137244	A09p10950.2_BraZ1	1730.04	+	655	2630	2979	0.8828466
A09	6140047	6141288	A09p10960.2_BraZ1	674.297	+	348	1232	1241	0.9927478
A09	6147440	6149285	A09p10970.2_BraZ1	936.9	-	111	1277	1845	0.6921409
A09	6160368	6160497	A09p10980.2_BraZ1	12.9	-	93	129	129	1.0000000
A09	6163568	6166266	A09p10990.2_BraZ1	1890	-	1045	2290	2698	0.8487769
A09	6178110	6178809	A09p11000.2_BraZ1	424.095	+	140	636	699	0.9098712
A09	6179915	6183062	A09p11010.2_BraZ1	940.941	+	1707	2901	3147	0.9218303
A09	6196742	6199384	A09p11020.2_BraZ1	1395.07	+	20	1140	2642	0.4314913
A09	6214688	6217325	A09p11030.2_BraZ1	1340.93	+	27	400	2637	0.1516875
A09	6221280	6222170	A09p11040.2_BraZ1	822	+	459	890	890	1.0000000
A09	6222568	6226032	A09p11050.2_BraZ1	704.097	-	1316	3257	3464	0.9402425
A09	6228901	6230182	A09p11060.2_BraZ1	552	+	164	1149	1281	0.8969555
A09	6230862	6231045	A09p11070.2_BraZ1	18.3	-	2	118	183	0.6448088
A09	6236165	6236715	A09p11080.2_BraZ1	324	+	93	531	550	0.9654545
A09	6238490	6240520	A09p11090.2_BraZ1	1123.5	-	300	1798	2030	0.8857143
A09	6241772	6243760	A09p11100.2_BraZ1	1773	-	20	330	1988	0.1659960
A09	6251473	6252191	A09p11110.2_BraZ1	411.429	+	0	0	718	0.0000000
A09	6259435	6261846	A09p11120.2_BraZ1	758.776	-	938	2411	2411	1.0000000
A09	6262805	6264227	A09p11130.2_BraZ1	9083	-	476	1422	1422	1.0000000
A09	6267009	6269134	A09p11140.2_BraZ1	777	-	371	1636	2125	0.7698824
A09	6273379	6276202	A09p11150.2_BraZ1	2157	+	725	2391	2823	0.8469713
A09	6281140	6282307	A09p11160.2_BraZ1	116.7	-	4	285	1167	0.2442159
A09	6284015	6285739	A09p11170.2_BraZ1	1623	-	192	1559	1724	0.9042923
A09	6287744	6288994	A09p11180.2_BraZ1	8115.38	+	241	1244	1250	0.9952000
A09	6290584	6291562	A09p11190.2_BraZ1	97.8	-	604	978	978	1.0000000
A09	6295081	6296014	A09p11200.2_BraZ1	642	+	586	933	933	1.0000000
A09	6298186	6300364	A09p11210.2_BraZ1	1764.91	+	1057	2111	2178	0.9692378
A09	6303410	6304036	A09p11220.2_BraZ1	450	+	81	626	626	1.0000000
A09	6313405	6315410	A09p11230.2_BraZ1	1752	+	298	1910	2005	0.9526185
A09	6318460	6319030	A09p11240.2_BraZ1	57	+	2	92	570	0.1614035
A09	6319464	6319656	A09p11250.2_BraZ1	19.2	-	201	192	192	1.0000000
A09	6322582	6323863	A09p11260.2_BraZ1	1131	+	384	860	1281	0.6713505
A09	6328511	6329420	A09p11270.2_BraZ1	90.9	-	9	248	909	0.2728273
A09	6337398	6342570	A09p11280.2_BraZ1	191.25	-	3640	5172	5172	1.0000000
A09	6353202	6354176	A09p11290.2_BraZ1	765.333	-	630	974	974	1.0000000
A09	6355375	6356601	A09p11300.2_BraZ1	1039.88	-	319	1226	1226	1.0000000
A09	6357293	6358390	A09p11310.2_BraZ1	930	-	242	824	1097	0.7511395
A09	6363054	6363468	A09p11320.2_BraZ1	41.4	-	68	396	414	0.9565217
A09	6363819	6366877	A09p11330.2_BraZ1	1315.64	-	84	1058	3058	0.3459778
A09	6440515	6442045	A09p11340.2_BraZ1	153	+	505	1325	1530	0.8660131
A09	6442375	6442847	A09p11350.2_BraZ1	240	+	854	472	472	1.0000000
A09	6442463	6443355	A09p11360.2_BraZ1	285	+	1036	860	892	0.9641256
A09	6446128	6447438	A09p11370.2_BraZ1	7699.2	-	920	1310	1310	1.0000000
A09	6450445	6450829	A09p11380.2_BraZ1	38.4	-	94	384	384	1.0000000
A09	6451397	6453887	A09p11390.2_BraZ1	1151.18	-	558	2081	2490	0.8357430
A09	6461247	6462225	A09p11400.2_BraZ1	97.8	-	740	978	978	1.0000000
A09	6465994	6466516	A09p11410.2_BraZ1	52.2	-	413	522	522	1.0000000
A09	6467891	6469429	A09p11420.2_BraZ1	682.619	-	609	1488	1538	0.9674903
A09	6469790	6470033	A09p11430.2_BraZ1	24.3	+	86	243	243	1.0000000
A09	6470754	6478836	A09p11440.2_BraZ1	4095.15	-	842	4972	8082	0.6151943
A09	6481076	6483535	A09p11450.2_BraZ1	1476	+	732	2387	2459	0.9707198
A09	6483894	6485431	A09p11460.2_BraZ1	764.903	-	412	1384	1537	0.9004554
A09	6487089	6488651	A09p11470.2_BraZ1	866.25	+	8	347	1562	0.2221511
A09	6490523	6491048	A09p11480.2_BraZ1	393	+	0	0	525	0.0000000
A09	6492023	6492778	A09p11490.2_BraZ1	681	-	14	387	755	0.5125828
A09	6495100	6497283	A09p11500.2_BraZ1	1434	-	17	337	2183	0.1543747
A09	6498969	6499485	A09p11510.2_BraZ1	51.6	+	68	378	516	0.7325581
A09	6502518	6503711	A09p11520.2_BraZ1	861.9	+	225	1142	1193	0.9572507
A09	6505395	6507969	A09p11530.2_BraZ1	4975.71	-	783	2096	2574	0.8142968
A09	6517547	6518208	A09p11540.2_BraZ1	408.951	+	407	658	661	0.9954614
A09	6518930	6519494	A09p11550.2_BraZ1	56.4	-	337	564	564	1.0000000
A09	6520318	6523978	A09p11560.2_BraZ1	1573.04	+	1481	3433	3660	0.9379781
A09	6529708	6530561	A09p11570.2_BraZ1	5082	+	122	688	853	0.8065650
A09	6531073	6532978	A09p11580.2_BraZ1	1168.38	-	409	1604	1905	0.8419948
A09	6539925	6540660	A09p11590.2_BraZ1	573	-	467	735	735	1.0000000
A09	6542580	6543840	A09p11600.2_BraZ1	1110	+	356	1173	1260	0.9309524
A09	6544964	6550938	A09p11610.2_BraZ1	2422.56	+	753	3734	5974	0.6250418
A09	6552205	6565301	A09p11620.2_BraZ1	1112.72	+	6269	7987	13096	0.6098809
A09	6573096	6575439	A09p11630.2_BraZ1	1870	-	864	2339	2343	0.9982928
A09	6587184	6588640	A09p11640.2_BraZ1	56.1	+	1061	1308	1456	0.8983517
A09	6592182	6593165	A09p11650.2_BraZ1	820	+	19	629	983	0.6398779
A09	6594753	6597022	A09p11660.2_BraZ1	1249.76	-	213	1682	2269	0.7412957
A09	6602540	6605305	A09p11670.2_BraZ1	1418.29	-	991	2645	2765	0.9566004
A09	6610601	6612499	A09p11680.2_BraZ1	1215.4	-	610	1635	1898	0.8614331
A09	6614603	6617704	A09p11690.2_BraZ1	1794	+	1036	3071	3101	0.9903257
A09	6621075	6622188	A09p11700.2_BraZ1	111.3	+	231	691	1113	0.6208445
A09	6624452	6626890	A09p11710.2_BraZ1	1591.07	+	1327	2378	2438	0.9753897
A09	6630847	6631969	A09p11720.2_BraZ1	109.8	+	537	1049	1122	0.9349376
A09	6633284	6633596	A09p11730.2_BraZ1	31.2	-	272	312	312	1.0000000
A09	6641366	6642387	A09p11740.2_BraZ1	426	-	651	1021	1021	1.0000000
A09	6642405	6657715	A09p11750.2_BraZ1	2449.04	+	1307	4386	15310	0.2864794
A09	6648350	6650875	A09p11760.2_BraZ1	2217	+	0	0	2525	0.0000000
A09	6659510	6661186	A09p11770.2_BraZ1	1119	+	1286	1676	1676	1.0000000
A09	6662113	6669833	A09p11780.2_BraZ1	2074.5	+	2789	6807	7720	0.8817357
A09	6670749	6672462	A09p11790.2_BraZ1	1457.94	+	424	1671	1713	0.9754816
A09	6674285	6677418	A09p11800.2_BraZ1	1669.26	-	1322	2819	3133	0.8997766
A09	6681470	6681647	A09p11810.2_BraZ1	17.7	-	387	177	177	1.0000000
A09	6688056	6688320	A09p11820.2_BraZ1	26.4	+	0	0	264	0.0000000
A09	6689308	6690083	A09p11830.2_BraZ1	201	+	25	517	775	0.6670968
A09	6692748	6694742	A09p11840.2_BraZ1	1113.4	+	776	1778	1994	0.8916750
A09	6695744	6701662	A09p11850.2_BraZ1	2183.67	-	5256	5519	5918	0.9325786
A09	6704315	6705238	A09p11860.2_BraZ1	408.375	-	656	923	923	1.0000000
A09	6705701	6706171	A09p11870.2_BraZ1	315	+	562	470	470	1.0000000
A09	6709384	6711304	A09p11880.2_BraZ1	1205.72	+	1198	1920	1920	1.0000000
A09	6715953	6717168	A09p11890.2_BraZ1	121.5	+	777	1215	1215	1.0000000
A09	6718280	6718490	A09p11900.2_BraZ1	21	+	6	137	210	0.6523809
A09	6720111	6721591	A09p11910.2_BraZ1	136.5	+	500	1480	1480	1.0000000
A09	6721633	6721950	A09p11920.2_BraZ1	19.2	+	55	273	317	0.8611987
A09	6729688	6730555	A09p11930.2_BraZ1	86.7	+	84	813	867	0.9377162
A09	6732356	6734591	A09p11940.2_BraZ1	1566	-	1029	2042	2235	0.9136465
A09	6738056	6741564	A09p11950.2_BraZ1	1551.55	-	892	2725	3508	0.7767959
A09	6749804	6750258	A09p11960.2_BraZ1	204	+	253	454	454	1.0000000
A09	6756384	6759354	A09p11970.2_BraZ1	297	+	352	2680	2970	0.9023569
A09	6763339	6764299	A09p11980.2_BraZ1	213	+	21	383	960	0.3989583
A09	6769143	6775448	A09p11990.2_BraZ1	811.2	+	823	3132	6305	0.4967486
A09	6775978	6777694	A09p12000.2_BraZ1	1092	-	12	509	1716	0.2966200
A09	6784693	6787654	A09p12010.2_BraZ1	296.1	+	227	2157	2961	0.7284701
A09	6790444	6791408	A09p12020.2_BraZ1	189	+	72	299	964	0.3101660
A09	6792690	6801197	A09p12030.2_BraZ1	480.375	+	152	2044	8507	0.2402727
A09	6795994	6798053	A09p12040.2_BraZ1	438.75	+	67	1060	2059	0.5148130
A09	6800600	6801119	A09p12050.2_BraZ1	48	+	18	90	519	0.1734104
A09	6801737	6803363	A09p12060.2_BraZ1	829.45	-	67	842	1626	0.5178352
A09	6808959	6810657	A09p12070.2_BraZ1	1500	+	27	757	1698	0.4458186
A09	6810459	6823665	A09p12080.2_BraZ1	1221	+	191	3536	13206	0.2677571
A09	6813859	6814826	A09p12090.2_BraZ1	372	+	25	532	967	0.5501551
A09	6818693	6819621	A09p12100.2_BraZ1	645.882	+	2	180	928	0.1939655
A09	6820136	6821741	A09p12110.2_BraZ1	1053	-	19	678	1605	0.4224299
A09	6828367	6831315	A09p12120.2_BraZ1	152.4	+	49	740	2948	0.2510176
A09	6838279	6839257	A09p12130.2_BraZ1	372	+	10	486	978	0.4969325
A09	6840560	6842759	A09p12140.2_BraZ1	353.1	+	19	377	2199	0.1714416
A09	6843338	6843580	A09p12150.2_BraZ1	171	-	2	49	242	0.2024793
A09	6846257	6846642	A09p12160.2_BraZ1	270	+	2	206	385	0.5350649
A09	6851503	6854455	A09p12170.2_BraZ1	295.2	+	10	698	2952	0.2364499
A09	6856429	6858580	A09p12180.2_BraZ1	1171.97	+	96	1782	2151	0.8284519
A09	6859887	6860753	A09p12190.2_BraZ1	233.333	+	28	435	866	0.5023094
A09	6860470	6865264	A09p12200.2_BraZ1	241.244	+	216	2713	4794	0.5659157
A09	6864410	6864833	A09p12210.2_BraZ1	42.3	+	52	421	423	0.9952719
A09	6865793	6866038	A09p12220.2_BraZ1	174	-	0	0	245	0.0000000
A09	6868678	6869180	A09p12230.2_BraZ1	249	+	1	20	502	0.0398406
A09	6875135	6877899	A09p12240.2_BraZ1	1563	+	232	1859	2764	0.6725760
A09	6880044	6881600	A09p12250.2_BraZ1	696	+	182	1434	1556	0.9215938
A09	6882281	6883125	A09p12260.2_BraZ1	666.643	+	36	541	844	0.6409953
A09	6887661	6889198	A09p12270.2_BraZ1	458.85	-	32	991	1537	0.6447625
A09	6897078	6899928	A09p12280.2_BraZ1	285	+	332	2382	2850	0.8357895
A09	6901853	6903955	A09p12290.2_BraZ1	1124.43	+	238	1206	2102	0.5737393
A09	6905680	6906084	A09p12300.2_BraZ1	144	-	141	358	404	0.8861386
A09	6906603	6907318	A09p12310.2_BraZ1	267	-	10	170	715	0.2377622
A09	6912566	6914661	A09p12320.2_BraZ1	946.636	+	0	0	2095	0.0000000
A09	6916215	6917166	A09p12330.2_BraZ1	574.364	+	178	951	951	1.0000000
A09	6917718	6919409	A09p12340.2_BraZ1	894.956	-	134	814	1691	0.4813720
A09	6920580	6921596	A09p12350.2_BraZ1	693.5	+	49	644	1016	0.6338583
A09	6932645	6933612	A09p12360.2_BraZ1	372	-	250	921	967	0.9524302
A09	6938429	6939299	A09p12370.2_BraZ1	510.409	+	9	310	870	0.3563218
A09	6939817	6941512	A09p12380.2_BraZ1	1033.5	-	46	905	1695	0.5339233
A09	6943954	6945442	A09p12390.2_BraZ1	4290	+	770	1271	1488	0.8541667
A09	6946231	6947395	A09p12400.2_BraZ1	566.877	+	772	1164	1164	1.0000000
A09	6952941	6953406	A09p12410.2_BraZ1	46.5	-	87	424	465	0.9118280
A09	6959067	6975320	A09p12420.2_BraZ1	10156	-	1376	9359	16253	0.5758321
A09	6979212	6980902	A09p12430.2_BraZ1	897	-	118	900	1690	0.5325444
A09	6990917	6991311	A09p12440.2_BraZ1	371.25	+	30	253	394	0.6421320
A09	6992009	6992299	A09p12450.2_BraZ1	249	+	13	206	290	0.7103449
A09	6997414	6997741	A09p12460.2_BraZ1	32.7	+	7	134	327	0.4097859
A09	6999387	7000476	A09p12470.2_BraZ1	676.609	+	253	1067	1089	0.9797980
A09	7001903	7002491	A09p12480.2_BraZ1	489	+	62	533	588	0.9064626
A09	7010914	7013204	A09p12490.2_BraZ1	1392.64	+	298	1896	2290	0.8279476
A09	7015361	7022303	A09p12500.2_BraZ1	3542.88	+	1220	5734	6942	0.8259867
A09	7023333	7025266	A09p12510.2_BraZ1	1084.91	-	185	1151	1933	0.5954475
A09	7031088	7032472	A09p12520.2_BraZ1	401.625	+	78	806	1384	0.5823699
A09	7032519	7032952	A09p12530.2_BraZ1	230.029	+	99	375	433	0.8660508
A09	7035800	7036304	A09p12540.2_BraZ1	50.4	-	26	355	504	0.7043651
A09	7036461	7036587	A09p12550.2_BraZ1	12.6	-	28	126	126	1.0000000
A09	7050740	7052406	A09p12560.2_BraZ1	632.882	-	158	1102	1666	0.6614646
A09	7053668	7055499	A09p12570.2_BraZ1	903.429	-	1412	1831	1831	1.0000000
A09	7057944	7058989	A09p12580.2_BraZ1	4213.5	+	38	804	1045	0.7693780
A09	7060838	7068467	A09p12590.2_BraZ1	1252.33	+	4126	6414	7629	0.8407393
A09	7069785	7071118	A09p12600.2_BraZ1	588.652	-	552	1333	1333	1.0000000
A09	7080654	7082415	A09p12610.2_BraZ1	1212	+	773	1681	1761	0.9545712
A09	7082840	7083663	A09p12620.2_BraZ1	251.357	+	522	823	823	1.0000000
A09	7092390	7093808	A09p12630.2_BraZ1	602.984	+	38	577	1418	0.4069111
A09	7097637	7100957	A09p12640.2_BraZ1	1791.1	+	1447	3195	3320	0.9623494
A09	7101379	7102862	A09p12650.2_BraZ1	375	+	561	1439	1483	0.9703304
A09	7103165	7103963	A09p12660.2_BraZ1	79.8	-	95	677	798	0.8483709
A09	7109343	7116806	A09p12670.2_BraZ1	312.75	-	39878	6632	7463	0.8886507
A09	7116941	7117352	A09p12680.2_BraZ1	270	+	0	0	411	0.0000000
A09	7131660	7132011	A09p12690.2_BraZ1	35.1	+	54	318	351	0.9059829
A09	7140082	7141094	A09p12700.2_BraZ1	5785.5	-	263	964	1012	0.9525692
A09	7148620	7154470	A09p12710.2_BraZ1	2110.97	-	3822	5598	5850	0.9569231
A09	7150869	7151172	A09p12720.2_BraZ1	30.3	-	300	303	303	1.0000000
A09	7156387	7157989	A09p12730.2_BraZ1	12575	+	231	1320	1602	0.8239700
A09	7160502	7162143	A09p12740.2_BraZ1	15030	-	87	633	1641	0.3857404
A09	7165953	7166306	A09p12750.2_BraZ1	180	-	2	58	353	0.1643060
A09	7172832	7174650	A09p12760.2_BraZ1	1031.4	-	938	1531	1818	0.8421342
A09	7175597	7176857	A09p12770.2_BraZ1	126	-	112	702	1260	0.5571429
A09	7178457	7182063	A09p12780.2_BraZ1	1365.38	-	666	2251	3606	0.6242374
A09	7187421	7188928	A09p12790.2_BraZ1	672	-	344	1086	1507	0.7206370
A09	7202309	7203597	A09p12800.2_BraZ1	469.107	-	823	1267	1288	0.9836956
A09	7206547	7207702	A09p12810.2_BraZ1	115.5	+	335	1155	1155	1.0000000
A09	7209099	7210212	A09p12820.2_BraZ1	111.3	-	191	886	1113	0.7960467
A09	7212132	7213377	A09p12830.2_BraZ1	124.5	-	110	1028	1245	0.8257028
A09	7219019	7219979	A09p12840.2_BraZ1	96	+	160	380	960	0.3958333
A09	7249581	7252338	A09p12850.2_BraZ1	2486.87	+	89	1675	2757	0.6075444
A09	7255101	7257625	A09p12860.2_BraZ1	1089.31	+	1396	2396	2524	0.9492868
A09	7261620	7262119	A09p12870.2_BraZ1	39.3	-	263	499	499	1.0000000
A09	7264568	7267784	A09p12880.2_BraZ1	1701.92	+	890	2798	3216	0.8700249
A09	7268918	7270664	A09p12890.2_BraZ1	174.6	-	35	233	1746	0.1334479
A09	7274588	7277123	A09p12900.2_BraZ1	922.613	+	693	2322	2535	0.9159763
A09	7284705	7287506	A09p12910.2_BraZ1	970	+	211	1386	2801	0.4948233
A09	7291400	7291861	A09p12920.2_BraZ1	1606.5	-	537	461	461	1.0000000
A09	7294545	7295598	A09p12930.2_BraZ1	3552	-	122	841	1053	0.7986705
A09	7318745	7324104	A09p12940.2_BraZ1	2545.4	+	387	3480	5359	0.6493749
A09	7326176	7326686	A09p12950.2_BraZ1	51	-	18	68	510	0.1333333
A09	7345834	7346206	A09p12960.2_BraZ1	37.2	+	243	372	372	1.0000000
A09	7350137	7350712	A09p12970.2_BraZ1	459	+	33	333	575	0.5791304
A09	7352208	7353122	A09p12980.2_BraZ1	494.545	+	278	817	914	0.8938731
A09	7354836	7360132	A09p12990.2_BraZ1	841.941	+	4409	5296	5296	1.0000000
A09	7364523	7366589	A09p13000.2_BraZ1	1356	-	173	1538	2066	0.7444337
A09	7368576	7370145	A09p13010.2_BraZ1	919.227	+	799	1566	1569	0.9980879
A09	7370421	7373097	A09p13020.2_BraZ1	2373.96	-	355	2470	2676	0.9230194
A09	7373839	7374118	A09p13030.2_BraZ1	27.9	-	81	279	279	1.0000000
A09	7375388	7375583	A09p13040.2_BraZ1	19.5	-	133	195	195	1.0000000
A09	7379241	7381701	A09p13050.2_BraZ1	246	+	390	1867	2460	0.7589431
A09	7387766	7389182	A09p13060.2_BraZ1	141.6	+	344	1407	1416	0.9936441
A09	7390111	7390576	A09p13070.2_BraZ1	46.5	-	93	373	465	0.8021505
A09	7394934	7395287	A09p13080.2_BraZ1	159	-	1	148	353	0.4192635
A09	7398994	7400443	A09p13090.2_BraZ1	430.833	-	634	1249	1449	0.8619738
A09	7401714	7404091	A09p13100.2_BraZ1	1065.78	+	1324	2267	2377	0.9537232
A09	7404579	7407860	A09p13110.2_BraZ1	2192.39	-	701	2890	3281	0.8808290
A09	7414569	7415311	A09p13120.2_BraZ1	546	+	225	742	742	1.0000000
A09	7415373	7416352	A09p13130.2_BraZ1	315	+	232	887	979	0.9060265
A09	7418436	7420600	A09p13140.2_BraZ1	1569.6	+	885	2116	2164	0.9778188
A09	7424250	7424831	A09p13150.2_BraZ1	312	+	496	581	581	1.0000000
A09	7425761	7427342	A09p13160.2_BraZ1	158.1	+	148	1440	1581	0.9108160
A09	7428530	7428671	A09p13170.2_BraZ1	14.1	+	22	141	141	1.0000000
A09	7429328	7432291	A09p13180.2_BraZ1	1542.92	-	1174	2648	2963	0.8936889
A09	7437251	7440170	A09p13190.2_BraZ1	1452.44	+	1405	2789	2919	0.9554642
A09	7440874	7443256	A09p13200.2_BraZ1	1144.14	-	1535	2086	2382	0.8757347
A09	7445054	7447399	A09p13210.2_BraZ1	878.348	+	788	2154	2345	0.9185501
A09	7447910	7452066	A09p13220.2_BraZ1	1457.56	-	449	3065	4156	0.7374880
A09	7460509	7460964	A09p13230.2_BraZ1	348	+	25	441	455	0.9692308
A09	7462320	7462775	A09p13240.2_BraZ1	348	+	38	382	455	0.8395604
A09	7478400	7480394	A09p13250.2_BraZ1	1080.87	+	273	1708	1994	0.8565697
A09	7481104	7484100	A09p13260.2_BraZ1	1427.67	+	1016	2955	2996	0.9863151
A09	7484889	7487327	A09p13270.2_BraZ1	1112.57	+	1307	2420	2438	0.9926169
A09	7488957	7489610	A09p13280.2_BraZ1	330	+	58	509	653	0.7794793
A09	7489883	7493174	A09p13290.2_BraZ1	5896.67	-	739	2406	3291	0.7310848
A09	7496162	7497350	A09p13300.2_BraZ1	118.8	-	152	894	1188	0.7525253
A09	7501438	7503412	A09p13310.2_BraZ1	197.4	+	216	871	1974	0.4412361
A09	7504112	7505258	A09p13320.2_BraZ1	114.6	+	949	1140	1146	0.9947644
A09	7505656	7507598	A09p13330.2_BraZ1	127.8	-	237	938	1942	0.4830072
A09	7512914	7513706	A09p13340.2_BraZ1	161.412	+	497	792	792	1.0000000
A09	7514973	7516217	A09p13350.2_BraZ1	369.098	+	863	1244	1244	1.0000000
A09	7517124	7517736	A09p13360.2_BraZ1	360	+	365	601	612	0.9820262
A09	7518551	7519344	A09p13370.2_BraZ1	189	+	593	793	793	1.0000000
A09	7520531	7521158	A09p13380.2_BraZ1	28.8	+	337	627	627	1.0000000
A09	7522711	7523498	A09p13390.2_BraZ1	396	-	256	787	787	1.0000000
A09	7532418	7535283	A09p13400.2_BraZ1	481.692	-	1524	2595	2865	0.9057592
A09	7542152	7543298	A09p13410.2_BraZ1	114.6	-	213	334	1146	0.2914485
A09	7546543	7550872	A09p13420.2_BraZ1	1168.3	-	661	2704	4329	0.6246246
A09	7552336	7553163	A09p13430.2_BraZ1	486.317	+	428	791	827	0.9564692
A09	7554172	7556888	A09p13440.2_BraZ1	805.966	-	899	2273	2716	0.8368925
A09	7563432	7564580	A09p13450.2_BraZ1	578.859	-	856	1039	1148	0.9050522
A09	7571745	7574504	A09p13460.2_BraZ1	1441.56	+	982	2595	2759	0.9405582
A09	7574949	7575306	A09p13470.2_BraZ1	252	-	159	357	357	1.0000000
A09	7575610	7596979	A09p13480.2_BraZ1	1578.21	+	2439	11245	21369	0.5262296
A09	7587036	7590025	A09p13490.2_BraZ1	1027.2	-	24	623	2989	0.2084309
A09	7597796	7602354	A09p13500.2_BraZ1	2065.03	-	1911	4414	4558	0.9684072
A09	7603219	7603741	A09p13510.2_BraZ1	52.2	-	90	264	522	0.5057471
A09	7614726	7614900	A09p13520.2_BraZ1	17.4	-	177	174	174	1.0000000
A09	7617346	7619380	A09p13530.2_BraZ1	560.55	-	702	1997	2034	0.9818093
A09	7627384	7634365	A09p13540.2_BraZ1	2653.12	+	3510	5566	6981	0.7973070
A09	7633571	7634101	A09p13550.2_BraZ1	1462.5	+	967	530	530	1.0000000
A09	7638925	7645830	A09p13560.2_BraZ1	4022.37	-	2471	5664	6905	0.8202752
A09	7650857	7651406	A09p13570.2_BraZ1	240	+	312	549	549	1.0000000
A09	7653650	7655783	A09p13580.2_BraZ1	1225.04	-	1257	2133	2133	1.0000000
A09	7656896	7659076	A09p13590.2_BraZ1	858.98	-	601	1615	2180	0.7408257
A09	7659835	7667749	A09p13600.2_BraZ1	3804.14	-	1436	5236	7914	0.6616123
A09	7670440	7673582	A09p13610.2_BraZ1	2241.08	-	391	2359	3142	0.7507957
A09	7675618	7676975	A09p13620.2_BraZ1	1110	-	481	1357	1357	1.0000000
A09	7679012	7683907	A09p13630.2_BraZ1	2846.61	+	1070	4125	4895	0.8426966
A09	7688441	7691073	A09p13640.2_BraZ1	1145.14	+	811	2315	2632	0.8795593
A09	7693808	7695433	A09p13650.2_BraZ1	333	+	0	0	1625	0.0000000
A09	7697800	7699562	A09p13660.2_BraZ1	333	+	0	0	1762	0.0000000
A09	7706617	7738270	A09p13670.2_BraZ1	1985.02	+	4241	18450	31653	0.5828831
A09	7715219	7720601	A09p13680.2_BraZ1	3423.49	+	493	3723	5382	0.6917503
A09	7740227	7742024	A09p13690.2_BraZ1	179.7	+	247	1570	1797	0.8736783
A09	7744413	7746029	A09p13700.2_BraZ1	762.385	+	964	1597	1616	0.9882426
A09	7746767	7747695	A09p13710.2_BraZ1	609.5	-	257	766	928	0.8254310
A09	7752357	7754370	A09p13720.2_BraZ1	1087.5	-	183	1675	2013	0.8320914
A09	7761578	7762232	A09p13730.2_BraZ1	65.4	-	40	449	654	0.6865444
A09	7762859	7763705	A09p13740.2_BraZ1	195	+	495	803	846	0.9491726
A09	7764076	7764436	A09p13750.2_BraZ1	534	-	357	360	360	1.0000000
A09	7765258	7765645	A09p13760.2_BraZ1	38.7	-	97	387	387	1.0000000
A09	7766183	7769417	A09p13770.2_BraZ1	1230.34	-	3153	3054	3234	0.9443414
A09	7772185	7772497	A09p13780.2_BraZ1	31.2	+	57	207	312	0.6634616
A09	7772937	7773499	A09p13790.2_BraZ1	150	-	718	562	562	1.0000000
A09	7775791	7776388	A09p13800.2_BraZ1	246	+	0	0	597	0.0000000
A09	7776664	7777058	A09p13810.2_BraZ1	369	+	74	394	394	1.0000000
A09	7779527	7781068	A09p13820.2_BraZ1	1431	+	488	1357	1541	0.8805970
A09	7781453	7785162	A09p13830.2_BraZ1	1454.53	-	749	2832	3709	0.7635481
A09	7786857	7788996	A09p13840.2_BraZ1	1559.52	+	227	1786	2139	0.8349696
A09	7790576	7792151	A09p13850.2_BraZ1	1105.65	-	173	1356	1575	0.8609524
A09	7794114	7795304	A09p13860.2_BraZ1	558.9	-	270	1141	1190	0.9588235
A09	7798081	7799512	A09p13870.2_BraZ1	1161	+	481	1378	1431	0.9629630
A09	7806076	7806944	A09p13880.2_BraZ1	601.65	-	367	769	868	0.8859447
A09	7809255	7809528	A09p13890.2_BraZ1	27.3	-	84	268	273	0.9816850
A09	7813966	7814068	A09p13900.2_BraZ1	10.2	+	18	59	102	0.5784314
A09	7816778	7819884	A09p13910.2_BraZ1	1927.8	-	197	1833	3106	0.5901481
A09	7821438	7822264	A09p13920.2_BraZ1	612	-	299	741	826	0.8970944
A09	7824041	7824692	A09p13930.2_BraZ1	60.6	+	253	651	651	1.0000000
A09	7826521	7826770	A09p13940.2_BraZ1	24.9	+	13	197	249	0.7911646
A09	7831083	7832342	A09p13950.2_BraZ1	1164	-	160	1156	1259	0.9181890
A09	7851750	7853261	A09p13960.2_BraZ1	1146.93	+	676	1511	1511	1.0000000
A09	7859359	7860169	A09p13970.2_BraZ1	81	-	215	809	810	0.9987654
A09	7863810	7865186	A09p13980.2_BraZ1	645.652	-	173	1184	1376	0.8604651
A09	7866290	7867652	A09p13990.2_BraZ1	136.2	-	314	1199	1362	0.8803231
A09	7869926	7871324	A09p14000.2_BraZ1	139.8	-	239	1185	1398	0.8476395
A09	7873093	7879950	A09p14010.2_BraZ1	2445	+	599	2189	6857	0.3192358
A09	7880548	7882415	A09p14020.2_BraZ1	366.545	-	661	1535	1867	0.8221746
A09	7883818	7885294	A09p14030.2_BraZ1	943.92	+	350	1432	1476	0.9701897
A09	7894626	7895185	A09p14040.2_BraZ1	210	+	0	0	559	0.0000000
A09	7900130	7904276	A09p14050.2_BraZ1	1741.33	+	286	2598	4146	0.6266281
A09	7908051	7911860	A09p14060.2_BraZ1	1578.55	+	1283	3665	3809	0.9621948
A09	7913403	7913697	A09p14070.2_BraZ1	183	-	13	253	294	0.8605442
A09	7919695	7921303	A09p14080.2_BraZ1	160.8	-	1063	1608	1608	1.0000000
A09	7924510	7927357	A09p14090.2_BraZ1	1263.8	-	1968	2777	2847	0.9754127
A09	7928234	7929692	A09p14100.2_BraZ1	145.8	+	197	1247	1458	0.8552812
A09	7931030	7933191	A09p14110.2_BraZ1	1587.3	+	310	1756	2161	0.8125868
A09	7933484	7933649	A09p14120.2_BraZ1	16.5	-	45	165	165	1.0000000
A09	7936905	7937269	A09p14130.2_BraZ1	279	-	201	364	364	1.0000000
A09	7939311	7939677	A09p14140.2_BraZ1	333	+	107	366	366	1.0000000
A09	7940167	7943939	A09p14150.2_BraZ1	1088.37	-	270	2679	3772	0.7102333
A09	7951589	7959187	A09p14160.2_BraZ1	2985.25	+	1646	6305	7598	0.8298236
A09	7960061	7961155	A09p14170.2_BraZ1	1014	+	107	547	1094	0.5000000
A09	7961841	7962180	A09p14180.2_BraZ1	33.6	-	489	339	339	1.0000000
A09	7962432	7963259	A09p14190.2_BraZ1	3465	-	285	764	827	0.9238210
A09	7971124	7975402	A09p14200.2_BraZ1	753.632	+	5271	3984	4278	0.9312763
A09	7979994	7980892	A09p14210.2_BraZ1	798	-	0	0	898	0.0000000
A09	7981695	7983598	A09p14220.2_BraZ1	576	+	31	357	1903	0.1875985
A09	7986484	7987797	A09p14230.2_BraZ1	582	+	139	900	1313	0.6854532
A09	7989031	7990525	A09p14240.2_BraZ1	774	+	94	769	1494	0.5147256
A09	7991308	7992358	A09p14250.2_BraZ1	105	+	613	1050	1050	1.0000000
A09	8002092	8005219	A09p14260.2_BraZ1	906.071	+	1644	3114	3127	0.9958426
A09	8007169	8011381	A09p14270.2_BraZ1	1454.87	-	1248	3442	4212	0.8171890
A09	8011129	8011599	A09p14280.2_BraZ1	243	+	402	470	470	1.0000000
A09	8021554	8021905	A09p14290.2_BraZ1	35.1	-	56	321	351	0.9145299
A09	8026547	8032498	A09p14300.2_BraZ1	4045.85	-	1435	5428	5951	0.9121156
A09	8043912	8044470	A09p14310.2_BraZ1	55.8	-	346	558	558	1.0000000
A09	8045671	8046796	A09p14320.2_BraZ1	112.5	+	246	1125	1125	1.0000000
A09	8055235	8055988	A09p14330.2_BraZ1	75.3	+	127	641	753	0.8512616
A09	8061049	8061319	A09p14340.2_BraZ1	27	-	52	249	270	0.9222222
A09	8075906	8085873	A09p14350.2_BraZ1	501.893	+	7121	9707	9967	0.9739139
A09	8086663	8087732	A09p14360.2_BraZ1	870	-	320	1069	1069	1.0000000
A09	8090259	8090799	A09p14370.2_BraZ1	453	-	390	540	540	1.0000000
A09	8098707	8100666	A09p14380.2_BraZ1	195.9	-	731	1944	1959	0.9923430
A09	8109535	8109952	A09p14390.2_BraZ1	41.7	-	2	18	417	0.0431655
A09	8110824	8113536	A09p14400.2_BraZ1	930.1	-	16	829	2712	0.3056785
A09	8115542	8115752	A09p14410.2_BraZ1	21	+	119	210	210	1.0000000
A09	8118991	8120266	A09p14420.2_BraZ1	889.412	-	370	1253	1275	0.9827451
A09	8127968	8129329	A09p14430.2_BraZ1	1059	+	1685	1361	1361	1.0000000
A09	8131500	8133180	A09p14440.2_BraZ1	850	-	495	1503	1680	0.8946428
A09	8133713	8135215	A09p14450.2_BraZ1	985.091	+	249	1436	1502	0.9560586
A09	8135639	8137574	A09p14460.2_BraZ1	987.36	-	731	1792	1935	0.9260982
A09	8138498	8144694	A09p14470.2_BraZ1	559.059	-	1430	4879	6196	0.7874435
A09	8149096	8150155	A09p14480.2_BraZ1	428.864	+	298	1059	1059	1.0000000
A09	8151731	8151986	A09p14490.2_BraZ1	25.5	-	38	194	255	0.7607843
A09	8159415	8161289	A09p14500.2_BraZ1	680.167	-	942	1874	1874	1.0000000
A09	8162913	8165004	A09p14510.2_BraZ1	510	-	952	2024	2091	0.9679579
A09	8168382	8170390	A09p14520.2_BraZ1	412.5	+	29	658	2008	0.3276892
A09	8172787	8175991	A09p14530.2_BraZ1	315	-	276	1154	3204	0.3601748
A09	8186823	8187563	A09p14540.2_BraZ1	343.2	+	22	375	740	0.5067568
A09	8192139	8195670	A09p14550.2_BraZ1	2652.89	+	1127	3131	3531	0.8867176
A09	8200528	8201133	A09p14560.2_BraZ1	267	-	28	252	605	0.4165289
A09	8202455	8202743	A09p14570.2_BraZ1	159	+	115	288	288	1.0000000
A09	8203584	8206704	A09p14580.2_BraZ1	1584	+	1000	1799	3120	0.5766026
A09	8207418	8208894	A09p14590.2_BraZ1	147.6	+	882	1464	1476	0.9918699
A09	8215106	8216163	A09p14600.2_BraZ1	721.625	+	1083	1057	1057	1.0000000
A09	8216424	8219080	A09p14610.2_BraZ1	78.6	+	1643	2656	2656	1.0000000
A09	8220123	8220573	A09p14620.2_BraZ1	45	-	188	450	450	1.0000000
A09	8225500	8228741	A09p14630.2_BraZ1	1457.15	+	323	1918	3241	0.5917926
A09	8235455	8238504	A09p14640.2_BraZ1	1512.29	+	2493	3043	3049	0.9980322
A09	8242889	8247762	A09p14650.2_BraZ1	3017.65	+	5135	4873	4873	1.0000000
A09	8248443	8249729	A09p14660.2_BraZ1	289.5	+	924	1203	1286	0.9354588
A09	8250288	8252306	A09p14670.2_BraZ1	1101.47	-	873	1802	2018	0.8929633
A09	8256028	8263592	A09p14680.2_BraZ1	4148	-	1741	5406	7564	0.7147012
A09	8267456	8269797	A09p14690.2_BraZ1	1336.6	+	880	2272	2341	0.9705254
A09	8271240	8273054	A09p14700.2_BraZ1	1599	+	700	1638	1814	0.9029769
A09	8275065	8277061	A09p14710.2_BraZ1	7296	+	2028	1918	1996	0.9609218
A09	8277625	8283241	A09p14720.2_BraZ1	240	+	2107	2226	5616	0.3963675
A09	8281263	8281545	A09p14730.2_BraZ1	276	-	0	0	282	0.0000000
A09	8281498	8281920	A09p14740.2_BraZ1	637.5	-	0	0	422	0.0000000
A09	8283237	8285213	A09p14750.2_BraZ1	187.8	+	1558	1976	1976	1.0000000
A09	8286145	8286531	A09p14760.2_BraZ1	33.6	+	458	386	386	1.0000000
A09	8286499	8287306	A09p14770.2_BraZ1	5050	+	861	807	807	1.0000000
A09	8286547	8288024	A09p14780.2_BraZ1	402	+	1512	1459	1477	0.9878131
A09	8289046	8297922	A09p14790.2_BraZ1	3083.54	-	4021	8545	8876	0.9627084
A09	8291184	8291731	A09p14800.2_BraZ1	49.5	-	148	547	547	1.0000000
A09	8299163	8299385	A09p14810.2_BraZ1	20.7	+	165	222	222	1.0000000
A09	8299486	8300812	A09p14820.2_BraZ1	300	+	453	1261	1326	0.9509804
A09	8306273	8309374	A09p14830.2_BraZ1	1791	+	223	2252	3101	0.7262173
A09	8312626	8315612	A09p14840.2_BraZ1	1553.5	-	1310	2894	2986	0.9691895
A09	8317313	8317538	A09p14850.2_BraZ1	22.5	-	2	126	225	0.5600000
A09	8322073	8322988	A09p14860.2_BraZ1	276	+	1328	915	915	1.0000000
A09	8329556	8332217	A09p14870.2_BraZ1	6758	+	487	2107	2661	0.7918076
A09	8333102	8333501	A09p14880.2_BraZ1	39.9	-	52	360	399	0.9022557
A09	8333712	8337001	A09p14890.2_BraZ1	2027.5	-	2400	3227	3289	0.9811493
A09	8337564	8339504	A09p14900.2_BraZ1	150.857	+	228	1394	1940	0.7185567
A09	8341507	8343286	A09p14910.2_BraZ1	1677	-	1705	1779	1779	1.0000000
A09	8344582	8345872	A09p14920.2_BraZ1	7832	-	505	1264	1290	0.9798450
A09	8350257	8353758	A09p14930.2_BraZ1	3809.08	+	2036	3433	3501	0.9805770
A09	8355068	8358075	A09p14940.2_BraZ1	280	+	1054	2664	3007	0.8859328
A09	8358417	8360648	A09p14950.2_BraZ1	1186.88	-	1207	2231	2231	1.0000000
A09	8364553	8365552	A09p14960.2_BraZ1	772.676	+	215	952	999	0.9529530
A09	8367750	8369425	A09p14970.2_BraZ1	640.815	+	1138	1479	1675	0.8829851
A09	8372505	8373000	A09p14980.2_BraZ1	49.5	-	288	495	495	1.0000000
A09	8379390	8380779	A09p14990.2_BraZ1	520.534	-	1117	1389	1389	1.0000000
A09	8381719	8382701	A09p15000.2_BraZ1	59.7	-	1402	982	982	1.0000000
A09	8384457	8386334	A09p15010.2_BraZ1	977.159	+	959	1712	1877	0.9120938
A09	8389115	8391190	A09p15020.2_BraZ1	111	-	1852	2075	2075	1.0000000
A09	8405001	8406240	A09p15030.2_BraZ1	123.9	+	38	416	1239	0.3357546
A09	8407370	8408816	A09p15040.2_BraZ1	47.5588	+	286	1029	1446	0.7116182
A09	8411581	8414815	A09p15050.2_BraZ1	1330.28	+	3372	3234	3234	1.0000000
A09	8415771	8416797	A09p15060.2_BraZ1	423	+	639	1011	1026	0.9853801
A09	8417477	8418757	A09p15070.2_BraZ1	797.727	-	684	1280	1280	1.0000000
A09	8419067	8421401	A09p15080.2_BraZ1	1026.19	+	916	2165	2334	0.9275921
A09	8421664	8423579	A09p15090.2_BraZ1	903.389	-	792	1818	1915	0.9493473
A09	8429522	8431441	A09p15100.2_BraZ1	171.243	+	950	1886	1919	0.9828035
A09	8432300	8433531	A09p15110.2_BraZ1	114	-	1002	1231	1231	1.0000000
A09	8434548	8435872	A09p15120.2_BraZ1	963	-	187	1068	1324	0.8066465
A09	8437316	8438458	A09p15130.2_BraZ1	734.023	+	327	1100	1142	0.9632224
A09	8440312	8442274	A09p15140.2_BraZ1	196.2	-	280	1498	1962	0.7635067
A09	8445804	8446712	A09p15150.2_BraZ1	144	+	158	814	908	0.8964758
A09	8447239	8447410	A09p15160.2_BraZ1	17.1	+	65	128	171	0.7485380
A09	8453357	8453695	A09p15170.2_BraZ1	267	-	395	338	338	1.0000000
A09	8457285	8457834	A09p15180.2_BraZ1	54.9	+	22	168	549	0.3060109
A09	8458382	8461666	A09p15190.2_BraZ1	20374.5	-	826	3121	3284	0.9503654
A09	8465723	8467927	A09p15200.2_BraZ1	1731	+	1124	2096	2204	0.9509982
A09	8468251	8468845	A09p15210.2_BraZ1	348.698	+	302	594	594	1.0000000
A09	8469078	8470542	A09p15220.2_BraZ1	146.4	-	293	748	1464	0.5109290
A09	8472023	8481357	A09p15230.2_BraZ1	696.105	+	2637	6092	9334	0.6526676
A09	8481755	8482034	A09p15240.2_BraZ1	27.9	+	41	185	279	0.6630824
A09	8482414	8482717	A09p15250.2_BraZ1	30.3	+	53	193	303	0.6369637
A09	8483579	8483837	A09p15260.2_BraZ1	24	-	388	258	258	1.0000000
A09	8484769	8486929	A09p15270.2_BraZ1	1641.6	-	636	2056	2160	0.9518518
A09	8494048	8494276	A09p15280.2_BraZ1	22.8	-	132	228	228	1.0000000
A09	8495625	8496616	A09p15290.2_BraZ1	91.8	+	976	991	991	1.0000000
A09	8496568	8501270	A09p15300.2_BraZ1	6382.97	+	785	2828	4702	0.6014462
A09	8508339	8509331	A09p15310.2_BraZ1	4295.25	+	211	795	992	0.8014113
A09	8513855	8514810	A09p15320.2_BraZ1	1482	+	325	852	955	0.8921466
A09	8516221	8516513	A09p15330.2_BraZ1	225	+	315	292	292	1.0000000
A09	8517824	8518280	A09p15340.2_BraZ1	45.6	+	231	403	456	0.8837720
A09	8519868	8520804	A09p15350.2_BraZ1	93.6	-	510	936	936	1.0000000
A09	8532501	8533805	A09p15360.2_BraZ1	1023.4	+	666	1253	1304	0.9608896
A09	8546612	8549934	A09p15370.2_BraZ1	1876.65	+	726	2534	3322	0.7627935
A09	8551004	8557359	A09p15380.2_BraZ1	2023.97	-	1368	4535	6355	0.7136113
A09	8567740	8568193	A09p15390.2_BraZ1	45.3	+	23	309	453	0.6821192
A09	8568740	8570296	A09p15400.2_BraZ1	1473	-	381	1351	1556	0.8682519
A09	8574024	8575594	A09p15410.2_BraZ1	571.921	-	226	938	1570	0.5974522
A09	8578478	8579613	A09p15420.2_BraZ1	702	-	296	994	1135	0.8757709
A09	8579831	8581776	A09p15430.2_BraZ1	804	+	167	934	1945	0.4802057
A09	8589889	8591569	A09p15440.2_BraZ1	936	+	380	1671	1680	0.9946429
A09	8593146	8593626	A09p15450.2_BraZ1	48	-	255	480	480	1.0000000
A09	8594500	8597585	A09p15460.2_BraZ1	1787.5	-	862	2996	3085	0.9711508
A09	8600967	8603283	A09p15470.2_BraZ1	1801.98	-	588	2226	2316	0.9611399
A09	8612448	8613443	A09p15480.2_BraZ1	341.739	+	0	0	995	0.0000000
A09	8644225	8645059	A09p15490.2_BraZ1	4181.25	-	57	151	834	0.1810552
A09	8656878	8659175	A09p15500.2_BraZ1	1322.96	-	314	1720	2297	0.7488028
A09	8665472	8667411	A09p15510.2_BraZ1	1329	-	141	1068	1939	0.5507994
A09	8673252	8674140	A09p15520.2_BraZ1	66.9	+	111	214	888	0.2409910
A09	8676876	8679246	A09p15530.2_BraZ1	1167.91	-	1012	2084	2370	0.8793249
A09	8693029	8694165	A09p15540.2_BraZ1	457.826	+	494	1055	1136	0.9286972
A09	8696093	8696237	A09p15550.2_BraZ1	14.4	+	0	0	144	0.0000000
A09	8700523	8702623	A09p15560.2_BraZ1	1942.88	-	1196	2055	2100	0.9785714
A09	8715717	8719154	A09p15570.2_BraZ1	1675.88	+	1835	3333	3437	0.9697410
A09	8719488	8724863	A09p15580.2_BraZ1	1801.21	-	2036	5245	5375	0.9758139
A09	8729325	8730517	A09p15590.2_BraZ1	232.5	+	523	986	1192	0.8271812
A09	8730914	8731211	A09p15600.2_BraZ1	29.7	-	64	220	297	0.7407407
A09	8734424	8735948	A09p15610.2_BraZ1	152.4	+	805	1524	1524	1.0000000
A09	8736841	8737392	A09p15620.2_BraZ1	225	-	323	523	551	0.9491833
A09	8737746	8742149	A09p15630.2_BraZ1	2987.01	-	712	2987	4403	0.6784011
A09	8746713	8750778	A09p15640.2_BraZ1	2115.54	-	890	3698	4065	0.9097171
A09	8752470	8752742	A09p15650.2_BraZ1	25.5	-	278	272	272	1.0000000
A09	8752949	8753207	A09p15660.2_BraZ1	25.8	+	337	258	258	1.0000000
A09	8753961	8754415	A09p15670.2_BraZ1	225	+	131	350	454	0.7709251
A09	8757442	8760716	A09p15680.2_BraZ1	2248.83	-	1179	3185	3274	0.9728161
A09	8762286	8763808	A09p15690.2_BraZ1	788.132	-	569	1492	1522	0.9802891
A09	8764042	8764986	A09p15700.2_BraZ1	669	+	150	709	944	0.7510593
A09	8765573	8766656	A09p15710.2_BraZ1	108.3	-	366	949	1083	0.8762696
A09	8767114	8767496	A09p15720.2_BraZ1	34.8	-	84	314	382	0.8219895
A09	8771668	8773347	A09p15730.2_BraZ1	22386	+	358	1460	1679	0.8695652
A09	8774142	8775177	A09p15740.2_BraZ1	103.5	+	101	666	1035	0.6434783
A09	8776288	8778397	A09p15750.2_BraZ1	970.304	-	616	2059	2109	0.9762921
A09	8779100	8781912	A09p15760.2_BraZ1	1581.7	-	794	2694	2812	0.9580370
A09	8782480	8782876	A09p15770.2_BraZ1	39.6	-	246	396	396	1.0000000
A09	8787294	8790478	A09p15780.2_BraZ1	1666.29	-	225	2119	3184	0.6655151
A09	8830361	8831279	A09p15790.2_BraZ1	91.8	+	503	910	918	0.9912854
A09	8832664	8833117	A09p15800.2_BraZ1	45.3	-	73	435	453	0.9602649
A09	8834632	8836444	A09p15810.2_BraZ1	1065.07	-	879	1812	1812	1.0000000
A09	8842538	8845006	A09p15820.2_BraZ1	225	-	1852	2468	2468	1.0000000
A09	8845595	8846993	A09p15830.2_BraZ1	59.4	+	496	1280	1398	0.9155937
A09	8851599	8852713	A09p15840.2_BraZ1	1208.81	+	603	1027	1114	0.9219031
A09	8855146	8855510	A09p15850.2_BraZ1	231	+	203	364	364	1.0000000
A09	8856483	8858128	A09p15860.2_BraZ1	1527	-	579	1480	1645	0.8996961
A09	8864926	8867551	A09p15870.2_BraZ1	2817	-	332	1961	2625	0.7470476
A09	8870035	8871253	A09p15880.2_BraZ1	121.8	+	134	494	1218	0.4055829
A09	8871716	8873381	A09p15890.2_BraZ1	166.5	-	476	1664	1665	0.9993994
A09	8873872	8876104	A09p15900.2_BraZ1	2160	-	77	814	2232	0.3646953
A09	8878015	8879152	A09p15910.2_BraZ1	113.7	-	378	999	1137	0.8786280
A09	8882107	8882710	A09p15920.2_BraZ1	60.3	+	238	603	603	1.0000000
A09	8883208	8885750	A09p15930.2_BraZ1	7997	-	2981	2542	2542	1.0000000
A09	8888350	8890603	A09p15940.2_BraZ1	1464	-	2742	2253	2253	1.0000000
A09	8892603	8892822	A09p15950.2_BraZ1	21.9	+	118	219	219	1.0000000
A09	8893024	8894850	A09p15960.2_BraZ1	25491	-	1485	1826	1826	1.0000000
A09	8896106	8897778	A09p15970.2_BraZ1	708.288	+	751	1559	1672	0.9324163
A09	8900054	8900509	A09p15980.2_BraZ1	228	+	133	395	455	0.8681319
A09	8902203	8902839	A09p15990.2_BraZ1	348.698	-	145	636	636	1.0000000
A09	8903240	8906365	A09p16000.2_BraZ1	994.675	+	1154	2638	3125	0.8441600
A09	8909502	8911437	A09p16010.2_BraZ1	193.5	+	228	1218	1935	0.6294574
A09	8914468	8918785	A09p16020.2_BraZ1	2296.32	+	1160	3740	4317	0.8663424
A09	8922628	8922992	A09p16030.2_BraZ1	258	-	660	364	364	1.0000000
A09	8934348	8935670	A09p16040.2_BraZ1	730.589	-	1114	1322	1322	1.0000000
A09	8941177	8942311	A09p16050.2_BraZ1	333.45	-	559	845	1134	0.7451499
A09	8943251	8943596	A09p16060.2_BraZ1	34.5	-	257	345	345	1.0000000
A09	8948783	8950315	A09p16070.2_BraZ1	44.4	+	694	1532	1532	1.0000000
A09	8953190	8954526	A09p16080.2_BraZ1	1254	+	404	1321	1336	0.9887725
A09	8956964	8957612	A09p16090.2_BraZ1	64.8	-	378	648	648	1.0000000
A09	8966992	8967324	A09p16100.2_BraZ1	243	-	4	198	332	0.5963855
A09	8970297	8971883	A09p16110.2_BraZ1	771	-	8533	1586	1586	1.0000000
A09	8977612	8977944	A09p16120.2_BraZ1	243	-	46	243	332	0.7319277
A09	8979731	8982059	A09p16130.2_BraZ1	3321	-	690	1562	2328	0.6709622
A09	8983870	8984466	A09p16140.2_BraZ1	450	-	48	302	596	0.5067114
A09	8986821	8994926	A09p16150.2_BraZ1	3840.33	+	6338	5377	8105	0.6634176
A09	9000624	9006102	A09p16160.2_BraZ1	2637.12	-	827	4376	5478	0.7988317
A09	9008178	9008328	A09p16170.2_BraZ1	15	+	246	150	150	1.0000000
A09	9012861	9015675	A09p16180.2_BraZ1	1276.06	-	499	1984	2814	0.7050462
A09	9016588	9016915	A09p16190.2_BraZ1	102	+	81	124	327	0.3792049
A09	9016588	9017422	A09p16200.2_BraZ1	363	+	146	509	834	0.6103117
A09	9020525	9021765	A09p16210.2_BraZ1	3234.38	+	948	1210	1240	0.9758065
A09	9033283	9034749	A09p16220.2_BraZ1	132.3	+	1165	1466	1466	1.0000000
A09	9036064	9037110	A09p16230.2_BraZ1	392.348	-	48	239	1046	0.2284895
A09	9037526	9038051	A09p16240.2_BraZ1	52.5	+	0	0	525	0.0000000
A09	9042316	9044590	A09p16250.2_BraZ1	1013.61	-	809	2206	2274	0.9700968
A09	9044871	9046117	A09p16260.2_BraZ1	627.545	+	584	1235	1246	0.9911718
A09	9054651	9055181	A09p16270.2_BraZ1	282	-	80	530	530	1.0000000
A09	9061895	9063736	A09p16280.2_BraZ1	1048.57	+	1527	1752	1841	0.9516567
A09	9065292	9065674	A09p16290.2_BraZ1	159	+	494	382	382	1.0000000
A09	9082101	9084998	A09p16300.2_BraZ1	12001.7	+	2354	2468	2897	0.8519158
A09	9092286	9093608	A09p16310.2_BraZ1	732	+	215	1132	1322	0.8562784
A09	9094748	9095002	A09p16320.2_BraZ1	159	+	43	254	254	1.0000000
A09	9099236	9101395	A09p16330.2_BraZ1	1330	+	5	401	2159	0.1857341
A09	9102077	9111504	A09p16340.2_BraZ1	4621.5	+	705	5160	9427	0.5473639
A09	9137083	9137501	A09p16350.2_BraZ1	249	+	15	208	418	0.4976076
A09	9139592	9139826	A09p16360.2_BraZ1	23.4	+	0	0	234	0.0000000
A09	9141734	9142271	A09p16370.2_BraZ1	53.7	+	4	45	537	0.0837989
A09	9143894	9150487	A09p16380.2_BraZ1	11014.5	+	380	2578	6593	0.3910208
A09	9146735	9147224	A09p16390.2_BraZ1	48.9	+	2	187	489	0.3824131
A09	9152005	9152384	A09p16400.2_BraZ1	24.6	+	35	317	379	0.8364116
A09	9158793	9162947	A09p16410.2_BraZ1	47520	+	270	2105	4154	0.5067405
A09	9165279	9168879	A09p16420.2_BraZ1	15546.7	+	1268	2877	3600	0.7991667
A09	9170194	9173761	A09p16430.2_BraZ1	2147.15	-	1541	3221	3567	0.9029997
A09	9177436	9179103	A09p16440.2_BraZ1	1599	-	158	1173	1667	0.7036593
A09	9182378	9182600	A09p16450.2_BraZ1	17.1	+	30	222	222	1.0000000
A09	9188067	9188574	A09p16460.2_BraZ1	50.7	+	77	391	507	0.7712032
A09	9202526	9202742	A09p16470.2_BraZ1	21.6	-	349	216	216	1.0000000
A09	9209509	9210313	A09p16480.2_BraZ1	80.1	-	18	381	804	0.4738806
A09	9210981	9212114	A09p16490.2_BraZ1	715	-	127	1093	1133	0.9646955
A09	9220434	9221945	A09p16500.2_BraZ1	861	+	401	1418	1511	0.9384513
A09	9231773	9233742	A09p16510.2_BraZ1	819.631	+	1185	1903	1969	0.9664804
A09	9234724	9243711	A09p16520.2_BraZ1	1650.91	-	6858	7261	8987	0.8079448
A09	9251540	9251758	A09p16530.2_BraZ1	15.6	+	75	218	218	1.0000000
A09	9252376	9255889	A09p16540.2_BraZ1	2482.35	+	773	2940	3513	0.8368915
A09	9256709	9260241	A09p16550.2_BraZ1	1406.37	-	1179	3304	3532	0.9354473
A09	9260994	9261147	A09p16560.2_BraZ1	15.3	+	9	153	153	1.0000000
A09	9266459	9267087	A09p16570.2_BraZ1	441	-	115	584	628	0.9299363
A09	9276131	9278025	A09p16580.2_BraZ1	1743	+	1033	1878	1894	0.9915523
A09	9282006	9284417	A09p16590.2_BraZ1	1506.11	+	1201	2313	2411	0.9593530
A09	9290906	9294593	A09p16600.2_BraZ1	1810.88	-	830	2314	3687	0.6276105
A09	9304300	9304778	A09p16610.2_BraZ1	240	+	911	478	478	1.0000000
A09	9308034	9308187	A09p16620.2_BraZ1	15.3	-	72	153	153	1.0000000
A09	9314761	9320345	A09p16630.2_BraZ1	3004.45	+	2590	5349	5584	0.9579155
A09	9320604	9320856	A09p16640.2_BraZ1	198	+	477	252	252	1.0000000
A09	9321037	9321625	A09p16650.2_BraZ1	159	+	273	563	588	0.9574830
A09	9322107	9322935	A09p16660.2_BraZ1	82.8	-	36	350	828	0.4227053
A09	9325452	9325905	A09p16670.2_BraZ1	1778	-	89	439	453	0.9690949
A09	9327942	9328251	A09p16680.2_BraZ1	222	+	384	309	309	1.0000000
A09	9330081	9332330	A09p16690.2_BraZ1	1312	-	1116	2213	2249	0.9839929
A09	9338324	9340042	A09p16700.2_BraZ1	1492.94	+	1336	1695	1718	0.9866123
A09	9341248	9343154	A09p16710.2_BraZ1	183.6	-	826	1835	1906	0.9627492
A09	9343605	9345191	A09p16720.2_BraZ1	1062	-	145	1355	1586	0.8543506
A09	9355855	9356957	A09p16730.2_BraZ1	590.4	+	17	316	1102	0.2867514
A09	9362963	9363428	A09p16740.2_BraZ1	46.5	+	18	153	465	0.3290323
A09	9364918	9365608	A09p16750.2_BraZ1	69	+	268	667	690	0.9666666
A09	9366600	9369546	A09p16760.2_BraZ1	2242.23	+	1402	2946	2946	1.0000000
A09	9371165	9374807	A09p16770.2_BraZ1	2702.02	+	1268	3061	3642	0.8404723
A09	9375244	9377795	A09p16780.2_BraZ1	1066.42	+	1860	2461	2551	0.9647197
A09	9378295	9378841	A09p16790.2_BraZ1	285	-	18	442	546	0.8095238
A09	9381794	9382049	A09p16800.2_BraZ1	25.5	+	32	205	255	0.8039216
A09	9393739	9395847	A09p16810.2_BraZ1	1481.43	+	743	2083	2108	0.9881404
A09	9396671	9397700	A09p16820.2_BraZ1	428.864	-	226	941	1029	0.9144801
A09	9399106	9400033	A09p16830.2_BraZ1	471	-	3	32	927	0.0345200
A09	9401556	9402326	A09p16840.2_BraZ1	863.333	+	428	770	770	1.0000000
A09	9411957	9413076	A09p16850.2_BraZ1	398.908	+	976	1119	1119	1.0000000
A09	9416483	9418709	A09p16860.2_BraZ1	659.688	-	176	853	2226	0.3831986
A09	9419401	9419533	A09p16870.2_BraZ1	13.2	+	93	132	132	1.0000000
A09	9424703	9426281	A09p16880.2_BraZ1	1117.29	-	376	1493	1578	0.9461343
A09	9447824	9448918	A09p16890.2_BraZ1	360	-	1030	1094	1094	1.0000000
A09	9452036	9453493	A09p16900.2_BraZ1	960	+	442	1421	1457	0.9752917
A09	9455867	9458628	A09p16910.2_BraZ1	1051.69	-	3544	2761	2761	1.0000000
A09	9460784	9462722	A09p16920.2_BraZ1	193.8	+	659	1771	1938	0.9138287
A09	9469475	9471539	A09p16930.2_BraZ1	627	+	127	875	2064	0.4239341
A09	9481843	9482887	A09p16940.2_BraZ1	853.159	+	174	970	1044	0.9291188
A09	9484919	9485961	A09p16950.2_BraZ1	367.2	-	4	396	1042	0.3800384
A09	9486352	9488521	A09p16960.2_BraZ1	1244.88	+	1628	2095	2169	0.9658829
A09	9507748	9508495	A09p16970.2_BraZ1	74.7	-	59	622	747	0.8326640
A09	9510624	9510825	A09p16980.2_BraZ1	20.1	+	202	201	201	1.0000000
A09	9517609	9520419	A09p16990.2_BraZ1	1795.61	+	675	2642	2810	0.9402135
A09	9529955	9531326	A09p17000.2_BraZ1	894	-	949	1356	1371	0.9890591
A09	9534208	9534401	A09p17010.2_BraZ1	14.7	-	222	193	193	1.0000000
A09	9534920	9541220	A09p17020.2_BraZ1	1087.8	-	5614	6225	6300	0.9880952
A09	9560706	9561039	A09p17030.2_BraZ1	33.3	-	0	0	333	0.0000000
A09	9565272	9565605	A09p17040.2_BraZ1	33.3	-	9	77	333	0.2312312
A09	9569840	9570173	A09p17050.2_BraZ1	33.3	-	9	24	333	0.0720721
A09	9574770	9577077	A09p17060.2_BraZ1	2232	-	522	2256	2307	0.9778934
A09	9584937	9586832	A09p17070.2_BraZ1	1551.52	+	580	1725	1895	0.9102902
A09	9591737	9592280	A09p17080.2_BraZ1	288	+	151	543	543	1.0000000
A09	9592953	9594714	A09p17090.2_BraZ1	567.6	-	798	1761	1761	1.0000000
A09	9601014	9602778	A09p17100.2_BraZ1	751.238	+	404	1633	1764	0.9257370
A09	9609471	9610118	A09p17110.2_BraZ1	282	-	410	647	647	1.0000000
A09	9618117	9620355	A09p17120.2_BraZ1	223.8	+	171	1751	2238	0.7823950
A09	9633264	9634900	A09p17130.2_BraZ1	650.52	+	1080	1577	1636	0.9639364
A09	9635217	9637314	A09p17140.2_BraZ1	209.7	+	482	1968	2097	0.9384835
A09	9639001	9642159	A09p17150.2_BraZ1	1138.28	+	940	2698	3158	0.8543382
A09	9643137	9644882	A09p17160.2_BraZ1	443.563	-	905	1596	1745	0.9146132
A09	9659502	9659874	A09p17170.2_BraZ1	37.2	-	0	0	372	0.0000000
A09	9670446	9672076	A09p17180.2_BraZ1	675.671	+	281	1486	1630	0.9116564
A09	9675900	9676689	A09p17190.2_BraZ1	612	+	183	665	789	0.8428391
A09	9679420	9687510	A09p17200.2_BraZ1	1760	+	746	3362	8090	0.4155748
A09	9691387	9691876	A09p17210.2_BraZ1	255	-	401	489	489	1.0000000
A09	9692685	9693274	A09p17220.2_BraZ1	190.286	-	238	584	589	0.9915110
A09	9701329	9701992	A09p17230.2_BraZ1	66.3	+	407	663	663	1.0000000
A09	9703192	9703450	A09p17240.2_BraZ1	25.8	+	2	137	258	0.5310078
A09	9709161	9709311	A09p17250.2_BraZ1	14.7	-	0	0	150	0.0000000
A09	9709654	9710990	A09p17260.2_BraZ1	553.875	+	7	133	1336	0.0995509
A09	9713905	9714599	A09p17270.2_BraZ1	147	+	0	0	694	0.0000000
A09	9719154	9721737	A09p17280.2_BraZ1	2438.86	+	823	2358	2583	0.9128920
A09	9722087	9724600	A09p17290.2_BraZ1	1603.76	-	928	2259	2513	0.8989256
A09	9732862	9733780	A09p17300.2_BraZ1	91.8	+	108	888	918	0.9673203
A09	9757804	9759588	A09p17310.2_BraZ1	1178.78	+	33	517	1784	0.2897982
A09	9761898	9763023	A09p17320.2_BraZ1	112.5	-	1638	1125	1125	1.0000000
A09	9772683	9774462	A09p17330.2_BraZ1	856.875	+	453	1744	1779	0.9803260
A09	9783599	9809036	A09p17340.2_BraZ1	1623.5	+	15362	24674	25437	0.9700043
A09	9786193	9787477	A09p17350.2_BraZ1	373.286	-	905	1195	1284	0.9306853
A09	9800927	9801325	A09p17360.2_BraZ1	240	+	1222	398	398	1.0000000
A09	9812000	9815524	A09p17370.2_BraZ1	1853.95	-	1041	3084	3524	0.8751419
A09	9821222	9823077	A09p17380.2_BraZ1	1215	-	512	1855	1855	1.0000000
A09	9827007	9828938	A09p17390.2_BraZ1	569.25	-	518	1455	1931	0.7534956
A09	9829848	9835495	A09p17400.2_BraZ1	1140.26	-	3967	5335	5647	0.9447494
A09	9836341	9839029	A09p17410.2_BraZ1	928.481	+	681	2496	2688	0.9285714
A09	9839622	9840192	A09p17420.2_BraZ1	57	+	282	570	570	1.0000000
A09	9848698	9849325	A09p17430.2_BraZ1	444	-	26	25	627	0.0398724
A09	9853705	9859211	A09p17440.2_BraZ1	1087.75	-	1460	4673	5506	0.8487105
A09	9879733	9880528	A09p17450.2_BraZ1	79.5	-	34	287	795	0.3610063
A09	9899657	9900044	A09p17460.2_BraZ1	38.7	+	0	0	387	0.0000000
A09	9904880	9905324	A09p17470.2_BraZ1	44.4	+	15	102	444	0.2297297
A09	9907541	9907658	A09p17480.2_BraZ1	11.7	+	133	117	117	1.0000000
A09	9911968	9912841	A09p17490.2_BraZ1	87.3	-	156	592	873	0.6781214
A09	9915749	9917042	A09p17500.2_BraZ1	129.3	+	313	1211	1293	0.9365816
A09	9917305	9917953	A09p17510.2_BraZ1	64.8	-	1167	648	648	1.0000000
A09	9929171	9930959	A09p17520.2_BraZ1	626.786	+	897	1508	1788	0.8434004
A09	9933931	9936313	A09p17530.2_BraZ1	238.2	-	3235	2085	2382	0.8753148
A09	9938246	9938679	A09p17540.2_BraZ1	183	-	55	391	433	0.9030023
A09	9945169	9948291	A09p17550.2_BraZ1	1222.77	+	2403	3122	3122	1.0000000
A09	9954093	9955382	A09p17560.2_BraZ1	774	+	1190	1289	1289	1.0000000
A09	9958865	9960324	A09p17570.2_BraZ1	1141.07	-	733	1459	1459	1.0000000
A09	9973891	9975520	A09p17580.2_BraZ1	905.933	-	38	644	1629	0.3953346
A09	10005720	10005921	A09p17590.2_BraZ1	20.1	-	190	201	201	1.0000000
A09	10023328	10023655	A09p17600.2_BraZ1	32.7	+	533	327	327	1.0000000
A09	10046761	10049644	A09p17610.2_BraZ1	1063.38	+	739	2196	2883	0.7617065
A09	10052375	10054924	A09p17620.2_BraZ1	225	-	1450	2505	2549	0.9827383
A09	10055352	10058435	A09p17630.2_BraZ1	1769.71	-	493	2728	3083	0.8848524
A09	10070691	10071161	A09p17640.2_BraZ1	29.1	+	871	470	470	1.0000000
A09	10074606	10078425	A09p17650.2_BraZ1	2136.52	+	895	3331	3819	0.8722178
A09	10089816	10094546	A09p17660.2_BraZ1	2458.33	+	552	3010	4730	0.6363636
A09	10099095	10099730	A09p17670.2_BraZ1	702	-	238	539	635	0.8488189
A09	10123672	10128286	A09p17680.2_BraZ1	2577.42	+	901	3193	4614	0.6920243
A09	10128589	10128809	A09p17690.2_BraZ1	19.2	-	188	220	220	1.0000000
A09	10129926	10131021	A09p17700.2_BraZ1	549	+	10	359	1095	0.3278539
A09	10132850	10134869	A09p17710.2_BraZ1	952.5	-	147	1676	2019	0.8301139
A09	10134227	10135343	A09p17720.2_BraZ1	415.95	-	9	603	1116	0.5403226
A09	10137005	10140716	A09p17730.2_BraZ1	2613.46	+	720	2029	3711	0.5467529
A09	10160814	10163187	A09p17740.2_BraZ1	1659	+	166	1746	2373	0.7357775
A09	10173664	10173835	A09p17750.2_BraZ1	17.1	+	41	171	171	1.0000000
A09	10180317	10181549	A09p17760.2_BraZ1	1146	+	13	280	1232	0.2272727
A09	10192893	10193585	A09p17770.2_BraZ1	387	+	95	399	692	0.5765896
A09	10196853	10201903	A09p17780.2_BraZ1	11632.5	+	1823	3899	5050	0.7720792
A09	10202927	10203362	A09p17790.2_BraZ1	43.5	+	212	435	435	1.0000000
A09	10209802	10211878	A09p17800.2_BraZ1	1971	+	136	1502	2076	0.7235067
A09	10212518	10212959	A09p17810.2_BraZ1	44.1	+	70	394	441	0.8934240
A09	10214610	10214967	A09p17820.2_BraZ1	35.7	+	512	357	357	1.0000000
A09	10215418	10215865	A09p17830.2_BraZ1	44.7	+	401	447	447	1.0000000
A09	10221467	10222574	A09p17840.2_BraZ1	246	+	794	1107	1107	1.0000000
A09	10225942	10227166	A09p17850.2_BraZ1	58.2	+	434	1210	1224	0.9885621
A09	10228892	10229093	A09p17860.2_BraZ1	20.1	+	48	201	201	1.0000000
A09	10230789	10234175	A09p17870.2_BraZ1	1398	-	1810	3202	3386	0.9456586
A09	10235801	10239763	A09p17880.2_BraZ1	1374	-	2219	3962	3962	1.0000000
A09	10246931	10248505	A09p17890.2_BraZ1	360	+	748	938	1574	0.5959339
A09	10253730	10254327	A09p17900.2_BraZ1	59.7	-	13	235	597	0.3936349
A09	10261373	10263784	A09p17910.2_BraZ1	1086.12	+	472	2044	2411	0.8477810
A09	10277271	10277448	A09p17920.2_BraZ1	17.7	+	0	0	177	0.0000000
A09	10279543	10279755	A09p17930.2_BraZ1	17.1	+	65	78	212	0.3679245
A09	10291063	10294183	A09p17940.2_BraZ1	1408.97	+	667	2833	3120	0.9080128
A09	10301703	10307744	A09p17950.2_BraZ1	3856.99	-	1195	4099	6041	0.6785300
A09	10309338	10310593	A09p17960.2_BraZ1	477	+	0	0	1255	0.0000000
A09	10311023	10311667	A09p17970.2_BraZ1	34.7143	+	1	136	644	0.2111801
A09	10314436	10314820	A09p17980.2_BraZ1	38.4	+	13	154	384	0.4010417
A09	10315867	10316682	A09p17990.2_BraZ1	2730	-	552	810	815	0.9938650
A09	10320762	10323025	A09p18000.2_BraZ1	555.27	+	1345	2187	2263	0.9664162
A09	10323276	10323754	A09p18010.2_BraZ1	282	-	297	478	478	1.0000000
A09	10330446	10333933	A09p18020.2_BraZ1	15616	+	2438	3183	3487	0.9128190
A09	10336467	10337610	A09p18030.2_BraZ1	114.3	+	386	930	1143	0.8136483
A09	10344686	10357152	A09p18040.2_BraZ1	977.143	+	7616	11581	12466	0.9290069
A09	10373927	10374589	A09p18050.2_BraZ1	555	+	229	662	662	1.0000000
A09	10379995	10381988	A09p18060.2_BraZ1	2410.85	+	215	980	1993	0.4917210
A09	10392678	10393816	A09p18070.2_BraZ1	945	+	380	878	1138	0.7715290
A09	10399950	10400439	A09p18080.2_BraZ1	30.9	+	214	489	489	1.0000000
A09	10415248	10415488	A09p18090.2_BraZ1	24	+	362	240	240	1.0000000
A09	10418011	10418251	A09p18100.2_BraZ1	24	+	655	240	240	1.0000000
A09	10421202	10426106	A09p18110.2_BraZ1	1582.29	+	3101	3390	4904	0.6912724
A09	10427096	10428110	A09p18120.2_BraZ1	816	-	106	812	1014	0.8007889
A09	10433545	10446698	A09p18130.2_BraZ1	2977.15	+	4260	9292	13153	0.7064548
A09	10456356	10469605	A09p18140.2_BraZ1	2717.47	+	2825	10286	13249	0.7763605
A09	10471861	10474299	A09p18150.2_BraZ1	1887	-	510	2227	2438	0.9134536
A09	10496714	10498099	A09p18160.2_BraZ1	7560	+	1190	1385	1385	1.0000000
A09	10504804	10505272	A09p18170.2_BraZ1	46.8	+	272	468	468	1.0000000
A09	10505859	10508053	A09p18180.2_BraZ1	859.772	-	1184	2190	2194	0.9981769
A09	10509464	10511859	A09p18190.2_BraZ1	1157.58	-	1790	2293	2395	0.9574113
A09	10515404	10517937	A09p18200.2_BraZ1	1536.52	-	227	966	2533	0.3813660
A09	10538593	10543238	A09p18210.2_BraZ1	1171.5	-	1190	4349	4645	0.9362755
A09	10548717	10548897	A09p18220.2_BraZ1	18	-	22	39	180	0.2166667
A09	10554666	10557403	A09p18230.2_BraZ1	1992	-	3339	2528	2737	0.9236390
A09	10560379	10567377	A09p18240.2_BraZ1	2591.4	-	2081	4632	6998	0.6619034
A09	10571336	10575229	A09p18250.2_BraZ1	438	+	1401	3142	3893	0.8070896
A09	10589292	10590715	A09p18260.2_BraZ1	945.929	-	8	127	1423	0.0892481
A09	10601490	10602694	A09p18270.2_BraZ1	597	+	383	866	1204	0.7192691
A09	10619066	10619510	A09p18280.2_BraZ1	44.4	+	346	444	444	1.0000000
A09	10621339	10625013	A09p18290.2_BraZ1	2676.39	+	1459	3515	3674	0.9567229
A09	10627239	10628952	A09p18300.2_BraZ1	1386	-	378	1623	1713	0.9474606
A09	10635337	10637308	A09p18310.2_BraZ1	1287	+	172	1096	1971	0.5560629
A09	10639265	10641161	A09p18320.2_BraZ1	543.667	+	555	1492	1896	0.7869198
A09	10643798	10645124	A09p18330.2_BraZ1	1128	+	438	1294	1326	0.9758673
A09	10645648	10646095	A09p18340.2_BraZ1	44.7	-	48	447	447	1.0000000
A09	10646850	10650692	A09p18350.2_BraZ1	1546.56	-	758	2346	3842	0.6106195
A09	10652125	10652661	A09p18360.2_BraZ1	33.3	+	207	507	536	0.9458955
A09	10660285	10660579	A09p18370.2_BraZ1	29.4	-	218	294	294	1.0000000
A09	10662317	10663448	A09p18380.2_BraZ1	113.1	+	526	985	1131	0.8709107
A09	10664972	10665733	A09p18390.2_BraZ1	429	+	154	712	761	0.9356110
A09	10674849	10675143	A09p18400.2_BraZ1	29.4	-	98	276	294	0.9387755
A09	10677444	10677926	A09p18410.2_BraZ1	264	-	89	407	482	0.8443983
A09	10686845	10693576	A09p18420.2_BraZ1	3107.09	+	2245	3415	6731	0.5073540
A09	10694096	10694870	A09p18430.2_BraZ1	77.4	+	169	631	774	0.8152454
A09	10697052	10698117	A09p18440.2_BraZ1	106.5	+	226	1002	1065	0.9408451
A09	10699882	10700989	A09p18450.2_BraZ1	110.7	-	344	1107	1107	1.0000000
A09	10702684	10706099	A09p18460.2_BraZ1	1258.59	-	2808	3345	3415	0.9795022
A09	10708576	10708825	A09p18470.2_BraZ1	183	+	540	249	249	1.0000000
A09	10715121	10715932	A09p18480.2_BraZ1	243.89	+	513	810	811	0.9987670
A09	10715768	10718352	A09p18490.2_BraZ1	444	+	964	2464	2584	0.9535604
A09	10735665	10739373	A09p18500.2_BraZ1	2289.63	+	863	3437	3708	0.9269148
A09	10750410	10751007	A09p18510.2_BraZ1	59.7	-	175	597	597	1.0000000
A09	10764942	10765317	A09p18520.2_BraZ1	997.5	+	30	304	375	0.8106667
A09	10770299	10771062	A09p18530.2_BraZ1	1023	+	32	505	763	0.6618611
A09	10772621	10777517	A09p18540.2_BraZ1	313.2	-	748	4537	4896	0.9266748
A09	10785207	10786668	A09p18550.2_BraZ1	67.8	-	1313	1449	1461	0.9917864
A09	10786105	10788316	A09p18560.2_BraZ1	99.6	-	1193	1644	2211	0.7435549
A09	10788016	10791059	A09p18570.2_BraZ1	184.5	-	444	2737	3043	0.8994414
A09	10794895	10795269	A09p18580.2_BraZ1	285	+	99	374	374	1.0000000
A09	10799418	10799742	A09p18590.2_BraZ1	32.4	+	461	324	324	1.0000000
A09	10800083	10800592	A09p18600.2_BraZ1	444	-	42	380	509	0.7465619
A09	10801544	10805958	A09p18610.2_BraZ1	2063.25	-	2266	3947	4414	0.8942003
A09	10808511	10808989	A09p18620.2_BraZ1	32.7	-	129	392	478	0.8200837
A09	10812701	10817964	A09p18630.2_BraZ1	1995.85	+	4565	5126	5263	0.9739692
A09	10823640	10825759	A09p18640.2_BraZ1	1091.97	+	985	2028	2119	0.9570552
A09	10826804	10827086	A09p18650.2_BraZ1	28.2	+	456	282	282	1.0000000
A09	10828252	10830537	A09p18660.2_BraZ1	1162	+	1282	2087	2285	0.9133479
A09	10833887	10835846	A09p18670.2_BraZ1	1525.57	+	471	1831	1959	0.9346606
A09	10838203	10838536	A09p18680.2_BraZ1	33.3	-	106	333	333	1.0000000
A09	10842171	10843251	A09p18690.2_BraZ1	108	-	742	1080	1080	1.0000000
A09	10845409	10847213	A09p18700.2_BraZ1	11808	+	585	1739	1804	0.9639689
A09	10847565	10848087	A09p18710.2_BraZ1	52.2	-	86	274	522	0.5249042
A09	10850025	10854006	A09p18720.2_BraZ1	24804	+	2395	3852	3981	0.9675961
A09	10857587	10859202	A09p18730.2_BraZ1	2643.43	+	1283	1615	1615	1.0000000
A09	10864594	10866790	A09p18740.2_BraZ1	553.5	+	806	1944	2196	0.8852459
A09	10867403	10868206	A09p18750.2_BraZ1	2880	-	159	801	803	0.9975094
A09	10868235	10868583	A09p18760.2_BraZ1	29.1	-	75	344	348	0.9885057
A09	10870791	10872228	A09p18770.2_BraZ1	1278.58	+	345	1355	1437	0.9429367
A09	10873041	10873599	A09p18780.2_BraZ1	360	-	20	540	558	0.9677419
A09	10878352	10878491	A09p18790.2_BraZ1	11.4	+	248	139	139	1.0000000
A09	10891801	10892459	A09p18800.2_BraZ1	528	+	550	595	658	0.9042553
A09	10898223	10900742	A09p18810.2_BraZ1	609.244	-	1319	2493	2519	0.9896784
A09	10902457	10903013	A09p18820.2_BraZ1	387	+	426	556	556	1.0000000
A09	10903388	10903866	A09p18830.2_BraZ1	186	-	436	478	478	1.0000000
A09	10903758	10904878	A09p18840.2_BraZ1	236.25	+	912	1120	1120	1.0000000
A09	10905450	10907101	A09p18850.2_BraZ1	2091.25	+	887	1651	1651	1.0000000
A09	10933919	10934374	A09p18860.2_BraZ1	189	-	17	261	455	0.5736264
A09	10939801	10942221	A09p18870.2_BraZ1	1532.69	+	383	1922	2420	0.7942149
A09	10943086	10944305	A09p18880.2_BraZ1	725.143	-	1025	1219	1219	1.0000000
A09	10952183	10954128	A09p18890.2_BraZ1	1017	+	858	1914	1945	0.9840617
A09	10954665	10957077	A09p18900.2_BraZ1	963	-	1126	2370	2412	0.9825870
A09	10963132	10965474	A09p18910.2_BraZ1	3380	-	513	2339	2342	0.9987190
A09	10969627	10973774	A09p18920.2_BraZ1	1864.5	+	2861	3933	4147	0.9483964
A09	10975037	10976073	A09p18930.2_BraZ1	589.567	+	223	964	1036	0.9305019
A09	10976774	10977189	A09p18940.2_BraZ1	366	-	98	415	415	1.0000000
A09	10983451	10984777	A09p18950.2_BraZ1	1005	+	390	826	1326	0.6229261
A09	10996685	10997911	A09p18960.2_BraZ1	894	+	40	326	1226	0.2659054
A09	10999533	11018151	A09p18970.2_BraZ1	1459.49	+	9632	17320	18618	0.9302825
A09	11002822	11003191	A09p18980.2_BraZ1	192	+	313	369	369	1.0000000
A09	11009014	11010479	A09p18990.2_BraZ1	2799	-	1198	1465	1465	1.0000000
A09	11011139	11012225	A09p19000.2_BraZ1	456	-	968	1086	1086	1.0000000
A09	11014112	11014413	A09p19010.2_BraZ1	216	-	315	301	301	1.0000000
A09	11019540	11025701	A09p19020.2_BraZ1	371.1	+	574	4255	6161	0.6906346
A09	11026201	11029254	A09p19030.2_BraZ1	138.6	+	14	831	3053	0.2721913
A09	11032242	11032608	A09p19040.2_BraZ1	36.6	-	61	366	366	1.0000000
A09	11034131	11035396	A09p19050.2_BraZ1	723	-	84	615	1265	0.4861660
A09	11038313	11039180	A09p19060.2_BraZ1	86.7	+	120	791	867	0.9123414
A09	11040776	11041487	A09p19070.2_BraZ1	71.1	+	49	525	711	0.7383966
A09	11047795	11049759	A09p19080.2_BraZ1	19624.5	+	73	672	1964	0.3421589
A09	11057918	11058404	A09p19090.2_BraZ1	48.6	-	7	116	486	0.2386831
A09	11061264	11067374	A09p19100.2_BraZ1	627	-	3677	5643	6110	0.9235680
A09	11068604	11070593	A09p19110.2_BraZ1	1371	+	676	1962	1989	0.9864253
A09	11070803	11073934	A09p19120.2_BraZ1	1493.38	-	768	2951	3131	0.9425104
A09	11075558	11077952	A09p19130.2_BraZ1	357	-	1315	2394	2394	1.0000000
A09	11092273	11092435	A09p19140.2_BraZ1	16.2	+	191	162	162	1.0000000
A09	11096278	11097477	A09p19150.2_BraZ1	1047.38	-	86	755	1199	0.6296914
A09	11098866	11099270	A09p19160.2_BraZ1	261	+	384	404	404	1.0000000
A09	11121182	11121538	A09p19170.2_BraZ1	249	+	31	194	356	0.5449438
A09	11147345	11148896	A09p19180.2_BraZ1	737.743	+	913	1521	1551	0.9806576
A09	11153723	11156156	A09p19190.2_BraZ1	952.467	-	436	1834	2433	0.7538019
A09	11176877	11178757	A09p19200.2_BraZ1	638.769	+	466	1733	1880	0.9218085
A09	11183929	11184097	A09p19210.2_BraZ1	16.8	-	134	168	168	1.0000000
A09	11190431	11190925	A09p19220.2_BraZ1	282	-	569	494	494	1.0000000
A09	11195002	11195554	A09p19230.2_BraZ1	500	-	263	552	552	1.0000000
A09	11195782	11196742	A09p19240.2_BraZ1	810	-	304	955	960	0.9947917
A09	11204974	11207096	A09p19250.2_BraZ1	1056.96	+	204	1178	2122	0.5551367
A09	11233842	11234664	A09p19260.2_BraZ1	528	+	178	698	822	0.8491484
A09	11235740	11236613	A09p19270.2_BraZ1	8032.5	+	379	873	873	1.0000000
A09	11242498	11242962	A09p19280.2_BraZ1	162	-	340	464	464	1.0000000
A09	11242581	11246124	A09p19290.2_BraZ1	558	+	2062	3543	3543	1.0000000
A09	11247923	11250030	A09p19300.2_BraZ1	1484	+	519	1537	2107	0.7294732
A09	11249794	11252586	A09p19310.2_BraZ1	20016	+	1310	2676	2792	0.9584527
A09	11252641	11254715	A09p19320.2_BraZ1	1191.25	-	782	2055	2074	0.9908389
A09	11258799	11259152	A09p19330.2_BraZ1	159	+	0	0	353	0.0000000
A09	11259728	11261178	A09p19340.2_BraZ1	1377	+	363	1210	1450	0.8344827
A09	11264454	11265642	A09p19350.2_BraZ1	118.8	-	408	1154	1188	0.9713805
A09	11267750	11269103	A09p19360.2_BraZ1	958.5	+	807	1353	1353	1.0000000
A09	11270032	11270841	A09p19370.2_BraZ1	642	-	930	758	809	0.9369592
A09	11271258	11272551	A09p19380.2_BraZ1	129.3	-	992	1228	1293	0.9497293
A09	11274038	11275024	A09p19390.2_BraZ1	665.531	+	352	986	986	1.0000000
A09	11277923	11283112	A09p19400.2_BraZ1	2052.04	-	3234	4891	5189	0.9425708
A09	11287662	11288256	A09p19410.2_BraZ1	59.4	+	14	197	594	0.3316498
A09	11292139	11293775	A09p19420.2_BraZ1	2401.2	+	0	0	1636	0.0000000
A09	11303358	11305129	A09p19430.2_BraZ1	904.255	+	572	1679	1771	0.9480519
A09	11305986	11309304	A09p19440.2_BraZ1	4243.8	+	2203	2418	3318	0.7287523
A09	11318976	11323940	A09p19450.2_BraZ1	2386.03	+	2495	4909	4964	0.9889202
A09	11330586	11337066	A09p19460.2_BraZ1	1718.36	-	3516	5619	6480	0.8671296
A09	11366148	11366772	A09p19470.2_BraZ1	38.7	+	305	624	624	1.0000000
A09	11367283	11368515	A09p19480.2_BraZ1	1023	-	592	1232	1232	1.0000000
A09	11372076	11373173	A09p19490.2_BraZ1	885	-	405	1097	1097	1.0000000
A09	11376786	11378563	A09p19500.2_BraZ1	705	-	1092	1597	1777	0.8987057
A09	11392493	11395702	A09p19510.2_BraZ1	792	-	605	2047	3209	0.6378934
A09	11397356	11397869	A09p19520.2_BraZ1	199.8	-	272	513	513	1.0000000
A09	11398737	11399235	A09p19530.2_BraZ1	393	+	229	498	498	1.0000000
A09	11403086	11404180	A09p19540.2_BraZ1	4977	-	355	891	1094	0.8144424
A09	11405081	11408952	A09p19550.2_BraZ1	6700	-	2373	3082	3871	0.7961767
A09	11409995	11418962	A09p19560.2_BraZ1	3050.4	-	3366	8757	8967	0.9765808
A09	11426701	11427533	A09p19570.2_BraZ1	507	+	578	832	832	1.0000000
A09	11427949	11428608	A09p19580.2_BraZ1	483	-	590	659	659	1.0000000
A09	11441309	11441927	A09p19590.2_BraZ1	61.8	-	174	607	618	0.9822006
A09	11447488	11447932	A09p19600.2_BraZ1	381	-	605	444	444	1.0000000
A09	11448527	11460648	A09p19610.2_BraZ1	5265.66	+	226	2906	12121	0.2397492
A09	11463271	11467913	A09p19620.2_BraZ1	2055.01	+	4069	4306	4642	0.9276174
A09	11473799	11476360	A09p19630.2_BraZ1	232.4	+	97	697	2561	0.2721593
A09	11476360	11486136	A09p19640.2_BraZ1	1793.16	+	0	0	9776	0.0000000
A09	11505056	11510754	A09p19650.2_BraZ1	721.686	-	0	0	5698	0.0000000
A09	11508331	11508958	A09p19660.2_BraZ1	70.2222	-	0	0	627	0.0000000
A09	11508958	11517388	A09p19670.2_BraZ1	4856.53	-	86	583	8430	0.0691578
A09	11528404	11528854	A09p19680.2_BraZ1	45	-	33	257	450	0.5711111
A09	11537010	11537570	A09p19690.2_BraZ1	189	+	628	560	560	1.0000000
A09	11541027	11541539	A09p19700.2_BraZ1	810	-	371	512	512	1.0000000
A09	11542037	11543153	A09p19710.2_BraZ1	111.6	-	873	1116	1116	1.0000000
A09	11544794	11545726	A09p19720.2_BraZ1	519	+	808	932	932	1.0000000
A09	11545793	11546345	A09p19730.2_BraZ1	201	+	408	552	552	1.0000000
A09	11548852	11550254	A09p19740.2_BraZ1	982.258	-	598	1402	1402	1.0000000
A09	11551649	11552823	A09p19750.2_BraZ1	507	+	1077	1174	1174	1.0000000
A09	11555916	11557305	A09p19760.2_BraZ1	1015	-	39	490	1389	0.3527718
A09	11558184	11559408	A09p19770.2_BraZ1	1095	-	514	1121	1224	0.9158497
A09	11563419	11564668	A09p19780.2_BraZ1	202.5	-	2696	1249	1249	1.0000000
A09	11567740	11568705	A09p19790.2_BraZ1	849.375	-	64	795	965	0.8238342
A09	11576661	11579131	A09p19800.2_BraZ1	1520.5	+	902	2011	2470	0.8141701
A09	11581274	11581805	A09p19810.2_BraZ1	53.1	-	326	527	531	0.9924670
A09	11582774	11585822	A09p19820.2_BraZ1	462.24	+	4574	3048	3048	1.0000000
A09	11596227	11596329	A09p19830.2_BraZ1	10.2	+	388	102	102	1.0000000
A09	11600704	11603691	A09p19840.2_BraZ1	5580	+	2063	2877	2987	0.9631737
A09	11608297	11612014	A09p19850.2_BraZ1	2301.24	-	1415	3495	3717	0.9402744
A09	11616448	11617393	A09p19860.2_BraZ1	483	+	125	829	945	0.8772487
A09	11622415	11626141	A09p19870.2_BraZ1	921.6	-	901	2534	3726	0.6800859
A09	11651727	11655842	A09p19880.2_BraZ1	2170.12	+	1433	3890	4115	0.9453220
A09	11671265	11673141	A09p19890.2_BraZ1	1599	-	61	533	1876	0.2841151
A09	11699719	11700001	A09p19900.2_BraZ1	141	+	507	282	282	1.0000000
A09	11706193	11706391	A09p19910.2_BraZ1	19.8	-	422	198	198	1.0000000
A09	11707635	11709311	A09p19920.2_BraZ1	1524	+	42	877	1676	0.5232697
A09	11720333	11721704	A09p19930.2_BraZ1	318	-	474	1160	1371	0.8460978
A09	11723250	11724354	A09p19940.2_BraZ1	330.828	+	525	1062	1104	0.9619565
A09	11727368	11727799	A09p19950.2_BraZ1	54.0517	+	281	431	431	1.0000000
A09	11731499	11733562	A09p19960.2_BraZ1	1554.58	+	712	1988	2063	0.9636452
A09	11734877	11740763	A09p19970.2_BraZ1	830.455	-	6821	5519	5886	0.9376487
A09	11742971	11754035	A09p19980.2_BraZ1	26250.7	+	7391	10226	11064	0.9242588
A09	11756448	11757501	A09p19990.2_BraZ1	102.9	-	576	1053	1053	1.0000000
A09	11758304	11758757	A09p20000.2_BraZ1	285	-	337	453	453	1.0000000
A09	11758843	11759234	A09p20010.2_BraZ1	165	-	482	391	391	1.0000000
A09	11765405	11766434	A09p20020.2_BraZ1	46.8	-	495	1029	1029	1.0000000
A09	11771983	11783641	A09p20030.2_BraZ1	6551.13	+	444	4399	11658	0.3773375
A09	11786814	11790145	A09p20040.2_BraZ1	1779.51	+	813	2566	3331	0.7703393
A09	11790405	11793352	A09p20050.2_BraZ1	2829	-	192	1942	2947	0.6589752
A09	11810328	11811588	A09p20060.2_BraZ1	126	-	157	853	1260	0.6769841
A09	11811609	11811888	A09p20070.2_BraZ1	174	-	20	225	279	0.8064516
A09	11816526	11817900	A09p20080.2_BraZ1	1090.83	+	204	1103	1374	0.8027657
A09	11825526	11826711	A09p20090.2_BraZ1	118.5	+	296	1180	1185	0.9957806
A09	11829595	11832162	A09p20100.2_BraZ1	1182.56	+	2220	2567	2567	1.0000000
A09	11832771	11833491	A09p20110.2_BraZ1	72	-	580	720	720	1.0000000
A09	11836838	11848832	A09p20120.2_BraZ1	3926.49	+	1804	7677	11994	0.6400700
A09	11856569	11858288	A09p20130.2_BraZ1	1037	+	971	1686	1719	0.9808028
A09	11879743	11882033	A09p20140.2_BraZ1	1513.08	+	817	2194	2290	0.9580786
A09	11882084	11885863	A09p20150.2_BraZ1	228	+	2595	3734	3779	0.9880921
A09	11885863	11887090	A09p20160.2_BraZ1	333.529	+	248	1058	1227	0.8622657
A09	11889544	11890630	A09p20170.2_BraZ1	108.6	-	114	817	1086	0.7523021
A09	11890727	11891415	A09p20180.2_BraZ1	315	-	331	688	688	1.0000000
A09	11901850	11904394	A09p20190.2_BraZ1	1723.57	+	1964	2509	2544	0.9862421
A09	11905585	11905906	A09p20200.2_BraZ1	32.1	-	867	321	321	1.0000000
A09	11910537	11910801	A09p20210.2_BraZ1	16.5	+	0	0	264	0.0000000
A09	11915268	11916759	A09p20220.2_BraZ1	149.1	+	132	932	1491	0.6250839
A09	11931377	11931668	A09p20230.2_BraZ1	29.1	-	0	0	291	0.0000000
A09	11933550	11935041	A09p20240.2_BraZ1	149.1	+	347	795	1491	0.5331992
A09	11938509	11940000	A09p20250.2_BraZ1	149.1	+	293	1279	1491	0.8578135
A09	11942382	11943114	A09p20260.2_BraZ1	585.833	+	291	699	732	0.9549180
A09	11942937	11944079	A09p20270.2_BraZ1	998.667	+	265	1052	1142	0.9211909
A09	11946930	11948424	A09p20280.2_BraZ1	149.4	+	59	1297	1494	0.8681392
A09	11948929	11950597	A09p20290.2_BraZ1	79.2	-	499	1506	1668	0.9028777
A09	11951495	11952989	A09p20300.2_BraZ1	149.4	-	625	1488	1494	0.9959840
A09	11960009	11960284	A09p20310.2_BraZ1	24.9	-	201	275	275	1.0000000
A09	11960866	11962357	A09p20320.2_BraZ1	149.1	-	209	1271	1491	0.8524480
A09	11977213	11978707	A09p20330.2_BraZ1	149.4	-	430	1494	1494	1.0000000
A09	11984370	11985728	A09p20340.2_BraZ1	496.483	+	251	1130	1358	0.8321061
A09	11985694	11987311	A09p20350.2_BraZ1	984.455	+	211	1381	1617	0.8540507
A09	11987752	11989478	A09p20360.2_BraZ1	942.857	-	378	1642	1726	0.9513326
A09	11991081	11991396	A09p20370.2_BraZ1	31.5	-	26	211	315	0.6698413
A09	12002252	12003178	A09p20380.2_BraZ1	1268.4	+	1030	926	926	1.0000000
A09	12027556	12028291	A09p20390.2_BraZ1	570	-	150	593	735	0.8068027
A09	12028884	12030286	A09p20400.2_BraZ1	641.565	-	613	1384	1402	0.9871612
A09	12037183	12044815	A09p20410.2_BraZ1	2498.35	+	4202	6610	7632	0.8660901
A09	12060974	12061245	A09p20420.2_BraZ1	159	+	14	269	271	0.9926199
A09	12061809	12064104	A09p20430.2_BraZ1	1177.11	-	426	1849	2295	0.8056645
A09	12065587	12066185	A09p20440.2_BraZ1	345	+	416	578	598	0.9665552
A09	12138811	12140946	A09p20450.2_BraZ1	1239.45	+	14	453	2135	0.2121780
A09	12144941	12147857	A09p20460.2_BraZ1	1101.33	+	247	2091	2916	0.7170782
A09	12148133	12151887	A09p20470.2_BraZ1	1948	-	225	2461	3754	0.6555674
A09	12154625	12160117	A09p20480.2_BraZ1	1066.7	-	2014	4765	5492	0.8676257
A09	12162114	12163686	A09p20490.2_BraZ1	157.2	-	530	1407	1572	0.8950382
A09	12164593	12165506	A09p20500.2_BraZ1	466	-	904	908	913	0.9945235
A09	12177483	12179194	A09p20510.2_BraZ1	693	+	2483	1711	1711	1.0000000
A09	12181345	12183746	A09p20520.2_BraZ1	1239	-	813	2081	2401	0.8667222
A09	12190087	12191736	A09p20530.2_BraZ1	757.143	-	571	1501	1649	0.9102486
A09	12197969	12198173	A09p20540.2_BraZ1	20.4	-	338	204	204	1.0000000
A09	12199708	12201825	A09p20550.2_BraZ1	1170	+	667	2117	2117	1.0000000
A09	12203279	12203540	A09p20560.2_BraZ1	26.1	-	448	261	261	1.0000000
A09	12216717	12217185	A09p20570.2_BraZ1	46.8	+	38	262	468	0.5598291
A09	12217755	12220086	A09p20580.2_BraZ1	1815	-	393	1877	2331	0.8052338
A09	12229271	12249713	A09p20590.2_BraZ1	3531	-	9327	18644	20442	0.9120438
A09	12249868	12251881	A09p20600.2_BraZ1	201.3	+	1187	1656	2013	0.8226528
A09	12253127	12254733	A09p20610.2_BraZ1	710.686	-	648	1606	1606	1.0000000
A09	12259512	12260873	A09p20620.2_BraZ1	819	-	287	1340	1361	0.9845701
A09	12263117	12274963	A09p20630.2_BraZ1	1266.43	+	16403	10766	11846	0.9088300
A09	12275625	12278754	A09p20640.2_BraZ1	2157	-	572	2966	3129	0.9479067
A09	12290105	12291199	A09p20650.2_BraZ1	6885	+	18	574	1094	0.5246801
A09	12307500	12307716	A09p20660.2_BraZ1	21.6	-	222	216	216	1.0000000
A09	12314946	12316811	A09p20670.2_BraZ1	1311.09	-	104	643	1865	0.3447721
A09	12318850	12321384	A09p20680.2_BraZ1	1608	-	835	2293	2534	0.9048935
A09	12325660	12326282	A09p20690.2_BraZ1	1564.5	+	510	622	622	1.0000000
A09	12337447	12341099	A09p20700.2_BraZ1	1411.15	-	1323	3649	3652	0.9991785
A09	12342041	12344997	A09p20710.2_BraZ1	632.143	+	2260	2956	2956	1.0000000
A09	12345563	12345752	A09p20720.2_BraZ1	18.9	+	306	189	189	1.0000000
A09	12351349	12359342	A09p20730.2_BraZ1	1610.21	-	5705	7862	7993	0.9836106
A09	12364148	12365572	A09p20740.2_BraZ1	1062	-	643	1355	1424	0.9515449
A09	12368126	12368491	A09p20750.2_BraZ1	31.2	+	614	365	365	1.0000000
A09	12368451	12368645	A09p20760.2_BraZ1	159	+	344	194	194	1.0000000
A09	12369949	12372439	A09p20770.2_BraZ1	2322	-	1027	2396	2490	0.9622490
A09	12383116	12384544	A09p20780.2_BraZ1	951.025	+	132	1104	1428	0.7731093
A09	12386343	12387753	A09p20790.2_BraZ1	701.434	+	231	1408	1410	0.9985816
A09	12387942	12391207	A09p20800.2_BraZ1	2405.11	-	1259	2407	3265	0.7372128
A09	12393411	12394786	A09p20810.2_BraZ1	623.1	-	536	1347	1375	0.9796364
A09	12400302	12402860	A09p20820.2_BraZ1	1180.23	-	331	2107	2558	0.8236904
A09	12406307	12407706	A09p20830.2_BraZ1	1086.38	+	329	1399	1399	1.0000000
A09	12408288	12411892	A09p20840.2_BraZ1	1964.91	-	1006	3554	3604	0.9861265
A09	12416207	12417569	A09p20850.2_BraZ1	1047	-	134	823	1362	0.6042584
A09	12421804	12424925	A09p20860.2_BraZ1	906	-	761	1814	3121	0.5812240
A09	12428146	12428363	A09p20870.2_BraZ1	138	-	5	178	217	0.8202765
A09	12428461	12434465	A09p20880.2_BraZ1	1503.11	-	1870	4787	6004	0.7973018
A09	12435841	12436009	A09p20890.2_BraZ1	16.8	-	58	168	168	1.0000000
A09	12439623	12440546	A09p20900.2_BraZ1	260.4	+	2	140	923	0.1516793
A09	12443774	12447028	A09p20910.2_BraZ1	2509.64	+	1420	3212	3254	0.9870928
A09	12449396	12465872	A09p20920.2_BraZ1	429.981	-	10998	14914	16476	0.9051954
A09	12459632	12460463	A09p20930.2_BraZ1	306	-	455	831	831	1.0000000
A09	12468645	12468765	A09p20940.2_BraZ1	12	-	111	120	120	1.0000000
A09	12469996	12470260	A09p20950.2_BraZ1	17.3333	-	12	129	264	0.4886364
A09	12473363	12476468	A09p20960.2_BraZ1	957	+	335	2417	3105	0.7784219
A09	12477536	12480954	A09p20970.2_BraZ1	1142.44	-	35	529	3418	0.1547689
A09	12482805	12483867	A09p20980.2_BraZ1	106.2	+	161	1019	1062	0.9595104
A09	12484615	12486743	A09p20990.2_BraZ1	1821.15	-	891	1868	2128	0.8778195
A09	12497774	12498545	A09p21000.2_BraZ1	77.1	+	12	208	771	0.2697795
A09	12508513	12509472	A09p21010.2_BraZ1	384	+	546	959	959	1.0000000
A09	12512730	12515393	A09p21020.2_BraZ1	1669.44	-	671	2397	2663	0.9001126
A09	12528424	12532344	A09p21030.2_BraZ1	1862.34	+	644	2753	3920	0.7022959
A09	12534010	12541961	A09p21040.2_BraZ1	3441.53	+	3295	7692	7951	0.9674255
A09	12544120	12544930	A09p21050.2_BraZ1	81	+	14	455	810	0.5617284
A09	12546506	12547010	A09p21060.2_BraZ1	50.4	-	288	504	504	1.0000000
A09	12547303	12548319	A09p21070.2_BraZ1	927	-	542	1016	1016	1.0000000
A09	12551732	12557724	A09p21080.2_BraZ1	2659.81	-	2333	5755	5992	0.9604473
A09	12559261	12561237	A09p21090.2_BraZ1	862.625	-	807	1473	1976	0.7454454
A09	12563921	12568219	A09p21100.2_BraZ1	2255.46	+	1665	3855	4298	0.8969288
A09	12569422	12572032	A09p21110.2_BraZ1	261	-	270	1858	2610	0.7118774
A09	12576319	12576746	A09p21120.2_BraZ1	2331	-	435	427	427	1.0000000
A09	12579753	12581984	A09p21130.2_BraZ1	1170.21	+	900	2044	2231	0.9161811
A09	12585343	12587824	A09p21140.2_BraZ1	1908.36	+	305	1911	2481	0.7702540
A09	12588873	12590520	A09p21150.2_BraZ1	164.7	-	630	1502	1647	0.9119611
A09	12592395	12593155	A09p21160.2_BraZ1	669	-	69	302	760	0.3973684
A09	12594866	12595028	A09p21170.2_BraZ1	16.2	+	245	162	162	1.0000000
A09	12596141	12598016	A09p21180.2_BraZ1	1296.75	-	520	1794	1875	0.9568000
A09	12603853	12604408	A09p21190.2_BraZ1	55.5	-	75	514	555	0.9261261
A09	12609100	12616387	A09p21200.2_BraZ1	3060.44	+	2252	5949	7287	0.8163853
A09	12620919	12626590	A09p21210.2_BraZ1	3168.79	-	404	3343	5671	0.5894904
A09	12643065	12643371	A09p21220.2_BraZ1	30.6	+	3	6	306	0.0196078
A09	12647054	12649332	A09p21230.2_BraZ1	918	-	1006	2278	2278	1.0000000
A09	12655156	12655363	A09p21240.2_BraZ1	20.7	-	83	135	207	0.6521739
A09	12656638	12657914	A09p21250.2_BraZ1	1059	+	917	1270	1276	0.9952978
A09	12658598	12660577	A09p21260.2_BraZ1	12789	+	802	1944	1979	0.9823143
A09	12661239	12663172	A09p21270.2_BraZ1	864.3	-	1704	1933	1933	1.0000000
A09	12667386	12667947	A09p21280.2_BraZ1	56.1	-	2155	561	561	1.0000000
A09	12676380	12676811	A09p21290.2_BraZ1	253.125	-	257	431	431	1.0000000
A09	12676811	12678675	A09p21300.2_BraZ1	1254	-	708	1864	1864	1.0000000
A09	12760431	12761686	A09p21310.2_BraZ1	4800.75	+	2292	1255	1255	1.0000000
A09	12762792	12764577	A09p21320.2_BraZ1	803.111	+	1190	1743	1785	0.9764706
A09	12765022	12765565	A09p21330.2_BraZ1	54.3	-	579	533	543	0.9815838
A09	12767705	12768834	A09p21340.2_BraZ1	684.77	+	680	1087	1129	0.9627990
A09	12779057	12780644	A09p21350.2_BraZ1	891	-	0	0	1587	0.0000000
A09	12783459	12784254	A09p21360.2_BraZ1	79.5	+	26	250	795	0.3144654
A09	12785705	12788559	A09p21370.2_BraZ1	1476.43	-	105	1313	2854	0.4600561
A09	12806751	12807116	A09p21380.2_BraZ1	33.3	+	504	365	365	1.0000000
A09	12815307	12816219	A09p21390.2_BraZ1	60.6	-	85	789	912	0.8651316
A09	12816969	12817254	A09p21400.2_BraZ1	231	+	21	157	285	0.5508772
A09	12817776	12818358	A09p21410.2_BraZ1	345	-	25	510	582	0.8762887
A09	12824957	12827201	A09p21420.2_BraZ1	1237.09	-	783	2182	2244	0.9723707
A09	12830749	12830938	A09p21430.2_BraZ1	16.2	-	77	187	189	0.9894180
A09	12836507	12836930	A09p21440.2_BraZ1	41.1	-	255	423	423	1.0000000
A09	12839837	12840194	A09p21450.2_BraZ1	216	+	0	0	357	0.0000000
A09	12840953	12844439	A09p21460.2_BraZ1	1795.2	+	493	1660	3486	0.4761905
A09	12851760	12868504	A09p21470.2_BraZ1	1959.98	+	9156	13351	16744	0.7973602
A09	12870124	12870550	A09p21480.2_BraZ1	342	-	529	426	426	1.0000000
A09	12880327	12885799	A09p21490.2_BraZ1	686	+	5760	5231	5472	0.9559576
A09	12887425	12888538	A09p21500.2_BraZ1	629.673	-	575	1113	1113	1.0000000
A09	12892017	12892947	A09p21510.2_BraZ1	93	-	469	930	930	1.0000000
A09	12893765	12894229	A09p21520.2_BraZ1	363	-	83	430	464	0.9267241
A09	12896271	12898123	A09p21530.2_BraZ1	17340	-	1350	1825	1852	0.9854212
A09	12903447	12905004	A09p21540.2_BraZ1	1115.89	-	505	1393	1557	0.8946692
A09	12907848	12909908	A09p21550.2_BraZ1	1290.2	+	374	2004	2060	0.9728155
A09	12911166	12912042	A09p21560.2_BraZ1	87.6	-	292	876	876	1.0000000
A09	12920041	12921538	A09p21570.2_BraZ1	944.045	-	71	911	1497	0.6085504
A09	12924801	12928324	A09p21580.2_BraZ1	2289.08	-	417	2093	3523	0.5940959
A09	12931935	12932221	A09p21590.2_BraZ1	177	+	2	220	286	0.7692308
A09	12932920	12933644	A09p21600.2_BraZ1	871.5	-	2	32	724	0.0441989
A09	12934286	12934599	A09p21610.2_BraZ1	195	+	39	73	313	0.2332268
A09	12941659	12941857	A09p21620.2_BraZ1	19.8	-	0	0	198	0.0000000
A09	12943798	12944529	A09p21630.2_BraZ1	1267.5	-	95	344	731	0.4705882
A09	12948518	12949220	A09p21640.2_BraZ1	266.146	-	611	702	702	1.0000000
A09	12950094	12950532	A09p21650.2_BraZ1	43.8	+	92	161	438	0.3675799
A09	12968045	12972087	A09p21660.2_BraZ1	894	+	901	3735	4042	0.9240475
A09	12973965	12974878	A09p21670.2_BraZ1	535.827	-	374	913	913	1.0000000
A09	12998173	12999211	A09p21680.2_BraZ1	451.261	-	360	1006	1038	0.9691715
A09	13001048	13003991	A09p21690.2_BraZ1	1153.64	-	454	1990	2943	0.6761808
A09	13008988	13010943	A09p21700.2_BraZ1	1233	-	798	1936	1955	0.9902813
A09	13013058	13014647	A09p21710.2_BraZ1	511.2	+	1579	1589	1589	1.0000000
A09	13020040	13026335	A09p21720.2_BraZ1	4439.71	+	464	2887	6295	0.4586180
A09	13027862	13028521	A09p21730.2_BraZ1	37.2	+	482	659	659	1.0000000
A09	13029608	13031047	A09p21740.2_BraZ1	463.593	-	973	1439	1439	1.0000000
A09	13032332	13032803	A09p21750.2_BraZ1	47.1	+	174	471	471	1.0000000
A09	13037630	13038048	A09p21760.2_BraZ1	273	-	111	401	418	0.9593301
A09	13039273	13039814	A09p21770.2_BraZ1	159	+	508	473	541	0.8743069
A09	13044443	13044704	A09p21780.2_BraZ1	24.6	+	95	261	261	1.0000000
A09	13057961	13060148	A09p21790.2_BraZ1	1440.86	+	347	1464	2187	0.6694102
A09	13066098	13067295	A09p21800.2_BraZ1	119.7	-	149	992	1197	0.8287385
A09	13079687	13083550	A09p21810.2_BraZ1	2358.38	+	1168	2994	3863	0.7750453
A09	13083907	13084204	A09p21820.2_BraZ1	29.7	-	165	297	297	1.0000000
A09	13086283	13104474	A09p21830.2_BraZ1	2360.96	+	6404	16427	18191	0.9030290
A09	13105021	13106486	A09p21840.2_BraZ1	985.32	-	621	1455	1465	0.9931741
A09	13114035	13114938	A09p21850.2_BraZ1	831	+	380	903	903	1.0000000
A09	13115488	13116710	A09p21860.2_BraZ1	990	-	911	1182	1222	0.9672668
A09	13130925	13133419	A09p21870.2_BraZ1	888.955	-	1488	2464	2494	0.9879711
A09	13136368	13138936	A09p21880.2_BraZ1	1190.12	-	1117	2431	2568	0.9466511
A09	13154366	13155883	A09p21890.2_BraZ1	982.887	+	215	1342	1517	0.8846408
A09	13160800	13162333	A09p21900.2_BraZ1	153.3	-	51	358	1533	0.2335290
A09	13171992	13172263	A09p21910.2_BraZ1	189	+	219	271	271	1.0000000
A09	13178636	13180353	A09p21920.2_BraZ1	41760	-	1208	1717	1717	1.0000000
A09	13183425	13185136	A09p21930.2_BraZ1	44892	-	1288	1711	1711	1.0000000
A09	13188312	13188590	A09p21940.2_BraZ1	162	+	56	278	278	1.0000000
A09	13208960	13210322	A09p21950.2_BraZ1	4485	+	1404	1362	1362	1.0000000
A09	13213720	13215875	A09p21960.2_BraZ1	1064.77	-	300	1952	2155	0.9058005
A09	13223683	13223866	A09p21970.2_BraZ1	18.3	-	236	183	183	1.0000000
A09	13226974	13228682	A09p21980.2_BraZ1	50895	+	223	758	1708	0.4437939
A09	13240262	13241970	A09p21990.2_BraZ1	19731.6	+	1631	927	1708	0.5427400
A09	13247446	13247845	A09p22000.2_BraZ1	39.9	-	84	394	399	0.9874687
A09	13301248	13305237	A09p22010.2_BraZ1	845.804	+	1539	3802	3989	0.9531211
A09	13305690	13306256	A09p22020.2_BraZ1	483	-	672	550	566	0.9717314
A09	13310442	13310998	A09p22030.2_BraZ1	25.3846	+	14	253	556	0.4550360
A09	13314906	13315892	A09p22040.2_BraZ1	437.538	+	171	913	986	0.9259635
A09	13317296	13317830	A09p22050.2_BraZ1	53.4	+	2	20	534	0.0374532
A09	13323013	13323424	A09p22060.2_BraZ1	41.1	+	1	30	411	0.0729927
A09	13329628	13331172	A09p22070.2_BraZ1	168	+	1532	1127	1544	0.7299223
A09	13337143	13340554	A09p22080.2_BraZ1	773.5	-	1134	3039	3411	0.8909411
A09	13359674	13359860	A09p22090.2_BraZ1	18.6	-	152	186	186	1.0000000
A09	13365778	13366538	A09p22100.2_BraZ1	562.286	+	14	282	760	0.3710526
A09	13368489	13369821	A09p22110.2_BraZ1	101.333	+	458	1286	1332	0.9654655
A09	13372809	13373419	A09p22120.2_BraZ1	201	-	421	610	610	1.0000000
A09	13394246	13395808	A09p22130.2_BraZ1	756	-	497	1453	1562	0.9302177
A09	13398775	13400616	A09p22140.2_BraZ1	308.857	-	1045	1720	1841	0.9342749
A09	13402182	13403824	A09p22150.2_BraZ1	1002	+	831	1640	1642	0.9987820
A09	13404804	13407400	A09p22160.2_BraZ1	2366.55	-	1370	2367	2596	0.9117874
A09	13414605	13415034	A09p22170.2_BraZ1	42.9	+	398	429	429	1.0000000
A09	13418119	13418555	A09p22180.2_BraZ1	351	+	421	436	436	1.0000000
A09	13419528	13423462	A09p22190.2_BraZ1	1721.67	+	4100	3846	3934	0.9776309
A09	13425659	13426139	A09p22200.2_BraZ1	48	-	170	356	480	0.7416667
A09	13430067	13438710	A09p22210.2_BraZ1	4247.14	-	2710	8228	8643	0.9519843
A09	13442462	13442855	A09p22220.2_BraZ1	39.3	+	0	0	393	0.0000000
A09	13445601	13450634	A09p22230.2_BraZ1	1059.31	-	2252	4943	5033	0.9821180
A09	13450685	13456490	A09p22240.2_BraZ1	2515.17	+	1466	5593	5805	0.9634798
A09	13460915	13467058	A09p22250.2_BraZ1	1584	-	2449	4113	6143	0.6695426
A09	13474578	13477146	A09p22260.2_BraZ1	1095.89	+	929	2435	2568	0.9482087
A09	13477708	13480055	A09p22270.2_BraZ1	1187.88	-	610	2236	2347	0.9527056
A09	13485391	13485694	A09p22280.2_BraZ1	30.3	+	151	303	303	1.0000000
A09	13487207	13487498	A09p22290.2_BraZ1	29.1	-	78	248	291	0.8522336
A09	13488511	13488652	A09p22300.2_BraZ1	14.1	+	671	141	141	1.0000000
A09	13491760	13493636	A09p22310.2_BraZ1	1052.52	-	690	1807	1876	0.9632196
A09	13497532	13499044	A09p22320.2_BraZ1	691.914	+	58	616	1512	0.4074074
A09	13501582	13512918	A09p22330.2_BraZ1	758.25	-	11648	10864	11336	0.9583628
A09	13513822	13515089	A09p22340.2_BraZ1	321	-	154	593	1267	0.4680347
A09	13523766	13524225	A09p22350.2_BraZ1	45.9	+	62	451	459	0.9825708
A09	13527214	13530034	A09p22360.2_BraZ1	985.263	+	507	2405	2820	0.8528369
A09	13530873	13533606	A09p22370.2_BraZ1	1023.07	+	642	2343	2733	0.8572997
A09	13534390	13537963	A09p22380.2_BraZ1	1380.95	-	1254	3395	3573	0.9501819
A09	13538799	13541516	A09p22390.2_BraZ1	1373.97	-	2122	2709	2717	0.9970556
A09	13547244	13550841	A09p22400.2_BraZ1	726.818	-	1975	3597	3597	1.0000000
A09	13553988	13555087	A09p22410.2_BraZ1	342	+	1197	1099	1099	1.0000000
A09	13556686	13560595	A09p22420.2_BraZ1	2544	-	3265	3909	3909	1.0000000
A09	13562578	13562785	A09p22430.2_BraZ1	20.7	-	25	207	207	1.0000000
A09	13565336	13565925	A09p22440.2_BraZ1	33.3	-	311	589	589	1.0000000
A09	13572081	13573744	A09p22450.2_BraZ1	763.8	-	468	1497	1663	0.9001804
A09	13578559	13580271	A09p22460.2_BraZ1	858	+	1349	1712	1712	1.0000000
A09	13583421	13583829	A09p22470.2_BraZ1	33.9	+	602	408	408	1.0000000
A09	13584430	13584888	A09p22480.2_BraZ1	183	+	0	0	458	0.0000000
A09	13585196	13586779	A09p22490.2_BraZ1	1037.4	-	112	967	1583	0.6108655
A09	13587473	13588226	A09p22500.2_BraZ1	75.3	+	14	749	753	0.9946879
A09	13597882	13599262	A09p22510.2_BraZ1	1091.52	-	730	1334	1380	0.9666666
A09	13599695	13600385	A09p22520.2_BraZ1	69	+	42	499	690	0.7231884
A09	13616531	13622927	A09p22530.2_BraZ1	3179.92	+	2198	6234	6396	0.9746717
A09	13624309	13626307	A09p22540.2_BraZ1	99.3	+	502	1981	1998	0.9914915
A09	13626470	13628128	A09p22550.2_BraZ1	1177.14	-	1647	1658	1658	1.0000000
A09	13632155	13633289	A09p22560.2_BraZ1	113.4	-	63	630	1134	0.5555556
A09	13641072	13643808	A09p22570.2_BraZ1	1172.74	-	1491	2461	2736	0.8994883
A09	13645580	13648758	A09p22580.2_BraZ1	2868	+	1293	3109	3178	0.9782882
A09	13651428	13653981	A09p22590.2_BraZ1	1892.17	-	896	2517	2553	0.9858990
A09	13660877	13662228	A09p22600.2_BraZ1	936	-	796	1190	1351	0.8808290
A09	13663674	13665432	A09p22610.2_BraZ1	175.8	-	276	1604	1758	0.9124005
A09	13666599	13668187	A09p22620.2_BraZ1	31610.2	-	256	1579	1588	0.9943325
A09	13669994	13670645	A09p22630.2_BraZ1	1797.75	+	0	0	651	0.0000000
A09	13671146	13673937	A09p22640.2_BraZ1	1935	+	3345	2377	2791	0.8516661
A09	13675635	13676637	A09p22650.2_BraZ1	100.2	+	432	947	1002	0.9451098
A09	13687371	13689724	A09p22660.2_BraZ1	936.284	-	1569	2353	2353	1.0000000
A09	13692704	13696584	A09p22670.2_BraZ1	17041.5	-	1838	3880	3880	1.0000000
A09	13700805	13727246	A09p22680.2_BraZ1	634.667	-	123960	24628	26441	0.9314322
A09	13701753	13702330	A09p22690.2_BraZ1	91	-	917	577	577	1.0000000
A09	13712461	13712682	A09p22700.2_BraZ1	120	+	29	221	221	1.0000000
A09	13728560	13729104	A09p22710.2_BraZ1	189	-	253	544	544	1.0000000
A09	13736551	13743042	A09p22720.2_BraZ1	4155.33	-	964	4454	6491	0.6861809
A09	13740174	13740606	A09p22730.2_BraZ1	43.2	+	64	364	432	0.8425926
A09	13740948	13741911	A09p22740.2_BraZ1	714	+	127	681	963	0.7071651
A09	13747703	13749460	A09p22750.2_BraZ1	388	+	102	1019	1757	0.5799658
A09	13771642	13773444	A09p22760.2_BraZ1	5258.67	-	382	1398	1802	0.7758046
A09	13783712	13785317	A09p22770.2_BraZ1	160.2	-	319	1249	1605	0.7781932
A09	13787228	13788908	A09p22780.2_BraZ1	936.232	-	875	1680	1680	1.0000000
A09	13798096	13800168	A09p22790.2_BraZ1	1158.69	+	1011	2072	2072	1.0000000
A09	13800559	13800919	A09p22800.2_BraZ1	36	-	392	360	360	1.0000000
A09	13801007	13804860	A09p22810.2_BraZ1	504.739	+	3800	3848	3853	0.9987023
A09	13805885	13808155	A09p22820.2_BraZ1	801	-	1317	1981	2270	0.8726872
A09	13808631	13811480	A09p22830.2_BraZ1	174	-	3306	2849	2849	1.0000000
A09	13813907	13815152	A09p22840.2_BraZ1	124.5	+	384	738	1245	0.5927711
A09	13819551	13820505	A09p22850.2_BraZ1	531.562	+	1	1	954	0.0010482
A09	13823370	13824325	A09p22860.2_BraZ1	519.75	+	0	0	955	0.0000000
A09	13826481	13826989	A09p22870.2_BraZ1	3193	+	371	508	508	1.0000000
A09	13827918	13828896	A09p22880.2_BraZ1	97.8	-	129	869	978	0.8885481
A09	13832244	13833222	A09p22890.2_BraZ1	97.8	-	163	978	978	1.0000000
A09	13833917	13840675	A09p22900.2_BraZ1	1226.11	+	6025	6509	6758	0.9631548
A09	13840909	13841827	A09p22910.2_BraZ1	759	-	404	840	918	0.9150327
A09	13844821	13847098	A09p22920.2_BraZ1	227.7	+	59	1443	2277	0.6337286
A09	13849014	13852677	A09p22930.2_BraZ1	2270.5	-	1582	3039	3663	0.8296478
A09	13863010	13863624	A09p22940.2_BraZ1	229.5	-	269	614	614	1.0000000
A09	13866815	13870003	A09p22950.2_BraZ1	16496	+	320	1898	3188	0.5953576
A09	13870337	13874944	A09p22960.2_BraZ1	2815.57	-	969	3488	4607	0.7571087
A09	13876148	13884641	A09p22970.2_BraZ1	6614.97	-	1145	4489	8493	0.5285529
A09	13887538	13893419	A09p22980.2_BraZ1	832.5	-	1751	4577	5881	0.7782690
A09	13906132	13906450	A09p22990.2_BraZ1	31.8	-	426	183	318	0.5754717
A09	13915826	13919466	A09p23000.2_BraZ1	1558.29	-	3062	3052	3640	0.8384615
A09	13924409	13924643	A09p23010.2_BraZ1	21.6	-	85	234	234	1.0000000
A09	13925474	13926113	A09p23020.2_BraZ1	447	+	268	639	639	1.0000000
A09	13928100	13929353	A09p23030.2_BraZ1	308	+	838	1028	1253	0.8204310
A09	13930144	13930399	A09p23040.2_BraZ1	25.5	-	462	255	255	1.0000000
A09	13934243	13936968	A09p23050.2_BraZ1	1161.92	+	1242	2265	2725	0.8311927
A09	13940196	13945646	A09p23060.2_BraZ1	2149.88	+	2192	5202	5450	0.9544954
A09	13950206	13954118	A09p23070.2_BraZ1	2944.53	-	636	3394	3912	0.8675869
A09	13955564	13959958	A09p23080.2_BraZ1	301.442	+	2033	3964	4394	0.9021393
A09	13959840	13961193	A09p23090.2_BraZ1	139.154	+	369	872	1353	0.6444937
A09	13962327	13966253	A09p23100.2_BraZ1	1408.74	+	87	1713	3926	0.4363219
A09	13972805	13974492	A09p23110.2_BraZ1	1326.38	-	111	719	1687	0.4262004
A09	13976123	13977061	A09p23120.2_BraZ1	304	-	179	405	938	0.4317697
A09	14011298	14012119	A09p23130.2_BraZ1	60.3	+	14	64	821	0.0779537
A09	14013027	14016447	A09p23140.2_BraZ1	216.6	+	1238	3309	3420	0.9675438
A09	14028619	14030602	A09p23150.2_BraZ1	903.75	+	437	1719	1983	0.8668684
A09	14032330	14032636	A09p23160.2_BraZ1	30.6	-	61	294	306	0.9607843
A09	14036900	14041716	A09p23170.2_BraZ1	2106	-	1249	4319	4816	0.8968023
A09	14037390	14039287	A09p23180.2_BraZ1	663	-	579	1786	1897	0.9414865
A09	14044919	14045939	A09p23190.2_BraZ1	505.227	-	154	913	1020	0.8950980
A09	14056212	14057766	A09p23200.2_BraZ1	155.4	+	92	477	1554	0.3069498
A09	14062925	14064550	A09p23210.2_BraZ1	546.196	+	507	1247	1625	0.7673846
A09	14068449	14072815	A09p23220.2_BraZ1	918	-	1381	2411	4366	0.5522217
A09	14081715	14083226	A09p23230.2_BraZ1	420	+	54	337	1511	0.2230311
A09	14088444	14089505	A09p23240.2_BraZ1	774	+	68	175	1061	0.1649387
A09	14091154	14091779	A09p23250.2_BraZ1	354.25	-	97	325	625	0.5200000
A09	14092418	14093637	A09p23260.2_BraZ1	1037.82	-	156	1009	1219	0.8277276
A09	14104615	14113653	A09p23270.2_BraZ1	2331	-	849	4740	9038	0.5244523
A09	14120837	14121335	A09p23280.2_BraZ1	49.8	+	194	498	498	1.0000000
A09	14127661	14131389	A09p23290.2_BraZ1	10065	+	1061	2493	3728	0.6687232
A09	14132146	14134657	A09p23300.2_BraZ1	1437.95	-	1078	1601	2511	0.6375946
A09	14140857	14142953	A09p23310.2_BraZ1	1376.28	-	549	1787	2096	0.8525763
A09	14143569	14143773	A09p23320.2_BraZ1	20.4	-	26	8	204	0.0392157
A09	14150574	14151173	A09p23330.2_BraZ1	261	-	113	591	599	0.9866444
A09	14167801	14170535	A09p23340.2_BraZ1	1518.75	-	498	2667	2734	0.9754938
A09	14176954	14177369	A09p23350.2_BraZ1	282	+	70	312	415	0.7518072
A09	14196329	14196573	A09p23360.2_BraZ1	171	-	319	220	244	0.9016393
A09	14199382	14203378	A09p23370.2_BraZ1	348.355	-	1310	2939	3996	0.7354855
A09	14205822	14206867	A09p23380.2_BraZ1	525	-	59	562	1045	0.5377991
A09	14209324	14211085	A09p23390.2_BraZ1	936	-	812	1744	1761	0.9903464
A09	14213777	14215426	A09p23400.2_BraZ1	1031.25	+	874	1467	1649	0.8896301
A09	14224511	14226278	A09p23410.2_BraZ1	936.96	+	910	1733	1767	0.9807584
A09	14229104	14230460	A09p23420.2_BraZ1	135.6	-	1266	1356	1356	1.0000000
A09	14238611	14246023	A09p23430.2_BraZ1	1916.15	+	2351	5086	7412	0.6861846
A09	14248949	14257743	A09p23440.2_BraZ1	13277.8	-	5609	8106	8794	0.9217649
A09	14268315	14269131	A09p23450.2_BraZ1	81.6	+	1119	816	816	1.0000000
A09	14283111	14283444	A09p23460.2_BraZ1	135	-	59	312	333	0.9369369
A09	14284136	14284939	A09p23470.2_BraZ1	576	-	26	642	803	0.7995019
A09	14295170	14295365	A09p23480.2_BraZ1	19.5	-	4	20	195	0.1025641
A09	14295811	14300317	A09p23490.2_BraZ1	855	+	679	2366	4506	0.5250777
A09	14305323	14307799	A09p23500.2_BraZ1	2403	+	944	2474	2476	0.9991922
A09	14308087	14309296	A09p23510.2_BraZ1	10670.2	-	1032	1209	1209	1.0000000
A09	14313008	14313621	A09p23520.2_BraZ1	302.5	-	7	183	613	0.2985318
A09	14314099	14316706	A09p23530.2_BraZ1	735	-	1674	2569	2607	0.9854239
A09	14317216	14317828	A09p23540.2_BraZ1	306	+	520	612	612	1.0000000
A09	14318157	14320413	A09p23550.2_BraZ1	1248.64	+	2149	2086	2256	0.9246454
A09	14324380	14325745	A09p23560.2_BraZ1	571.824	+	951	1365	1365	1.0000000
A09	14326569	14331886	A09p23570.2_BraZ1	2054.29	+	2282	4781	5317	0.8991913
A09	14337378	14337726	A09p23580.2_BraZ1	34.8	-	4	247	348	0.7097701
A09	14339513	14340123	A09p23590.2_BraZ1	234	-	592	610	610	1.0000000
A09	14346946	14352905	A09p23600.2_BraZ1	2110.28	-	367	2645	5959	0.4438664
A09	14368201	14370093	A09p23610.2_BraZ1	1086	+	252	1295	1892	0.6844609
A09	14370611	14371737	A09p23620.2_BraZ1	574.08	+	433	1044	1126	0.9271758
A09	14384338	14385423	A09p23630.2_BraZ1	1023	+	95	769	1085	0.7087557
A09	14388071	14391322	A09p23640.2_BraZ1	2708.45	-	548	2985	3251	0.9181790
A09	14400718	14401538	A09p23650.2_BraZ1	333.2	-	35	673	820	0.8207317
A09	14401228	14402187	A09p23660.2_BraZ1	357	+	200	927	959	0.9666319
A09	14402796	14406113	A09p23670.2_BraZ1	1984.95	+	957	2991	3317	0.9017184
A09	14407052	14408032	A09p23680.2_BraZ1	27593.5	-	305	960	980	0.9795918
A09	14411560	14412225	A09p23690.2_BraZ1	196.429	+	4805	665	665	1.0000000
A09	14412225	14413153	A09p23700.2_BraZ1	1124.57	+	5920	928	928	1.0000000
A09	14412717	14413692	A09p23710.2_BraZ1	1340.57	+	4462	975	975	1.0000000
A09	14420274	14420970	A09p23720.2_BraZ1	588	+	0	0	696	0.0000000
A09	14421349	14421646	A09p23730.2_BraZ1	243	-	2	130	297	0.4377104
A09	14422187	14423100	A09p23740.2_BraZ1	68.7	+	9	382	913	0.4184009
A09	14426971	14428072	A09p23750.2_BraZ1	771	-	30	833	1101	0.7565849
A09	14434696	14437222	A09p23760.2_BraZ1	840	-	459	1195	2526	0.4730800
A09	14445089	14445685	A09p23770.2_BraZ1	462	-	143	569	596	0.9546980
A09	14445904	14449234	A09p23780.2_BraZ1	1374	-	1505	2956	3330	0.8876877
A09	14461596	14462570	A09p23790.2_BraZ1	353.4	-	651	928	974	0.9527721
A09	14463142	14465193	A09p23800.2_BraZ1	570	+	840	2051	2051	1.0000000
A09	14478627	14485431	A09p23810.2_BraZ1	1782.37	-	2403	5391	6804	0.7923281
A09	14495295	14504164	A09p23820.2_BraZ1	1657.55	-	651	5216	8869	0.5881159
A09	14516472	14522201	A09p23830.2_BraZ1	1048.58	-	751	4250	5729	0.7418398
A09	14539478	14544096	A09p23840.2_BraZ1	3069.99	+	738	3219	4618	0.6970550
A09	14549245	14550226	A09p23850.2_BraZ1	98.1	-	139	953	981	0.9714577
A09	14551286	14551957	A09p23860.2_BraZ1	215.625	-	113	670	671	0.9985097
A09	14551917	14552545	A09p23870.2_BraZ1	324.273	-	130	599	628	0.9538217
A09	14564163	14564406	A09p23880.2_BraZ1	23.7	-	227	243	243	1.0000000
A09	14564900	14566598	A09p23890.2_BraZ1	915.194	-	832	1698	1698	1.0000000
A09	14579782	14580414	A09p23900.2_BraZ1	403.2	-	0	0	632	0.0000000
A09	14583315	14583638	A09p23910.2_BraZ1	243	+	228	323	323	1.0000000
A09	14584413	14587153	A09p23920.2_BraZ1	2031	+	233	1732	2740	0.6321168
A09	14594157	14595528	A09p23930.2_BraZ1	635.143	+	208	1154	1371	0.8417214
A09	14601852	14601966	A09p23940.2_BraZ1	11.4	-	133	114	114	1.0000000
A09	14602432	14605541	A09p23950.2_BraZ1	730.3	-	2237	3109	3109	1.0000000
A09	14606391	14610836	A09p23960.2_BraZ1	2265.9	-	3123	4404	4445	0.9907762
A09	14613801	14614338	A09p23970.2_BraZ1	53.7	-	143	346	537	0.6443203
A09	14615241	14618405	A09p23980.2_BraZ1	1974	-	377	2166	3164	0.6845765
A09	14635731	14638265	A09p23990.2_BraZ1	1067.18	+	295	2346	2534	0.9258090
A09	14638872	14641179	A09p24000.2_BraZ1	1201.05	-	376	2201	2307	0.9540529
A09	14650685	14650898	A09p24010.2_BraZ1	144	-	18	213	213	1.0000000
A09	14657095	14660842	A09p24020.2_BraZ1	22325	+	1039	3483	3747	0.9295436
A09	14668572	14672329	A09p24030.2_BraZ1	945	-	1123	3581	3757	0.9531541
A09	14683682	14685050	A09p24040.2_BraZ1	12960	-	162	915	1368	0.6688597
A09	14686397	14688683	A09p24050.2_BraZ1	1008.67	-	812	2077	2286	0.9085739
A09	14689744	14691316	A09p24060.2_BraZ1	997.941	-	1480	1572	1572	1.0000000
A09	14691965	14694488	A09p24070.2_BraZ1	1312.04	+	790	2484	2523	0.9845422
A09	14700635	14701448	A09p24080.2_BraZ1	402	+	347	718	813	0.8831488
A09	14702281	14702539	A09p24090.2_BraZ1	25.8	+	78	228	258	0.8837209
A09	14702715	14703056	A09p24100.2_BraZ1	309	+	65	301	341	0.8826979
A09	14706851	14707169	A09p24110.2_BraZ1	30.6	+	97	130	318	0.4088050
A09	14710080	14711360	A09p24120.2_BraZ1	1071	+	129	525	1280	0.4101562
A09	14713511	14721398	A09p24130.2_BraZ1	2715.32	+	1567	4621	7887	0.5859008
A09	14722563	14760589	A09p24140.2_BraZ1	225	+	29007	36292	38026	0.9543996
A09	14723196	14739224	A09p24150.2_BraZ1	14917.2	+	9935	14681	16028	0.9159596
A09	14739736	14743540	A09p24160.2_BraZ1	3297.13	-	4636	3804	3804	1.0000000
A09	14751428	14760344	A09p24170.2_BraZ1	3040.2	+	9373	8878	8916	0.9957380
A09	14761535	14761814	A09p24180.2_BraZ1	14.7	+	152	279	279	1.0000000
A09	14764222	14765607	A09p24190.2_BraZ1	460.261	+	435	1342	1385	0.9689531
A09	14765877	14775718	A09p24200.2_BraZ1	3551.06	-	2581	5583	9841	0.5673204
A09	14777929	14784407	A09p24210.2_BraZ1	1856.03	+	4644	6129	6478	0.9461253
A09	14784631	14785030	A09p24220.2_BraZ1	162	-	37	399	399	1.0000000
A09	14787277	14788200	A09p24230.2_BraZ1	260.4	-	96	507	923	0.5492958
A09	14804065	14806429	A09p24240.2_BraZ1	1271.13	+	2091	2364	2364	1.0000000
A09	14808312	14809810	A09p24250.2_BraZ1	919.038	+	398	1021	1498	0.6815754
A09	14811009	14813361	A09p24260.2_BraZ1	1807.71	+	643	2271	2352	0.9655612
A09	14819091	14819937	A09p24270.2_BraZ1	84.6	+	191	841	846	0.9940898
A09	14830880	14834653	A09p24280.2_BraZ1	9418.5	+	3166	3773	3773	1.0000000
A09	14837310	14837619	A09p24290.2_BraZ1	30.9	-	482	309	309	1.0000000
A09	14850274	14851557	A09p24300.2_BraZ1	813	+	162	852	1283	0.6640686
A09	14853108	14854407	A09p24310.2_BraZ1	650	-	731	1299	1299	1.0000000
A09	14855456	14855936	A09p24320.2_BraZ1	364.929	+	194	480	480	1.0000000
A09	14856213	14857350	A09p24330.2_BraZ1	267.429	+	78	718	1137	0.6314864
A09	14867800	14868367	A09p24340.2_BraZ1	56.7	+	89	490	567	0.8641976
A09	14876303	14877164	A09p24350.2_BraZ1	86.1	-	5	214	861	0.2485482
A09	14878320	14879361	A09p24360.2_BraZ1	798	+	1262	1028	1041	0.9875120
A09	14884325	14885852	A09p24370.2_BraZ1	4711.5	-	424	1441	1527	0.9436804
A09	14888337	14888634	A09p24380.2_BraZ1	23.4	+	362	297	297	1.0000000
A09	14888704	14889425	A09p24390.2_BraZ1	474	-	594	716	721	0.9930652
A09	14892409	14894104	A09p24400.2_BraZ1	169.5	+	190	1252	1695	0.7386431
A09	14903362	14904010	A09p24410.2_BraZ1	64.8	-	127	343	648	0.5293210
A09	14907426	14908366	A09p24420.2_BraZ1	1407.38	-	144	848	940	0.9021277
A09	14909531	14910747	A09p24430.2_BraZ1	903	-	178	959	1216	0.7886513
A09	14918985	14920509	A09p24440.2_BraZ1	152.4	+	68	1066	1524	0.6994750
A09	14939904	14942064	A09p24450.2_BraZ1	550	+	1829	2160	2160	1.0000000
A09	14945186	14945321	A09p24460.2_BraZ1	13.5	-	33	135	135	1.0000000
A09	14945713	14946225	A09p24470.2_BraZ1	231	-	65	512	512	1.0000000
A09	14975092	14976622	A09p24480.2_BraZ1	120	+	137	1433	1530	0.9366013
A09	14987046	14991357	A09p24490.2_BraZ1	951.75	-	816	3723	4311	0.8636047
A09	15007898	15009997	A09p24500.2_BraZ1	279	-	1336	2053	2099	0.9780848
A09	15011663	15011969	A09p24510.2_BraZ1	30.6	+	325	306	306	1.0000000
A09	15021006	15025410	A09p24520.2_BraZ1	2155.65	+	548	2589	4404	0.5878747
A09	15031275	15031668	A09p24530.2_BraZ1	39.3	-	40	244	393	0.6208652
A09	15044947	15045337	A09p24540.2_BraZ1	39	-	0	0	390	0.0000000
A09	15051652	15054851	A09p24550.2_BraZ1	2003.29	+	965	2933	3199	0.9168490
A09	15062604	15063147	A09p24560.2_BraZ1	54.3	-	60	288	543	0.5303867
A09	15067321	15077000	A09p24570.2_BraZ1	376.125	-	785	7878	9679	0.8139271
A09	15093416	15094400	A09p24580.2_BraZ1	98.4	-	308	958	984	0.9735773
A09	15098483	15098789	A09p24590.2_BraZ1	213	-	422	306	306	1.0000000
A09	15105018	15107750	A09p24600.2_BraZ1	83.1086	+	1554	2715	2732	0.9937775
A09	15113845	15121196	A09p24610.2_BraZ1	3992.54	+	1049	5476	7351	0.7449327
A09	15121964	15123541	A09p24620.2_BraZ1	612	+	1285	1577	1577	1.0000000
A09	15138556	15145116	A09p24630.2_BraZ1	924	+	648	1225	6560	0.1867378
A09	15184791	15187698	A09p24640.2_BraZ1	9327.11	+	162	1606	2907	0.5524596
A09	15190722	15191477	A09p24650.2_BraZ1	294	+	155	661	755	0.8754967
A09	15191728	15192121	A09p24660.2_BraZ1	177	+	9	288	393	0.7328244
A09	15198060	15198743	A09p24670.2_BraZ1	531	+	61	636	683	0.9311860
A09	15199946	15201750	A09p24680.2_BraZ1	1193.86	-	448	1748	1804	0.9689579
A09	15202511	15202703	A09p24690.2_BraZ1	19.2	-	256	192	192	1.0000000
A09	15205080	15205307	A09p24700.2_BraZ1	189	-	702	227	227	1.0000000
A09	15224357	15224474	A09p24710.2_BraZ1	11.7	-	10	70	117	0.5982906
A09	15227820	15227940	A09p24720.2_BraZ1	12	-	96	120	120	1.0000000
A09	15227959	15228730	A09p24730.2_BraZ1	699	-	601	771	771	1.0000000
A09	15240222	15242009	A09p24740.2_BraZ1	628.898	-	761	1453	1787	0.8130946
A09	15246674	15247271	A09p24750.2_BraZ1	189	+	134	556	597	0.9313233
A09	15247337	15247466	A09p24760.2_BraZ1	12.9	+	122	129	129	1.0000000
A09	15254388	15255456	A09p24770.2_BraZ1	786	-	191	945	1068	0.8848315
A09	15256090	15257523	A09p24780.2_BraZ1	678.9	+	995	1342	1433	0.9364969
A09	15268975	15269209	A09p24790.2_BraZ1	23.4	+	361	234	234	1.0000000
A09	15270873	15272844	A09p24800.2_BraZ1	1407	+	1252	1971	1971	1.0000000
A09	15273657	15275434	A09p24810.2_BraZ1	658.75	-	1069	1777	1777	1.0000000
A09	15276485	15277546	A09p24820.2_BraZ1	584.571	-	755	1061	1061	1.0000000
A09	15284225	15285473	A09p24830.2_BraZ1	576.042	+	615	1225	1248	0.9815705
A09	15285974	15287680	A09p24840.2_BraZ1	912	-	425	1620	1706	0.9495897
A09	15301953	15302691	A09p24850.2_BraZ1	73.8	-	58	501	738	0.6788618
A09	15330987	15332352	A09p24860.2_BraZ1	477	-	141	1119	1365	0.8197802
A09	15333574	15334459	A09p24870.2_BraZ1	88.5	+	209	790	885	0.8926554
A09	15337767	15338598	A09p24880.2_BraZ1	1240	-	151	767	831	0.9229844
A09	15339003	15340771	A09p24890.2_BraZ1	248.64	+	732	1504	1768	0.8506787
A09	15342011	15343674	A09p24900.2_BraZ1	920.522	+	212	1162	1663	0.6987372
A09	15345092	15345334	A09p24910.2_BraZ1	171	+	196	242	242	1.0000000
A09	15345509	15345826	A09p24920.2_BraZ1	213	+	364	317	317	1.0000000
A09	15345885	15346472	A09p24930.2_BraZ1	429	+	553	587	587	1.0000000
A09	15350184	15351269	A09p24940.2_BraZ1	800.682	-	638	1085	1085	1.0000000
A09	15357408	15360317	A09p24950.2_BraZ1	1668.04	-	228	1964	2909	0.6751461
A09	15364158	15365346	A09p24960.2_BraZ1	969	+	481	1077	1188	0.9065657
A09	15366588	15371316	A09p24970.2_BraZ1	2387.89	-	3327	4691	4728	0.9921743
A09	15373623	15373731	A09p24980.2_BraZ1	10.8	+	19	108	108	1.0000000
A09	15376145	15382148	A09p24990.2_BraZ1	3747.51	+	695	4660	6003	0.7762786
A09	15388647	15394597	A09p25000.2_BraZ1	3648	+	1006	5046	5950	0.8480672
A09	15395479	15396219	A09p25010.2_BraZ1	648	-	196	711	740	0.9608108
A09	15398091	15399151	A09p25020.2_BraZ1	94.8	+	194	1026	1060	0.9679245
A09	15399525	15401715	A09p25030.2_BraZ1	1149.54	-	1199	1906	2190	0.8703197
A09	15404526	15405027	A09p25040.2_BraZ1	50.1	-	39	445	501	0.8882235
A09	15405109	15405361	A09p25050.2_BraZ1	25.2	-	9	228	252	0.9047619
A09	15407959	15412269	A09p25060.2_BraZ1	9315	-	1864	3179	4310	0.7375870
A09	15409999	15411321	A09p25070.2_BraZ1	69.3	-	1023	1322	1322	1.0000000
A09	15414143	15417788	A09p25080.2_BraZ1	15177.6	-	2322	3579	3645	0.9818930
A09	15423609	15424171	A09p25090.2_BraZ1	480	-	632	562	562	1.0000000
A09	15427490	15428045	A09p25100.2_BraZ1	55.5	+	249	555	555	1.0000000
A09	15428349	15430030	A09p25110.2_BraZ1	857.486	-	985	1681	1681	1.0000000
A09	15431843	15432538	A09p25120.2_BraZ1	645	+	438	695	695	1.0000000
A09	15432761	15434001	A09p25130.2_BraZ1	1035	-	400	1203	1240	0.9701613
A09	15436285	15438536	A09p25140.2_BraZ1	1023.67	+	821	2058	2251	0.9142603
A09	15441012	15442860	A09p25150.2_BraZ1	947.725	-	658	1728	1848	0.9350649
A09	15447496	15449332	A09p25160.2_BraZ1	868.009	-	519	1726	1836	0.9400871
A09	15451070	15452702	A09p25170.2_BraZ1	510	-	1845	1632	1632	1.0000000
A09	15453415	15453598	A09p25180.2_BraZ1	18.3	-	113	183	183	1.0000000
A09	15462724	15463018	A09p25190.2_BraZ1	29.4	+	114	227	294	0.7721089
A09	15463854	15464298	A09p25200.2_BraZ1	44.4	+	128	444	444	1.0000000
A09	15465447	15471937	A09p25210.2_BraZ1	5103	-	847	3935	6490	0.6063174
A09	15483719	15485737	A09p25220.2_BraZ1	1926	+	672	1975	2018	0.9786918
A09	15488119	15489378	A09p25230.2_BraZ1	708.171	-	187	1178	1259	0.9356632
A09	15490422	15490884	A09p25240.2_BraZ1	46.2	-	50	399	462	0.8636364
A09	15495321	15498125	A09p25250.2_BraZ1	1500.05	-	438	1687	2804	0.6016405
A09	15502414	15504983	A09p25260.2_BraZ1	351	-	1697	2423	2569	0.9431685
A09	15519060	15520333	A09p25270.2_BraZ1	624.273	+	177	1122	1273	0.8813826
A09	15522507	15522687	A09p25280.2_BraZ1	18	+	62	152	180	0.8444445
A09	15523877	15525029	A09p25290.2_BraZ1	115.2	-	1126	1122	1152	0.9739583
A09	15526929	15527349	A09p25300.2_BraZ1	42	-	89	418	420	0.9952381
A09	15529886	15530321	A09p25310.2_BraZ1	43.5	-	117	435	435	1.0000000
A09	15543516	15544057	A09p25320.2_BraZ1	437.4	+	0	0	541	0.0000000
A09	15550026	15552587	A09p25330.2_BraZ1	1423.43	-	1611	2560	2561	0.9996095
A09	15557236	15559006	A09p25340.2_BraZ1	274.934	+	189	1540	1770	0.8700565
A09	15568093	15569447	A09p25350.2_BraZ1	770.783	-	117	605	1354	0.4468242
A09	15576849	15577167	A09p25360.2_BraZ1	31.8	-	15	296	318	0.9308176
A09	15578084	15578645	A09p25370.2_BraZ1	480	-	402	561	561	1.0000000
A09	15578741	15584182	A09p25380.2_BraZ1	393.75	-	4291	5441	5441	1.0000000
A09	15598248	15598928	A09p25390.2_BraZ1	459	+	412	609	680	0.8955882
A09	15607668	15608529	A09p25400.2_BraZ1	543	-	80	710	861	0.8246225
A09	15609845	15610332	A09p25410.2_BraZ1	405	+	103	260	487	0.5338809
A09	15619185	15619550	A09p25420.2_BraZ1	198	+	146	365	365	1.0000000
A09	15620057	15620192	A09p25430.2_BraZ1	13.5	+	82	135	135	1.0000000
A09	15622208	15622542	A09p25440.2_BraZ1	135	+	569	334	334	1.0000000
A09	15629855	15631595	A09p25450.2_BraZ1	174	-	222	1180	1740	0.6781609
A09	15633641	15634683	A09p25460.2_BraZ1	570	-	0	0	1042	0.0000000
A09	15653277	15653856	A09p25470.2_BraZ1	57.9	-	85	408	579	0.7046632
A09	15655648	15655974	A09p25480.2_BraZ1	228	+	470	326	326	1.0000000
A09	15657377	15658061	A09p25490.2_BraZ1	374.192	-	730	630	684	0.9210526
A09	15659604	15659852	A09p25500.2_BraZ1	15.3	+	322	248	248	1.0000000
A09	15664537	15668233	A09p25510.2_BraZ1	1722.24	+	3217	3467	3696	0.9380412
A09	15669053	15669792	A09p25520.2_BraZ1	424.286	+	564	739	739	1.0000000
A09	15677546	15678161	A09p25530.2_BraZ1	61.5	-	89	542	615	0.8813008
A09	15680212	15680920	A09p25540.2_BraZ1	1656	-	1	62	708	0.0875706
A09	15687133	15691429	A09p25550.2_BraZ1	1999.97	-	1274	3933	4296	0.9155028
A09	15696176	15697896	A09p25560.2_BraZ1	258.667	-	3330	1719	1720	0.9994186
A09	15696350	15696782	A09p25570.2_BraZ1	303	-	547	431	432	0.9976852
A09	15699988	15701398	A09p25580.2_BraZ1	1068.26	-	366	1316	1410	0.9333333
A09	15702366	15704043	A09p25590.2_BraZ1	167.7	-	289	1657	1677	0.9880739
A09	15730570	15731213	A09p25600.2_BraZ1	378.611	-	139	607	643	0.9440125
A09	15745644	15746386	A09p25610.2_BraZ1	336	-	659	742	742	1.0000000
A09	15749079	15751336	A09p25620.2_BraZ1	1319.32	+	504	1620	2257	0.7177669
A09	15762661	15762820	A09p25630.2_BraZ1	15.9	-	319	159	159	1.0000000
A09	15780303	15783169	A09p25640.2_BraZ1	3200	-	896	2667	2866	0.9305652
A09	15790141	15796027	A09p25650.2_BraZ1	3274.09	+	770	2809	5886	0.4772341
A09	15797374	15799758	A09p25660.2_BraZ1	1447.53	-	235	1726	2384	0.7239933
A09	15803524	15805073	A09p25670.2_BraZ1	402	-	1539	1549	1549	1.0000000
A09	15806411	15809233	A09p25680.2_BraZ1	1255.19	+	639	1871	2822	0.6630049
A09	15813563	15816556	A09p25690.2_BraZ1	1513.37	+	210	1466	2993	0.4898095
A09	15817275	15817668	A09p25700.2_BraZ1	39.3	+	77	382	393	0.9720102
A09	15819841	15821186	A09p25710.2_BraZ1	119.1	-	0	0	1345	0.0000000
A09	15831311	15833279	A09p25720.2_BraZ1	606.48	+	617	1951	1968	0.9913618
A09	15866729	15866891	A09p25730.2_BraZ1	16.2	+	231	162	162	1.0000000
A09	15869754	15873432	A09p25740.2_BraZ1	1980.71	+	298	2687	3678	0.7305601
A09	15884016	15884229	A09p25750.2_BraZ1	21.3	-	5	146	213	0.6854460
A09	15901676	15904564	A09p25760.2_BraZ1	654.545	-	108	1362	2888	0.4716066
A09	15904922	15905378	A09p25770.2_BraZ1	45.6	-	22	369	456	0.8092105
A09	15915773	15916644	A09p25780.2_BraZ1	654	-	832	871	871	1.0000000
A09	15924521	15928212	A09p25790.2_BraZ1	2194.2	+	1429	3640	3691	0.9861826
A09	15932849	15933421	A09p25800.2_BraZ1	234	+	398	572	572	1.0000000
A09	15942483	15942678	A09p25810.2_BraZ1	19.5	-	4	69	195	0.3538462
A09	15942789	15943031	A09p25820.2_BraZ1	19.5	+	17	6	242	0.0247934
A09	15946641	15949733	A09p25830.2_BraZ1	1157.33	-	1746	3060	3092	0.9896507
A09	15950222	15950681	A09p25840.2_BraZ1	45.9	-	411	459	459	1.0000000
A09	15951505	15952115	A09p25850.2_BraZ1	252	-	494	610	610	1.0000000
A09	15954476	15956488	A09p25860.2_BraZ1	909	+	542	1979	2012	0.9835984
A09	15965679	15967251	A09p25870.2_BraZ1	680.126	+	1200	1572	1572	1.0000000
A09	15967846	15968227	A09p25880.2_BraZ1	204	+	368	381	381	1.0000000
A09	15978747	15980740	A09p25890.2_BraZ1	472.267	-	426	1494	1993	0.7496237
A09	15989615	15996327	A09p25900.2_BraZ1	1175.87	+	560	3890	6712	0.5795590
A09	16009397	16011568	A09p25910.2_BraZ1	668.182	+	643	1403	2171	0.6462460
A09	16014833	16015088	A09p25920.2_BraZ1	25.5	+	89	255	255	1.0000000
A09	16015406	16016604	A09p25930.2_BraZ1	1159.2	+	320	1198	1198	1.0000000
A09	16022087	16023078	A09p25940.2_BraZ1	82.5	-	323	989	991	0.9979818
A09	16023255	16023912	A09p25950.2_BraZ1	333	+	127	644	657	0.9802131
A09	16026732	16028457	A09p25960.2_BraZ1	1380	+	113	710	1725	0.4115942
A09	16028758	16033245	A09p25970.2_BraZ1	1548.87	-	1390	4332	4487	0.9654558
A09	16033781	16034634	A09p25980.2_BraZ1	5866.59	+	801	853	853	1.0000000
A09	16037928	16039929	A09p25990.2_BraZ1	1642.08	+	401	1526	2001	0.7626187
A09	16046558	16048054	A09p26000.2_BraZ1	803.4	-	379	1460	1496	0.9759358
A09	16060169	16061498	A09p26010.2_BraZ1	132.9	+	330	1069	1329	0.8043642
A09	16068374	16069649	A09p26020.2_BraZ1	127.5	-	64	926	1275	0.7262745
A09	16077489	16078013	A09p26030.2_BraZ1	3697.5	-	222	500	524	0.9541985
A09	16078930	16079453	A09p26040.2_BraZ1	399	-	310	523	523	1.0000000
A09	16079501	16082336	A09p26050.2_BraZ1	826.8	+	1345	2770	2835	0.9770723
A09	16083974	16086597	A09p26060.2_BraZ1	1388.31	+	1143	2596	2623	0.9897065
A09	16088025	16090254	A09p26070.2_BraZ1	969.08	+	1040	2065	2229	0.9264244
A09	16090811	16091998	A09p26080.2_BraZ1	1665	-	368	1081	1187	0.9106992
A09	16093912	16100276	A09p26090.2_BraZ1	3369.63	+	1115	3637	6364	0.5714959
A09	16100738	16101224	A09p26100.2_BraZ1	390	+	2	20	486	0.0411523
A09	16106188	16108048	A09p26110.2_BraZ1	874.125	-	82	886	1860	0.4763441
A09	16112509	16116619	A09p26120.2_BraZ1	218.4	+	548	4045	4110	0.9841849
A09	16117648	16117921	A09p26130.2_BraZ1	27.3	+	149	273	273	1.0000000
A09	16118417	16123425	A09p26140.2_BraZ1	162.6	+	812	4799	5008	0.9582668
A09	16124605	16125417	A09p26150.2_BraZ1	1116	-	57	611	812	0.7524630
A09	16126243	16127509	A09p26160.2_BraZ1	723	-	106	1266	1266	1.0000000
A09	16129886	16130366	A09p26170.2_BraZ1	48	+	332	480	480	1.0000000
A09	16132861	16134229	A09p26180.2_BraZ1	136.8	-	63	672	1368	0.4912281
A09	16137296	16148127	A09p26190.2_BraZ1	234	-	3432	9602	10831	0.8865294
A09	16142924	16143686	A09p26200.2_BraZ1	624	-	40	600	762	0.7874016
A09	16152004	16174887	A09p26210.2_BraZ1	2977.63	-	20125	22377	22883	0.9778875
A09	16157710	16158412	A09p26220.2_BraZ1	582	-	1311	702	702	1.0000000
A09	16165791	16166411	A09p26230.2_BraZ1	378	+	2310	620	620	1.0000000
A09	16194159	16201843	A09p26240.2_BraZ1	2015.13	-	3905	5776	7684	0.7516918
A09	16217320	16219491	A09p26250.2_BraZ1	1932	+	952	1890	2171	0.8705665
A09	16236242	16236978	A09p26260.2_BraZ1	475.875	-	0	0	736	0.0000000
A09	16238279	16239504	A09p26270.2_BraZ1	654.107	-	1247	1225	1225	1.0000000
A09	16257619	16259584	A09p26280.2_BraZ1	1099.13	-	1377	1880	1965	0.9567430
A09	16260433	16260622	A09p26290.2_BraZ1	18.9	-	271	189	189	1.0000000
A09	16263451	16264125	A09p26300.2_BraZ1	369.692	-	45	309	674	0.4584570
A09	16264554	16264975	A09p26310.2_BraZ1	300	-	3	56	421	0.1330166
A09	16268754	16269744	A09p26320.2_BraZ1	99	+	893	990	990	1.0000000
A09	16270863	16272577	A09p26330.2_BraZ1	1362	-	56	1001	1714	0.5840140
A09	16279081	16279249	A09p26340.2_BraZ1	16.8	+	181	168	168	1.0000000
A09	16279278	16279690	A09p26350.2_BraZ1	300	+	359	403	412	0.9781553
A09	16280340	16284125	A09p26360.2_BraZ1	1488.5	-	1156	3673	3785	0.9704095
A09	16284179	16284559	A09p26370.2_BraZ1	159	-	26	340	380	0.8947368
A09	16285339	16290274	A09p26380.2_BraZ1	1035	+	2362	4791	4935	0.9708207
A09	16290378	16291164	A09p26390.2_BraZ1	491.111	-	212	701	786	0.8918575
A09	16291500	16292763	A09p26400.2_BraZ1	1220	-	344	1241	1263	0.9825811
A09	16295961	16296207	A09p26410.2_BraZ1	24.6	+	138	246	246	1.0000000
A09	16301090	16304029	A09p26420.2_BraZ1	1764.2	+	549	2322	2939	0.7900646
A09	16304932	16306949	A09p26430.2_BraZ1	992.268	+	1787	1968	2017	0.9757065
A09	16308263	16310297	A09p26440.2_BraZ1	1074.43	+	261	1098	2034	0.5398230
A09	16312921	16316305	A09p26450.2_BraZ1	1139.05	+	504	2569	3384	0.7591608
A09	16316403	16317141	A09p26460.2_BraZ1	408	+	59	567	738	0.7682927
A09	16319428	16320315	A09p26470.2_BraZ1	262.731	+	3	15	887	0.0169109
A09	16322970	16323108	A09p26480.2_BraZ1	13.8	+	272	138	138	1.0000000
A09	16323327	16330096	A09p26490.2_BraZ1	105	+	95642	6769	6769	1.0000000
A09	16330145	16340163	A09p26500.2_BraZ1	333.703	+	2330	7871	10018	0.7856858
A09	16336176	16342604	A09p26510.2_BraZ1	1509.38	+	1740	4971	6428	0.7733354
A09	16343496	16343932	A09p26520.2_BraZ1	366	+	254	436	436	1.0000000
A09	16344286	16344921	A09p26530.2_BraZ1	213	-	691	635	635	1.0000000
A09	16351806	16352124	A09p26540.2_BraZ1	31.8	-	420	318	318	1.0000000
A09	16351945	16352230	A09p26550.2_BraZ1	108.333	+	395	285	285	1.0000000
A09	16357154	16358061	A09p26560.2_BraZ1	270	+	566	907	907	1.0000000
A09	16359175	16361321	A09p26570.2_BraZ1	587.647	+	448	1753	2146	0.8168686
A09	16361891	16363239	A09p26580.2_BraZ1	683.114	+	949	1262	1348	0.9362018
A09	16367760	16368732	A09p26590.2_BraZ1	97.2	-	350	972	972	1.0000000
A09	16378634	16379612	A09p26600.2_BraZ1	97.8	-	467	960	978	0.9815951
A09	16382304	16383276	A09p26610.2_BraZ1	97.2	-	408	972	972	1.0000000
A09	16384441	16385053	A09p26620.2_BraZ1	61.2	+	294	612	612	1.0000000
A09	16401956	16402700	A09p26630.2_BraZ1	57.3	-	157	588	744	0.7903226
A09	16415309	16416029	A09p26640.2_BraZ1	480	+	603	720	720	1.0000000
A09	16416158	16417739	A09p26650.2_BraZ1	612	+	1132	1581	1581	1.0000000
A09	16423909	16424362	A09p26660.2_BraZ1	45.3	+	230	409	453	0.9028698
A09	16427737	16428715	A09p26670.2_BraZ1	97.2	-	47	791	978	0.8087935
A09	16435614	16435957	A09p26680.2_BraZ1	195	+	4	249	343	0.7259475
A09	16440206	16440489	A09p26690.2_BraZ1	24.9	+	353	283	283	1.0000000
A09	16440932	16441295	A09p26700.2_BraZ1	36.3	+	441	363	363	1.0000000
A09	16443698	16446883	A09p26710.2_BraZ1	1160.84	-	1060	3029	3185	0.9510204
A09	16448473	16449513	A09p26720.2_BraZ1	38.7	-	1400	1040	1040	1.0000000
A09	16453199	16453971	A09p26730.2_BraZ1	63.3	+	379	772	772	1.0000000
A09	16455387	16457013	A09p26740.2_BraZ1	880.875	-	7	404	1626	0.2484625
A09	16462161	16463146	A09p26750.2_BraZ1	363	+	44	511	985	0.5187817
A09	16478166	16481032	A09p26760.2_BraZ1	957.879	+	1638	2525	2866	0.8810188
A09	16481292	16481602	A09p26770.2_BraZ1	117	+	207	310	310	1.0000000
A09	16496444	16496579	A09p26780.2_BraZ1	13.5	+	111	135	135	1.0000000
A09	16497534	16497952	A09p26790.2_BraZ1	150	+	371	418	418	1.0000000
A09	16498094	16498397	A09p26800.2_BraZ1	135	+	311	303	303	1.0000000
A09	16502561	16504463	A09p26810.2_BraZ1	1098	+	82	693	1902	0.3643533
A09	16505083	16508886	A09p26820.2_BraZ1	2517.07	+	847	2864	3803	0.7530897
A09	16522303	16522461	A09p26830.2_BraZ1	15.3	-	37	158	158	1.0000000
A09	16542549	16543803	A09p26840.2_BraZ1	534	+	35	610	1254	0.4864434
A09	16547108	16547675	A09p26850.2_BraZ1	417.562	+	6	329	567	0.5802469
A09	16549846	16550189	A09p26860.2_BraZ1	237	-	48	39	343	0.1137026
A09	16554649	16556745	A09p26870.2_BraZ1	417	+	1702	1159	2096	0.5529580
A09	16555467	16556447	A09p26880.2_BraZ1	159.375	+	1487	680	980	0.6938776
A09	16559072	16559496	A09p26890.2_BraZ1	37.2	-	0	0	424	0.0000000
A09	16566073	16569409	A09p26900.2_BraZ1	636	-	621	2023	3336	0.6064149
A09	16578138	16578898	A09p26910.2_BraZ1	168	+	138	662	760	0.8710526
A09	16578986	16579262	A09p26920.2_BraZ1	147	+	7	167	276	0.6050724
A09	16579491	16580570	A09p26930.2_BraZ1	396	+	60	90	1079	0.0834106
A09	16585346	16585725	A09p26940.2_BraZ1	207	-	0	0	379	0.0000000
A09	16590558	16592942	A09p26950.2_BraZ1	742.4	-	205	1930	2384	0.8095638
A09	16593693	16596108	A09p26960.2_BraZ1	1020.18	-	107	1375	2415	0.5693582
A09	16603110	16603661	A09p26970.2_BraZ1	396	+	1	37	551	0.0671506
A09	16615876	16616285	A09p26980.2_BraZ1	228	-	308	409	409	1.0000000
A09	16620608	16621205	A09p26990.2_BraZ1	135	-	37	524	597	0.8777220
A09	16630186	16631184	A09p27000.2_BraZ1	915	+	74	906	998	0.9078156
A09	16638546	16639032	A09p27010.2_BraZ1	48.6	+	42	301	486	0.6193416
A09	16640223	16642503	A09p27020.2_BraZ1	1259.91	-	756	2070	2280	0.9078947
A09	16642950	16645426	A09p27030.2_BraZ1	1412.03	+	776	2146	2476	0.8667205
A09	16645840	16646135	A09p27040.2_BraZ1	16.2	-	129	295	295	1.0000000
A09	16652216	16652339	A09p27050.2_BraZ1	12.3	-	22	123	123	1.0000000
A09	16657318	16657471	A09p27060.2_BraZ1	15.3	-	13	129	153	0.8431373
A09	16661099	16661883	A09p27070.2_BraZ1	276	+	810	784	784	1.0000000
A09	16664323	16665184	A09p27080.2_BraZ1	762	+	12	252	861	0.2926829
A09	16669441	16670947	A09p27090.2_BraZ1	465	-	296	1455	1506	0.9661354
A09	16674190	16675049	A09p27100.2_BraZ1	762	+	158	544	859	0.6332945
A09	16683690	16685829	A09p27110.2_BraZ1	915.45	+	181	1095	2139	0.5119215
A09	16703862	16704572	A09p27120.2_BraZ1	129	-	135	700	710	0.9859155
A09	16710013	16710754	A09p27130.2_BraZ1	179.833	+	472	741	741	1.0000000
A09	16714810	16718080	A09p27140.2_BraZ1	505.08	-	2445	3156	3270	0.9651376
A09	16718771	16721952	A09p27150.2_BraZ1	636.343	-	2581	3086	3181	0.9701352
A09	16722080	16726720	A09p27160.2_BraZ1	2320.44	-	550	3438	4640	0.7409483
A09	16727057	16728949	A09p27170.2_BraZ1	1355.29	+	199	1380	1892	0.7293869
A09	16729550	16729916	A09p27180.2_BraZ1	36.6	-	13	202	366	0.5519125
A09	16737095	16738208	A09p27190.2_BraZ1	840	-	629	1045	1113	0.9389039
A09	16739005	16740724	A09p27200.2_BraZ1	415.029	+	0	0	1719	0.0000000
A09	16743871	16744937	A09p27210.2_BraZ1	659.077	+	557	1037	1066	0.9727955
A09	16747018	16748261	A09p27220.2_BraZ1	1167	-	320	952	1243	0.7658890
A09	16749050	16750280	A09p27230.2_BraZ1	784.385	+	735	1230	1230	1.0000000
A09	16750578	16751958	A09p27240.2_BraZ1	138	+	131	1195	1380	0.8659420
A09	16753798	16756674	A09p27250.2_BraZ1	1368	+	696	2058	2876	0.7155772
A09	16758118	16760223	A09p27260.2_BraZ1	1197	+	485	1947	2105	0.9249406
A09	16761239	16761596	A09p27270.2_BraZ1	35.7	+	0	0	357	0.0000000
A09	16782080	16783691	A09p27280.2_BraZ1	161.1	+	5	114	1611	0.0707635
A09	16789404	16790253	A09p27290.2_BraZ1	39	+	915	849	849	1.0000000
A09	16791455	16791626	A09p27300.2_BraZ1	17.1	-	224	171	171	1.0000000
A09	16795405	16796478	A09p27310.2_BraZ1	505.875	-	525	1025	1073	0.9552656
A09	16796389	16798456	A09p27320.2_BraZ1	590.45	-	1189	2067	2067	1.0000000
A09	16799488	16802252	A09p27330.2_BraZ1	210	-	2251	1935	2764	0.7000723
A09	16809246	16812299	A09p27340.2_BraZ1	1097.17	-	0	0	3053	0.0000000
A09	16821912	16822216	A09p27350.2_BraZ1	285	+	29	304	304	1.0000000
A09	16827192	16830243	A09p27360.2_BraZ1	1160.78	-	6	288	3051	0.0943953
A09	16839345	16839649	A09p27370.2_BraZ1	285	+	35	300	304	0.9868421
A09	16844631	16847682	A09p27380.2_BraZ1	1068.92	-	0	0	3051	0.0000000
A09	16858974	16865146	A09p27390.2_BraZ1	1001.02	-	137	894	6172	0.1448477
A09	16869625	16869877	A09p27400.2_BraZ1	25.2	-	331	231	252	0.9166667
A09	16875808	16878586	A09p27410.2_BraZ1	679.5	-	282	1927	2778	0.6936645
A09	16879141	16879532	A09p27420.2_BraZ1	308.077	-	1184	391	391	1.0000000
A09	16879218	16880164	A09p27430.2_BraZ1	114	-	1398	946	946	1.0000000
A09	16884418	16887450	A09p27440.2_BraZ1	1169.13	-	58	1130	3032	0.3726913
A09	16898391	16900038	A09p27450.2_BraZ1	695.625	+	86	712	1647	0.4323012
A09	16900507	16906235	A09p27460.2_BraZ1	2626.92	-	545	2420	5728	0.4224860
A09	16907279	16909304	A09p27470.2_BraZ1	1475.09	+	310	1575	2025	0.7777778
A09	16911203	16911965	A09p27480.2_BraZ1	76.2	-	231	714	762	0.9370078
A09	16913286	16914907	A09p27490.2_BraZ1	920.429	-	230	1265	1621	0.7803825
A09	16917461	16919257	A09p27500.2_BraZ1	1280.12	-	759	1542	1796	0.8585746
A09	16922809	16924560	A09p27510.2_BraZ1	1002.13	+	656	1510	1751	0.8623644
A09	16924918	16925117	A09p27520.2_BraZ1	14.7	-	245	199	199	1.0000000
A09	16932380	16933285	A09p27530.2_BraZ1	203.538	-	160	728	905	0.8044199
A09	16941085	16942213	A09p27540.2_BraZ1	112.8	+	1173	1128	1128	1.0000000
A09	16957473	16958154	A09p27550.2_BraZ1	68.1	-	110	489	681	0.7180617
A09	16960120	16960816	A09p27560.2_BraZ1	69.6	+	7	110	696	0.1580460
A09	16960966	16962968	A09p27570.2_BraZ1	823.68	-	540	1655	2002	0.8266733
A09	16966893	16969661	A09p27580.2_BraZ1	1184.33	+	1455	2520	2768	0.9104046
A09	16970005	16973870	A09p27590.2_BraZ1	2098.34	-	389	2486	3865	0.6432083
A09	16974450	16975938	A09p27600.2_BraZ1	7491	+	361	1057	1488	0.7103494
A09	16977897	16979262	A09p27610.2_BraZ1	838.539	+	143	1097	1365	0.8036630
A09	16980549	16982725	A09p27620.2_BraZ1	1710.45	-	425	1933	2176	0.8883272
A09	16989631	16992079	A09p27630.2_BraZ1	1502.18	-	319	1758	2448	0.7181373
A09	16996847	16998251	A09p27640.2_BraZ1	14388	-	185	731	1404	0.5206553
A09	17006377	17006759	A09p27650.2_BraZ1	286	-	13	333	382	0.8717278
A09	17016533	17018561	A09p27660.2_BraZ1	1242.04	+	39	379	2028	0.1868836
A09	17032290	17034199	A09p27670.2_BraZ1	1180.04	+	119	1035	1909	0.5421687
A09	17058141	17068087	A09p27680.2_BraZ1	1833.17	+	4349	6401	9946	0.6435753
A09	17069871	17070048	A09p27690.2_BraZ1	17.7	+	0	0	177	0.0000000
A09	17070367	17070719	A09p27700.2_BraZ1	564	-	0	0	352	0.0000000
A09	17078057	17078473	A09p27710.2_BraZ1	216	-	219	413	416	0.9927884
A09	17081349	17083964	A09p27720.2_BraZ1	644.898	+	439	1280	2615	0.4894837
A09	17085283	17085937	A09p27730.2_BraZ1	544.333	+	190	654	654	1.0000000
A09	17085761	17086333	A09p27740.2_BraZ1	164	+	26	419	572	0.7325175
A09	17086926	17087260	A09p27750.2_BraZ1	135	+	233	334	334	1.0000000
A09	17089023	17089404	A09p27760.2_BraZ1	409.5	-	458	381	381	1.0000000
A09	17092933	17093320	A09p27770.2_BraZ1	101.25	-	46	387	387	1.0000000
A09	17100170	17101242	A09p27780.2_BraZ1	1789.2	+	69	648	1072	0.6044776
A09	17107581	17107836	A09p27790.2_BraZ1	123	-	0	0	255	0.0000000
A09	17108173	17108335	A09p27800.2_BraZ1	16.2	-	13	132	162	0.8148148
A09	17128587	17129792	A09p27810.2_BraZ1	1064.12	-	6	19	1205	0.0157676
A09	17136963	17139037	A09p27820.2_BraZ1	1010.71	-	236	1571	2074	0.7574735
A09	17145848	17146094	A09p27830.2_BraZ1	24.6	+	109	246	246	1.0000000
A09	17149488	17151172	A09p27840.2_BraZ1	745.286	+	584	1684	1684	1.0000000
A09	17152493	17155979	A09p27850.2_BraZ1	1411.92	-	988	2949	3486	0.8459553
A09	17157715	17158051	A09p27860.2_BraZ1	22.5	+	0	0	336	0.0000000
A09	17158244	17159169	A09p27870.2_BraZ1	247.333	+	0	0	925	0.0000000
A09	17165278	17165954	A09p27880.2_BraZ1	513	-	7	203	676	0.3002959
A09	17167730	17168883	A09p27890.2_BraZ1	988	+	375	1153	1153	1.0000000
A09	17168986	17170277	A09p27900.2_BraZ1	1533.71	+	420	1291	1291	1.0000000
A09	17172949	17173267	A09p27910.2_BraZ1	195	+	62	318	318	1.0000000
A09	17182549	17183210	A09p27920.2_BraZ1	465	-	907	661	661	1.0000000
A09	17184827	17185466	A09p27930.2_BraZ1	63.9	-	158	545	639	0.8528951
A09	17188261	17189406	A09p27940.2_BraZ1	888	-	39	375	1145	0.3275109
A09	17198413	17200435	A09p27950.2_BraZ1	202.2	-	39	269	2022	0.1330366
A09	17218621	17222342	A09p27960.2_BraZ1	2335.34	+	459	2726	3721	0.7325988
A09	17223331	17223781	A09p27970.2_BraZ1	342	-	38	252	450	0.5600000
A09	17225053	17230453	A09p27980.2_BraZ1	5307	-	301	1984	5400	0.3674074
A09	17232678	17234745	A09p27990.2_BraZ1	206.7	-	265	1767	2067	0.8548621
A09	17239734	17241100	A09p28000.2_BraZ1	306.8	+	1104	1248	1366	0.9136164
A09	17241687	17242115	A09p28010.2_BraZ1	345	+	4	90	428	0.2102804
A09	17247342	17249848	A09p28020.2_BraZ1	631.658	-	265	1574	2506	0.6280926
A09	17251600	17251951	A09p28030.2_BraZ1	61.5789	-	0	0	351	0.0000000
A09	17261453	17264928	A09p28040.2_BraZ1	1391.46	+	1701	2942	3475	0.8466187
A09	17267222	17272281	A09p28050.2_BraZ1	396	+	2381	3042	5059	0.6013046
A09	17280333	17282057	A09p28060.2_BraZ1	19.8	+	48	326	1724	0.1890951
A09	17285853	17287383	A09p28070.2_BraZ1	1043.73	+	242	1089	1530	0.7117647
A09	17293238	17294980	A09p28080.2_BraZ1	1008	-	29	570	1742	0.3272101
A09	17296961	17303826	A09p28090.2_BraZ1	3398.4	-	1067	3602	6865	0.5246904
A09	17305172	17305589	A09p28100.2_BraZ1	1071	+	360	417	417	1.0000000
A09	17309198	17314745	A09p28110.2_BraZ1	1989.06	+	572	3570	5547	0.6435911
A09	17318581	17319648	A09p28120.2_BraZ1	428.571	+	155	791	1067	0.7413309
A09	17326084	17327322	A09p28130.2_BraZ1	405	-	283	1132	1238	0.9143780
A09	17327418	17327592	A09p28140.2_BraZ1	15.9	-	58	174	174	1.0000000
A09	17335202	17338777	A09p28150.2_BraZ1	2198.99	+	288	2156	3575	0.6030769
A09	17340600	17343771	A09p28160.2_BraZ1	2096.25	-	137	1604	3171	0.5058341
A09	17352971	17354914	A09p28170.2_BraZ1	914.082	+	527	1278	1943	0.6577458
A09	17359224	17360556	A09p28180.2_BraZ1	425.25	-	0	0	1332	0.0000000
A09	17360902	17361022	A09p28190.2_BraZ1	12	+	1	60	120	0.5000000
A09	17362014	17363785	A09p28200.2_BraZ1	954.312	+	465	1276	1771	0.7204969
A09	17364421	17366216	A09p28210.2_BraZ1	598.5	-	1159	1553	1795	0.8651810
A09	17368047	17372242	A09p28220.2_BraZ1	1996.05	-	563	3538	4195	0.8433850
A09	17381593	17382966	A09p28230.2_BraZ1	36.9	-	577	1344	1373	0.9788784
A09	17383293	17387318	A09p28240.2_BraZ1	2236.3	+	1642	3534	4025	0.8780124
A09	17387624	17388710	A09p28250.2_BraZ1	408.259	-	1210	1019	1086	0.9383057
A09	17390828	17392580	A09p28260.2_BraZ1	16590	+	555	1719	1752	0.9811644
A09	17393254	17396861	A09p28270.2_BraZ1	1331.59	-	189	2074	3607	0.5749931
A09	17401350	17401794	A09p28280.2_BraZ1	44.4	+	386	444	444	1.0000000
A09	17402250	17409120	A09p28290.2_BraZ1	1483.6	+	2374	5457	6870	0.7943231
A09	17410462	17424036	A09p28300.2_BraZ1	1194.67	+	10639	12741	13574	0.9386327
A09	17414634	17415135	A09p28310.2_BraZ1	50.1	+	518	501	501	1.0000000
A09	17426148	17428101	A09p28320.2_BraZ1	443.7	+	7	415	1953	0.2124936
A09	17430395	17431598	A09p28330.2_BraZ1	120.3	-	233	997	1203	0.8287615
A09	17436975	17437572	A09p28340.2_BraZ1	513	+	285	516	597	0.8643216
A09	17438160	17439802	A09p28350.2_BraZ1	1377	-	1141	1642	1642	1.0000000
A09	17448872	17449061	A09p28360.2_BraZ1	18.9	-	47	186	189	0.9841270
A09	17451824	17453069	A09p28370.2_BraZ1	648	+	0	0	1245	0.0000000
A09	17456969	17459011	A09p28380.2_BraZ1	393.435	+	2065	2042	2042	1.0000000
A09	17467339	17468142	A09p28390.2_BraZ1	720	+	152	649	803	0.8082192
A09	17479300	17484464	A09p28400.2_BraZ1	372	-	707	4877	5164	0.9444229
A09	17486013	17486347	A09p28410.2_BraZ1	135	-	644	334	334	1.0000000
A09	17486531	17486904	A09p28420.2_BraZ1	147	-	633	373	373	1.0000000
A09	17488336	17488714	A09p28430.2_BraZ1	246	-	489	378	378	1.0000000
A09	17507940	17511862	A09p28440.2_BraZ1	2834.86	-	2599	3855	3922	0.9829169
A09	17516255	17519020	A09p28450.2_BraZ1	1679.12	-	243	1101	2765	0.3981917
A09	17525155	17525457	A09p28460.2_BraZ1	234	+	522	302	302	1.0000000
A09	17536689	17538124	A09p28470.2_BraZ1	399.3	+	1649	1426	1435	0.9937282
A09	17537294	17537987	A09p28480.2_BraZ1	396	+	443	684	693	0.9870130
A09	17539030	17541013	A09p28490.2_BraZ1	183.6	+	375	1773	1983	0.8940998
A09	17544483	17544837	A09p28500.2_BraZ1	35.4	+	26	258	354	0.7288136
A09	17549673	17550395	A09p28510.2_BraZ1	162	-	244	722	722	1.0000000
A09	17554583	17555366	A09p28520.2_BraZ1	522	+	855	783	783	1.0000000
A09	17557437	17560018	A09p28530.2_BraZ1	2020.93	+	1176	2091	2581	0.8101511
A09	17566093	17569169	A09p28540.2_BraZ1	1177.22	+	1551	3048	3076	0.9908973
A09	17569752	17570380	A09p28550.2_BraZ1	489	-	360	608	628	0.9681529
A09	17572699	17573905	A09p28560.2_BraZ1	120.6	-	218	921	1206	0.7636816
A09	17574583	17575869	A09p28570.2_BraZ1	548.409	+	344	1156	1286	0.8989114
A09	17576083	17578607	A09p28580.2_BraZ1	1457.74	-	187	904	2524	0.3581617
A09	17581118	17583980	A09p28590.2_BraZ1	1565.77	-	290	2214	2862	0.7735849
A09	17592561	17595055	A09p28600.2_BraZ1	262.5	-	0	0	2494	0.0000000
A09	17599166	17602210	A09p28610.2_BraZ1	2812	+	897	2470	3044	0.8114323
A09	17607330	17607898	A09p28620.2_BraZ1	486	+	458	568	568	1.0000000
A09	17611072	17611219	A09p28630.2_BraZ1	14.7	+	20	131	147	0.8911564
A09	17626273	17627390	A09p28640.2_BraZ1	558.409	+	35	467	1117	0.4180841
A09	17627584	17628505	A09p28650.2_BraZ1	390	-	386	898	921	0.9750271
A09	17628793	17629206	A09p28660.2_BraZ1	276	+	252	413	413	1.0000000
A09	17629598	17630760	A09p28670.2_BraZ1	680.2	-	220	1070	1162	0.9208261
A09	17630757	17632880	A09p28680.2_BraZ1	411.8	-	393	1734	2123	0.8167687
A09	17636489	17639487	A09p28690.2_BraZ1	1759.5	-	574	2048	2998	0.6831221
A09	17642354	17642961	A09p28700.2_BraZ1	216	-	196	556	607	0.9159802
A09	17644052	17644660	A09p28710.2_BraZ1	405	-	594	608	608	1.0000000
A09	17648066	17648689	A09p28720.2_BraZ1	493.5	-	2	20	623	0.0321027
A09	17656273	17656715	A09p28730.2_BraZ1	363	+	138	316	442	0.7149321
A09	17656828	17658081	A09p28740.2_BraZ1	746.25	+	412	998	1253	0.7964884
A09	17662924	17663227	A09p28750.2_BraZ1	213	-	141	275	303	0.9075907
A09	17667167	17667497	A09p28760.2_BraZ1	234	-	0	0	330	0.0000000
A09	17671197	17671765	A09p28770.2_BraZ1	219	-	186	549	568	0.9665493
A09	17675344	17679205	A09p28780.2_BraZ1	1589.14	-	1433	2612	3861	0.6765087
A09	17688019	17688686	A09p28790.2_BraZ1	900	+	0	0	667	0.0000000
A09	17692252	17693798	A09p28800.2_BraZ1	957	-	553	1320	1546	0.8538163
A09	17698984	17700293	A09p28810.2_BraZ1	582	-	726	866	1309	0.6615737
A09	17701426	17703944	A09p28820.2_BraZ1	737.453	-	1357	2337	2518	0.9281176
A09	17704761	17707028	A09p28830.2_BraZ1	1361.79	+	550	2040	2267	0.8998677
A09	17707774	17710990	A09p28840.2_BraZ1	1472.69	+	2240	3068	3216	0.9539801
A09	17713458	17714773	A09p28850.2_BraZ1	708.923	+	763	1315	1315	1.0000000
A09	17715015	17718248	A09p28860.2_BraZ1	5295.71	-	952	2977	3233	0.9208166
A09	17719377	17721677	A09p28870.2_BraZ1	1196.68	-	549	2252	2300	0.9791304
A09	17727559	17729067	A09p28880.2_BraZ1	255.159	+	1229	1508	1508	1.0000000
A09	17729192	17731011	A09p28890.2_BraZ1	835.556	-	227	1677	1819	0.9219351
A09	17732684	17732945	A09p28900.2_BraZ1	186	+	116	261	261	1.0000000
A09	17735453	17736030	A09p28910.2_BraZ1	608.143	+	315	577	577	1.0000000
A09	17738095	17740528	A09p28920.2_BraZ1	243.3	+	473	892	2433	0.3666256
A09	17749109	17750627	A09p28930.2_BraZ1	1227	-	100	303	1518	0.1996047
A09	17755300	17758097	A09p28940.2_BraZ1	17936.1	+	190	1247	2797	0.4458348
A09	17761365	17762280	A09p28950.2_BraZ1	91.5	+	9	103	915	0.1125683
A09	17772265	17772916	A09p28960.2_BraZ1	534	-	865	651	651	1.0000000
A09	17775721	17777024	A09p28970.2_BraZ1	300.938	+	894	1303	1303	1.0000000
A09	17777351	17777795	A09p28980.2_BraZ1	44.4	+	643	444	444	1.0000000
A09	17781475	17784652	A09p28990.2_BraZ1	1836.41	-	723	2109	3177	0.6638338
A09	17786112	17786529	A09p29000.2_BraZ1	41.7	-	72	359	417	0.8609113
A09	17787741	17790075	A09p29010.2_BraZ1	1387.52	-	628	2209	2334	0.9464439
A09	17790844	17791627	A09p29020.2_BraZ1	555	-	225	783	783	1.0000000
A09	17797727	17799540	A09p29030.2_BraZ1	741	+	945	1709	1813	0.9426365
A09	17809014	17809332	A09p29040.2_BraZ1	31.8	+	120	226	318	0.7106918
A09	17809798	17812718	A09p29050.2_BraZ1	2655	-	650	2438	2920	0.8349315
A09	17819678	17822923	A09p29060.2_BraZ1	264	+	1955	3245	3245	1.0000000
A09	17830955	17831315	A09p29070.2_BraZ1	261	-	9	157	360	0.4361111
A09	17850600	17850990	A09p29080.2_BraZ1	39	-	197	338	390	0.8666667
A09	17855928	17857556	A09p29090.2_BraZ1	1428.24	+	1212	1600	1628	0.9828010
A09	17864952	17865399	A09p29100.2_BraZ1	336	-	321	447	447	1.0000000
A09	17865399	17866083	A09p29110.2_BraZ1	432	-	857	684	684	1.0000000
A09	17873883	17874393	A09p29120.2_BraZ1	51	+	4	196	510	0.3843137
A09	17891737	17900504	A09p29130.2_BraZ1	802.75	-	5784	8761	8767	0.9993156
A09	17909252	17910089	A09p29140.2_BraZ1	83.7	+	10	112	837	0.1338112
A09	17926232	17926598	A09p29150.2_BraZ1	36.6	-	28	77	366	0.2103825
A09	17935030	17935281	A09p29160.2_BraZ1	21.6	-	191	251	251	1.0000000
A09	17944193	17947687	A09p29170.2_BraZ1	1142.31	+	861	2916	3494	0.8345736
A09	17947768	17949086	A09p29180.2_BraZ1	807.5	-	67	975	1318	0.7397572
A09	17952071	17955890	A09p29190.2_BraZ1	288	-	2319	3819	3819	1.0000000
A09	17957310	17957454	A09p29200.2_BraZ1	14.4	-	479	144	144	1.0000000
A09	17965226	17965709	A09p29210.2_BraZ1	48.3	+	16	98	483	0.2028985
A09	17968110	17968653	A09p29220.2_BraZ1	54.3	+	542	543	543	1.0000000
A09	17973543	17974200	A09p29230.2_BraZ1	65.7	-	6	107	657	0.1628615
A09	17977584	17978323	A09p29240.2_BraZ1	505.565	-	369	736	739	0.9959404
A09	17979209	17980945	A09p29250.2_BraZ1	1167	-	1456	1736	1736	1.0000000
A09	17991746	17992274	A09p29260.2_BraZ1	52.8	+	84	454	528	0.8598485
A09	18001021	18001392	A09p29270.2_BraZ1	156	-	402	371	371	1.0000000
A09	18018538	18020647	A09p29280.2_BraZ1	1629	+	290	1359	2109	0.6443812
A09	18037326	18038631	A09p29290.2_BraZ1	130.5	+	188	1081	1305	0.8283525
A09	18048422	18048743	A09p29300.2_BraZ1	138	+	0	0	321	0.0000000
A09	18050450	18053121	A09p29310.2_BraZ1	1308.33	+	599	2209	2671	0.8270311
A09	18053996	18058034	A09p29320.2_BraZ1	1012.5	+	2621	3706	4038	0.9177811
A09	18059708	18061225	A09p29330.2_BraZ1	1135.65	-	258	1296	1517	0.8543177
A09	18063612	18067493	A09p29340.2_BraZ1	889.95	+	2888	3643	3881	0.9386756
A09	18068081	18071550	A09p29350.2_BraZ1	1368.82	-	1699	3325	3469	0.9584895
A09	18072218	18072439	A09p29360.2_BraZ1	19.8	-	326	221	221	1.0000000
A09	18084534	18085666	A09p29370.2_BraZ1	709.943	+	731	1132	1132	1.0000000
A09	18087048	18087372	A09p29380.2_BraZ1	32.4	+	112	324	324	1.0000000
A09	18088255	18088651	A09p29390.2_BraZ1	39.6	+	383	396	396	1.0000000
A09	18095112	18095640	A09p29400.2_BraZ1	52.8	-	102	480	528	0.9090909
A09	18095999	18099996	A09p29410.2_BraZ1	357	+	3421	2962	3997	0.7410558
A09	18112356	18114446	A09p29420.2_BraZ1	870.774	-	36	772	2090	0.3693780
A09	18121814	18122875	A09p29430.2_BraZ1	492	+	135	770	1061	0.7257304
A09	18123220	18132087	A09p29440.2_BraZ1	11131.7	-	1099	6429	8867	0.7250479
A09	18135751	18135904	A09p29450.2_BraZ1	15.3	-	171	153	153	1.0000000
A09	18136610	18141286	A09p29460.2_BraZ1	4219.35	+	1117	3622	4676	0.7745937
A09	18142478	18144407	A09p29470.2_BraZ1	962.5	+	256	1727	1929	0.8952825
A09	18154836	18158673	A09p29480.2_BraZ1	1640.81	+	1059	3144	3837	0.8193902
A09	18158708	18159936	A09p29490.2_BraZ1	527.654	+	991	1228	1228	1.0000000
A09	18162201	18163143	A09p29500.2_BraZ1	94.2	+	8	181	942	0.1921444
A09	18164025	18164918	A09p29510.2_BraZ1	1794	+	54	719	893	0.8051512
A09	18167699	18170258	A09p29520.2_BraZ1	1311.43	+	1191	2325	2559	0.9085580
A09	18176044	18179116	A09p29530.2_BraZ1	593.509	-	2246	2845	3072	0.9261068
A09	18180286	18184256	A09p29540.2_BraZ1	611.696	-	4664	3970	3970	1.0000000
A09	18218430	18218711	A09p29550.2_BraZ1	504	+	183	281	281	1.0000000
A09	18224379	18224557	A09p29560.2_BraZ1	12.9	+	360	178	178	1.0000000
A09	18233748	18237044	A09p29570.2_BraZ1	1857.56	+	1580	3283	3296	0.9960558
A09	18252943	18256237	A09p29580.2_BraZ1	2236.69	+	1130	3025	3294	0.9183364
A09	18258558	18258729	A09p29590.2_BraZ1	17.1	+	407	171	171	1.0000000
A09	18262512	18265398	A09p29600.2_BraZ1	1316.3	+	455	2128	2886	0.7373527
A09	18266296	18269195	A09p29610.2_BraZ1	1870.64	-	422	2334	2899	0.8051052
A09	18274084	18278678	A09p29620.2_BraZ1	2888.4	+	1156	3532	4594	0.7688289
A09	18279033	18281315	A09p29630.2_BraZ1	1156.38	-	547	1626	2282	0.7125329
A09	18282995	18283934	A09p29640.2_BraZ1	840	-	615	858	939	0.9137380
A09	18291252	18292068	A09p29650.2_BraZ1	81.6	-	501	816	816	1.0000000
A09	18299007	18301348	A09p29660.2_BraZ1	1437	-	285	2032	2341	0.8680051
A09	18312061	18312357	A09p29670.2_BraZ1	27.3	+	213	296	296	1.0000000
A09	18315671	18318099	A09p29680.2_BraZ1	1208.89	+	6377	2428	2428	1.0000000
A09	18318072	18318495	A09p29690.2_BraZ1	360	+	352	423	423	1.0000000
A09	18319336	18320120	A09p29700.2_BraZ1	465	+	590	784	784	1.0000000
A09	18324612	18329749	A09p29710.2_BraZ1	300	-	17069	4846	5137	0.9433522
A09	18330252	18332108	A09p29720.2_BraZ1	51.6	-	3376	1813	1856	0.9768319
A09	18332058	18332278	A09p29730.2_BraZ1	141	-	2440	220	220	1.0000000
A09	18333489	18336257	A09p29740.2_BraZ1	162.9	-	11513	2738	2768	0.9891618
A09	18337226	18338396	A09p29750.2_BraZ1	117	+	983	1073	1170	0.9170940
A09	18341017	18343880	A09p29760.2_BraZ1	1390	-	404	2407	2863	0.8407265
A09	18347683	18348387	A09p29770.2_BraZ1	246	+	216	701	704	0.9957386
A09	18349915	18350167	A09p29780.2_BraZ1	25.2	-	206	252	252	1.0000000
A09	18355412	18355804	A09p29790.2_BraZ1	300	+	0	0	392	0.0000000
A09	18360053	18363882	A09p29800.2_BraZ1	2032.62	-	570	2969	3829	0.7753983
A09	18364643	18365176	A09p29810.2_BraZ1	495	+	683	533	533	1.0000000
A09	18365365	18367093	A09p29820.2_BraZ1	172.8	-	146	1452	1728	0.8402778
A09	18368739	18368988	A09p29830.2_BraZ1	24.9	-	186	249	249	1.0000000
A09	18372531	18372672	A09p29840.2_BraZ1	14.1	+	9	121	141	0.8581560
A09	18379943	18382179	A09p29850.2_BraZ1	5016	+	927	2112	2236	0.9445438
A09	18382836	18390559	A09p29860.2_BraZ1	3149.34	+	365	3441	7723	0.4455523
A09	18390698	18391871	A09p29870.2_BraZ1	107.4	-	103	940	1173	0.8013640
A09	18399446	18401680	A09p29880.2_BraZ1	17301	-	996	2145	2234	0.9601611
A09	18406397	18407854	A09p29890.2_BraZ1	607.059	-	704	1418	1457	0.9732327
A09	18414182	18415464	A09p29900.2_BraZ1	526.08	-	165	909	1282	0.7090484
A09	18424188	18424419	A09p29910.2_BraZ1	22.5	+	334	231	231	1.0000000
A09	18429948	18432838	A09p29920.2_BraZ1	5813.8	-	279	2327	2890	0.8051903
A09	18443799	18443994	A09p29930.2_BraZ1	19.5	+	401	195	195	1.0000000
A09	18450461	18451565	A09p29940.2_BraZ1	373.864	-	735	1104	1104	1.0000000
A09	18452166	18452478	A09p29950.2_BraZ1	31.2	+	807	312	312	1.0000000
A09	18454334	18458511	A09p29960.2_BraZ1	2840.8	-	548	2862	4177	0.6851807
A09	18464892	18465972	A09p29970.2_BraZ1	108	-	192	449	1080	0.4157407
A09	18486945	18507944	A09p29980.2_BraZ1	1550.9	+	7472	12421	20999	0.5915043
A09	18510465	18510977	A09p29990.2_BraZ1	216	+	36	175	512	0.3417969
A09	18516406	18518972	A09p30000.2_BraZ1	2218.58	-	2411	2566	2566	1.0000000
A09	18524609	18527273	A09p30010.2_BraZ1	743.364	-	1729	2632	2664	0.9879880
A09	18530004	18532529	A09p30020.2_BraZ1	435	-	433	2205	2525	0.8732674
A09	18532529	18539140	A09p30030.2_BraZ1	1549.8	-	3793	5128	6611	0.7756769
A09	18542086	18546055	A09p30040.2_BraZ1	2730.82	+	382	2095	3969	0.5278408
A09	18547720	18549450	A09p30050.2_BraZ1	769.613	+	333	1566	1730	0.9052023
A09	18549818	18552650	A09p30060.2_BraZ1	1649.29	+	565	2069	2832	0.7305791
A09	18563773	18566224	A09p30070.2_BraZ1	2011.75	+	140	715	2451	0.2917177
A09	18575163	18576304	A09p30080.2_BraZ1	258	-	1357	1141	1141	1.0000000
A09	18601087	18601573	A09p30090.2_BraZ1	327	+	246	486	486	1.0000000
A09	18601580	18601760	A09p30100.2_BraZ1	18	+	74	180	180	1.0000000
A09	18603535	18603685	A09p30110.2_BraZ1	15	+	26	150	150	1.0000000
A09	18607086	18607239	A09p30120.2_BraZ1	15.3	+	408	153	153	1.0000000
A09	18608230	18608572	A09p30130.2_BraZ1	34.2	-	466	342	342	1.0000000
A09	18609862	18610143	A09p30140.2_BraZ1	207	-	8	281	281	1.0000000
A09	18618697	18619102	A09p30150.2_BraZ1	40.5	+	82	405	405	1.0000000
A09	18623077	18623281	A09p30160.2_BraZ1	20.4	-	60	204	204	1.0000000
A09	18646420	18648197	A09p30170.2_BraZ1	8460	-	1887	1219	1777	0.6859876
A09	18654107	18658734	A09p30180.2_BraZ1	2283.18	-	1599	3865	4627	0.8353145
A09	18666857	18667503	A09p30190.2_BraZ1	191.625	+	664	646	646	1.0000000
A09	18675324	18675819	A09p30200.2_BraZ1	49.5	-	14	48	495	0.0969697
A09	18677496	18678624	A09p30210.2_BraZ1	664.4	+	342	1059	1128	0.9388298
A09	18691872	18694721	A09p30220.2_BraZ1	1584.19	-	1197	2124	2849	0.7455248
A09	18709701	18712463	A09p30230.2_BraZ1	377.455	-	1437	2194	2762	0.7943519
A09	18718933	18720016	A09p30240.2_BraZ1	108.3	+	139	940	1083	0.8679594
A09	18721509	18722952	A09p30250.2_BraZ1	952.565	-	197	899	1443	0.6230076
A09	18728525	18730334	A09p30260.2_BraZ1	1509.77	-	525	1533	1809	0.8474295
A09	18738986	18743998	A09p30270.2_BraZ1	4148.18	-	1056	3471	5012	0.6925379
A09	18752157	18752661	A09p30280.2_BraZ1	45.6	-	201	504	504	1.0000000
A09	18762484	18764500	A09p30290.2_BraZ1	1025.18	+	1718	2016	2016	1.0000000
A09	18764913	18766241	A09p30300.2_BraZ1	926.87	-	476	666	1328	0.5015060
A09	18767689	18768175	A09p30310.2_BraZ1	378	-	3	230	486	0.4732510
A09	18772002	18781221	A09p30320.2_BraZ1	1228.86	+	144	2780	9219	0.3015511
A09	18786285	18786399	A09p30330.2_BraZ1	11.4	-	33	114	114	1.0000000
A09	18792620	18793798	A09p30340.2_BraZ1	420	+	282	1129	1178	0.9584041
A09	18810560	18813853	A09p30350.2_BraZ1	1091.22	-	83	1280	3293	0.3887033
A09	18816965	18818150	A09p30360.2_BraZ1	67.5	-	65	527	1185	0.4447258
A09	18822196	18825454	A09p30370.2_BraZ1	1939.48	-	1266	3156	3258	0.9686924
A09	18828869	18847794	A09p30380.2_BraZ1	1962.3	+	8168	16645	18925	0.8795244
A09	18834464	18836394	A09p30390.2_BraZ1	856.95	+	2308	1930	1930	1.0000000
A09	18847939	18848113	A09p30400.2_BraZ1	17.4	+	73	174	174	1.0000000
A09	18855214	18855861	A09p30410.2_BraZ1	426	-	133	549	647	0.8485317
A09	18858565	18858715	A09p30420.2_BraZ1	15	-	8	47	150	0.3133333
A09	18866351	18866625	A09p30430.2_BraZ1	180	+	12	153	274	0.5583941
A09	18870975	18872252	A09p30440.2_BraZ1	584.43	-	634	1277	1277	1.0000000
A09	18872719	18876872	A09p30450.2_BraZ1	3295.83	-	552	2826	4153	0.6804720
A09	18877030	18877181	A09p30460.2_BraZ1	12.3	-	167	151	151	1.0000000
A09	18877579	18877765	A09p30470.2_BraZ1	18.6	+	247	186	186	1.0000000
A09	18883165	18885004	A09p30480.2_BraZ1	1163.76	-	692	1739	1839	0.9456226
A09	18886832	18891191	A09p30490.2_BraZ1	1781.78	-	946	3638	4359	0.8345951
A09	18893050	18893531	A09p30500.2_BraZ1	267	+	498	481	481	1.0000000
A09	18896009	18897048	A09p30510.2_BraZ1	439.875	+	883	1039	1039	1.0000000
A09	18900963	18902593	A09p30520.2_BraZ1	1245.5	+	368	1545	1630	0.9478528
A09	18903077	18905011	A09p30530.2_BraZ1	1252.5	+	790	1922	1934	0.9937952
A09	18905424	18906707	A09p30540.2_BraZ1	619.444	+	656	1283	1283	1.0000000
A09	18907616	18908003	A09p30550.2_BraZ1	228	+	88	371	387	0.9586563
A09	18911216	18913548	A09p30560.2_BraZ1	864	-	1309	2210	2332	0.9476844
A09	18922538	18922712	A09p30570.2_BraZ1	15.3	+	159	174	174	1.0000000
A09	18924493	18925479	A09p30580.2_BraZ1	408	+	1125	969	986	0.9827586
A09	18932092	18935797	A09p30590.2_BraZ1	2001	-	583	3317	3705	0.8952767
A09	18938949	18939343	A09p30600.2_BraZ1	252	+	8	20	394	0.0507614
A09	18939851	18941463	A09p30610.2_BraZ1	9301.5	-	0	0	1612	0.0000000
A09	18951992	18953260	A09p30620.2_BraZ1	653.443	+	863	1158	1268	0.9132492
A09	18953611	18955428	A09p30630.2_BraZ1	23436	-	4	391	1817	0.2151899
A09	18958478	18960316	A09p30640.2_BraZ1	23808	-	421	1271	1838	0.6915125
A09	18964671	18965784	A09p30650.2_BraZ1	788.4	+	521	1076	1113	0.9667565
A09	18966456	18967300	A09p30660.2_BraZ1	300	+	11	160	844	0.1895735
A09	18973319	18973768	A09p30670.2_BraZ1	222	-	52	57	449	0.1269488
A09	18974543	18975085	A09p30680.2_BraZ1	432	-	8	56	542	0.1033210
A09	19002852	19003213	A09p30690.2_BraZ1	201	-	135	282	361	0.7811635
A09	19022704	19025147	A09p30700.2_BraZ1	1004.28	+	231	2058	2443	0.8424069
A09	19034308	19035548	A09p30710.2_BraZ1	1019.52	+	286	1023	1240	0.8250000
A09	19037378	19039232	A09p30720.2_BraZ1	1208.86	+	780	1787	1854	0.9638619
A09	19040086	19041190	A09p30730.2_BraZ1	754.759	+	294	1098	1104	0.9945652
A09	19045113	19045341	A09p30740.2_BraZ1	22.8	-	17	120	228	0.5263158
A09	19046507	19048331	A09p30750.2_BraZ1	672.957	-	276	1417	1824	0.7768641
A09	19053341	19054872	A09p30760.2_BraZ1	637.5	-	271	1100	1531	0.7184846
A09	19060404	19061246	A09p30770.2_BraZ1	885	-	796	842	842	1.0000000
A09	19071748	19072258	A09p30780.2_BraZ1	412.714	-	141	509	510	0.9980392
A09	19079395	19080064	A09p30790.2_BraZ1	245.455	-	50	426	669	0.6367713
A09	19082578	19084000	A09p30800.2_BraZ1	142.2	-	75	746	1422	0.5246132
A09	19089756	19090008	A09p30810.2_BraZ1	25.2	+	18	60	252	0.2380952
A09	19090720	19091094	A09p30820.2_BraZ1	18.9	+	34	340	374	0.9090909
A09	19091727	19092531	A09p30830.2_BraZ1	80.4	-	10	441	804	0.5485075
A09	19100984	19103560	A09p30840.2_BraZ1	385.607	+	0	0	2576	0.0000000
A09	19122790	19125370	A09p30850.2_BraZ1	1129.43	-	0	0	2580	0.0000000
A09	19142088	19143805	A09p30860.2_BraZ1	1179.36	+	412	1582	1717	0.9213745
A09	19144113	19144542	A09p30870.2_BraZ1	42.9	-	6	274	429	0.6386946
A09	19154912	19159266	A09p30880.2_BraZ1	1917.59	+	1556	3015	4354	0.6924667
A09	19161467	19164264	A09p30890.2_BraZ1	2016	+	742	2421	2797	0.8655702
A09	19165199	19166279	A09p30900.2_BraZ1	108	-	61	612	1080	0.5666667
A09	19172678	19176257	A09p30910.2_BraZ1	1537.71	+	697	2992	3579	0.8359877
A09	19178332	19179064	A09p30920.2_BraZ1	65.4	-	69	692	732	0.9453552
A09	19180582	19183625	A09p30930.2_BraZ1	288	+	404	1863	3043	0.6122248
A09	19185620	19187362	A09p30940.2_BraZ1	388.667	-	1215	1619	1742	0.9293915
A09	19195823	19197758	A09p30950.2_BraZ1	193.5	+	635	1860	1935	0.9612403
A09	19198635	19200335	A09p30960.2_BraZ1	1002.08	+	111	1001	1700	0.5888236
A09	19204801	19206772	A09p30970.2_BraZ1	20127.8	-	383	1758	1971	0.8919330
A09	19207694	19207907	A09p30980.2_BraZ1	153	-	560	213	213	1.0000000
A09	19221803	19224533	A09p30990.2_BraZ1	1088	-	1150	2730	2730	1.0000000
A09	19225230	19225533	A09p31000.2_BraZ1	172	-	208	303	303	1.0000000
A09	19225536	19227471	A09p31010.2_BraZ1	1012.5	-	935	1912	1935	0.9881137
A09	19229917	19231623	A09p31020.2_BraZ1	828.945	-	730	1706	1706	1.0000000
A09	19253570	19254105	A09p31030.2_BraZ1	34.5	+	280	535	535	1.0000000
A09	19258738	19259249	A09p31040.2_BraZ1	198	-	358	511	511	1.0000000
A09	19261765	19262377	A09p31050.2_BraZ1	61.2	+	112	416	612	0.6797386
A09	19273079	19274395	A09p31060.2_BraZ1	844.688	-	233	1097	1316	0.8335866
A09	19275346	19276760	A09p31070.2_BraZ1	2196	-	604	1414	1414	1.0000000
A09	19284871	19285161	A09p31080.2_BraZ1	111	+	316	290	290	1.0000000
A09	19286417	19287402	A09p31090.2_BraZ1	639	+	337	985	985	1.0000000
A09	19289804	19291239	A09p31100.2_BraZ1	549	-	226	1074	1435	0.7484320
A09	19297948	19298252	A09p31110.2_BraZ1	19.5	-	189	304	304	1.0000000
A09	19298525	19299173	A09p31120.2_BraZ1	216	-	740	648	648	1.0000000
A09	19300012	19300790	A09p31130.2_BraZ1	630	+	232	778	778	1.0000000
A09	19302567	19304751	A09p31140.2_BraZ1	1813.98	+	37	708	2184	0.3241758
A09	19306103	19306217	A09p31150.2_BraZ1	11.4	-	45	108	114	0.9473684
A09	19306368	19329271	A09p31160.2_BraZ1	811.181	+	41444	21898	22903	0.9561193
A09	19327427	19328101	A09p31170.2_BraZ1	369	+	141	660	674	0.9792285
A09	19329878	19331226	A09p31180.2_BraZ1	846	-	561	1319	1348	0.9784867
A09	19353375	19356679	A09p31190.2_BraZ1	1299.05	-	556	2346	3304	0.7100484
A09	19367478	19368401	A09p31200.2_BraZ1	237.5	-	213	923	923	1.0000000
A09	19387073	19414752	A09p31210.2_BraZ1	164.4	-	32434	26978	27679	0.9746739
A09	19421425	19421899	A09p31220.2_BraZ1	47.4	-	757	474	474	1.0000000
A09	19443249	19443803	A09p31230.2_BraZ1	480	+	16	131	554	0.2364621
A09	19448207	19448652	A09p31240.2_BraZ1	261	+	204	445	445	1.0000000
A09	19454947	19456274	A09p31250.2_BraZ1	3802.67	-	724	1305	1327	0.9834213
A09	19473014	19474441	A09p31260.2_BraZ1	1226.4	-	606	1359	1427	0.9523476
A09	19490153	19490717	A09p31270.2_BraZ1	56.4	+	556	564	564	1.0000000
A09	19496645	19497469	A09p31280.2_BraZ1	492	+	763	819	824	0.9939321
A09	19497802	19500983	A09p31290.2_BraZ1	2186.8	-	1513	2742	3181	0.8619931
A09	19502872	19503572	A09p31300.2_BraZ1	468	-	305	669	700	0.9557143
A09	19526203	19527160	A09p31310.2_BraZ1	780	+	501	957	957	1.0000000
A09	19527543	19529213	A09p31320.2_BraZ1	1242.47	-	676	1360	1670	0.8143712
A09	19529880	19531163	A09p31330.2_BraZ1	688	-	772	1274	1283	0.9929852
A09	19533989	19536410	A09p31340.2_BraZ1	1651.96	+	713	2264	2421	0.9351507
A09	19538991	19539435	A09p31350.2_BraZ1	22.5	+	925	444	444	1.0000000
A09	19541063	19542112	A09p31360.2_BraZ1	333	+	2094	1049	1049	1.0000000
A09	19543801	19544551	A09p31370.2_BraZ1	234	+	320	750	750	1.0000000
A09	19546574	19547228	A09p31380.2_BraZ1	65.4	+	403	654	654	1.0000000
A09	19558275	19558972	A09p31390.2_BraZ1	438	-	1140	697	697	1.0000000
A09	19565682	19566571	A09p31400.2_BraZ1	726	+	353	889	889	1.0000000
A09	19574097	19577603	A09p31410.2_BraZ1	3500.28	+	755	2746	3506	0.7832288
A09	19584277	19588456	A09p31420.2_BraZ1	452.571	+	872	3912	4179	0.9361091
A09	19588700	19591488	A09p31430.2_BraZ1	949.354	-	688	2139	2788	0.7672166
A09	19592326	19593397	A09p31440.2_BraZ1	677.1	-	146	999	1071	0.9327731
A09	19594615	19600045	A09p31450.2_BraZ1	1040.6	-	2846	5342	5430	0.9837937
A09	19603241	19603592	A09p31460.2_BraZ1	35.1	+	11	138	351	0.3931624
A09	19604034	19606281	A09p31470.2_BraZ1	1220.62	-	1763	2247	2247	1.0000000
A09	19619743	19621268	A09p31480.2_BraZ1	848.571	+	461	1491	1525	0.9777049
A09	19629372	19630032	A09p31490.2_BraZ1	396	-	181	271	660	0.4106061
A09	19633364	19635851	A09p31500.2_BraZ1	1041.55	+	142	1635	2487	0.6574185
A09	19653941	19654457	A09p31510.2_BraZ1	666	+	595	475	516	0.9205427
A09	19657176	19659284	A09p31520.2_BraZ1	21352	-	370	1017	2108	0.4824478
A09	19659669	19659858	A09p31530.2_BraZ1	18.9	+	1	110	189	0.5820106
A09	19663873	19665041	A09p31540.2_BraZ1	315	-	152	915	1168	0.7833904
A09	19679895	19681204	A09p31550.2_BraZ1	564	-	526	1253	1309	0.9572192
A09	19698187	19699706	A09p31560.2_BraZ1	1188	-	2054	1316	1519	0.8663595
A09	19701584	19702250	A09p31570.2_BraZ1	270	+	683	666	666	1.0000000
A09	19707539	19711090	A09p31580.2_BraZ1	1381.8	-	1674	3290	3551	0.9264996
A09	19717603	19718292	A09p31590.2_BraZ1	965.25	+	405	689	689	1.0000000
A09	19722628	19724205	A09p31600.2_BraZ1	424.975	-	675	1406	1577	0.8915663
A09	19726304	19726485	A09p31610.2_BraZ1	10.2	-	200	181	181	1.0000000
A09	19730203	19730611	A09p31620.2_BraZ1	24	+	15	361	408	0.8848040
A09	19737142	19737538	A09p31630.2_BraZ1	39.6	-	192	297	396	0.7500000
A09	19737747	19738194	A09p31640.2_BraZ1	44.7	-	0	0	447	0.0000000
A09	19756217	19756565	A09p31650.2_BraZ1	34.8	+	253	348	348	1.0000000
A09	19759524	19761522	A09p31660.2_BraZ1	357	+	2643	1998	1998	1.0000000
A09	19762808	19763172	A09p31670.2_BraZ1	34.8	+	150	364	364	1.0000000
A09	19764043	19766036	A09p31680.2_BraZ1	357	-	906	1874	1993	0.9402910
A09	19767313	19767680	A09p31690.2_BraZ1	34.8	-	43	367	367	1.0000000
A09	19770603	19774261	A09p31700.2_BraZ1	726	-	1049	2602	3658	0.7113177
A09	19775538	19779197	A09p31710.2_BraZ1	726	-	231	2971	3659	0.8119705
A09	19780495	19782490	A09p31720.2_BraZ1	357	-	581	1521	1995	0.7624060
A09	19783788	19785782	A09p31730.2_BraZ1	357	-	872	1994	1994	1.0000000
A09	19787081	19787429	A09p31740.2_BraZ1	34.8	-	84	329	348	0.9454023
A09	19788726	19790720	A09p31750.2_BraZ1	363	-	2510	1994	1994	1.0000000
A09	19792017	19792365	A09p31760.2_BraZ1	34.8	-	417	348	348	1.0000000
A09	19793595	19793962	A09p31770.2_BraZ1	34.8	-	715	367	367	1.0000000
A09	19796316	19796487	A09p31780.2_BraZ1	17.1	+	352	171	171	1.0000000
A09	19797068	19797816	A09p31790.2_BraZ1	180	+	795	743	748	0.9933155
A09	19801495	19803203	A09p31800.2_BraZ1	946.688	+	588	1630	1708	0.9543325
A09	19811755	19813413	A09p31810.2_BraZ1	921.477	+	78	992	1658	0.5983112
A09	19813646	19816595	A09p31820.2_BraZ1	831.448	-	415	1526	2949	0.5174636
A09	19838373	19840949	A09p31830.2_BraZ1	814.125	-	1413	2566	2576	0.9961180
A09	19847070	19848469	A09p31840.2_BraZ1	734.25	-	825	1399	1399	1.0000000
A09	19854856	19855723	A09p31850.2_BraZ1	774	-	28	318	867	0.3667820
A09	19857535	19857827	A09p31860.2_BraZ1	165	-	6	50	292	0.1712329
A09	19864170	19864439	A09p31870.2_BraZ1	165	-	231	269	269	1.0000000
A09	19864722	19865241	A09p31880.2_BraZ1	348	-	300	519	519	1.0000000
A09	19867558	19873190	A09p31890.2_BraZ1	3518.61	-	635	2860	5632	0.5078125
A09	19879674	19882421	A09p31900.2_BraZ1	824	+	6552	2747	2747	1.0000000
A09	19880868	19881368	A09p31910.2_BraZ1	278.667	+	658	500	500	1.0000000
A09	19889844	19890549	A09p31920.2_BraZ1	70.5	-	8	173	705	0.2453901
A09	19893883	19894969	A09p31930.2_BraZ1	492	+	661	1086	1086	1.0000000
A09	19902544	19903260	A09p31940.2_BraZ1	489	-	81	576	716	0.8044693
A09	19909265	19909725	A09p31950.2_BraZ1	30.3	-	272	460	460	1.0000000
A09	19909726	19910325	A09p31960.2_BraZ1	351	-	279	599	599	1.0000000
A09	19914353	19915478	A09p31970.2_BraZ1	516	-	297	1125	1125	1.0000000
A09	19918927	19922451	A09p31980.2_BraZ1	1470.27	+	576	2718	3524	0.7712826
A09	19923751	19924642	A09p31990.2_BraZ1	89.1	+	164	891	891	1.0000000
A09	19924931	19926824	A09p32000.2_BraZ1	92.7	+	185	1649	1893	0.8711041
A09	19926824	19927271	A09p32010.2_BraZ1	180	+	148	445	447	0.9955257
A09	19928035	19928218	A09p32020.2_BraZ1	18.3	-	71	183	183	1.0000000
A09	19937516	19937821	A09p32030.2_BraZ1	222	-	295	279	305	0.9147541
A09	19937887	19940556	A09p32040.2_BraZ1	952.8	-	745	2569	2669	0.9625328
A09	19941322	19942586	A09p32050.2_BraZ1	82.8	+	361	1238	1264	0.9794304
A09	19949168	19950020	A09p32060.2_BraZ1	786	+	45	505	852	0.5927230
A09	19961831	19966309	A09p32070.2_BraZ1	2847.3	-	265	2388	4478	0.5332738
A09	19966964	19967300	A09p32080.2_BraZ1	19.8	-	430	336	336	1.0000000
A09	19968772	19969015	A09p32090.2_BraZ1	24.3	+	343	243	243	1.0000000
A09	19979295	19979712	A09p32100.2_BraZ1	41.7	-	5	72	417	0.1726619
A09	20008589	20010371	A09p32110.2_BraZ1	607.56	+	1384	1782	1782	1.0000000
A09	20016530	20017106	A09p32120.2_BraZ1	2109.75	+	434	576	576	1.0000000
A09	20017638	20020084	A09p32130.2_BraZ1	63	-	1142	2446	2446	1.0000000
A09	20020665	20022011	A09p32140.2_BraZ1	846.56	+	771	1228	1346	0.9123328
A09	20026838	20027124	A09p32150.2_BraZ1	27.3	-	631	286	286	1.0000000
A09	20027875	20028266	A09p32160.2_BraZ1	38.1	+	912	391	391	1.0000000
A09	20032663	20033466	A09p32170.2_BraZ1	375	-	293	803	803	1.0000000
A09	20040482	20042018	A09p32180.2_BraZ1	869.954	+	2658	1536	1536	1.0000000
A09	20054962	20055542	A09p32190.2_BraZ1	276	+	533	580	580	1.0000000
A09	20065431	20067214	A09p32200.2_BraZ1	1491.2	+	3094	1783	1783	1.0000000
A09	20069907	20071610	A09p32210.2_BraZ1	1136.25	-	80	995	1703	0.5842631
A09	20075750	20083296	A09p32220.2_BraZ1	240	+	31382	7507	7546	0.9948317
A09	20083565	20098874	A09p32230.2_BraZ1	5124	+	15694	15148	15309	0.9894833
A09	20085598	20085940	A09p32240.2_BraZ1	34.2	+	189	339	342	0.9912280
A09	20099391	20107365	A09p32250.2_BraZ1	495	-	5004	7974	7974	1.0000000
A09	20108828	20110299	A09p32260.2_BraZ1	171.429	+	311	1316	1471	0.8946295
A09	20128519	20128942	A09p32270.2_BraZ1	204	+	312	423	423	1.0000000
A09	20138238	20138565	A09p32280.2_BraZ1	32.7	+	475	327	327	1.0000000
A09	20139397	20143757	A09p32290.2_BraZ1	7728	-	4801	4360	4360	1.0000000
A09	20150593	20151679	A09p32300.2_BraZ1	108.6	+	726	932	1086	0.8581952
A09	20160770	20161184	A09p32310.2_BraZ1	267	-	860	414	414	1.0000000
A09	20163701	20163971	A09p32320.2_BraZ1	225	-	4	179	270	0.6629630
A09	20166375	20166507	A09p32330.2_BraZ1	13.2	+	16	132	132	1.0000000
A09	20170400	20171215	A09p32340.2_BraZ1	266.757	+	793	815	815	1.0000000
A09	20181446	20181854	A09p32350.2_BraZ1	40.8	-	10	168	408	0.4117647
A09	20184017	20185098	A09p32360.2_BraZ1	50.4	-	676	1081	1081	1.0000000
A09	20185305	20186892	A09p32370.2_BraZ1	248.062	-	649	1573	1587	0.9911783
A09	20186792	20187253	A09p32380.2_BraZ1	69	-	125	447	461	0.9696313
A09	20196397	20197611	A09p32390.2_BraZ1	954	-	732	1214	1214	1.0000000
A09	20204591	20205265	A09p32400.2_BraZ1	654	-	178	631	674	0.9362018
A09	20205337	20205743	A09p32410.2_BraZ1	327	-	333	406	406	1.0000000
A09	20206980	20209632	A09p32420.2_BraZ1	1465.71	+	1102	2652	2652	1.0000000
A09	20210918	20211782	A09p32430.2_BraZ1	42	+	374	864	864	1.0000000
A09	20212453	20214428	A09p32440.2_BraZ1	109.8	-	963	1975	1975	1.0000000
A09	20214395	20217466	A09p32450.2_BraZ1	204.9	-	2620	3028	3071	0.9859980
A09	20217963	20222072	A09p32460.2_BraZ1	148.5	-	1630	4109	4109	1.0000000
A09	20221969	20223402	A09p32470.2_BraZ1	117	-	638	1432	1433	0.9993021
A09	20224772	20225687	A09p32480.2_BraZ1	1617	-	62	626	915	0.6841530
A09	20242906	20245690	A09p32490.2_BraZ1	489	-	1896	2781	2784	0.9989224
A09	20247602	20248826	A09p32500.2_BraZ1	122.4	+	152	590	1224	0.4820261
A09	20256550	20256688	A09p32510.2_BraZ1	13.8	-	194	138	138	1.0000000
A09	20259434	20262000	A09p32520.2_BraZ1	214.2	-	480	2207	2566	0.8600935
A09	20272653	20273706	A09p32530.2_BraZ1	105.3	-	32	171	1053	0.1623932
A09	20300151	20300301	A09p32540.2_BraZ1	15	-	191	150	150	1.0000000
A09	20300947	20301752	A09p32550.2_BraZ1	738	+	602	805	805	1.0000000
A09	20307746	20322467	A09p32560.2_BraZ1	404.25	-	11582	13375	14721	0.9085660
A09	20331337	20334952	A09p32570.2_BraZ1	829.714	+	952	3096	3615	0.8564315
A09	20339015	20342857	A09p32580.2_BraZ1	1017.47	-	2790	3840	3842	0.9994794
A09	20352109	20352397	A09p32590.2_BraZ1	28.8	-	773	288	288	1.0000000
A09	20373528	20373777	A09p32600.2_BraZ1	24.9	+	663	249	249	1.0000000
A09	20375780	20393437	A09p32610.2_BraZ1	468	+	1589	8199	17657	0.4643484
A09	20394043	20398791	A09p32620.2_BraZ1	2931.39	-	10244	4748	4748	1.0000000
A09	20398872	20399534	A09p32630.2_BraZ1	116	-	733	662	662	1.0000000
A09	20399474	20399783	A09p32640.2_BraZ1	134	-	67	309	309	1.0000000
A09	20407511	20408793	A09p32650.2_BraZ1	1110	+	453	700	1282	0.5460218
A09	20411141	20411982	A09p32660.2_BraZ1	249	+	575	841	841	1.0000000
A09	20412040	20414642	A09p32670.2_BraZ1	1620	+	2597	2602	2602	1.0000000
A09	20413231	20414642	A09p32680.2_BraZ1	418.2	+	1183	1411	1411	1.0000000
A09	20414642	20416497	A09p32690.2_BraZ1	408	+	2180	1855	1855	1.0000000
A09	20417446	20418403	A09p32700.2_BraZ1	741	-	1277	957	957	1.0000000
A09	20418460	20419189	A09p32710.2_BraZ1	639	-	1115	729	729	1.0000000
A09	20434879	20436282	A09p32720.2_BraZ1	378	+	494	1312	1403	0.9351390
A09	20452710	20453453	A09p32730.2_BraZ1	48.6	-	5665	743	743	1.0000000
A09	20455243	20480487	A09p32740.2_BraZ1	306	-	70825	23364	25244	0.9255269
A09	20459558	20479101	A09p32750.2_BraZ1	1282.5	+	66780	17671	19543	0.9042112
A09	20482312	20483657	A09p32760.2_BraZ1	601.63	-	246	1004	1345	0.7464684
A09	20484404	20484791	A09p32770.2_BraZ1	27.6	-	254	387	387	1.0000000
A09	20493590	20518389	A09p32780.2_BraZ1	388.8	+	6728	19681	24799	0.7936207
A09	20518605	20518906	A09p32790.2_BraZ1	219	+	235	301	301	1.0000000
A09	20520441	20521102	A09p32800.2_BraZ1	258	-	587	661	661	1.0000000
A09	20535643	20535823	A09p32810.2_BraZ1	18	-	219	180	180	1.0000000
A09	20536341	20537591	A09p32820.2_BraZ1	453	-	627	1250	1250	1.0000000
A09	20581961	20584520	A09p32830.2_BraZ1	144.3	-	78613	2559	2559	1.0000000
A09	20591871	20594428	A09p32840.2_BraZ1	1879.68	-	658	2207	2557	0.8631209
A09	20599679	20602828	A09p32850.2_BraZ1	1360.23	+	671	2864	3149	0.9094951
A09	20607951	20609089	A09p32860.2_BraZ1	567	-	152	1048	1138	0.9209139
A09	20613180	20613834	A09p32870.2_BraZ1	324	-	877	654	654	1.0000000
A09	20634139	20636948	A09p32880.2_BraZ1	1846.18	+	677	2679	2809	0.9537202
A09	20644135	20646345	A09p32890.2_BraZ1	987.71	-	509	1742	2210	0.7882353
A09	20647632	20670484	A09p32900.2_BraZ1	1422.02	+	19364	21121	22852	0.9242517
A09	20673887	20674830	A09p32910.2_BraZ1	471	+	1068	943	943	1.0000000
A09	20694257	20694525	A09p32920.2_BraZ1	162	+	141	268	268	1.0000000
A09	20941292	20944623	A09p32930.2_BraZ1	979.88	-	511	2172	3331	0.6520565
A09	20947673	20967095	A09p32940.2_BraZ1	744	-	13321	19324	19422	0.9949542
A09	20967089	20968658	A09p32950.2_BraZ1	640.714	-	595	1569	1569	1.0000000
A09	20994751	20995094	A09p32960.2_BraZ1	30.9	+	154	343	343	1.0000000
A09	21045789	21046485	A09p32970.2_BraZ1	588	+	349	696	696	1.0000000
A09	21050116	21051238	A09p32980.2_BraZ1	780	-	600	1122	1122	1.0000000
A09	21065246	21065447	A09p32990.2_BraZ1	20.1	+	1806	201	201	1.0000000
A09	21067360	21068184	A09p33000.2_BraZ1	171	+	1318	824	824	1.0000000
A09	21072848	21073698	A09p33010.2_BraZ1	12948	-	1	16	850	0.0188235
A09	21081386	21081699	A09p33020.2_BraZ1	20.4	+	318	313	313	1.0000000
A09	21113069	21117229	A09p33030.2_BraZ1	1046.71	-	1717	3518	4160	0.8456731
A09	21347463	21351616	A09p33040.2_BraZ1	1568.46	-	682	2925	4153	0.7043101
A09	21351688	21359864	A09p33050.2_BraZ1	178.2	-	7703	8146	8176	0.9963307
A09	21361165	21361383	A09p33060.2_BraZ1	120	+	90	218	218	1.0000000
A09	21365018	21365371	A09p33070.2_BraZ1	207	+	1	56	353	0.1586402
A09	21365686	21365863	A09p33080.2_BraZ1	17.7	-	15	111	177	0.6271186
A09	21367347	21369173	A09p33090.2_BraZ1	657	-	1527	1826	1826	1.0000000
A09	21373247	21375918	A09p33100.2_BraZ1	1652.32	+	509	1900	2671	0.7113441
A09	21396074	21397184	A09p33110.2_BraZ1	49.2	+	555	1110	1110	1.0000000
A09	21399825	21400490	A09p33120.2_BraZ1	238.966	+	98	665	665	1.0000000
A09	21405565	21414251	A09p33130.2_BraZ1	288	+	4882	8629	8686	0.9934377
A09	21412811	21415100	A09p33140.2_BraZ1	513	-	2538	2289	2289	1.0000000
A09	21419144	21428511	A09p33150.2_BraZ1	781.479	+	3577	8174	9367	0.8726380
A09	21462685	21465502	A09p33160.2_BraZ1	919.7	-	4690	2817	2817	1.0000000
A09	21470503	21480863	A09p33170.2_BraZ1	314.333	+	96759	10360	10360	1.0000000
A09	21481111	21481899	A09p33180.2_BraZ1	321	+	567	788	788	1.0000000
A09	21482688	21483959	A09p33190.2_BraZ1	210	+	1507	1271	1271	1.0000000
A09	21490347	21492301	A09p33200.2_BraZ1	336	-	1063	1776	1954	0.9089048
A09	21493227	21493524	A09p33210.2_BraZ1	29.7	+	32	297	297	1.0000000
A09	21499025	21500617	A09p33220.2_BraZ1	325.5	-	366	334	1592	0.2097990
A09	21503179	21505438	A09p33230.2_BraZ1	14490	+	124	957	2259	0.4236388
A09	21517943	21518474	A09p33240.2_BraZ1	438	+	127	523	531	0.9849341
A09	21528485	21528951	A09p33250.2_BraZ1	378	-	599	466	466	1.0000000
A09	21530590	21530887	A09p33260.2_BraZ1	29.7	+	95	297	297	1.0000000
A09	21531067	21532600	A09p33270.2_BraZ1	153.3	+	181	1104	1533	0.7201566
A09	21546471	21547517	A09p33280.2_BraZ1	320.333	-	0	0	1046	0.0000000
A09	21555243	21555681	A09p33290.2_BraZ1	201	+	0	0	438	0.0000000
A09	21556335	21558597	A09p33300.2_BraZ1	8176.5	+	169	549	2262	0.2427056
A09	21562078	21562480	A09p33310.2_BraZ1	40.2	-	297	402	402	1.0000000
A09	21562508	21563087	A09p33320.2_BraZ1	486	-	528	579	579	1.0000000
A09	21563532	21565530	A09p33330.2_BraZ1	861.735	+	958	1952	1998	0.9769770
A09	21568173	21568934	A09p33340.2_BraZ1	420	-	1914	761	761	1.0000000
A09	21590245	21591421	A09p33350.2_BraZ1	117.6	+	55	318	1176	0.2704082
A09	21592768	21594419	A09p33360.2_BraZ1	475.2	+	1268	1651	1651	1.0000000
A09	21686022	21686989	A09p33370.2_BraZ1	4032	-	337	967	967	1.0000000
A09	21727877	21728338	A09p33380.2_BraZ1	315	+	269	461	461	1.0000000
A09	21728601	21729489	A09p33390.2_BraZ1	672	+	902	888	888	1.0000000
A09	21854911	21855842	A09p33400.2_BraZ1	432	+	171	884	931	0.9495167
A09	22034190	22040496	A09p33410.2_BraZ1	411	+	2633	6306	6306	1.0000000
A09	22041612	22042528	A09p33420.2_BraZ1	384	-	282	916	916	1.0000000
A09	22058334	22058703	A09p33430.2_BraZ1	225	-	97	369	369	1.0000000
A09	22058403	22059774	A09p33440.2_BraZ1	249	+	317	1370	1371	0.9992706
A09	22059911	22060037	A09p33450.2_BraZ1	12.6	-	30	126	126	1.0000000
A09	22083521	22083852	A09p33460.2_BraZ1	231	+	1396	331	331	1.0000000
A09	22083852	22084273	A09p33470.2_BraZ1	147	-	289	339	421	0.8052257
A09	22085652	22086427	A09p33480.2_BraZ1	456	-	15	291	775	0.3754839
A09	22086342	22087403	A09p33490.2_BraZ1	3237.5	-	29	575	1061	0.5419416
A09	22089631	22090899	A09p33500.2_BraZ1	55.5	+	903	609	1268	0.4802839
A09	22090899	22091680	A09p33510.2_BraZ1	2268	-	5	181	781	0.2317542
A09	22100664	22110202	A09p33520.2_BraZ1	309	-	3703	9538	9538	1.0000000
A09	22110089	22110292	A09p33530.2_BraZ1	104.5	-	133	203	203	1.0000000
A09	22120630	22121758	A09p33540.2_BraZ1	225	-	51	955	1128	0.8466312
A09	22121073	22125225	A09p33550.2_BraZ1	303	-	572	3754	4152	0.9041426
A09	22122849	22123604	A09p33560.2_BraZ1	255	-	130	755	755	1.0000000
A09	22128722	22129213	A09p33570.2_BraZ1	231	-	23	453	491	0.9226069
A09	22128791	22130595	A09p33580.2_BraZ1	168	+	69	1620	1804	0.8980044
A09	22129646	22132361	A09p33590.2_BraZ1	261	-	123	2401	2715	0.8843462
A09	22130558	22131428	A09p33600.2_BraZ1	219	-	42	858	870	0.9862069
A09	22130722	22132544	A09p33610.2_BraZ1	186.375	+	130	1632	1822	0.8957190
A09	22137910	22138521	A09p33620.2_BraZ1	225	-	243	611	611	1.0000000
A09	22138386	22138803	A09p33630.2_BraZ1	231	-	155	417	417	1.0000000
A09	22140002	22140314	A09p33640.2_BraZ1	31.2	-	319	312	312	1.0000000
A09	22158440	22162655	A09p33650.2_BraZ1	399	+	655	4215	4215	1.0000000
A09	22280905	22290056	A09p33660.2_BraZ1	330	+	10374	6067	9151	0.6629876
A09	22292031	22292736	A09p33670.2_BraZ1	171	-	14	444	705	0.6297872
A09	22534732	22535449	A09p33680.2_BraZ1	186	-	88	655	717	0.9135286
A09	22589537	22592965	A09p33690.2_BraZ1	825.6	+	752	3428	3428	1.0000000
A09	22603080	22606268	A09p33700.2_BraZ1	1850.4	-	1776	3173	3188	0.9952949
A09	22607882	22614579	A09p33710.2_BraZ1	201	-	5875	6679	6697	0.9973122
A09	22693319	22697567	A09p33720.2_BraZ1	834	-	2477	4248	4248	1.0000000
A09	22723820	22724450	A09p33730.2_BraZ1	249	-	616	630	630	1.0000000
A09	22723993	22726346	A09p33740.2_BraZ1	285	-	1875	2353	2353	1.0000000
A09	22726180	22726982	A09p33750.2_BraZ1	471	+	599	802	802	1.0000000
A09	22785107	22789518	A09p33760.2_BraZ1	416.167	-	1321	4320	4411	0.9793698
A09	22789428	22790895	A09p33770.2_BraZ1	504	-	750	1403	1467	0.9563736
A09	22795154	22796483	A09p33780.2_BraZ1	303	-	286	1197	1329	0.9006772
A09	22796317	22797119	A09p33790.2_BraZ1	471	+	221	802	802	1.0000000
A09	22813158	22937665	A09p33800.2_BraZ1	1080	-	38879	97134	124507	0.7801489
A09	22884577	22898426	A09p33810.2_BraZ1	465	+	2894	11440	13849	0.8260524
A09	22930898	22938367	A09p33820.2_BraZ1	234	+	3948	7437	7469	0.9957156
A09	22960088	23015816	A09p33830.2_BraZ1	787.35	-	43568	54960	55728	0.9862188
A09	22977155	23007643	A09p33840.2_BraZ1	369	+	22065	30244	30488	0.9919968
A09	23015484	23016473	A09p33850.2_BraZ1	294	-	835	989	989	1.0000000
A09	23015822	23018288	A09p33860.2_BraZ1	432	+	2400	2466	2466	1.0000000
A09	23168890	23170167	A09p33870.2_BraZ1	291	-	1348	1277	1277	1.0000000
A09	23170001	23170800	A09p33880.2_BraZ1	392.5	+	395	788	799	0.9862328
A09	23190415	23202696	A09p33890.2_BraZ1	453	+	11139	12151	12281	0.9894145
A09	23190754	23191754	A09p33900.2_BraZ1	234	+	518	1000	1000	1.0000000
A09	23200557	23201359	A09p33910.2_BraZ1	429	+	589	802	802	1.0000000
A09	23240568	23255066	A09p33920.2_BraZ1	1119.97	-	16732	14487	14498	0.9992413
A09	23250933	23251735	A09p33930.2_BraZ1	429	+	1775	802	802	1.0000000
A09	23267257	23267377	A09p33940.2_BraZ1	12	+	254	120	120	1.0000000
A09	23276432	23277222	A09p33950.2_BraZ1	347.5	+	1969	790	790	1.0000000
A09	23290450	23295264	A09p33960.2_BraZ1	1180.8	-	6278	4814	4814	1.0000000
A09	23291132	23291934	A09p33970.2_BraZ1	357.5	+	1127	802	802	1.0000000
A09	23321136	23321635	A09p33980.2_BraZ1	303	+	678	499	499	1.0000000
A09	23322158	23322425	A09p33990.2_BraZ1	26.7	-	335	267	267	1.0000000
A09	23323559	23324858	A09p34000.2_BraZ1	291	-	1089	1299	1299	1.0000000
A09	23335482	23337604	A09p34010.2_BraZ1	1018.9	-	1948	2122	2122	1.0000000
A09	23342088	23407581	A09p34020.2_BraZ1	1026	-	93859	64926	65493	0.9913426
A09	23364018	23397663	A09p34030.2_BraZ1	396	+	62708	33332	33645	0.9906970
A09	23366774	23370715	A09p34040.2_BraZ1	555	-	2762	3800	3941	0.9642223
A09	23398224	23399590	A09p34050.2_BraZ1	387	+	1340	1366	1366	1.0000000
A09	23407941	23408743	A09p34060.2_BraZ1	471	+	551	802	802	1.0000000
A09	23411672	23465510	A09p34070.2_BraZ1	399	+	70360	53771	53838	0.9987555
A09	23421546	23464126	A09p34080.2_BraZ1	1581	-	56372	42526	42580	0.9987318
A09	23429530	23429919	A09p34090.2_BraZ1	267	-	620	389	389	1.0000000
A09	23440516	23449209	A09p34100.2_BraZ1	453	+	13450	8693	8693	1.0000000
A09	23463567	23464810	A09p34110.2_BraZ1	276	-	1264	1243	1243	1.0000000
A09	23464925	23465315	A09p34120.2_BraZ1	267	-	813	390	390	1.0000000
A09	23473037	23538988	A09p34130.2_BraZ1	970.705	-	70845	65291	65951	0.9899926
A09	23474055	23474857	A09p34140.2_BraZ1	471	+	1111	802	802	1.0000000
A09	23523977	23524367	A09p34150.2_BraZ1	267	-	397	390	390	1.0000000
A09	23551931	23553818	A09p34160.2_BraZ1	420	+	2113	1887	1887	1.0000000
A09	23565926	23566728	A09p34170.2_BraZ1	471	+	1673	802	802	1.0000000
A09	23591920	23592310	A09p34180.2_BraZ1	267	-	206	390	390	1.0000000
A09	23593588	23639547	A09p34190.2_BraZ1	1596	-	32666	45528	45959	0.9906221
A09	23600517	23659584	A09p34200.2_BraZ1	345	+	50259	58374	59067	0.9882675
A09	23601463	23601852	A09p34210.2_BraZ1	267	-	732	389	389	1.0000000
A09	23612752	23613142	A09p34220.2_BraZ1	267	-	367	390	390	1.0000000
A09	23631293	23631683	A09p34230.2_BraZ1	267	-	183	390	390	1.0000000
A09	23641268	23641655	A09p34240.2_BraZ1	264	-	253	387	387	1.0000000
A09	23682398	23713455	A09p34250.2_BraZ1	984.5	-	19100	30535	31057	0.9831922
A09	23721209	23747588	A09p34260.2_BraZ1	493.5	-	25225	25846	26379	0.9797946
A09	23736843	23744323	A09p34270.2_BraZ1	399	+	12438	6972	7480	0.9320856
A09	23752996	23753798	A09p34280.2_BraZ1	471	+	306	802	802	1.0000000
A09	23860067	23860457	A09p34290.2_BraZ1	267	-	324	390	390	1.0000000
A09	23875296	23875688	A09p34300.2_BraZ1	297	-	621	392	392	1.0000000
A09	23944105	23944495	A09p34310.2_BraZ1	267	-	391	390	390	1.0000000
A09	23960692	23963519	A09p34320.2_BraZ1	453	+	8854	2827	2827	1.0000000
A09	23961529	23961920	A09p34330.2_BraZ1	267	-	5574	391	391	1.0000000
A09	23986683	23987069	A09p34340.2_BraZ1	228	-	168	386	386	1.0000000
A09	24104960	24105406	A09p34350.2_BraZ1	330	+	138	446	446	1.0000000
A09	24130909	24131758	A09p34360.2_BraZ1	396	+	159	839	849	0.9882215
A09	24162720	24164144	A09p34370.2_BraZ1	1173.75	+	121	991	1424	0.6959270
A09	24175175	24175605	A09p34380.2_BraZ1	824	+	261	430	430	1.0000000
A09	24176463	24184432	A09p34390.2_BraZ1	468	-	2685	7561	7969	0.9488016
A09	24184782	24185082	A09p34400.2_BraZ1	30	+	305	300	300	1.0000000
A09	24186235	24218087	A09p34410.2_BraZ1	2154.92	-	16845	31852	31852	1.0000000
A09	24257778	24258012	A09p34420.2_BraZ1	189	-	362	234	234	1.0000000
A09	24258012	24263150	A09p34430.2_BraZ1	1599	-	3023	5138	5138	1.0000000
A09	24275057	24275719	A09p34440.2_BraZ1	154	+	388	662	662	1.0000000
A09	24302014	24303265	A09p34450.2_BraZ1	348	-	1136	1251	1251	1.0000000
A09	24328576	24340974	A09p34460.2_BraZ1	960	+	9912	12398	12398	1.0000000
A09	24338959	24342484	A09p34470.2_BraZ1	312	+	3974	3525	3525	1.0000000
A09	24390304	24398327	A09p34480.2_BraZ1	603	-	2149	4549	8023	0.5669949
A09	24391782	24407545	A09p34490.2_BraZ1	802.222	+	1079	5889	15763	0.3735964
A09	24407542	24408653	A09p34500.2_BraZ1	488	+	10	515	1111	0.4635464
A09	24408679	24409546	A09p34510.2_BraZ1	222	+	44	430	867	0.4959631
A09	24409257	24463573	A09p34520.2_BraZ1	1524	-	2333	24824	54316	0.4570292
A09	24413738	24417371	A09p34530.2_BraZ1	921	-	32	1380	3633	0.3798514
A09	24415874	24417195	A09p34540.2_BraZ1	318	+	19	574	1321	0.4345193
A09	24460311	24585113	A09p34550.2_BraZ1	1776.78	+	4866	52714	124802	0.4223810
A09	24585082	24586948	A09p34560.2_BraZ1	840	-	51	1010	1866	0.5412647
A09	24590836	24591136	A09p34570.2_BraZ1	30	+	162	300	300	1.0000000
A09	24594109	24626184	A09p34580.2_BraZ1	177	+	659	12247	32075	0.3818238
A09	24596466	24598064	A09p34590.2_BraZ1	699	+	6	384	1598	0.2403004
A09	24627934	24659885	A09p34600.2_BraZ1	744	+	993	12413	31951	0.3885011
A09	24688850	24692314	A09p34610.2_BraZ1	531	+	24	1185	3464	0.3420901
A09	24693581	24696023	A09p34620.2_BraZ1	975	+	5	356	2442	0.1457821
A09	24704449	24706210	A09p34630.2_BraZ1	804	+	14	703	1761	0.3992050
A09	24747920	24748983	A09p34640.2_BraZ1	552	+	31	801	1063	0.7535278
A09	24761126	24764278	A09p34650.2_BraZ1	561	+	7	370	3152	0.1173858
A09	24763104	24765872	A09p34660.2_BraZ1	330	-	83	1463	2768	0.5285405
A09	24763929	24766305	A09p34670.2_BraZ1	192	+	76	1132	2376	0.4764310
A09	24794707	24805083	A09p34680.2_BraZ1	2306.57	+	748	7854	10376	0.7569391
A09	24799750	24803883	A09p34690.2_BraZ1	258	-	123	2285	4133	0.5528672
A09	24815696	24832323	A09p34700.2_BraZ1	225	-	908	11098	16627	0.6674685
A09	24832983	24870223	A09p34710.2_BraZ1	1407.38	+	1455	20798	37240	0.5584855
A09	24870223	24882116	A09p34720.2_BraZ1	1143	+	334	6386	11893	0.5369545
A09	24902959	24931470	A09p34730.2_BraZ1	1110	-	1285	15668	28511	0.5495423
A09	24964577	24991592	A09p34740.2_BraZ1	972	-	12502	18542	27015	0.6863594
A09	24964662	24978013	A09p34750.2_BraZ1	255	+	10807	9158	13351	0.6859411
A09	25013287	25016426	A09p34760.2_BraZ1	225	+	157	1769	3139	0.5635553
A09	25013328	25016232	A09p34770.2_BraZ1	648	-	157	1769	2904	0.6091598
A09	25015948	25065298	A09p34780.2_BraZ1	259.875	-	915	18822	49350	0.3813982
A09	25035658	25038772	A09p34790.2_BraZ1	267	-	222	2019	3114	0.6483622
A09	25038615	25066004	A09p34800.2_BraZ1	823.333	+	396	11022	27389	0.4024243
A09	25064738	25146047	A09p34810.2_BraZ1	189	+	19640	42279	81309	0.5199794
A09	25105318	25105672	A09p34820.2_BraZ1	120	+	3	289	354	0.8163842
A09	25105672	25106951	A09p34830.2_BraZ1	726.75	-	52	911	1279	0.7122752
A09	25119620	25122664	A09p34840.2_BraZ1	279	-	231	1826	3044	0.5998686
A09	25124561	25137660	A09p34850.2_BraZ1	438	+	415	6050	13099	0.4618673
A09	25128544	25129790	A09p34860.2_BraZ1	165.6	+	149	815	1246	0.6540931
A09	25140357	25141972	A09p34870.2_BraZ1	183	-	5802	1615	1615	1.0000000
A09	25145128	25200626	A09p34880.2_BraZ1	1786.5	-	1118	21347	55498	0.3846445
A09	25149916	25150502	A09p34890.2_BraZ1	52.2	+	14	388	586	0.6621161
A09	25167100	25168963	A09p34900.2_BraZ1	1011	-	2	278	1863	0.1492217
A09	25168742	25170031	A09p34910.2_BraZ1	507	-	4	334	1289	0.2591156
A09	25198134	25199044	A09p34920.2_BraZ1	330	-	84	643	910	0.7065934
A09	25201348	25208018	A09p34930.2_BraZ1	584	+	727	4265	6670	0.6394303
A09	25221703	25254307	A09p34940.2_BraZ1	672	+	397	9746	32604	0.2989204
A09	25261788	25263139	A09p34950.2_BraZ1	249	-	99	749	1351	0.5544041
A09	25264917	25278959	A09p34960.2_BraZ1	1354.6	+	425	6246	14042	0.4448084
A09	25302015	25314685	A09p34970.2_BraZ1	1447.2	+	598	6822	12670	0.5384372
A09	25346464	25348206	A09p34980.2_BraZ1	292.923	+	57	1212	1742	0.6957520
A09	25347754	25353028	A09p34990.2_BraZ1	858	+	78	2318	5274	0.4395146
A09	25362652	25369500	A09p35000.2_BraZ1	1815	-	85	2871	6848	0.4192465
A09	25370803	25423474	A09p35010.2_BraZ1	201	+	2281	15271	52671	0.2899318
A09	25407812	25409402	A09p35020.2_BraZ1	1125	+	29	895	1590	0.5628931
A09	25410600	25466981	A09p35030.2_BraZ1	1062	-	1089	21672	56381	0.3843848
A09	25463911	25467252	A09p35040.2_BraZ1	438	+	0	0	3341	0.0000000
A09	25489984	25505085	A09p35050.2_BraZ1	1586.67	+	1172	8657	15101	0.5732733
A09	25499046	25502902	A09p35060.2_BraZ1	240	-	657	3487	3856	0.9043050
A09	25502744	25505483	A09p35070.2_BraZ1	282	-	148	1725	2739	0.6297919
A09	25531707	25537700	A09p35080.2_BraZ1	480	+	133	2034	5993	0.3393960
A09	25533402	25537206	A09p35090.2_BraZ1	610.875	-	41	1008	3804	0.2649842
A09	25536865	25540448	A09p35100.2_BraZ1	423	-	61	1701	3583	0.4747418
A09	25537843	25555191	A09p35110.2_BraZ1	663	-	393	7311	17348	0.4214319
A09	25559069	25560778	A09p35120.2_BraZ1	490.5	-	63	760	1709	0.4447045
A09	25672536	25673352	A09p35130.2_BraZ1	336	-	34	494	816	0.6053922
A09	25673349	25673744	A09p35140.2_BraZ1	303	+	4	160	395	0.4050633
A09	25673869	25675264	A09p35150.2_BraZ1	1143	-	167	1132	1395	0.8114696
A09	25678988	25685746	A09p35160.2_BraZ1	333	-	66	2358	6758	0.3489198
A09	25679307	25684640	A09p35170.2_BraZ1	930.75	-	53	2130	5333	0.3994000
A09	25683698	25709342	A09p35180.2_BraZ1	558.875	-	553	9223	25644	0.3596553
A09	25685340	25688767	A09p35190.2_BraZ1	150	-	0	0	3427	0.0000000
A09	25701030	25709694	A09p35200.2_BraZ1	291	-	435	4543	8664	0.5243536
A09	25709869	25762838	A09p35210.2_BraZ1	498	-	6497	26083	52969	0.4924201
A09	25773397	25807881	A09p35220.2_BraZ1	845.765	-	833	12069	34484	0.3499884
A09	25807881	25808311	A09p35230.2_BraZ1	62	-	0	0	430	0.0000000
A09	25866600	25869504	A09p35240.2_BraZ1	437.5	+	8	396	2904	0.1363636
A09	25867261	25870337	A09p35250.2_BraZ1	660	+	9	517	3076	0.1680754
A09	25870991	25874155	A09p35260.2_BraZ1	20223	-	0	0	3164	0.0000000
A09	25874755	25875607	A09p35270.2_BraZ1	555	-	4	105	852	0.1232394
A09	25878321	25882055	A09p35280.2_BraZ1	819	+	26	607	3734	0.1625603
A09	25886760	25888629	A09p35290.2_BraZ1	3168	+	38	861	1869	0.4606742
A09	25899049	25907705	A09p35300.2_BraZ1	756	+	44	2310	8656	0.2668669
A09	25908730	25910224	A09p35310.2_BraZ1	789	-	40	386	1494	0.2583668
A09	25918598	25922891	A09p35320.2_BraZ1	1196.67	+	40	420	4293	0.0978337
A09	25923043	25923243	A09p35330.2_BraZ1	147	+	2	37	200	0.1850000
A09	25930813	25931207	A09p35340.2_BraZ1	336	+	0	0	394	0.0000000
A09	25934698	25935799	A09p35350.2_BraZ1	354	+	5	290	1101	0.2633969
A09	25935489	25941032	A09p35360.2_BraZ1	600	+	23	1064	5543	0.1919538
A09	25941653	25949717	A09p35370.2_BraZ1	572	+	21	1312	8064	0.1626984
A09	25950333	25950811	A09p35380.2_BraZ1	213	+	331	463	478	0.9686192
A09	25953512	25954263	A09p35390.2_BraZ1	238	+	10	339	751	0.4513981
A09	25954277	25957712	A09p35400.2_BraZ1	1368.8	+	10	711	3435	0.2069869
A09	25966485	25968390	A09p35410.2_BraZ1	324	+	29	463	1905	0.2430446
A09	25989269	25990519	A09p35420.2_BraZ1	495	-	0	0	1250	0.0000000
A09	26006502	26007188	A09p35430.2_BraZ1	171	-	4	105	686	0.1530612
A09	26007548	26024689	A09p35440.2_BraZ1	420	+	603	7972	17141	0.4650837
A09	26048648	26049385	A09p35450.2_BraZ1	441	-	0	0	737	0.0000000
A09	26132084	26132204	A09p35460.2_BraZ1	12	-	0	0	120	0.0000000
A09	26142828	26142965	A09p35470.2_BraZ1	13.5	+	42	137	137	1.0000000
A09	26164834	26170381	A09p35480.2_BraZ1	1401	-	47	1571	5547	0.2832161
A09	26170357	26175146	A09p35490.2_BraZ1	940.5	+	91	1524	4789	0.3182293
A09	26194462	26204263	A09p35500.2_BraZ1	1346.4	+	214	3517	9801	0.3588409
A09	26212608	26231203	A09p35510.2_BraZ1	1143	+	329	6017	18595	0.3235816
A09	26248801	26254933	A09p35520.2_BraZ1	1011	+	56	1619	6132	0.2640248
A09	26257740	26258603	A09p35530.2_BraZ1	168	+	18	239	863	0.2769409
A09	26418624	26419485	A09p35540.2_BraZ1	375	+	20	524	861	0.6085947
A09	26418671	26419213	A09p35550.2_BraZ1	144	+	17	235	542	0.4335793
A09	26466618	26468663	A09p35560.2_BraZ1	303	-	40	1500	2045	0.7334963
A09	26476941	26478879	A09p35570.2_BraZ1	652.75	-	25	247	1938	0.1274510
A09	26487423	26487694	A09p35580.2_BraZ1	138	+	2	90	271	0.3321033
A09	26487690	26499316	A09p35590.2_BraZ1	2121.88	-	19	885	11626	0.0761225
A09	26488006	26489067	A09p35600.2_BraZ1	264	+	0	0	1061	0.0000000
A09	26490687	26493955	A09p35610.2_BraZ1	228	+	4	62	3268	0.0189718
A09	26494447	26496930	A09p35620.2_BraZ1	198	-	3	73	2483	0.0293999
A09	26503563	26503938	A09p35630.2_BraZ1	336	-	0	0	375	0.0000000
A09	26510424	26512673	A09p35640.2_BraZ1	1113.75	-	88	1431	2249	0.6362828
A09	26520087	26530338	A09p35650.2_BraZ1	1236	-	117	4825	10251	0.4706858
A09	26530498	26531200	A09p35660.2_BraZ1	171	+	36	460	702	0.6552706
A09	26593046	26599187	A09p35670.2_BraZ1	1005	-	148	3463	6141	0.5639147
A09	26596072	26597806	A09p35680.2_BraZ1	267	+	71	1382	1734	0.7970012
A09	26599185	26600301	A09p35690.2_BraZ1	285	+	58	862	1116	0.7724015
A09	26664664	26698575	A09p35700.2_BraZ1	582	-	417	11267	33911	0.3322521
A09	26671446	26681835	A09p35710.2_BraZ1	552	-	159	4047	10389	0.3895466
A09	26719459	26720487	A09p35720.2_BraZ1	342	-	35	258	1028	0.2509727
A09	26799222	26799979	A09p35730.2_BraZ1	231	-	0	0	757	0.0000000
A09	26895661	26895823	A09p35740.2_BraZ1	13.5	-	1	36	162	0.2222222
A09	26899393	26899555	A09p35750.2_BraZ1	13.5	-	6	141	162	0.8703704
A09	26909670	26910560	A09p35760.2_BraZ1	273	-	1	73	890	0.0820225
A09	26962751	26964312	A09p35770.2_BraZ1	300	+	11	747	1561	0.4785394
A09	26988924	26997116	A09p35780.2_BraZ1	462	+	107	1810	8192	0.2209473
A09	27006283	27011205	A09p35790.2_BraZ1	1035	+	66	1831	4922	0.3720033
A09	27007985	27010696	A09p35800.2_BraZ1	474	+	22	881	2711	0.3249723
A09	27013025	27014045	A09p35810.2_BraZ1	19.5	+	31	501	1020	0.4911765
A09	27023095	27026286	A09p35820.2_BraZ1	642	+	6	410	3191	0.1284864
A09	27032867	27033400	A09p35830.2_BraZ1	162	+	0	0	533	0.0000000
A09	27669231	27669381	A09p35840.2_BraZ1	15	-	0	0	150	0.0000000
A09	27752422	27754123	A09p35850.2_BraZ1	507	-	33	819	1701	0.4814815
A09	27925657	27926342	A09p35860.2_BraZ1	171	+	14	335	685	0.4890511
A09	27958691	27959311	A09p35870.2_BraZ1	213	-	7	296	620	0.4774193
A09	28028385	28035113	A09p35880.2_BraZ1	645	-	86	2623	6728	0.3898633
A09	28061628	28062557	A09p35890.2_BraZ1	573	+	4	382	929	0.4111948
A09	28071831	28077488	A09p35900.2_BraZ1	1134.25	+	186	3048	5657	0.5388015
A09	28080165	28081733	A09p35910.2_BraZ1	846	+	4	371	1568	0.2366071
A09	28153881	28154834	A09p35920.2_BraZ1	630	+	14	352	953	0.3693599
A09	28173046	28173746	A09p35930.2_BraZ1	213	+	1	48	700	0.0685714
A09	28285552	28286442	A09p35940.2_BraZ1	273	+	8	186	890	0.2089888
A09	28442050	28442272	A09p35950.2_BraZ1	22.2	+	6	164	222	0.7387387
A09	28515106	28539989	A09p35960.2_BraZ1	1005	+	300	8670	24883	0.3484307
A09	28532467	28533302	A09p35970.2_BraZ1	65.1	+	22	456	835	0.5461078
A09	28536297	28537424	A09p35980.2_BraZ1	363	-	1	150	1127	0.1330967
A09	28539618	28540477	A09p35990.2_BraZ1	261	+	54	479	859	0.5576252
A09	28542136	28542388	A09p36000.2_BraZ1	14.4	-	0	0	252	0.0000000
A09	28545523	28545841	A09p36010.2_BraZ1	31.8	-	2	108	318	0.3396226
A09	28550479	28552970	A09p36020.2_BraZ1	700.889	+	181	1656	2491	0.6647933
A09	28553171	28554020	A09p36030.2_BraZ1	55	+	382	847	849	0.9976443
A09	28555004	28557408	A09p36040.2_BraZ1	1773.75	+	104	1326	2404	0.5515807
A09	28556390	28557015	A09p36050.2_BraZ1	246	-	5	297	625	0.4752000
A09	28558601	28559281	A09p36060.2_BraZ1	435.75	+	24	530	680	0.7794118
A09	28577794	28587691	A09p36070.2_BraZ1	95.9444	+	1279	6359	9897	0.6425179
A09	28587658	28588769	A09p36080.2_BraZ1	82.6719	+	66	770	1111	0.6930693
A09	28594234	28595459	A09p36090.2_BraZ1	262	-	52	701	1225	0.5722449
A09	28596787	28606675	A09p36100.2_BraZ1	414	+	104	3106	9888	0.3141181
A09	28598293	28599312	A09p36110.2_BraZ1	94.8	+	14	492	1019	0.4828263
A09	28604307	28604848	A09p36120.2_BraZ1	44.1	-	4	22	541	0.0406654
A09	28631945	28702131	A09p36130.2_BraZ1	990	-	2458	24941	70186	0.3553558
A09	28635744	28636860	A09p36140.2_BraZ1	285	+	104	958	1116	0.8584229
A09	28712830	28713064	A09p36150.2_BraZ1	23.4	+	0	0	234	0.0000000
A09	28727744	28730546	A09p36160.2_BraZ1	644.583	+	51	917	2802	0.3272662
A09	28729904	28730657	A09p36170.2_BraZ1	186	-	0	0	753	0.0000000
A09	28730015	28730609	A09p36180.2_BraZ1	144	-	0	0	594	0.0000000
A09	28853247	28854987	A09p36190.2_BraZ1	612	-	0	0	1740	0.0000000
A09	28859403	28862146	A09p36200.2_BraZ1	657	-	10	395	2743	0.1440029
A09	29000603	29000765	A09p36210.2_BraZ1	13.5	-	0	0	162	0.0000000
A09	29004327	29004489	A09p36220.2_BraZ1	13.5	-	0	0	162	0.0000000
A09	29008075	29008237	A09p36230.2_BraZ1	13.5	-	1	19	162	0.1172839
A09	29018371	29019256	A09p36240.2_BraZ1	273	-	2	26	885	0.0293785
A09	29019254	29021946	A09p36250.2_BraZ1	654	+	2	260	2692	0.0965825
A09	29051985	29062310	A09p36260.2_BraZ1	681	+	182	3536	10325	0.3424697
A09	29062415	29064480	A09p36270.2_BraZ1	852	+	16	282	2065	0.1365617
A09	29065200	29070232	A09p36280.2_BraZ1	327	+	18	1033	5032	0.2052862
A09	29068179	29070820	A09p36290.2_BraZ1	456	+	2	82	2641	0.0310488
A09	29068680	29075262	A09p36300.2_BraZ1	768	+	23	842	6582	0.1279246
A09	29103728	29107478	A09p36310.2_BraZ1	948	+	31	937	3750	0.2498667
A09	29106450	29127552	A09p36320.2_BraZ1	342	-	1043	3477	21102	0.1647711
A09	29127571	29135476	A09p36330.2_BraZ1	1083	+	255	2578	7905	0.3261227
A09	29160873	29169534	A09p36340.2_BraZ1	595.5	+	177	1827	8661	0.2109456
A09	29169085	29196297	A09p36350.2_BraZ1	606.25	+	203	6204	27212	0.2279876
A09	29214122	29216539	A09p36360.2_BraZ1	493.5	+	14	552	2417	0.2283823
A09	29216799	29219829	A09p36370.2_BraZ1	292.5	+	16	730	3030	0.2409241
A09	29230409	29236415	A09p36380.2_BraZ1	804.632	+	56	2742	6006	0.4565434
A09	29237153	29237578	A09p36390.2_BraZ1	231	+	1	138	425	0.3247059
A09	29237904	29242447	A09p36400.2_BraZ1	843	+	12	820	4543	0.1804975
A09	29240249	29241872	A09p36410.2_BraZ1	300	+	5	375	1623	0.2310536
A09	29243714	29245044	A09p36420.2_BraZ1	390	+	3	187	1330	0.1406015
A09	29245558	29252737	A09p36430.2_BraZ1	1095.37	+	53	943	7179	0.1313553
A09	29247970	29249718	A09p36440.2_BraZ1	189	+	0	0	1748	0.0000000
A09	29258924	29260171	A09p36450.2_BraZ1	396	+	0	0	1247	0.0000000
A09	29270363	29271945	A09p36460.2_BraZ1	655.667	+	0	0	1582	0.0000000
A09	29272772	29273802	A09p36470.2_BraZ1	200	+	0	0	1030	0.0000000
A09	29295578	29297772	A09p36480.2_BraZ1	447	-	5	150	2194	0.0683683
A09	29347086	29358400	A09p36490.2_BraZ1	330	+	272	4606	11314	0.4071063
A09	29358779	29359735	A09p36500.2_BraZ1	690	-	4	247	956	0.2583682
A09	29371086	29371224	A09p36510.2_BraZ1	13.8	+	16	138	138	1.0000000
A09	29372106	29373213	A09p36520.2_BraZ1	147	+	0	0	1107	0.0000000
A09	29373592	29384361	A09p36530.2_BraZ1	1599	+	29	1077	10769	0.1000093
A09	29381145	29384577	A09p36540.2_BraZ1	297	-	13	461	3432	0.1343240
A09	29389109	29391208	A09p36550.2_BraZ1	687	-	15	774	2099	0.3687470
A09	29503133	29506516	A09p36560.2_BraZ1	782	-	3	222	3383	0.0656222
A09	29530092	29531794	A09p36570.2_BraZ1	1122	+	15	505	1702	0.2967097
A09	29531769	29532264	A09p36580.2_BraZ1	200	-	2	121	495	0.2444444
A09	29536554	29539845	A09p36590.2_BraZ1	740	-	215	1837	3291	0.5581890
A09	29539845	29545414	A09p36600.2_BraZ1	1166	-	439	3241	5569	0.5819716
A09	29541531	29545880	A09p36610.2_BraZ1	138	+	401	2841	4349	0.6532536
A09	29546156	29546858	A09p36620.2_BraZ1	171	+	46	448	702	0.6381766
A09	29601666	29616473	A09p36630.2_BraZ1	363	-	1050	4783	14807	0.3230229
A09	29616443	29624599	A09p36640.2_BraZ1	1528.82	-	3	90	8156	0.0110348
A09	29616771	29617174	A09p36650.2_BraZ1	351	+	0	0	403	0.0000000
A09	29625330	29626030	A09p36660.2_BraZ1	171	+	66	512	700	0.7314286
A09	29626352	29729923	A09p36670.2_BraZ1	315	+	1893	21572	103571	0.2082822
A09	29670420	29671357	A09p36680.2_BraZ1	1125	+	91	607	937	0.6478122
A09	29671728	29672103	A09p36690.2_BraZ1	291	+	178	319	375	0.8506666
A09	29686836	29709455	A09p36700.2_BraZ1	1143	-	226	2654	22619	0.1173350
A09	29710966	29725339	A09p36710.2_BraZ1	588	-	74	1865	14373	0.1297572
A09	29726923	29735828	A09p36720.2_BraZ1	3097.5	-	55	1767	8905	0.1984279
A09	29736152	29737823	A09p36730.2_BraZ1	435	-	10	317	1671	0.1897068
A09	29746205	29748082	A09p36740.2_BraZ1	681	+	5	197	1877	0.1049547
A09	29757005	29758061	A09p36750.2_BraZ1	357	-	12	582	1056	0.5511364
A09	29759531	29770679	A09p36760.2_BraZ1	2143.75	-	145	4037	11148	0.3621277
A09	29793240	29794283	A09p36770.2_BraZ1	877.5	-	0	0	1043	0.0000000
A09	29808667	29808973	A09p36780.2_BraZ1	17.1	-	0	0	306	0.0000000
A09	29814767	29840522	A09p36790.2_BraZ1	1437.69	+	169	5404	25755	0.2098233
A09	29840522	29852532	A09p36800.2_BraZ1	762	-	28	869	12010	0.0723564
A09	29852519	29853248	A09p36810.2_BraZ1	408	-	14	421	729	0.5775034
A09	29862532	29865732	A09p36820.2_BraZ1	582	+	123	574	3200	0.1793750
A09	29875335	29877077	A09p36830.2_BraZ1	726	+	203	1608	1742	0.9230769
A09	29877345	29877933	A09p36840.2_BraZ1	243.75	+	37	588	588	1.0000000
A09	29974809	29975115	A09p36850.2_BraZ1	17.1	+	34	270	306	0.8823529
A09	30103232	30228641	A09p36860.2_BraZ1	474	+	4989	68447	125409	0.5457902
A09	30187897	30294070	A09p36870.2_BraZ1	492	+	3902	61757	106173	0.5816639
A09	30293547	30311879	A09p36880.2_BraZ1	212.7	-	995	11793	18332	0.6433013
A09	30311160	30319958	A09p36890.2_BraZ1	381	+	572	5029	8798	0.5716072
A09	30350371	30351245	A09p36900.2_BraZ1	432	+	20	837	874	0.9576659
A09	30350419	30350964	A09p36910.2_BraZ1	144	+	14	508	545	0.9321101
A09	30352703	30352926	A09p36920.2_BraZ1	13.2	-	3	166	223	0.7443946
A09	30352899	30354632	A09p36930.2_BraZ1	67.5	-	42	1213	1733	0.6999423
A09	30358918	30404672	A09p36940.2_BraZ1	750	-	2422	30009	45754	0.6558771
A09	30390950	30394385	A09p36950.2_BraZ1	798	-	34	1547	3435	0.4503639
A09	30404672	30423033	A09p36960.2_BraZ1	414	-	607	11404	18361	0.6210991
A09	30438314	30455134	A09p36970.2_BraZ1	900	+	916	10971	16820	0.6522592
A09	30463369	30465682	A09p36980.2_BraZ1	741	-	90	1779	2313	0.7691310
A09	30646714	30676911	A09p36990.2_BraZ1	573	-	1009	17036	30197	0.5641620
A09	30677030	30690602	A09p37000.2_BraZ1	2611	+	291	5222	13572	0.3847627
A09	30699911	30708561	A09p37010.2_BraZ1	2421.68	-	296	5647	8650	0.6528324
A09	30700859	30703932	A09p37020.2_BraZ1	249	+	54	1763	3073	0.5737064
A09	30704816	30706347	A09p37030.2_BraZ1	207	+	79	1242	1531	0.8112345
A09	30723646	30727751	A09p37040.2_BraZ1	715.909	+	122	2530	4105	0.6163216
A09	30742340	30746961	A09p37050.2_BraZ1	450	+	168	2353	4621	0.5091971
A09	30746925	30774057	A09p37060.2_BraZ1	1145.83	-	1506	15459	27132	0.5697700
A09	30783195	30817205	A09p37070.2_BraZ1	933	-	1361	20037	34010	0.5891502
A09	30817205	30817822	A09p37080.2_BraZ1	246	-	19	315	617	0.5105348
A09	30834211	30851486	A09p37090.2_BraZ1	285	-	4312	12547	17275	0.7263097
A09	30851051	30852095	A09p37100.2_BraZ1	510	-	96	558	1044	0.5344828
A09	30856198	30914435	A09p37110.2_BraZ1	933	-	4143	38498	58237	0.6610574
A09	30914023	30921453	A09p37120.2_BraZ1	294	-	828	6231	7430	0.8386272
A09	30923910	30924296	A09p37130.2_BraZ1	333	-	19	248	386	0.6424870
A09	30966809	30969296	A09p37140.2_BraZ1	894	-	265	2173	2487	0.8737435
A09	30996620	31018445	A09p37150.2_BraZ1	636	-	1123	11868	21825	0.5437801
A09	31020691	31023611	A09p37160.2_BraZ1	396	-	185	2059	2920	0.7051370
A09	31054433	31057367	A09p37170.2_BraZ1	285	+	37	1308	2934	0.4458078
A09	31091424	31104045	A09p37180.2_BraZ1	549	-	938	9466	12621	0.7500198
A09	31104067	31183128	A09p37190.2_BraZ1	1150	-	9671	56002	79061	0.7083392
A09	31125004	31162696	A09p37200.2_BraZ1	529.875	-	5737	25620	37692	0.6797198
A09	31162654	31181251	A09p37210.2_BraZ1	354.857	+	773	12843	18597	0.6905953
A09	31182778	31183294	A09p37220.2_BraZ1	144.875	+	17	445	516	0.8624031
A09	31184651	31188537	A09p37230.2_BraZ1	744	-	172	2660	3886	0.6845085
A09	31212822	31213459	A09p37240.2_BraZ1	489	-	24	387	637	0.6075353
A09	31223057	31249583	A09p37250.2_BraZ1	1802.08	-	1411	18080	26526	0.6815954
A09	31239098	31240224	A09p37260.2_BraZ1	153	+	54	746	1126	0.6625222
A09	31249583	31250693	A09p37270.2_BraZ1	969	+	179	1008	1110	0.9081081
A09	31261117	31267939	A09p37280.2_BraZ1	306	+	273	4902	6822	0.7185576
A09	31335649	31335784	A09p37290.2_BraZ1	13.5	+	19	135	135	1.0000000
A09	31335815	31335923	A09p37300.2_BraZ1	10.8	+	19	108	108	1.0000000
A09	31362370	31362502	A09p37310.2_BraZ1	13.2	+	3	8	132	0.0606061
A09	31367889	31395104	A09p37320.2_BraZ1	657	-	1438	16384	27215	0.6020209
A09	31368385	31397043	A09p37330.2_BraZ1	294	-	1450	17359	28658	0.6057296
A09	31398740	31409503	A09p37340.2_BraZ1	1008	-	153	5043	10763	0.4685497
A09	31409424	31410357	A09p37350.2_BraZ1	444	-	7	496	933	0.5316184
A09	31410719	31411633	A09p37360.2_BraZ1	432	+	42	713	914	0.7800875
A09	31439613	31464606	A09p37370.2_BraZ1	1523.94	-	699	10904	24993	0.4362822
A09	31474477	31476053	A09p37380.2_BraZ1	418.5	+	320	1429	1576	0.9067259
A09	31492675	31493101	A09p37390.2_BraZ1	333	+	13	358	426	0.8403756
A09	31499758	31506911	A09p37400.2_BraZ1	1599	-	584	6027	7153	0.8425835
A09	31509778	31524084	A09p37410.2_BraZ1	477	-	1153	10924	14306	0.7635957
A09	31511614	31538054	A09p37420.2_BraZ1	717	-	2119	19566	26440	0.7400151
A09	31543075	31655105	A09p37430.2_BraZ1	1697.88	+	8508	58390	112030	0.5211997
A09	31543827	31610195	A09p37440.2_BraZ1	198	-	2953	30097	66368	0.4534866
A09	31544950	31557052	A09p37450.2_BraZ1	198	-	383	6031	12102	0.4983474
A09	31545106	31654285	A09p37460.2_BraZ1	489	-	8239	56486	109179	0.5173706
A09	31657847	31658757	A09p37470.2_BraZ1	330	+	15	723	910	0.7945055
A09	31759052	31759858	A09p37480.2_BraZ1	534	-	50	725	806	0.8995037
A09	31765458	31765581	A09p37490.2_BraZ1	12.3	+	99	123	123	1.0000000
A09	31767284	31769440	A09p37500.2_BraZ1	720	-	106	1445	2156	0.6702226
A09	31778182	31781900	A09p37510.2_BraZ1	1275	-	40	1253	3718	0.3370091
A09	31783556	31784889	A09p37520.2_BraZ1	201	+	105	672	1333	0.5041260
A09	31783784	31786039	A09p37530.2_BraZ1	840	-	217	1398	2255	0.6199557
A09	31803047	31803784	A09p37540.2_BraZ1	555	-	38	329	737	0.4464043
A09	31803784	31829706	A09p37550.2_BraZ1	360	+	3778	20307	25922	0.7833886
A09	31821448	31829089	A09p37560.2_BraZ1	904	-	485	5175	7641	0.6772674
A09	31821994	31822908	A09p37570.2_BraZ1	420	+	45	487	914	0.5328227
A09	31830059	31841570	A09p37580.2_BraZ1	1623.27	-	801	8516	11511	0.7398141
A09	31841570	31842343	A09p37590.2_BraZ1	276	-	2	132	773	0.1707633
A09	31851746	31852578	A09p37600.2_BraZ1	1809	-	6	450	832	0.5408654
A09	31864056	31865369	A09p37610.2_BraZ1	526	-	65	876	1313	0.6671744
A09	31864092	31883025	A09p37620.2_BraZ1	609	+	961	11713	18933	0.6186553
A09	31866093	31866888	A09p37630.2_BraZ1	291	-	12	616	795	0.7748427
A09	31882344	31897547	A09p37640.2_BraZ1	1387.43	+	336	8090	15203	0.5321318
A09	31895578	31898448	A09p37650.2_BraZ1	888	+	116	1657	2870	0.5773519
A09	31907886	31909490	A09p37660.2_BraZ1	963	+	20	624	1604	0.3890274
A09	31908726	31910229	A09p37670.2_BraZ1	273.6	+	78	879	1503	0.5848303
A09	31910520	31911344	A09p37680.2_BraZ1	279	+	167	824	824	1.0000000
A09	31912870	31915218	A09p37690.2_BraZ1	6451.2	+	71	1349	2348	0.5745315
A09	31921901	31922446	A09p37700.2_BraZ1	50.7	+	0	0	545	0.0000000
A09	31936457	31956089	A09p37710.2_BraZ1	1157.2	-	1898	12127	19632	0.6177160
A09	31979063	32014880	A09p37720.2_BraZ1	3226.98	-	2675	19629	35817	0.5480359
A09	31990371	32007194	A09p37730.2_BraZ1	342	-	1779	8393	16823	0.4989003
A09	32123561	32129482	A09p37740.2_BraZ1	1002	+	96	1581	5921	0.2670157
A09	32148973	32153629	A09p37750.2_BraZ1	841.667	-	16	814	4656	0.1748282
A09	32160969	32163181	A09p37760.2_BraZ1	591	-	11	261	2212	0.1179928
A09	32166507	32184078	A09p37770.2_BraZ1	1157.06	-	489	5112	17571	0.2909339
A09	32184825	32196639	A09p37780.2_BraZ1	438	-	216	4616	11814	0.3907229
A09	32196835	32205721	A09p37790.2_BraZ1	1513	-	74	2005	8886	0.2256358
A09	32206947	32208306	A09p37800.2_BraZ1	201	-	3	246	1359	0.1810154
A09	32217864	32229107	A09p37810.2_BraZ1	684	-	273	5761	11243	0.5124077
A09	32239163	32239750	A09p37820.2_BraZ1	345	+	29	359	587	0.6115843
A09	32272793	32297334	A09p37830.2_BraZ1	2034.38	-	1503	14666	24541	0.5976121
A09	32290727	32295151	A09p37840.2_BraZ1	246	+	134	2272	4424	0.5135624
A09	32297364	32298063	A09p37850.2_BraZ1	429.857	-	21	591	699	0.8454936
A09	32298237	32299379	A09p37860.2_BraZ1	555	-	25	759	1142	0.6646234
A09	32327479	32327983	A09p37870.2_BraZ1	495	-	4	252	504	0.5000000
A09	32327929	32328806	A09p37880.2_BraZ1	774	+	13	275	877	0.3135690
A09	32328841	32330512	A09p37890.2_BraZ1	474	+	54	1145	1671	0.6852185
A09	32397800	32400361	A09p37900.2_BraZ1	336	-	25	780	2561	0.3045685
A09	32418346	32423212	A09p37910.2_BraZ1	630	-	4	249	4866	0.0511714
A09	32425238	32455973	A09p37920.2_BraZ1	315	-	186	7945	30735	0.2585001
A09	32429635	32430025	A09p37930.2_BraZ1	39	-	6	177	390	0.4538462
A09	32458776	32516826	A09p37940.2_BraZ1	417	-	374	10868	58050	0.1872179
A09	32475396	32520934	A09p37950.2_BraZ1	1494	-	185	7216	45538	0.1584611
A09	32510290	32511095	A09p37960.2_BraZ1	168	-	0	0	805	0.0000000
A09	32532991	32533229	A09p37970.2_BraZ1	522	-	2	157	238	0.6596639
A09	32533229	32533833	A09p37980.2_BraZ1	738	-	5	335	604	0.5546358
A09	32540922	32542107	A09p37990.2_BraZ1	1080	-	96	765	1185	0.6455696
A09	32553264	32555880	A09p38000.2_BraZ1	948	-	33	1073	2616	0.4101682
A09	32568195	32569767	A09p38010.2_BraZ1	354	+	62	1205	1572	0.7665395
A09	32616531	32616805	A09p38020.2_BraZ1	225	-	9	189	274	0.6897810
A09	32616771	32620073	A09p38030.2_BraZ1	1041	+	25	1147	3302	0.3473652
A09	32619177	32620593	A09p38040.2_BraZ1	243	-	10	496	1416	0.3502825
A09	32668890	32696715	A09p38050.2_BraZ1	681	-	603	12236	27825	0.4397484
A09	32674615	32676207	A09p38060.2_BraZ1	546	-	28	421	1592	0.2644472
A09	32691318	32787703	A09p38070.2_BraZ1	1431	+	2710	34441	96385	0.3573274
A09	32712457	32715033	A09p38080.2_BraZ1	596.4	-	319	1559	2576	0.6052018
A09	32762949	32805523	A09p38090.2_BraZ1	2028	-	3048	15606	42574	0.3665617
A09	32807060	32808485	A09p38100.2_BraZ1	330	+	14	480	1425	0.3368421
A09	32824673	32825535	A09p38110.2_BraZ1	45	-	2	150	862	0.1740139
A09	32832089	32845635	A09p38120.2_BraZ1	351	-	87	3309	13546	0.2442788
A09	32845852	32847390	A09p38130.2_BraZ1	324	+	56	957	1538	0.6222367
A09	32847070	32847760	A09p38140.2_BraZ1	264	-	5	136	690	0.1971014
A09	32852912	32870529	A09p38150.2_BraZ1	543	-	168	4948	17617	0.2808651
A09	32870527	32871440	A09p38160.2_BraZ1	432	+	4	276	913	0.3023001
A09	32884136	32967065	A09p38170.2_BraZ1	297	+	1969	32085	82929	0.3868972
A09	32884191	32891381	A09p38180.2_BraZ1	498	+	18	826	7190	0.1148818
A09	32892001	32892872	A09p38190.2_BraZ1	351	+	2	205	871	0.2353617
A09	32900023	32900658	A09p38200.2_BraZ1	294	+	2	275	635	0.4330709
A09	32909845	32911305	A09p38210.2_BraZ1	600	+	4	228	1460	0.1561644
A09	32911811	32913307	A09p38220.2_BraZ1	165	+	17	394	1496	0.2633690
A09	32913218	32913772	A09p38230.2_BraZ1	183	+	8	193	554	0.3483754
A09	32924860	32954633	A09p38240.2_BraZ1	654	+	648	11684	29773	0.3924361
A09	32925727	32926117	A09p38250.2_BraZ1	39	+	0	0	390	0.0000000
A09	32927783	32928209	A09p38260.2_BraZ1	354	-	18	381	426	0.8943662
A09	33102252	33103195	A09p38270.2_BraZ1	576	-	4	312	943	0.3308590
A09	33216544	33216721	A09p38280.2_BraZ1	17.7	+	1	45	177	0.2542373
A09	33218765	33219177	A09p38290.2_BraZ1	342	-	7	236	412	0.5728155
A09	33219645	33224208	A09p38300.2_BraZ1	1025.14	+	29	1016	4563	0.2226605
A09	33225539	33225870	A09p38310.2_BraZ1	231	+	0	0	331	0.0000000
A09	33225870	33226292	A09p38320.2_BraZ1	126	-	0	0	422	0.0000000
A09	33235492	33237374	A09p38330.2_BraZ1	462	+	6	245	1882	0.1301807
A09	33236752	33240150	A09p38340.2_BraZ1	813.214	-	18	842	3398	0.2477928
A09	33243227	33243475	A09p38350.2_BraZ1	123	+	2	89	248	0.3588710
A09	33244036	33245023	A09p38360.2_BraZ1	236.444	+	64	226	987	0.2289767
A09	33244408	33246891	A09p38370.2_BraZ1	134.667	+	126	480	2483	0.1933145
A09	33262550	33278834	A09p38380.2_BraZ1	132	+	132	2471	16284	0.1517440
A09	33265818	33266271	A09p38390.2_BraZ1	45.3	+	3	326	453	0.7196468
A09	33268664	33273746	A09p38400.2_BraZ1	975	+	9	380	5082	0.0747737
A09	33273709	33278793	A09p38410.2_BraZ1	246	-	9	563	5084	0.1107396
A09	33275299	33281683	A09p38420.2_BraZ1	437.5	+	13	804	6384	0.1259398
A09	33278118	33283300	A09p38430.2_BraZ1	957	+	48	1305	5182	0.2518333
A09	33287884	33289699	A09p38440.2_BraZ1	399	+	0	0	1815	0.0000000
A09	33299838	33300324	A09p38450.2_BraZ1	282	+	4	274	486	0.5637860
A09	33316293	33317535	A09p38460.2_BraZ1	153	+	6	196	1242	0.1578100
A09	33326307	33328057	A09p38470.2_BraZ1	231	-	12	542	1750	0.3097143
A09	33334110	33345639	A09p38480.2_BraZ1	261	-	80	2531	11529	0.2195334
A09	33359581	33416311	A09p38490.2_BraZ1	369	+	1345	18654	56730	0.3288207
A09	33365299	33417260	A09p38500.2_BraZ1	934.5	+	905	16398	51961	0.3155828
A09	33365676	33366543	A09p38510.2_BraZ1	249	-	0	0	867	0.0000000
A09	33366245	33368572	A09p38520.2_BraZ1	312	+	51	945	2327	0.4061023
A09	33366553	33368757	A09p38530.2_BraZ1	468	-	52	1073	2204	0.4868421
A09	33414056	33414738	A09p38540.2_BraZ1	171	-	10	168	682	0.2463343
A09	33417303	33430946	A09p38550.2_BraZ1	636	+	303	3851	13643	0.2822693
A09	33417859	33430343	A09p38560.2_BraZ1	654	+	210	3422	12484	0.2741109
A09	33425572	33425860	A09p38570.2_BraZ1	219	-	0	0	288	0.0000000
A09	33425897	33426579	A09p38580.2_BraZ1	381	+	0	0	682	0.0000000
A09	33431258	33438302	A09p38590.2_BraZ1	687	+	57	1644	7044	0.2333901
A09	33438554	33439740	A09p38600.2_BraZ1	645	+	2	154	1186	0.1298482
A09	33452467	33455264	A09p38610.2_BraZ1	762	+	49	747	2797	0.2670719
A09	33473389	33474291	A09p38620.2_BraZ1	564	+	0	0	902	0.0000000
A09	33494657	33507316	A09p38630.2_BraZ1	420	+	142	2875	12659	0.2271111
A09	33592292	33593105	A09p38640.2_BraZ1	417	+	0	0	813	0.0000000
A09	33608315	33611200	A09p38650.2_BraZ1	722.7	-	45	1258	2885	0.4360485
A09	33611236	33625402	A09p38660.2_BraZ1	921	-	416	5762	14166	0.4067486
A09	33613125	33623246	A09p38670.2_BraZ1	168	-	344	4659	10121	0.4603300
A09	33644455	33646305	A09p38680.2_BraZ1	1101	+	141	1643	1850	0.8881081
A09	33655297	33690255	A09p38690.2_BraZ1	976.5	-	1019	16657	34958	0.4764861
A09	33673623	33674233	A09p38700.2_BraZ1	276	+	4	350	610	0.5737705
A09	33674229	33674650	A09p38710.2_BraZ1	258	-	44	240	421	0.5700713
A09	33688562	33747779	A09p38720.2_BraZ1	879.353	-	1043	22526	59217	0.3803975
A09	33698967	33747923	A09p38730.2_BraZ1	84	-	915	17888	48956	0.3653893
A09	33747789	33762731	A09p38740.2_BraZ1	382.95	-	1312	8315	14942	0.5564851
A09	33761937	33763220	A09p38750.2_BraZ1	108	-	116	1246	1283	0.9711614
A09	33762791	33766318	A09p38760.2_BraZ1	505.5	-	262	2171	3527	0.6155373
A09	33766526	33767639	A09p38770.2_BraZ1	285	+	10	678	1113	0.6091644
A09	33823122	33824149	A09p38780.2_BraZ1	384.75	-	44	679	1027	0.6611490
A09	33841103	33844099	A09p38790.2_BraZ1	334.5	-	140	1910	2996	0.6375167
A09	33884588	33939484	A09p38800.2_BraZ1	228	-	5258	34205	54896	0.6230873
A09	33902065	33902519	A09p38810.2_BraZ1	336	-	56	438	454	0.9647577
A09	33903014	33904147	A09p38820.2_BraZ1	279	-	83	293	1133	0.2586055
A09	33904378	33905186	A09p38830.2_BraZ1	846.857	-	43	369	808	0.4566832
A09	33904840	33905314	A09p38840.2_BraZ1	438	+	43	413	474	0.8713080
A09	33905285	33906303	A09p38850.2_BraZ1	6800	-	365	955	1018	0.9381139
A09	33906574	33906937	A09p38860.2_BraZ1	36.3	-	0	0	363	0.0000000
A09	33908043	33908821	A09p38870.2_BraZ1	534	-	20	484	778	0.6221080
A09	33909264	33913596	A09p38880.2_BraZ1	62.1	+	160	2484	4332	0.5734072
A09	33909739	33911046	A09p38890.2_BraZ1	14.7	+	34	829	1307	0.6342770
A09	33910106	33910653	A09p38900.2_BraZ1	222	-	27	410	547	0.7495430
A09	33913556	33915724	A09p38910.2_BraZ1	54.3	+	134	1726	2168	0.7961255
A09	33917016	33918978	A09p38920.2_BraZ1	42.3	+	216	1811	1962	0.9230377
A09	33919002	33921386	A09p38930.2_BraZ1	384	+	35	1329	2384	0.5574664
A09	33919279	33920140	A09p38940.2_BraZ1	465	+	15	681	861	0.7909408
A09	33921556	33922142	A09p38950.2_BraZ1	18.6	-	0	0	586	0.0000000
A09	33921944	33922623	A09p38960.2_BraZ1	973	-	38	229	679	0.3372607
A09	33922776	33929526	A09p38970.2_BraZ1	74.4	+	1314	6022	6750	0.8921481
A09	33923882	33924358	A09p38980.2_BraZ1	832.5	-	41	465	476	0.9768907
A09	33929916	33932172	A09p38990.2_BraZ1	445	-	77	1171	2256	0.5190603
A09	33932172	33934284	A09p39000.2_BraZ1	82.5	+	188	2009	2112	0.9512311
A09	33935723	33937501	A09p39010.2_BraZ1	1323.67	-	179	1106	1778	0.6220472
A09	33952267	33962130	A09p39020.2_BraZ1	135.194	-	1111	6378	9863	0.6466593
A09	33980597	33981277	A09p39030.2_BraZ1	435.75	-	5	208	680	0.3058824
A09	33982470	33984874	A09p39040.2_BraZ1	1519.38	-	139	1602	2404	0.6663893
A09	33992900	33993230	A09p39050.2_BraZ1	231	-	204	281	330	0.8515152
A09	33997774	33998131	A09p39060.2_BraZ1	25.2	+	0	0	357	0.0000000
A09	34000206	34007535	A09p39070.2_BraZ1	336	-	207	2306	7329	0.3146405
A09	34008202	34017249	A09p39080.2_BraZ1	357	-	54	2857	9047	0.3157953
A09	34020400	34091680	A09p39090.2_BraZ1	584.5	-	530	18149	71280	0.2546156
A09	34062930	34063858	A09p39100.2_BraZ1	183	-	6	332	928	0.3577586
A09	34091614	34104623	A09p39110.2_BraZ1	342	-	47	1784	13009	0.1371358
A09	34116272	34116447	A09p39120.2_BraZ1	162	+	0	0	175	0.0000000
A09	34123689	34125594	A09p39130.2_BraZ1	72	+	9	656	1905	0.3443570
A09	34144488	34145284	A09p39140.2_BraZ1	186	+	1	122	796	0.1532663
A09	34144494	34147091	A09p39150.2_BraZ1	660	+	90	755	2597	0.2907201
A09	34155456	34159567	A09p39160.2_BraZ1	492	+	3	251	4111	0.0610557
A09	34169295	34169439	A09p39170.2_BraZ1	14.4	+	3	144	144	1.0000000
A09	34171759	34182485	A09p39180.2_BraZ1	633.6	+	83	3108	10726	0.2897632
A09	34182816	34183630	A09p39190.2_BraZ1	558	+	4	287	814	0.3525799
A09	34189913	34190946	A09p39200.2_BraZ1	45.3	+	12	431	1033	0.4172314
A09	34233302	34237605	A09p39210.2_BraZ1	207	+	6	442	4303	0.1027190
A09	34243470	34246061	A09p39220.2_BraZ1	213	+	2367	85	2591	0.0328059
A09	34265532	34288250	A09p39230.2_BraZ1	327	+	204	5802	22718	0.2553922
A09	34265984	34304404	A09p39240.2_BraZ1	300	+	397	10773	38420	0.2804008
A09	34304558	34317691	A09p39250.2_BraZ1	448.875	+	222	5782	13133	0.4402650
A09	34329541	34331309	A09p39260.2_BraZ1	159	+	4	412	1768	0.2330317
A09	34331443	34340582	A09p39270.2_BraZ1	498	+	64	3228	9139	0.3532115
A09	34377675	34377877	A09p39280.2_BraZ1	189	+	21	172	202	0.8514851
A09	34378074	34378558	A09p39290.2_BraZ1	372	+	41	484	484	1.0000000
A09	34384112	34388919	A09p39300.2_BraZ1	489	+	13	846	4807	0.1759933
A09	34946374	34947059	A09p39310.2_BraZ1	171	-	8	219	685	0.3197080
A09	35176087	35182053	A09p39320.2_BraZ1	972	-	10	294	5966	0.0492793
A09	35181235	35183013	A09p39330.2_BraZ1	297	-	4	167	1778	0.0939258
A09	35240595	35240871	A09p39340.2_BraZ1	27.6	-	0	0	276	0.0000000
A09	35262956	35263818	A09p39350.2_BraZ1	312	-	43	483	862	0.5603248
A09	35263988	35270689	A09p39360.2_BraZ1	1437.69	-	77	1790	6701	0.2671243
A09	35342261	35390389	A09p39370.2_BraZ1	204	+	810	16578	48128	0.3444565
A09	35474381	35475802	A09p39380.2_BraZ1	414	+	192	1043	1421	0.7339901
A09	35494914	35498922	A09p39390.2_BraZ1	423	-	64	1196	4008	0.2984032
A09	35499140	35501325	A09p39400.2_BraZ1	267	+	16	514	2185	0.2352403
A09	35499638	35522897	A09p39410.2_BraZ1	852	-	1389	8468	23259	0.3640741
A09	35524041	35525201	A09p39420.2_BraZ1	663	-	2	229	1160	0.1974138
A09	35550826	35552127	A09p39430.2_BraZ1	72	-	105	627	1301	0.4819370
A09	35564582	35566171	A09p39440.2_BraZ1	696	-	87	873	1589	0.5494021
A09	35606687	35609220	A09p39450.2_BraZ1	507	-	65	1893	2533	0.7473352
A09	35659770	35660619	A09p39460.2_BraZ1	381	-	0	0	849	0.0000000
A09	35670908	35686334	A09p39470.2_BraZ1	520.5	-	17	603	15426	0.0390898
A09	35686617	35686841	A09p39480.2_BraZ1	75	-	0	0	224	0.0000000
A09	35721558	35721919	A09p39490.2_BraZ1	123	-	17	219	361	0.6066482
A09	35721905	35723450	A09p39500.2_BraZ1	262.5	-	57	569	1545	0.3682848
A09	35734948	35737658	A09p39510.2_BraZ1	372	-	60	1028	2710	0.3793358
A09	35738438	35742926	A09p39520.2_BraZ1	1017	-	34	931	4488	0.2074421
A09	35743178	35755004	A09p39530.2_BraZ1	306	-	111	3340	11826	0.2824285
A09	35743655	35753812	A09p39540.2_BraZ1	277.2	+	51	2115	10157	0.2082308
A09	35755212	35755670	A09p39550.2_BraZ1	240	-	5	262	458	0.5720524
A09	35757693	35758221	A09p39560.2_BraZ1	447	-	6	429	528	0.8125000
A09	35758221	35759566	A09p39570.2_BraZ1	1024.8	-	21	877	1345	0.6520446
A09	35861254	35863044	A09p39580.2_BraZ1	300	-	11	448	1790	0.2502793
A09	35862030	35864695	A09p39590.2_BraZ1	258	-	13	698	2665	0.2619137
A09	35863639	35872293	A09p39600.2_BraZ1	774.667	-	28	1042	8654	0.1204067
A09	35867383	35868464	A09p39610.2_BraZ1	261	-	0	0	1081	0.0000000
A09	35881860	35893817	A09p39620.2_BraZ1	714	-	165	4075	11957	0.3408045
A09	35899318	35901407	A09p39630.2_BraZ1	213	+	156	1473	2089	0.7051221
A09	35903564	35904176	A09p39640.2_BraZ1	210	-	4	99	612	0.1617647
A09	35903847	35904504	A09p39650.2_BraZ1	345	-	2	135	657	0.2054795
A09	35921103	35923072	A09p39660.2_BraZ1	276	-	2	116	1969	0.0589132
A09	35921235	35922757	A09p39670.2_BraZ1	624	-	2	116	1522	0.0762155
A09	35953734	35954421	A09p39680.2_BraZ1	171	+	4	302	687	0.4395924
A09	35953953	36094169	A09p39690.2_BraZ1	170.625	-	10382	58673	140216	0.4184473
A09	35992097	35992830	A09p39700.2_BraZ1	423	-	33	461	733	0.6289222
A09	35996948	36003539	A09p39710.2_BraZ1	366	-	83	3173	6591	0.4814140
A09	36003296	36004859	A09p39720.2_BraZ1	285	+	27	670	1563	0.4286628
A09	36027367	36089089	A09p39730.2_BraZ1	663	-	5472	23111	61722	0.3744370
A09	36027996	36031932	A09p39740.2_BraZ1	408	-	53	841	3936	0.2136687
A09	36066953	36068169	A09p39750.2_BraZ1	456	-	18	811	1216	0.6669408
A09	36068510	36069780	A09p39760.2_BraZ1	1890	-	37	817	1270	0.6433071
A09	36084652	36093779	A09p39770.2_BraZ1	720	-	43	1118	9127	0.1224937
A09	36094307	36096734	A09p39780.2_BraZ1	227.5	-	91	1248	2427	0.5142151
A09	36094682	36095256	A09p39790.2_BraZ1	38.1	+	25	530	574	0.9233450
A09	36100767	36101449	A09p39800.2_BraZ1	345	-	2240	602	682	0.8826979
A09	36107253	36110108	A09p39810.2_BraZ1	693	-	32	826	2855	0.2893170
A09	36111342	36111555	A09p39820.2_BraZ1	21.3	-	6	153	213	0.7183099
A09	36143279	36143993	A09p39830.2_BraZ1	1998	-	1	45	714	0.0630252
A09	36144212	36144917	A09p39840.2_BraZ1	417	-	0	0	705	0.0000000
A09	36145435	36145636	A09p39850.2_BraZ1	20.1	-	8	169	201	0.8407960
A09	36146591	36147161	A09p39860.2_BraZ1	222	+	0	0	570	0.0000000
A09	36149166	36149588	A09p39870.2_BraZ1	126	+	2	46	422	0.1090047
A09	36149588	36149919	A09p39880.2_BraZ1	231	-	0	0	331	0.0000000
A09	36312595	36313911	A09p39890.2_BraZ1	318	-	112	1175	1316	0.8928571
A09	36369788	36370490	A09p39900.2_BraZ1	171	-	10	493	702	0.7022792
A09	36375955	36377643	A09p39910.2_BraZ1	424	-	142	1378	1688	0.8163507
A09	36381177	36382679	A09p39920.2_BraZ1	477	-	279	1487	1502	0.9900133
A09	36412468	36415693	A09p39930.2_BraZ1	732	+	338	2899	3225	0.8989148
A09	36419315	36420077	A09p39940.2_BraZ1	243	+	11	477	762	0.6259843
A09	36428849	36432779	A09p39950.2_BraZ1	655.667	+	83	1830	3930	0.4656489
A09	36439547	36440211	A09p39960.2_BraZ1	57.3	+	5	416	664	0.6265060
A09	36443561	36445308	A09p39970.2_BraZ1	249	-	49	679	1747	0.3886663
A09	36444243	36444852	A09p39980.2_BraZ1	207	+	7	77	609	0.1264368
A09	36448666	36452508	A09p39990.2_BraZ1	867.6	+	130	1381	3842	0.3594482
A09	36450075	36454180	A09p40000.2_BraZ1	399	-	75	1439	4105	0.3505481
A09	36464391	36483061	A09p40010.2_BraZ1	832.5	+	324	7917	18670	0.4240493
A09	36473400	36473930	A09p40020.2_BraZ1	234	-	11	403	530	0.7603773
A09	36492264	36496831	A09p40030.2_BraZ1	1182	+	99	2446	4567	0.5355814
A09	36494884	36495165	A09p40040.2_BraZ1	201	-	14	281	281	1.0000000
A09	36510067	36522286	A09p40050.2_BraZ1	234	-	434	6702	12219	0.5484900
A09	36511262	36522669	A09p40060.2_BraZ1	102	+	457	5965	11407	0.5229245
A09	36522074	36527993	A09p40070.2_BraZ1	225	+	431	3981	5919	0.6725798
A09	36522669	36527650	A09p40080.2_BraZ1	747	+	297	3386	4981	0.6797832
A09	36649771	36650836	A09p40090.2_BraZ1	312	-	20	697	1065	0.6544601
A09	36651825	36663710	A09p40100.2_BraZ1	408	-	259	5711	11885	0.4805217
A09	36663145	36663933	A09p40110.2_BraZ1	336	-	2	106	788	0.1345178
A09	36686561	36686873	A09p40120.2_BraZ1	28.2	+	3	158	312	0.5064102
A09	36762667	36762889	A09p40130.2_BraZ1	22.2	-	116	165	222	0.7432432
A09	36807187	36899684	A09p40140.2_BraZ1	441	-	1938	31278	92497	0.3381515
A09	36881967	36885926	A09p40150.2_BraZ1	411	-	263	2618	3959	0.6612781
A09	36929217	36929724	A09p40160.2_BraZ1	50.1	-	0	0	507	0.0000000
A09	36942350	36942973	A09p40170.2_BraZ1	333	-	48	279	623	0.4478331
A09	36942693	36942991	A09p40180.2_BraZ1	153	-	1	60	298	0.2013423
A09	36979674	36980587	A09p40190.2_BraZ1	432	+	3	219	913	0.2398686
A09	36997635	37002888	A09p40200.2_BraZ1	1035	+	43	1379	5253	0.2625166
A09	36998242	36999324	A09p40210.2_BraZ1	267	-	1	57	1082	0.0526802
A09	36999430	37002113	A09p40220.2_BraZ1	501	-	35	801	2683	0.2985464
A09	37003193	37036925	A09p40230.2_BraZ1	390	+	1266	11567	33732	0.3429088
A09	37010624	37011279	A09p40240.2_BraZ1	474	-	0	0	655	0.0000000
A09	37017654	37023716	A09p40250.2_BraZ1	708	+	285	3222	6062	0.5315077
A09	37040872	37041262	A09p40260.2_BraZ1	39	+	2	159	390	0.4076923
A09	37042927	37043353	A09p40270.2_BraZ1	354	-	0	0	426	0.0000000
A09	37151420	37176900	A09p40280.2_BraZ1	249	+	393	7210	25480	0.2829670
A09	37209920	37210866	A09p40290.2_BraZ1	576	-	6	553	946	0.5845666
A09	37622915	37623730	A09p40300.2_BraZ1	303	+	6	513	815	0.6294479
A09	37743996	37748514	A09p40310.2_BraZ1	528	+	4	402	4518	0.0889774
A09	37755129	37755671	A09p40320.2_BraZ1	396	+	0	0	542	0.0000000
A09	37781937	37786668	A09p40330.2_BraZ1	1047	+	19	1072	4731	0.2265906
A09	37782853	37785344	A09p40340.2_BraZ1	132	-	5	453	2491	0.1818547
A09	37797873	37803014	A09p40350.2_BraZ1	618.75	+	188	966	5141	0.1879012
A09	37803004	37806256	A09p40360.2_BraZ1	295.5	+	9	599	3252	0.1841943
A09	37811051	37814710	A09p40370.2_BraZ1	480	-	38	1475	3659	0.4031156
A09	37814819	37816470	A09p40380.2_BraZ1	606	+	16	434	1651	0.2628710
A09	37923701	37924268	A09p40390.2_BraZ1	240	+	3	179	567	0.3156967
A09	38003111	38003261	A09p40400.2_BraZ1	15	-	0	0	150	0.0000000
A09	38118283	38122376	A09p40410.2_BraZ1	192	-	110	2011	4093	0.4913267
A09	38118322	38122089	A09p40420.2_BraZ1	564.667	+	110	1894	3767	0.5027874
A09	38122089	38122745	A09p40430.2_BraZ1	444	+	1	78	656	0.1189024
A09	38131278	38153909	A09p40440.2_BraZ1	1073.14	+	203	6339	22631	0.2801025
A09	38154256	38172378	A09p40450.2_BraZ1	1845	+	377	8182	18122	0.4514954
A09	38165665	38166906	A09p40460.2_BraZ1	135	+	15	645	1241	0.5197421
A09	38173055	38173961	A09p40470.2_BraZ1	276	+	52	672	906	0.7417219
A09	38229715	38244698	A09p40480.2_BraZ1	196.3	+	693	5707	14983	0.3808984
A09	38244698	38245109	A09p40490.2_BraZ1	41.1	+	2	108	411	0.2627737
A09	38245192	38255613	A09p40500.2_BraZ1	1503	-	909	5347	10421	0.5130985
A09	38252112	38252703	A09p40510.2_BraZ1	201	-	119	323	591	0.5465313
A09	38256273	38256974	A09p40520.2_BraZ1	171	+	38	449	701	0.6405135
A09	38256482	38345522	A09p40530.2_BraZ1	189	-	1236	21742	89040	0.2441824
A09	38301589	38302532	A09p40540.2_BraZ1	1125	+	39	569	943	0.6033934
A09	38302903	38303278	A09p40550.2_BraZ1	291	+	10	325	375	0.8666667
A09	38318033	38322078	A09p40560.2_BraZ1	106.5	+	33	456	4045	0.1127318
A09	38342007	38345176	A09p40570.2_BraZ1	888	-	24	1006	3169	0.3174503
A09	38356028	38367615	A09p40580.2_BraZ1	1664.7	-	171	3078	11587	0.2656425
A09	38376098	38377920	A09p40590.2_BraZ1	1296	+	12	574	1822	0.3150384
A09	38390392	38391555	A09p40600.2_BraZ1	481	+	8	255	1163	0.2192605
A09	38400903	38405856	A09p40610.2_BraZ1	1314	+	223	3032	4953	0.6121542
A09	38405832	38406256	A09p40620.2_BraZ1	168	-	38	424	424	1.0000000
A09	38439050	38439203	A09p40630.2_BraZ1	15.3	-	0	0	153	0.0000000
A09	38740051	38745722	A09p40640.2_BraZ1	489	+	126	2824	5671	0.4979721
A09	38748302	38749295	A09p40650.2_BraZ1	183	+	14	529	993	0.5327291
A09	38852150	38854468	A09p40660.2_BraZ1	525	+	508	1953	2318	0.8425367
A09	38907490	38908269	A09p40670.2_BraZ1	360	+	49	484	779	0.6213094
A09	38915056	38916384	A09p40680.2_BraZ1	234	+	79	1177	1328	0.8862952
A09	38983518	38985347	A09p40690.2_BraZ1	183	+	73	903	1829	0.4937124
A09	38997321	38998283	A09p40700.2_BraZ1	201	+	144	754	962	0.7837838
A09	39021316	39027042	A09p40710.2_BraZ1	687	+	54	1330	5726	0.2322738
A09	39021443	39025873	A09p40720.2_BraZ1	153	-	38	722	4430	0.1629797
A09	39027940	39031197	A09p40730.2_BraZ1	510	+	21	931	3257	0.2858459
A09	39040142	39041891	A09p40740.2_BraZ1	510	+	82	1122	1749	0.6415094
A09	39051796	39055966	A09p40750.2_BraZ1	651	-	913	3979	4170	0.9541966
A09	39052118	39055664	A09p40760.2_BraZ1	1035	-	848	3395	3546	0.9574168
A09	39056012	39056791	A09p40770.2_BraZ1	249	-	80	779	779	1.0000000
A09	39072489	39083304	A09p40780.2_BraZ1	435	+	1182	9443	10815	0.8731391
A09	39089920	39093504	A09p40790.2_BraZ1	604.5	+	667	3390	3584	0.9458705
A09	39145961	39164836	A09p40800.2_BraZ1	228	-	3629	15227	18875	0.8067285
A09	39148478	39161066	A09p40810.2_BraZ1	252	-	1685	10857	12588	0.8624881
A09	39196107	39196728	A09p40820.2_BraZ1	486	-	52	612	621	0.9855072
A09	39196671	39197582	A09p40830.2_BraZ1	396	+	135	911	911	1.0000000
A09	39196719	39197305	A09p40840.2_BraZ1	144	+	123	586	586	1.0000000
A09	39221300	39235367	A09p40850.2_BraZ1	468	-	653	7730	14067	0.5495130
A09	39222699	39224186	A09p40860.2_BraZ1	86.1	-	96	1349	1487	0.9071957
A09	39233996	39236913	A09p40870.2_BraZ1	1551	+	54	1628	2917	0.5581077
A09	39251852	39259305	A09p40880.2_BraZ1	1710	+	427	4962	7453	0.6657722
A09	39257468	39259406	A09p40890.2_BraZ1	210	+	114	1808	1938	0.9329205
A09	39266526	39267896	A09p40900.2_BraZ1	192	-	46	993	1370	0.7248175
A09	39272636	39272843	A09p40910.2_BraZ1	20.7	-	60	207	207	1.0000000
A09	39282272	39287198	A09p40920.2_BraZ1	188.25	-	466	3756	4926	0.7624848
A09	39335515	39381490	A09p40930.2_BraZ1	324	-	10221	30586	45975	0.6652746
A09	39395495	39396693	A09p40940.2_BraZ1	489	-	440	1198	1198	1.0000000
A09	39398104	39398488	A09p40950.2_BraZ1	249	-	114	384	384	1.0000000
A09	39426229	39480852	A09p40960.2_BraZ1	645	+	6176	35360	54623	0.6473464
A09	39480244	39481043	A09p40970.2_BraZ1	222	+	81	695	799	0.8698373
A09	39487150	39552061	A09p40980.2_BraZ1	1428	-	10194	50744	64911	0.7817473
A09	39488693	39491785	A09p40990.2_BraZ1	657	+	41	1361	3092	0.4401682
A09	39540442	39541927	A09p41000.2_BraZ1	423	-	205	1007	1485	0.6781145
A09	39554667	39683660	A09p41010.2_BraZ1	435	-	36562	91636	128993	0.7103952
A09	39557206	39660041	A09p41020.2_BraZ1	570	-	35560	75584	102835	0.7350027
A09	39594883	39595051	A09p41030.2_BraZ1	147	-	91	168	168	1.0000000
A09	39600426	39607094	A09p41040.2_BraZ1	366	-	612	5951	6668	0.8924715
A09	39651668	39651971	A09p41050.2_BraZ1	150	+	6	44	303	0.1452145
A09	39651739	39652350	A09p41060.2_BraZ1	567	+	8	195	611	0.3191489
A09	39683825	39685394	A09p41070.2_BraZ1	510	-	240	1538	1569	0.9802422
A09	39713607	39716365	A09p41080.2_BraZ1	1155	+	47	1026	2758	0.3720087
A09	39734519	39734825	A09p41090.2_BraZ1	30.6	+	114	306	306	1.0000000
A09	39802364	39803406	A09p41100.2_BraZ1	339	-	39	772	1042	0.7408829
A09	39808989	39818820	A09p41110.2_BraZ1	1028.86	-	356	4718	9831	0.4799105
A09	39810201	39810817	A09p41120.2_BraZ1	333	-	16	179	616	0.2905844
A09	39819314	39828528	A09p41130.2_BraZ1	837.25	-	250	5493	9214	0.5961580
A09	39860479	39861532	A09p41140.2_BraZ1	444	-	3	197	1053	0.1870845
A09	39864652	39881078	A09p41150.2_BraZ1	1308.27	-	60	1802	16426	0.1097041
A09	39881078	39881840	A09p41160.2_BraZ1	553.091	-	0	0	762	0.0000000
A09	39881897	39882207	A09p41170.2_BraZ1	309	+	0	0	310	0.0000000
A09	39887537	39899119	A09p41180.2_BraZ1	1725.2	-	85	2410	11582	0.2080815
A09	39908236	39908533	A09p41190.2_BraZ1	135	-	0	0	297	0.0000000
A09	39908533	39909690	A09p41200.2_BraZ1	636	-	0	0	1157	0.0000000
A09	39914098	39919705	A09p41210.2_BraZ1	1957.5	-	293	4602	5607	0.8207598
A09	39936141	39948660	A09p41220.2_BraZ1	1689	-	253	4708	12519	0.3760684
A09	39942843	39948814	A09p41230.2_BraZ1	240	+	94	1765	5971	0.2955954
A09	39943302	39944623	A09p41240.2_BraZ1	309	-	3	196	1321	0.1483724
A09	39955738	39956815	A09p41250.2_BraZ1	513	-	2	181	1077	0.1680594
A09	39955955	39957404	A09p41260.2_BraZ1	309	+	4	284	1449	0.1959972
A09	39959802	39962295	A09p41270.2_BraZ1	906	+	46	806	2493	0.3233052
A09	39970778	39976193	A09p41280.2_BraZ1	1188	+	41	719	5415	0.1327793
A09	40010404	40010951	A09p41290.2_BraZ1	393	-	1	91	547	0.1663620
A09	40057092	40065892	A09p41300.2_BraZ1	366	-	82	2325	8800	0.2642045
A09	40062830	40065982	A09p41310.2_BraZ1	687	-	25	728	3152	0.2309645
A09	40070487	40071283	A09p41320.2_BraZ1	282	+	8	221	796	0.2776382
A09	40125790	40126896	A09p41330.2_BraZ1	273	+	3	146	1106	0.1320072
A09	40138996	40181653	A09p41340.2_BraZ1	831	-	895	15659	42657	0.3670910
A09	40214676	40230702	A09p41350.2_BraZ1	732	-	2023	8968	16026	0.5595906
A09	40759384	40778191	A09p41360.2_BraZ1	765	+	993	11461	18807	0.6094007
A09	40806821	40807164	A09p41370.2_BraZ1	30.9	-	67	281	343	0.8192420
A09	40807223	40807656	A09p41380.2_BraZ1	25.5	-	57	433	433	1.0000000
A09	40828084	40839386	A09p41390.2_BraZ1	948	-	273	4088	11302	0.3617059
A09	40830665	40831862	A09p41400.2_BraZ1	501	+	5	313	1197	0.2614870
A09	40838856	40839587	A09p41410.2_BraZ1	47.1	-	69	597	731	0.8166895
A09	40858981	40862534	A09p41420.2_BraZ1	972	-	884	3534	3553	0.9946524
A09	40906174	40913086	A09p41430.2_BraZ1	675	-	2155	5982	6912	0.8654514
A09	41106562	41106986	A09p41440.2_BraZ1	33.3	+	37	418	424	0.9858491
A09	44684826	44685653	A09p41450.2_BraZ1	588	+	18	32	827	0.0386941
A09	44686402	44686576	A09p41460.2_BraZ1	17.4	+	295	174	174	1.0000000
A09	44838809	44839066	A09p41470.2_BraZ1	231	-	3	92	257	0.3579766
A09	44843192	44843876	A09p41480.2_BraZ1	276	+	3605	684	684	1.0000000
A09	44861247	44861544	A09p41490.2_BraZ1	29.7	-	2024	297	297	1.0000000
A09	44862302	44873656	A09p41500.2_BraZ1	438.75	-	11428	7572	11354	0.6669015
A09	44872879	44874226	A09p41510.2_BraZ1	462.5	-	9131	1347	1347	1.0000000
A09	44908242	44908757	A09p41520.2_BraZ1	228	-	3250	497	515	0.9650486
A09	45019109	45020019	A09p41530.2_BraZ1	450	+	572	910	910	1.0000000
A09	45020061	45021405	A09p41540.2_BraZ1	134.4	+	187	932	1344	0.6934524
A09	45023752	45023935	A09p41550.2_BraZ1	18.3	-	347	183	183	1.0000000
A09	45086200	45086461	A09p41560.2_BraZ1	14.7	+	35	208	261	0.7969348
A09	45109566	45110432	A09p41570.2_BraZ1	480	-	409	866	866	1.0000000
A09	45110454	45110781	A09p41580.2_BraZ1	32.7	-	185	327	327	1.0000000
A09	45113892	45115542	A09p41590.2_BraZ1	622.917	+	117	1466	1650	0.8884848
A09	45129946	45131180	A09p41600.2_BraZ1	585	+	220	1036	1234	0.8395462
A09	45130614	45132984	A09p41610.2_BraZ1	510.3	+	1337	2194	2370	0.9257384
A09	45143355	45143730	A09p41620.2_BraZ1	37.5	+	532	375	375	1.0000000
A09	45144070	45144898	A09p41630.2_BraZ1	3150	+	594	828	828	1.0000000
A09	45154534	45155234	A09p41640.2_BraZ1	252	-	36	345	700	0.4928571
A09	45285788	45286267	A09p41650.2_BraZ1	33	+	252	457	479	0.9540710
A09	45318507	45321382	A09p41660.2_BraZ1	172.2	+	31	752	2875	0.2615652
A09	45325904	45326177	A09p41670.2_BraZ1	186	-	1	33	273	0.1208791
A09	45332237	45338883	A09p41680.2_BraZ1	345.6	-	16	436	6646	0.0656034
A09	45339889	45340969	A09p41690.2_BraZ1	108	+	0	0	1080	0.0000000
A09	45474942	45475174	A09p41700.2_BraZ1	17.4	-	31	232	232	1.0000000
A09	45476809	45477202	A09p41710.2_BraZ1	27.6	+	57	393	393	1.0000000
A09	45479600	45480320	A09p41720.2_BraZ1	384	+	68	548	720	0.7611111
A09	45480179	45483377	A09p41730.2_BraZ1	279.818	+	107	1785	3198	0.5581614
A09	45484182	45493594	A09p41740.2_BraZ1	330	+	534	5188	9412	0.5512112
A09	45491164	45491863	A09p41750.2_BraZ1	69.9	-	41	507	699	0.7253219
A09	45495359	45496052	A09p41760.2_BraZ1	55.5	-	0	0	693	0.0000000
A09	45531088	45531352	A09p41770.2_BraZ1	26.4	-	0	0	264	0.0000000
A09	45531961	45532711	A09p41780.2_BraZ1	633	+	0	0	750	0.0000000
A09	45533466	45535527	A09p41790.2_BraZ1	608.802	-	17	74	2061	0.0359049
A09	45561465	45564339	A09p41800.2_BraZ1	150.3	+	0	0	2874	0.0000000
A09	45564508	45564685	A09p41810.2_BraZ1	14.4	+	2	138	177	0.7796610
A09	45575182	45581825	A09p41820.2_BraZ1	345.6	-	2	143	6643	0.0215264
A09	45582832	45583912	A09p41830.2_BraZ1	108	+	2	150	1080	0.1388889
A09	45718953	45719346	A09p41840.2_BraZ1	27.6	+	4	49	393	0.1246819
A09	45722007	45722728	A09p41850.2_BraZ1	367.5	+	179	721	721	1.0000000
A09	45722686	45725782	A09p41860.2_BraZ1	524.25	+	109	2373	3096	0.7664729
A09	45733573	45738460	A09p41870.2_BraZ1	702	-	14	408	4887	0.0834868
A09	45735661	45736003	A09p41880.2_BraZ1	34.2	+	2	186	342	0.5438597
A09	45759054	45759645	A09p41890.2_BraZ1	564	+	2	121	591	0.2047377
A09	45765247	45765511	A09p41900.2_BraZ1	26.4	-	438	264	264	1.0000000
A09	45766120	45766867	A09p41910.2_BraZ1	630	+	3	72	747	0.0963855
A09	45767621	45769760	A09p41920.2_BraZ1	1094.4	-	0	0	2139	0.0000000
A09	45797846	45800710	A09p41930.2_BraZ1	153	+	2	35	2864	0.0122207
A09	45805227	45805500	A09p41940.2_BraZ1	186	-	23	115	273	0.4212454
A09	45808782	45810466	A09p41950.2_BraZ1	1254	+	0	0	1684	0.0000000
A09	45814135	45815215	A09p41960.2_BraZ1	108	+	0	0	1080	0.0000000
A09	45834597	45845323	A09p41970.2_BraZ1	771	+	168	3106	10726	0.2895767
A09	45846146	45847631	A09p41980.2_BraZ1	693	+	48	909	1485	0.6121212
A09	45855687	45857195	A09p41990.2_BraZ1	51.3529	-	0	0	1508	0.0000000
A09	45858128	45858656	A09p42000.2_BraZ1	177.618	-	0	0	528	0.0000000
A09	45862035	45862397	A09p42010.2_BraZ1	222	+	0	0	362	0.0000000
A09	45865211	45867346	A09p42020.2_BraZ1	544.914	-	0	0	2135	0.0000000
A09	45873270	45873642	A09p42030.2_BraZ1	37.2	-	233	372	372	1.0000000
A09	46007738	46008131	A09p42040.2_BraZ1	39.3	+	57	393	393	1.0000000
A09	46010793	46012715	A09p42050.2_BraZ1	379.2	+	308	912	1922	0.4745057
A09	46014214	46019213	A09p42060.2_BraZ1	489	-	133	1309	4999	0.2618524
A09	46020597	46020939	A09p42070.2_BraZ1	34.2	+	0	0	342	0.0000000
A09	46027262	46030876	A09p42080.2_BraZ1	288.333	+	78	695	3614	0.1923077
A09	46028693	46029325	A09p42090.2_BraZ1	474	+	0	0	632	0.0000000
A09	46037214	46037556	A09p42100.2_BraZ1	34.2	+	0	0	342	0.0000000
A09	46039300	46039996	A09p42110.2_BraZ1	69.6	-	237	696	696	1.0000000
A09	46051830	46053230	A09p42120.2_BraZ1	513	+	278	1345	1400	0.9607143
A09	46067951	46068696	A09p42130.2_BraZ1	378	+	27	258	745	0.3463087
A09	46069462	46071064	A09p42140.2_BraZ1	428.674	-	0	0	1602	0.0000000
A09	46098931	46101799	A09p42150.2_BraZ1	169.5	+	64	832	2868	0.2900976
A09	46109876	46111576	A09p42160.2_BraZ1	1599	+	0	0	1700	0.0000000
A09	46115230	46116310	A09p42170.2_BraZ1	108	+	4	389	1080	0.3601852
A09	46135688	46146413	A09p42180.2_BraZ1	771	+	154	4122	10725	0.3843357
A09	46147236	46148721	A09p42190.2_BraZ1	693	+	64	819	1485	0.5515152
A09	46150887	46151205	A09p42200.2_BraZ1	31.8	+	411	318	318	1.0000000
A09	46151789	46153054	A09p42210.2_BraZ1	393	+	367	1265	1265	1.0000000
A09	46153882	46155320	A09p42220.2_BraZ1	1216.8	+	78	865	1438	0.6015299
A09	46157115	46157736	A09p42230.2_BraZ1	477	+	138	494	621	0.7954912
A09	46168490	46170000	A09p42240.2_BraZ1	29.1	-	120	1243	1510	0.8231788
A09	46170932	46171460	A09p42250.2_BraZ1	178.841	-	0	0	528	0.0000000
A09	46172530	46172638	A09p42260.2_BraZ1	10.8	+	71	108	108	1.0000000
A09	46174839	46175202	A09p42270.2_BraZ1	210	+	0	0	363	0.0000000
A09	46178018	46180157	A09p42280.2_BraZ1	1107.86	-	0	0	2139	0.0000000
A09	46181721	46203407	A09p42290.2_BraZ1	396	+	81785	15095	21686	0.6960712
A09	46183334	46184592	A09p42300.2_BraZ1	903	+	680	1232	1258	0.9793323
A09	46186916	46187862	A09p42310.2_BraZ1	816	+	83	770	946	0.8139535
A09	46187814	46188691	A09p42320.2_BraZ1	3729	+	85	803	877	0.9156215
A09	46210246	46212852	A09p42330.2_BraZ1	1365	+	179	1871	2606	0.7179586
A09	46214264	46214928	A09p42340.2_BraZ1	54.3	+	16	345	664	0.5195783
A09	46230642	46231851	A09p42350.2_BraZ1	1350	+	13	561	1209	0.4640199
A09	46231890	46232345	A09p42360.2_BraZ1	585	+	14	294	455	0.6461539
A09	46290317	46291753	A09p42370.2_BraZ1	306	+	457	1316	1436	0.9164345
A09	46554229	46555049	A09p42380.2_BraZ1	597	+	12	784	820	0.9560975
A09	46690105	46709756	A09p42390.2_BraZ1	186	-	3805	12737	19651	0.6481604
A09	46700073	46711779	A09p42400.2_BraZ1	625.167	-	4102	7972	11706	0.6810183
A09	46714001	46714792	A09p42410.2_BraZ1	282	+	648	791	791	1.0000000
A09	46717896	46720802	A09p42420.2_BraZ1	1650.61	-	124	1522	2906	0.5237440
A09	46728539	46730357	A09p42430.2_BraZ1	517.922	+	427	1628	1818	0.8954896
A09	46738763	46741911	A09p42440.2_BraZ1	477	+	2015	3045	3148	0.9672808
A09	46742549	46742699	A09p42450.2_BraZ1	15	-	25	79	150	0.5266666
A09	46743627	46744607	A09p42460.2_BraZ1	1054	+	149	900	980	0.9183673
A09	46745524	46745749	A09p42470.2_BraZ1	22.5	-	2712	225	225	1.0000000
A09	46749545	46752200	A09p42480.2_BraZ1	441	-	678	2329	2655	0.8772128
A09	46772953	46775708	A09p42490.2_BraZ1	1088.63	-	215	1604	2755	0.5822142
A09	46820325	46820685	A09p42500.2_BraZ1	36	+	10	96	360	0.2666667
A09	46821022	46822069	A09p42510.2_BraZ1	104.7	-	1190	844	1047	0.8061127
A09	46826406	46826820	A09p42520.2_BraZ1	229.5	+	0	0	414	0.0000000
A09	46828206	46828620	A09p42530.2_BraZ1	229.5	+	0	0	414	0.0000000
A09	46832950	46834080	A09p42540.2_BraZ1	982.8	-	129	634	1130	0.5610619
A09	46850441	46851501	A09p42550.2_BraZ1	648	+	494	1060	1060	1.0000000
A09	46870660	46871019	A09p42560.2_BraZ1	282	+	201	359	359	1.0000000
A09	46871019	46877160	A09p42570.2_BraZ1	231	+	4156	5575	6141	0.9078326
A09	46878665	46878984	A09p42580.2_BraZ1	237	+	291	319	319	1.0000000
A09	46879212	46880503	A09p42590.2_BraZ1	609	+	705	783	1291	0.6065066
A09	46894849	46895230	A09p42600.2_BraZ1	38.1	+	241	381	381	1.0000000
A09	46897392	46897659	A09p42610.2_BraZ1	237	-	587	267	267	1.0000000
A09	46901397	46902459	A09p42620.2_BraZ1	106.2	+	37	558	1062	0.5254237
A09	46919522	46920378	A09p42630.2_BraZ1	693	-	1094	840	856	0.9813084
A09	46947363	46948305	A09p42640.2_BraZ1	543	+	426	592	942	0.6284501
A09	46961942	46963397	A09p42650.2_BraZ1	839.367	+	55	894	1455	0.6144330
A09	46966638	46966959	A09p42660.2_BraZ1	16.8	+	456	321	321	1.0000000
A09	46970635	46971794	A09p42670.2_BraZ1	733.6	-	470	1111	1159	0.9585850
A09	47011638	47012015	A09p42680.2_BraZ1	204	+	324	377	377	1.0000000
A09	47017258	47019023	A09p42690.2_BraZ1	864	-	277	1373	1765	0.7779037
A09	47044857	47045401	A09p42700.2_BraZ1	369	-	424	499	544	0.9172794
A09	47048685	47049474	A09p42710.2_BraZ1	366	-	1186	789	789	1.0000000
A09	47053630	47054744	A09p42720.2_BraZ1	783.692	-	33	871	1114	0.7818671
A09	47059101	47059760	A09p42730.2_BraZ1	360	+	1505	659	659	1.0000000
A09	47065762	47067609	A09p42740.2_BraZ1	1095	-	356	960	1847	0.5197618
A09	47068043	47068230	A09p42750.2_BraZ1	11.7	-	24	187	187	1.0000000
A09	47079134	47079862	A09p42760.2_BraZ1	135	-	732	728	728	1.0000000
A09	47098593	47098821	A09p42770.2_BraZ1	22.8	+	3	132	228	0.5789474
A09	47107958	47108584	A09p42780.2_BraZ1	159	+	958	608	626	0.9712460
A09	47129348	47130319	A09p42790.2_BraZ1	774	+	481	959	971	0.9876416
A09	47130641	47130842	A09p42800.2_BraZ1	12.6	+	349	201	201	1.0000000
A09	47148197	47150458	A09p42810.2_BraZ1	1322.75	-	377	1547	2261	0.6842105
A09	47170000	47170483	A09p42820.2_BraZ1	288	-	25	262	483	0.5424430
A09	47200029	47200218	A09p42830.2_BraZ1	18.9	-	113	189	189	1.0000000
A09	47201317	47202907	A09p42840.2_BraZ1	421.667	+	576	1519	1590	0.9553459
A09	47213813	47217584	A09p42850.2_BraZ1	1560.74	+	1053	2369	3771	0.6282153
A09	47218858	47223085	A09p42860.2_BraZ1	212.1	+	2132	3180	4227	0.7523066
A09	47223384	47225610	A09p42870.2_BraZ1	1221	-	2642	2226	2226	1.0000000
A09	47227528	47229556	A09p42880.2_BraZ1	1284.73	+	598	1984	2028	0.9783037
A09	47231447	47231782	A09p42890.2_BraZ1	22.5	-	265	335	335	1.0000000
A09	47232451	47233399	A09p42900.2_BraZ1	448.875	-	632	948	948	1.0000000
A09	47233930	47234601	A09p42910.2_BraZ1	182.6	+	76	145	671	0.2160954
A09	47234810	47235133	A09p42920.2_BraZ1	59	+	113	248	323	0.7678019
A09	47241340	47242769	A09p42930.2_BraZ1	929.25	+	277	1202	1429	0.8411477
A09	47283389	47284742	A09p42940.2_BraZ1	135.3	-	592	1279	1353	0.9453067
A09	47292258	47292769	A09p42950.2_BraZ1	330	+	267	511	511	1.0000000
A09	47295144	47311849	A09p42960.2_BraZ1	3342.27	-	16218	13874	16705	0.8305298
A09	47313704	47314210	A09p42970.2_BraZ1	42.9	+	963	449	506	0.8873518
A09	47315974	47317328	A09p42980.2_BraZ1	104.7	+	3350	1301	1354	0.9608567
A09	47322047	47322325	A09p42990.2_BraZ1	22.3636	-	233	278	278	1.0000000
A09	47322500	47323587	A09p43000.2_BraZ1	300	-	671	1087	1087	1.0000000
A09	47331342	47334390	A09p43010.2_BraZ1	1463.25	-	2589	3007	3048	0.9865485
A09	47337374	47337533	A09p43020.2_BraZ1	15.9	+	17	92	159	0.5786164
A09	47338645	47341772	A09p43030.2_BraZ1	1956	-	685	2472	3127	0.7905341
A09	47346360	47347759	A09p43040.2_BraZ1	115.8	-	1500	1399	1399	1.0000000
A09	47358646	47361178	A09p43050.2_BraZ1	253.2	-	101	1347	2532	0.5319905
A09	47372018	47373455	A09p43060.2_BraZ1	411.75	+	222	946	1437	0.6583160
A09	47387163	47388766	A09p43070.2_BraZ1	1452	+	556	1414	1603	0.8820961
A09	47389378	47395138	A09p43080.2_BraZ1	3877.15	-	700	3892	5760	0.6756945
A09	47395181	47395997	A09p43090.2_BraZ1	309	-	563	816	816	1.0000000
A09	47429001	47429109	A09p43100.2_BraZ1	10.8	-	114	108	108	1.0000000
A09	47429230	47431096	A09p43110.2_BraZ1	945	-	1324	1866	1866	1.0000000
A09	47435927	47436853	A09p43120.2_BraZ1	413	-	12	338	926	0.3650108
A09	47437691	47438760	A09p43130.2_BraZ1	360	-	160	858	1069	0.8026193
A09	47443712	47444123	A09p43140.2_BraZ1	41.1	+	76	337	411	0.8199514
A09	47470448	47472378	A09p43150.2_BraZ1	2426.67	+	541	1702	1930	0.8818653
A09	47475418	47477742	A09p43160.2_BraZ1	1510.5	-	190	1543	2324	0.6639415
A09	47490305	47492047	A09p43170.2_BraZ1	10089	-	562	1592	1742	0.9138921
A09	47497960	47500109	A09p43180.2_BraZ1	1405.16	-	604	1562	2149	0.7268497
A09	47524332	47524497	A09p43190.2_BraZ1	16.2	-	319	165	165	1.0000000
A09	47526926	47528947	A09p43200.2_BraZ1	192	+	1420	1954	2021	0.9668481
A09	47533229	47535841	A09p43210.2_BraZ1	201	+	531	2590	2612	0.9915773
A09	47543105	47543406	A09p43220.2_BraZ1	156	+	95	301	301	1.0000000
A09	47549779	47552257	A09p43230.2_BraZ1	1420.4	-	1013	2252	2478	0.9087974
A09	47552095	47554929	A09p43240.2_BraZ1	868.846	-	1125	1986	2834	0.7007763
A09	47558587	47558965	A09p43250.2_BraZ1	195	+	715	378	378	1.0000000
A09	47563405	47568383	A09p43260.2_BraZ1	1242	+	1938	3430	4978	0.6890317
A09	47569221	47572277	A09p43270.2_BraZ1	1800.48	-	1534	2951	3056	0.9656414
A09	47572659	47573107	A09p43280.2_BraZ1	360	-	395	448	448	1.0000000
A09	47574663	47574897	A09p43290.2_BraZ1	23.4	-	81	229	234	0.9786325
A09	47596688	47598410	A09p43300.2_BraZ1	956.333	-	269	1266	1722	0.7351916
A09	47599445	47601648	A09p43310.2_BraZ1	893.613	+	1534	2075	2203	0.9418974
A09	47612730	47614511	A09p43320.2_BraZ1	1335	+	158	1344	1781	0.7546322
A09	47633800	47636532	A09p43330.2_BraZ1	377.4	+	1090	2571	2732	0.9410688
A09	47636981	47638572	A09p43340.2_BraZ1	1036	-	535	1414	1591	0.8887492
A09	47648244	47649615	A09p43350.2_BraZ1	2095.88	+	824	1317	1371	0.9606127
A09	47650205	47651133	A09p43360.2_BraZ1	519	+	397	928	928	1.0000000
A09	47651434	47653317	A09p43370.2_BraZ1	1032	-	741	1870	1883	0.9930961
A09	47654808	47655442	A09p43380.2_BraZ1	468	+	2	132	634	0.2082019
A09	47657465	47658357	A09p43390.2_BraZ1	555.333	-	824	855	892	0.9585202
A09	47659490	47660243	A09p43400.2_BraZ1	75.3	+	155	753	753	1.0000000
A09	47660295	47660970	A09p43410.2_BraZ1	67.5	+	148	647	675	0.9585185
A09	47664336	47664831	A09p43420.2_BraZ1	49.5	-	290	495	495	1.0000000
A09	47665831	47666706	A09p43430.2_BraZ1	792	+	79	502	875	0.5737143
A09	47667520	47668378	A09p43440.2_BraZ1	85.8	+	68	734	858	0.8554779
A09	47668918	47686461	A09p43450.2_BraZ1	915.739	-	8903	15981	17543	0.9109616
A09	47688848	47689104	A09p43460.2_BraZ1	186	+	16	108	256	0.4218750
A09	47688848	47689214	A09p43470.2_BraZ1	150	+	25	218	366	0.5956284
A09	47700076	47700265	A09p43480.2_BraZ1	18.9	+	186	189	189	1.0000000
A09	47716378	47719298	A09p43490.2_BraZ1	1131.99	-	27370	2177	2920	0.7455480
A09	47730270	47730691	A09p43500.2_BraZ1	237	+	283	421	421	1.0000000
A09	47733107	47734539	A09p43510.2_BraZ1	818.049	+	377	1310	1432	0.9148045
A09	47734820	47735396	A09p43520.2_BraZ1	417	-	295	576	576	1.0000000
A09	47741841	47742260	A09p43530.2_BraZ1	282	+	20	370	419	0.8830549
A09	47742260	47747343	A09p43540.2_BraZ1	7154.88	+	2333	4570	5083	0.8990753
A09	47748852	47749377	A09p43550.2_BraZ1	231	-	472	525	525	1.0000000
A09	47752497	47753452	A09p43560.2_BraZ1	891	-	24	435	955	0.4554974
A09	47762959	47764182	A09p43570.2_BraZ1	963	+	656	1128	1223	0.9223222
A09	47764494	47766769	A09p43580.2_BraZ1	1878	-	118	1281	2275	0.5630769
A09	47771027	47782633	A09p43590.2_BraZ1	191.25	+	11158	11606	11606	1.0000000
A09	47772240	47772707	A09p43600.2_BraZ1	264	-	505	467	467	1.0000000
A09	47788721	47790362	A09p43610.2_BraZ1	375.375	-	1634	1641	1641	1.0000000
A09	47796180	47796732	A09p43620.2_BraZ1	55.2	-	112	509	552	0.9221014
A09	47826094	47830771	A09p43630.2_BraZ1	2733.13	+	755	3448	4677	0.7372247
A09	47831858	47836467	A09p43640.2_BraZ1	1757.81	-	1384	3920	4609	0.8505099
A09	47842555	47844134	A09p43650.2_BraZ1	144	-	157	1276	1579	0.8081064
A09	47846706	47846862	A09p43660.2_BraZ1	15.6	+	16	21	156	0.1346154
A09	47853621	47854619	A09p43670.2_BraZ1	495	+	563	998	998	1.0000000
A09	47855377	47856488	A09p43680.2_BraZ1	687	+	323	1060	1111	0.9540954
A09	47857549	47858498	A09p43690.2_BraZ1	801	+	250	792	949	0.8345627
A09	47869676	47870188	A09p43700.2_BraZ1	660	+	1169	409	512	0.7988281
A09	47892185	47895067	A09p43710.2_BraZ1	1806	+	96	1690	2882	0.5863984
A09	47902500	47903097	A09p43720.2_BraZ1	59.7	+	10	19	597	0.0318258
A09	47914463	47915520	A09p43730.2_BraZ1	8442	+	777	1057	1057	1.0000000
A09	47917051	47918167	A09p43740.2_BraZ1	111.6	+	71	548	1116	0.4910394
A09	47920029	47920548	A09p43750.2_BraZ1	51.9	+	239	519	519	1.0000000
A09	47921087	47922668	A09p43760.2_BraZ1	156.6	-	174	1168	1581	0.7387729
A09	47922985	47926249	A09p43770.2_BraZ1	1874.57	+	1255	3263	3264	0.9996936
A09	47951182	47955791	A09p43780.2_BraZ1	512.909	-	3545	4482	4609	0.9724452
A09	47961081	47969326	A09p43790.2_BraZ1	402	-	5959	8179	8245	0.9919952
A09	47963694	47964273	A09p43800.2_BraZ1	429	-	362	579	579	1.0000000
A09	47970267	47970642	A09p43810.2_BraZ1	37.5	-	336	375	375	1.0000000
A09	47977294	47989143	A09p43820.2_BraZ1	402	-	4844	10200	11849	0.8608322
A09	48001602	48004118	A09p43830.2_BraZ1	1721.21	-	365	1784	2516	0.7090620
A09	48025686	48025986	A09p43840.2_BraZ1	30	-	144	300	300	1.0000000
A09	48031327	48033024	A09p43850.2_BraZ1	950.893	-	262	1536	1697	0.9051267
A09	48060505	48061607	A09p43860.2_BraZ1	528	+	472	1102	1102	1.0000000
A09	48061983	48063779	A09p43870.2_BraZ1	1075.98	-	801	1635	1796	0.9103563
A09	48069948	48070194	A09p43880.2_BraZ1	24.6	-	163	246	246	1.0000000
A09	48072833	48073079	A09p43890.2_BraZ1	24.6	-	3	127	246	0.5162601
A09	48075714	48075960	A09p43900.2_BraZ1	24.6	-	118	246	246	1.0000000
A09	48078537	48078822	A09p43910.2_BraZ1	28.5	-	15	242	285	0.8491228
A09	48081430	48081676	A09p43920.2_BraZ1	24.6	-	2	130	246	0.5284553
A09	48084294	48084540	A09p43930.2_BraZ1	24.6	-	2	77	246	0.3130081
A09	48087202	48087410	A09p43940.2_BraZ1	13.5	-	82	208	208	1.0000000
A09	48090073	48090319	A09p43950.2_BraZ1	24.6	-	128	246	246	1.0000000
A09	48092970	48093216	A09p43960.2_BraZ1	24.6	-	81	246	246	1.0000000
A09	48110088	48110518	A09p43970.2_BraZ1	177	+	328	430	430	1.0000000
A09	48110617	48112073	A09p43980.2_BraZ1	594.182	+	220	1219	1456	0.8372253
A09	48119931	48121247	A09p43990.2_BraZ1	1044	-	62	560	1316	0.4255319
A09	48134762	48135020	A09p44000.2_BraZ1	25.8	-	743	258	258	1.0000000
A09	48145809	48146016	A09p44010.2_BraZ1	20.7	-	1765	207	207	1.0000000
A09	48148130	48148646	A09p44020.2_BraZ1	282	-	200	516	516	1.0000000
A09	48149230	48149455	A09p44030.2_BraZ1	22.5	+	159	225	225	1.0000000
A09	48158848	48160636	A09p44040.2_BraZ1	1617	+	670	1715	1788	0.9591722
A09	48174343	48176671	A09p44050.2_BraZ1	186.9	+	581	2190	2328	0.9407216
A09	48182218	48184907	A09p44060.2_BraZ1	892.306	-	1949	2689	2689	1.0000000
A09	48186097	48186293	A09p44070.2_BraZ1	183	+	184	196	196	1.0000000
A09	48190982	48192424	A09p44080.2_BraZ1	345.15	+	1397	1442	1442	1.0000000
A09	48196956	48197981	A09p44090.2_BraZ1	681	-	328	993	1025	0.9687805
A09	48199640	48200818	A09p44100.2_BraZ1	133.636	-	410	1138	1178	0.9660441
A09	48215625	48216846	A09p44110.2_BraZ1	122.1	+	296	744	1221	0.6093366
A09	48217538	48218567	A09p44120.2_BraZ1	78	+	49	399	1029	0.3877551
A09	48219248	48220277	A09p44130.2_BraZ1	102.9	+	12	452	1029	0.4392614
A09	48224446	48224991	A09p44140.2_BraZ1	304.023	-	73	312	545	0.5724770
A09	48230272	48233476	A09p44150.2_BraZ1	345	-	1916	3204	3204	1.0000000
A09	48234455	48251718	A09p44160.2_BraZ1	1050.13	+	12646	16607	17263	0.9619997
A09	48254055	48257701	A09p44170.2_BraZ1	1386.67	+	12369	3646	3646	1.0000000
A09	48258886	48260835	A09p44180.2_BraZ1	750	-	2986	1949	1949	1.0000000
A09	48269708	48272381	A09p44190.2_BraZ1	360	-	432	2414	2673	0.9031051
A09	48273188	48279328	A09p44200.2_BraZ1	1214.12	+	3037	5717	6140	0.9311075
A09	48280328	48281510	A09p44210.2_BraZ1	118.2	+	628	1182	1182	1.0000000
A09	48289637	48289742	A09p44220.2_BraZ1	10.5	-	121	105	105	1.0000000
A09	48291708	48291879	A09p44230.2_BraZ1	17.1	+	401	171	171	1.0000000
A09	48293555	48293763	A09p44240.2_BraZ1	19.2	+	65	208	208	1.0000000
A09	48300439	48301610	A09p44250.2_BraZ1	5070	+	894	1171	1171	1.0000000
A09	48307273	48307900	A09p44260.2_BraZ1	62.7	-	308	627	627	1.0000000
A09	48318010	48331554	A09p44270.2_BraZ1	486	+	40024	13544	13544	1.0000000
A09	48333119	48335550	A09p44280.2_BraZ1	1917	+	228	1827	2431	0.7515426
A09	48340949	48341873	A09p44290.2_BraZ1	531.667	+	418	924	924	1.0000000
A09	48348917	48351312	A09p44300.2_BraZ1	3267	+	1770	2395	2395	1.0000000
A09	48361198	48361450	A09p44310.2_BraZ1	25.2	-	64	252	252	1.0000000
A09	48369550	48370329	A09p44320.2_BraZ1	249	+	554	779	779	1.0000000
A09	48370140	48370840	A09p44330.2_BraZ1	270	-	414	700	700	1.0000000
A09	48375442	48375643	A09p44340.2_BraZ1	20.1	+	26	170	201	0.8457711
A09	48384105	48385591	A09p44350.2_BraZ1	246	-	293	1328	1486	0.8936743
A09	48384343	48385015	A09p44360.2_BraZ1	1587.5	-	141	595	672	0.8854167
A09	48389615	48390748	A09p44370.2_BraZ1	519.444	+	1245	1133	1133	1.0000000
A09	48395019	48395522	A09p44380.2_BraZ1	303	+	1081	503	503	1.0000000
A09	48395491	48396229	A09p44390.2_BraZ1	135	+	1320	738	738	1.0000000
A09	48396420	48401627	A09p44400.2_BraZ1	1167	+	3675	5207	5207	1.0000000
A09	48398435	48398971	A09p44410.2_BraZ1	30.6	+	265	536	536	1.0000000
A09	48401823	48403027	A09p44420.2_BraZ1	471	-	565	1204	1204	1.0000000
A09	48403435	48416740	A09p44430.2_BraZ1	3117	-	7319	12499	13305	0.9394213
A09	48406268	48407452	A09p44440.2_BraZ1	630	-	489	1184	1184	1.0000000
A09	48419987	48422361	A09p44450.2_BraZ1	191.4	-	1324	2374	2374	1.0000000
A09	48420769	48421464	A09p44460.2_BraZ1	225	+	340	695	695	1.0000000
A09	48447779	48455826	A09p44470.2_BraZ1	3178.71	-	1214	6391	8047	0.7942090
A09	48472086	48472952	A09p44480.2_BraZ1	231	+	4	152	866	0.1755196
A09	48475069	48477401	A09p44490.2_BraZ1	360	+	258	2197	2332	0.9421098
A09	48479965	48481976	A09p44500.2_BraZ1	1044.29	+	1329	1996	2011	0.9925410
A09	48482272	48482623	A09p44510.2_BraZ1	35.1	+	335	351	351	1.0000000
A09	48485016	48485250	A09p44520.2_BraZ1	23.4	-	59	215	234	0.9188034
A09	48491153	48492996	A09p44530.2_BraZ1	144.6	+	562	1400	1843	0.7596310
A09	48493552	48497658	A09p44540.2_BraZ1	2417.78	-	809	3472	4106	0.8455918
A09	48502118	48502819	A09p44550.2_BraZ1	735	-	261	701	701	1.0000000
A09	48507912	48509707	A09p44560.2_BraZ1	924	+	1576	1795	1795	1.0000000
A09	48512110	48514765	A09p44570.2_BraZ1	1063.46	+	337	1450	2655	0.5461394
A09	48519091	48522029	A09p44580.2_BraZ1	240	-	2122	2906	2938	0.9891083
A09	48529840	48530032	A09p44590.2_BraZ1	19.2	+	250	192	192	1.0000000
A09	48530230	48530332	A09p44600.2_BraZ1	10.2	-	388	102	102	1.0000000
A09	48534914	48536714	A09p44610.2_BraZ1	1070.11	+	221	1177	1800	0.6538889
A09	48544999	48545218	A09p44620.2_BraZ1	21.9	+	408	219	219	1.0000000
A09	48565788	48566121	A09p44630.2_BraZ1	33.3	-	20	236	333	0.7087087
A09	48570322	48571096	A09p44640.2_BraZ1	339	-	127	719	774	0.9289406
A09	48572636	48573409	A09p44650.2_BraZ1	519	-	745	773	773	1.0000000
A09	48574829	48575732	A09p44660.2_BraZ1	90.3	-	126	802	903	0.8881506
A09	48584146	48585645	A09p44670.2_BraZ1	5586	+	413	1425	1499	0.9506338
A09	48588539	48589099	A09p44680.2_BraZ1	219.818	-	344	448	560	0.8000000
A09	48590546	48592851	A09p44690.2_BraZ1	1542.17	+	490	1643	2305	0.7127982
A09	48601220	48601541	A09p44700.2_BraZ1	234	-	80	321	321	1.0000000
A09	48619959	48622970	A09p44710.2_BraZ1	559.125	-	1174	3011	3011	1.0000000
A09	48631834	48632863	A09p44720.2_BraZ1	630.517	+	27	524	1029	0.5092323
A09	48635150	48641204	A09p44730.2_BraZ1	420	-	3628	5952	6054	0.9831516
A09	48645709	48646223	A09p44740.2_BraZ1	522.6	-	271	514	514	1.0000000
A09	48646592	48648398	A09p44750.2_BraZ1	511.826	+	510	1588	1806	0.8792912
A09	48655294	48655654	A09p44760.2_BraZ1	258	+	122	360	360	1.0000000
A09	48656522	48656825	A09p44770.2_BraZ1	2160	-	217	303	303	1.0000000
A09	48661497	48661863	A09p44780.2_BraZ1	201	-	233	366	366	1.0000000
A09	48667232	48667738	A09p44790.2_BraZ1	417	-	291	492	506	0.9723320
A09	48670944	48673364	A09p44800.2_BraZ1	29928	+	566	2026	2420	0.8371901
A09	48673793	48674599	A09p44810.2_BraZ1	711	+	130	646	806	0.8014888
A09	48675118	48676607	A09p44820.2_BraZ1	4319.25	-	732	1489	1489	1.0000000
A09	48678045	48679394	A09p44830.2_BraZ1	669.565	-	783	1349	1349	1.0000000
A09	48687599	48687732	A09p44840.2_BraZ1	12.9	-	377	133	133	1.0000000
A09	48687851	48688635	A09p44850.2_BraZ1	490.226	+	605	784	784	1.0000000
A09	48688944	48689253	A09p44860.2_BraZ1	30.9	-	257	309	309	1.0000000
A09	48727571	48727679	A09p44870.2_BraZ1	10.8	+	270	108	108	1.0000000
A09	48732437	48736639	A09p44880.2_BraZ1	1775.8	+	1169	3105	4202	0.7389339
A09	48736920	48739223	A09p44890.2_BraZ1	227.4	-	290	1498	2303	0.6504560
A09	48739586	48740383	A09p44900.2_BraZ1	414.943	-	484	797	797	1.0000000
A09	48743823	48744321	A09p44910.2_BraZ1	49.8	+	510	498	498	1.0000000
A09	48749054	48750496	A09p44920.2_BraZ1	808.4	+	1041	1442	1442	1.0000000
A09	48752281	48754318	A09p44930.2_BraZ1	1146.03	-	644	1913	2037	0.9391262
A09	48756130	48756995	A09p44940.2_BraZ1	715	-	1104	865	865	1.0000000
A09	48757375	48758349	A09p44950.2_BraZ1	83.4	-	214	906	974	0.9301848
A09	48759435	48760893	A09p44960.2_BraZ1	11946	-	1029	1452	1458	0.9958848
A09	48774437	48774920	A09p44970.2_BraZ1	48.3	+	640	483	483	1.0000000
A09	48777810	48778144	A09p44980.2_BraZ1	945	-	745	334	334	1.0000000
A09	48778741	48779479	A09p44990.2_BraZ1	507	-	343	738	738	1.0000000
A09	48787414	48790281	A09p45000.2_BraZ1	1515	+	1180	2678	2867	0.9340774
A09	48791093	48792012	A09p45010.2_BraZ1	73.5	-	347	801	919	0.8715996
A09	48792714	48794304	A09p45020.2_BraZ1	747.939	-	1016	1590	1590	1.0000000
A09	48794608	48795551	A09p45030.2_BraZ1	576	+	655	943	943	1.0000000
A09	48800708	48801002	A09p45040.2_BraZ1	29.4	+	410	294	294	1.0000000
A09	48808801	48809182	A09p45050.2_BraZ1	38.1	+	808	381	381	1.0000000
A09	48812637	48813465	A09p45060.2_BraZ1	24	-	739	828	828	1.0000000
A09	48820874	48824659	A09p45070.2_BraZ1	896.912	+	1961	3676	3785	0.9712021
A09	48835062	48836354	A09p45080.2_BraZ1	352	-	17	360	1292	0.2786378
A09	48854235	48855843	A09p45090.2_BraZ1	35.7	+	2265	1608	1608	1.0000000
A09	48867084	48867822	A09p45100.2_BraZ1	73.8	-	131	705	738	0.9552845
A09	48869165	48871434	A09p45110.2_BraZ1	1021.2	-	1810	2269	2269	1.0000000
A09	48890803	48894937	A09p45120.2_BraZ1	2960.33	+	359	3061	4134	0.7404451
A09	48898744	48899736	A09p45130.2_BraZ1	369	-	35	581	992	0.5856855
A09	48901152	48901480	A09p45140.2_BraZ1	189	-	334	328	328	1.0000000
A09	48903563	48905009	A09p45150.2_BraZ1	790.414	-	1567	1446	1446	1.0000000
A09	48905373	48907073	A09p45160.2_BraZ1	255.789	+	1453	1700	1700	1.0000000
A09	48908511	48911006	A09p45170.2_BraZ1	1240.03	+	1509	2395	2495	0.9599198
A09	48930559	48933367	A09p45180.2_BraZ1	1277.2	+	510	1995	2808	0.7104701
A09	48935244	48937223	A09p45190.2_BraZ1	58.5	-	1727	1979	1979	1.0000000
A09	48951788	48972490	A09p45200.2_BraZ1	486.15	+	3254	15996	20702	0.7726790
A09	48978765	48979392	A09p45210.2_BraZ1	62.7	+	42	303	627	0.4832536
A09	48989219	48989441	A09p45220.2_BraZ1	22.2	-	420	222	222	1.0000000
A09	49008666	49010798	A09p45230.2_BraZ1	872.727	-	1936	2091	2132	0.9807692
A09	49016820	49020061	A09p45240.2_BraZ1	1379.08	+	1433	3241	3241	1.0000000
A09	49020445	49025007	A09p45250.2_BraZ1	9216	-	1067	3939	4562	0.8634371
A09	49026419	49027746	A09p45260.2_BraZ1	162.75	+	21	366	1327	0.2758101
A09	49027737	49028329	A09p45270.2_BraZ1	180.8	+	255	525	592	0.8868243
A09	49031737	49034650	A09p45280.2_BraZ1	1899.57	-	302	2147	2913	0.7370409
A09	49048781	49051034	A09p45290.2_BraZ1	607.05	+	126	1097	2253	0.4869063
A09	49056604	49057119	A09p45300.2_BraZ1	297	+	51	361	515	0.7009709
A09	49069236	49070621	A09p45310.2_BraZ1	808.25	+	108	629	1385	0.4541516
A09	49082565	49083209	A09p45320.2_BraZ1	243	+	294	494	644	0.7670807
A09	49084040	49086173	A09p45330.2_BraZ1	1486.48	+	98	1602	2133	0.7510548
A09	49094574	49096282	A09p45340.2_BraZ1	1174.74	-	333	1430	1708	0.8372365
A09	49102205	49104180	A09p45350.2_BraZ1	880	+	459	1764	1975	0.8931646
A09	49108171	49110606	A09p45360.2_BraZ1	1107.15	-	555	2247	2435	0.9227926
A09	49117783	49118257	A09p45370.2_BraZ1	47.4	-	10	76	474	0.1603376
A09	49121416	49122073	A09p45380.2_BraZ1	240	-	132	597	657	0.9086758
A09	49126890	49127457	A09p45390.2_BraZ1	56.7	-	465	567	567	1.0000000
A09	49128553	49129537	A09p45400.2_BraZ1	98.4	-	72	547	984	0.5558943
A09	49134305	49135864	A09p45410.2_BraZ1	999	+	548	1523	1559	0.9769083
A09	49136568	49136951	A09p45420.2_BraZ1	267	-	245	383	383	1.0000000
A09	49138883	49139312	A09p45430.2_BraZ1	3750	+	280	429	429	1.0000000
A09	49139691	49139916	A09p45440.2_BraZ1	138	+	303	225	225	1.0000000
A09	49142102	49142576	A09p45450.2_BraZ1	47.4	-	41	267	474	0.5632911
A09	49146584	49147586	A09p45460.2_BraZ1	100.2	-	574	988	1002	0.9860280
A09	49149043	49151723	A09p45470.2_BraZ1	1592.84	-	1511	2680	2680	1.0000000
A09	49155234	49156148	A09p45480.2_BraZ1	408.25	+	423	914	914	1.0000000
A09	49170311	49172751	A09p45490.2_BraZ1	1166.6	-	271	1679	2440	0.6881148
A09	49177383	49179248	A09p45500.2_BraZ1	1788	-	509	1812	1865	0.9715818
A09	49183874	49184133	A09p45510.2_BraZ1	213	-	748	259	259	1.0000000
A09	49192501	49195915	A09p45520.2_BraZ1	2508	-	1528	2838	3414	0.8312830
A09	49200883	49201154	A09p45530.2_BraZ1	24.3	+	181	271	271	1.0000000
A09	49206464	49207027	A09p45540.2_BraZ1	43.2	-	1458	563	563	1.0000000
A09	49209736	49210407	A09p45550.2_BraZ1	240.955	+	52	448	671	0.6676602
A09	49212891	49214070	A09p45560.2_BraZ1	975	-	1086	1179	1179	1.0000000
A09	49219315	49222379	A09p45570.2_BraZ1	2448.07	-	1428	2450	3064	0.7996083
A09	49226800	49229214	A09p45580.2_BraZ1	966.15	-	435	1957	2414	0.8106877
A09	49244769	49246302	A09p45590.2_BraZ1	195	-	1792	1533	1533	1.0000000
A09	49248710	49250006	A09p45600.2_BraZ1	809.792	+	664	1296	1296	1.0000000
A09	49252611	49276777	A09p45610.2_BraZ1	1596	+	12188	21297	24166	0.8812795
A09	49276870	49277218	A09p45620.2_BraZ1	243	+	297	348	348	1.0000000
A09	49285931	49288800	A09p45630.2_BraZ1	1784.66	-	808	2568	2869	0.8950854
A09	49299749	49300520	A09p45640.2_BraZ1	4089	+	935	771	771	1.0000000
A09	49305541	49305694	A09p45650.2_BraZ1	15.3	+	100	153	153	1.0000000
A09	49320973	49321156	A09p45660.2_BraZ1	18.3	+	349	183	183	1.0000000
A09	49325440	49325661	A09p45670.2_BraZ1	13.2	+	237	221	221	1.0000000
A09	49333610	49334561	A09p45680.2_BraZ1	758.5	-	72	324	951	0.3406940
A09	49342625	49344122	A09p45690.2_BraZ1	149.7	+	243	1157	1497	0.7728791
A09	49344799	49346420	A09p45700.2_BraZ1	7536	+	224	1352	1621	0.8340530
A09	49346853	49347985	A09p45710.2_BraZ1	9300	+	501	1101	1132	0.9726148
A09	49353919	49354410	A09p45720.2_BraZ1	243	+	22	382	491	0.7780041
A09	49356622	49358008	A09p45730.2_BraZ1	138.6	+	1132	1386	1386	1.0000000
A09	49359027	49359540	A09p45740.2_BraZ1	263.5	+	810	513	513	1.0000000
A09	49365050	49370644	A09p45750.2_BraZ1	3021.91	+	4818	5183	5594	0.9265284
A09	49371120	49371634	A09p45760.2_BraZ1	28.2	-	181	514	514	1.0000000
A09	49374534	49377298	A09p45770.2_BraZ1	2011.13	-	636	2358	2764	0.8531114
A09	49396742	49396931	A09p45780.2_BraZ1	18.9	+	338	189	189	1.0000000
A09	49416914	49419455	A09p45790.2_BraZ1	2010.94	+	353	2128	2541	0.8374656
A09	49419959	49420543	A09p45800.2_BraZ1	33	+	1029	584	584	1.0000000
A09	49425774	49426361	A09p45810.2_BraZ1	652.5	+	245	556	587	0.9471891
A09	49447973	49468692	A09p45820.2_BraZ1	216	-	6703	17145	20719	0.8275014
A09	49463242	49463791	A09p45830.2_BraZ1	297	+	189	549	549	1.0000000
A09	49471932	49475885	A09p45840.2_BraZ1	2703.18	-	163	1844	3953	0.4664811
A09	49484316	49491841	A09p45850.2_BraZ1	1669.61	+	4520	6981	7525	0.9277076
A09	49487716	49488459	A09p45860.2_BraZ1	120	+	125	710	743	0.9555855
A09	49493994	49494432	A09p45870.2_BraZ1	43.8	+	572	438	438	1.0000000
A09	49495850	49496351	A09p45880.2_BraZ1	480	+	43	329	501	0.6566866
A09	49496371	49496813	A09p45890.2_BraZ1	31.2	+	7	159	442	0.3597285
A09	49497040	49498359	A09p45900.2_BraZ1	540	-	1150	916	1319	0.6944655
A09	49512764	49514090	A09p45910.2_BraZ1	132.3	+	211	1186	1326	0.8944193
A09	49514259	49519128	A09p45920.2_BraZ1	2469.27	-	2551	4830	4869	0.9919901
A09	49520983	49528010	A09p45930.2_BraZ1	2367.38	+	1084	3032	7027	0.4314786
A09	49530618	49532009	A09p45940.2_BraZ1	134.1	+	518	1322	1391	0.9503954
A09	49536178	49536469	A09p45950.2_BraZ1	29.1	+	472	291	291	1.0000000
A09	49537196	49537757	A09p45960.2_BraZ1	282	+	778	561	561	1.0000000
A09	49539505	49540818	A09p45970.2_BraZ1	4881.75	-	2003	1313	1313	1.0000000
A09	49541891	49542590	A09p45980.2_BraZ1	69.9	+	531	699	699	1.0000000
A09	49570017	49570363	A09p45990.2_BraZ1	204	+	402	346	346	1.0000000
A09	49579767	49580991	A09p46000.2_BraZ1	122.4	+	23	591	1224	0.4828431
A09	49591009	49591138	A09p46010.2_BraZ1	12.9	-	141	129	129	1.0000000
A09	49591617	49592068	A09p46020.2_BraZ1	123	-	599	451	451	1.0000000
A09	49593087	49593537	A09p46030.2_BraZ1	45	+	45	134	450	0.2977778
A09	49593697	49593925	A09p46040.2_BraZ1	22.8	+	3	43	228	0.1885965
A09	49595042	49596375	A09p46050.2_BraZ1	762	+	70	1146	1333	0.8597149
A09	49596574	49597416	A09p46060.2_BraZ1	390	-	165	680	842	0.8076010
A09	49600831	49603348	A09p46070.2_BraZ1	584.25	+	648	2387	2517	0.9483512
A09	49610707	49611094	A09p46080.2_BraZ1	82.5	+	68	387	387	1.0000000
A09	49617682	49617901	A09p46090.2_BraZ1	21.9	+	42	219	219	1.0000000
A09	49622254	49623426	A09p46100.2_BraZ1	663	+	412	1126	1172	0.9607509
A09	49629790	49630064	A09p46110.2_BraZ1	135	+	7	215	274	0.7846715
A09	49644956	49646485	A09p46120.2_BraZ1	1167	+	181	938	1529	0.6134729
A09	49651369	49651582	A09p46130.2_BraZ1	21.3	-	0	0	213	0.0000000
A09	49655500	49656444	A09p46140.2_BraZ1	441	+	672	944	944	1.0000000
A09	49658555	49659893	A09p46150.2_BraZ1	788.681	-	1611	1338	1338	1.0000000
A09	49663689	49667112	A09p46160.2_BraZ1	3117	-	631	2478	3423	0.7239264
A09	49677097	49677563	A09p46170.2_BraZ1	348	+	699	466	466	1.0000000
A09	49677542	49678637	A09p46180.2_BraZ1	386.25	+	1488	1095	1095	1.0000000
A09	49689250	49691348	A09p46190.2_BraZ1	1157.93	+	348	1665	2098	0.7936130
A09	49694690	49694909	A09p46200.2_BraZ1	21.9	+	337	219	219	1.0000000
A09	49696795	49697638	A09p46210.2_BraZ1	84.3	+	377	747	843	0.8861210
A09	49698721	49702966	A09p46220.2_BraZ1	2608.12	+	1017	3533	4245	0.8322732
A09	49703941	49705094	A09p46230.2_BraZ1	753.692	-	794	1094	1153	0.9488291
A09	49705721	49708219	A09p46240.2_BraZ1	268.795	+	1217	2176	2498	0.8710968
A09	49710903	49711382	A09p46250.2_BraZ1	381	-	595	479	479	1.0000000
A09	49712173	49712903	A09p46260.2_BraZ1	551.182	+	440	730	730	1.0000000
A09	49713002	49714869	A09p46270.2_BraZ1	1113	-	256	1380	1867	0.7391537
A09	49715664	49715958	A09p46280.2_BraZ1	28.2	-	51	294	294	1.0000000
A09	49739648	49740101	A09p46290.2_BraZ1	285	-	47	391	453	0.8631347
A09	49742830	49750241	A09p46300.2_BraZ1	436.5	-	10081	7411	7411	1.0000000
A09	49757166	49758132	A09p46310.2_BraZ1	96.6	+	220	790	966	0.8178054
A09	49793260	49796813	A09p46320.2_BraZ1	1383.84	-	126	1971	3553	0.5547425
A09	49796964	49797108	A09p46330.2_BraZ1	14.4	+	26	109	144	0.7569444
A09	49820809	49824707	A09p46340.2_BraZ1	1024.41	+	895	2709	3898	0.6949718
A09	49825458	49826182	A09p46350.2_BraZ1	63	-	516	724	724	1.0000000
A09	49828045	49828538	A09p46360.2_BraZ1	32.4	-	393	493	493	1.0000000
A09	49832520	49836445	A09p46370.2_BraZ1	530.2	+	2581	3877	3925	0.9877707
A09	49854059	49855088	A09p46380.2_BraZ1	392	-	510	1029	1029	1.0000000
A09	49857548	49859100	A09p46390.2_BraZ1	994.286	+	1200	1552	1552	1.0000000
A09	49860478	49860783	A09p46400.2_BraZ1	27.9	-	127	305	305	1.0000000
A09	49868437	49870054	A09p46410.2_BraZ1	877.7	+	853	1617	1617	1.0000000
A09	49876471	49878314	A09p46420.2_BraZ1	1275.7	+	1054	1786	1843	0.9690722
A09	49880105	49883423	A09p46430.2_BraZ1	1782	-	1428	3061	3318	0.9225437
A09	49885450	49885951	A09p46440.2_BraZ1	353.8	+	467	501	501	1.0000000
A09	49886459	49887852	A09p46450.2_BraZ1	1044	-	793	1376	1393	0.9877961
A09	49916756	49917622	A09p46460.2_BraZ1	3644.25	-	2448	866	866	1.0000000
A09	49918329	49918752	A09p46470.2_BraZ1	30.9	-	2088	423	423	1.0000000
A09	49919753	49919954	A09p46480.2_BraZ1	20.1	-	56	110	201	0.5472637
A09	49921213	49923621	A09p46490.2_BraZ1	1729.73	+	1713	2408	2408	1.0000000
A09	49930102	49935250	A09p46500.2_BraZ1	689.093	+	1817	4110	5148	0.7983683
A09	49936882	49937225	A09p46510.2_BraZ1	243	+	205	343	343	1.0000000
A09	49944514	49945408	A09p46520.2_BraZ1	89.4	-	60	446	894	0.4988814
A09	49947151	49947298	A09p46530.2_BraZ1	14.7	+	387	147	147	1.0000000
A09	49950781	49951347	A09p46540.2_BraZ1	396	-	233	566	566	1.0000000
A09	49953854	49954094	A09p46550.2_BraZ1	14.7	+	79	240	240	1.0000000
A09	49959929	49960540	A09p46560.2_BraZ1	390	-	523	611	611	1.0000000
A09	49964328	49965402	A09p46570.2_BraZ1	255	+	639	1074	1074	1.0000000
A09	49980668	49981076	A09p46580.2_BraZ1	294	-	2549	408	408	1.0000000
A09	49986135	49987311	A09p46590.2_BraZ1	117.6	-	42	473	1176	0.4022109
A09	49992439	49992766	A09p46600.2_BraZ1	261	-	3287	327	327	1.0000000
A09	49999471	50009714	A09p46610.2_BraZ1	705	-	11777	10243	10243	1.0000000
A09	50004959	50005436	A09p46620.2_BraZ1	47.7	+	1503	477	477	1.0000000
A09	50008176	50008603	A09p46630.2_BraZ1	110.25	-	732	427	427	1.0000000
A09	50013727	50014804	A09p46640.2_BraZ1	471	+	480	1077	1077	1.0000000
A09	50016069	50017245	A09p46650.2_BraZ1	117.6	-	56	325	1176	0.2763605
A09	50034907	50035639	A09p46660.2_BraZ1	570	-	616	732	732	1.0000000
A09	50049932	50051950	A09p46670.2_BraZ1	856.282	-	409	1889	2018	0.9360753
A09	50062862	50063267	A09p46680.2_BraZ1	30.3	+	0	0	405	0.0000000
A09	50095481	50098970	A09p46690.2_BraZ1	1711.98	+	1601	3474	3489	0.9957008
A09	50102199	50108587	A09p46700.2_BraZ1	2360.57	+	1731	5492	6388	0.8597370
A09	50110596	50111025	A09p46710.2_BraZ1	42.9	+	27	232	429	0.5407925
A09	50113235	50113409	A09p46720.2_BraZ1	17.4	+	151	174	174	1.0000000
A09	50114510	50114696	A09p46730.2_BraZ1	18.6	-	287	186	186	1.0000000
A09	50119723	50120566	A09p46740.2_BraZ1	84.3	+	1101	843	843	1.0000000
A09	50127362	50127734	A09p46750.2_BraZ1	37.2	-	5	241	372	0.6478494
A09	50130608	50130800	A09p46760.2_BraZ1	19.2	+	280	192	192	1.0000000
A09	50141146	50142284	A09p46770.2_BraZ1	742.304	+	410	1043	1138	0.9165202
A09	50147942	50150291	A09p46780.2_BraZ1	1605	-	522	1812	2349	0.7713921
A09	50163037	50165857	A09p46790.2_BraZ1	1373.83	+	1758	2622	2820	0.9297872
A09	50166135	50166699	A09p46800.2_BraZ1	55.8	+	35	415	564	0.7358156
A09	50171077	50173636	A09p46810.2_BraZ1	1243.77	+	269	2121	2559	0.8288394
A09	50173929	50175540	A09p46820.2_BraZ1	161.1	-	507	1611	1611	1.0000000
A09	50178271	50179855	A09p46830.2_BraZ1	158.4	-	270	1147	1584	0.7241161
A09	50183231	50183822	A09p46840.2_BraZ1	249	-	582	591	591	1.0000000
A09	50185418	50187014	A09p46850.2_BraZ1	159.6	-	1077	1596	1596	1.0000000
A09	50188884	50189340	A09p46860.2_BraZ1	324	-	429	456	456	1.0000000
A09	50195356	50195698	A09p46870.2_BraZ1	264	-	0	0	342	0.0000000
A09	50195702	50196435	A09p46880.2_BraZ1	309	-	33	261	733	0.3560709
A09	50202705	50204540	A09p46890.2_BraZ1	1593	-	768	1614	1835	0.8795640
A09	50214111	50215188	A09p46900.2_BraZ1	107.7	-	12	106	1077	0.0984215
A09	50225940	50226240	A09p46910.2_BraZ1	30	-	86	300	300	1.0000000
A09	50227312	50229287	A09p46920.2_BraZ1	333	-	1492	1975	1975	1.0000000
A09	50230851	50233787	A09p46930.2_BraZ1	872.577	-	638	2668	2936	0.9087194
A09	50235074	50236862	A09p46940.2_BraZ1	1201.76	-	1711	1788	1788	1.0000000
A09	50242206	50243045	A09p46950.2_BraZ1	1350	+	31	567	839	0.6758046
A09	50245980	50250120	A09p46960.2_BraZ1	1953.31	-	4386	4140	4140	1.0000000
A09	50313091	50314554	A09p46970.2_BraZ1	136.5	+	180	831	1463	0.5680109
A09	50316363	50318672	A09p46980.2_BraZ1	1215	-	603	2127	2309	0.9211780
A09	50332863	50336289	A09p46990.2_BraZ1	1611.59	-	543	2423	3426	0.7072387
A09	50337398	50338964	A09p47000.2_BraZ1	830.87	+	411	1559	1566	0.9955300
A09	50339766	50342020	A09p47010.2_BraZ1	1236.47	-	560	1968	2254	0.8731145
A09	50343374	50343653	A09p47020.2_BraZ1	27.9	-	75	279	279	1.0000000
A09	50350224	50350389	A09p47030.2_BraZ1	16.5	-	138	165	165	1.0000000
A09	50352164	50355731	A09p47040.2_BraZ1	2728.96	-	1797	3101	3567	0.8693580
A09	50358766	50362391	A09p47050.2_BraZ1	2243.62	+	1200	3565	3625	0.9834483
A09	50370289	50371340	A09p47060.2_BraZ1	34.8	+	250	931	1051	0.8858230
A09	50372425	50375374	A09p47070.2_BraZ1	1178.53	+	2311	2887	2949	0.9789760
A09	50375875	50378434	A09p47080.2_BraZ1	255.9	-	1013	2419	2559	0.9452911
A09	50381328	50382023	A09p47090.2_BraZ1	504	-	164	439	695	0.6316547
A09	50382884	50383519	A09p47100.2_BraZ1	56.7	+	296	526	635	0.8283464
A09	50383660	50384406	A09p47110.2_BraZ1	666	+	483	690	746	0.9249330
A09	50384980	50385505	A09p47120.2_BraZ1	52.5	+	237	477	525	0.9085714
A09	50386783	50387816	A09p47130.2_BraZ1	730.125	+	355	1029	1033	0.9961278
A09	50389507	50391566	A09p47140.2_BraZ1	1702.4	-	953	2059	2059	1.0000000
A09	50397627	50397827	A09p47150.2_BraZ1	189	+	303	200	200	1.0000000
A09	50398422	50400325	A09p47160.2_BraZ1	988.4	+	1158	1903	1903	1.0000000
A09	50400727	50402964	A09p47170.2_BraZ1	1812.14	-	1466	2209	2237	0.9874833
A09	50403701	50403915	A09p47180.2_BraZ1	19.2	+	311	214	214	1.0000000
A09	50407153	50409728	A09p47190.2_BraZ1	1585.76	-	1933	2575	2575	1.0000000
A09	50410576	50411038	A09p47200.2_BraZ1	46.2	+	320	462	462	1.0000000
A09	50413824	50415591	A09p47210.2_BraZ1	1076.05	+	1336	1705	1767	0.9649123
A09	50416839	50418014	A09p47220.2_BraZ1	386.75	+	263	1059	1175	0.9012766
A09	50424790	50429213	A09p47230.2_BraZ1	2495.58	+	1153	4054	4423	0.9165725
A09	50434926	50436827	A09p47240.2_BraZ1	2362.8	-	2277	1901	1901	1.0000000
A09	50437880	50448424	A09p47250.2_BraZ1	3034.69	-	10008	10469	10544	0.9928870
A09	50453767	50454375	A09p47260.2_BraZ1	181.731	-	438	605	608	0.9950658
A09	50459746	50460016	A09p47270.2_BraZ1	27	-	126	270	270	1.0000000
A09	50461581	50463284	A09p47280.2_BraZ1	1567.5	-	1194	1670	1703	0.9806224
A09	50464928	50467563	A09p47290.2_BraZ1	1980	-	1132	2304	2635	0.8743833
A09	50469883	50470138	A09p47300.2_BraZ1	25.5	-	20	110	255	0.4313726
A09	50471624	50473341	A09p47310.2_BraZ1	18408	-	139	1139	1717	0.6633663
A09	50480915	50481221	A09p47320.2_BraZ1	30.6	+	31	288	306	0.9411765
A09	50489720	50496819	A09p47330.2_BraZ1	4404.47	-	1655	5895	7099	0.8303986
A09	50498843	50499867	A09p47340.2_BraZ1	626.85	+	458	1024	1024	1.0000000
A09	50503439	50512224	A09p47350.2_BraZ1	4605.72	-	2688	7897	8785	0.8989186
A09	50530537	50531097	A09p47360.2_BraZ1	225	-	230	560	560	1.0000000
A09	50535172	50535936	A09p47370.2_BraZ1	363.673	-	152	488	764	0.6387435
A09	50537422	50539012	A09p47380.2_BraZ1	159	+	291	1288	1590	0.8100629
A09	50539664	50543617	A09p47390.2_BraZ1	2114.78	-	1651	3662	3953	0.9263850
A09	50545095	50545320	A09p47400.2_BraZ1	22.5	-	633	225	225	1.0000000
A09	50547251	50547692	A09p47410.2_BraZ1	44.1	-	300	441	441	1.0000000
A09	50577823	50577987	A09p47420.2_BraZ1	14.7	+	177	164	164	1.0000000
A09	50610027	50614370	A09p47430.2_BraZ1	2337.17	+	1402	4097	4343	0.9433571
A09	50619789	50620212	A09p47440.2_BraZ1	396	+	376	423	423	1.0000000
A09	50626149	50628470	A09p47450.2_BraZ1	480	-	1400	2182	2321	0.9401120
A09	50628967	50629246	A09p47460.2_BraZ1	27.9	+	339	279	279	1.0000000
A09	50634034	50636491	A09p47470.2_BraZ1	1086.98	-	949	2345	2457	0.9544160
A09	50644431	50646458	A09p47480.2_BraZ1	839.683	-	1141	1877	2027	0.9259990
A09	50647245	50649669	A09p47490.2_BraZ1	242.4	+	965	2273	2424	0.9377063
A09	50661567	50662574	A09p47500.2_BraZ1	591.6	+	94	666	1007	0.6613704
A09	50664670	50665174	A09p47510.2_BraZ1	50.4	+	28	399	504	0.7916667
A09	50668855	50673315	A09p47520.2_BraZ1	1527	+	1671	4409	4460	0.9885650
A09	50675064	50675418	A09p47530.2_BraZ1	35.4	+	1	29	354	0.0819209
A09	50689589	50691246	A09p47540.2_BraZ1	1308	+	845	1657	1657	1.0000000
A09	50697127	50699830	A09p47550.2_BraZ1	1213.4	-	993	2667	2703	0.9866815
A09	50709555	50710474	A09p47560.2_BraZ1	835.714	+	24	235	919	0.2557127
A09	50710984	50711122	A09p47570.2_BraZ1	13.8	+	0	0	138	0.0000000
A09	50716584	50716875	A09p47580.2_BraZ1	29.1	-	3	168	291	0.5773196
A09	50733519	50733747	A09p47590.2_BraZ1	22.8	+	207	228	228	1.0000000
A09	50740646	50741129	A09p47600.2_BraZ1	228	+	90	483	483	1.0000000
A09	50741772	50742684	A09p47610.2_BraZ1	507.96	+	345	652	912	0.7149123
A09	50745866	50749558	A09p47620.2_BraZ1	2368	+	1383	3492	3692	0.9458288
A09	50750415	50751794	A09p47630.2_BraZ1	601.62	-	1033	1337	1379	0.9695432
A09	50753157	50754305	A09p47640.2_BraZ1	727.375	-	730	1148	1148	1.0000000
A09	50759893	50760850	A09p47650.2_BraZ1	95.7	+	326	816	957	0.8526646
A09	50763343	50764468	A09p47660.2_BraZ1	112.5	-	636	1125	1125	1.0000000
A09	50775488	50776316	A09p47670.2_BraZ1	82.8	-	339	828	828	1.0000000
A09	50785441	50786023	A09p47680.2_BraZ1	402	-	138	511	582	0.8780069
A09	50798791	50799125	A09p47690.2_BraZ1	135	+	195	334	334	1.0000000
A09	50803029	50804842	A09p47700.2_BraZ1	189	-	2380	1813	1813	1.0000000
A09	50809662	50811557	A09p47710.2_BraZ1	1070.36	+	1419	1830	1895	0.9656992
A09	50812229	50813278	A09p47720.2_BraZ1	535.2	-	358	790	1049	0.7530982
A09	50816449	50816578	A09p47730.2_BraZ1	12.9	-	422	129	129	1.0000000
A09	50816933	50817739	A09p47740.2_BraZ1	377.018	+	2204	806	806	1.0000000
A09	50843253	50845023	A09p47750.2_BraZ1	177	-	229	1074	1770	0.6067796
A09	50871509	50872706	A09p47760.2_BraZ1	119.7	+	105	741	1197	0.6190476
A09	50888147	50888336	A09p47770.2_BraZ1	18.9	-	332	189	189	1.0000000
A09	50889588	50890913	A09p47780.2_BraZ1	1989.75	+	14	533	1325	0.4022641
A09	50920784	50921981	A09p47790.2_BraZ1	666	+	617	1196	1197	0.9991646
A09	50924188	50925455	A09p47800.2_BraZ1	1197	-	517	1258	1267	0.9928966
A09	50926278	50928143	A09p47810.2_BraZ1	1002.68	-	366	1291	1865	0.6922252
A09	50935170	50935732	A09p47820.2_BraZ1	204	+	59	366	562	0.6512455
A09	50962341	50963787	A09p47830.2_BraZ1	1302	+	538	537	1446	0.3713693
A09	50963250	50964763	A09p47840.2_BraZ1	1890	+	15	201	1513	0.1328487
A09	50964567	50965389	A09p47850.2_BraZ1	366	+	11	385	822	0.4683698
A09	50971755	50973882	A09p47860.2_BraZ1	212.7	-	367	1606	2127	0.7550541
A09	50979376	50982092	A09p47870.2_BraZ1	1730.4	+	543	2551	2716	0.9392489
A09	50982534	50983872	A09p47880.2_BraZ1	384.068	-	728	1338	1338	1.0000000
A09	50993017	50995812	A09p47890.2_BraZ1	1230	+	1584	2795	2795	1.0000000
A09	51001999	51003210	A09p47900.2_BraZ1	430.862	+	1438	1211	1211	1.0000000
A09	51004477	51005062	A09p47910.2_BraZ1	58.5	-	171	585	585	1.0000000
A09	51008778	51009552	A09p47920.2_BraZ1	77.4	+	0	0	774	0.0000000
A09	51018183	51018987	A09p47930.2_BraZ1	80.4	+	28	687	804	0.8544776
A09	51019592	51023452	A09p47940.2_BraZ1	3450.75	-	463	2404	3860	0.6227979
A09	51026298	51029185	A09p47950.2_BraZ1	1179.83	-	1553	2877	2887	0.9965362
A09	51034846	51037908	A09p47960.2_BraZ1	2030.82	+	736	2190	3062	0.7152188
A09	51038681	51039764	A09p47970.2_BraZ1	841.571	-	467	1061	1083	0.9796861
A09	51047090	51047919	A09p47980.2_BraZ1	367.714	-	1052	829	829	1.0000000
A09	51050511	51051943	A09p47990.2_BraZ1	526.848	+	1595	1432	1432	1.0000000
A09	51052309	51055166	A09p48000.2_BraZ1	1483.86	-	1351	2665	2857	0.9327967
A09	51056164	51057286	A09p48010.2_BraZ1	112.2	-	402	1118	1122	0.9964349
A09	51060763	51061606	A09p48020.2_BraZ1	84.3	-	178	769	843	0.9122183
A09	51062270	51063750	A09p48030.2_BraZ1	1416	-	947	1325	1480	0.8952703
A09	51067263	51072987	A09p48040.2_BraZ1	2625.47	+	1446	3916	5724	0.6841370
A09	51081945	51087463	A09p48050.2_BraZ1	2223.69	+	2919	5429	5518	0.9838710
A09	51089048	51089454	A09p48060.2_BraZ1	324	+	71	369	406	0.9088670
A09	51101739	51107617	A09p48070.2_BraZ1	2635.71	+	2330	5407	5878	0.9198707
A09	51108030	51109026	A09p48080.2_BraZ1	702	+	320	684	996	0.6867470
A09	51121018	51122532	A09p48090.2_BraZ1	170.625	-	1144	1514	1514	1.0000000
A09	51131119	51131536	A09p48100.2_BraZ1	41.7	+	186	417	417	1.0000000
A09	51137992	51139139	A09p48110.2_BraZ1	433.714	-	7	171	1147	0.1490846
A09	51145419	51150307	A09p48120.2_BraZ1	299.688	-	3463	2547	4888	0.5210720
A09	51154965	51156112	A09p48130.2_BraZ1	414	-	12	239	1147	0.2083697
A09	51158014	51158377	A09p48140.2_BraZ1	207	-	543	363	363	1.0000000
A09	51163438	51167309	A09p48150.2_BraZ1	1356.14	-	3942	3871	3871	1.0000000
A09	51168120	51169456	A09p48160.2_BraZ1	747	-	1025	1336	1336	1.0000000
A09	51171767	51172694	A09p48170.2_BraZ1	618.125	+	1149	927	927	1.0000000
A09	51173929	51174756	A09p48180.2_BraZ1	468.364	-	272	697	827	0.8428053
A09	51175330	51175711	A09p48190.2_BraZ1	33	-	260	381	381	1.0000000
A09	51178092	51178608	A09p48200.2_BraZ1	51.6	-	533	516	516	1.0000000
A09	51179439	51180246	A09p48210.2_BraZ1	7039.5	-	642	807	807	1.0000000
A09	51192593	51195359	A09p48220.2_BraZ1	1365.9	+	517	2346	2766	0.8481562
A09	51196911	51197505	A09p48230.2_BraZ1	59.4	+	273	594	594	1.0000000
A09	51201630	51202065	A09p48240.2_BraZ1	43.5	+	102	371	435	0.8528736
A09	51203281	51203516	A09p48250.2_BraZ1	222	-	179	235	235	1.0000000
A09	51206413	51206616	A09p48260.2_BraZ1	132	-	125	182	203	0.8965517
A09	51211646	51211880	A09p48270.2_BraZ1	23.4	+	382	234	234	1.0000000
A09	51219189	51222412	A09p48280.2_BraZ1	2253.05	+	1839	3136	3223	0.9730065
A09	51223354	51224737	A09p48290.2_BraZ1	666.9	+	573	1370	1383	0.9906002
A09	51225418	51227102	A09p48300.2_BraZ1	5906.25	-	420	1435	1684	0.8521377
A09	51235344	51240187	A09p48310.2_BraZ1	2350.08	+	976	3665	4843	0.7567623
A09	51242128	51244243	A09p48320.2_BraZ1	211.5	-	1075	2115	2115	1.0000000
A09	51261039	51262480	A09p48330.2_BraZ1	638.393	+	838	1438	1441	0.9979181
A09	51262792	51265089	A09p48340.2_BraZ1	1216.53	-	994	2255	2297	0.9817153
A09	51269849	51270234	A09p48350.2_BraZ1	29.1	+	0	0	385	0.0000000
A09	51274485	51276258	A09p48360.2_BraZ1	1044.7	-	1165	1648	1773	0.9294980
A09	51283327	51286515	A09p48370.2_BraZ1	1823.11	-	22	1014	3188	0.3180678
A09	51296795	51298614	A09p48380.2_BraZ1	10710	-	404	1801	1819	0.9901044
A09	51302641	51303991	A09p48390.2_BraZ1	135	+	335	1225	1350	0.9074074
A09	51314106	51314427	A09p48400.2_BraZ1	32.1	-	93	289	321	0.9003115
A09	51321075	51321423	A09p48410.2_BraZ1	34.8	-	1	16	348	0.0459770
A09	51324216	51325397	A09p48420.2_BraZ1	405	-	13	391	1181	0.3310754
A09	51324739	51326302	A09p48430.2_BraZ1	870	-	25	204	1563	0.1305182
A09	51333771	51334098	A09p48440.2_BraZ1	32.7	-	274	327	327	1.0000000
A09	51338030	51338923	A09p48450.2_BraZ1	789	-	333	860	893	0.9630459
A09	51349123	51349561	A09p48460.2_BraZ1	375	+	356	438	438	1.0000000
A09	51360179	51360617	A09p48470.2_BraZ1	43.8	+	26	309	438	0.7054794
A09	51361291	51361393	A09p48480.2_BraZ1	10.2	-	120	102	102	1.0000000
A09	51364725	51367230	A09p48490.2_BraZ1	1761.38	+	1519	2358	2505	0.9413174
A09	51367388	51369256	A09p48500.2_BraZ1	937.878	-	1250	1868	1868	1.0000000
A09	51372041	51372970	A09p48510.2_BraZ1	371.757	-	669	929	929	1.0000000
A09	51373257	51374211	A09p48520.2_BraZ1	95.4	+	320	901	954	0.9444444
A09	51385442	51386883	A09p48530.2_BraZ1	1153.12	+	588	1259	1441	0.8736988
A09	51388231	51394332	A09p48540.2_BraZ1	2026.46	+	3045	5826	6101	0.9549254
A09	51397105	51397347	A09p48550.2_BraZ1	108	+	237	242	242	1.0000000
A09	51410931	51411459	A09p48560.2_BraZ1	52.8	+	4	72	528	0.1363636
A09	51415716	51417018	A09p48570.2_BraZ1	130.2	-	921	1302	1302	1.0000000
A09	51418503	51419571	A09p48580.2_BraZ1	516	-	91	702	1068	0.6573034
A09	51441262	51442397	A09p48590.2_BraZ1	4872	+	29	575	1135	0.5066079
A09	51444131	51445350	A09p48600.2_BraZ1	3500	+	48	318	1219	0.2608696
A09	51451199	51453253	A09p48610.2_BraZ1	513.333	-	171	1898	2054	0.9240506
A09	51453248	51455323	A09p48620.2_BraZ1	1232.18	-	164	1910	2075	0.9204819
A09	51487565	51488700	A09p48630.2_BraZ1	4872	+	35	576	1135	0.5074890
A09	51490408	51491627	A09p48640.2_BraZ1	3150	+	30	393	1219	0.3223954
A09	51492824	51495241	A09p48650.2_BraZ1	324.188	+	230	2299	2417	0.9511791
A09	51498430	51498946	A09p48660.2_BraZ1	313.765	-	27	456	516	0.8837209
A09	51498941	51502552	A09p48670.2_BraZ1	2060.21	-	514	2834	3611	0.7848241
A09	51511164	51511500	A09p48680.2_BraZ1	33.6	+	350	336	336	1.0000000
A09	51511928	51512911	A09p48690.2_BraZ1	972	+	539	983	983	1.0000000
A09	51521308	51522440	A09p48700.2_BraZ1	827.609	+	171	940	1132	0.8303887
A09	51524287	51525514	A09p48710.2_BraZ1	1050	+	259	720	1227	0.5867971
A09	51527686	51528556	A09p48720.2_BraZ1	498	-	778	870	870	1.0000000
A09	51528707	51529424	A09p48730.2_BraZ1	345	-	966	717	717	1.0000000
A09	51544746	51545306	A09p48740.2_BraZ1	38.1	-	5	47	560	0.0839286
A09	51550442	51553154	A09p48750.2_BraZ1	1083.87	+	521	2175	2712	0.8019912
A09	51554664	51556022	A09p48760.2_BraZ1	579	+	1193	1358	1358	1.0000000
A09	51555848	51558621	A09p48770.2_BraZ1	432	+	2231	2726	2773	0.9830508
A09	51563950	51566484	A09p48780.2_BraZ1	1476.43	+	515	1897	2534	0.7486188
A09	51567094	51568328	A09p48790.2_BraZ1	654.968	-	646	1234	1234	1.0000000
A09	51577457	51578554	A09p48800.2_BraZ1	167.75	-	196	930	1097	0.8477666
A09	51597914	51598154	A09p48810.2_BraZ1	24	+	237	240	240	1.0000000
A09	51599830	51600271	A09p48820.2_BraZ1	354	-	55	402	441	0.9115646
A09	51606557	51607405	A09p48830.2_BraZ1	171.429	+	1248	848	848	1.0000000
A09	51610171	51614754	A09p48840.2_BraZ1	264	+	991	3311	4583	0.7224525
A09	51610799	51614153	A09p48850.2_BraZ1	222	-	329	2082	3354	0.6207513
A09	51611104	51612873	A09p48860.2_BraZ1	1020	-	153	951	1769	0.5375919
A09	51614469	51615787	A09p48870.2_BraZ1	186	-	1027	1318	1318	1.0000000
A09	51620005	51620932	A09p48880.2_BraZ1	92.7	+	560	792	927	0.8543689
A09	51621602	51623168	A09p48890.2_BraZ1	1425	-	752	1334	1566	0.8518519
A09	51662807	51665283	A09p48900.2_BraZ1	947.2	+	1656	2453	2476	0.9907108
A09	51686079	51687778	A09p48910.2_BraZ1	892.895	+	1443	1699	1699	1.0000000
A09	51692268	51693939	A09p48920.2_BraZ1	1851.3	-	660	1671	1671	1.0000000
A09	51695431	51697383	A09p48930.2_BraZ1	447.75	+	1612	1952	1952	1.0000000
A09	51698343	51699681	A09p48940.2_BraZ1	133.8	+	1127	1338	1338	1.0000000
A09	51700955	51703365	A09p48950.2_BraZ1	983.944	+	905	1999	2410	0.8294606
A09	51703912	51704637	A09p48960.2_BraZ1	657	+	208	605	725	0.8344827
A09	51705799	51708068	A09p48970.2_BraZ1	1046.83	-	1003	2224	2269	0.9801674
A09	51718728	51720576	A09p48980.2_BraZ1	674.286	-	1299	1774	1848	0.9599567
A09	51722794	51723014	A09p48990.2_BraZ1	19.2	-	138	220	220	1.0000000
A09	51724520	51725456	A09p49000.2_BraZ1	864	-	281	936	936	1.0000000
A09	51736853	51737267	A09p49010.2_BraZ1	41.4	+	44	335	414	0.8091788
A09	51739959	51740857	A09p49020.2_BraZ1	540	-	369	639	898	0.7115813
A09	51763641	51764310	A09p49030.2_BraZ1	66.9	+	95	537	669	0.8026906
A09	51767461	51768954	A09p49040.2_BraZ1	939	-	41	574	1493	0.3844608
A09	51778764	51781955	A09p49050.2_BraZ1	2982	-	362	2507	3191	0.7856472
A09	51790232	51797347	A09p49060.2_BraZ1	4572.4	-	2477	7016	7115	0.9860857
A09	51798298	51800678	A09p49070.2_BraZ1	579.068	+	1279	1723	2380	0.7239496
A09	51805137	51806175	A09p49080.2_BraZ1	103.8	+	4	197	1038	0.1897881
A09	51813298	51813667	A09p49090.2_BraZ1	285	+	494	369	369	1.0000000
A09	51815131	51817897	A09p49100.2_BraZ1	1757.25	-	518	2105	2766	0.7610267
A09	51825581	51825707	A09p49110.2_BraZ1	12.6	-	156	126	126	1.0000000
A09	51834611	51838349	A09p49120.2_BraZ1	495	+	3496	3735	3738	0.9991974
A09	51853288	51854136	A09p49130.2_BraZ1	618.75	-	770	848	848	1.0000000
A09	51857990	51858536	A09p49140.2_BraZ1	54.6	-	408	521	546	0.9542124
A09	51862497	51862869	A09p49150.2_BraZ1	327	-	136	372	372	1.0000000
A09	51863711	51864307	A09p49160.2_BraZ1	36	-	1294	596	596	1.0000000
A09	51867846	51870731	A09p49170.2_BraZ1	1822.67	-	1692	2731	2885	0.9466205
A09	51877141	51879981	A09p49180.2_BraZ1	1240.69	-	2137	2840	2840	1.0000000
A09	51885385	51886135	A09p49190.2_BraZ1	360.29	+	23	99	750	0.1320000
A09	51894307	51898448	A09p49200.2_BraZ1	2023.07	+	1397	3801	4141	0.9178942
A09	51921071	51922255	A09p49210.2_BraZ1	966	+	21	436	1184	0.3682432
A09	51922321	51922618	A09p49220.2_BraZ1	29.7	+	54	164	297	0.5521886
A09	51930050	51930265	A09p49230.2_BraZ1	177	-	1	95	215	0.4418605
A09	51931716	51936255	A09p49240.2_BraZ1	928.036	+	544	2506	4539	0.5521040
A09	51952295	51954219	A09p49250.2_BraZ1	7224	+	518	1598	1924	0.8305613
A09	51962337	51965700	A09p49260.2_BraZ1	423	-	1869	3307	3363	0.9833482
A09	51964090	51965007	A09p49270.2_BraZ1	630	+	580	917	917	1.0000000
A09	51973223	51976105	A09p49280.2_BraZ1	2459.86	+	858	2257	2882	0.7831367
A09	51976653	51977373	A09p49290.2_BraZ1	323.889	-	801	720	720	1.0000000
A09	51980865	51983661	A09p49300.2_BraZ1	1540.88	+	1224	2685	2796	0.9603004
A09	51984142	51985427	A09p49310.2_BraZ1	1068	+	429	944	1285	0.7346303
A09	51985915	51986032	A09p49320.2_BraZ1	11.7	+	114	117	117	1.0000000
A09	51987259	51992935	A09p49330.2_BraZ1	1095	-	4771	5548	5676	0.9774489
A09	51994002	51995124	A09p49340.2_BraZ1	112.2	-	939	1122	1122	1.0000000
A09	52013092	52013935	A09p49350.2_BraZ1	84.3	+	310	843	843	1.0000000
A09	52022331	52023060	A09p49360.2_BraZ1	72.9	-	17	188	729	0.2578875
A09	52028491	52028860	A09p49370.2_BraZ1	237	-	125	276	369	0.7479675
A09	52037218	52037942	A09p49380.2_BraZ1	387	+	232	724	724	1.0000000
A09	52038674	52040014	A09p49390.2_BraZ1	820.62	+	376	1268	1340	0.9462687
A09	52042418	52043256	A09p49400.2_BraZ1	810	-	797	838	838	1.0000000
A09	52050791	52051182	A09p49410.2_BraZ1	177	+	367	391	391	1.0000000
A09	52057365	52059849	A09p49420.2_BraZ1	1769	-	47	782	2484	0.3148148
A09	52079499	52079808	A09p49430.2_BraZ1	30.9	-	0	0	309	0.0000000
A09	52088300	52090832	A09p49440.2_BraZ1	1289.17	+	362	2242	2532	0.8854660
A09	52091015	52092830	A09p49450.2_BraZ1	813.204	-	171	1753	1815	0.9658402
A09	52096037	52099258	A09p49460.2_BraZ1	1455.15	-	1692	3106	3221	0.9642968
A09	52104570	52110300	A09p49470.2_BraZ1	118.5	+	291	1565	5730	0.2731239
A09	52108519	52109119	A09p49480.2_BraZ1	60	+	1	128	600	0.2133333
A09	52116667	52117472	A09p49490.2_BraZ1	327	-	563	805	805	1.0000000
A09	52119521	52125620	A09p49500.2_BraZ1	2115.45	-	3430	5786	6099	0.9486801
A09	52130003	52130432	A09p49510.2_BraZ1	33	+	24	303	429	0.7062937
A09	52133483	52134592	A09p49520.2_BraZ1	435	-	435	1109	1109	1.0000000
A09	52135407	52138621	A09p49530.2_BraZ1	2253.5	-	703	2967	3214	0.9231488
A09	52141145	52147570	A09p49540.2_BraZ1	592.912	+	5998	6425	6425	1.0000000
A09	52153678	52154077	A09p49550.2_BraZ1	39.9	-	67	282	399	0.7067669
A09	52157609	52158005	A09p49560.2_BraZ1	39.6	-	317	396	396	1.0000000
A09	52159780	52160176	A09p49570.2_BraZ1	39.6	-	331	396	396	1.0000000
A09	52161955	52162351	A09p49580.2_BraZ1	39.6	-	167	396	396	1.0000000
A09	52164126	52164522	A09p49590.2_BraZ1	39.6	-	107	396	396	1.0000000
A09	52166298	52166694	A09p49600.2_BraZ1	39.6	-	0	0	396	0.0000000
A09	52168470	52168866	A09p49610.2_BraZ1	39.6	-	0	0	396	0.0000000
A09	52170640	52171035	A09p49620.2_BraZ1	28.8	-	0	0	395	0.0000000
A09	52175097	52176559	A09p49630.2_BraZ1	992.25	+	1078	1462	1462	1.0000000
A09	52178741	52179026	A09p49640.2_BraZ1	28.5	+	274	285	285	1.0000000
A09	52181144	52181641	A09p49650.2_BraZ1	417	-	373	497	497	1.0000000
A09	52191351	52193611	A09p49660.2_BraZ1	2053.93	+	2000	2260	2260	1.0000000
A09	52197717	52197937	A09p49670.2_BraZ1	19.2	-	228	220	220	1.0000000
A09	52198586	52199616	A09p49680.2_BraZ1	889	-	1205	1030	1030	1.0000000
A09	52203358	52205680	A09p49690.2_BraZ1	3773	+	2515	2322	2322	1.0000000
A09	52206331	52207772	A09p49700.2_BraZ1	573.429	+	6	399	1441	0.2768911
A09	52215690	52215843	A09p49710.2_BraZ1	15.3	+	19	153	153	1.0000000
A09	52216852	52228557	A09p49720.2_BraZ1	3349.04	-	4285	10323	11705	0.8819308
A09	52228741	52228888	A09p49730.2_BraZ1	14.7	-	104	147	147	1.0000000
A09	52232758	52234359	A09p49740.2_BraZ1	1203	+	640	1601	1601	1.0000000
A09	52236112	52239167	A09p49750.2_BraZ1	427.5	+	1938	3029	3055	0.9914894
A09	52239964	52241251	A09p49760.2_BraZ1	781.773	+	695	1287	1287	1.0000000
A09	52241502	52241913	A09p49770.2_BraZ1	216	-	264	358	411	0.8710462
A09	52243196	52243903	A09p49780.2_BraZ1	384	-	219	707	707	1.0000000
A09	52246997	52247792	A09p49790.2_BraZ1	79.5	+	122	420	795	0.5283019
A09	52250119	52255459	A09p49800.2_BraZ1	570	-	1486	4349	5340	0.8144194
A09	52271553	52276300	A09p49810.2_BraZ1	3273.6	+	1187	4472	4747	0.9420687
A09	52276879	52277749	A09p49820.2_BraZ1	87	+	90	621	870	0.7137931
A09	52281367	52284469	A09p49830.2_BraZ1	1454.97	-	1162	2574	3102	0.8297873
A09	52294079	52297073	A09p49840.2_BraZ1	2260.86	+	1502	2834	2994	0.9465598
A09	52299588	52303388	A09p49850.2_BraZ1	3010.43	-	1730	3391	3800	0.8923684
A09	52309835	52312144	A09p49860.2_BraZ1	1325.94	+	1331	2119	2309	0.9177133
A09	52312688	52315126	A09p49870.2_BraZ1	1199.96	-	1474	2388	2438	0.9794914
A09	52322881	52327439	A09p49880.2_BraZ1	3021.65	-	1819	3863	4558	0.8475208
A09	52328734	52329762	A09p49890.2_BraZ1	709.211	-	372	931	1028	0.9056420
A09	52335171	52335861	A09p49900.2_BraZ1	69	+	103	652	690	0.9449275
A09	52337152	52337596	A09p49910.2_BraZ1	44.4	-	399	444	444	1.0000000
A09	52338118	52338844	A09p49920.2_BraZ1	188.906	-	335	726	726	1.0000000
A09	52340162	52342035	A09p49930.2_BraZ1	1392.37	-	187	1277	1873	0.6817939
A09	52347562	52350490	A09p49940.2_BraZ1	1360.93	-	1209	2870	2928	0.9801912
A09	52360064	52360850	A09p49950.2_BraZ1	78.6	+	653	786	786	1.0000000
A09	52362527	52364972	A09p49960.2_BraZ1	9933	-	1397	2006	2445	0.8204499
A09	52368130	52368391	A09p49970.2_BraZ1	26.1	+	27	163	261	0.6245211
A09	52374044	52374293	A09p49980.2_BraZ1	24.9	+	302	249	249	1.0000000
A09	52374322	52375413	A09p49990.2_BraZ1	387	+	862	1091	1091	1.0000000
A09	52375780	52377673	A09p50000.2_BraZ1	1530	+	401	1764	1893	0.9318542
A09	52379652	52389689	A09p50010.2_BraZ1	3363.3	-	6743	9852	10037	0.9815682
A09	52390803	52394725	A09p50020.2_BraZ1	1495.12	-	1254	3713	3922	0.9467109
A09	52397247	52399601	A09p50030.2_BraZ1	162	-	1928	2354	2354	1.0000000
A09	52401476	52405150	A09p50040.2_BraZ1	1066.15	+	2089	2835	3674	0.7716385
A09	52406235	52412421	A09p50050.2_BraZ1	2895.94	+	3325	6042	6186	0.9767216
A09	52414287	52415436	A09p50060.2_BraZ1	585.723	-	629	1149	1149	1.0000000
A09	52416797	52417111	A09p50070.2_BraZ1	237	-	11	177	314	0.5636942
A09	52418183	52419538	A09p50080.2_BraZ1	550.521	-	693	1348	1355	0.9948339
A09	52431803	52432921	A09p50090.2_BraZ1	608.348	+	692	1118	1118	1.0000000
A09	52433699	52435668	A09p50100.2_BraZ1	553.5	+	1189	1966	1969	0.9984764
A09	52436678	52437476	A09p50110.2_BraZ1	286.2	+	416	798	798	1.0000000
A09	52439130	52440535	A09p50120.2_BraZ1	818.4	+	708	1405	1405	1.0000000
A09	52441275	52442647	A09p50130.2_BraZ1	976	-	253	1325	1372	0.9657434
A09	52444427	52445748	A09p50140.2_BraZ1	879.84	+	40	539	1321	0.4080242
A09	52449565	52450403	A09p50150.2_BraZ1	131.667	+	1066	838	838	1.0000000
A09	52450819	52452728	A09p50160.2_BraZ1	15904.5	-	812	1848	1909	0.9680461
A09	52454472	52457423	A09p50170.2_BraZ1	40.8	-	2151	2951	2951	1.0000000
A09	52456095	52456671	A09p50180.2_BraZ1	57.6	+	390	576	576	1.0000000
A09	52457463	52458709	A09p50190.2_BraZ1	240	+	868	1245	1246	0.9991974
A09	52459062	52460144	A09p50200.2_BraZ1	606	-	264	1082	1082	1.0000000
A09	52461114	52462130	A09p50210.2_BraZ1	1554	-	556	940	1016	0.9251968
A09	52462660	52463446	A09p50220.2_BraZ1	40.5	-	1802	786	786	1.0000000
A09	52463527	52464204	A09p50230.2_BraZ1	636	-	1169	677	677	1.0000000
A09	52465548	52467742	A09p50240.2_BraZ1	753.626	-	1623	2194	2194	1.0000000
A09	52474533	52477004	A09p50250.2_BraZ1	836.284	+	1503	2411	2471	0.9757183
A09	52477584	52481449	A09p50260.2_BraZ1	1300.92	-	3220	3865	3865	1.0000000
A09	52485059	52486223	A09p50270.2_BraZ1	116.4	+	235	852	1164	0.7319587
A09	52487903	52488032	A09p50280.2_BraZ1	12.9	+	1	44	129	0.3410853
A09	52489031	52489205	A09p50290.2_BraZ1	17.4	-	337	174	174	1.0000000
A09	52489793	52490468	A09p50300.2_BraZ1	67.5	-	267	675	675	1.0000000
A09	52492083	52492600	A09p50310.2_BraZ1	233.438	-	525	517	517	1.0000000
A09	52496570	52523289	A09p50320.2_BraZ1	915.516	+	6203	19662	26719	0.7358809
A09	52499534	52501970	A09p50330.2_BraZ1	1326	-	498	1760	2436	0.7224959
A09	52524259	52525564	A09p50340.2_BraZ1	130.5	+	689	1131	1305	0.8666667
A09	52527939	52529114	A09p50350.2_BraZ1	694.612	+	828	1157	1175	0.9846808
A09	52530103	52530899	A09p50360.2_BraZ1	578.842	+	1570	796	796	1.0000000
A09	52532833	52539410	A09p50370.2_BraZ1	4576.84	+	2543	5189	6577	0.7889615
A09	52540548	52543626	A09p50380.2_BraZ1	880	+	2100	2893	3078	0.9398960
A09	52547284	52548675	A09p50390.2_BraZ1	291	-	618	1279	1391	0.9194824
A09	52548876	52549298	A09p50400.2_BraZ1	213	-	150	421	422	0.9976304
A09	52549645	52552332	A09p50410.2_BraZ1	1496.38	+	856	2679	2687	0.9970227
A09	52557443	52558244	A09p50420.2_BraZ1	590.625	+	192	733	801	0.9151061
A09	52558596	52561395	A09p50430.2_BraZ1	1536.68	-	1182	2799	2799	1.0000000
A09	52562762	52563122	A09p50440.2_BraZ1	36	+	12	93	360	0.2583333
A09	52566378	52575918	A09p50450.2_BraZ1	1326	+	6875	8659	9540	0.9076520
A09	52579212	52580778	A09p50460.2_BraZ1	156.6	+	438	1092	1566	0.6973180
A09	52581200	52582974	A09p50470.2_BraZ1	1158	-	482	1598	1774	0.9007892
A09	52585348	52588306	A09p50480.2_BraZ1	13652.2	+	925	2787	2958	0.9421906
A09	52594269	52596363	A09p50490.2_BraZ1	1072.67	+	71	364	2094	0.1738300
A09	52602879	52605018	A09p50500.2_BraZ1	1057.25	+	214	1552	2139	0.7255727
A09	52605187	52606393	A09p50510.2_BraZ1	144	+	293	1128	1206	0.9353234
A09	52607170	52607407	A09p50520.2_BraZ1	23.7	-	377	237	237	1.0000000
A09	52630783	52633916	A09p50530.2_BraZ1	939	-	354	2150	3133	0.6862432
A09	52645371	52646507	A09p50540.2_BraZ1	2784	-	2	20	1136	0.0176056
A09	52646957	52647129	A09p50550.2_BraZ1	12	-	0	0	172	0.0000000
A09	52652288	52654078	A09p50560.2_BraZ1	1156.73	-	532	1712	1790	0.9564246
A09	52654688	52655240	A09p50570.2_BraZ1	339	-	0	0	552	0.0000000
A09	52657571	52658144	A09p50580.2_BraZ1	57.3	-	6	75	573	0.1308901
A09	52665362	52668525	A09p50590.2_BraZ1	1623.03	-	1960	3163	3163	1.0000000
A09	52678045	52679800	A09p50600.2_BraZ1	718.808	-	1977	1755	1755	1.0000000
A09	52703707	52704364	A09p50610.2_BraZ1	312	+	96	586	657	0.8919330
A09	52704564	52705422	A09p50620.2_BraZ1	552.75	-	677	858	858	1.0000000
A09	52708006	52709143	A09p50630.2_BraZ1	113.7	+	26	435	1137	0.3825858
A09	52726698	52728789	A09p50640.2_BraZ1	1152	+	26	822	2091	0.3931133
A09	52731896	52733324	A09p50650.2_BraZ1	535.87	-	1752	1365	1428	0.9558824
A09	52746136	52746346	A09p50660.2_BraZ1	21	+	185	210	210	1.0000000
A09	52748180	52750016	A09p50670.2_BraZ1	749.1	+	1163	1836	1836	1.0000000
A09	52752868	52755632	A09p50680.2_BraZ1	1129.85	+	120	1664	2764	0.6020260
A09	52757888	52758420	A09p50690.2_BraZ1	176.7	+	38	510	532	0.9586466
A09	52772041	52772316	A09p50700.2_BraZ1	180	+	131	275	275	1.0000000
A09	52773280	52773556	A09p50710.2_BraZ1	27.6	-	215	276	276	1.0000000
A09	52775832	52777797	A09p50720.2_BraZ1	1626.86	+	1186	1965	1965	1.0000000
A09	52777873	52779128	A09p50730.2_BraZ1	222	-	376	1145	1255	0.9123506
A09	52781542	52781974	A09p50740.2_BraZ1	43.2	+	71	312	432	0.7222222
A09	52785368	52787949	A09p50750.2_BraZ1	2091	+	609	2360	2581	0.9143743
A09	52793429	52795093	A09p50760.2_BraZ1	1398	+	0	0	1664	0.0000000
A09	52797533	52798690	A09p50770.2_BraZ1	5143	+	347	1115	1157	0.9636992
A09	52804251	52809234	A09p50780.2_BraZ1	1654.01	-	3717	4983	4983	1.0000000
A09	52811111	52812055	A09p50790.2_BraZ1	9273	-	786	944	944	1.0000000
A09	52814809	52818907	A09p50800.2_BraZ1	1399.91	-	2209	4098	4098	1.0000000
A09	52824414	52824603	A09p50810.2_BraZ1	18.9	+	39	186	189	0.9841270
A09	52825457	52826145	A09p50820.2_BraZ1	162	+	109	425	688	0.6177326
A09	52826158	52826628	A09p50830.2_BraZ1	6150	+	188	422	470	0.8978723
A09	52828288	52830563	A09p50840.2_BraZ1	924.393	+	937	2211	2275	0.9718682
A09	52831334	52833488	A09p50850.2_BraZ1	1701.19	-	569	2106	2154	0.9777158
A09	52839595	52841844	A09p50860.2_BraZ1	1423.71	-	101	674	2249	0.2996888
A09	52847500	52849586	A09p50870.2_BraZ1	1803	+	459	1680	2086	0.8053691
A09	52852625	52853268	A09p50880.2_BraZ1	276	+	216	494	643	0.7682737
A09	52856183	52858432	A09p50890.2_BraZ1	181.2	+	60	730	2249	0.3245887
A09	52871946	52873473	A09p50900.2_BraZ1	152.7	+	3632	1475	1527	0.9659463
A09	52874629	52875670	A09p50910.2_BraZ1	104.1	-	11	659	1041	0.6330451
A09	52876399	52879006	A09p50920.2_BraZ1	2265	-	1421	2087	2607	0.8005370
A09	52886649	52886904	A09p50930.2_BraZ1	240	+	3	51	255	0.2000000
A09	52888825	52889752	A09p50940.2_BraZ1	1326	+	49	787	927	0.8489752
A09	52894755	52894952	A09p50950.2_BraZ1	16.8	+	269	197	197	1.0000000
A09	52898720	52898876	A09p50960.2_BraZ1	15.6	-	62	156	156	1.0000000
A09	52910874	52911183	A09p50970.2_BraZ1	30.9	+	5	104	309	0.3365696
A09	52916565	52918065	A09p50980.2_BraZ1	828	+	1532	1500	1500	1.0000000
A09	52918709	52920863	A09p50990.2_BraZ1	405	+	439	1304	2154	0.6053853
A09	52926153	52927018	A09p51000.2_BraZ1	465	+	701	865	865	1.0000000
A09	52934835	52936198	A09p51010.2_BraZ1	1511.25	-	870	1363	1363	1.0000000
A09	52945197	52945491	A09p51020.2_BraZ1	29.4	+	192	294	294	1.0000000
A09	52951898	52952522	A09p51030.2_BraZ1	62.4	+	4	19	624	0.0304487
A09	52963752	52964019	A09p51040.2_BraZ1	26.7	+	494	267	267	1.0000000
A09	52965814	52972400	A09p51050.2_BraZ1	288	+	6683	6321	6586	0.9597631
A09	52983611	52985204	A09p51060.2_BraZ1	1245	-	161	923	1593	0.5794099
A09	52989379	52991440	A09p51070.2_BraZ1	1494	-	367	1362	2061	0.6608443
A09	52996239	53001317	A09p51080.2_BraZ1	716.71	+	1392	4196	5078	0.8263096
A09	53002750	53003139	A09p51090.2_BraZ1	588	+	34	381	389	0.9794344
A09	53003390	53003615	A09p51100.2_BraZ1	22.5	+	25	225	225	1.0000000
A09	53007416	53008910	A09p51110.2_BraZ1	801.504	+	325	1277	1494	0.8547524
A09	53009524	53010633	A09p51120.2_BraZ1	1020	-	170	1056	1109	0.9522092
A09	53012801	53015975	A09p51130.2_BraZ1	1601.79	+	691	2429	3174	0.7652804
A09	53018039	53027402	A09p51140.2_BraZ1	1312.33	+	3198	7709	9363	0.8233472
A09	53024155	53024970	A09p51150.2_BraZ1	24.9	-	328	749	815	0.9190184
A09	53028177	53032254	A09p51160.2_BraZ1	2719.75	-	417	2880	4077	0.7064018
A09	53032753	53032972	A09p51170.2_BraZ1	21.9	+	165	213	219	0.9726027
A09	53035354	53038499	A09p51180.2_BraZ1	1323	-	2870	3145	3145	1.0000000
A09	53045678	53046560	A09p51190.2_BraZ1	468	-	8	123	882	0.1394558
A09	53046844	53047062	A09p51200.2_BraZ1	120	+	0	0	218	0.0000000
A09	53051290	53056148	A09p51210.2_BraZ1	2181.98	-	3000	4800	4858	0.9880610
A09	53059373	53060244	A09p51220.2_BraZ1	321	-	213	704	871	0.8082663
A09	53066280	53068186	A09p51230.2_BraZ1	432.6	+	1465	1840	1906	0.9653725
A09	53079685	53080389	A09p51240.2_BraZ1	561	+	15	568	704	0.8068182
A09	53109395	53110904	A09p51250.2_BraZ1	1038.67	+	1023	1509	1509	1.0000000
A09	53117518	53118608	A09p51260.2_BraZ1	210.857	+	1483	1090	1090	1.0000000
A09	53130829	53131945	A09p51270.2_BraZ1	111.6	-	177	906	1116	0.8118280
A09	53146049	53149360	A09p51280.2_BraZ1	1734.05	-	1131	3243	3311	0.9794624
A09	53151418	53153114	A09p51290.2_BraZ1	944.229	-	1333	1696	1696	1.0000000
A09	53154357	53155856	A09p51300.2_BraZ1	933.818	-	425	1411	1499	0.9412942
A09	53160684	53163874	A09p51310.2_BraZ1	1469.65	+	71	1031	3190	0.3231975
A09	53166077	53166381	A09p51320.2_BraZ1	138	+	60	304	304	1.0000000
A09	53166870	53167002	A09p51330.2_BraZ1	10.8	+	2	58	132	0.4393939
A09	53171818	53177678	A09p51340.2_BraZ1	2790.1	+	2045	5109	5860	0.8718430
A09	53178078	53180579	A09p51350.2_BraZ1	1339.3	-	2619	2501	2501	1.0000000
A09	53181870	53182201	A09p51360.2_BraZ1	132	-	314	331	331	1.0000000
A09	53184664	53185289	A09p51370.2_BraZ1	324	-	153	625	625	1.0000000
A09	53187757	53188189	A09p51380.2_BraZ1	43.2	-	414	432	432	1.0000000
A09	53192554	53193928	A09p51390.2_BraZ1	881.1	-	248	1365	1374	0.9934498
A09	53201736	53201921	A09p51400.2_BraZ1	14.4	+	1411	185	185	1.0000000
A09	53201937	53203095	A09p51410.2_BraZ1	648.45	+	7101	1158	1158	1.0000000
A09	53208277	53208586	A09p51420.2_BraZ1	30.9	+	24	120	309	0.3883495
A09	53210214	53211601	A09p51430.2_BraZ1	955.8	-	48	826	1387	0.5955299
A09	53214715	53215135	A09p51440.2_BraZ1	42	+	284	420	420	1.0000000
A09	53215495	53218366	A09p51450.2_BraZ1	2315.13	-	1264	2810	2871	0.9787530
A09	53218694	53219593	A09p51460.2_BraZ1	159	-	273	899	899	1.0000000
A09	53221346	53221771	A09p51470.2_BraZ1	207	-	841	425	425	1.0000000
A09	53223665	53224363	A09p51480.2_BraZ1	162	-	285	698	698	1.0000000
A09	53232348	53234211	A09p51490.2_BraZ1	186.3	-	570	1714	1863	0.9200215
A09	53248399	53249001	A09p51500.2_BraZ1	218.7	-	173	548	602	0.9102990
A09	53249469	53249869	A09p51510.2_BraZ1	33.6	-	215	324	400	0.8100000
A09	53253246	53255485	A09p51520.2_BraZ1	1008.86	+	817	2054	2239	0.9173738
A09	53255979	53256433	A09p51530.2_BraZ1	252	+	0	0	454	0.0000000
A09	53256915	53262966	A09p51540.2_BraZ1	3305.72	+	4174	5756	6051	0.9512478
A09	53263430	53264148	A09p51550.2_BraZ1	398.727	+	406	718	718	1.0000000
A09	53266444	53269550	A09p51560.2_BraZ1	1962.9	-	2554	3106	3106	1.0000000
A09	53270058	53270337	A09p51570.2_BraZ1	27.9	-	362	279	279	1.0000000
A09	53275895	53277485	A09p51580.2_BraZ1	159	-	371	1411	1590	0.8874214
A09	53283367	53283680	A09p51590.2_BraZ1	258	-	234	313	313	1.0000000
A09	53285795	53287379	A09p51600.2_BraZ1	158.4	-	391	1140	1584	0.7196970
A09	53289173	53290654	A09p51610.2_BraZ1	11508	-	914	1466	1481	0.9898717
A09	53300061	53302744	A09p51620.2_BraZ1	1534.04	+	1067	2683	2683	1.0000000
A09	53303249	53304559	A09p51630.2_BraZ1	395.938	+	600	1310	1310	1.0000000
A09	53305101	53306308	A09p51640.2_BraZ1	610.085	-	426	1200	1207	0.9942005
A09	53306754	53308311	A09p51650.2_BraZ1	155.7	+	503	1538	1557	0.9877970
A09	53308786	53310806	A09p51660.2_BraZ1	1046.18	-	604	1479	2020	0.7321782
A09	53311434	53312343	A09p51670.2_BraZ1	412.541	+	1167	909	909	1.0000000
A09	53314868	53317937	A09p51680.2_BraZ1	1388.62	+	1334	2915	3069	0.9498208
A09	53319147	53320593	A09p51690.2_BraZ1	144.6	+	480	1393	1446	0.9633471
A09	53320797	53323260	A09p51700.2_BraZ1	776.308	+	1180	2455	2463	0.9967519
A09	53327203	53328181	A09p51710.2_BraZ1	97.8	+	668	978	978	1.0000000
A09	53329035	53329389	A09p51720.2_BraZ1	35.4	+	483	354	354	1.0000000
A09	53330696	53332517	A09p51730.2_BraZ1	1359	+	1094	1767	1821	0.9703460
A09	53333056	53336110	A09p51740.2_BraZ1	1535.88	-	2017	3031	3054	0.9924689
A09	53345788	53346136	A09p51750.2_BraZ1	34.8	+	0	0	348	0.0000000
A09	53351029	53351956	A09p51760.2_BraZ1	432	+	69	628	927	0.6774542
A09	53357343	53358344	A09p51770.2_BraZ1	443.39	+	675	1001	1001	1.0000000
A09	53358848	53360923	A09p51780.2_BraZ1	984.793	-	1067	2075	2075	1.0000000
A09	53361608	53362619	A09p51790.2_BraZ1	101.1	+	257	1011	1011	1.0000000
A09	53365116	53367284	A09p51800.2_BraZ1	1950	+	827	2159	2168	0.9958487
A09	53372015	53372909	A09p51810.2_BraZ1	546	+	1632	894	894	1.0000000
A09	53373549	53374046	A09p51820.2_BraZ1	447	-	577	497	497	1.0000000
A09	53375234	53383846	A09p51830.2_BraZ1	2424	+	5282	8586	8612	0.9969810
A09	53380131	53381268	A09p51840.2_BraZ1	858	-	196	1137	1137	1.0000000
A09	53385219	53387724	A09p51850.2_BraZ1	5339.96	+	5387	2505	2505	1.0000000
A09	53388881	53389572	A09p51860.2_BraZ1	67.2	+	2254	691	691	1.0000000
A09	53389997	53392964	A09p51870.2_BraZ1	2906.72	+	6937	2967	2967	1.0000000
A09	53401221	53402151	A09p51880.2_BraZ1	625.455	-	291	930	930	1.0000000
A09	53404512	53410279	A09p51890.2_BraZ1	1680.49	+	1913	4633	5767	0.8033640
A09	53407018	53408365	A09p51900.2_BraZ1	1200	-	83	923	1347	0.6852264
A09	53413176	53416476	A09p51910.2_BraZ1	1899.65	+	804	2658	3300	0.8054546
A09	53417006	53418826	A09p51920.2_BraZ1	410.87	-	1793	1820	1820	1.0000000
A09	53419145	53420131	A09p51930.2_BraZ1	579	+	594	986	986	1.0000000
A09	53420385	53422011	A09p51940.2_BraZ1	162.6	-	458	1598	1626	0.9827798
A09	53422388	53423690	A09p51950.2_BraZ1	130.2	-	677	1255	1302	0.9639017
A09	53425194	53426367	A09p51960.2_BraZ1	117.3	-	1092	1173	1173	1.0000000
A09	53437866	53439107	A09p51970.2_BraZ1	777	+	279	974	1241	0.7848510
A09	53443238	53443876	A09p51980.2_BraZ1	528	+	419	608	638	0.9529781
A09	53446521	53448678	A09p51990.2_BraZ1	215.7	+	1260	2157	2157	1.0000000
A09	53453507	53454724	A09p52000.2_BraZ1	1107	-	1062	1217	1217	1.0000000
A09	53460368	53460572	A09p52010.2_BraZ1	20.4	-	139	204	204	1.0000000
A09	53462641	53464075	A09p52020.2_BraZ1	1191.53	-	1282	1434	1434	1.0000000
A09	53466014	53468290	A09p52030.2_BraZ1	15118.1	+	359	2011	2276	0.8835677
A09	53468940	53470635	A09p52040.2_BraZ1	824.773	+	1418	1695	1695	1.0000000
A09	53471341	53473925	A09p52050.2_BraZ1	1797.56	-	413	1964	2584	0.7600619
A09	53486892	53487522	A09p52060.2_BraZ1	63	-	77	586	630	0.9301587
A09	53498297	53500314	A09p52070.2_BraZ1	1222.57	+	123	887	2017	0.4397620
A09	53503568	53504788	A09p52080.2_BraZ1	1176	+	35	361	1220	0.2959016
A09	53505501	53506032	A09p52090.2_BraZ1	53.1	+	97	187	531	0.3521657
A09	53512196	53512376	A09p52100.2_BraZ1	18	-	14	180	180	1.0000000
A09	53512600	53514235	A09p52110.2_BraZ1	316.985	-	273	1531	1635	0.9363914
A09	53525869	53526394	A09p52120.2_BraZ1	52.5	+	32	97	525	0.1847619
A09	53529478	53529685	A09p52130.2_BraZ1	20.7	-	233	207	207	1.0000000
A09	53538945	53540259	A09p52140.2_BraZ1	131.4	-	92	903	1314	0.6872146
A09	53552542	53554056	A09p52150.2_BraZ1	603.171	+	398	1435	1514	0.9478204
A09	53567372	53568532	A09p52160.2_BraZ1	288	+	143	973	1160	0.8387931
A09	53574800	53575166	A09p52170.2_BraZ1	36.6	-	390	366	366	1.0000000
A09	53581326	53583578	A09p52180.2_BraZ1	650.417	-	1927	2252	2252	1.0000000
A09	53586115	53586280	A09p52190.2_BraZ1	16.5	-	0	0	165	0.0000000
A09	53587410	53596331	A09p52200.2_BraZ1	1160.65	+	3807	2992	8921	0.3353884
A09	53593764	53594142	A09p52210.2_BraZ1	123	+	713	378	378	1.0000000
A09	53600953	53601219	A09p52220.2_BraZ1	168	-	111	243	266	0.9135338
A09	53601684	53601849	A09p52230.2_BraZ1	16.5	-	0	0	165	0.0000000
A09	53603215	53620763	A09p52240.2_BraZ1	443.7	+	7039	12343	17548	0.7033850
A09	53621478	53629271	A09p52250.2_BraZ1	979.49	+	4424	6891	7793	0.8842551
A09	53624401	53625261	A09p52260.2_BraZ1	224	-	252	408	860	0.4744186
A09	53626519	53626906	A09p52270.2_BraZ1	114	-	363	387	387	1.0000000
A09	53627260	53627741	A09p52280.2_BraZ1	45.9	+	313	481	481	1.0000000
A09	53632326	53633882	A09p52290.2_BraZ1	889.562	+	1277	1556	1556	1.0000000
A09	53636962	53637971	A09p52300.2_BraZ1	503.125	+	52	783	1009	0.7760159
A09	53638040	53640540	A09p52310.2_BraZ1	740.51	+	1284	2458	2500	0.9832000
A09	53640815	53645573	A09p52320.2_BraZ1	2280.27	-	2244	4605	4758	0.9678437
A09	53646675	53650578	A09p52330.2_BraZ1	14991	-	1288	3558	3903	0.9116064
A09	53651945	53655640	A09p52340.2_BraZ1	270	-	499	2626	3695	0.7106901
A09	53658729	53661089	A09p52350.2_BraZ1	1844.54	+	1468	2360	2360	1.0000000
A09	53662574	53663385	A09p52360.2_BraZ1	684	+	165	798	811	0.9839704
A09	53665350	53667901	A09p52370.2_BraZ1	943.797	+	950	2466	2551	0.9666798
A09	53678479	53679414	A09p52380.2_BraZ1	423	+	531	935	935	1.0000000
A09	53683280	53684141	A09p52390.2_BraZ1	313.2	-	1553	861	861	1.0000000
A09	53686990	53687249	A09p52400.2_BraZ1	156	+	216	259	259	1.0000000
A09	53688132	53689654	A09p52410.2_BraZ1	673.909	+	619	1245	1522	0.8180026
A09	53694267	53694839	A09p52420.2_BraZ1	912	-	479	572	572	1.0000000
A09	53695727	53697161	A09p52430.2_BraZ1	411	+	639	1434	1434	1.0000000
A09	53698987	53707007	A09p52440.2_BraZ1	11102.4	+	4235	7540	8020	0.9401496
A09	53710419	53714239	A09p52450.2_BraZ1	2872.8	+	3113	3773	3820	0.9876963
A09	53715086	53716886	A09p52460.2_BraZ1	180	-	488	1724	1800	0.9577778
A09	53718050	53719775	A09p52470.2_BraZ1	172.5	-	490	1677	1725	0.9721739
A09	53727278	53728397	A09p52480.2_BraZ1	110.4	+	578	1119	1119	1.0000000
A09	53729397	53730495	A09p52490.2_BraZ1	109.2	+	270	916	1098	0.8342441
A09	53731350	53733525	A09p52500.2_BraZ1	1857.92	-	296	1062	2175	0.4882759
A09	53735791	53735947	A09p52510.2_BraZ1	15.6	+	3	55	156	0.3525641
A09	53747053	53747415	A09p52520.2_BraZ1	273	+	282	362	362	1.0000000
A09	53748082	53748774	A09p52530.2_BraZ1	50.7	+	150	598	692	0.8641618
A09	53752650	53754079	A09p52540.2_BraZ1	892.5	+	824	1413	1429	0.9888034
A09	53754338	53756411	A09p52550.2_BraZ1	1126.45	+	1716	2073	2073	1.0000000
A09	53756525	53756816	A09p52560.2_BraZ1	16.2	+	191	291	291	1.0000000
A09	53758259	53759581	A09p52570.2_BraZ1	115.8	+	335	1307	1322	0.9886535
A09	53760997	53763065	A09p52580.2_BraZ1	1333.86	+	3095	2068	2068	1.0000000
A09	53763646	53765973	A09p52590.2_BraZ1	14880	-	1100	2327	2327	1.0000000
A09	53775332	53776157	A09p52600.2_BraZ1	219.333	+	660	825	825	1.0000000
A09	53776951	53778106	A09p52610.2_BraZ1	115.5	+	549	1079	1155	0.9341992
A09	53779239	53780466	A09p52620.2_BraZ1	122.7	+	62	886	1227	0.7220864
A09	53786147	53786330	A09p52630.2_BraZ1	18.3	-	10	183	183	1.0000000
A09	53788520	53789375	A09p52640.2_BraZ1	396	-	266	828	855	0.9684210
A09	53791833	53794372	A09p52650.2_BraZ1	1040.99	+	2815	2522	2539	0.9933044
A09	53794832	53795828	A09p52660.2_BraZ1	99.6	-	60	438	996	0.4397590
A09	53797523	53799080	A09p52670.2_BraZ1	1395	+	265	1534	1557	0.9852280
A09	53800016	53806344	A09p52680.2_BraZ1	1813.1	-	3889	6307	6328	0.9966814
A09	53806575	53807641	A09p52690.2_BraZ1	984	+	313	1019	1066	0.9559100
A09	53808260	53810037	A09p52700.2_BraZ1	962.927	-	159	557	1777	0.3134496
A09	53823830	53824276	A09p52710.2_BraZ1	357	+	77	385	446	0.8632287
A09	53838919	53844519	A09p52720.2_BraZ1	241.5	+	5686	5600	5600	1.0000000
A09	53845021	53850033	A09p52730.2_BraZ1	309.3	+	6584	5012	5012	1.0000000
A09	53851573	53852387	A09p52740.2_BraZ1	1116	-	607	814	814	1.0000000
A09	53853227	53854493	A09p52750.2_BraZ1	723	-	3278	1266	1266	1.0000000
A09	53859811	53860044	A09p52760.2_BraZ1	19.8	+	289	233	233	1.0000000
A09	53862468	53863572	A09p52770.2_BraZ1	110.4	+	514	1104	1104	1.0000000
A09	53864592	53869839	A09p52780.2_BraZ1	2316.74	-	570	3951	5247	0.7530017
A09	53870331	53871902	A09p52790.2_BraZ1	1017.61	+	1004	1571	1571	1.0000000
A09	53872087	53874580	A09p52800.2_BraZ1	1356.52	-	1315	2493	2493	1.0000000
A09	53882199	53883304	A09p52810.2_BraZ1	451.714	+	425	986	1105	0.8923077
A09	53884718	53885794	A09p52820.2_BraZ1	840	+	574	1076	1076	1.0000000
A09	53886755	53887080	A09p52830.2_BraZ1	32.1	+	221	325	325	1.0000000
A09	53887080	53887374	A09p52840.2_BraZ1	180	+	473	294	294	1.0000000
A09	53887758	53888313	A09p52850.2_BraZ1	55.5	-	333	544	555	0.9801802
A09	53888313	53890119	A09p52860.2_BraZ1	315	-	257	893	1806	0.4944629
A09	53894891	53895092	A09p52870.2_BraZ1	20.1	+	0	0	201	0.0000000
A09	53895534	53902560	A09p52880.2_BraZ1	1130.5	-	3144	6573	7026	0.9355252
A09	53902890	53905449	A09p52890.2_BraZ1	747	+	1282	2336	2559	0.9128566
A09	53917240	53917664	A09p52900.2_BraZ1	252	+	249	424	424	1.0000000
A09	53920500	53921520	A09p52910.2_BraZ1	100.8	+	978	1020	1020	1.0000000
A09	53922166	53924516	A09p52920.2_BraZ1	932.342	-	2156	2350	2350	1.0000000
A09	53930537	53933291	A09p52930.2_BraZ1	1520.26	+	1260	2754	2754	1.0000000
A09	53933631	53935482	A09p52940.2_BraZ1	1551	-	1132	1851	1851	1.0000000
A09	53936822	53937355	A09p52950.2_BraZ1	411	-	129	533	533	1.0000000
A09	53938084	53939546	A09p52960.2_BraZ1	1139.62	+	321	1421	1462	0.9719563
A09	53939727	53941674	A09p52970.2_BraZ1	480.902	-	1369	1947	1947	1.0000000
A09	53964486	53964687	A09p52980.2_BraZ1	20.1	-	21	177	201	0.8805970
A09	53972368	53972569	A09p52990.2_BraZ1	20.1	-	87	150	201	0.7462686
A09	53975282	53975474	A09p53000.2_BraZ1	19.2	+	328	192	192	1.0000000
A09	53978073	53982800	A09p53010.2_BraZ1	1762.5	-	2586	4612	4727	0.9756716
A09	53985718	53986413	A09p53020.2_BraZ1	282	-	256	695	695	1.0000000
A09	54000091	54001003	A09p53030.2_BraZ1	91.2	-	523	881	912	0.9660088
A09	54004060	54006126	A09p53040.2_BraZ1	799.5	+	651	1594	2066	0.7715392
A09	54008082	54008263	A09p53050.2_BraZ1	10.5	+	291	181	181	1.0000000
A09	54008359	54009520	A09p53060.2_BraZ1	772.5	-	1335	1161	1161	1.0000000
A09	54011411	54014887	A09p53070.2_BraZ1	1878.7	+	1591	3228	3476	0.9286536
A09	54015362	54016001	A09p53080.2_BraZ1	63.9	-	156	627	639	0.9812207
A09	54017162	54017522	A09p53090.2_BraZ1	36	+	166	297	360	0.8250000
A09	54023387	54026532	A09p53100.2_BraZ1	793.8	+	563	2430	3145	0.7726550
A09	54031880	54032066	A09p53110.2_BraZ1	18.6	+	17	101	186	0.5430108
A09	54038133	54038898	A09p53120.2_BraZ1	666	-	16	432	765	0.5647059
A09	54039632	54041691	A09p53130.2_BraZ1	930.857	-	362	1034	2059	0.5021855
A09	54046999	54049049	A09p53140.2_BraZ1	360.462	-	1571	2050	2050	1.0000000
A09	54048530	54049107	A09p53150.2_BraZ1	279	-	712	577	577	1.0000000
A09	54049895	54052225	A09p53160.2_BraZ1	1548.86	-	293	1568	2330	0.6729614
A09	54054305	54069879	A09p53170.2_BraZ1	1372.11	-	11363	15109	15574	0.9701425
A09	54064648	54066439	A09p53180.2_BraZ1	594.75	-	315	1683	1791	0.9396985
A09	54071134	54071485	A09p53190.2_BraZ1	35.1	-	198	351	351	1.0000000
A09	54072578	54072764	A09p53200.2_BraZ1	108	-	21	186	186	1.0000000
A09	54076011	54078764	A09p53210.2_BraZ1	1610.24	+	1159	2169	2753	0.7878678
A09	54085328	54086559	A09p53220.2_BraZ1	115.2	+	243	1218	1231	0.9894395
A09	54087152	54087431	A09p53230.2_BraZ1	210	+	738	279	279	1.0000000
A09	54103263	54104060	A09p53240.2_BraZ1	524	+	817	797	797	1.0000000
A09	54110861	54120591	A09p53250.2_BraZ1	987	+	5047	8815	9730	0.9059609
A09	54112175	54112447	A09p53260.2_BraZ1	120	+	36	258	272	0.9485294
A09	54125232	54130982	A09p53270.2_BraZ1	803.25	+	3812	3619	5750	0.6293913
A09	54126746	54127051	A09p53280.2_BraZ1	174	+	39	210	305	0.6885246
A09	54139054	54141394	A09p53290.2_BraZ1	1173.06	+	193	1394	2340	0.5957265
A09	54142549	54144366	A09p53300.2_BraZ1	1310.4	+	628	1817	1817	1.0000000
A09	54144600	54145860	A09p53310.2_BraZ1	126	-	1342	1260	1260	1.0000000
A09	54147519	54148517	A09p53320.2_BraZ1	774	-	867	998	998	1.0000000
A09	54159749	54160988	A09p53330.2_BraZ1	2047.5	-	238	836	1239	0.6747377
A09	54179722	54182053	A09p53340.2_BraZ1	974.1	+	244	1286	2331	0.5516946
A09	54183043	54183190	A09p53350.2_BraZ1	14.7	-	42	147	147	1.0000000
A09	54186274	54187447	A09p53360.2_BraZ1	525	-	1337	1173	1173	1.0000000
A09	54193296	54194114	A09p53370.2_BraZ1	615	-	469	818	818	1.0000000
A09	54197459	54198248	A09p53380.2_BraZ1	470	+	333	789	789	1.0000000
A09	54205446	54205711	A09p53390.2_BraZ1	240	-	30	235	265	0.8867925
A09	54205711	54206662	A09p53400.2_BraZ1	765	-	153	750	951	0.7886435
A09	54207728	54209973	A09p53410.2_BraZ1	875.25	+	295	1189	2245	0.5296214
A09	54212065	54212461	A09p53420.2_BraZ1	39.6	-	621	396	396	1.0000000
A09	54214458	54218175	A09p53430.2_BraZ1	447	-	179	1510	3717	0.4062416
A09	54217333	54218854	A09p53440.2_BraZ1	115	-	10	358	1521	0.2353715
A09	54221296	54223758	A09p53450.2_BraZ1	1290.14	+	1104	2376	2462	0.9650691
A09	54224146	54225676	A09p53460.2_BraZ1	1330	-	1297	1530	1530	1.0000000
A09	54228474	54229157	A09p53470.2_BraZ1	317.1	+	517	683	683	1.0000000
A09	54229157	54229818	A09p53480.2_BraZ1	184.8	+	735	661	661	1.0000000
A09	54230158	54230599	A09p53490.2_BraZ1	44.1	-	104	410	441	0.9297052
A09	54231588	54232321	A09p53500.2_BraZ1	72.9	+	140	656	733	0.8949522
A09	54235397	54235523	A09p53510.2_BraZ1	12.6	+	0	0	126	0.0000000
A09	54237222	54238584	A09p53520.2_BraZ1	435.101	+	718	1362	1362	1.0000000
A09	54239199	54246059	A09p53530.2_BraZ1	4408.35	-	2558	6809	6860	0.9925656
A09	54247492	54248520	A09p53540.2_BraZ1	393	-	528	1028	1028	1.0000000
A09	54250745	54252878	A09p53550.2_BraZ1	1436.58	-	314	1120	2133	0.5250821
A09	54257369	54258065	A09p53560.2_BraZ1	69.6	+	194	672	696	0.9655172
A09	54270410	54272515	A09p53570.2_BraZ1	1650	-	346	1462	2105	0.6945368
A09	54276363	54280356	A09p53580.2_BraZ1	1648.94	-	1855	3026	3993	0.7578262
A09	54281401	54284125	A09p53590.2_BraZ1	1721.39	-	1282	2720	2724	0.9985316
A09	54288995	54289181	A09p53600.2_BraZ1	18.6	+	0	0	186	0.0000000
A09	54295171	54295668	A09p53610.2_BraZ1	414	-	254	423	497	0.8511066
A09	54295726	54295879	A09p53620.2_BraZ1	15.3	-	4	41	153	0.2679739
A09	54297721	54298371	A09p53630.2_BraZ1	472.023	+	195	650	650	1.0000000
A09	54300024	54300825	A09p53640.2_BraZ1	3871.5	-	111	761	801	0.9500624
A09	54303593	54304031	A09p53650.2_BraZ1	31.7647	-	159	438	438	1.0000000
A09	54319423	54324902	A09p53660.2_BraZ1	1725.76	+	2241	5320	5479	0.9709801
A09	54325688	54326180	A09p53670.2_BraZ1	49.2	-	190	462	492	0.9390244
A09	54331322	54331757	A09p53680.2_BraZ1	43.5	-	68	387	435	0.8896552
A09	54333376	54334400	A09p53690.2_BraZ1	663	+	8	360	1024	0.3515625
A09	54335375	54335493	A09p53700.2_BraZ1	11.4	+	0	0	118	0.0000000
A09	54340874	54343093	A09p53710.2_BraZ1	1800.95	-	964	2179	2219	0.9819739
A09	54347113	54347734	A09p53720.2_BraZ1	362.25	-	7	275	621	0.4428341
A09	54351629	54354181	A09p53730.2_BraZ1	1693.09	-	1414	2538	2552	0.9945141
A09	54359009	54360557	A09p53740.2_BraZ1	731.565	-	579	1470	1548	0.9496124
A09	54365184	54365983	A09p53750.2_BraZ1	462	-	935	799	799	1.0000000
A09	54369978	54371359	A09p53760.2_BraZ1	866.871	+	988	1381	1381	1.0000000
A09	54372085	54374551	A09p53770.2_BraZ1	2235	+	1662	1976	2466	0.8012977
A09	54383469	54384479	A09p53780.2_BraZ1	2915.25	+	675	1010	1010	1.0000000
A09	54385464	54386086	A09p53790.2_BraZ1	2029.2	-	998	622	622	1.0000000
A09	54386382	54386828	A09p53800.2_BraZ1	366	+	315	446	446	1.0000000
A09	54388016	54389949	A09p53810.2_BraZ1	778.52	+	1793	1933	1933	1.0000000
A09	54390467	54392740	A09p53820.2_BraZ1	1449.51	-	744	2120	2273	0.9326881
A09	54401715	54405810	A09p53830.2_BraZ1	2760.28	-	1200	3939	4095	0.9619048
A09	54409894	54411870	A09p53840.2_BraZ1	1079.92	+	623	1882	1976	0.9524292
A09	54413729	54415431	A09p53850.2_BraZ1	697.846	-	231	1464	1702	0.8601645
A09	54422057	54422618	A09p53860.2_BraZ1	56.1	+	520	561	561	1.0000000
A09	54427101	54429158	A09p53870.2_BraZ1	500.5	+	1509	2057	2057	1.0000000
A09	54432643	54432947	A09p53880.2_BraZ1	198	-	648	304	304	1.0000000
A09	54433295	54435349	A09p53890.2_BraZ1	2079.41	-	1665	1987	2054	0.9673807
A09	54437596	54442126	A09p53900.2_BraZ1	2634.45	-	1643	4121	4530	0.9097130
A09	54442655	54447739	A09p53910.2_BraZ1	2797.38	-	1821	4318	5084	0.8493313
A09	54450607	54452490	A09p53920.2_BraZ1	812.227	+	1353	1883	1883	1.0000000
A09	54453060	54453803	A09p53930.2_BraZ1	333.443	-	267	743	743	1.0000000
A09	54454396	54456427	A09p53940.2_BraZ1	203.1	-	1168	2031	2031	1.0000000
A09	54461908	54462343	A09p53950.2_BraZ1	43.5	+	97	426	435	0.9793103
A09	54462966	54465019	A09p53960.2_BraZ1	1136.71	-	1556	2053	2053	1.0000000
A09	54465983	54466829	A09p53970.2_BraZ1	660	-	654	846	846	1.0000000
A09	54468851	54473356	A09p53980.2_BraZ1	2085.75	-	1008	3595	4505	0.7980022
A09	54475445	54475742	A09p53990.2_BraZ1	29.7	+	77	245	297	0.8249158
A09	54478148	54481964	A09p54000.2_BraZ1	711.955	-	3293	3809	3816	0.9981656
A09	54482799	54485149	A09p54010.2_BraZ1	2109	-	891	2263	2350	0.9629787
A09	54486573	54487507	A09p54020.2_BraZ1	549	-	894	934	934	1.0000000
A09	54500760	54501257	A09p54030.2_BraZ1	5544	+	320	497	497	1.0000000
A09	54512688	54514767	A09p54040.2_BraZ1	1461.32	+	139	1572	2079	0.7561328
A09	54515796	54517224	A09p54050.2_BraZ1	778.345	+	296	1093	1428	0.7654062
A09	54517499	54518111	A09p54060.2_BraZ1	351.476	-	139	612	612	1.0000000
A09	54519892	54521436	A09p54070.2_BraZ1	1278	+	281	1331	1544	0.8620467
A09	54521719	54525410	A09p54080.2_BraZ1	1571.45	-	793	3072	3691	0.8322948
A09	54534052	54536998	A09p54090.2_BraZ1	1493.16	+	1142	2741	2946	0.9304141
A09	54538154	54538427	A09p54100.2_BraZ1	27.3	-	457	273	273	1.0000000
A09	54549939	54551860	A09p54110.2_BraZ1	4320	+	420	1420	1921	0.7391983
A09	54559710	54560427	A09p54120.2_BraZ1	71.7	-	0	0	717	0.0000000
A09	54562302	54563305	A09p54130.2_BraZ1	670.781	-	726	998	1003	0.9950150
A09	54566636	54567491	A09p54140.2_BraZ1	447	+	104	833	855	0.9742690
A09	54568223	54568621	A09p54150.2_BraZ1	234	-	282	398	398	1.0000000
A09	54568930	54570742	A09p54160.2_BraZ1	315	+	1469	1812	1812	1.0000000
A09	54570753	54571341	A09p54170.2_BraZ1	165	+	71	269	588	0.4574830
A09	54571733	54574778	A09p54180.2_BraZ1	304.5	-	445	2258	3045	0.7415435
A09	54582551	54582856	A09p54190.2_BraZ1	702	+	213	305	305	1.0000000
A09	54586547	54587036	A09p54200.2_BraZ1	48.9	-	21	187	489	0.3824131
A09	54601852	54604078	A09p54210.2_BraZ1	1695	+	102	1214	2226	0.5453728
A09	54604399	54606442	A09p54220.2_BraZ1	1660.45	-	397	1774	2043	0.8683309
A09	54607358	54613567	A09p54230.2_BraZ1	1212.43	+	903	5341	6209	0.8602029
A09	54628119	54631623	A09p54240.2_BraZ1	216.3	+	1652	3432	3504	0.9794521
A09	54633841	54634972	A09p54250.2_BraZ1	113.1	-	146	495	1131	0.4376658
A09	54645201	54646369	A09p54260.2_BraZ1	431.682	+	0	0	1168	0.0000000
A09	54653891	54656019	A09p54270.2_BraZ1	906	+	480	1825	2128	0.8576128
A09	54659417	54660360	A09p54280.2_BraZ1	555	+	692	943	943	1.0000000
A09	54663676	54664126	A09p54290.2_BraZ1	45	+	25	140	450	0.3111111
A09	54677308	54680171	A09p54300.2_BraZ1	1569.73	+	1925	2789	2863	0.9741530
A09	54681086	54681320	A09p54310.2_BraZ1	23.4	-	0	0	234	0.0000000
A09	54682223	54683720	A09p54320.2_BraZ1	149.7	+	0	0	1497	0.0000000
A09	54684239	54685494	A09p54330.2_BraZ1	509.375	-	1126	1255	1255	1.0000000
A09	54686669	54689109	A09p54340.2_BraZ1	901.162	-	688	1917	2440	0.7856557
A09	54696061	54696620	A09p54350.2_BraZ1	210	+	1	56	559	0.1001789
A09	54702027	54702756	A09p54360.2_BraZ1	72.9	+	0	0	729	0.0000000
A09	54712959	54715467	A09p54370.2_BraZ1	1364.78	-	271	2251	2508	0.8975279
A09	54720215	54721803	A09p54380.2_BraZ1	1476	+	716	1482	1588	0.9332494
A09	54725042	54725282	A09p54390.2_BraZ1	24	-	243	240	240	1.0000000
A09	54727502	54730092	A09p54400.2_BraZ1	10890	+	1209	2471	2590	0.9540541
A09	54732321	54746798	A09p54410.2_BraZ1	2115	+	2900	12415	14477	0.8575672
A09	54747497	54750269	A09p54420.2_BraZ1	698.4	-	1307	2720	2772	0.9812410
A09	54754858	54755299	A09p54430.2_BraZ1	44.1	+	283	441	441	1.0000000
A09	54756250	54757939	A09p54440.2_BraZ1	13902.3	+	1287	1689	1689	1.0000000
A09	54758588	54759962	A09p54450.2_BraZ1	800.27	-	713	1374	1374	1.0000000
A09	54764556	54765837	A09p54460.2_BraZ1	34.5	-	188	832	1281	0.6494926
A09	54766098	54766269	A09p54470.2_BraZ1	17.1	+	40	148	171	0.8654971
A09	54772796	54774432	A09p54480.2_BraZ1	237	-	899	1636	1636	1.0000000
A09	54772855	54773348	A09p54490.2_BraZ1	240	-	360	493	493	1.0000000
A09	54772859	54773774	A09p54500.2_BraZ1	135	-	541	915	915	1.0000000
A09	54779571	54779955	A09p54510.2_BraZ1	38.4	+	273	384	384	1.0000000
A09	54780608	54781521	A09p54520.2_BraZ1	6600	-	361	913	913	1.0000000
A09	54784845	54786952	A09p54530.2_BraZ1	1084.5	-	833	2058	2107	0.9767442
A09	54787769	54788708	A09p54540.2_BraZ1	93.9	-	734	896	939	0.9542066
A09	54795486	54796461	A09p54550.2_BraZ1	97.5	-	222	625	975	0.6410257
A09	54807593	54810013	A09p54560.2_BraZ1	1048.41	+	1272	2420	2420	1.0000000
A09	54811012	54811795	A09p54570.2_BraZ1	78.3	-	183	763	783	0.9744572
A09	54815166	54815493	A09p54580.2_BraZ1	165	-	309	327	327	1.0000000
A09	54825767	54826055	A09p54590.2_BraZ1	19.5	+	0	0	288	0.0000000
A09	54833949	54836654	A09p54600.2_BraZ1	812.114	+	1689	2668	2705	0.9863216
A09	54838290	54838888	A09p54610.2_BraZ1	477	-	102	598	598	1.0000000
A09	54842243	54846511	A09p54620.2_BraZ1	1628.93	-	1548	3817	4268	0.8943299
A09	54850238	54850749	A09p54630.2_BraZ1	237	+	576	511	511	1.0000000
A09	54850943	54851552	A09p54640.2_BraZ1	315	+	861	609	609	1.0000000
A09	54859080	54859212	A09p54650.2_BraZ1	13.2	+	568	132	132	1.0000000
A09	54861470	54864181	A09p54660.2_BraZ1	1223.85	+	1598	2711	2711	1.0000000
A09	54871450	54871840	A09p54670.2_BraZ1	325.125	+	670	390	390	1.0000000
A09	54878630	54879503	A09p54680.2_BraZ1	84.6	+	428	820	873	0.9392898
A09	54888493	54890330	A09p54690.2_BraZ1	1030.8	-	1614	1837	1837	1.0000000
A09	54898815	54899196	A09p54700.2_BraZ1	291	+	0	0	381	0.0000000
A09	54907208	54907433	A09p54710.2_BraZ1	22.5	-	119	225	225	1.0000000
A09	54917062	54923583	A09p54720.2_BraZ1	5398.83	+	4866	6448	6521	0.9888054
A09	54924115	54924931	A09p54730.2_BraZ1	357	-	832	816	816	1.0000000
A09	54926954	54928370	A09p54740.2_BraZ1	141.6	-	561	1395	1416	0.9851695
A09	54931141	54932271	A09p54750.2_BraZ1	411	+	1243	1130	1130	1.0000000
A09	54938118	54939239	A09p54760.2_BraZ1	999	+	240	1091	1121	0.9732382
A09	54941212	54941563	A09p54770.2_BraZ1	35.1	-	55	310	351	0.8831909
A09	54941799	54944153	A09p54780.2_BraZ1	1740	-	1191	2179	2354	0.9256585
A09	54950837	54953354	A09p54790.2_BraZ1	991.432	+	189	1332	2517	0.5292014
A09	54959411	54961010	A09p54800.2_BraZ1	833.286	+	2	270	1599	0.1688555
A09	54970170	54973119	A09p54810.2_BraZ1	1331.65	+	2315	2797	2949	0.9484571
A09	54976021	54976369	A09p54820.2_BraZ1	34.8	+	87	247	348	0.7097701
A09	54976608	54977116	A09p54830.2_BraZ1	285	-	83	310	508	0.6102362
A09	54991262	54992660	A09p54840.2_BraZ1	13482	+	362	1191	1398	0.8519313
A09	55001374	55001990	A09p54850.2_BraZ1	332.5	-	702	616	616	1.0000000
A09	55007695	55008151	A09p54860.2_BraZ1	45.6	-	12	147	456	0.3223684
A09	55008320	55008672	A09p54870.2_BraZ1	285	+	46	280	352	0.7954546
A09	55012267	55012981	A09p54880.2_BraZ1	71.4	-	146	430	714	0.6022409
A09	55035070	55035643	A09p54890.2_BraZ1	57.3	-	275	566	573	0.9877836
A09	55049581	55050405	A09p54900.2_BraZ1	240	+	550	824	824	1.0000000
A09	55053626	55054658	A09p54910.2_BraZ1	103.2	-	347	1032	1032	1.0000000
A09	55055546	55055714	A09p54920.2_BraZ1	138	-	221	168	168	1.0000000
A09	55056066	55057179	A09p54930.2_BraZ1	111.3	-	1076	1113	1113	1.0000000
A09	55058417	55059569	A09p54940.2_BraZ1	115.2	-	1262	1152	1152	1.0000000
A09	55063696	55065232	A09p54950.2_BraZ1	576	-	1288	1536	1536	1.0000000
A09	55074386	55075574	A09p54960.2_BraZ1	118.8	-	1312	1188	1188	1.0000000
A09	55078772	55079879	A09p54970.2_BraZ1	480	-	1231	1107	1107	1.0000000
A09	55081360	55082691	A09p54980.2_BraZ1	607.5	-	831	1331	1331	1.0000000
A09	55084877	55094183	A09p54990.2_BraZ1	1359	-	8745	9277	9306	0.9968837
A09	55095588	55096215	A09p55000.2_BraZ1	917	+	234	545	627	0.8692185
A09	55106753	55107991	A09p55010.2_BraZ1	690.375	+	743	1238	1238	1.0000000
A09	55116813	55118480	A09p55020.2_BraZ1	1392	+	457	1664	1667	0.9982004
A09	55120077	55122232	A09p55030.2_BraZ1	1394.68	-	320	1552	2155	0.7201856
A09	55123403	55123844	A09p55040.2_BraZ1	44.1	+	79	396	441	0.8979592
A09	55132502	55133339	A09p55050.2_BraZ1	738	+	423	837	837	1.0000000
A09	55144428	55145685	A09p55060.2_BraZ1	125.7	+	359	1257	1257	1.0000000
A09	55145964	55146211	A09p55070.2_BraZ1	16.5	-	508	247	247	1.0000000
A09	55147827	55148025	A09p55080.2_BraZ1	19.8	+	147	198	198	1.0000000
A09	55154160	55155491	A09p55090.2_BraZ1	1041	-	884	1241	1331	0.9323817
A09	55159007	55159256	A09p55100.2_BraZ1	24.9	-	91	249	249	1.0000000
A09	55161636	55161970	A09p55110.2_BraZ1	201	-	268	334	334	1.0000000
A09	55162450	55163583	A09p55120.2_BraZ1	616	-	370	1106	1133	0.9761695
A09	55164015	55165766	A09p55130.2_BraZ1	249	-	444	1307	1751	0.7464306
A09	55166380	55170195	A09p55140.2_BraZ1	1701	-	726	2518	3815	0.6600262
A09	55172729	55179453	A09p55150.2_BraZ1	1365.74	+	4363	6678	6724	0.9931588
A09	55179788	55182534	A09p55160.2_BraZ1	1653.71	-	1355	2693	2746	0.9806992
A09	55190752	55191553	A09p55170.2_BraZ1	80.1	-	427	801	801	1.0000000
A09	55194425	55194878	A09p55180.2_BraZ1	45.3	+	794	453	453	1.0000000
A09	55195146	55195734	A09p55190.2_BraZ1	58.8	+	350	588	588	1.0000000
A09	55203014	55213235	A09p55200.2_BraZ1	390.825	-	6609	9499	10221	0.9293611
A09	55213450	55213946	A09p55210.2_BraZ1	189	+	145	496	496	1.0000000
A09	55224185	55225521	A09p55220.2_BraZ1	1062	-	493	1294	1336	0.9685629
A09	55237397	55240103	A09p55230.2_BraZ1	270.6	-	505	1998	2706	0.7383592
A09	55242621	55244736	A09p55240.2_BraZ1	955.156	+	725	1960	2115	0.9267139
A09	55245923	55248767	A09p55250.2_BraZ1	1589.2	-	1107	2828	2844	0.9943741
A09	55249565	55256612	A09p55260.2_BraZ1	6865.5	-	3275	6525	7047	0.9259259
A09	55260017	55260348	A09p55270.2_BraZ1	132	-	129	331	331	1.0000000
A09	55260638	55261047	A09p55280.2_BraZ1	246	-	764	409	409	1.0000000
A09	55264753	55266678	A09p55290.2_BraZ1	847.636	-	602	1822	1925	0.9464935
A09	55267847	55268822	A09p55300.2_BraZ1	97.5	-	351	889	975	0.9117949
A09	55271722	55277362	A09p55310.2_BraZ1	2864.57	-	3315	5559	5640	0.9856383
A09	55284732	55285221	A09p55320.2_BraZ1	48.9	+	160	489	489	1.0000000
A09	55287623	55288982	A09p55330.2_BraZ1	135.9	+	1036	1359	1359	1.0000000
A09	55290231	55291260	A09p55340.2_BraZ1	102.9	-	220	914	1029	0.8882410
A09	55304872	55305507	A09p55350.2_BraZ1	426	-	436	635	635	1.0000000
A09	55308622	55309301	A09p55360.2_BraZ1	64.2	-	272	642	679	0.9455081
A09	55328718	55329924	A09p55370.2_BraZ1	120.6	-	147	961	1206	0.7968491
A09	55340928	55341522	A09p55380.2_BraZ1	513	+	8	357	594	0.6010101
A09	55342948	55349600	A09p55390.2_BraZ1	5664	-	3081	6635	6652	0.9974444
A09	55352235	55352595	A09p55400.2_BraZ1	36	-	260	360	360	1.0000000
A09	55352469	55353543	A09p55410.2_BraZ1	212.143	+	371	691	1074	0.6433892
A09	55357026	55358824	A09p55420.2_BraZ1	690	+	180	1457	1798	0.8103448
A09	55360548	55360808	A09p55430.2_BraZ1	19.8	+	38	260	260	1.0000000
A09	55360929	55361554	A09p55440.2_BraZ1	318	+	104	550	625	0.8800000
A09	55362245	55363418	A09p55450.2_BraZ1	117.3	+	386	1173	1173	1.0000000
A09	55364648	55365862	A09p55460.2_BraZ1	735	+	569	1214	1214	1.0000000
A09	55369675	55370776	A09p55470.2_BraZ1	110.1	+	432	1068	1101	0.9700273
A09	55371974	55373360	A09p55480.2_BraZ1	138.6	+	108	830	1386	0.5988456
A09	55381062	55381422	A09p55490.2_BraZ1	36	+	96	307	360	0.8527778
A09	55382998	55383898	A09p55500.2_BraZ1	327	+	61	555	900	0.6166667
A09	55387774	55388440	A09p55510.2_BraZ1	66.6	+	298	666	666	1.0000000
A09	55392708	55393454	A09p55520.2_BraZ1	63.9	+	328	614	746	0.8230563
A09	55402412	55403170	A09p55530.2_BraZ1	1953	+	30	684	758	0.9023747
A09	55407776	55408532	A09p55540.2_BraZ1	1302	+	15	485	756	0.6415344
A09	55412818	55413571	A09p55550.2_BraZ1	648	+	20	498	753	0.6613546
A09	55414351	55428242	A09p55560.2_BraZ1	279.571	-	4502	7156	13891	0.5151537
A09	55432705	55435728	A09p55570.2_BraZ1	1455.89	+	1163	2945	3023	0.9741978
A09	55438921	55442838	A09p55580.2_BraZ1	804.375	-	259	2166	3917	0.5529742
A09	55450010	55450387	A09p55590.2_BraZ1	3658	+	0	0	377	0.0000000
A09	55451340	55451847	A09p55600.2_BraZ1	26.4	-	13	411	507	0.8106509
A09	55451971	55455610	A09p55610.2_BraZ1	102.3	-	69	984	3639	0.2704040
A09	55455445	55455865	A09p55620.2_BraZ1	261	-	0	0	420	0.0000000
A09	55456928	55458015	A09p55630.2_BraZ1	36.3	-	4	276	1087	0.2539099
A09	55457387	55460303	A09p55640.2_BraZ1	69.9	-	60	984	2916	0.3374486
A09	55458932	55462516	A09p55650.2_BraZ1	147.9	-	129	1516	3584	0.4229911
A09	55462711	55463008	A09p55660.2_BraZ1	29.7	-	1	128	297	0.4309764
A09	55468265	55468982	A09p55670.2_BraZ1	71.7	-	3	118	717	0.1645746
A09	55475377	55483162	A09p55680.2_BraZ1	4419.99	+	1368	5604	7785	0.7198458
A09	55487342	55488074	A09p55690.2_BraZ1	73.2	-	40	499	732	0.6816940
A09	55495037	55496505	A09p55700.2_BraZ1	1055.13	-	1285	1431	1468	0.9747956
A09	55508594	55508789	A09p55710.2_BraZ1	19.5	+	357	195	195	1.0000000
A09	55514702	55514921	A09p55720.2_BraZ1	21.9	-	91	219	219	1.0000000
A09	55517749	55518346	A09p55730.2_BraZ1	474	-	3	119	597	0.1993300
A09	55538156	55541065	A09p55740.2_BraZ1	1233.51	-	173	1600	2909	0.5500172
A09	55550742	55550946	A09p55750.2_BraZ1	20.4	+	332	139	204	0.6813725
A09	55569525	55569980	A09p55760.2_BraZ1	411	+	101	434	455	0.9538462
A09	55569980	55570759	A09p55770.2_BraZ1	285	-	598	779	779	1.0000000
A09	55579702	55580014	A09p55780.2_BraZ1	18.9	+	318	312	312	1.0000000
A09	55585793	55587544	A09p55790.2_BraZ1	12731	+	682	1428	1751	0.8155340
A09	55596341	55597265	A09p55800.2_BraZ1	92.4	-	18	483	924	0.5227273
A09	55605257	55606415	A09p55810.2_BraZ1	115.8	-	347	743	1158	0.6416235
A09	55619457	55622098	A09p55820.2_BraZ1	438.375	-	8	185	2641	0.0700492
A09	55624830	55625357	A09p55830.2_BraZ1	333	-	0	0	527	0.0000000
A09	55625391	55626047	A09p55840.2_BraZ1	43.2	-	8	105	656	0.1600610
A09	55635781	55636125	A09p55850.2_BraZ1	135	-	242	298	344	0.8662791
A09	55644914	55647558	A09p55860.2_BraZ1	438.375	-	2	187	2644	0.0707262
A09	55653222	55653651	A09p55870.2_BraZ1	42.9	+	11	20	429	0.0466200
A09	55662954	55663230	A09p55880.2_BraZ1	27.6	+	250	228	276	0.8260869
A09	55675457	55678102	A09p55890.2_BraZ1	438.375	-	4	20	2645	0.0075614
A09	55683999	55684806	A09p55900.2_BraZ1	80.7	-	1220	807	807	1.0000000
A09	55687059	55688214	A09p55910.2_BraZ1	115.5	-	663	1122	1155	0.9714286
A09	55698766	55699692	A09p55920.2_BraZ1	743.125	+	119	726	926	0.7840173
A09	55700907	55701376	A09p55930.2_BraZ1	378	-	80	387	469	0.8251599
A09	55704620	55706198	A09p55940.2_BraZ1	157.8	-	201	1103	1578	0.6989861
A09	55711497	55713186	A09p55950.2_BraZ1	1132.55	-	711	1612	1689	0.9544109
A09	55719623	55719981	A09p55960.2_BraZ1	222	-	3	222	358	0.6201117
A09	55721553	55722000	A09p55970.2_BraZ1	44.7	-	54	373	447	0.8344519
A09	55726192	55726944	A09p55980.2_BraZ1	198	-	109	731	752	0.9720744
A09	55728572	55728796	A09p55990.2_BraZ1	126	+	1	124	224	0.5535714
A09	55731057	55731890	A09p56000.2_BraZ1	591.571	-	61	605	833	0.7262905
A09	55732320	55733174	A09p56010.2_BraZ1	1036	-	99	555	854	0.6498829
A09	55735348	55736290	A09p56020.2_BraZ1	488.222	-	357	942	942	1.0000000
A09	55737359	55737847	A09p56030.2_BraZ1	152	-	176	488	488	1.0000000
A09	55738975	55739085	A09p56040.2_BraZ1	10.2	-	137	110	110	1.0000000
A09	55740573	55741599	A09p56050.2_BraZ1	573.696	-	167	943	1026	0.9191033
A09	55742631	55745596	A09p56060.2_BraZ1	1283.01	-	371	2648	2965	0.8930860
A09	55746985	55748050	A09p56070.2_BraZ1	348.75	-	271	1022	1065	0.9596244
A09	55754817	55755587	A09p56080.2_BraZ1	687	-	514	770	770	1.0000000
A09	55760639	55761774	A09p56090.2_BraZ1	1156.25	+	1052	1135	1135	1.0000000
A09	55771628	55772876	A09p56100.2_BraZ1	873	+	140	656	1248	0.5256410
A09	55774377	55775205	A09p56110.2_BraZ1	82.8	+	134	507	828	0.6123188
A09	55775440	55775636	A09p56120.2_BraZ1	17.1	-	104	196	196	1.0000000
A09	55777296	55777956	A09p56130.2_BraZ1	66	+	212	517	660	0.7833334
A09	55779473	55780549	A09p56140.2_BraZ1	483	+	312	791	1076	0.7351301
A09	55782087	55783581	A09p56150.2_BraZ1	1272.41	+	1958	1494	1494	1.0000000
A09	55783901	55784909	A09p56160.2_BraZ1	4095	-	255	1008	1008	1.0000000
A09	55789403	55790165	A09p56170.2_BraZ1	76.2	+	535	762	762	1.0000000
A09	55796797	55797682	A09p56180.2_BraZ1	810	+	415	885	885	1.0000000
A09	55810586	55812206	A09p56190.2_BraZ1	161.7	+	216	755	1620	0.4660494
A09	55814732	55819563	A09p56200.2_BraZ1	3256	+	874	4084	4831	0.8453736
A09	55819770	55821177	A09p56210.2_BraZ1	661.886	-	1022	1407	1407	1.0000000
A09	55822573	55823587	A09p56220.2_BraZ1	405	+	420	901	1014	0.8885602
A09	55824355	55825970	A09p56230.2_BraZ1	997.905	+	319	1482	1615	0.9176471
A09	55826605	55829746	A09p56240.2_BraZ1	619.714	-	1786	3119	3141	0.9929959
A09	55830526	55831177	A09p56250.2_BraZ1	440.217	+	112	577	651	0.8863287
A09	55832899	55834105	A09p56260.2_BraZ1	2271.25	-	200	912	1206	0.7562189
A09	55836610	55836766	A09p56270.2_BraZ1	15.6	-	9	79	156	0.5064102
A09	55840012	55840697	A09p56280.2_BraZ1	212	+	779	685	685	1.0000000
A09	55840697	55841928	A09p56290.2_BraZ1	417	+	595	1168	1231	0.9488221
A09	55842361	55842989	A09p56300.2_BraZ1	363	+	6	125	628	0.1990446
A09	55853521	55855121	A09p56310.2_BraZ1	1092	+	157	1066	1600	0.6662500
A09	55856974	55857871	A09p56320.2_BraZ1	34.5	-	192	539	897	0.6008919
A09	55861256	55864650	A09p56330.2_BraZ1	2187.88	+	314	2024	3394	0.5963465
A09	55872549	55878322	A09p56340.2_BraZ1	2903.76	-	2209	5575	5773	0.9657024
A09	55883550	55883811	A09p56350.2_BraZ1	26.1	+	280	261	261	1.0000000
A09	55884599	55890758	A09p56360.2_BraZ1	1444.12	+	3302	6159	6159	1.0000000
A09	55894046	55898276	A09p56370.2_BraZ1	2631.1	+	1116	3505	4230	0.8286052
A09	55899162	55900540	A09p56380.2_BraZ1	1083	-	352	1357	1378	0.9847605
A09	55929361	55931667	A09p56390.2_BraZ1	10879.9	+	1289	2210	2306	0.9583695
A09	55932090	55933330	A09p56400.2_BraZ1	935	-	129	931	1240	0.7508065
A09	55935925	55936243	A09p56410.2_BraZ1	31.8	-	3	119	318	0.3742138
A09	55937589	55938299	A09p56420.2_BraZ1	591	-	178	710	710	1.0000000
A09	55940420	55941934	A09p56430.2_BraZ1	1115.46	+	70	972	1514	0.6420079
A09	55946529	55948617	A09p56440.2_BraZ1	1240.65	+	824	2088	2088	1.0000000
A09	55948913	55949786	A09p56450.2_BraZ1	87.3	-	739	873	873	1.0000000
A09	55960645	55961490	A09p56460.2_BraZ1	456	+	87	705	845	0.8343195
A09	55962484	55964160	A09p56470.2_BraZ1	4302.86	+	834	1629	1676	0.9719570
A09	55965358	55968052	A09p56480.2_BraZ1	1288.78	+	750	2436	2694	0.9042316
A09	55972624	55973605	A09p56490.2_BraZ1	441	-	1691	981	981	1.0000000
A09	55975589	55977533	A09p56500.2_BraZ1	1862.25	+	2433	1944	1944	1.0000000
A09	55979042	55981495	A09p56510.2_BraZ1	1783.65	+	327	2214	2453	0.9025683
A09	55981675	55982500	A09p56520.2_BraZ1	750	-	203	797	825	0.9660606
A09	55984076	55985118	A09p56530.2_BraZ1	495.861	+	137	987	1042	0.9472169
A09	55985550	55990180	A09p56540.2_BraZ1	2110.87	-	364	2881	4630	0.6222462
A09	55992115	55993714	A09p56550.2_BraZ1	159.9	-	1273	1599	1599	1.0000000
A09	55994785	55994978	A09p56560.2_BraZ1	16.2	-	69	193	193	1.0000000
A09	55995081	55995348	A09p56570.2_BraZ1	26.7	+	81	174	267	0.6516854
A09	55996444	55996655	A09p56580.2_BraZ1	195	+	199	211	211	1.0000000
A09	55997843	56000482	A09p56590.2_BraZ1	1446.32	-	735	2496	2639	0.9458128
A09	56001313	56003791	A09p56600.2_BraZ1	236	+	227	1710	2478	0.6900727
A09	56004793	56007473	A09p56610.2_BraZ1	1283.26	-	1715	2677	2680	0.9988806
A09	56009199	56010006	A09p56620.2_BraZ1	307.034	-	696	807	807	1.0000000
A09	56011522	56012869	A09p56630.2_BraZ1	1098	+	510	1347	1347	1.0000000
A09	56021867	56022900	A09p56640.2_BraZ1	2639.25	-	854	1033	1033	1.0000000
A09	56026721	56027064	A09p56650.2_BraZ1	1218.75	+	136	343	343	1.0000000
A09	56031473	56031756	A09p56660.2_BraZ1	24.9	+	300	283	283	1.0000000
A09	56032329	56034309	A09p56670.2_BraZ1	810.851	+	769	1718	1980	0.8676768
A09	56034444	56035269	A09p56680.2_BraZ1	82.5	-	436	784	825	0.9503030
A09	56038268	56039115	A09p56690.2_BraZ1	83.4	-	68	491	847	0.5796930
A09	56053798	56053900	A09p56700.2_BraZ1	10.2	-	0	0	102	0.0000000
A09	56058883	56060190	A09p56710.2_BraZ1	531	-	21	224	1307	0.1713849
A09	56061197	56066148	A09p56720.2_BraZ1	880.38	+	748	3989	4951	0.8056958
A09	56070405	56072681	A09p56730.2_BraZ1	2079	+	158	1227	2276	0.5391037
A09	56073349	56085965	A09p56740.2_BraZ1	258	-	4755	10992	12616	0.8712746
A09	56085965	56086513	A09p56750.2_BraZ1	36.3	-	194	420	548	0.7664233
A09	56087419	56088115	A09p56760.2_BraZ1	69.6	-	33	264	696	0.3793103
A09	56115281	56117356	A09p56770.2_BraZ1	1596.44	-	78	1044	2075	0.5031325
A09	56118921	56119542	A09p56780.2_BraZ1	62.1	+	1178	621	621	1.0000000
A09	56129271	56133324	A09p56790.2_BraZ1	2905.27	-	3091	4053	4053	1.0000000
A09	56138525	56139864	A09p56800.2_BraZ1	6900.5	+	500	1321	1339	0.9865571
A09	56151438	56154237	A09p56810.2_BraZ1	780.984	+	617	2211	2799	0.7899250
A09	56154011	56155494	A09p56820.2_BraZ1	452.884	+	46	921	1483	0.6210384
A09	56156356	56158021	A09p56830.2_BraZ1	1086	-	646	1622	1665	0.9741742
A09	56158735	56165018	A09p56840.2_BraZ1	2167.66	+	3454	5839	6283	0.9293332
A09	56165809	56168890	A09p56850.2_BraZ1	1924.36	-	1164	2827	3081	0.9175592
A09	56174700	56175429	A09p56860.2_BraZ1	558	+	330	729	729	1.0000000
A09	56177115	56179416	A09p56870.2_BraZ1	1281.78	+	263	1674	2301	0.7275098
A09	56181256	56195574	A09p56880.2_BraZ1	3070.57	-	6612	13752	14318	0.9604694
A09	56186652	56187370	A09p56890.2_BraZ1	448	+	345	718	718	1.0000000
A09	56196073	56200253	A09p56900.2_BraZ1	14137.2	+	693	2704	4180	0.6468899
A09	56201901	56202360	A09p56910.2_BraZ1	45.9	-	144	421	459	0.9172114
A09	56213432	56213783	A09p56920.2_BraZ1	35.1	-	31	231	351	0.6581197
A09	56214384	56215625	A09p56930.2_BraZ1	387.917	-	988	1241	1241	1.0000000
A09	56217975	56218176	A09p56940.2_BraZ1	20.1	+	169	201	201	1.0000000
A09	56218315	56220968	A09p56950.2_BraZ1	1968.85	+	696	2460	2653	0.9272522
A09	56226273	56228960	A09p56960.2_BraZ1	2312.61	+	590	2038	2687	0.7584667
A09	56229734	56230258	A09p56970.2_BraZ1	362.667	+	212	524	524	1.0000000
A09	56230325	56232857	A09p56980.2_BraZ1	3950	+	43	723	2532	0.2855450
A09	56236544	56248567	A09p56990.2_BraZ1	416.1	+	1237	7250	12023	0.6030109
A09	56250636	56250804	A09p57000.2_BraZ1	16.8	-	3	160	168	0.9523810
A09	56257800	56258873	A09p57010.2_BraZ1	7797	-	621	1067	1073	0.9944082
A09	56264886	56266912	A09p57020.2_BraZ1	951.152	+	82	1016	2026	0.5014808
A09	56272108	56273176	A09p57030.2_BraZ1	891	-	249	761	1068	0.7125468
A09	56277780	56279406	A09p57040.2_BraZ1	871.714	-	536	1224	1626	0.7527675
A09	56290182	56291544	A09p57050.2_BraZ1	1233	+	1444	1358	1362	0.9970632
A09	56296871	56297060	A09p57060.2_BraZ1	18.9	-	1364	189	189	1.0000000
A09	56300481	56303592	A09p57070.2_BraZ1	10573.5	+	948	2893	3111	0.9299261
A09	56306003	56306517	A09p57080.2_BraZ1	285	+	114	423	514	0.8229572
A09	56307717	56308059	A09p57090.2_BraZ1	34.2	+	158	342	342	1.0000000
A09	56308913	56310461	A09p57100.2_BraZ1	879	-	723	1548	1548	1.0000000
A09	56310461	56312904	A09p57110.2_BraZ1	4546.29	-	273	2108	2443	0.8628735
A09	56312920	56313936	A09p57120.2_BraZ1	1207.12	-	277	868	1016	0.8543307
A09	56315448	56316587	A09p57130.2_BraZ1	630.341	+	475	1139	1139	1.0000000
A09	56323709	56323994	A09p57140.2_BraZ1	28.5	-	61	279	285	0.9789473
A09	56325866	56328494	A09p57150.2_BraZ1	262.8	-	476	2322	2628	0.8835617
A09	56330490	56331341	A09p57160.2_BraZ1	777	-	54	612	851	0.7191539
A09	56332217	56335292	A09p57170.2_BraZ1	2659.76	-	431	1773	3075	0.5765854
A09	56335571	56335703	A09p57180.2_BraZ1	13.2	-	81	132	132	1.0000000
A09	56339960	56341206	A09p57190.2_BraZ1	786	-	805	1246	1246	1.0000000
A09	56342514	56343273	A09p57200.2_BraZ1	75.9	-	331	759	759	1.0000000
A09	56344082	56349661	A09p57210.2_BraZ1	2009.61	-	3211	5560	5579	0.9965944
A09	56350238	56353046	A09p57220.2_BraZ1	1205.22	-	2315	2808	2808	1.0000000
A09	56355561	56355798	A09p57230.2_BraZ1	12.6	+	185	237	237	1.0000000
A09	56363881	56364237	A09p57240.2_BraZ1	300	+	0	0	356	0.0000000
A09	56364855	56367631	A09p57250.2_BraZ1	1454.75	+	831	2637	2776	0.9499279
A09	56369087	56370257	A09p57260.2_BraZ1	519	-	906	1170	1170	1.0000000
A09	56370950	56375395	A09p57270.2_BraZ1	2072.03	-	686	3942	4445	0.8868392
A09	56392531	56392783	A09p57280.2_BraZ1	25.2	+	371	252	252	1.0000000
A09	56400801	56402052	A09p57290.2_BraZ1	125.1	+	87	610	1251	0.4876099
A09	56402892	56404240	A09p57300.2_BraZ1	12600	-	216	1060	1348	0.7863501
A09	56415890	56417977	A09p57310.2_BraZ1	1411.41	-	220	1635	2087	0.7834212
A09	56420537	56420774	A09p57320.2_BraZ1	23.7	-	38	237	237	1.0000000
A09	56421440	56421955	A09p57330.2_BraZ1	270	-	96	515	515	1.0000000
A09	56422065	56422299	A09p57340.2_BraZ1	132	-	182	234	234	1.0000000
A09	56427116	56428736	A09p57350.2_BraZ1	1016	-	635	1620	1620	1.0000000
A09	56429691	56430843	A09p57360.2_BraZ1	115.2	+	863	1138	1152	0.9878472
A09	56432290	56432727	A09p57370.2_BraZ1	273	-	414	437	437	1.0000000
A09	56433409	56437324	A09p57380.2_BraZ1	1080	+	3059	3815	3915	0.9744572
A09	56438113	56439145	A09p57390.2_BraZ1	103.2	-	475	1032	1032	1.0000000
A09	56440237	56440579	A09p57400.2_BraZ1	34.2	+	343	342	342	1.0000000
A09	56440723	56442803	A09p57410.2_BraZ1	868.482	-	1313	2080	2080	1.0000000
A09	56443581	56449037	A09p57420.2_BraZ1	1751.13	+	1689	4694	5456	0.8603373
A09	56444551	56445346	A09p57430.2_BraZ1	312	-	356	795	795	1.0000000
A09	56449738	56449948	A09p57440.2_BraZ1	21	+	83	210	210	1.0000000
A09	56450357	56451841	A09p57450.2_BraZ1	947.021	-	716	1470	1484	0.9905660
A09	56453292	56453626	A09p57460.2_BraZ1	195	+	0	0	334	0.0000000
A09	56453506	56454461	A09p57470.2_BraZ1	600	+	66	284	955	0.2973822
A09	56454940	56457193	A09p57480.2_BraZ1	1158.96	+	559	2000	2253	0.8877053
A09	56457468	56457974	A09p57490.2_BraZ1	36.6	-	71	285	506	0.5632411
A09	56458677	56466476	A09p57500.2_BraZ1	3835.21	+	2622	6662	7799	0.8542121
A09	56467103	56478315	A09p57510.2_BraZ1	388	-	4983	9664	11212	0.8619336
A09	56471301	56472291	A09p57520.2_BraZ1	626.769	+	3	105	990	0.1060606
A09	56472843	56473352	A09p57530.2_BraZ1	315	-	53	416	509	0.8172888
A09	56478277	56478569	A09p57540.2_BraZ1	222	-	60	292	292	1.0000000
A09	56483452	56484443	A09p57550.2_BraZ1	632.571	+	32	588	991	0.5933400
A09	56484998	56485505	A09p57560.2_BraZ1	249.136	-	3	237	507	0.4674556
A09	56502953	56503955	A09p57570.2_BraZ1	626.769	+	27	287	1002	0.2864271
A09	56504508	56510919	A09p57580.2_BraZ1	1957.58	-	2765	6144	6411	0.9583528
A09	56511921	56514103	A09p57590.2_BraZ1	399	+	589	1539	2182	0.7053162
A09	56517162	56519605	A09p57600.2_BraZ1	1014.93	+	836	2441	2443	0.9991813
A09	56519941	56521755	A09p57610.2_BraZ1	732	-	880	1805	1814	0.9950386
A09	56522189	56523146	A09p57620.2_BraZ1	417	+	732	919	957	0.9602926
A09	56523758	56526062	A09p57630.2_BraZ1	1706.63	-	863	1958	2304	0.8498264
A09	56531655	56537849	A09p57640.2_BraZ1	4795	+	1170	4814	6194	0.7772037
A09	56538085	56538786	A09p57650.2_BraZ1	268.667	-	244	679	701	0.9686162
A09	56539143	56541768	A09p57660.2_BraZ1	826.435	-	445	2396	2625	0.9127619
A09	56548529	56548827	A09p57670.2_BraZ1	177	-	48	285	298	0.9563758
A09	56549643	56550864	A09p57680.2_BraZ1	122.1	+	0	0	1221	0.0000000
A09	56557472	56558201	A09p57690.2_BraZ1	282	+	618	729	729	1.0000000
A09	56559511	56559809	A09p57700.2_BraZ1	177	-	20	227	298	0.7617450
A09	56560629	56561844	A09p57710.2_BraZ1	121.5	+	68	380	1215	0.3127572
A09	56563967	56564230	A09p57720.2_BraZ1	162	-	186	263	263	1.0000000
A09	56565709	56567165	A09p57730.2_BraZ1	529.113	+	1296	1456	1456	1.0000000
A09	56579579	56579935	A09p57740.2_BraZ1	1691	+	191	356	356	1.0000000
A09	56584128	56585233	A09p57750.2_BraZ1	396	+	1167	1105	1105	1.0000000
A09	56587760	56588089	A09p57760.2_BraZ1	276	+	361	329	329	1.0000000
A09	56593707	56594952	A09p57770.2_BraZ1	124.5	-	1354	1245	1245	1.0000000
A09	56597283	56598340	A09p57780.2_BraZ1	735	-	825	917	1057	0.8675497
A09	56601688	56602021	A09p57790.2_BraZ1	33.3	+	0	0	333	0.0000000
A09	56604744	56605444	A09p57800.2_BraZ1	183	+	128	571	700	0.8157143
A09	56606670	56610797	A09p57810.2_BraZ1	1644	+	565	2686	4127	0.6508359
A09	56613595	56613760	A09p57820.2_BraZ1	16.5	+	128	165	165	1.0000000
A09	56615953	56628321	A09p57830.2_BraZ1	1455.3	+	3438	10855	12368	0.8776682
A09	56628859	56630921	A09p57840.2_BraZ1	3535	+	43	778	2062	0.3773036
A09	56632040	56638319	A09p57850.2_BraZ1	651	-	901	3397	6279	0.5410097
A09	56640677	56641424	A09p57860.2_BraZ1	72.9	+	20	203	747	0.2717537
A09	56643711	56643897	A09p57870.2_BraZ1	18.6	-	0	0	186	0.0000000
A09	56648947	56650255	A09p57880.2_BraZ1	130.8	-	57	540	1308	0.4128440
A09	56659142	56659552	A09p57890.2_BraZ1	222	+	1025	403	410	0.9829268
A09	56662405	56662753	A09p57900.2_BraZ1	34.8	-	252	348	348	1.0000000
A09	56663852	56664795	A09p57910.2_BraZ1	1086	-	224	943	943	1.0000000
A09	56672997	56673906	A09p57920.2_BraZ1	90.9	+	397	893	909	0.9823982
A09	56676315	56676942	A09p57930.2_BraZ1	62.7	+	42	398	627	0.6347687
A09	56679047	56679194	A09p57940.2_BraZ1	14.7	+	296	147	147	1.0000000
A09	56685647	56686298	A09p57950.2_BraZ1	401.143	+	1084	651	651	1.0000000
A09	56687662	56687909	A09p57960.2_BraZ1	24.3	-	263	247	247	1.0000000
A09	56687958	56688288	A09p57970.2_BraZ1	213	-	247	330	330	1.0000000
A09	56688660	56689214	A09p57980.2_BraZ1	808.5	-	1584	554	554	1.0000000
A09	56690858	56691488	A09p57990.2_BraZ1	63	-	28	359	630	0.5698413
A09	56697507	56700160	A09p58000.2_BraZ1	1921.18	-	162	1651	2653	0.6223143
A09	56706920	56707724	A09p58010.2_BraZ1	80.4	-	42	235	804	0.2922886
A09	56711646	56712138	A09p58020.2_BraZ1	49.2	-	69	292	492	0.5934959
A09	56716183	56717403	A09p58030.2_BraZ1	495.158	-	488	1180	1220	0.9672131
A09	56722198	56722489	A09p58040.2_BraZ1	29.1	-	243	291	291	1.0000000
A09	56725777	56734515	A09p58050.2_BraZ1	533.081	+	2907	8174	8738	0.9354543
A09	56732163	56732607	A09p58060.2_BraZ1	44.4	+	202	444	444	1.0000000
A09	56736004	56738078	A09p58070.2_BraZ1	1271.7	+	542	2049	2074	0.9879460
A09	56738854	56741189	A09p58080.2_BraZ1	261	+	962	2314	2335	0.9910064
A09	56746940	56747153	A09p58090.2_BraZ1	21.3	-	189	213	213	1.0000000
A09	56749328	56749442	A09p58100.2_BraZ1	11.4	-	305	114	114	1.0000000
A09	56750216	56750357	A09p58110.2_BraZ1	14.1	+	26	141	141	1.0000000
A09	56752821	56754806	A09p58120.2_BraZ1	1369.8	+	1209	1977	1985	0.9959698
A09	56757569	56759055	A09p58130.2_BraZ1	6756.75	+	714	1379	1486	0.9279946
A09	56764879	56767088	A09p58140.2_BraZ1	8320	+	377	1331	2209	0.6025351
A09	56768119	56769243	A09p58150.2_BraZ1	798	+	398	762	1124	0.6779360
A09	56773802	56775945	A09p58160.2_BraZ1	882.3	+	2979	2143	2143	1.0000000
A09	56777412	56778796	A09p58170.2_BraZ1	294	-	831	1384	1384	1.0000000
A09	56785218	56787680	A09p58180.2_BraZ1	306	+	3900	2462	2462	1.0000000
A09	56795315	56795930	A09p58190.2_BraZ1	249	-	538	615	615	1.0000000
A09	56800680	56801511	A09p58200.2_BraZ1	83.1	+	331	831	831	1.0000000
A09	56802531	56802660	A09p58210.2_BraZ1	12.9	-	103	129	129	1.0000000
A09	56804478	56807061	A09p58220.2_BraZ1	841.852	-	1283	2285	2583	0.8846303
A09	56810710	56811910	A09p58230.2_BraZ1	192	-	463	1200	1200	1.0000000
A09	56813402	56813819	A09p58240.2_BraZ1	41.7	-	92	368	417	0.8824940
A09	56817871	56818254	A09p58250.2_BraZ1	222	+	80	383	383	1.0000000
A09	56819076	56819390	A09p58260.2_BraZ1	234	+	133	314	314	1.0000000
A09	56819689	56822005	A09p58270.2_BraZ1	1275.43	-	1675	2169	2316	0.9365285
A09	56827445	56827881	A09p58280.2_BraZ1	237	-	207	414	436	0.9495413
A09	56831024	56833726	A09p58290.2_BraZ1	1256.6	-	811	2432	2702	0.9000740
A09	56840743	56840998	A09p58300.2_BraZ1	25.5	-	35	222	255	0.8705882
A09	56850708	56851239	A09p58310.2_BraZ1	53.1	+	102	491	531	0.9246705
A09	56857299	56857664	A09p58320.2_BraZ1	198	+	104	365	365	1.0000000
A09	56861572	56864719	A09p58330.2_BraZ1	1258.47	-	850	2126	3147	0.6755641
A09	56870344	56870613	A09p58340.2_BraZ1	21.6	-	80	269	269	1.0000000
A09	56871763	56875390	A09p58350.2_BraZ1	1831.44	+	1019	2811	3627	0.7750207
A09	56875668	56876864	A09p58360.2_BraZ1	471	-	674	1149	1196	0.9607024
A09	56877436	56879943	A09p58370.2_BraZ1	1253.55	-	777	2128	2507	0.8488233
A09	56881273	56883655	A09p58380.2_BraZ1	630	+	3820	1955	2382	0.8207389
A09	56890080	56894395	A09p58390.2_BraZ1	2191.27	+	2080	4240	4315	0.9826187
A09	56894851	56896995	A09p58400.2_BraZ1	1088.64	-	708	2144	2144	1.0000000
A09	56908961	56909523	A09p58410.2_BraZ1	262.5	+	1483	562	562	1.0000000
A09	56914594	56915202	A09p58420.2_BraZ1	300	+	223	608	608	1.0000000
A09	56916605	56916962	A09p58430.2_BraZ1	202.5	+	186	357	357	1.0000000
A09	56924378	56925664	A09p58440.2_BraZ1	645.621	+	578	1286	1286	1.0000000
A09	56926855	56928445	A09p58450.2_BraZ1	1077	-	531	1529	1590	0.9616352
A09	56930754	56931987	A09p58460.2_BraZ1	526.519	+	327	1180	1233	0.9570154
A09	56933054	56934674	A09p58470.2_BraZ1	162	-	751	1496	1620	0.9234568
A09	56936585	56936813	A09p58480.2_BraZ1	22.8	+	422	228	228	1.0000000
A09	56937527	56943572	A09p58490.2_BraZ1	870	-	6707	6045	6045	1.0000000
A09	56948916	56949609	A09p58500.2_BraZ1	69.3	+	156	652	693	0.9408370
A09	56953112	56954813	A09p58510.2_BraZ1	1224	+	1292	1611	1701	0.9470900
A09	56957556	56960837	A09p58520.2_BraZ1	1497.35	+	1930	3266	3281	0.9954282
A09	56964772	56965925	A09p58530.2_BraZ1	874.759	+	657	1153	1153	1.0000000
A09	56966266	56967983	A09p58540.2_BraZ1	849	-	415	1192	1717	0.6942341
A09	56969447	56970164	A09p58550.2_BraZ1	266.5	-	753	717	717	1.0000000
A09	56970417	56971509	A09p58560.2_BraZ1	106.2	+	450	1061	1092	0.9716117
A09	56973201	56974003	A09p58570.2_BraZ1	506.029	-	410	802	802	1.0000000
A09	56974690	56976506	A09p58580.2_BraZ1	1523.81	+	1608	1799	1816	0.9906388
A09	56976929	56983203	A09p58590.2_BraZ1	194	+	4316	5739	6274	0.9147274
A09	56979992	56980352	A09p58600.2_BraZ1	36	-	224	360	360	1.0000000
A09	56994885	56996533	A09p58610.2_BraZ1	1366.88	-	805	1451	1648	0.8804612
A09	56997284	57001553	A09p58620.2_BraZ1	2428.36	+	2986	4070	4269	0.9533849
A09	57018392	57021670	A09p58630.2_BraZ1	1192.5	+	1254	2591	3278	0.7904210
A09	57024230	57025205	A09p58640.2_BraZ1	697	-	1241	975	975	1.0000000
A09	57030121	57033587	A09p58650.2_BraZ1	2176.2	+	1333	3207	3466	0.9252741
A09	57034449	57035930	A09p58660.2_BraZ1	66.3	+	231	673	1481	0.4544227
A09	57038353	57039440	A09p58670.2_BraZ1	484.5	+	2	104	1087	0.0956762
A09	57039517	57039794	A09p58680.2_BraZ1	22.4	+	13	277	277	1.0000000
A09	57042122	57042290	A09p58690.2_BraZ1	16.8	+	300	168	168	1.0000000
A09	57046800	57046974	A09p58700.2_BraZ1	17.4	-	30	122	174	0.7011494
A09	57049686	57049938	A09p58710.2_BraZ1	25.2	-	112	252	252	1.0000000
A09	57050739	57051799	A09p58720.2_BraZ1	682.5	-	324	395	1060	0.3726415
A09	57056604	57056895	A09p58730.2_BraZ1	29.1	+	383	291	291	1.0000000
A09	57059498	57059891	A09p58740.2_BraZ1	39.3	+	66	298	393	0.7582697
A09	57060399	57062916	A09p58750.2_BraZ1	2172	-	224	1350	2517	0.5363528
A09	57067844	57070424	A09p58760.2_BraZ1	386.467	-	4030	2574	2580	0.9976744
A09	57070424	57070797	A09p58770.2_BraZ1	249	-	534	373	373	1.0000000
A09	57078031	57086888	A09p58780.2_BraZ1	2442.5	+	4279	7913	8857	0.8934177
A09	57087712	57088866	A09p58790.2_BraZ1	610.235	-	1389	1154	1154	1.0000000
A09	57089580	57092215	A09p58800.2_BraZ1	1526.61	-	938	2569	2635	0.9749526
A09	57093063	57094180	A09p58810.2_BraZ1	372.36	-	501	1117	1117	1.0000000
A09	57096565	57097792	A09p58820.2_BraZ1	17623.5	-	673	1209	1227	0.9853300
A09	57097983	57098097	A09p58830.2_BraZ1	11.4	+	147	114	114	1.0000000
A09	57100252	57102553	A09p58840.2_BraZ1	230.1	+	1891	2300	2301	0.9995654
A09	57102821	57103679	A09p58850.2_BraZ1	340.364	-	116	760	858	0.8857809
A09	57108370	57112073	A09p58860.2_BraZ1	1561.86	+	1495	3376	3703	0.9116932
A09	57119227	57119543	A09p58870.2_BraZ1	117	+	218	316	316	1.0000000
A09	57119623	57120932	A09p58880.2_BraZ1	1134	+	909	1309	1309	1.0000000
A09	57121412	57123013	A09p58890.2_BraZ1	797.023	-	863	1538	1601	0.9606496
A09	57127122	57127623	A09p58900.2_BraZ1	50.1	-	146	501	501	1.0000000
A09	57130364	57131876	A09p58910.2_BraZ1	151.2	+	803	1512	1512	1.0000000
A09	57132300	57134733	A09p58920.2_BraZ1	623.563	-	1518	2433	2433	1.0000000
A09	57144319	57145686	A09p58930.2_BraZ1	900.28	-	362	1367	1367	1.0000000
A09	57148674	57149161	A09p58940.2_BraZ1	2680	+	10	146	487	0.2997947
A09	57149739	57150646	A09p58950.2_BraZ1	264	-	44	583	907	0.6427784
A09	57151493	57154174	A09p58960.2_BraZ1	462.857	+	57	1164	2681	0.4341663
A09	57156893	57157004	A09p58970.2_BraZ1	11.1	-	0	0	111	0.0000000
A09	57157371	57159976	A09p58980.2_BraZ1	1786.18	-	28	672	2605	0.2579654
A09	57162931	57164598	A09p58990.2_BraZ1	811.785	-	364	1448	1667	0.8686263
A09	57172478	57173408	A09p59000.2_BraZ1	3934	+	354	930	930	1.0000000
A09	57179555	57181902	A09p59010.2_BraZ1	2259	-	181	1201	2347	0.5117171
A09	57183964	57185691	A09p59020.2_BraZ1	952.673	+	0	0	1727	0.0000000
A09	57185642	57187785	A09p59030.2_BraZ1	2055	-	19	487	2143	0.2272515
A09	57195733	57198050	A09p59040.2_BraZ1	1231.35	+	37	343	2317	0.1480363
A09	57199147	57200205	A09p59050.2_BraZ1	736	+	1077	1058	1058	1.0000000
A09	57200469	57203829	A09p59060.2_BraZ1	1800.63	-	1720	3275	3360	0.9747024
A09	57211822	57211945	A09p59070.2_BraZ1	12.3	+	159	123	123	1.0000000
A09	57216888	57218521	A09p59080.2_BraZ1	690	+	626	1581	1633	0.9681568
A09	57218614	57219700	A09p59090.2_BraZ1	108.6	-	490	1086	1086	1.0000000
A09	57222913	57225512	A09p59100.2_BraZ1	1342.12	-	951	2592	2599	0.9973066
A09	57226274	57228252	A09p59110.2_BraZ1	870.034	+	1227	1909	1978	0.9651163
A09	57229979	57239313	A09p59120.2_BraZ1	1706.21	-	3599	8797	9334	0.9424684
A09	57244769	57246591	A09p59130.2_BraZ1	597	+	847	1727	1822	0.9478595
A09	57247026	57247851	A09p59140.2_BraZ1	633	+	589	825	825	1.0000000
A09	57249215	57249632	A09p59150.2_BraZ1	41.7	+	130	417	417	1.0000000
A09	57250981	57252518	A09p59160.2_BraZ1	783	+	1040	1534	1537	0.9980481
A09	57255290	57257399	A09p59170.2_BraZ1	1488	-	619	1912	2109	0.9065908
A09	57258272	57262470	A09p59180.2_BraZ1	1439.96	-	1503	3902	4198	0.9294902
A09	57264499	57264811	A09p59190.2_BraZ1	31.2	-	69	312	312	1.0000000
A09	57266497	57268042	A09p59200.2_BraZ1	102	+	2607	1545	1545	1.0000000
A09	57268511	57269386	A09p59210.2_BraZ1	37.5	-	430	837	875	0.9565714
A09	57270344	57272043	A09p59220.2_BraZ1	37044	+	389	1352	1699	0.7957622
A09	57272591	57278828	A09p59230.2_BraZ1	2533.39	-	457	3442	6237	0.5518679
A09	57286880	57288935	A09p59240.2_BraZ1	205.5	-	257	975	2055	0.4744526
A09	57290015	57291805	A09p59250.2_BraZ1	880.218	+	952	1246	1790	0.6960894
A09	57292447	57297888	A09p59260.2_BraZ1	2016	-	577	2177	5441	0.4001103
A09	57305527	57305847	A09p59270.2_BraZ1	258	-	653	320	320	1.0000000
A09	57310300	57310723	A09p59280.2_BraZ1	42.3	+	2	29	423	0.0685579
A09	57314737	57317947	A09p59290.2_BraZ1	1917	+	1895	2946	3210	0.9177570
A09	57318277	57318915	A09p59300.2_BraZ1	456	-	194	557	638	0.8730407
A09	57325159	57325639	A09p59310.2_BraZ1	321	+	87	449	480	0.9354166
A09	57331847	57332411	A09p59320.2_BraZ1	56.4	+	196	521	564	0.9237589
A09	57332694	57334335	A09p59330.2_BraZ1	1328.25	+	2050	1641	1641	1.0000000
A09	57335287	57335965	A09p59340.2_BraZ1	67.8	-	358	678	678	1.0000000
A09	57336317	57337026	A09p59350.2_BraZ1	39.6	+	535	709	709	1.0000000
A09	57337493	57341512	A09p59360.2_BraZ1	23408	-	1618	3686	4019	0.9171436
A09	57342904	57344541	A09p59370.2_BraZ1	847.624	+	580	1511	1637	0.9230300
A09	57346301	57348426	A09p59380.2_BraZ1	320.526	-	1348	2125	2125	1.0000000
A09	57348920	57351729	A09p59390.2_BraZ1	1596.91	-	1055	2539	2809	0.9038804
A09	57362919	57363117	A09p59400.2_BraZ1	19.8	+	0	0	198	0.0000000
A09	57363175	57363502	A09p59410.2_BraZ1	32.7	-	0	0	327	0.0000000
A09	57368906	57376492	A09p59420.2_BraZ1	441.071	+	1506	5548	7586	0.7313472
A09	57382742	57385601	A09p59430.2_BraZ1	719.625	-	720	1461	2859	0.5110179
A09	57395973	57397943	A09p59440.2_BraZ1	424	-	209	1235	1970	0.6269035
A09	57409939	57411391	A09p59450.2_BraZ1	1209.21	+	1165	1452	1452	1.0000000
A09	57415778	57417650	A09p59460.2_BraZ1	539.651	-	253	1396	1872	0.7457265
A09	57418585	57420764	A09p59470.2_BraZ1	13280	+	727	2131	2179	0.9779716
A09	57422933	57424042	A09p59480.2_BraZ1	2431	+	1325	1109	1109	1.0000000
A09	57429780	57430764	A09p59490.2_BraZ1	2431	+	370	984	984	1.0000000
A09	57433462	57434090	A09p59500.2_BraZ1	4054.5	+	202	628	628	1.0000000
A09	57434854	57435195	A09p59510.2_BraZ1	171	+	68	341	341	1.0000000
A09	57435400	57440403	A09p59520.2_BraZ1	7965.85	+	6599	4980	5003	0.9954028
A09	57441109	57441478	A09p59530.2_BraZ1	333	+	835	369	369	1.0000000
A09	57443480	57444460	A09p59540.2_BraZ1	3576	+	1197	980	980	1.0000000
A09	57451088	57454012	A09p59550.2_BraZ1	947.5	-	650	2787	2924	0.9531464
A09	57456146	57456761	A09p59560.2_BraZ1	61.5	-	1312	615	615	1.0000000
A09	57461578	57463120	A09p59570.2_BraZ1	1392	+	434	1457	1542	0.9448768
A09	57463499	57466926	A09p59580.2_BraZ1	1825.65	-	822	3249	3427	0.9480595
A09	57471365	57473632	A09p59590.2_BraZ1	844.232	+	1688	2259	2267	0.9964711
A09	57473904	57474786	A09p59600.2_BraZ1	593.455	-	192	882	882	1.0000000
A09	57476407	57478420	A09p59610.2_BraZ1	1902	-	543	1929	2013	0.9582713
A09	57479008	57480553	A09p59620.2_BraZ1	3861	-	982	1545	1545	1.0000000
A09	57481507	57484176	A09p59630.2_BraZ1	1631.43	-	693	2484	2669	0.9306856
A09	57485487	57486082	A09p59640.2_BraZ1	316.8	+	129	570	595	0.9579832
A09	57489562	57491250	A09p59650.2_BraZ1	93.3	-	807	1688	1688	1.0000000
A09	57492573	57495123	A09p59660.2_BraZ1	1007.05	+	967	2388	2550	0.9364706
A09	57496710	57497301	A09p59670.2_BraZ1	279	+	75	591	591	1.0000000
A09	57497303	57499364	A09p59680.2_BraZ1	1308.4	-	1224	2061	2061	1.0000000
A09	57502511	57503201	A09p59690.2_BraZ1	68.7	+	220	690	690	1.0000000
A09	57504470	57505193	A09p59700.2_BraZ1	627	-	170	673	723	0.9308437
A09	57507611	57518830	A09p59710.2_BraZ1	3455.99	+	6889	10683	11219	0.9522239
A09	57520489	57520780	A09p59720.2_BraZ1	29.1	+	35	251	291	0.8625429
A09	57521173	57524038	A09p59730.2_BraZ1	1191.52	-	593	2412	2865	0.8418848
A09	57525310	57528008	A09p59740.2_BraZ1	1139.25	-	1042	2233	2698	0.8276501
A09	57537905	57550170	A09p59750.2_BraZ1	4031.28	+	4293	8079	12265	0.6587036
A09	57550800	57552035	A09p59760.2_BraZ1	1098	-	385	1233	1235	0.9983805
A09	57556876	57557283	A09p59770.2_BraZ1	222	-	42	139	407	0.3415233
A09	57560208	57561987	A09p59780.2_BraZ1	625.452	-	1135	1481	1779	0.8324901
A09	57564201	57565903	A09p59790.2_BraZ1	885.733	-	2155	1702	1702	1.0000000
A09	57569601	57573264	A09p59800.2_BraZ1	741.6	+	757	3016	3663	0.8233688
A09	57574613	57576522	A09p59810.2_BraZ1	611.031	-	367	1706	1909	0.8936616
A09	57578725	57581034	A09p59820.2_BraZ1	1201.38	-	1182	2056	2309	0.8904288
A09	57583276	57584637	A09p59830.2_BraZ1	10695	-	637	1361	1361	1.0000000
A09	57586291	57589408	A09p59840.2_BraZ1	1293	-	957	2831	3117	0.9082451
A09	57594893	57595802	A09p59850.2_BraZ1	2260.5	+	71	676	909	0.7436743
A09	57600910	57602354	A09p59860.2_BraZ1	93.0682	-	173	1185	1444	0.8206371
A09	57604177	57607976	A09p59870.2_BraZ1	1640.02	+	2233	3515	3799	0.9252435
A09	57610213	57612672	A09p59880.2_BraZ1	702.136	-	1392	2446	2459	0.9947133
A09	57613519	57614646	A09p59890.2_BraZ1	300.682	-	1162	1127	1127	1.0000000
A09	57616577	57619817	A09p59900.2_BraZ1	1907.12	+	652	2948	3240	0.9098765
A09	57620113	57621951	A09p59910.2_BraZ1	294.231	-	1626	1838	1838	1.0000000
A09	57622680	57623057	A09p59920.2_BraZ1	282	+	358	377	377	1.0000000
A09	57627898	57629275	A09p59930.2_BraZ1	1167.05	-	942	1377	1377	1.0000000
A09	57630252	57632411	A09p59940.2_BraZ1	215.7	+	578	2030	2159	0.9402501
A09	57632875	57634351	A09p59950.2_BraZ1	567	+	969	1476	1476	1.0000000
A09	57643655	57649745	A09p59960.2_BraZ1	2169	-	15060	5348	6090	0.8781609
A09	57650997	57651222	A09p59970.2_BraZ1	22.5	-	5	42	225	0.1866667
A09	57657036	57659341	A09p59980.2_BraZ1	352.688	+	2916	2297	2305	0.9965293
A09	57659483	57659776	A09p59990.2_BraZ1	167.5	+	655	293	293	1.0000000
A09	57660299	57662127	A09p60000.2_BraZ1	1201.2	-	1101	1737	1828	0.9502188
A09	57668262	57669987	A09p60010.2_BraZ1	172.5	-	940	1725	1725	1.0000000
A09	57670978	57672688	A09p60020.2_BraZ1	856.762	-	519	1463	1710	0.8555555
A09	57673448	57677062	A09p60030.2_BraZ1	1681.38	-	990	3115	3614	0.8619258
A09	57678839	57681499	A09p60040.2_BraZ1	1594.76	-	2278	2660	2660	1.0000000
A09	57683972	57691114	A09p60050.2_BraZ1	2780.5	+	3448	6680	7142	0.9353122
A09	57691946	57694055	A09p60060.2_BraZ1	1010	+	419	1729	2109	0.8198198
A09	57693759	57694487	A09p60070.2_BraZ1	342	+	237	728	728	1.0000000
A09	57695331	57696927	A09p60080.2_BraZ1	159.6	-	69	1074	1596	0.6729323
A09	57701994	57705064	A09p60090.2_BraZ1	2081.9	-	1411	3008	3070	0.9798046
A09	57708385	57709153	A09p60100.2_BraZ1	75.6	+	328	730	768	0.9505208
A09	57710948	57712325	A09p60110.2_BraZ1	1195.56	+	537	1356	1377	0.9847494
A09	57712699	57716539	A09p60120.2_BraZ1	1730.29	-	2495	3803	3840	0.9903646
A09	57717846	57718508	A09p60130.2_BraZ1	180	+	0	0	662	0.0000000
A09	57725788	57727599	A09p60140.2_BraZ1	752.143	-	302	1272	1811	0.7023744
A09	57728969	57731368	A09p60150.2_BraZ1	2011.43	-	747	2293	2399	0.9558149
A09	57732574	57733304	A09p60160.2_BraZ1	1056.19	+	777	695	730	0.9520548
A09	57734942	57739264	A09p60170.2_BraZ1	2031.95	+	929	3521	4322	0.8146691
A09	57751100	57752442	A09p60180.2_BraZ1	978	+	81	549	1342	0.4090909
A09	57757629	57759967	A09p60190.2_BraZ1	86.1	+	186	1172	2338	0.5012832
A09	57760413	57761037	A09p60200.2_BraZ1	360	-	345	624	624	1.0000000
A09	57765435	57765800	A09p60210.2_BraZ1	255	+	80	237	365	0.6493151
A09	57770855	57771822	A09p60220.2_BraZ1	696	+	161	903	967	0.9338159
A09	57773911	57774863	A09p60230.2_BraZ1	92.4	+	262	907	952	0.9527311
A09	57776287	57779726	A09p60240.2_BraZ1	1302.89	-	418	2637	3439	0.7667927
A09	57785562	57799317	A09p60250.2_BraZ1	1634.74	+	8283	12466	13755	0.9062886
A09	57791311	57791671	A09p60260.2_BraZ1	36	+	319	360	360	1.0000000
A09	57791677	57792034	A09p60270.2_BraZ1	35.7	+	458	357	357	1.0000000
A09	57800344	57805179	A09p60280.2_BraZ1	1582.43	-	2406	4322	4835	0.8938987
A09	57807316	57813008	A09p60290.2_BraZ1	2870.08	+	2805	5111	5692	0.8979269
A09	57813492	57814152	A09p60300.2_BraZ1	329.778	-	117	648	660	0.9818182
A09	57818958	57820302	A09p60310.2_BraZ1	10567.3	-	207	1163	1344	0.8653274
A09	57821420	57821945	A09p60320.2_BraZ1	52.5	-	306	525	525	1.0000000
A09	57823621	57825047	A09p60330.2_BraZ1	1546.88	-	791	1384	1426	0.9705470
A09	57826568	57827222	A09p60340.2_BraZ1	366	-	32	348	654	0.5321101
A09	57828069	57835807	A09p60350.2_BraZ1	1888.89	-	3857	7096	7738	0.9170328
A09	57835906	57837300	A09p60360.2_BraZ1	131.4	-	1099	1387	1394	0.9949785
A09	57838469	57839490	A09p60370.2_BraZ1	192	-	386	1021	1021	1.0000000
A09	57838563	57838857	A09p60380.2_BraZ1	159.955	-	136	294	294	1.0000000
A09	57842778	57844181	A09p60390.2_BraZ1	2371.2	-	836	1403	1403	1.0000000
A09	57846062	57846955	A09p60400.2_BraZ1	69.7143	-	582	824	893	0.9227324
A09	57848012	57849407	A09p60410.2_BraZ1	1123.71	-	287	1368	1395	0.9806452
A09	57850405	57853767	A09p60420.2_BraZ1	1728.33	+	903	3055	3362	0.9086853
A09	57854729	57856360	A09p60430.2_BraZ1	1479	-	218	906	1631	0.5554875
A09	57861891	57863492	A09p60440.2_BraZ1	1061.82	+	1111	1506	1601	0.9406621
A09	57868968	57870614	A09p60450.2_BraZ1	1491	-	181	984	1646	0.5978129
A09	57872739	57875748	A09p60460.2_BraZ1	1690.29	-	899	2744	3009	0.9119309
A09	57876538	57878063	A09p60470.2_BraZ1	885.236	-	395	1509	1525	0.9895082
A09	57878257	57880792	A09p60480.2_BraZ1	253.5	+	728	2043	2535	0.8059171
A09	57885495	57888625	A09p60490.2_BraZ1	817	-	1344	3003	3130	0.9594249
A09	57911312	57911699	A09p60500.2_BraZ1	108	+	579	387	387	1.0000000
A09	57911960	57912620	A09p60510.2_BraZ1	171	+	1071	660	660	1.0000000
A09	57912785	57914972	A09p60520.2_BraZ1	569.16	+	1693	2187	2187	1.0000000
A09	57916565	57918559	A09p60530.2_BraZ1	1158.3	+	343	1670	1994	0.8375126
A09	57918917	57924024	A09p60540.2_BraZ1	1799.43	-	2999	5054	5107	0.9896221
A09	57925174	57925969	A09p60550.2_BraZ1	304.5	+	638	795	795	1.0000000
A09	57927568	57928697	A09p60560.2_BraZ1	662.625	+	489	1082	1129	0.9583703
A09	57929117	57930691	A09p60570.2_BraZ1	833.469	-	1458	1574	1574	1.0000000
A09	57931309	57932552	A09p60580.2_BraZ1	1167	-	99	913	1243	0.7345133
A09	57944001	57946420	A09p60590.2_BraZ1	451.818	+	1112	2184	2419	0.9028524
A09	57948949	57951215	A09p60600.2_BraZ1	1071.52	+	1153	2266	2266	1.0000000
A09	57955223	57956986	A09p60610.2_BraZ1	897	+	229	1120	1763	0.6352808
A09	57957257	57960489	A09p60620.2_BraZ1	1209.33	-	432	2428	3232	0.7512376
A09	57967654	57968002	A09p60630.2_BraZ1	34.8	+	51	348	348	1.0000000
A09	57969799	57972512	A09p60640.2_BraZ1	1890.67	-	752	2448	2713	0.9023222
A09	57980236	57981836	A09p60650.2_BraZ1	716.833	-	593	1568	1600	0.9800000
A09	57986820	57987953	A09p60660.2_BraZ1	59.1	+	885	1133	1133	1.0000000
A09	57988480	57990196	A09p60670.2_BraZ1	4880	-	877	1682	1716	0.9801865
A09	57990985	57992875	A09p60680.2_BraZ1	189	-	123	1025	1890	0.5423281
A09	57996022	57997266	A09p60690.2_BraZ1	378	-	23	137	1244	0.1101286
A09	58002660	58004728	A09p60700.2_BraZ1	873.409	+	617	2001	2068	0.9676015
A09	58006649	58007469	A09p60710.2_BraZ1	288	-	294	694	820	0.8463415
A09	58015755	58017165	A09p60720.2_BraZ1	13513.5	+	734	1402	1410	0.9943262
A09	58019918	58020472	A09p60730.2_BraZ1	10787	+	289	554	554	1.0000000
A09	58020714	58022048	A09p60740.2_BraZ1	782.5	+	630	1334	1334	1.0000000
A09	58022098	58022341	A09p60750.2_BraZ1	150	-	272	243	243	1.0000000
A09	58022400	58022698	A09p60760.2_BraZ1	213	-	300	298	298	1.0000000
A09	58023140	58025383	A09p60770.2_BraZ1	1844.18	+	761	1909	2243	0.8510923
A09	58026822	58027065	A09p60780.2_BraZ1	153	+	104	243	243	1.0000000
A09	58027897	58029360	A09p60790.2_BraZ1	1221	+	797	1456	1463	0.9952153
A09	58030216	58031811	A09p60800.2_BraZ1	755.286	-	1005	1502	1595	0.9416928
A09	58033456	58034719	A09p60810.2_BraZ1	697.714	-	610	1242	1263	0.9833729
A09	58049889	58051463	A09p60820.2_BraZ1	2270.4	+	871	1451	1574	0.9218552
A09	58063438	58064133	A09p60830.2_BraZ1	58.2	-	12	412	695	0.5928057
A09	58072266	58073457	A09p60840.2_BraZ1	209.569	+	803	1175	1191	0.9865659
A09	58073435	58079255	A09p60850.2_BraZ1	384.921	+	1608	3609	5820	0.6201031
A09	58079478	58082560	A09p60860.2_BraZ1	1472.72	-	1789	3082	3082	1.0000000
A09	58086476	58087130	A09p60870.2_BraZ1	65.1	+	254	635	654	0.9709480
A09	58089015	58090983	A09p60880.2_BraZ1	1362	-	1258	1968	1968	1.0000000
A09	58100447	58102476	A09p60890.2_BraZ1	1353	-	202	1531	2029	0.7545589
A09	58108714	58110793	A09p60900.2_BraZ1	672	+	2518	2079	2079	1.0000000
A09	58114327	58116127	A09p60910.2_BraZ1	924	+	1283	1800	1800	1.0000000
A09	58118620	58120368	A09p60920.2_BraZ1	1089	-	996	1601	1748	0.9159039
A09	58122393	58124222	A09p60930.2_BraZ1	445.63	+	1706	1747	1829	0.9551668
A09	58128432	58133073	A09p60940.2_BraZ1	3117.52	-	1927	4346	4641	0.9364361
A09	58133671	58135461	A09p60950.2_BraZ1	849.3	+	677	1762	1790	0.9843575
A09	58135561	58139424	A09p60960.2_BraZ1	297.5	+	785	1973	3863	0.5107430
A09	58139750	58144652	A09p60970.2_BraZ1	1029.6	+	1497	1708	4902	0.3484292
A09	58142397	58143730	A09p60980.2_BraZ1	128.7	+	10	135	1333	0.1012753
A09	58146093	58147748	A09p60990.2_BraZ1	1066.38	+	569	1655	1655	1.0000000
A09	58148150	58149476	A09p61000.2_BraZ1	1131.25	+	0	0	1326	0.0000000
A09	58149377	58150770	A09p61010.2_BraZ1	140.4	+	73	430	1393	0.3086863
A09	58156823	58157954	A09p61020.2_BraZ1	772.962	-	458	1131	1131	1.0000000
A09	58161452	58164145	A09p61030.2_BraZ1	1203.89	+	1957	2595	2693	0.9636093
A09	58179607	58179874	A09p61040.2_BraZ1	26.7	+	2	42	267	0.1573034
A09	58183481	58184433	A09p61050.2_BraZ1	537.188	+	364	734	952	0.7710084
A09	58184951	58186847	A09p61060.2_BraZ1	791.388	-	1165	1746	1896	0.9208861
A09	58188928	58190266	A09p61070.2_BraZ1	133.8	-	111	507	1338	0.3789238
A09	58192636	58193530	A09p61080.2_BraZ1	89.4	-	38	497	894	0.5559284
A09	58199103	58199343	A09p61090.2_BraZ1	204	-	154	240	240	1.0000000
A09	58205298	58208242	A09p61100.2_BraZ1	1335.6	+	2434	2766	2944	0.9395381
A09	58209314	58211200	A09p61110.2_BraZ1	600.348	+	1166	1778	1886	0.9427360
A09	58211949	58216179	A09p61120.2_BraZ1	2034.57	-	727	3095	4230	0.7316785
A09	58223745	58224681	A09p61130.2_BraZ1	744	+	12	237	936	0.2532051
A09	58235207	58237508	A09p61140.2_BraZ1	542.667	+	1531	2206	2301	0.9587136
A09	58238448	58241058	A09p61150.2_BraZ1	1190.78	+	1153	2347	2610	0.8992337
A09	58241800	58243712	A09p61160.2_BraZ1	880.32	+	1613	1912	1912	1.0000000
A09	58258034	58260482	A09p61170.2_BraZ1	486.933	+	1621	2448	2448	1.0000000
A09	58261849	58264469	A09p61180.2_BraZ1	1654.71	-	1683	2427	2620	0.9263359
A09	58271925	58272380	A09p61190.2_BraZ1	32.7	+	27	357	455	0.7846154
A09	58272885	58273156	A09p61200.2_BraZ1	174	+	59	271	271	1.0000000
A09	58275676	58277663	A09p61210.2_BraZ1	1380	+	1320	1951	1987	0.9818822
A09	58288772	58289199	A09p61220.2_BraZ1	228	-	103	263	427	0.6159251
A09	58293832	58295711	A09p61230.2_BraZ1	1386	+	402	1646	1879	0.8759979
A09	58295935	58297454	A09p61240.2_BraZ1	1122	-	815	1519	1519	1.0000000
A09	58299164	58299299	A09p61250.2_BraZ1	13.5	-	61	135	135	1.0000000
A09	58302016	58302388	A09p61260.2_BraZ1	37.2	+	0	0	372	0.0000000
A09	58316905	58317013	A09p61270.2_BraZ1	10.8	+	121	108	108	1.0000000
A09	58318038	58318785	A09p61280.2_BraZ1	670	+	428	747	747	1.0000000
A09	58328935	58331142	A09p61290.2_BraZ1	1270.5	+	414	1802	2207	0.8164930
A09	58333670	58334531	A09p61300.2_BraZ1	328	+	388	836	861	0.9709640
A09	58334974	58335948	A09p61310.2_BraZ1	209.045	+	650	974	974	1.0000000
A09	58336091	58337364	A09p61320.2_BraZ1	555.5	+	600	1228	1273	0.9646505
A09	58339015	58340155	A09p61330.2_BraZ1	113.4	+	334	1058	1140	0.9280702
A09	58341520	58341853	A09p61340.2_BraZ1	33.3	+	173	323	333	0.9699700
A09	58342867	58344929	A09p61350.2_BraZ1	1167.76	+	132	1679	2062	0.8142580
A09	58348166	58348772	A09p61360.2_BraZ1	60.6	+	230	606	606	1.0000000
A09	58349649	58351020	A09p61370.2_BraZ1	878.423	+	322	1369	1371	0.9985412
A09	58351245	58352523	A09p61380.2_BraZ1	127.8	-	19	238	1278	0.1862285
A09	58355089	58356355	A09p61390.2_BraZ1	126.6	+	18	58	1266	0.0458136
A09	58364047	58366614	A09p61400.2_BraZ1	191.25	-	509	1563	2567	0.6088820
A09	58366839	58375206	A09p61410.2_BraZ1	2731.5	-	1953	4798	8367	0.5734433
A09	58381686	58383154	A09p61420.2_BraZ1	636	+	399	1252	1468	0.8528610
A09	58385906	58387897	A09p61430.2_BraZ1	509.438	+	596	1692	1991	0.8498242
A09	58388905	58390387	A09p61440.2_BraZ1	675	-	817	1482	1482	1.0000000
A09	58394277	58396924	A09p61450.2_BraZ1	1676.12	+	356	1671	2647	0.6312807
A09	58398935	58401350	A09p61460.2_BraZ1	241.5	-	245	1631	2415	0.6753623
A09	58410601	58412049	A09p61470.2_BraZ1	725.2	-	757	1448	1448	1.0000000
A09	58414053	58418662	A09p61480.2_BraZ1	1466.14	-	1450	3826	4609	0.8301150
A09	58442516	58442678	A09p61490.2_BraZ1	16.2	+	26	162	162	1.0000000
A09	58465942	58467634	A09p61500.2_BraZ1	169.2	+	127	719	1692	0.4249409
A09	58471352	58473930	A09p61510.2_BraZ1	1355.75	+	175	1883	2578	0.7304112
A09	58474830	58477010	A09p61520.2_BraZ1	1575	-	432	1822	2180	0.8357798
A09	58477997	58478758	A09p61530.2_BraZ1	624	+	504	749	761	0.9842313
A09	58479602	58480311	A09p61540.2_BraZ1	279	-	167	709	709	1.0000000
A09	58482433	58482631	A09p61550.2_BraZ1	19.8	-	145	198	198	1.0000000
A09	58483371	58484400	A09p61560.2_BraZ1	100.2	+	326	999	1029	0.9708455
A09	58484613	58489562	A09p61570.2_BraZ1	2568.21	-	2441	4481	4949	0.9054354
A09	58490536	58518295	A09p61580.2_BraZ1	2016	-	13977	23775	27759	0.8564790
A09	58523126	58523675	A09p61590.2_BraZ1	54.9	-	187	473	549	0.8615665
A09	58530379	58531403	A09p61600.2_BraZ1	663	+	2	271	1024	0.2646484
A09	58534223	58534341	A09p61610.2_BraZ1	11.4	+	10	113	118	0.9576271
A09	58539286	58540775	A09p61620.2_BraZ1	741.556	-	651	1250	1489	0.8394896
A09	58542876	58543488	A09p61630.2_BraZ1	61.2	-	58	482	612	0.7875817
A09	58544715	58547556	A09p61640.2_BraZ1	930	+	2090	2812	2841	0.9897923
A09	58548063	58549909	A09p61650.2_BraZ1	624.094	+	1957	1846	1846	1.0000000
A09	58551550	58554370	A09p61660.2_BraZ1	26106	+	820	2633	2820	0.9336879
A09	58554661	58561870	A09p61670.2_BraZ1	3306.71	-	2319	6722	7209	0.9324455
A09	58568400	58570181	A09p61680.2_BraZ1	938.786	+	1017	1702	1781	0.9556429
A09	58570676	58571468	A09p61690.2_BraZ1	821.071	+	176	701	792	0.8851010
A09	58571953	58573995	A09p61700.2_BraZ1	812.547	-	1098	1904	2042	0.9324192
A09	58575464	58577532	A09p61710.2_BraZ1	1305	+	509	1797	2068	0.8689555
A09	58578699	58593296	A09p61720.2_BraZ1	960	+	1105	8823	14597	0.6044393
A09	58589258	58589609	A09p61730.2_BraZ1	35.1	+	2	105	351	0.2991453
A09	58593688	58601805	A09p61740.2_BraZ1	420.25	-	4272	7743	8117	0.9539239
A09	58607382	58608662	A09p61750.2_BraZ1	457.556	+	42	768	1280	0.6000000
A09	58609365	58610638	A09p61760.2_BraZ1	852	-	248	898	1273	0.7054203
A09	58611776	58612209	A09p61770.2_BraZ1	318	-	30	200	433	0.4618938
A09	58621656	58623139	A09p61780.2_BraZ1	577.778	+	1500	1483	1483	1.0000000
A09	58623487	58624102	A09p61790.2_BraZ1	61.5	-	12	233	615	0.3788618
A09	58635850	58637610	A09p61800.2_BraZ1	1266	+	632	1516	1760	0.8613636
A09	58638821	58639239	A09p61810.2_BraZ1	76.2353	+	775	418	418	1.0000000
A09	58640907	58641710	A09p61820.2_BraZ1	544.974	-	782	801	803	0.9975094
A09	58642779	58645154	A09p61830.2_BraZ1	1040	+	2906	2375	2375	1.0000000
A09	58645565	58647944	A09p61840.2_BraZ1	1291.27	-	285	2155	2379	0.9058428
A09	58651125	58652804	A09p61850.2_BraZ1	1293	+	1275	1654	1679	0.9851102
A09	58653121	58657177	A09p61860.2_BraZ1	672	-	2427	3171	4056	0.7818047
A09	58658423	58659098	A09p61870.2_BraZ1	67.5	+	351	675	675	1.0000000
A09	58661142	58664434	A09p61880.2_BraZ1	2880	-	679	2810	3292	0.8535845
A09	58668008	58668879	A09p61890.2_BraZ1	452.045	+	186	689	871	0.7910448
A09	58670444	58671851	A09p61900.2_BraZ1	831	-	740	1249	1407	0.8877043
A09	58676584	58677588	A09p61910.2_BraZ1	900	-	109	663	1004	0.6603585
A09	58686662	58690067	A09p61920.2_BraZ1	1404	-	2725	2834	3405	0.8323054
A09	58693592	58694313	A09p61930.2_BraZ1	161.571	-	343	686	721	0.9514563
A09	58694901	58696455	A09p61940.2_BraZ1	845.714	-	488	1392	1554	0.8957529
A09	58697500	58703055	A09p61950.2_BraZ1	2945.45	+	2745	5275	5555	0.9495950
A09	58703483	58705883	A09p61960.2_BraZ1	1363.54	-	1522	2227	2400	0.9279166
A09	58708651	58709530	A09p61970.2_BraZ1	360	+	29	450	879	0.5119454
A09	58711723	58712970	A09p61980.2_BraZ1	434.106	+	1673	1247	1247	1.0000000
A09	58713742	58715067	A09p61990.2_BraZ1	2908.2	-	444	1325	1325	1.0000000
A09	58715947	58718257	A09p62000.2_BraZ1	178.2	-	1450	2291	2310	0.9917749
A09	58718672	58720699	A09p62010.2_BraZ1	1451.59	+	858	2020	2027	0.9965466
A09	58727108	58728047	A09p62020.2_BraZ1	93.9	+	566	933	939	0.9936102
A09	58728794	58730495	A09p62030.2_BraZ1	1024	+	897	1629	1701	0.9576719
A09	58733217	58738432	A09p62040.2_BraZ1	2606.96	+	1891	4574	5215	0.8770853
A09	58740426	58740712	A09p62050.2_BraZ1	111	+	0	0	286	0.0000000
A09	58747590	58749330	A09p62060.2_BraZ1	1117.57	-	236	1202	1740	0.6908046
A09	58767162	58769535	A09p62070.2_BraZ1	237	+	372	2103	2373	0.8862200
A09	58770358	58770625	A09p62080.2_BraZ1	26.7	+	459	267	267	1.0000000
A09	58770839	58774984	A09p62090.2_BraZ1	2820.71	-	3444	4145	4145	1.0000000
A09	58776018	58778282	A09p62100.2_BraZ1	1761.94	-	897	2157	2264	0.9527385
A09	58781943	58782269	A09p62110.2_BraZ1	246	-	435	326	326	1.0000000
A09	58794621	58795561	A09p62120.2_BraZ1	578.25	-	397	940	940	1.0000000
A09	58796818	58797268	A09p62130.2_BraZ1	45	-	202	450	450	1.0000000
A09	58802263	58810656	A09p62140.2_BraZ1	1004.08	+	4010	7742	8393	0.9224353
A09	58810962	58812559	A09p62150.2_BraZ1	705.094	-	999	1445	1597	0.9048215
A09	58813265	58814070	A09p62160.2_BraZ1	573	-	238	805	805	1.0000000
A09	58820664	58820957	A09p62170.2_BraZ1	174	+	86	293	293	1.0000000
A09	58821021	58821834	A09p62180.2_BraZ1	337.5	+	223	720	813	0.8856089
A09	58823519	58825968	A09p62190.2_BraZ1	996	-	1972	2416	2449	0.9865251
A09	58826953	58828762	A09p62200.2_BraZ1	561.68	-	789	1793	1809	0.9911553
A09	58829386	58830329	A09p62210.2_BraZ1	1018.67	-	361	923	943	0.9787911
A09	58830822	58832569	A09p62220.2_BraZ1	1233.33	+	255	1193	1747	0.6828849
A09	58832868	58834106	A09p62230.2_BraZ1	852	-	60	645	1238	0.5210016
A09	58834279	58842730	A09p62240.2_BraZ1	1122.33	+	3244	7135	8451	0.8442788
A09	58835604	58836658	A09p62250.2_BraZ1	467.4	-	289	780	1054	0.7400380
A09	58836537	58837145	A09p62260.2_BraZ1	306	-	640	600	608	0.9868421
A09	58838617	58839089	A09p62270.2_BraZ1	360	+	367	472	472	1.0000000
A09	58843029	58844266	A09p62280.2_BraZ1	881.721	-	46	802	1237	0.6483428
A09	58844423	58850717	A09p62290.2_BraZ1	1345.5	+	2257	5742	6294	0.9122974
A09	58846007	58847849	A09p62300.2_BraZ1	1389	-	1172	1842	1842	1.0000000
A09	58848026	58848443	A09p62310.2_BraZ1	41.7	-	47	250	417	0.5995204
A09	58851498	58852848	A09p62320.2_BraZ1	135	-	188	791	1350	0.5859259
A09	58853618	58856382	A09p62330.2_BraZ1	2374.39	+	1082	2473	2764	0.8947178
A09	58865310	58865997	A09p62340.2_BraZ1	68.7	+	137	654	687	0.9519651
A09	58869623	58870478	A09p62350.2_BraZ1	456.261	-	329	855	855	1.0000000
A09	58882098	58884816	A09p62360.2_BraZ1	1317.4	+	1165	2512	2718	0.9242090
A09	58885060	58885661	A09p62370.2_BraZ1	411.907	-	121	530	601	0.8818635
A09	58885964	58886178	A09p62380.2_BraZ1	15	+	3	160	214	0.7476636
A09	58886277	58887908	A09p62390.2_BraZ1	796.32	+	378	1401	1631	0.8589822
A09	58889296	58894322	A09p62400.2_BraZ1	1715.06	+	1476	3799	5026	0.7558695
A09	58894567	58895434	A09p62410.2_BraZ1	546.375	-	1209	867	867	1.0000000
A09	58896277	58896596	A09p62420.2_BraZ1	246	+	0	0	319	0.0000000
A09	58896604	58896935	A09p62430.2_BraZ1	21.0909	+	0	0	331	0.0000000
A09	58897599	58900875	A09p62440.2_BraZ1	8184	-	901	3061	3276	0.9343712
A09	58903814	58906868	A09p62450.2_BraZ1	2202.37	+	545	2486	3054	0.8140144
A09	58926257	58927127	A09p62460.2_BraZ1	750	-	109	481	870	0.5528736
A09	58934008	58934905	A09p62470.2_BraZ1	750	-	173	897	897	1.0000000
A09	58939634	58941110	A09p62480.2_BraZ1	756	-	521	869	1476	0.5887534
A09	58948294	58952176	A09p62490.2_BraZ1	2099.82	-	1320	3314	3882	0.8536837
A09	58953007	58954461	A09p62500.2_BraZ1	888	+	652	1404	1454	0.9656121
A09	58955344	58964145	A09p62510.2_BraZ1	1110	-	5063	5862	8801	0.6660607
A09	58956817	58957489	A09p62520.2_BraZ1	417	+	0	0	672	0.0000000
A09	58967848	58969961	A09p62530.2_BraZ1	5250	-	927	2109	2113	0.9981070
A09	58976061	58977285	A09p62540.2_BraZ1	401.767	+	1977	1224	1224	1.0000000
A09	58977997	58980148	A09p62550.2_BraZ1	970.442	-	392	1615	2151	0.7508136
A09	58981259	58986864	A09p62560.2_BraZ1	3698.29	-	537	3005	5605	0.5361285
A09	58987092	58987425	A09p62570.2_BraZ1	252	+	248	333	333	1.0000000
A09	58989338	58990526	A09p62580.2_BraZ1	118.8	+	240	851	1188	0.7163300
A09	58992487	58994214	A09p62590.2_BraZ1	675.826	+	810	1727	1727	1.0000000
A09	58994442	58999312	A09p62600.2_BraZ1	946.864	+	3027	4814	4870	0.9885010
A09	59000200	59000786	A09p62610.2_BraZ1	408	+	473	586	586	1.0000000
A09	59000766	59001422	A09p62620.2_BraZ1	1341	+	302	563	656	0.8582317
A09	59003112	59003491	A09p62630.2_BraZ1	291	+	15	334	379	0.8812665
A09	59004059	59004173	A09p62640.2_BraZ1	11.4	-	15	114	114	1.0000000
A09	59007410	59008723	A09p62650.2_BraZ1	126	+	1216	1313	1313	1.0000000
A09	59014876	59015287	A09p62660.2_BraZ1	41.1	+	0	0	411	0.0000000
A09	59019779	59022000	A09p62670.2_BraZ1	1389	+	425	1480	2221	0.6663665
A09	59023747	59024009	A09p62680.2_BraZ1	216	-	220	262	262	1.0000000
A09	59024404	59024542	A09p62690.2_BraZ1	13.8	-	218	138	138	1.0000000
A09	59024569	59024761	A09p62700.2_BraZ1	19.2	+	356	192	192	1.0000000
A09	59024823	59025123	A09p62710.2_BraZ1	27.6	+	506	300	300	1.0000000
A09	59025821	59025923	A09p62720.2_BraZ1	10.2	+	0	0	102	0.0000000
A09	59026122	59026346	A09p62730.2_BraZ1	132	+	0	0	224	0.0000000
A09	59027820	59030204	A09p62740.2_BraZ1	488.212	+	4	29	2384	0.0121644
A09	59032964	59035952	A09p62750.2_BraZ1	1554.82	-	2167	2726	2988	0.9123159
A09	59037713	59040362	A09p62760.2_BraZ1	1674.91	-	864	2546	2649	0.9611174
A09	59040689	59042391	A09p62770.2_BraZ1	1094.74	+	730	1702	1702	1.0000000
A09	59052181	59054847	A09p62780.2_BraZ1	1399.74	+	1361	2540	2666	0.9527382
A09	59055388	59057805	A09p62790.2_BraZ1	1161.62	+	1538	2417	2417	1.0000000
A09	59058356	59059497	A09p62800.2_BraZ1	1038	-	268	1054	1141	0.9237511
A09	59063578	59064135	A09p62810.2_BraZ1	528	-	314	557	557	1.0000000
A09	59064135	59064736	A09p62820.2_BraZ1	429	-	219	599	601	0.9966722
A09	59067371	59068535	A09p62830.2_BraZ1	1023	-	12	414	1164	0.3556701
A09	59075023	59076409	A09p62840.2_BraZ1	582.282	+	613	1386	1386	1.0000000
A09	59076876	59079004	A09p62850.2_BraZ1	1271.88	-	540	2128	2128	1.0000000
A09	59083399	59090503	A09p62860.2_BraZ1	4422.26	+	941	5715	7104	0.8044764
A09	59093129	59097846	A09p62870.2_BraZ1	2650.5	-	1409	4077	4717	0.8643205
A09	59107633	59108716	A09p62880.2_BraZ1	108.3	+	337	1053	1083	0.9722992
A09	59108940	59113632	A09p62890.2_BraZ1	2337.43	-	2678	3762	4692	0.8017903
A09	59113965	59114943	A09p62900.2_BraZ1	655.087	+	1178	978	978	1.0000000
A09	59119356	59121368	A09p62910.2_BraZ1	1203	+	1768	2012	2012	1.0000000
A09	59123150	59125662	A09p62920.2_BraZ1	645.634	+	2363	2512	2512	1.0000000
A09	59128442	59129783	A09p62930.2_BraZ1	134.1	+	772	1341	1341	1.0000000
A09	59134084	59140064	A09p62940.2_BraZ1	2732.36	-	2379	5370	5980	0.8979933
A09	59143840	59143993	A09p62950.2_BraZ1	15.3	+	0	0	153	0.0000000
A09	59144119	59144284	A09p62960.2_BraZ1	16.5	+	0	0	165	0.0000000
A09	59147636	59150270	A09p62970.2_BraZ1	263.1	-	1723	2634	2634	1.0000000
A09	59159041	59159652	A09p62980.2_BraZ1	52.2	-	114	591	611	0.9672668
A09	59165793	59166785	A09p62990.2_BraZ1	72.6	+	1179	992	992	1.0000000
A09	59169458	59169740	A09p63000.2_BraZ1	28.2	+	166	282	282	1.0000000
A09	59170470	59176097	A09p63010.2_BraZ1	2700.87	-	3320	5395	5627	0.9587702
A09	59177124	59177861	A09p63020.2_BraZ1	657	-	513	737	737	1.0000000
A09	59178993	59179386	A09p63030.2_BraZ1	39.3	+	42	221	393	0.5623410
A09	59180353	59182629	A09p63040.2_BraZ1	951.853	-	1200	2205	2276	0.9688049
A09	59185858	59189653	A09p63050.2_BraZ1	2269.27	-	2374	3706	3795	0.9765481
A09	59204273	59206916	A09p63060.2_BraZ1	1565.78	-	950	2405	2643	0.9099508
A09	59208697	59210216	A09p63070.2_BraZ1	882	-	114	1109	1519	0.7300856
A09	59222355	59224447	A09p63080.2_BraZ1	1049.23	+	1365	1974	2092	0.9435946
A09	59227357	59228389	A09p63090.2_BraZ1	103.2	-	710	1032	1032	1.0000000
A09	59229486	59237751	A09p63100.2_BraZ1	690.992	-	4520	7952	8265	0.9621295
A09	59241357	59242444	A09p63110.2_BraZ1	388.5	-	1096	1087	1087	1.0000000
A09	59242848	59250010	A09p63120.2_BraZ1	2928.73	+	7235	7039	7162	0.9828261
A09	59252105	59252918	A09p63130.2_BraZ1	81.3	+	319	785	813	0.9655597
A09	59253830	59255694	A09p63140.2_BraZ1	1394.44	-	791	1864	1864	1.0000000
A09	59262003	59266130	A09p63150.2_BraZ1	2051.38	-	1680	3582	4127	0.8679428
A09	59275617	59278430	A09p63160.2_BraZ1	1019.79	+	2533	2807	2813	0.9978670
A09	59279457	59286895	A09p63170.2_BraZ1	4842.33	+	3520	7251	7438	0.9748588
A09	59298197	59300192	A09p63180.2_BraZ1	1125	+	209	1406	1995	0.7047619
A09	59303547	59305357	A09p63190.2_BraZ1	1723.68	+	393	1379	1810	0.7618784
A09	59305357	59306679	A09p63200.2_BraZ1	619.2	+	334	1202	1322	0.9092284
A09	59312697	59314223	A09p63210.2_BraZ1	151.8	+	228	1473	1526	0.9652687
A09	59318212	59320585	A09p63220.2_BraZ1	1409.06	+	363	2186	2373	0.9211968
A09	59321602	59321788	A09p63230.2_BraZ1	18.6	+	96	186	186	1.0000000
A09	59326917	59327934	A09p63240.2_BraZ1	101.7	+	790	1017	1017	1.0000000
A09	59329400	59351481	A09p63250.2_BraZ1	2202	-	7434	14571	22081	0.6598886
A09	59331467	59331761	A09p63260.2_BraZ1	249	+	13	73	294	0.2482993
A09	59335249	59335856	A09p63270.2_BraZ1	439.714	+	635	581	607	0.9571664
A09	59336381	59336855	A09p63280.2_BraZ1	47.4	+	166	474	474	1.0000000
A09	59345655	59348848	A09p63290.2_BraZ1	301.95	+	334	1949	3193	0.6103978
A09	59351687	59352746	A09p63300.2_BraZ1	105	+	465	913	1059	0.8621341
A09	59354135	59357185	A09p63310.2_BraZ1	950.731	-	1244	2968	3050	0.9731147
A09	59365846	59367147	A09p63320.2_BraZ1	833.478	+	421	1297	1301	0.9969254
A09	59376328	59378856	A09p63330.2_BraZ1	1941	+	583	2403	2528	0.9505538
A09	59379153	59381387	A09p63340.2_BraZ1	405.818	+	1087	2183	2234	0.9771710
A09	59382098	59383459	A09p63350.2_BraZ1	495.075	-	1089	1340	1361	0.9845701
A09	59384427	59385133	A09p63360.2_BraZ1	531	+	289	702	706	0.9943343
A09	59385669	59389196	A09p63370.2_BraZ1	1659.09	+	938	2846	3527	0.8069181
A09	59391328	59391574	A09p63380.2_BraZ1	24.6	+	141	246	246	1.0000000
A09	59394641	59400715	A09p63390.2_BraZ1	3042.31	+	3835	5917	6074	0.9741521
A09	59403907	59404441	A09p63400.2_BraZ1	53.4	+	384	534	534	1.0000000
A09	59404977	59405351	A09p63410.2_BraZ1	22.5	-	0	0	374	0.0000000
A09	59405919	59406351	A09p63420.2_BraZ1	3009	-	0	0	432	0.0000000
A09	59413688	59415272	A09p63430.2_BraZ1	909.9	+	1271	1584	1584	1.0000000
A09	59415438	59417843	A09p63440.2_BraZ1	2596.5	-	1218	2381	2405	0.9900208
A09	59419371	59420388	A09p63450.2_BraZ1	101.7	-	387	998	1017	0.9813176
A09	59428320	59428869	A09p63460.2_BraZ1	54.6	+	77	429	549	0.7814208
A09	59429877	59431090	A09p63470.2_BraZ1	631.35	+	850	1213	1213	1.0000000
A09	59432662	59433976	A09p63480.2_BraZ1	131.4	+	367	1314	1314	1.0000000
A09	59437321	59438908	A09p63490.2_BraZ1	15627.8	+	888	1413	1587	0.8903592
A09	59439932	59441799	A09p63500.2_BraZ1	1137.1	-	569	1726	1867	0.9244778
A09	59447541	59448303	A09p63510.2_BraZ1	76.2	-	176	693	762	0.9094488
A09	59457964	59458378	A09p63520.2_BraZ1	240	-	246	401	414	0.9685990
A09	59464041	59465917	A09p63530.2_BraZ1	1086.55	-	809	1873	1876	0.9984009
A09	59471096	59472753	A09p63540.2_BraZ1	454.121	+	2567	1657	1657	1.0000000
A09	59472979	59475482	A09p63550.2_BraZ1	1204.84	-	2394	2503	2503	1.0000000
A09	59476294	59477111	A09p63560.2_BraZ1	326.767	-	1105	817	817	1.0000000
A09	59478890	59480517	A09p63570.2_BraZ1	808.35	+	2216	1627	1627	1.0000000
A09	59484793	59485662	A09p63580.2_BraZ1	747	-	338	609	869	0.7008055
A09	59497306	59497458	A09p63590.2_BraZ1	12.6	+	332	152	152	1.0000000
A09	59499635	59500951	A09p63600.2_BraZ1	495.545	+	613	1272	1316	0.9665654
A09	59507740	59511111	A09p63610.2_BraZ1	1943.62	-	2636	3371	3371	1.0000000
A09	59512657	59513827	A09p63620.2_BraZ1	718.929	+	663	1170	1170	1.0000000
A09	59515615	59523737	A09p63630.2_BraZ1	277.038	-	6063	8058	8122	0.9921201
A09	59527544	59528937	A09p63640.2_BraZ1	671.333	-	1941	1393	1393	1.0000000
A09	59530561	59531424	A09p63650.2_BraZ1	554.81	+	526	863	863	1.0000000
A09	59531863	59536103	A09p63660.2_BraZ1	1632.19	-	3642	4097	4240	0.9662736
A09	59539145	59542250	A09p63670.2_BraZ1	6408	+	1233	2978	3105	0.9590982
A09	59542996	59548714	A09p63680.2_BraZ1	1311.79	-	5258	5331	5718	0.9323190
A09	59549288	59551841	A09p63690.2_BraZ1	1808.47	+	1509	2405	2553	0.9420290
A09	59552951	59554361	A09p63700.2_BraZ1	1260	-	625	1410	1410	1.0000000
A09	59555104	59557344	A09p63710.2_BraZ1	479.324	+	1761	2086	2240	0.9312500
A09	59560064	59562633	A09p63720.2_BraZ1	1814.66	+	713	2524	2569	0.9824834
A09	59563129	59565844	A09p63730.2_BraZ1	1642.73	-	443	2161	2715	0.7959484
A09	59566868	59568884	A09p63740.2_BraZ1	732	-	495	1196	2016	0.5932540
A09	59570831	59573535	A09p63750.2_BraZ1	1704.89	+	696	2105	2704	0.7784764
A09	59581715	59584207	A09p63760.2_BraZ1	1806.64	+	1612	2220	2492	0.8908507
A09	59584509	59585688	A09p63770.2_BraZ1	117.9	-	199	892	1179	0.7565734
A09	59586544	59588104	A09p63780.2_BraZ1	906	-	393	1321	1560	0.8467948
A09	59589343	59594461	A09p63790.2_BraZ1	2217.51	-	563	3094	5118	0.6045330
A09	59596220	59597363	A09p63800.2_BraZ1	114.3	+	384	1143	1143	1.0000000
A09	59598048	59600051	A09p63810.2_BraZ1	446.806	-	1049	2003	2003	1.0000000
A09	59600965	59601397	A09p63820.2_BraZ1	252	+	406	423	432	0.9791667
A09	59603716	59606187	A09p63830.2_BraZ1	704.273	+	591	2264	2471	0.9162282
A09	59607156	59608158	A09p63840.2_BraZ1	64.8	+	520	1002	1002	1.0000000
A09	59608731	59608955	A09p63850.2_BraZ1	17.4	-	143	224	224	1.0000000
A09	59611066	59612481	A09p63860.2_BraZ1	816	+	130	1114	1415	0.7872791
A09	59612831	59613801	A09p63870.2_BraZ1	3363.75	-	358	955	970	0.9845361
A09	59617155	59617442	A09p63880.2_BraZ1	23.4	+	323	287	287	1.0000000
A09	59618037	59618823	A09p63890.2_BraZ1	78.6	-	78	400	786	0.5089058
A09	59621289	59624365	A09p63900.2_BraZ1	960.927	-	807	2161	3076	0.7025357
A09	59625909	59627780	A09p63910.2_BraZ1	766.406	-	1415	1642	1871	0.8776056
A09	59632206	59635131	A09p63920.2_BraZ1	1473.62	-	789	2827	2925	0.9664958
A09	59637952	59644474	A09p63930.2_BraZ1	2760.95	+	3835	5886	6522	0.9024839
A09	59653773	59656530	A09p63940.2_BraZ1	651.316	+	1895	2662	2757	0.9655423
A09	59656926	59660632	A09p63950.2_BraZ1	1522.25	-	1229	3438	3706	0.9276848
A09	59668866	59669886	A09p63960.2_BraZ1	102	+	268	1010	1020	0.9901960
A09	59674519	59674870	A09p63970.2_BraZ1	35.1	-	32	98	351	0.2792023
A09	59684501	59686162	A09p63980.2_BraZ1	1434	+	901	1661	1661	1.0000000
A09	59686379	59688231	A09p63990.2_BraZ1	1395	-	524	1699	1852	0.9173866
A09	59688745	59690553	A09p64000.2_BraZ1	1290	-	735	1786	1808	0.9878318
A09	59692002	59692782	A09p64010.2_BraZ1	65.1	+	432	780	780	1.0000000
A09	59694194	59696264	A09p64020.2_BraZ1	15660	-	833	2048	2070	0.9893720
A09	59705868	59708934	A09p64030.2_BraZ1	1795.42	-	2380	3066	3066	1.0000000
A09	59710643	59712396	A09p64040.2_BraZ1	980.138	-	1542	1563	1753	0.8916144
A09	59715924	59718406	A09p64050.2_BraZ1	583.2	-	1455	1733	2482	0.6982272
A09	59721240	59724012	A09p64060.2_BraZ1	910.395	+	2393	2633	2772	0.9498557
A09	59728033	59729969	A09p64070.2_BraZ1	1509.56	+	1047	1936	1936	1.0000000
A09	59730105	59736294	A09p64080.2_BraZ1	3653.17	-	2187	5672	6189	0.9164647
A09	59752247	59754117	A09p64090.2_BraZ1	261	+	1308	1624	1870	0.8684492
A09	59755898	59756341	A09p64100.2_BraZ1	390	-	797	443	443	1.0000000
A09	59758565	59758715	A09p64110.2_BraZ1	15	+	350	150	150	1.0000000
A09	59759680	59761376	A09p64120.2_BraZ1	7827.5	+	998	1696	1696	1.0000000
A09	59762771	59764714	A09p64130.2_BraZ1	4607.5	+	689	1756	1943	0.9037571
A09	59765439	59765733	A09p64140.2_BraZ1	29.4	+	127	294	294	1.0000000
A09	59768789	59770287	A09p64150.2_BraZ1	800.533	+	261	1246	1498	0.8317757
A09	59775726	59775950	A09p64160.2_BraZ1	132	+	0	0	224	0.0000000
A09	59775950	59776944	A09p64170.2_BraZ1	13.5	+	0	0	994	0.0000000
A09	59777025	59780295	A09p64180.2_BraZ1	3447.23	-	0	0	3270	0.0000000
A09	59780194	59782110	A09p64190.2_BraZ1	1744.83	-	0	0	1916	0.0000000
A09	59782459	59783252	A09p64200.2_BraZ1	51.3	-	5	247	793	0.3114754
A09	59783442	59783742	A09p64210.2_BraZ1	30	-	0	0	300	0.0000000
A09	59783963	59785365	A09p64220.2_BraZ1	473.6	+	573	1208	1402	0.8616263
A09	59788856	59791647	A09p64230.2_BraZ1	61264.5	+	16243	2791	2791	1.0000000
A09	59792362	59793210	A09p64240.2_BraZ1	343.37	-	520	848	848	1.0000000
A09	59794908	59797913	A09p64250.2_BraZ1	1165.82	+	2270	2983	3005	0.9926789
A09	59800737	59804850	A09p64260.2_BraZ1	14814	+	1315	3036	4113	0.7381473
A09	59805661	59808777	A09p64270.2_BraZ1	1066.5	-	2706	3079	3116	0.9881258
A09	59811811	59812582	A09p64280.2_BraZ1	77.1	-	259	771	771	1.0000000
A09	59813664	59821282	A09p64290.2_BraZ1	3580.26	+	1446	6188	7618	0.8122867
A09	59822667	59825328	A09p64300.2_BraZ1	266.1	-	1278	2505	2661	0.9413754
A09	59827243	59829088	A09p64310.2_BraZ1	1088.59	-	2123	1842	1845	0.9983740
A09	59832501	59833098	A09p64320.2_BraZ1	59.7	+	185	572	597	0.9581240
A09	59834102	59834975	A09p64330.2_BraZ1	795	-	355	873	873	1.0000000
A09	59838493	59839881	A09p64340.2_BraZ1	1001.76	+	110	1117	1388	0.8047550
A09	59840113	59842987	A09p64350.2_BraZ1	287.4	-	537	2651	2874	0.9224078
A09	59848411	59850476	A09p64360.2_BraZ1	612	+	708	2060	2065	0.9975787
A09	59850610	59852038	A09p64370.2_BraZ1	654.5	-	1616	1428	1428	1.0000000
A09	59855252	59856345	A09p64380.2_BraZ1	384.3	+	648	1093	1093	1.0000000
A09	59861344	59862154	A09p64390.2_BraZ1	81	+	172	792	810	0.9777778
A09	59862840	59864348	A09p64400.2_BraZ1	1191.51	+	642	1442	1508	0.9562334
A09	59864791	59868789	A09p64410.2_BraZ1	1933.87	-	966	3666	3998	0.9169585
A09	59869284	59869671	A09p64420.2_BraZ1	576	-	362	387	387	1.0000000
A09	59870085	59873292	A09p64430.2_BraZ1	1537.41	+	2577	3207	3207	1.0000000
A09	59873653	59876893	A09p64440.2_BraZ1	1927.8	-	1277	2870	3240	0.8858024
A09	59879913	59881622	A09p64450.2_BraZ1	810	+	1249	1709	1709	1.0000000
A09	59890404	59890864	A09p64460.2_BraZ1	321	-	228	460	460	1.0000000
A09	59891244	59891634	A09p64470.2_BraZ1	1291.5	-	159	332	390	0.8512821
A09	59894031	59894636	A09p64480.2_BraZ1	218	-	912	605	605	1.0000000
A09	59899665	59900611	A09p64490.2_BraZ1	441	+	406	946	946	1.0000000
A09	59901056	59902091	A09p64500.2_BraZ1	240	-	1077	1035	1035	1.0000000
A09	59904927	59907391	A09p64510.2_BraZ1	1390.1	-	1785	2400	2464	0.9740260
A09	59911142	59912655	A09p64520.2_BraZ1	1035	-	590	1372	1513	0.9068077
A09	59912813	59913173	A09p64530.2_BraZ1	255	-	108	360	360	1.0000000
A09	59915356	59916907	A09p64540.2_BraZ1	8876.25	+	510	1551	1551	1.0000000
A09	59917724	59918289	A09p64550.2_BraZ1	363.83	+	255	565	565	1.0000000
A09	59925923	59926776	A09p64560.2_BraZ1	78.6667	+	593	853	853	1.0000000
A09	59926304	59927991	A09p64570.2_BraZ1	363	+	539	1071	1687	0.6348548
A09	59937732	59941553	A09p64580.2_BraZ1	1411.54	-	1647	3417	3821	0.8942685
A09	59944344	59946200	A09p64590.2_BraZ1	1567.18	+	542	1606	1856	0.8653017
A09	59946372	59950638	A09p64600.2_BraZ1	457.2	+	341	2651	4266	0.6214252
A09	59954334	59956527	A09p64610.2_BraZ1	1428.87	+	691	2028	2193	0.9247606
A09	59958084	59959496	A09p64620.2_BraZ1	828.043	-	466	1164	1412	0.8243626
A09	59967661	59967893	A09p64630.2_BraZ1	21	+	336	232	232	1.0000000
A09	59968274	59974416	A09p64640.2_BraZ1	4537.41	-	893	4756	6142	0.7743406
A09	59978566	59980985	A09p64650.2_BraZ1	1071.47	+	1691	2398	2419	0.9913187
A09	59981569	59982152	A09p64660.2_BraZ1	267	-	211	583	583	1.0000000
A09	59983239	59985381	A09p64670.2_BraZ1	1122.8	+	368	2037	2142	0.9509804
A09	59985710	59986888	A09p64680.2_BraZ1	43.5	-	438	961	1178	0.8157895
A09	59987391	59988223	A09p64690.2_BraZ1	288.409	+	890	832	832	1.0000000
A09	59988703	59992022	A09p64700.2_BraZ1	1973.8	-	956	2779	3319	0.8373004
A09	59992980	59995331	A09p64710.2_BraZ1	1407.44	-	594	2232	2351	0.9493833
A09	59996602	59998190	A09p64720.2_BraZ1	963.444	-	118	824	1588	0.5188917
A09	59998554	59999342	A09p64730.2_BraZ1	267	-	419	709	788	0.8997462
A09	59999608	60001834	A09p64740.2_BraZ1	1167	-	128	1227	2226	0.5512130
A09	60004874	60005252	A09p64750.2_BraZ1	37.8	+	84	149	378	0.3941799
A09	60006764	60007047	A09p64760.2_BraZ1	16.5	-	25	233	283	0.8233216
A09	60008442	60012311	A09p64770.2_BraZ1	507.375	+	1772	3154	3869	0.8151977
A09	60015568	60016957	A09p64780.2_BraZ1	222	+	1141	1389	1389	1.0000000
A09	60024195	60026437	A09p64790.2_BraZ1	1363.45	+	427	1684	2242	0.7511151
A09	60026928	60027272	A09p64800.2_BraZ1	252	-	51	305	344	0.8866279
A09	60030956	60031283	A09p64810.2_BraZ1	32.1	+	44	179	327	0.5474006
A09	60033723	60036394	A09p64820.2_BraZ1	1789.07	-	1533	2560	2671	0.9584425
A09	60038532	60041148	A09p64830.2_BraZ1	1196.9	+	1475	2460	2616	0.9403670
A09	60044660	60045923	A09p64840.2_BraZ1	126.3	+	242	1115	1263	0.8828187
A09	60046098	60048483	A09p64850.2_BraZ1	1327.3	-	628	2256	2385	0.9459119
A09	60050510	60052553	A09p64860.2_BraZ1	999.783	+	1236	2041	2043	0.9990211
A09	60060658	60063627	A09p64870.2_BraZ1	1734.08	+	1335	2919	2969	0.9831593
A09	60063793	60064771	A09p64880.2_BraZ1	813	-	291	959	978	0.9805726
A09	60065156	60067865	A09p64890.2_BraZ1	1138.17	-	1483	2709	2709	1.0000000
A09	60068626	60069118	A09p64900.2_BraZ1	49.2	-	628	492	492	1.0000000
A09	60070644	60071115	A09p64910.2_BraZ1	47.1	-	118	471	471	1.0000000
A09	60077806	60078283	A09p64920.2_BraZ1	47.7	-	24	392	477	0.8218029
A09	60081774	60082251	A09p64930.2_BraZ1	47.7	-	127	477	477	1.0000000
A09	60095932	60097582	A09p64940.2_BraZ1	165	+	423	929	1650	0.5630303
A09	60098490	60099538	A09p64950.2_BraZ1	732	-	1649	1048	1048	1.0000000
A09	60103635	60104595	A09p64960.2_BraZ1	96	+	271	960	960	1.0000000
A09	60106949	60107414	A09p64970.2_BraZ1	46.5	+	368	465	465	1.0000000
A09	60109870	60112687	A09p64980.2_BraZ1	1693.04	+	1169	2486	2817	0.8824991
A09	60120517	60136957	A09p64990.2_BraZ1	326.1	+	4586	14082	16440	0.8565693
A09	60140107	60150235	A09p65000.2_BraZ1	1303.57	+	4752	8502	10128	0.8394549
A09	60151191	60151587	A09p65010.2_BraZ1	39.6	-	274	396	396	1.0000000
A09	60152210	60153387	A09p65020.2_BraZ1	525.648	-	1286	1177	1177	1.0000000
A09	60154037	60157589	A09p65030.2_BraZ1	1794.96	-	2312	3521	3552	0.9912725
A09	60163692	60164508	A09p65040.2_BraZ1	81.6	+	110	774	816	0.9485294
A09	60165889	60167446	A09p65050.2_BraZ1	981	-	1443	1450	1557	0.9312781
A09	60171291	60171747	A09p65060.2_BraZ1	45.6	-	376	456	456	1.0000000
A09	60185481	60185866	A09p65070.2_BraZ1	267	+	165	385	385	1.0000000
A09	60187140	60188198	A09p65080.2_BraZ1	951	-	841	1058	1058	1.0000000
A09	60188945	60190029	A09p65090.2_BraZ1	110.579	+	988	1084	1084	1.0000000
A09	60190768	60191903	A09p65100.2_BraZ1	500	-	589	1122	1135	0.9885463
A09	60193415	60195250	A09p65110.2_BraZ1	795.326	+	1417	1820	1835	0.9918256
A09	60195754	60196607	A09p65120.2_BraZ1	711	-	129	852	853	0.9988277
A09	60198741	60198891	A09p65130.2_BraZ1	15	-	209	150	150	1.0000000
A09	60199632	60202320	A09p65140.2_BraZ1	2100.36	-	1847	2620	2688	0.9747024
A09	60204570	60209172	A09p65150.2_BraZ1	2531.58	+	876	2744	4602	0.5962625
A09	60209981	60210762	A09p65160.2_BraZ1	642.675	+	211	779	781	0.9974392
A09	60211294	60218950	A09p65170.2_BraZ1	930.24	+	5460	6854	7656	0.8952456
A09	60220884	60224482	A09p65180.2_BraZ1	2457.49	-	676	3190	3598	0.8866037
A09	60227463	60228855	A09p65190.2_BraZ1	668.921	-	1100	1392	1392	1.0000000
A09	60231052	60231582	A09p65200.2_BraZ1	1890	-	353	530	530	1.0000000
A09	60235236	60236857	A09p65210.2_BraZ1	907.636	-	240	1393	1621	0.8593461
A09	60243572	60244259	A09p65220.2_BraZ1	408	-	61	20	687	0.0291121
A09	60247094	60247418	A09p65230.2_BraZ1	32.4	-	71	324	324	1.0000000
A09	60249419	60251078	A09p65240.2_BraZ1	1076.4	+	454	1579	1659	0.9517782
A09	60251400	60252920	A09p65250.2_BraZ1	397.8	+	211	1389	1520	0.9138158
A09	60258797	60261098	A09p65260.2_BraZ1	503.25	+	534	2187	2301	0.9504563
A09	60262420	60264917	A09p65270.2_BraZ1	891	+	243	1347	2497	0.5394473
A09	60265188	60266103	A09p65280.2_BraZ1	822	-	396	905	915	0.9890710
A09	60267163	60267364	A09p65290.2_BraZ1	20.1	+	301	201	201	1.0000000
A09	60267613	60268182	A09p65300.2_BraZ1	507	-	9	263	569	0.4622144
A09	60270445	60275565	A09p65310.2_BraZ1	1134	+	1780	4579	5120	0.8943359
A09	60276456	60276882	A09p65320.2_BraZ1	42.6	-	136	426	426	1.0000000
A09	60288028	60288775	A09p65330.2_BraZ1	74.7	+	102	613	747	0.8206158
A09	60292346	60294399	A09p65340.2_BraZ1	1057.26	+	1004	2053	2053	1.0000000
A09	60297099	60297788	A09p65350.2_BraZ1	390	-	2	103	689	0.1494920
A09	60300137	60307309	A09p65360.2_BraZ1	2308.95	+	1989	5860	7172	0.8170664
A09	60307545	60309953	A09p65370.2_BraZ1	2109	+	1410	2197	2408	0.9123754
A09	60312166	60313300	A09p65380.2_BraZ1	998.036	+	107	1010	1134	0.8906525
A09	60322841	60323702	A09p65390.2_BraZ1	708	+	183	731	861	0.8490128
A09	60329520	60330311	A09p65400.2_BraZ1	702	+	75	700	791	0.8849558
A09	60338242	60339133	A09p65410.2_BraZ1	89.1	+	527	885	891	0.9932660
A09	60343674	60344982	A09p65420.2_BraZ1	1077	+	722	1238	1308	0.9464832
A09	60345972	60347906	A09p65430.2_BraZ1	638.045	+	481	1725	1934	0.8919338
A09	60348625	60350130	A09p65440.2_BraZ1	975	+	937	1444	1505	0.9594684
A09	60350595	60350724	A09p65450.2_BraZ1	12.9	+	37	117	129	0.9069768
A09	60352900	60353896	A09p65460.2_BraZ1	197.727	+	871	981	996	0.9849398
A09	60355274	60357197	A09p65470.2_BraZ1	814.347	+	1761	1923	1923	1.0000000
A09	60359906	60361134	A09p65480.2_BraZ1	693	-	523	1223	1228	0.9959283
A09	60364716	60366111	A09p65490.2_BraZ1	139.5	+	582	1379	1395	0.9885305
A09	60370705	60371218	A09p65500.2_BraZ1	51.3	+	72	375	513	0.7309942
A09	60380029	60381914	A09p65510.2_BraZ1	3960	+	507	1309	1885	0.6944297
A09	60383372	60385770	A09p65520.2_BraZ1	1398.21	+	65	906	2398	0.3778149
A09	60385937	60386169	A09p65530.2_BraZ1	168	-	5	143	232	0.6163793
A09	60387880	60390589	A09p65540.2_BraZ1	1876.48	+	1040	2597	2709	0.9586563
A09	60391453	60392390	A09p65550.2_BraZ1	416.316	-	296	921	937	0.9829242
A09	60396956	60397845	A09p65560.2_BraZ1	7590	+	3	152	889	0.1709786
A09	60398115	60400560	A09p65570.2_BraZ1	1250.1	+	99	850	2445	0.3476483
A09	60401191	60401644	A09p65580.2_BraZ1	45.3	+	0	0	453	0.0000000
A09	60401918	60404126	A09p65590.2_BraZ1	569.25	+	1817	2115	2208	0.9578804
A09	60405995	60408046	A09p65600.2_BraZ1	1348.77	+	885	1725	2051	0.8410531
A09	60413742	60414631	A09p65610.2_BraZ1	7590	+	7	238	889	0.2677165
A09	60414901	60417342	A09p65620.2_BraZ1	1250.1	+	110	996	2441	0.4080295
A09	60420502	60421433	A09p65630.2_BraZ1	336	-	1013	931	931	1.0000000
A09	60427899	60429585	A09p65640.2_BraZ1	860.108	-	956	1686	1686	1.0000000
A09	60430566	60431698	A09p65650.2_BraZ1	618.614	+	433	1132	1132	1.0000000
A09	60431891	60433083	A09p65660.2_BraZ1	682.839	-	866	1192	1192	1.0000000
A09	60433251	60435003	A09p65670.2_BraZ1	1028.61	+	1243	1744	1752	0.9954338
A09	60437078	60438962	A09p65680.2_BraZ1	188.4	+	374	1764	1884	0.9363058
A09	60440342	60441539	A09p65690.2_BraZ1	807	+	710	1197	1197	1.0000000
A09	60441793	60441898	A09p65700.2_BraZ1	10.5	+	180	105	105	1.0000000
A09	60443721	60444993	A09p65710.2_BraZ1	127.2	-	114	1236	1272	0.9716981
A09	60446039	60446488	A09p65720.2_BraZ1	306	+	373	449	449	1.0000000
A09	60446774	60458529	A09p65730.2_BraZ1	7984.36	-	2547	9970	11755	0.8481497
A09	60460070	60460374	A09p65740.2_BraZ1	225	+	0	0	304	0.0000000
A09	60461249	60463429	A09p65750.2_BraZ1	9213	-	840	2087	2180	0.9573395
A09	60465776	60466341	A09p65760.2_BraZ1	259.162	-	606	565	565	1.0000000
A09	60467173	60469947	A09p65770.2_BraZ1	1918.64	+	865	2486	2774	0.8961788
A09	60471256	60472331	A09p65780.2_BraZ1	645.261	-	264	979	1075	0.9106977
A09	60472987	60474486	A09p65790.2_BraZ1	1292.85	+	987	1478	1499	0.9859906
A09	60476214	60478751	A09p65800.2_BraZ1	798.518	+	2826	2537	2537	1.0000000
A09	60481115	60483609	A09p65810.2_BraZ1	1196.59	+	1522	2379	2494	0.9538893
A09	60484029	60486444	A09p65820.2_BraZ1	241.2	-	1735	2415	2415	1.0000000
A09	60487446	60488267	A09p65830.2_BraZ1	428.526	+	0	0	821	0.0000000
A09	60492621	60492984	A09p65840.2_BraZ1	222	-	502	363	363	1.0000000
A09	60496606	60496960	A09p65850.2_BraZ1	258	-	544	354	354	1.0000000
A09	60499575	60501071	A09p65860.2_BraZ1	827.143	+	650	1496	1496	1.0000000
A09	60503181	60503361	A09p65870.2_BraZ1	18	+	106	180	180	1.0000000
A09	60503592	60504228	A09p65880.2_BraZ1	63.6	-	21	226	636	0.3553459
A09	60513582	60514616	A09p65890.2_BraZ1	849	-	840	1034	1034	1.0000000
A09	60517685	60519188	A09p65900.2_BraZ1	49.5	+	830	1444	1503	0.9607452
A09	60519429	60520316	A09p65910.2_BraZ1	513.567	-	640	887	887	1.0000000
A09	60523251	60524828	A09p65920.2_BraZ1	286.154	-	337	1191	1577	0.7552314
A09	60529719	60531953	A09p65930.2_BraZ1	1172.15	+	772	2065	2234	0.9243509
A09	60534103	60535151	A09p65940.2_BraZ1	948.395	+	375	1013	1048	0.9666030
A09	60535416	60536487	A09p65950.2_BraZ1	562.286	-	608	987	1071	0.9215686
A09	60538272	60540204	A09p65960.2_BraZ1	1194.22	+	300	1484	1932	0.7681159
A09	60541773	60544291	A09p65970.2_BraZ1	1370.2	+	726	1861	2518	0.7390786
A09	60546960	60549297	A09p65980.2_BraZ1	1086.85	+	707	1749	2337	0.7483954
A09	60550994	60553763	A09p65990.2_BraZ1	1265.45	+	1366	2746	2769	0.9916937
A09	60557749	60557985	A09p66000.2_BraZ1	20.7	+	6	145	236	0.6144068
A09	60558503	60561485	A09p66010.2_BraZ1	298.2	+	693	2835	2982	0.9507042
A09	60561669	60563190	A09p66020.2_BraZ1	981.391	-	511	1461	1521	0.9605523
A09	60565703	60567568	A09p66030.2_BraZ1	14945.5	+	412	1600	1865	0.8579088
A09	60567764	60569222	A09p66040.2_BraZ1	145.8	-	589	1458	1458	1.0000000
A09	60569792	60570463	A09p66050.2_BraZ1	45.9	+	462	641	671	0.9552906
A09	60570937	60573347	A09p66060.2_BraZ1	1822.5	-	717	2272	2410	0.9427386
A09	60580003	60581882	A09p66070.2_BraZ1	1148.15	+	960	1863	1879	0.9914848
A09	60582568	60584039	A09p66080.2_BraZ1	791.1	+	692	1460	1471	0.9925221
A09	60584664	60586630	A09p66090.2_BraZ1	1019.46	-	1463	1966	1966	1.0000000
A09	60597751	60599241	A09p66100.2_BraZ1	49507.5	+	262	1321	1490	0.8865772
A09	60601827	60603853	A09p66110.2_BraZ1	1027.28	+	887	1961	2026	0.9679171
A09	60606896	60608396	A09p66120.2_BraZ1	727.406	+	1288	1434	1500	0.9560000
A09	60611008	60611530	A09p66130.2_BraZ1	52.2	-	150	522	522	1.0000000
A09	60618738	60618888	A09p66140.2_BraZ1	15	+	136	150	150	1.0000000
A09	60619909	60621652	A09p66150.2_BraZ1	965.2	-	874	1736	1743	0.9959840
A09	60622851	60628690	A09p66160.2_BraZ1	2454.42	+	2824	5453	5839	0.9338928
A09	60630222	60632611	A09p66170.2_BraZ1	1386	+	1306	2311	2389	0.9673504
A09	60634018	60635369	A09p66180.2_BraZ1	240	-	425	1337	1351	0.9896373
A09	60638438	60640403	A09p66190.2_BraZ1	1123.75	+	1186	1965	1965	1.0000000
A09	60644500	60646621	A09p66200.2_BraZ1	1400.45	-	1289	1932	2121	0.9108911
A09	60657150	60658535	A09p66210.2_BraZ1	993.143	-	236	1276	1385	0.9212996
A09	60659204	60659315	A09p66220.2_BraZ1	11.1	-	103	111	111	1.0000000
A09	60660522	60661182	A09p66230.2_BraZ1	66	+	248	646	660	0.9787879
A09	60663020	60663378	A09p66240.2_BraZ1	222	+	33	153	358	0.4273743
A09	60670494	60674215	A09p66250.2_BraZ1	2121.14	-	1955	3548	3721	0.9535071
A09	60676930	60678274	A09p66260.2_BraZ1	134.4	+	214	1310	1344	0.9747024
A09	60685027	60687946	A09p66270.2_BraZ1	1231.2	+	894	2515	2919	0.8615965
A09	60690007	60690874	A09p66280.2_BraZ1	86.7	+	1144	867	867	1.0000000
A09	60692964	60695539	A09p66290.2_BraZ1	1523.34	+	2122	2575	2575	1.0000000
A09	60697638	60699148	A09p66300.2_BraZ1	1256.86	+	899	1351	1510	0.8947020
A09	60700126	60701615	A09p66310.2_BraZ1	632.057	-	2769	1489	1489	1.0000000
A09	60709171	60710023	A09p66320.2_BraZ1	85.2	+	860	852	852	1.0000000
A09	60711039	60713639	A09p66330.2_BraZ1	1436.22	-	1578	2577	2600	0.9911538
A09	60714100	60715866	A09p66340.2_BraZ1	910.582	-	1123	1766	1766	1.0000000
A09	60717047	60717479	A09p66350.2_BraZ1	43.2	+	514	432	432	1.0000000
A09	60721573	60724145	A09p66360.2_BraZ1	1638.38	+	543	2316	2572	0.9004666
A09	60724644	60725474	A09p66370.2_BraZ1	237	+	678	830	830	1.0000000
A09	60725910	60728948	A09p66380.2_BraZ1	392.533	+	2040	3038	3038	1.0000000
A09	60730468	60735334	A09p66390.2_BraZ1	3636.01	+	1486	4673	4866	0.9603370
A09	60740036	60740650	A09p66400.2_BraZ1	270	-	628	614	614	1.0000000
A09	60744539	60747064	A09p66410.2_BraZ1	22942.5	-	1248	2384	2525	0.9441584
A09	60747806	60749138	A09p66420.2_BraZ1	1113	-	1012	1332	1332	1.0000000
A09	60754538	60756555	A09p66430.2_BraZ1	1279.55	-	664	1853	2017	0.9186911
A09	60757860	60758740	A09p66440.2_BraZ1	807	+	667	880	880	1.0000000
A09	60769043	60769740	A09p66450.2_BraZ1	345	+	0	0	697	0.0000000
A09	60779853	60780655	A09p66460.2_BraZ1	411.075	+	382	739	802	0.9214464
A09	60780749	60784912	A09p66470.2_BraZ1	862.412	+	2550	4151	4163	0.9971175
A09	60789756	60794598	A09p66480.2_BraZ1	1896	-	1895	4541	4842	0.9378356
A09	60791669	60792566	A09p66490.2_BraZ1	321.6	+	217	849	897	0.9464883
A09	60798873	60800147	A09p66500.2_BraZ1	819	+	591	1032	1274	0.8100471
A09	60800884	60801745	A09p66510.2_BraZ1	717	+	179	700	861	0.8130081
A09	60805091	60806847	A09p66520.2_BraZ1	1599	-	161	1185	1756	0.6748292
A09	60820928	60822020	A09p66530.2_BraZ1	6583.5	-	106	776	1092	0.7106227
A09	60845519	60845874	A09p66540.2_BraZ1	174	+	446	355	355	1.0000000
A09	60846133	60847432	A09p66550.2_BraZ1	186	+	1890	1299	1299	1.0000000
A09	60846203	60847541	A09p66560.2_BraZ1	240	+	1883	1338	1338	1.0000000
A09	60849802	60850162	A09p66570.2_BraZ1	36	+	270	360	360	1.0000000
A09	60854223	60855535	A09p66580.2_BraZ1	969	-	124	836	1312	0.6371951
A09	60867170	60867737	A09p66590.2_BraZ1	56.7	-	17	303	567	0.5343915
A09	60874445	60874778	A09p66600.2_BraZ1	33.3	+	1	55	333	0.1651652
A09	60876871	60877879	A09p66610.2_BraZ1	318	+	626	968	1008	0.9603174
A09	60879103	60880509	A09p66620.2_BraZ1	858	+	432	1397	1406	0.9935989
A09	60881151	60884300	A09p66630.2_BraZ1	1523.47	-	1169	2722	3149	0.8644014
A09	60892596	60893475	A09p66640.2_BraZ1	87.9	+	81	401	879	0.4562002
A09	60896433	60896802	A09p66650.2_BraZ1	35.7	-	246	369	369	1.0000000
A09	60897883	60900237	A09p66660.2_BraZ1	294	+	719	894	2354	0.3797791
A09	60900579	60902125	A09p66670.2_BraZ1	719.531	-	616	1546	1546	1.0000000
A09	60907145	60913183	A09p66680.2_BraZ1	3357.33	+	2133	4782	6038	0.7919841
A09	60913457	60914233	A09p66690.2_BraZ1	663	-	405	749	776	0.9652062
A09	60915447	60916001	A09p66700.2_BraZ1	729.6	+	502	554	554	1.0000000
A09	60916930	60917701	A09p66710.2_BraZ1	177.222	-	3	171	771	0.2217899
A09	60917688	60917960	A09p66720.2_BraZ1	55	-	10	272	272	1.0000000
A09	60918927	60919916	A09p66730.2_BraZ1	417.353	+	668	823	989	0.8321537
A09	60920326	60921654	A09p66740.2_BraZ1	557.735	+	623	1328	1328	1.0000000
A09	60921802	60923112	A09p66750.2_BraZ1	578.286	-	1277	1310	1310	1.0000000
A09	60924810	60927027	A09p66760.2_BraZ1	1125.09	+	1971	2194	2217	0.9896256
A09	60927687	60928425	A09p66770.2_BraZ1	73.8	-	320	738	738	1.0000000
A09	60929988	60932058	A09p66780.2_BraZ1	1224.6	+	794	2036	2070	0.9835749
A09	60932444	60933762	A09p66790.2_BraZ1	1026.91	-	450	1145	1318	0.8687405
A09	60938979	60939763	A09p66800.2_BraZ1	450.333	+	2	245	784	0.3125000
A09	60943316	60944246	A09p66810.2_BraZ1	534	+	14	599	930	0.6440860
A09	60945044	60947096	A09p66820.2_BraZ1	1182.83	-	627	1717	2052	0.8367447
A09	60948886	60951303	A09p66830.2_BraZ1	1229.93	-	980	2403	2417	0.9942077
A09	60959812	60961026	A09p66840.2_BraZ1	561.522	+	1031	1214	1214	1.0000000
A09	60962016	60963908	A09p66850.2_BraZ1	1755	-	82	1040	1892	0.5496829
A09	60966226	60966932	A09p66860.2_BraZ1	65.1	-	25	516	706	0.7308782
A09	60967826	60968931	A09p66870.2_BraZ1	287.557	+	432	1105	1105	1.0000000
A09	60970161	60972290	A09p66880.2_BraZ1	1736.39	-	251	1657	2129	0.7782997
A09	60973559	60974033	A09p66890.2_BraZ1	47.4	+	54	431	474	0.9092827
A09	60975084	60976873	A09p66900.2_BraZ1	670.091	-	1059	1789	1789	1.0000000
A09	60979221	60982236	A09p66910.2_BraZ1	1719.85	+	1942	2883	3015	0.9562189
A09	60982474	60985416	A09p66920.2_BraZ1	2004.9	-	1018	2815	2942	0.9568321
A09	60985812	60986376	A09p66930.2_BraZ1	56.4	-	522	564	564	1.0000000
A09	60987063	60989074	A09p66940.2_BraZ1	21580	-	674	1962	2011	0.9756340
A09	60993761	60994847	A09p66950.2_BraZ1	897	-	924	1086	1086	1.0000000
A09	61001143	61007903	A09p66960.2_BraZ1	3154.91	-	4442	6181	6760	0.9143491
A09	61009275	61011013	A09p66970.2_BraZ1	1413	-	819	1706	1738	0.9815880
A09	61012037	61012232	A09p66980.2_BraZ1	19.5	+	130	195	195	1.0000000
A09	61013713	61014106	A09p66990.2_BraZ1	39.3	+	486	393	393	1.0000000
A09	61014439	61014865	A09p67000.2_BraZ1	42.6	-	89	426	426	1.0000000
A09	61015625	61015891	A09p67010.2_BraZ1	15	-	333	266	266	1.0000000
A09	61016394	61017603	A09p67020.2_BraZ1	120.9	+	1604	1209	1209	1.0000000
A09	61018014	61018534	A09p67030.2_BraZ1	234	+	635	520	520	1.0000000
A09	61019058	61020879	A09p67040.2_BraZ1	182.1	-	478	1683	1821	0.9242175
A09	61021862	61022701	A09p67050.2_BraZ1	482.889	+	519	839	839	1.0000000
A09	61033810	61035753	A09p67060.2_BraZ1	1598.35	+	350	1404	1943	0.7225939
A09	61037878	61038689	A09p67070.2_BraZ1	642	+	158	767	811	0.9457460
A09	61038860	61040960	A09p67080.2_BraZ1	1857.05	-	444	1418	2100	0.6752381
A09	61041829	61044124	A09p67090.2_BraZ1	925.333	-	857	2295	2295	1.0000000
A09	61044458	61046231	A09p67100.2_BraZ1	5187	+	1122	1773	1773	1.0000000
A09	61048411	61049548	A09p67110.2_BraZ1	113.7	-	528	1137	1137	1.0000000
A09	61050614	61050953	A09p67120.2_BraZ1	33.9	-	9	277	339	0.8171092
A09	61052371	61052539	A09p67130.2_BraZ1	16.8	+	27	154	168	0.9166667
A09	61052870	61053131	A09p67140.2_BraZ1	26.1	+	227	261	261	1.0000000
A09	61054763	61055201	A09p67150.2_BraZ1	43.8	+	558	438	438	1.0000000
A09	61059993	61061189	A09p67160.2_BraZ1	108.3	+	333	921	1196	0.7700669
A09	61063392	61065049	A09p67170.2_BraZ1	1157.75	-	87	1077	1657	0.6499698
A09	61069085	61069555	A09p67180.2_BraZ1	6150	-	0	0	470	0.0000000
A09	61069572	61070263	A09p67190.2_BraZ1	144	-	0	0	691	0.0000000
A09	61081714	61082026	A09p67200.2_BraZ1	31.2	+	230	312	312	1.0000000
A09	61083186	61084877	A09p67210.2_BraZ1	936	-	428	1691	1691	1.0000000
A09	61088507	61094014	A09p67220.2_BraZ1	3869.81	-	1122	4765	5507	0.8652624
A09	61099109	61100549	A09p67230.2_BraZ1	339	-	677	792	1440	0.5500000
A09	61101791	61103470	A09p67240.2_BraZ1	12792.8	+	195	1224	1679	0.7290053
A09	61103894	61105383	A09p67250.2_BraZ1	936	-	552	1291	1489	0.8670248
A09	61109465	61112199	A09p67260.2_BraZ1	1195.86	+	1038	2453	2734	0.8972202
A09	61113294	61115871	A09p67270.2_BraZ1	1171.5	+	666	2395	2577	0.9293752
A09	61116411	61117974	A09p67280.2_BraZ1	1070.53	-	692	1514	1563	0.9686500
A09	61118967	61119738	A09p67290.2_BraZ1	252	-	542	771	771	1.0000000
A09	61120291	61121760	A09p67300.2_BraZ1	734.091	-	752	1403	1469	0.9550714
A09	61122315	61122702	A09p67310.2_BraZ1	1995	+	145	387	387	1.0000000
A09	61124556	61125135	A09p67320.2_BraZ1	57	+	52	166	579	0.2867012
A09	61131127	61147750	A09p67330.2_BraZ1	1512.08	-	5879	14701	16623	0.8843771
A09	61138354	61140503	A09p67340.2_BraZ1	1048.67	-	490	2130	2149	0.9911587
A09	61150354	61150824	A09p67350.2_BraZ1	44.1	+	316	470	470	1.0000000
A09	61150804	61151385	A09p67360.2_BraZ1	443.625	+	168	581	581	1.0000000
A09	61151716	61154300	A09p67370.2_BraZ1	1080.37	-	2547	2584	2584	1.0000000
A09	61158313	61158855	A09p67380.2_BraZ1	243	+	399	542	542	1.0000000
A09	61159155	61159464	A09p67390.2_BraZ1	30.9	-	94	309	309	1.0000000
A09	61160677	61161753	A09p67400.2_BraZ1	975	-	569	1076	1076	1.0000000
A09	61165069	61165381	A09p67410.2_BraZ1	31.2	+	1	45	312	0.1442308
A09	61167970	61168279	A09p67420.2_BraZ1	30.9	+	9	176	309	0.5695793
A09	61170329	61172408	A09p67430.2_BraZ1	829.707	+	893	1956	2079	0.9408370
A09	61173269	61175612	A09p67440.2_BraZ1	20115	-	588	2067	2343	0.8822023
A09	61198045	61198441	A09p67450.2_BraZ1	39.6	+	330	396	396	1.0000000
A09	61201611	61202083	A09p67460.2_BraZ1	429	+	660	472	472	1.0000000
A09	61206740	61208025	A09p67470.2_BraZ1	1077	+	360	1185	1285	0.9221790
A09	61212267	61212831	A09p67480.2_BraZ1	56.4	+	313	564	564	1.0000000
A09	61212884	61213895	A09p67490.2_BraZ1	445.909	+	652	1011	1011	1.0000000
A09	61214696	61217107	A09p67500.2_BraZ1	138	+	1511	2395	2411	0.9933637
A09	61217193	61217340	A09p67510.2_BraZ1	14.7	+	128	147	147	1.0000000
A09	61220364	61220937	A09p67520.2_BraZ1	102	-	492	573	573	1.0000000
A09	61221662	61224024	A09p67530.2_BraZ1	1827	+	1421	2362	2362	1.0000000
A09	61228243	61229242	A09p67540.2_BraZ1	99.9	-	155	921	999	0.9219219
A09	61237272	61238011	A09p67550.2_BraZ1	669	-	763	739	739	1.0000000
A09	61238403	61240620	A09p67560.2_BraZ1	1543.5	+	429	1874	2217	0.8452864
A09	61241913	61242183	A09p67570.2_BraZ1	27	-	221	270	270	1.0000000
A09	61243714	61244816	A09p67580.2_BraZ1	565.714	+	398	1102	1102	1.0000000
A09	61245269	61246760	A09p67590.2_BraZ1	388.99	-	509	1455	1491	0.9758551
A09	61247004	61247675	A09p67600.2_BraZ1	4632	+	232	671	671	1.0000000
A09	61249240	61250467	A09p67610.2_BraZ1	1146	+	367	1209	1227	0.9853300
A09	61271358	61273080	A09p67620.2_BraZ1	3646.5	-	1000	1722	1722	1.0000000
A09	61273320	61273630	A09p67630.2_BraZ1	24	+	124	310	310	1.0000000
A09	61279120	61279928	A09p67640.2_BraZ1	711	-	536	808	808	1.0000000
A09	61292385	61295216	A09p67650.2_BraZ1	1494.78	-	648	2713	2831	0.9583186
A09	61300661	61307584	A09p67660.2_BraZ1	1817.61	-	4103	6688	6923	0.9660552
A09	61307928	61309537	A09p67670.2_BraZ1	3432	+	1144	1557	1609	0.9676818
A09	61310576	61311119	A09p67680.2_BraZ1	54.3	-	138	543	543	1.0000000
A09	61311381	61312046	A09p67690.2_BraZ1	247.5	+	630	665	665	1.0000000
A09	61314031	61315744	A09p67700.2_BraZ1	1632	+	491	1684	1713	0.9830706
A09	61317712	61319923	A09p67710.2_BraZ1	1366.8	+	414	2001	2211	0.9050204
A09	61321821	61323173	A09p67720.2_BraZ1	500.25	+	18	526	1352	0.3890533
A09	61325127	61326168	A09p67730.2_BraZ1	104.1	+	192	1014	1041	0.9740634
A09	61326545	61332530	A09p67740.2_BraZ1	2947.76	-	1151	5584	5985	0.9329992
A09	61335108	61345744	A09p67750.2_BraZ1	3471.43	-	3631	9703	10636	0.9122791
A09	61348538	61350708	A09p67760.2_BraZ1	829.688	+	1442	2024	2170	0.9327189
A09	61351291	61351663	A09p67770.2_BraZ1	37.2	-	113	361	372	0.9704301
A09	61352824	61354222	A09p67780.2_BraZ1	139.8	-	127	682	1398	0.4878398
A09	61355161	61358596	A09p67790.2_BraZ1	1655.33	-	1474	2972	3435	0.8652111
A09	61359002	61361014	A09p67800.2_BraZ1	1066.42	-	1220	1994	2012	0.9910537
A09	61365147	61366193	A09p67810.2_BraZ1	972	+	255	994	1046	0.9502868
A09	61370573	61378321	A09p67820.2_BraZ1	3202.8	+	4309	7025	7748	0.9066856
A09	61379888	61382046	A09p67830.2_BraZ1	1048.67	+	397	1899	2158	0.8799815
A09	61382583	61384128	A09p67840.2_BraZ1	622.187	-	1096	1545	1545	1.0000000
A09	61385921	61391281	A09p67850.2_BraZ1	2870.1	+	4141	5328	5360	0.9940299
A09	61392538	61394389	A09p67860.2_BraZ1	2190	-	1943	1851	1851	1.0000000
A09	61397046	61399460	A09p67870.2_BraZ1	1073.22	-	2053	2414	2414	1.0000000
A09	61406475	61408764	A09p67880.2_BraZ1	1138.09	+	428	1721	2289	0.7518567
A09	61409383	61413467	A09p67890.2_BraZ1	1540.91	-	2120	3863	4084	0.9458864
A09	61414753	61416973	A09p67900.2_BraZ1	164.4	+	1156	2196	2220	0.9891892
A09	61418337	61423977	A09p67910.2_BraZ1	2308.5	+	2822	5555	5640	0.9849291
A09	61425551	61426748	A09p67920.2_BraZ1	501.882	+	493	1150	1197	0.9607351
A09	61428057	61430116	A09p67930.2_BraZ1	920.75	-	1398	2059	2059	1.0000000
A09	61435833	61436523	A09p67940.2_BraZ1	69	+	6	111	690	0.1608696
A09	61439486	61440647	A09p67950.2_BraZ1	116.1	-	290	1161	1161	1.0000000
A09	61443602	61446254	A09p67960.2_BraZ1	1689.55	+	1609	2632	2652	0.9924585
A09	61446590	61449153	A09p67970.2_BraZ1	1382.96	-	631	2508	2563	0.9785408
A09	61456771	61457152	A09p67980.2_BraZ1	38.1	-	152	238	381	0.6246719
A09	61457619	61457967	A09p67990.2_BraZ1	34.8	+	314	348	348	1.0000000
A09	61458587	61462147	A09p68000.2_BraZ1	1678.95	-	887	3286	3560	0.9230337
A09	61463715	61464222	A09p68010.2_BraZ1	50.7	-	76	391	507	0.7712032
A09	61468206	61471488	A09p68020.2_BraZ1	1547.09	+	2875	3282	3282	1.0000000
A09	61472448	61475241	A09p68030.2_BraZ1	1366.32	-	1247	2776	2793	0.9939134
A09	61477381	61479462	A09p68040.2_BraZ1	822	-	581	1635	2081	0.7856799
A09	61479616	61480629	A09p68050.2_BraZ1	10350	+	436	666	1013	0.6574531
A09	61486967	61488347	A09p68060.2_BraZ1	138	+	136	1119	1380	0.8108696
A09	61490153	61491336	A09p68070.2_BraZ1	894.205	+	1038	1183	1183	1.0000000
A09	61492556	61493942	A09p68080.2_BraZ1	1267.43	+	344	1212	1386	0.8744588
A09	61494703	61498751	A09p68090.2_BraZ1	2330.68	-	583	3065	4048	0.7571641
A09	61501810	61503781	A09p68100.2_BraZ1	197.1	-	815	1686	1971	0.8554034
A09	61504559	61506335	A09p68110.2_BraZ1	177.6	-	909	1713	1776	0.9645270
A09	61506855	61508262	A09p68120.2_BraZ1	788.497	+	472	1378	1407	0.9793888
A09	61509981	61510554	A09p68130.2_BraZ1	57.3	+	144	573	573	1.0000000
A09	61512068	61513874	A09p68140.2_BraZ1	180.6	-	1274	1806	1806	1.0000000
A09	61522114	61524553	A09p68150.2_BraZ1	243.9	+	594	2316	2439	0.9495695
A09	61525219	61528157	A09p68160.2_BraZ1	2000	+	1836	2894	2938	0.9850238
A09	61528671	61530250	A09p68170.2_BraZ1	957.6	-	527	1349	1579	0.8543382
A09	61538049	61540730	A09p68180.2_BraZ1	1712.05	-	1449	2582	2681	0.9630735
A09	61542054	61543104	A09p68190.2_BraZ1	105	-	356	1050	1050	1.0000000
A09	61545970	61546248	A09p68200.2_BraZ1	111	-	194	278	278	1.0000000
A09	61547387	61550871	A09p68210.2_BraZ1	1705.61	+	908	3366	3484	0.9661309
A09	61554547	61556550	A09p68220.2_BraZ1	1590.61	+	390	1727	2003	0.8622067
A09	61559318	61561172	A09p68230.2_BraZ1	184.8	-	119	1332	1854	0.7184466
A09	61563307	61565233	A09p68240.2_BraZ1	13234	-	571	1876	1926	0.9740394
A09	61570202	61576176	A09p68250.2_BraZ1	4468.46	+	340	3281	5974	0.5492132
A09	61578356	61579683	A09p68260.2_BraZ1	538.175	+	895	1327	1327	1.0000000
A09	61581210	61583175	A09p68270.2_BraZ1	940.267	+	861	1965	1965	1.0000000
A09	61584868	61587213	A09p68280.2_BraZ1	2265	+	433	1874	2345	0.7991471
A09	61588323	61589883	A09p68290.2_BraZ1	800.914	+	1100	1524	1560	0.9769230
A09	61590047	61592654	A09p68300.2_BraZ1	1497.02	-	831	2369	2607	0.9087073
A09	61596749	61597238	A09p68310.2_BraZ1	48.9	-	489	489	489	1.0000000
A09	61601810	61605157	A09p68320.2_BraZ1	1666.91	-	2843	3347	3347	1.0000000
A09	61607189	61607363	A09p68330.2_BraZ1	17.4	+	433	174	174	1.0000000
A09	61607898	61608147	A09p68340.2_BraZ1	24.9	+	551	249	249	1.0000000
A09	61614360	61614585	A09p68350.2_BraZ1	22.5	-	9	101	225	0.4488889
A09	61620503	61620744	A09p68360.2_BraZ1	3672	-	81	241	241	1.0000000
A09	61623625	61624681	A09p68370.2_BraZ1	105.6	+	239	897	1056	0.8494318
A09	61627140	61627266	A09p68380.2_BraZ1	12.6	+	90	126	126	1.0000000
A09	61632398	61633708	A09p68390.2_BraZ1	129.6	+	245	1236	1310	0.9435114
A09	61634425	61637586	A09p68400.2_BraZ1	1038.32	-	2354	3005	3161	0.9506485
A09	61639520	61647273	A09p68410.2_BraZ1	3542.98	-	1959	6979	7753	0.9001677
A09	61650854	61654501	A09p68420.2_BraZ1	2925	+	773	3424	3647	0.9388539
A09	61657588	61659112	A09p68430.2_BraZ1	14427	+	509	1524	1524	1.0000000
A09	61662155	61662530	A09p68440.2_BraZ1	37.5	+	515	375	375	1.0000000
A09	61664964	61666564	A09p68450.2_BraZ1	601.548	-	797	1600	1600	1.0000000
A09	61667328	61667615	A09p68460.2_BraZ1	180	+	171	287	287	1.0000000
A09	61667736	61668397	A09p68470.2_BraZ1	668.25	+	617	661	661	1.0000000
A09	61672789	61681771	A09p68480.2_BraZ1	216	+	2920	7663	8982	0.8531507
A09	61683609	61684831	A09p68490.2_BraZ1	612.919	-	575	1212	1222	0.9918167
A09	61692386	61694853	A09p68500.2_BraZ1	801.839	+	1607	2467	2467	1.0000000
A09	61696213	61696858	A09p68510.2_BraZ1	537	-	261	645	645	1.0000000
A09	61707142	61707836	A09p68520.2_BraZ1	252	-	324	667	694	0.9610951
A09	61710776	61717909	A09p68530.2_BraZ1	3234.71	+	4094	7108	7133	0.9964952
A09	61719156	61721248	A09p68540.2_BraZ1	699.545	-	646	1675	2092	0.8006692
A09	61724607	61730661	A09p68550.2_BraZ1	1503.43	-	3156	5757	6054	0.9509415
A09	61739180	61749756	A09p68560.2_BraZ1	1012.38	-	3866	8154	10576	0.7709909
A09	61753696	61754553	A09p68570.2_BraZ1	442.406	+	594	844	857	0.9848308
A09	61755500	61758213	A09p68580.2_BraZ1	1206.63	-	528	2167	2713	0.7987468
A09	61773887	61774681	A09p68590.2_BraZ1	64.8	-	69	497	794	0.6259446
A09	61776740	61778546	A09p68600.2_BraZ1	1444.2	+	716	1806	1806	1.0000000
A09	61780620	61781880	A09p68610.2_BraZ1	909.222	+	499	1260	1260	1.0000000
A09	61783425	61786439	A09p68620.2_BraZ1	2063.46	+	553	2844	3014	0.9435965
A09	61787554	61788765	A09p68630.2_BraZ1	501.6	-	731	1163	1211	0.9603633
A09	61792864	61793317	A09p68640.2_BraZ1	45.3	-	465	453	453	1.0000000
A09	61799540	61812844	A09p68650.2_BraZ1	2208.3	+	7592	12879	13304	0.9680547
A09	61814111	61816950	A09p68660.2_BraZ1	1850.87	+	1250	2666	2839	0.9390631
A09	61821220	61823850	A09p68670.2_BraZ1	1957.14	+	684	2269	2630	0.8627377
A09	61824770	61828195	A09p68680.2_BraZ1	1918.41	-	598	3005	3425	0.8773723
A09	61830593	61834191	A09p68690.2_BraZ1	1083.43	-	1338	3295	3598	0.9157866
A09	61835407	61835842	A09p68700.2_BraZ1	276	-	408	408	435	0.9379311
A09	61835842	61836598	A09p68710.2_BraZ1	78.8571	-	467	756	756	1.0000000
A09	61838953	61839829	A09p68720.2_BraZ1	735	+	230	867	876	0.9897260
A09	61840062	61840167	A09p68730.2_BraZ1	10.5	+	167	105	105	1.0000000
A09	61840417	61840546	A09p68740.2_BraZ1	12.9	+	380	129	129	1.0000000
A09	61841193	61842587	A09p68750.2_BraZ1	1041.64	+	252	1165	1394	0.8357245
A09	61845490	61846627	A09p68760.2_BraZ1	111.9	-	340	1108	1137	0.9744943
A09	61849114	61851826	A09p68770.2_BraZ1	1143.89	-	1503	2679	2712	0.9878318
A09	61854949	61860601	A09p68780.2_BraZ1	2848.44	+	2653	5306	5652	0.9387828
A09	61862383	61863391	A09p68790.2_BraZ1	100.8	+	628	1008	1008	1.0000000
A09	61866633	61867219	A09p68800.2_BraZ1	318	+	2	20	586	0.0341297
A09	61870133	61870688	A09p68810.2_BraZ1	55.5	-	871	555	555	1.0000000
A09	61871273	61871903	A09p68820.2_BraZ1	63	-	105	505	630	0.8015873
A09	61872877	61873720	A09p68830.2_BraZ1	84.3	+	148	385	843	0.4567023
A09	61874213	61874956	A09p68840.2_BraZ1	558	-	297	743	743	1.0000000
A09	61883792	61885872	A09p68850.2_BraZ1	863.143	+	881	1985	2080	0.9543269
A09	61886945	61889493	A09p68860.2_BraZ1	1184.48	-	887	2456	2548	0.9638932
A09	61894117	61897342	A09p68870.2_BraZ1	2252.69	+	283	2460	3225	0.7627907
A09	61897840	61909480	A09p68880.2_BraZ1	1582.08	-	3272	8771	11640	0.7535223
A09	61910416	61920483	A09p68890.2_BraZ1	2622.75	+	1650	4418	10067	0.4388596
A09	61923429	61924634	A09p68900.2_BraZ1	764.318	+	386	1108	1205	0.9195021
A09	61926641	61930310	A09p68910.2_BraZ1	1305.51	+	875	3492	3669	0.9517580
A09	61936490	61939140	A09p68920.2_BraZ1	886.956	+	496	2583	2650	0.9747170
A09	61966855	61967217	A09p68930.2_BraZ1	35.1	+	193	362	362	1.0000000
A09	61968451	61969869	A09p68940.2_BraZ1	132.3	-	145	1246	1418	0.8787024
A09	61973141	61973454	A09p68950.2_BraZ1	210	+	422	313	313	1.0000000
A09	61974059	61974991	A09p68960.2_BraZ1	380.714	-	279	932	932	1.0000000
A09	61979735	61980566	A09p68970.2_BraZ1	83.1	-	720	831	831	1.0000000
A09	61981295	61983034	A09p68980.2_BraZ1	987.429	-	1193	1739	1739	1.0000000
A09	61989838	61991297	A09p68990.2_BraZ1	4560	-	568	1459	1459	1.0000000
A09	61992370	61994328	A09p69000.2_BraZ1	1960	-	807	1879	1958	0.9596527
A09	61997405	61997743	A09p69010.2_BraZ1	201	-	600	338	338	1.0000000
A09	61999029	62001376	A09p69020.2_BraZ1	1573.8	+	863	2311	2347	0.9846613
A09	62002333	62004184	A09p69030.2_BraZ1	13005	-	344	1464	1851	0.7909238
A09	62011131	62013809	A09p69040.2_BraZ1	1805.17	+	328	1880	2678	0.7020164
A09	62015646	62019126	A09p69050.2_BraZ1	1013.74	+	795	3037	3480	0.8727012
A09	62020544	62021605	A09p69060.2_BraZ1	981	+	146	786	1061	0.7408106
A09	62023427	62026482	A09p69070.2_BraZ1	2979	-	98	1838	3055	0.6016366
A09	62028450	62030335	A09p69080.2_BraZ1	1491	-	551	1749	1885	0.9278514
A09	62031950	62035122	A09p69090.2_BraZ1	2025.16	+	710	2816	3172	0.8877680
A09	62035109	62036433	A09p69100.2_BraZ1	599.111	+	634	1324	1324	1.0000000
A09	62037300	62038937	A09p69110.2_BraZ1	1546.87	+	476	1637	1637	1.0000000
A09	62039437	62041652	A09p69120.2_BraZ1	1311.09	-	1494	2215	2215	1.0000000
A09	62045666	62046464	A09p69130.2_BraZ1	75	-	901	798	798	1.0000000
A09	62047590	62048413	A09p69140.2_BraZ1	444	-	488	823	823	1.0000000
A09	62053263	62055393	A09p69150.2_BraZ1	1557.9	+	1493	2130	2130	1.0000000
A09	62057451	62058282	A09p69160.2_BraZ1	83.1	+	712	831	831	1.0000000
A09	62059792	62060947	A09p69170.2_BraZ1	531.091	+	924	1155	1155	1.0000000
A09	62062057	62069427	A09p69180.2_BraZ1	4269.38	-	3145	6290	7370	0.8534600
A09	62072526	62073608	A09p69190.2_BraZ1	5329.5	+	9	263	1082	0.2430684
A09	62074372	62077938	A09p69200.2_BraZ1	2022.67	+	1339	3292	3566	0.9231632
A09	62078106	62079915	A09p69210.2_BraZ1	753	-	1282	1809	1809	1.0000000
A09	62083755	62086939	A09p69220.2_BraZ1	755.571	-	642	2612	3184	0.8203518
A09	62091347	62092850	A09p69230.2_BraZ1	674.375	-	591	1503	1503	1.0000000
A09	62099137	62100406	A09p69240.2_BraZ1	819	+	331	896	1269	0.7060677
A09	62102300	62103416	A09p69250.2_BraZ1	111.6	+	35	651	1116	0.5833333
A09	62104937	62105138	A09p69260.2_BraZ1	11.7	+	30	201	201	1.0000000
A09	62115902	62116357	A09p69270.2_BraZ1	333	-	498	455	455	1.0000000
A09	62119935	62121647	A09p69280.2_BraZ1	2630.57	+	509	1484	1712	0.8668224
A09	62134346	62136289	A09p69290.2_BraZ1	387	-	0	0	1943	0.0000000
A09	62137400	62137529	A09p69300.2_BraZ1	12.9	-	0	0	129	0.0000000
A09	62137877	62138039	A09p69310.2_BraZ1	16.2	+	1	49	162	0.3024691
A09	62142815	62147667	A09p69320.2_BraZ1	1721.92	+	1323	4145	4852	0.8542869
A09	62156686	62169912	A09p69330.2_BraZ1	664.889	+	2180	6978	13226	0.5275971
A09	62170073	62172894	A09p69340.2_BraZ1	614.732	-	844	1789	2821	0.6341723
A09	62180254	62180666	A09p69350.2_BraZ1	207	-	0	0	412	0.0000000
A09	62181661	62186351	A09p69360.2_BraZ1	2400.58	+	2855	4690	4690	1.0000000
A09	62187317	62188895	A09p69370.2_BraZ1	1380	-	466	1231	1578	0.7801014
A09	62189860	62192162	A09p69380.2_BraZ1	828	-	24	286	2302	0.1242398
A09	62195599	62196091	A09p69390.2_BraZ1	49.2	-	177	425	492	0.8638211
A09	62205701	62206999	A09p69400.2_BraZ1	589	-	253	977	1298	0.7526965
A09	62208218	62209683	A09p69410.2_BraZ1	388.6	-	423	1242	1465	0.8477816
A09	62217180	62218986	A09p69420.2_BraZ1	826.435	+	691	1522	1806	0.8427464
A09	62220052	62221616	A09p69430.2_BraZ1	1124.68	-	397	1265	1564	0.8088235
A09	62229447	62229912	A09p69440.2_BraZ1	46.5	+	378	465	465	1.0000000
A09	62232411	62236492	A09p69450.2_BraZ1	5346	+	2817	4081	4081	1.0000000
A09	62238599	62241843	A09p69460.2_BraZ1	1550.86	+	1889	2717	3244	0.8375462
A09	62252477	62252729	A09p69470.2_BraZ1	25.2	-	0	0	252	0.0000000
A09	62256206	62257176	A09p69480.2_BraZ1	976.444	+	328	947	970	0.9762887
A09	62260735	62263680	A09p69490.2_BraZ1	1543.69	-	1300	2900	2945	0.9847199
A09	62264769	62266707	A09p69500.2_BraZ1	984.261	+	453	1453	1938	0.7497420
A09	62267053	62270040	A09p69510.2_BraZ1	2079.48	-	609	2598	2987	0.8697690
A09	62271853	62275022	A09p69520.2_BraZ1	1627.71	-	1548	3070	3169	0.9687598
A09	62276285	62280372	A09p69530.2_BraZ1	2164.5	-	795	3546	4087	0.8676291
A09	62282243	62282504	A09p69540.2_BraZ1	25.8	-	48	261	261	1.0000000
A09	62288305	62289691	A09p69550.2_BraZ1	138.6	+	304	1000	1386	0.7215007
A09	62291106	62292462	A09p69560.2_BraZ1	135.6	+	233	1209	1356	0.8915929
A09	62293727	62296247	A09p69570.2_BraZ1	250.5	-	578	2105	2520	0.8353174
A09	62296818	62299221	A09p69580.2_BraZ1	1556.25	-	607	1484	2403	0.6175614
A09	62300016	62301150	A09p69590.2_BraZ1	2784	-	851	1134	1134	1.0000000
A09	62302807	62304358	A09p69600.2_BraZ1	155.1	-	157	1058	1551	0.6821405
A09	62323573	62325831	A09p69610.2_BraZ1	1396.98	+	328	1816	2258	0.8042516
A09	62330745	62336653	A09p69620.2_BraZ1	2701.92	+	3246	5463	5908	0.9246784
A09	62337562	62338646	A09p69630.2_BraZ1	91.8	-	429	1074	1084	0.9907749
A09	62438931	62439180	A09p69640.2_BraZ1	24.9	-	22	170	249	0.6827309
A09	62443276	62444047	A09p69650.2_BraZ1	77.1	+	166	614	771	0.7963684
A09	62447799	62450210	A09p69660.2_BraZ1	1205.36	-	715	2340	2411	0.9705516
A09	62451748	62452438	A09p69670.2_BraZ1	237	+	463	690	690	1.0000000
A09	62453403	62456069	A09p69680.2_BraZ1	1198.48	+	375	2366	2666	0.8874719
A09	62458345	62461252	A09p69690.2_BraZ1	3229.69	-	1200	2851	2907	0.9807361
A09	62466892	62471254	A09p69700.2_BraZ1	2939.27	-	1047	3667	4362	0.8406694
A09	62474769	62476680	A09p69710.2_BraZ1	707	-	786	1911	1911	1.0000000
A09	62479100	62484594	A09p69720.2_BraZ1	4177.45	+	1420	4149	5494	0.7551875
A09	62488559	62489413	A09p69730.2_BraZ1	1716.75	+	808	854	854	1.0000000
A09	62494389	62496245	A09p69740.2_BraZ1	1347	+	224	1039	1856	0.5598060
A09	62499553	62499970	A09p69750.2_BraZ1	41.7	+	70	321	417	0.7697842
A09	62501614	62507694	A09p69760.2_BraZ1	1097.5	-	3521	5259	6080	0.8649671
A09	62517860	62520578	A09p69770.2_BraZ1	2334	+	2240	2718	2718	1.0000000
A09	62521884	62522781	A09p69780.2_BraZ1	89.7	-	128	833	897	0.9286510
A09	62530028	62530973	A09p69790.2_BraZ1	94.5	+	203	944	945	0.9989418
A09	62531607	62533661	A09p69800.2_BraZ1	831.343	-	47	656	2054	0.3193768
A09	62547549	62549435	A09p69810.2_BraZ1	8283	+	200	843	1886	0.4469777
A09	62565290	62569790	A09p69820.2_BraZ1	2058.07	+	221	1807	4500	0.4015556
A09	62574132	62575440	A09p69830.2_BraZ1	130.8	+	45	1026	1308	0.7844037
A09	62579184	62580777	A09p69840.2_BraZ1	951	-	144	997	1593	0.6258631
A09	62589777	62590088	A09p69850.2_BraZ1	28.8	-	0	0	311	0.0000000
A09	62600778	62601756	A09p69860.2_BraZ1	819	-	157	978	978	1.0000000
A09	62604369	62609162	A09p69870.2_BraZ1	2107.34	-	589	3548	4793	0.7402462
A09	62616974	62618530	A09p69880.2_BraZ1	887.478	-	521	1547	1556	0.9942160
A09	62625901	62628141	A09p69890.2_BraZ1	2613.21	-	1531	2240	2240	1.0000000
A09	62629832	62630277	A09p69900.2_BraZ1	243	-	299	445	445	1.0000000
A09	62632941	62638036	A09p69910.2_BraZ1	549.964	-	1071	4475	5095	0.8783121
A09	62650883	62657049	A09p69920.2_BraZ1	1779.67	+	4095	5956	6166	0.9659423
A09	62657485	62662373	A09p69930.2_BraZ1	2234.39	-	1435	4634	4888	0.9480360
A09	62663735	62666523	A09p69940.2_BraZ1	1781.76	-	1238	2705	2788	0.9702296
A09	62677689	62677844	A09p69950.2_BraZ1	10.5	-	101	154	155	0.9935484
A09	62680599	62680701	A09p69960.2_BraZ1	10.2	-	49	102	102	1.0000000
A09	62680899	62682002	A09p69970.2_BraZ1	664.222	+	352	1017	1103	0.9220308
A09	62682926	62684888	A09p69980.2_BraZ1	1248	-	1902	1962	1962	1.0000000
A09	62688069	62690888	A09p69990.2_BraZ1	686.4	-	1899	2773	2819	0.9836822
A09	62695283	62699695	A09p70000.2_BraZ1	2574.35	+	1068	4027	4412	0.9127380
A09	62700121	62701011	A09p70010.2_BraZ1	66.6	-	222	818	890	0.9191011
A09	62702446	62703666	A09p70020.2_BraZ1	427.034	+	215	943	1220	0.7729508
A09	62705354	62705840	A09p70030.2_BraZ1	161.948	+	463	486	486	1.0000000
A09	62712515	62715603	A09p70040.2_BraZ1	1723.66	+	1470	3066	3088	0.9928756
A09	62718381	62718768	A09p70050.2_BraZ1	38.7	+	273	387	387	1.0000000
A09	62725073	62726021	A09p70060.2_BraZ1	94.8	+	92	879	948	0.9272152
A09	62730640	62732265	A09p70070.2_BraZ1	1071	+	460	1625	1625	1.0000000
A09	62737855	62740503	A09p70080.2_BraZ1	1486.12	-	1180	2608	2648	0.9848943
A09	62741680	62744179	A09p70090.2_BraZ1	921	-	1658	2369	2499	0.9479792
A09	62745844	62746306	A09p70100.2_BraZ1	46.2	+	138	462	462	1.0000000
A09	62748308	62750488	A09p70110.2_BraZ1	1335.85	-	1146	2151	2180	0.9866973
A09	62753503	62754607	A09p70120.2_BraZ1	891.429	+	424	1104	1104	1.0000000
A09	62778239	62778446	A09p70130.2_BraZ1	20.7	-	16	207	207	1.0000000
A09	62783913	62784096	A09p70140.2_BraZ1	18.3	-	27	68	183	0.3715847
A09	62785114	62785384	A09p70150.2_BraZ1	27	-	262	270	270	1.0000000
A09	62786908	62788053	A09p70160.2_BraZ1	11171.2	-	175	704	1145	0.6148472
A09	62799919	62803815	A09p70170.2_BraZ1	2225.79	+	1483	3234	3896	0.8300821
A09	62805014	62805851	A09p70180.2_BraZ1	83.7	-	93	576	837	0.6881720
A09	62812085	62812802	A09p70190.2_BraZ1	71.7	-	17	266	717	0.3709902
A09	62821477	62821763	A09p70200.2_BraZ1	222	+	336	286	286	1.0000000
A09	62823568	62823892	A09p70210.2_BraZ1	32.4	+	20	324	324	1.0000000
A09	62824249	62824656	A09p70220.2_BraZ1	35.1	-	55	407	407	1.0000000
A09	62827419	62829209	A09p70230.2_BraZ1	925.6	+	660	1688	1790	0.9430168
A09	62829453	62832967	A09p70240.2_BraZ1	2088	-	1361	3185	3514	0.9063745
A09	62835108	62836327	A09p70250.2_BraZ1	542.609	-	294	1100	1219	0.9023790
A09	62836874	62838232	A09p70260.2_BraZ1	884.864	-	832	1358	1358	1.0000000
A09	62851084	62852081	A09p70270.2_BraZ1	265.036	+	131	927	997	0.9297894
A09	62851984	62853122	A09p70280.2_BraZ1	734.773	+	275	1072	1138	0.9420035
A09	62853480	62854368	A09p70290.2_BraZ1	297.273	-	609	888	888	1.0000000
A09	62854948	62856828	A09p70300.2_BraZ1	939.927	-	1284	1848	1880	0.9829787
A09	62864180	62864515	A09p70310.2_BraZ1	30	+	56	335	335	1.0000000
A09	62868066	62868401	A09p70320.2_BraZ1	30	+	87	335	335	1.0000000
A09	62871249	62871967	A09p70330.2_BraZ1	546	+	80	656	718	0.9136490
A09	62876772	62876931	A09p70340.2_BraZ1	15.9	+	21	159	159	1.0000000
A09	62878706	62881938	A09p70350.2_BraZ1	1407.48	+	1331	2912	3232	0.9009901
A09	62882630	62889744	A09p70360.2_BraZ1	6318.9	-	678	2702	7114	0.3798144
A09	62895065	62895293	A09p70370.2_BraZ1	22.8	-	16	188	228	0.8245614
A09	62901654	62903617	A09p70380.2_BraZ1	885.83	-	662	1799	1963	0.9164544
A09	62910297	62911294	A09p70390.2_BraZ1	92.4	+	393	997	997	1.0000000
A09	62912551	62913715	A09p70400.2_BraZ1	42.3	-	1328	1164	1164	1.0000000
A09	62914629	62917014	A09p70410.2_BraZ1	238.5	-	1109	2385	2385	1.0000000
A09	62918573	62918831	A09p70420.2_BraZ1	144	-	70	258	258	1.0000000
A09	62922070	62923126	A09p70430.2_BraZ1	105.6	+	200	950	1056	0.8996212
A09	62925053	62926166	A09p70440.2_BraZ1	111.3	+	289	1113	1113	1.0000000
A09	62927265	62929231	A09p70450.2_BraZ1	958.14	+	187	1695	1966	0.8621567
A09	62933363	62937979	A09p70460.2_BraZ1	3714.13	+	760	4346	4616	0.9415078
A09	62945891	62946426	A09p70470.2_BraZ1	288	-	175	535	535	1.0000000
A09	62956633	62960615	A09p70480.2_BraZ1	1317.67	-	458	2736	3982	0.6870919
A09	62965395	62966263	A09p70490.2_BraZ1	666	+	140	697	868	0.8029954
A09	62967542	62969075	A09p70500.2_BraZ1	153.3	-	279	1007	1533	0.6568819
A09	62975233	62976490	A09p70510.2_BraZ1	594	+	316	1066	1257	0.8480509
A09	62977994	62979187	A09p70520.2_BraZ1	557.333	+	153	1082	1193	0.9069573
A09	62979381	62980061	A09p70530.2_BraZ1	342	-	74	532	680	0.7823529
A09	62981047	62983132	A09p70540.2_BraZ1	701.5	+	1112	2040	2085	0.9784173
A09	62984849	62985176	A09p70550.2_BraZ1	32.7	-	28	200	327	0.6116208
A09	62987847	62988228	A09p70560.2_BraZ1	38.1	+	166	381	381	1.0000000
A09	62988603	62990541	A09p70570.2_BraZ1	1077	-	680	1560	1938	0.8049536
A09	62991003	62991192	A09p70580.2_BraZ1	18.9	+	19	189	189	1.0000000
A09	62992305	62995085	A09p70590.2_BraZ1	1947.71	-	1792	2669	2780	0.9600719
A09	62995065	62996947	A09p70600.2_BraZ1	75.0909	-	394	538	1882	0.2858661
A09	62995738	62996075	A09p70610.2_BraZ1	159	-	0	0	337	0.0000000
A09	62997283	63000562	A09p70620.2_BraZ1	929.316	+	1309	3279	3279	1.0000000
A09	63000844	63003713	A09p70630.2_BraZ1	1752.94	-	1560	2752	2869	0.9592192
A09	63009231	63012602	A09p70640.2_BraZ1	1194	-	872	3151	3371	0.9347374
A09	63014151	63014906	A09p70650.2_BraZ1	507	+	467	715	755	0.9470199
A09	63021935	63022247	A09p70660.2_BraZ1	31.2	+	22	310	312	0.9935898
A09	63031217	63032780	A09p70670.2_BraZ1	975.946	-	85	1166	1563	0.7460013
A09	63034851	63035757	A09p70680.2_BraZ1	368.062	-	315	906	906	1.0000000
A09	63035895	63040519	A09p70690.2_BraZ1	2372.3	-	820	3704	4624	0.8010381
A09	63041911	63044914	A09p70700.2_BraZ1	976.219	+	1202	2999	3003	0.9986680
A09	63045450	63046972	A09p70710.2_BraZ1	60.9	-	924	1479	1522	0.9717477
A09	63047239	63048101	A09p70720.2_BraZ1	330.172	-	723	862	862	1.0000000
A09	63052596	63053271	A09p70730.2_BraZ1	67.5	+	199	624	675	0.9244444
A09	63054016	63054193	A09p70740.2_BraZ1	17.7	+	322	177	177	1.0000000
A09	63054870	63057208	A09p70750.2_BraZ1	18364.5	-	336	1635	2338	0.6993157
A09	63055581	63056120	A09p70760.2_BraZ1	423	-	88	409	539	0.7588126
A09	63060704	63061208	A09p70770.2_BraZ1	345	+	301	478	504	0.9484127
A09	63061509	63062515	A09p70780.2_BraZ1	611.429	-	613	996	1006	0.9900596
A09	63062946	63066057	A09p70790.2_BraZ1	1713.83	-	575	2287	3111	0.7351334
A09	63074013	63075825	A09p70800.2_BraZ1	891.763	+	700	1707	1812	0.9420530
A09	63078995	63080611	A09p70810.2_BraZ1	1207.91	+	647	1577	1616	0.9758663
A09	63081696	63082627	A09p70820.2_BraZ1	552	+	796	931	931	1.0000000
A09	63083786	63086824	A09p70830.2_BraZ1	1784.01	-	730	3014	3038	0.9921001
A09	63091478	63096526	A09p70840.2_BraZ1	2675.75	+	987	4015	5048	0.7953645
A09	63096990	63099862	A09p70850.2_BraZ1	1516.2	+	902	2773	2872	0.9655293
A09	63106128	63109252	A09p70860.2_BraZ1	1145.5	-	2361	3096	3124	0.9910371
A09	63109910	63114986	A09p70870.2_BraZ1	2239.71	-	2556	4813	5076	0.9481875
A09	63115968	63116133	A09p70880.2_BraZ1	16.5	+	0	0	165	0.0000000
A09	63118676	63120306	A09p70890.2_BraZ1	67.2857	-	146	1392	1630	0.8539878
A09	63121428	63123384	A09p70900.2_BraZ1	868.827	-	1831	1956	1956	1.0000000
A09	63124415	63131029	A09p70910.2_BraZ1	2829.81	-	1638	3967	6614	0.5997883
A09	63132580	63134942	A09p70920.2_BraZ1	1131.84	+	1633	2362	2362	1.0000000
A09	63135609	63138565	A09p70930.2_BraZ1	1373.92	-	1022	2937	2956	0.9935724
A09	63143546	63145630	A09p70940.2_BraZ1	1117.79	+	650	1934	2084	0.9280230
A09	63146420	63147564	A09p70950.2_BraZ1	463.413	-	288	1124	1144	0.9825175
A09	63151612	63155651	A09p70960.2_BraZ1	2389.85	+	318	2791	4039	0.6910126
A09	63156795	63157074	A09p70970.2_BraZ1	27.9	-	33	273	279	0.9784946
A09	63157837	63159547	A09p70980.2_BraZ1	846.194	-	493	1628	1710	0.9520468
A09	63160353	63161980	A09p70990.2_BraZ1	892.8	+	520	1494	1627	0.9182544
A09	63163775	63164294	A09p71000.2_BraZ1	51.9	+	388	519	519	1.0000000
A09	63170854	63174850	A09p71010.2_BraZ1	1016.5	+	1521	3929	3996	0.9832332
A09	63184993	63185308	A09p71020.2_BraZ1	31.5	-	18	175	315	0.5555556
A09	63195017	63196504	A09p71030.2_BraZ1	660.848	-	256	1415	1487	0.9515803
A09	63198163	63198298	A09p71040.2_BraZ1	13.5	+	6	92	135	0.6814815
A09	63198673	63198955	A09p71050.2_BraZ1	28.2	+	15	278	282	0.9858156
A09	63199914	63200313	A09p71060.2_BraZ1	39.9	+	27	267	399	0.6691729
A09	63202791	63204608	A09p71070.2_BraZ1	924.699	+	770	1795	1817	0.9878922
A09	63205298	63207192	A09p71080.2_BraZ1	750.571	-	1298	1784	1894	0.9419218
A09	63207722	63210032	A09p71090.2_BraZ1	741.149	-	1668	2283	2310	0.9883117
A09	63211267	63212954	A09p71100.2_BraZ1	947.206	+	1903	1687	1687	1.0000000
A09	63215876	63216461	A09p71110.2_BraZ1	58.5	+	308	572	585	0.9777778
A09	63217522	63218236	A09p71120.2_BraZ1	600	+	304	714	714	1.0000000
A09	63219056	63219605	A09p71130.2_BraZ1	228	+	711	549	549	1.0000000
A09	63219890	63220405	A09p71140.2_BraZ1	358.05	+	609	515	515	1.0000000
A09	63222742	63224358	A09p71150.2_BraZ1	156	+	227	1380	1616	0.8539604
A09	63227688	63228288	A09p71160.2_BraZ1	60	+	387	600	600	1.0000000
A09	63228858	63231020	A09p71170.2_BraZ1	1393.92	-	913	2153	2162	0.9958372
A09	63233951	63235064	A09p71180.2_BraZ1	192	-	607	1086	1113	0.9757413
A09	63238858	63239295	A09p71190.2_BraZ1	204	+	176	437	437	1.0000000
A09	63242819	63243197	A09p71200.2_BraZ1	201	-	426	378	378	1.0000000
A09	63243707	63245986	A09p71210.2_BraZ1	1457.79	-	1121	2097	2279	0.9201404
A09	63253248	63254671	A09p71220.2_BraZ1	848.4	-	1008	1303	1423	0.9156711
A09	63260216	63260705	A09p71230.2_BraZ1	243	-	0	0	489	0.0000000
A09	63260781	63261271	A09p71240.2_BraZ1	285	-	0	0	490	0.0000000
A09	63263008	63265228	A09p71250.2_BraZ1	1222.83	-	186	1870	2220	0.8423423
A09	63267433	63269632	A09p71260.2_BraZ1	1265.94	-	70	954	2199	0.4338336
A09	63273188	63273997	A09p71270.2_BraZ1	394.286	+	174	809	809	1.0000000
A09	63274103	63274472	A09p71280.2_BraZ1	282	-	265	369	369	1.0000000
A09	63275674	63278467	A09p71290.2_BraZ1	1380.92	+	402	2364	2793	0.8464017
A09	63278944	63280152	A09p71300.2_BraZ1	813.522	-	744	1208	1208	1.0000000
A09	63281622	63282558	A09p71310.2_BraZ1	93.6	-	507	936	936	1.0000000
A09	63286763	63287177	A09p71320.2_BraZ1	309	+	82	414	414	1.0000000
A09	63287721	63288165	A09p71330.2_BraZ1	44.4	+	159	444	444	1.0000000
A09	63288720	63290104	A09p71340.2_BraZ1	1190.22	-	347	1237	1384	0.8937861
A09	63291441	63291839	A09p71350.2_BraZ1	216	+	66	398	398	1.0000000
A09	63291969	63292216	A09p71360.2_BraZ1	162	-	264	247	247	1.0000000
A09	63292351	63293913	A09p71370.2_BraZ1	1243.88	+	805	1562	1562	1.0000000
A09	63295059	63295813	A09p71380.2_BraZ1	245.304	-	452	754	754	1.0000000
A09	63296217	63297504	A09p71390.2_BraZ1	978	+	262	1266	1287	0.9836830
A09	63298547	63299271	A09p71400.2_BraZ1	291	+	305	713	724	0.9848067
A09	63301175	63303058	A09p71410.2_BraZ1	1194.24	-	243	1759	1883	0.9341477
A09	63311236	63312533	A09p71420.2_BraZ1	872.438	+	440	1217	1297	0.9383192
A09	63313006	63315698	A09p71430.2_BraZ1	1370.22	-	1067	2617	2692	0.9721397
A09	63317770	63319209	A09p71440.2_BraZ1	885.15	+	360	969	1439	0.6733843
A09	63320522	63320862	A09p71450.2_BraZ1	164.25	-	677	340	340	1.0000000
A09	63322653	63324303	A09p71460.2_BraZ1	1149.69	+	386	1517	1650	0.9193940
A09	63324884	63327009	A09p71470.2_BraZ1	1314.05	+	1252	2125	2125	1.0000000
A09	63328047	63328556	A09p71480.2_BraZ1	668.455	-	265	464	509	0.9115914
A09	63329592	63331686	A09p71490.2_BraZ1	1138.41	-	544	1889	2094	0.9021012
A09	63339099	63339533	A09p71500.2_BraZ1	222	+	46	355	434	0.8179724
A09	63340237	63341428	A09p71510.2_BraZ1	1017	+	100	1132	1191	0.9504618
A09	63341538	63343155	A09p71520.2_BraZ1	161.1	-	851	1617	1617	1.0000000
A09	63343770	63344337	A09p71530.2_BraZ1	195	-	382	567	567	1.0000000
A09	63344658	63345108	A09p71540.2_BraZ1	189	+	557	450	450	1.0000000
A09	63345784	63348520	A09p71550.2_BraZ1	1313.38	+	877	2447	2736	0.8943713
A09	63350021	63350401	A09p71560.2_BraZ1	279	+	0	0	380	0.0000000
A09	63351959	63352421	A09p71570.2_BraZ1	87.75	+	0	0	462	0.0000000
A09	63356237	63357180	A09p71580.2_BraZ1	615	+	71	502	943	0.5323436
A09	63358177	63358561	A09p71590.2_BraZ1	38.4	-	2	37	384	0.0963542
A09	63359167	63371096	A09p71600.2_BraZ1	1896.28	-	1809	7237	11929	0.6066728
A09	63377057	63383440	A09p71610.2_BraZ1	978.248	+	2929	6105	6383	0.9564468
A09	63385808	63390315	A09p71620.2_BraZ1	672.893	+	3143	4399	4507	0.9760373
A09	63390797	63391948	A09p71630.2_BraZ1	767	-	774	1151	1151	1.0000000
A09	63394470	63397753	A09p71640.2_BraZ1	949.138	-	2787	3272	3283	0.9966494
A09	63403661	63403919	A09p71650.2_BraZ1	25.8	+	328	258	258	1.0000000
A09	63406136	63407147	A09p71660.2_BraZ1	281.368	+	13	331	1011	0.3273986
A09	63407363	63407678	A09p71670.2_BraZ1	31.5	+	0	0	315	0.0000000
A09	63415242	63417261	A09p71680.2_BraZ1	539.455	+	1050	1962	2019	0.9717682
A09	63418986	63425537	A09p71690.2_BraZ1	244.845	-	1843	3592	6551	0.5483133
A09	63422116	63423154	A09p71700.2_BraZ1	472.5	-	6	167	1038	0.1608863
A09	63423298	63423607	A09p71710.2_BraZ1	30.9	-	0	0	309	0.0000000
A09	63428068	63429587	A09p71720.2_BraZ1	712.391	-	791	1302	1519	0.8571429
A09	63430719	63431889	A09p71730.2_BraZ1	117	-	391	1152	1170	0.9846154
A09	63436310	63441589	A09p71740.2_BraZ1	2346.15	+	2016	4860	5279	0.9206289
A09	63442807	63445641	A09p71750.2_BraZ1	1484.39	-	1242	2813	2834	0.9925900
A09	63446596	63447361	A09p71760.2_BraZ1	76.5	+	1	69	765	0.0901961
A09	63451978	63453244	A09p71770.2_BraZ1	126.6	+	486	1266	1266	1.0000000
A09	63459934	63460224	A09p71780.2_BraZ1	15.3	-	377	290	290	1.0000000
A09	63464356	63465538	A09p71790.2_BraZ1	118.2	+	351	1182	1182	1.0000000
A09	63468149	63469711	A09p71800.2_BraZ1	1113	-	372	1112	1562	0.7119078
A09	63470627	63471981	A09p71810.2_BraZ1	405	+	480	1354	1354	1.0000000
A09	63473836	63473995	A09p71820.2_BraZ1	13.5	+	107	159	159	1.0000000
A09	63474361	63474982	A09p71830.2_BraZ1	396	+	272	621	621	1.0000000
A09	63475578	63476323	A09p71840.2_BraZ1	192	-	730	745	745	1.0000000
A09	63476869	63477199	A09p71850.2_BraZ1	33	+	283	330	330	1.0000000
A09	63477615	63477834	A09p71860.2_BraZ1	21.9	-	81	219	219	1.0000000
A09	63478942	63479739	A09p71870.2_BraZ1	359.767	-	650	797	797	1.0000000
A09	63480998	63483664	A09p71880.2_BraZ1	1117.48	+	1409	2666	2666	1.0000000
A09	63484098	63488172	A09p71890.2_BraZ1	1675.75	-	3028	4049	4074	0.9938635
A09	63491301	63492458	A09p71900.2_BraZ1	903.844	+	352	1126	1157	0.9732066
A09	63493671	63498780	A09p71910.2_BraZ1	344.375	+	2632	4844	5109	0.9481307
A09	63498970	63500045	A09p71920.2_BraZ1	204	+	784	1075	1075	1.0000000
A09	63500638	63502813	A09p71930.2_BraZ1	1310.47	-	1122	2175	2175	1.0000000
A09	63504651	63505694	A09p71940.2_BraZ1	5700	-	739	1043	1043	1.0000000
A09	63508838	63509985	A09p71950.2_BraZ1	330.75	-	103	1118	1147	0.9747167
A09	63511001	63513805	A09p71960.2_BraZ1	1471.94	-	2516	2804	2804	1.0000000
A09	63514531	63516427	A09p71970.2_BraZ1	1006.5	-	1179	1896	1896	1.0000000
A09	63517225	63519237	A09p71980.2_BraZ1	777.2	-	982	1954	2012	0.9711730
A09	63523057	63525913	A09p71990.2_BraZ1	1357.56	+	432	2518	2856	0.8816527
A09	63526331	63527864	A09p72000.2_BraZ1	153.3	-	330	941	1533	0.6138291
A09	63529988	63531098	A09p72010.2_BraZ1	903	+	255	743	1110	0.6693693
A09	63532088	63536134	A09p72020.2_BraZ1	237.6	+	2041	3998	4046	0.9881364
A09	63542680	63545943	A09p72030.2_BraZ1	8997.75	-	2450	2997	3263	0.9184799
A09	63547773	63550286	A09p72040.2_BraZ1	577.15	+	2127	2513	2513	1.0000000
A09	63553360	63554208	A09p72050.2_BraZ1	741	-	879	848	848	1.0000000
A09	63568731	63571358	A09p72060.2_BraZ1	1541.48	+	3336	2510	2627	0.9554625
A09	63573118	63575410	A09p72070.2_BraZ1	1655.11	-	3626	2292	2292	1.0000000
A09	63579350	63581496	A09p72080.2_BraZ1	985.6	+	1574	1986	2146	0.9254427
A09	63582510	63587473	A09p72090.2_BraZ1	2505.46	-	2075	4855	4963	0.9782389
A09	63591307	63593228	A09p72100.2_BraZ1	452.325	+	1295	1921	1921	1.0000000
A09	63594106	63597475	A09p72110.2_BraZ1	1415.88	-	1510	3369	3369	1.0000000
A09	63607755	63608490	A09p72120.2_BraZ1	370.174	-	407	735	735	1.0000000
A09	63610062	63610846	A09p72130.2_BraZ1	413.093	-	507	651	784	0.8303571
A09	63611338	63614842	A09p72140.2_BraZ1	2013.33	-	1858	3469	3504	0.9900114
A09	63615827	63620965	A09p72150.2_BraZ1	2008.11	-	5152	4820	5138	0.9381082
A09	63621712	63623571	A09p72160.2_BraZ1	1782	-	1123	1851	1859	0.9956966
A09	63626713	63626968	A09p72170.2_BraZ1	201	-	73	255	255	1.0000000
A09	63627717	63628159	A09p72180.2_BraZ1	270	-	89	441	442	0.9977375
A09	63630748	63631868	A09p72190.2_BraZ1	681.429	+	396	1048	1120	0.9357143
A09	63632554	63634159	A09p72200.2_BraZ1	1536	+	289	1338	1605	0.8336449
A09	63635163	63635808	A09p72210.2_BraZ1	64.5	+	176	580	645	0.8992248
A09	63637036	63640773	A09p72220.2_BraZ1	1849.66	-	2356	3627	3737	0.9705646
A09	63643204	63648517	A09p72230.2_BraZ1	2501.25	+	342	3248	5313	0.6113307
A09	63650503	63650796	A09p72240.2_BraZ1	18.3	-	293	293	293	1.0000000
A09	63653784	63657697	A09p72250.2_BraZ1	1632.09	+	383	2476	3913	0.6327626
A09	63657870	63660197	A09p72260.2_BraZ1	1059.38	-	1114	2327	2327	1.0000000
A09	63662255	63662641	A09p72270.2_BraZ1	279	-	418	386	386	1.0000000
A09	63665251	63667671	A09p72280.2_BraZ1	1638	-	588	2087	2420	0.8623967
A09	63670413	63671177	A09p72290.2_BraZ1	1296	+	711	764	764	1.0000000
A09	63677633	63677900	A09p72300.2_BraZ1	26.7	+	7	191	267	0.7153558
A09	63680926	63682210	A09p72310.2_BraZ1	128.4	-	37	409	1284	0.3185358
A09	63684333	63686365	A09p72320.2_BraZ1	783.03	-	46	933	2032	0.4591535
A09	63688249	63689398	A09p72330.2_BraZ1	114.9	-	624	1067	1149	0.9286336
A09	63691164	63692954	A09p72340.2_BraZ1	385.112	-	1388	1780	1790	0.9944134
A09	63693155	63694480	A09p72350.2_BraZ1	530.667	+	756	1103	1325	0.8324528
A09	63696215	63700471	A09p72360.2_BraZ1	625.4	+	2152	4225	4256	0.9927162
A09	63702898	63709316	A09p72370.2_BraZ1	80.4	-	2663	6126	6418	0.9545029
A09	63728175	63733445	A09p72380.2_BraZ1	1916.74	-	463	3004	5270	0.5700189
A09	63733721	63734875	A09p72390.2_BraZ1	564	+	532	1154	1154	1.0000000
A09	63743810	63747295	A09p72400.2_BraZ1	1158.13	-	2644	3296	3485	0.9457676
A09	63748269	63751194	A09p72410.2_BraZ1	2508	-	2685	2891	2925	0.9883761
A09	63752727	63753026	A09p72420.2_BraZ1	228	-	324	299	299	1.0000000
A09	63753468	63754059	A09p72430.2_BraZ1	207	-	309	591	591	1.0000000
A09	63767319	63768571	A09p72440.2_BraZ1	906.353	-	783	1231	1252	0.9832268
A09	63770606	63772858	A09p72450.2_BraZ1	1905.75	-	838	2034	2252	0.9031972
A09	63774122	63775335	A09p72460.2_BraZ1	684.438	+	660	1213	1213	1.0000000
A09	63775492	63775963	A09p72470.2_BraZ1	47.1	-	296	471	471	1.0000000
A09	63776788	63777677	A09p72480.2_BraZ1	819	-	340	780	889	0.8773903
A09	63778419	63781968	A09p72490.2_BraZ1	1078.34	-	1275	3088	3549	0.8701043
A09	63783804	63787206	A09p72500.2_BraZ1	1286.74	+	1619	3382	3402	0.9941211
A09	63787595	63790597	A09p72510.2_BraZ1	1906.76	-	1306	2842	3002	0.9467022
A09	63791485	63792735	A09p72520.2_BraZ1	62.1196	-	729	1187	1250	0.9496000
A09	63797245	63800929	A09p72530.2_BraZ1	4347.75	-	2793	3486	3684	0.9462541
A09	63803062	63806917	A09p72540.2_BraZ1	2666.48	+	1949	3787	3855	0.9823605
A09	63807414	63808473	A09p72550.2_BraZ1	58.5	-	581	1050	1059	0.9915014
A09	63809513	63810065	A09p72560.2_BraZ1	55.2	-	69	391	552	0.7083333
A09	63812599	63813463	A09p72570.2_BraZ1	523.25	-	155	737	864	0.8530093
A09	63814904	63815672	A09p72580.2_BraZ1	486	-	66	554	768	0.7213542
A09	63817534	63818323	A09p72590.2_BraZ1	552	-	72	603	789	0.7642586
A09	63825880	63831751	A09p72600.2_BraZ1	1709.59	-	448	3396	5871	0.5784364
A09	63835284	63836515	A09p72610.2_BraZ1	483	+	2095	768	1231	0.6238830
A09	63837860	63838777	A09p72620.2_BraZ1	759	-	435	917	917	1.0000000
A09	63839152	63841838	A09p72630.2_BraZ1	1484.35	+	1649	2686	2686	1.0000000
A09	63843743	63845469	A09p72640.2_BraZ1	513.512	+	887	1583	1726	0.9171495
A09	63846762	63848196	A09p72650.2_BraZ1	984	-	381	1380	1434	0.9623431
A09	63849021	63853507	A09p72660.2_BraZ1	1388.46	+	1855	4228	4486	0.9424877
A09	63854508	63856689	A09p72670.2_BraZ1	1106.62	+	1233	2094	2181	0.9601101
A09	63857007	63858898	A09p72680.2_BraZ1	3208.5	-	685	1891	1891	1.0000000
A09	63860106	63861480	A09p72690.2_BraZ1	137.4	-	153	836	1374	0.6084425
A09	63863209	63866685	A09p72700.2_BraZ1	1800.23	+	1664	3323	3476	0.9559839
A09	63867884	63870562	A09p72710.2_BraZ1	623.635	+	642	2340	2678	0.8737864
A09	63873568	63874792	A09p72720.2_BraZ1	8184	-	524	1190	1224	0.9722222
A09	63880530	63881372	A09p72730.2_BraZ1	466.442	+	467	835	842	0.9916865
A09	63882126	63885357	A09p72740.2_BraZ1	1774.62	+	569	2633	3231	0.8149180
A09	63885635	63886787	A09p72750.2_BraZ1	804	-	425	1152	1152	1.0000000
A09	63889810	63896092	A09p72760.2_BraZ1	1451.79	+	3591	6116	6282	0.9735753
A09	63898293	63899658	A09p72770.2_BraZ1	832.3	+	908	1317	1365	0.9648352
A09	63901604	63902172	A09p72780.2_BraZ1	54.6	-	580	559	568	0.9841549
A09	63905968	63911305	A09p72790.2_BraZ1	636	-	7357	5337	5337	1.0000000
A09	63916539	63919133	A09p72800.2_BraZ1	1400.87	+	1225	2519	2594	0.9710871
A09	63920056	63921082	A09p72810.2_BraZ1	981	-	96	1024	1026	0.9980507
A09	63923030	63926787	A09p72820.2_BraZ1	1646.4	-	1378	3600	3757	0.9582114
A09	63926888	63928151	A09p72830.2_BraZ1	126.3	+	398	1193	1263	0.9445764
A09	63929574	63929724	A09p72840.2_BraZ1	15	+	63	150	150	1.0000000
A09	63930781	63932047	A09p72850.2_BraZ1	812.605	+	869	1254	1266	0.9905213
A09	63932675	63951370	A09p72860.2_BraZ1	4754.33	-	5863	13617	18695	0.7283766
A09	63937694	63941506	A09p72870.2_BraZ1	1727.68	+	411	2710	3812	0.7109129
A09	63964126	63964368	A09p72880.2_BraZ1	117	+	252	242	242	1.0000000
A09	63967726	63967873	A09p72890.2_BraZ1	14.7	+	293	147	147	1.0000000
A09	63968483	63969221	A09p72900.2_BraZ1	73.8	-	11	513	738	0.6951219
A09	63969790	63970463	A09p72910.2_BraZ1	66.6	+	56	559	673	0.8306092
A09	63972203	63973933	A09p72920.2_BraZ1	54	+	1330	1730	1730	1.0000000
A09	63974560	63976163	A09p72930.2_BraZ1	858.789	+	578	1585	1603	0.9887711
A09	63977144	63981938	A09p72940.2_BraZ1	3555.42	-	1166	3881	4794	0.8095536
A09	63991386	63991725	A09p72950.2_BraZ1	33.9	-	255	339	339	1.0000000
A09	63992663	63995463	A09p72960.2_BraZ1	1293.73	+	1187	2692	2800	0.9614286
A09	63996113	64001530	A09p72970.2_BraZ1	2309.39	-	3788	4837	5417	0.8929297
A09	64007784	64008324	A09p72980.2_BraZ1	54	+	288	540	540	1.0000000
A09	64011691	64013273	A09p72990.2_BraZ1	6745.67	+	84	845	1582	0.5341340
A09	64014545	64017326	A09p73000.2_BraZ1	1080	+	679	2190	2781	0.7874865
A09	64017867	64021772	A09p73010.2_BraZ1	1963.08	-	575	2294	3905	0.5874520
A09	64030609	64035735	A09p73020.2_BraZ1	1788.23	-	1505	4615	5126	0.9003121
A09	64042583	64043554	A09p73030.2_BraZ1	740.727	+	413	971	971	1.0000000
A09	64050087	64054926	A09p73040.2_BraZ1	1534.37	-	5177	4321	4839	0.8929531
A09	64057494	64058121	A09p73050.2_BraZ1	62.1	+	67	275	627	0.4385965
A09	64059014	64061882	A09p73060.2_BraZ1	1441.55	-	841	2809	2868	0.9794282
A09	64066562	64066963	A09p73070.2_BraZ1	294	-	145	401	401	1.0000000
A09	64068783	64070631	A09p73080.2_BraZ1	534.687	+	1451	1848	1848	1.0000000
A09	64074904	64076066	A09p73090.2_BraZ1	606	-	425	1162	1162	1.0000000
A09	64077979	64078722	A09p73100.2_BraZ1	5940	-	150	600	743	0.8075370
A09	64084797	64085536	A09p73110.2_BraZ1	660	-	329	739	739	1.0000000
A09	64092107	64092845	A09p73120.2_BraZ1	3740	-	126	706	738	0.9566396
A09	64093627	64094352	A09p73130.2_BraZ1	326.7	+	783	725	725	1.0000000
A09	64094442	64094679	A09p73140.2_BraZ1	138	+	266	237	237	1.0000000
A09	64094986	64095731	A09p73150.2_BraZ1	468	-	729	745	745	1.0000000
A09	64099878	64100919	A09p73160.2_BraZ1	104.1	+	460	1041	1041	1.0000000
A09	64101176	64103120	A09p73170.2_BraZ1	987.544	-	479	1727	1944	0.8883745
A09	64106939	64108700	A09p73180.2_BraZ1	176.1	-	507	1566	1761	0.8892674
A09	64110565	64110865	A09p73190.2_BraZ1	28.5	+	21	260	300	0.8666667
A09	64112055	64113037	A09p73200.2_BraZ1	435	+	265	943	982	0.9602851
A09	64113260	64115771	A09p73210.2_BraZ1	251.1	-	980	2465	2511	0.9816806
A09	64122445	64125633	A09p73220.2_BraZ1	10237.5	+	1376	2891	3188	0.9068381
A09	64126837	64128537	A09p73230.2_BraZ1	755.789	-	405	1253	1700	0.7370588
A09	64132696	64134755	A09p73240.2_BraZ1	3209.33	-	851	1975	2059	0.9592035
A09	64136150	64137566	A09p73250.2_BraZ1	354.75	+	1206	1416	1416	1.0000000
A09	64140346	64171132	A09p73260.2_BraZ1	4120.2	-	18485	29946	30786	0.9727148
A09	64145501	64147177	A09p73270.2_BraZ1	801	+	874	1653	1676	0.9862769
A09	64147529	64147815	A09p73280.2_BraZ1	207	+	94	286	286	1.0000000
A09	64148487	64149855	A09p73290.2_BraZ1	396	+	799	1312	1368	0.9590643
A09	64151075	64151848	A09p73300.2_BraZ1	390	+	445	773	773	1.0000000
A09	64155353	64155764	A09p73310.2_BraZ1	41.1	+	523	411	411	1.0000000
A09	64159882	64160293	A09p73320.2_BraZ1	41.1	+	118	411	411	1.0000000
A09	64165120	64165531	A09p73330.2_BraZ1	41.1	+	75	411	411	1.0000000
A09	64168954	64169365	A09p73340.2_BraZ1	41.1	+	114	411	411	1.0000000
A09	64171627	64172038	A09p73350.2_BraZ1	41.1	+	29	327	411	0.7956204
A09	64174889	64175300	A09p73360.2_BraZ1	41.1	+	101	355	411	0.8637469
A09	64176414	64176961	A09p73370.2_BraZ1	426	-	281	524	547	0.9579524
A09	64177779	64186809	A09p73380.2_BraZ1	5473.72	+	1316	4946	9030	0.5477298
A09	64187336	64191399	A09p73390.2_BraZ1	2023.22	-	1419	3967	4063	0.9763721
A09	64192564	64199006	A09p73400.2_BraZ1	4567.58	-	2408	5907	6442	0.9169512
A09	64200271	64202212	A09p73410.2_BraZ1	537.615	-	1879	1941	1941	1.0000000
A09	64206798	64208398	A09p73420.2_BraZ1	1085.03	-	330	1074	1600	0.6712500
A09	64211322	64212934	A09p73430.2_BraZ1	1320	+	443	1494	1612	0.9267990
A09	64214781	64217553	A09p73440.2_BraZ1	1140.92	+	1316	2684	2772	0.9682540
A09	64217956	64218908	A09p73450.2_BraZ1	491.667	-	711	952	952	1.0000000
A09	64219426	64221984	A09p73460.2_BraZ1	1311.43	+	2255	2558	2558	1.0000000
A09	64222489	64223862	A09p73470.2_BraZ1	6364	-	2050	1373	1373	1.0000000
A09	64227090	64228307	A09p73480.2_BraZ1	495	+	750	1217	1217	1.0000000
A09	64229788	64230121	A09p73490.2_BraZ1	33.3	-	446	333	333	1.0000000
A09	64231502	64231763	A09p73500.2_BraZ1	222	+	29	261	261	1.0000000
A09	64236717	64237158	A09p73510.2_BraZ1	44.1	+	512	441	441	1.0000000
A09	64240602	64241492	A09p73520.2_BraZ1	735	-	658	890	890	1.0000000
A09	64253431	64254450	A09p73530.2_BraZ1	817.895	+	216	989	1019	0.9705594
A09	64255792	64257097	A09p73540.2_BraZ1	797.891	-	936	1305	1305	1.0000000
A09	64259492	64263763	A09p73550.2_BraZ1	1598.44	+	2722	4070	4271	0.9529384
A09	64264206	64266803	A09p73560.2_BraZ1	1130.65	-	1620	2545	2597	0.9799769
A09	64276694	64279412	A09p73570.2_BraZ1	1439.69	+	2377	2718	2718	1.0000000
A09	64279638	64280372	A09p73580.2_BraZ1	540	-	917	734	734	1.0000000
A09	64282446	64283009	A09p73590.2_BraZ1	300	+	518	563	563	1.0000000
A09	64283427	64287619	A09p73600.2_BraZ1	3243.51	-	2075	3723	4192	0.8881202
A09	64290598	64291671	A09p73610.2_BraZ1	620.822	+	740	1073	1073	1.0000000
A09	64292027	64294374	A09p73620.2_BraZ1	945	-	1694	2299	2347	0.9795483
A09	64295019	64296580	A09p73630.2_BraZ1	766.875	-	1090	1561	1561	1.0000000
A09	64297742	64298132	A09p73640.2_BraZ1	39	+	9	271	390	0.6948718
A09	64299750	64300465	A09p73650.2_BraZ1	430.5	+	326	715	715	1.0000000
A09	64300672	64302930	A09p73660.2_BraZ1	17328	-	1084	1741	2258	0.7710363
A09	64303397	64311526	A09p73670.2_BraZ1	1984.57	-	1066	2591	8129	0.3187354
A09	64312367	64317956	A09p73680.2_BraZ1	2398.49	-	4361	5574	5589	0.9973162
A09	64318370	64319988	A09p73690.2_BraZ1	644.532	-	1407	1618	1618	1.0000000
A09	64320646	64321069	A09p73700.2_BraZ1	336	+	544	423	423	1.0000000
A09	64321434	64323644	A09p73710.2_BraZ1	1248.47	-	1764	2210	2210	1.0000000
A09	64326493	64328118	A09p73720.2_BraZ1	982.33	+	1542	1607	1625	0.9889231
A09	64328431	64336200	A09p73730.2_BraZ1	2723.68	-	5979	7568	7769	0.9741279
A09	64337906	64338565	A09p73740.2_BraZ1	417.443	-	470	659	659	1.0000000
A09	64340317	64342941	A09p73750.2_BraZ1	1477.02	-	747	2388	2624	0.9100610
A09	64343687	64344965	A09p73760.2_BraZ1	653.906	+	569	1264	1278	0.9890454
A09	64345894	64347615	A09p73770.2_BraZ1	641.455	-	995	1721	1721	1.0000000
A09	64349046	64349730	A09p73780.2_BraZ1	68.4	+	720	684	684	1.0000000
A09	64350900	64352403	A09p73790.2_BraZ1	150.3	+	394	1466	1503	0.9753826
A09	64352850	64353776	A09p73800.2_BraZ1	780	+	117	829	926	0.8952484
A09	64354101	64355782	A09p73810.2_BraZ1	1158.3	-	531	1681	1681	1.0000000
A09	64357428	64359644	A09p73820.2_BraZ1	524.512	+	1003	1882	2216	0.8492780
A09	64361467	64362404	A09p73830.2_BraZ1	331.333	+	568	937	937	1.0000000
A09	64365431	64365947	A09p73840.2_BraZ1	171	-	8	19	516	0.0368217
A09	64369332	64369517	A09p73850.2_BraZ1	16.8	-	22	185	185	1.0000000
A09	64370728	64370863	A09p73860.2_BraZ1	13.5	+	17	135	135	1.0000000
A09	64372387	64377427	A09p73870.2_BraZ1	3473.66	+	1392	4091	5040	0.8117064
A09	64377822	64377990	A09p73880.2_BraZ1	16.8	+	169	168	168	1.0000000
A09	64379437	64379804	A09p73890.2_BraZ1	270	+	131	367	367	1.0000000
A09	64384793	64390078	A09p73900.2_BraZ1	2883.53	+	1662	4843	5285	0.9163671
A09	64391082	64396263	A09p73910.2_BraZ1	2497.04	-	2632	5068	5181	0.9781895
A09	64401925	64403002	A09p73920.2_BraZ1	107.7	-	214	911	1077	0.8458682
A09	64418464	64419323	A09p73930.2_BraZ1	154	-	939	859	859	1.0000000
A09	64420155	64421377	A09p73940.2_BraZ1	732	-	344	1197	1222	0.9795417
A09	64422240	64422895	A09p73950.2_BraZ1	437.357	+	13	156	655	0.2381679
A09	64423407	64425108	A09p73960.2_BraZ1	1127.5	-	891	1701	1701	1.0000000
A09	64430817	64431411	A09p73970.2_BraZ1	213	+	223	550	594	0.9259259
A09	64441618	64441798	A09p73980.2_BraZ1	18	-	12	125	180	0.6944444
A09	64445904	64447494	A09p73990.2_BraZ1	1077	+	201	1275	1590	0.8018868
A09	64452628	64452934	A09p74000.2_BraZ1	249	+	150	272	306	0.8888889
A09	64454716	64456879	A09p74010.2_BraZ1	216.3	+	790	2050	2163	0.9477577
A09	64461024	64461668	A09p74020.2_BraZ1	399	+	396	644	644	1.0000000
A09	64462130	64463744	A09p74030.2_BraZ1	1003.34	-	694	1569	1614	0.9721190
A09	64465135	64465912	A09p74040.2_BraZ1	77.7	-	15	445	777	0.5727156
A09	64468118	64468606	A09p74050.2_BraZ1	557.143	+	163	486	488	0.9959016
A09	64473156	64473864	A09p74060.2_BraZ1	297.632	+	875	697	708	0.9844633
A09	64474838	64474955	A09p74070.2_BraZ1	11.7	+	70	117	117	1.0000000
A09	64475154	64475661	A09p74080.2_BraZ1	50.7	-	119	507	507	1.0000000
A09	64476864	64477293	A09p74090.2_BraZ1	42.9	+	287	429	429	1.0000000
A09	64477695	64482117	A09p74100.2_BraZ1	751.565	-	745	2750	4422	0.6218905
A09	64478039	64478971	A09p74110.2_BraZ1	267.75	-	1	120	932	0.1287554
A09	64484677	64484917	A09p74120.2_BraZ1	24	-	20	107	240	0.4458333
A09	64485582	64485813	A09p74130.2_BraZ1	23.1	+	18	222	231	0.9610389
A09	64487618	64488886	A09p74140.2_BraZ1	516	-	1384	1259	1268	0.9929022
A09	64495343	64496346	A09p74150.2_BraZ1	510.071	-	740	1003	1003	1.0000000
A09	64498533	64499351	A09p74160.2_BraZ1	579	-	110	715	818	0.8740831
A09	64501499	64504429	A09p74170.2_BraZ1	738.292	+	1351	2902	2930	0.9904437
A09	64505413	64506823	A09p74180.2_BraZ1	897	+	627	1381	1410	0.9794326
A09	64507534	64509180	A09p74190.2_BraZ1	578.25	+	1258	1635	1646	0.9933171
A09	64509651	64509957	A09p74200.2_BraZ1	30.6	-	304	306	306	1.0000000
A09	64511055	64511940	A09p74210.2_BraZ1	188.514	+	590	861	885	0.9728814
A09	64512402	64518041	A09p74220.2_BraZ1	2984.77	-	959	4856	5639	0.8611456
A09	64518210	64520372	A09p74230.2_BraZ1	785.25	+	2315	2162	2162	1.0000000
A09	64520782	64522816	A09p74240.2_BraZ1	1147.61	-	734	2008	2034	0.9872173
A09	64524824	64528721	A09p74250.2_BraZ1	2455.6	+	647	2806	3897	0.7200410
A09	64529224	64529781	A09p74260.2_BraZ1	180.556	-	347	557	557	1.0000000
A09	64531118	64533296	A09p74270.2_BraZ1	1064.38	-	1266	2178	2178	1.0000000
A09	64538778	64540580	A09p74280.2_BraZ1	507	-	1398	1781	1802	0.9883463
A09	64543441	64545027	A09p74290.2_BraZ1	738.68	-	1997	1586	1586	1.0000000
A09	64546573	64549057	A09p74300.2_BraZ1	1632.78	+	1766	2484	2484	1.0000000
A09	64550521	64551667	A09p74310.2_BraZ1	114.6	+	485	1146	1146	1.0000000
A09	64551812	64553599	A09p74320.2_BraZ1	876.522	-	1386	1763	1787	0.9865696
A09	64554838	64557436	A09p74330.2_BraZ1	1395.08	+	1618	2550	2598	0.9815242
A09	64558306	64559656	A09p74340.2_BraZ1	134.1	-	329	1350	1350	1.0000000
A09	64560234	64561934	A09p74350.2_BraZ1	348.837	+	647	1638	1700	0.9635294
A09	64562740	64563425	A09p74360.2_BraZ1	5271.75	+	262	409	685	0.5970803
A09	64563896	64566462	A09p74370.2_BraZ1	1557.75	+	1428	2566	2566	1.0000000
A09	64567652	64568968	A09p74380.2_BraZ1	762.286	-	1817	1316	1316	1.0000000
A09	64569506	64570354	A09p74390.2_BraZ1	783	+	607	848	848	1.0000000
A09	64571642	64571882	A09p74400.2_BraZ1	24	+	251	240	240	1.0000000
A09	64583377	64590362	A09p74410.2_BraZ1	968.864	+	4270	6651	6985	0.9521832
A09	64593452	64593828	A09p74420.2_BraZ1	297	+	45	348	376	0.9255319
A09	64596933	64597095	A09p74430.2_BraZ1	16.2	-	165	162	162	1.0000000
A09	64598824	64599638	A09p74440.2_BraZ1	523.636	-	62	627	814	0.7702703
A09	64602135	64607855	A09p74450.2_BraZ1	3903.3	+	749	4540	5720	0.7937063
A09	64612774	64613562	A09p74460.2_BraZ1	192	-	267	532	788	0.6751269
A09	64615123	64618398	A09p74470.2_BraZ1	1543.68	+	970	2956	3275	0.9025954
A09	64619375	64622753	A09p74480.2_BraZ1	1730.58	+	1024	3262	3378	0.9656602
A09	64625346	64630885	A09p74490.2_BraZ1	1813.48	-	8126	5413	5539	0.9772522
A09	64635412	64636106	A09p74500.2_BraZ1	408	+	54	526	694	0.7579251
A09	64638093	64640316	A09p74510.2_BraZ1	1366.36	+	271	2129	2223	0.9577148
A09	64641403	64642441	A09p74520.2_BraZ1	726	-	25	436	1038	0.4200385
A09	64647143	64648817	A09p74530.2_BraZ1	957.091	+	248	999	1674	0.5967742
A09	64650910	64653107	A09p74540.2_BraZ1	1199.21	+	1262	2197	2197	1.0000000
A09	64656737	64658806	A09p74550.2_BraZ1	836	+	1676	2069	2069	1.0000000
A09	64660781	64663686	A09p74560.2_BraZ1	1681.58	+	1661	2903	2905	0.9993115
A09	64664800	64665319	A09p74570.2_BraZ1	51.9	-	74	423	519	0.8150289
A09	64666852	64669232	A09p74580.2_BraZ1	1204	-	207	1888	2380	0.7932773
A09	64668911	64669420	A09p74590.2_BraZ1	417	-	78	456	509	0.8958743
A09	64672191	64673349	A09p74600.2_BraZ1	36.8	-	293	1100	1158	0.9499136
A09	64676783	64678075	A09p74610.2_BraZ1	618.675	-	163	821	1292	0.6354489
A09	64682106	64682871	A09p74620.2_BraZ1	537	+	0	0	765	0.0000000
A09	64683312	64684555	A09p74630.2_BraZ1	687	-	19	526	1243	0.4231698
A09	64688037	64693622	A09p74640.2_BraZ1	3240.75	+	1857	5281	5585	0.9455685
A09	64694909	64697950	A09p74650.2_BraZ1	1737	+	1711	2981	3041	0.9802697
A09	64710506	64712890	A09p74660.2_BraZ1	723	+	356	1738	2384	0.7290269
A09	64720194	64722959	A09p74670.2_BraZ1	1368.9	-	113	1198	2765	0.4332730
A09	64726216	64727436	A09p74680.2_BraZ1	243	-	263	815	1220	0.6680328
A09	64728472	64730134	A09p74690.2_BraZ1	466.212	-	288	1437	1662	0.8646209
A09	64733207	64734724	A09p74700.2_BraZ1	871.75	+	223	958	1517	0.6315095
A09	64738332	64738962	A09p74710.2_BraZ1	306	+	0	0	630	0.0000000
A09	64740171	64742397	A09p74720.2_BraZ1	209.1	+	1042	2109	2226	0.9474394
A09	64742701	64743367	A09p74730.2_BraZ1	66.6	+	393	666	666	1.0000000
A09	64743659	64744826	A09p74740.2_BraZ1	116.7	+	119	632	1167	0.5415596
A09	64747309	64748852	A09p74750.2_BraZ1	704.55	+	1043	1505	1543	0.9753727
A09	64749034	64754612	A09p74760.2_BraZ1	2622	-	4272	5341	5578	0.9575117
A09	64755729	64756750	A09p74770.2_BraZ1	348	-	990	1021	1021	1.0000000
A09	64758559	64758892	A09p74780.2_BraZ1	33.3	+	9	163	333	0.4894895
A09	64769240	64770185	A09p74790.2_BraZ1	94.5	+	12	161	945	0.1703704
A09	64772538	64774215	A09p74800.2_BraZ1	167.7	-	293	1673	1677	0.9976148
A09	64775473	64787464	A09p74810.2_BraZ1	721.875	+	3075	6961	11991	0.5805187
A09	64777715	64778307	A09p74820.2_BraZ1	41.1	+	84	481	592	0.8125000
A09	64778616	64778900	A09p74830.2_BraZ1	189	+	0	0	284	0.0000000
A09	64780428	64781114	A09p74840.2_BraZ1	111	+	0	0	686	0.0000000
A09	64781188	64781472	A09p74850.2_BraZ1	340.2	+	0	0	284	0.0000000
A09	64784462	64785101	A09p74860.2_BraZ1	63.9	-	439	639	639	1.0000000
A09	64785120	64785865	A09p74870.2_BraZ1	654	-	391	745	745	1.0000000
A09	64785804	64788924	A09p74880.2_BraZ1	1460.78	+	1911	3083	3120	0.9881410
A09	64786517	64786783	A09p74890.2_BraZ1	255	-	158	266	266	1.0000000
A09	64789308	64791492	A09p74900.2_BraZ1	1249.26	-	826	1991	2184	0.9116300
A09	64795240	64799646	A09p74910.2_BraZ1	1403.51	+	2057	4303	4406	0.9766228
A09	64810135	64811359	A09p74920.2_BraZ1	122.4	+	295	770	1224	0.6290849
A09	64812570	64813736	A09p74930.2_BraZ1	75	-	646	1151	1166	0.9871355
A09	64815168	64816800	A09p74940.2_BraZ1	766.196	-	534	1525	1632	0.9344363
A09	64820665	64821228	A09p74950.2_BraZ1	480	+	278	428	563	0.7602131
A09	64821460	64822269	A09p74960.2_BraZ1	65.0294	+	205	769	809	0.9505562
A09	64822723	64824246	A09p74970.2_BraZ1	1010.1	+	69	824	1523	0.5410374
A09	64824591	64824809	A09p74980.2_BraZ1	12.6	-	26	148	218	0.6788991
A09	64825046	64825498	A09p74990.2_BraZ1	321	+	97	311	452	0.6880531
A09	64827021	64828404	A09p75000.2_BraZ1	839.5	-	356	911	1383	0.6587129
A09	64831310	64833336	A09p75010.2_BraZ1	319.312	-	3124	2026	2026	1.0000000
A09	64836415	64844484	A09p75020.2_BraZ1	441.316	+	8005	7988	8069	0.9899616
A09	64846606	64847594	A09p75030.2_BraZ1	580.211	+	979	984	988	0.9959514
A09	64849587	64850615	A09p75040.2_BraZ1	646	+	738	1028	1028	1.0000000
A09	64852205	64853174	A09p75050.2_BraZ1	660.435	+	655	831	969	0.8575851
A09	64853303	64854224	A09p75060.2_BraZ1	507	-	333	921	921	1.0000000
A09	64854676	64855249	A09p75070.2_BraZ1	57.3	+	222	573	573	1.0000000
A09	64855547	64857125	A09p75080.2_BraZ1	157.8	-	195	1508	1578	0.9556401
A09	64857795	64858806	A09p75090.2_BraZ1	948	-	590	1011	1011	1.0000000
A09	64860771	64862997	A09p75100.2_BraZ1	994.52	+	434	2226	2226	1.0000000
A09	64864074	64865009	A09p75110.2_BraZ1	556.696	+	399	935	935	1.0000000
A09	64865160	64866108	A09p75120.2_BraZ1	579	-	303	888	948	0.9367089
A09	64866782	64868148	A09p75130.2_BraZ1	927	+	285	1148	1366	0.8404099
A09	64870117	64871103	A09p75140.2_BraZ1	915	+	81	738	986	0.7484787
A09	64872100	64873179	A09p75150.2_BraZ1	918	+	113	752	1079	0.6969416
A09	64873490	64875038	A09p75160.2_BraZ1	154.8	-	54	899	1548	0.5807493
A09	64875583	64877189	A09p75170.2_BraZ1	1542	-	653	1421	1606	0.8848070
A09	64878822	64880524	A09p75180.2_BraZ1	1614	-	308	1606	1702	0.9435958
A09	64883597	64888681	A09p75190.2_BraZ1	208.5	-	1084	3987	5084	0.7842250
A09	64891490	64891982	A09p75200.2_BraZ1	49.2	+	564	492	492	1.0000000
A09	64892873	64897055	A09p75210.2_BraZ1	2106.58	-	873	3400	4182	0.8130081
A09	64899892	64904491	A09p75220.2_BraZ1	2071.02	-	812	2799	4599	0.6086106
A09	64906941	64907618	A09p75230.2_BraZ1	300	+	0	0	677	0.0000000
A09	64918223	64920124	A09p75240.2_BraZ1	1655.06	+	708	1570	1901	0.8258811
A09	64921969	64922835	A09p75250.2_BraZ1	639	+	245	866	866	1.0000000
A09	64923111	64925568	A09p75260.2_BraZ1	1268	-	1662	2447	2457	0.9959300
A09	64930659	64932804	A09p75270.2_BraZ1	1424.22	+	921	1611	2145	0.7510489
A09	64933392	64935381	A09p75280.2_BraZ1	13095	-	909	1863	1989	0.9366516
A09	64946184	64949660	A09p75290.2_BraZ1	1358.05	+	1360	3340	3476	0.9608746
A09	64949660	64953283	A09p75300.2_BraZ1	534	+	1244	1278	3623	0.3527463
A09	64954333	64955039	A09p75310.2_BraZ1	507	-	4	39	706	0.0552408
A09	64956859	64959302	A09p75320.2_BraZ1	1959	+	822	2413	2443	0.9877200
A09	64960015	64960183	A09p75330.2_BraZ1	16.8	-	0	0	168	0.0000000
A09	64960997	64961156	A09p75340.2_BraZ1	13.2	+	0	0	159	0.0000000
A09	64963150	64964545	A09p75350.2_BraZ1	784.313	-	713	1253	1395	0.8982079
A09	64965167	64966449	A09p75360.2_BraZ1	9975	-	1037	1282	1282	1.0000000
A09	64967749	64968658	A09p75370.2_BraZ1	90.9	+	393	858	909	0.9438944
A09	64969791	64970451	A09p75380.2_BraZ1	137.5	+	466	660	660	1.0000000
A09	64971599	64972366	A09p75390.2_BraZ1	491.538	+	302	767	767	1.0000000
A09	64972929	64973885	A09p75400.2_BraZ1	867	-	452	937	956	0.9801255
A09	64974465	64974978	A09p75410.2_BraZ1	324	+	615	513	513	1.0000000
A09	64974978	64976238	A09p75420.2_BraZ1	99.3	+	1047	1260	1260	1.0000000
A09	64978553	64980500	A09p75430.2_BraZ1	194.7	+	1028	1828	1947	0.9388803
A09	64982084	64984049	A09p75440.2_BraZ1	1334.67	-	57	1204	1965	0.6127226
A09	64985554	64987080	A09p75450.2_BraZ1	1353	-	1015	1526	1526	1.0000000
A09	64990934	64993941	A09p75460.2_BraZ1	1657.6	-	342	1749	3007	0.5816428
A09	64995572	64997347	A09p75470.2_BraZ1	248.333	+	1894	1775	1775	1.0000000
A09	64997868	64999454	A09p75480.2_BraZ1	6664	-	718	1586	1586	1.0000000
A09	65000790	65007232	A09p75490.2_BraZ1	1428	-	3481	6404	6442	0.9941012
A09	65003314	65004997	A09p75500.2_BraZ1	696.667	+	1592	1683	1683	1.0000000
A09	65010017	65010737	A09p75510.2_BraZ1	366	-	1	41	720	0.0569444
A09	65013300	65014926	A09p75520.2_BraZ1	342	-	0	0	1626	0.0000000
A09	65016218	65019935	A09p75530.2_BraZ1	1724.02	+	2321	3042	3717	0.8184019
A09	65020209	65021203	A09p75540.2_BraZ1	930	-	100	941	994	0.9466801
A09	65029808	65031464	A09p75550.2_BraZ1	1548	+	134	760	1656	0.4589372
A09	65034586	65034973	A09p75560.2_BraZ1	38.7	+	1	70	387	0.1808785
A09	65054200	65055311	A09p75570.2_BraZ1	13920.8	+	301	1086	1111	0.9774978
A09	65055482	65055652	A09p75580.2_BraZ1	13.8	-	186	170	170	1.0000000
A09	65058352	65058870	A09p75590.2_BraZ1	171	+	1026	518	518	1.0000000
A09	65063803	65065075	A09p75600.2_BraZ1	127.2	-	67	460	1272	0.3616352
A09	65072032	65072620	A09p75610.2_BraZ1	58.8	+	15	156	588	0.2653061
A09	65082584	65083586	A09p75620.2_BraZ1	282	-	474	1002	1002	1.0000000
A09	65084519	65086430	A09p75630.2_BraZ1	868.656	+	896	1831	1911	0.9581371
A09	65087698	65090435	A09p75640.2_BraZ1	1089.6	+	909	2572	2737	0.9397150
A09	65091105	65092854	A09p75650.2_BraZ1	1179	+	431	1508	1749	0.8622070
A09	65096244	65097984	A09p75660.2_BraZ1	1143	+	1179	1571	1740	0.9028736
A09	65099947	65101221	A09p75670.2_BraZ1	13716	+	1125	1247	1274	0.9788069
A09	65103252	65105271	A09p75680.2_BraZ1	979.29	+	507	1931	2019	0.9564140
A09	65107046	65108748	A09p75690.2_BraZ1	1034.27	+	519	1598	1702	0.9388954
A09	65118338	65119096	A09p75700.2_BraZ1	504.273	+	1	66	758	0.0870712
A09	65122050	65123338	A09p75710.2_BraZ1	1026	-	331	732	1288	0.5683230
A09	65125458	65126865	A09p75720.2_BraZ1	835.143	-	87	448	1407	0.3184080
A09	65127539	65128779	A09p75730.2_BraZ1	1004.55	+	154	875	1240	0.7056451
A09	65128974	65129373	A09p75740.2_BraZ1	39.9	-	236	306	399	0.7669173
A09	65130096	65130938	A09p75750.2_BraZ1	363	+	18	381	842	0.4524941
A09	65131458	65132861	A09p75760.2_BraZ1	711.667	-	42	855	1403	0.6094084
A09	65134402	65135690	A09p75770.2_BraZ1	893.455	+	120	905	1288	0.7026398
A09	65135887	65136160	A09p75780.2_BraZ1	27.3	-	12	160	273	0.5860806
A09	65136846	65137664	A09p75790.2_BraZ1	357	+	12	304	818	0.3716381
A09	65138132	65139546	A09p75800.2_BraZ1	789.333	-	79	996	1414	0.7043847
A09	65139933	65141358	A09p75810.2_BraZ1	835.312	+	64	290	1425	0.2035088
A09	65143202	65143672	A09p75820.2_BraZ1	211.179	-	25	243	470	0.5170213
A09	65145286	65146486	A09p75830.2_BraZ1	508.5	-	500	961	1200	0.8008333
A09	65149590	65151073	A09p75840.2_BraZ1	949.833	-	3787	1483	1483	1.0000000
A09	65166186	65166790	A09p75850.2_BraZ1	477	+	1030	604	604	1.0000000
A09	65167001	65167873	A09p75860.2_BraZ1	697.083	+	1384	872	872	1.0000000
A09	65169726	65171893	A09p75870.2_BraZ1	848.667	-	1173	2167	2167	1.0000000
A09	65175094	65176105	A09p75880.2_BraZ1	101.1	-	58	804	1011	0.7952522
A09	65192957	65193167	A09p75890.2_BraZ1	150	-	142	210	210	1.0000000
A09	65195827	65197135	A09p75900.2_BraZ1	130.8	-	138	962	1308	0.7354740
A09	65200343	65204721	A09p75910.2_BraZ1	3146.82	+	651	4191	4378	0.9572864
A09	65205476	65207607	A09p75920.2_BraZ1	446.286	+	616	1931	2131	0.9061474
A09	65208639	65212638	A09p75930.2_BraZ1	2356.53	-	1274	3431	3999	0.8579645
A09	65219620	65219875	A09p75940.2_BraZ1	25.2	-	493	255	255	1.0000000
A09	65222357	65225024	A09p75950.2_BraZ1	266.7	-	1050	2528	2667	0.9478815
A09	65227049	65229729	A09p75960.2_BraZ1	2595	-	433	2331	2680	0.8697761
A09	65230598	65232264	A09p75970.2_BraZ1	633.333	-	457	1539	1666	0.9237695
A09	65234679	65240652	A09p75980.2_BraZ1	2722.7	+	786	2816	5973	0.4714549
A09	65241914	65242213	A09p75990.2_BraZ1	187.5	+	0	0	299	0.0000000
A09	65242412	65243791	A09p76000.2_BraZ1	429	-	0	0	1379	0.0000000
A09	65249898	65250839	A09p76010.2_BraZ1	48.9	+	35	375	941	0.3985122
A09	65250916	65251153	A09p76020.2_BraZ1	23.7	-	6	216	237	0.9113924
A09	65253233	65256601	A09p76030.2_BraZ1	1603.82	+	1922	3309	3368	0.9824822
A09	65256740	65258583	A09p76040.2_BraZ1	1290	-	1205	1843	1843	1.0000000
A09	65260260	65262603	A09p76050.2_BraZ1	1524	-	876	2110	2343	0.9005548
A09	65264402	65269418	A09p76060.2_BraZ1	7400	+	2696	5016	5016	1.0000000
A09	65271646	65274262	A09p76070.2_BraZ1	2109.55	+	1091	2345	2616	0.8964067
A09	65274837	65276575	A09p76080.2_BraZ1	728	-	448	1487	1738	0.8555811
A09	65277049	65277597	A09p76090.2_BraZ1	41.1	-	159	548	548	1.0000000
A09	65279115	65280355	A09p76100.2_BraZ1	899.786	+	740	1240	1240	1.0000000
A09	65282021	65283633	A09p76110.2_BraZ1	1470	-	93	1296	1612	0.8039702
A09	65285692	65287312	A09p76120.2_BraZ1	1527	-	851	1620	1620	1.0000000
A09	65289048	65290347	A09p76130.2_BraZ1	395.719	-	400	897	1299	0.6905312
A09	65291494	65296913	A09p76140.2_BraZ1	1917.49	+	3516	5203	5419	0.9601402
A09	65298993	65300923	A09p76150.2_BraZ1	1367.18	+	973	1888	1930	0.9782383
A09	65303166	65304051	A09p76160.2_BraZ1	88.5	-	74	674	885	0.7615819
A09	65308253	65308595	A09p76170.2_BraZ1	249	+	0	0	342	0.0000000
A09	65310411	65318645	A09p76180.2_BraZ1	1225.04	-	3590	7475	8234	0.9078212
A09	65314162	65314742	A09p76190.2_BraZ1	237	+	76	375	580	0.6465517
A09	65324787	65331069	A09p76200.2_BraZ1	2184.77	+	5514	6215	6282	0.9893346
A09	65331446	65332568	A09p76210.2_BraZ1	112.2	+	290	1097	1122	0.9777184
A09	65333230	65335200	A09p76220.2_BraZ1	1328.37	+	1021	1913	1970	0.9710660
A09	65335383	65336067	A09p76230.2_BraZ1	68.4	-	152	605	684	0.8845029
A09	65337491	65339066	A09p76240.2_BraZ1	1266	+	1954	1575	1575	1.0000000
A09	65339737	65340501	A09p76250.2_BraZ1	37.5	-	36	361	764	0.4725131
A09	65341224	65343790	A09p76260.2_BraZ1	1088.05	-	1210	2566	2566	1.0000000
A09	65344090	65344630	A09p76270.2_BraZ1	54	+	445	540	540	1.0000000
A09	65348271	65350563	A09p76280.2_BraZ1	1833.5	+	1141	2204	2292	0.9616056
A09	65351915	65353865	A09p76290.2_BraZ1	195	-	1347	1950	1950	1.0000000
A09	65354591	65356619	A09p76300.2_BraZ1	1149	-	804	2005	2028	0.9886588
A09	65357733	65359808	A09p76310.2_BraZ1	1340.74	-	135	1326	2075	0.6390361
A09	65367755	65368148	A09p76320.2_BraZ1	28.8	+	80	308	393	0.7837150
A09	65369146	65370979	A09p76330.2_BraZ1	181.2	+	1013	1833	1833	1.0000000
A09	65372072	65374662	A09p76340.2_BraZ1	7109.14	+	2409	2581	2590	0.9965251
A09	65376315	65378105	A09p76350.2_BraZ1	1401.25	+	222	1324	1790	0.7396648
A09	65379026	65379641	A09p76360.2_BraZ1	396	-	941	615	615	1.0000000
A09	65381621	65382225	A09p76370.2_BraZ1	399	-	442	604	604	1.0000000
A09	65384609	65385521	A09p76380.2_BraZ1	390	-	464	876	912	0.9605263
A09	65386556	65387050	A09p76390.2_BraZ1	360	-	73	460	494	0.9311741
A09	65387869	65391438	A09p76400.2_BraZ1	586.894	-	1824	3428	3569	0.9604931
A09	65394290	65394908	A09p76410.2_BraZ1	61.8	+	253	618	618	1.0000000
A09	65395770	65397666	A09p76420.2_BraZ1	1551	-	513	1811	1896	0.9551688
A09	65400026	65400227	A09p76430.2_BraZ1	20.1	-	102	201	201	1.0000000
A09	65400627	65401707	A09p76440.2_BraZ1	583.353	-	369	1002	1080	0.9277778
A09	65401469	65407782	A09p76450.2_BraZ1	67.0588	-	950	3809	6313	0.6033581
A09	65408799	65410756	A09p76460.2_BraZ1	2800	-	1257	1892	1957	0.9667859
A09	65411871	65418163	A09p76470.2_BraZ1	537	-	1854	5907	6292	0.9388112
A09	65419795	65422753	A09p76480.2_BraZ1	1031.09	+	2585	2855	2958	0.9651791
A09	65425219	65426625	A09p76490.2_BraZ1	901.6	-	173	1252	1406	0.8904694
A09	65428526	65428994	A09p76500.2_BraZ1	46.8	+	140	429	468	0.9166667
A09	65429972	65430319	A09p76510.2_BraZ1	207	+	311	347	347	1.0000000
A09	65430708	65432598	A09p76520.2_BraZ1	189	-	752	1730	1890	0.9153439
A09	65432737	65440871	A09p76530.2_BraZ1	1734.06	-	2921	6759	8134	0.8309565
A09	65445546	65447787	A09p76540.2_BraZ1	224.1	+	292	1739	2241	0.7759929
A09	65453708	65458672	A09p76550.2_BraZ1	1986.71	-	3524	4964	4964	1.0000000
A09	65460342	65461094	A09p76560.2_BraZ1	7227	-	49	513	752	0.6821808
A09	65463576	65464023	A09p76570.2_BraZ1	44.7	+	77	405	447	0.9060403
A09	65465137	65465609	A09p76580.2_BraZ1	387	+	504	472	472	1.0000000
A09	65465725	65468380	A09p76590.2_BraZ1	265.5	+	1209	2623	2655	0.9879473
A09	65470129	65472802	A09p76600.2_BraZ1	267.3	+	1329	2673	2673	1.0000000
A09	65473786	65475708	A09p76610.2_BraZ1	1071.6	-	816	1855	1922	0.9651405
A09	65476695	65479206	A09p76620.2_BraZ1	488.182	+	3194	2511	2511	1.0000000
A09	65492488	65493850	A09p76630.2_BraZ1	698.238	+	204	824	1362	0.6049926
A09	65494501	65496183	A09p76640.2_BraZ1	815.652	-	1416	1682	1682	1.0000000
A09	65496469	65497573	A09p76650.2_BraZ1	505.314	-	1013	1104	1104	1.0000000
A09	65497929	65502617	A09p76660.2_BraZ1	1869.69	-	1393	3569	4688	0.7613055
A09	65507182	65511307	A09p76670.2_BraZ1	2810.5	-	3467	4050	4125	0.9818182
A09	65512505	65514808	A09p76680.2_BraZ1	1220.62	-	628	1953	2303	0.8480243
A09	65516170	65519092	A09p76690.2_BraZ1	177	+	1121	2453	2922	0.8394935
A09	65517454	65522514	A09p76700.2_BraZ1	2121	+	2200	4586	5060	0.9063241
A09	65523323	65525139	A09p76710.2_BraZ1	1380	-	428	1574	1816	0.8667401
A09	65529166	65530513	A09p76720.2_BraZ1	13662	+	1403	1347	1347	1.0000000
A09	65532428	65536181	A09p76730.2_BraZ1	1806.12	-	1775	3500	3753	0.9325873
A09	65550435	65550843	A09p76740.2_BraZ1	40.8	-	7	270	408	0.6617647
A09	65558996	65560452	A09p76750.2_BraZ1	602.679	+	59	1028	1456	0.7060440
A09	65561143	65561694	A09p76760.2_BraZ1	354	+	67	503	551	0.9128857
A09	65562080	65566700	A09p76770.2_BraZ1	2067	-	2176	4036	4620	0.8735931
A09	65566829	65566943	A09p76780.2_BraZ1	11.4	-	77	114	114	1.0000000
A09	65608615	65609290	A09p76790.2_BraZ1	67.5	+	200	585	675	0.8666667
A09	65612507	65613344	A09p76800.2_BraZ1	174	+	129	585	837	0.6989247
A09	65615260	65616679	A09p76810.2_BraZ1	891.692	-	212	1000	1419	0.7047216
A09	65619544	65623754	A09p76820.2_BraZ1	952.5	+	1274	3694	4210	0.8774347
A09	65626354	65629373	A09p76830.2_BraZ1	1321.35	+	2037	2754	3019	0.9122226
A09	65635804	65636224	A09p76840.2_BraZ1	42	+	32	274	420	0.6523809
A09	65642858	65643731	A09p76850.2_BraZ1	87.3	+	244	783	873	0.8969072
A09	65647424	65648762	A09p76860.2_BraZ1	133.8	+	213	1021	1338	0.7630792
A09	65650871	65652122	A09p76870.2_BraZ1	528	+	6	96	1251	0.0767386
A09	65654546	65659465	A09p76880.2_BraZ1	1476.15	+	3028	4881	4919	0.9922749
A09	65659821	65661664	A09p76890.2_BraZ1	1000	-	1487	1843	1843	1.0000000
A09	65661995	65662567	A09p76900.2_BraZ1	258	-	615	572	572	1.0000000
A09	65664200	65665570	A09p76910.2_BraZ1	229.279	-	1223	1370	1370	1.0000000
A09	65666376	65667536	A09p76920.2_BraZ1	600.455	-	551	1096	1160	0.9448276
A09	65668072	65670154	A09p76930.2_BraZ1	1489.72	+	927	2082	2082	1.0000000
A09	65670581	65673063	A09p76940.2_BraZ1	1328.19	-	1353	2482	2482	1.0000000
A09	65673731	65676274	A09p76950.2_BraZ1	1037.67	-	1072	2468	2543	0.9705073
A09	65676812	65676965	A09p76960.2_BraZ1	15.3	-	95	153	153	1.0000000
A09	65676972	65677302	A09p76970.2_BraZ1	33	-	50	300	330	0.9090909
A09	65678876	65686286	A09p76980.2_BraZ1	1364.46	+	3112	6109	7410	0.8244265
A09	65686682	65688299	A09p76990.2_BraZ1	161.7	-	520	1481	1617	0.9158936
A09	65689434	65689854	A09p77000.2_BraZ1	42	-	127	420	420	1.0000000
A09	65696144	65696561	A09p77010.2_BraZ1	41.7	-	177	417	417	1.0000000
A09	65697148	65698645	A09p77020.2_BraZ1	516.14	-	1028	1497	1497	1.0000000
A09	65700536	65701529	A09p77030.2_BraZ1	111	+	1116	989	993	0.9959718
A09	65707687	65710551	A09p77040.2_BraZ1	1426.62	+	2594	2864	2864	1.0000000
A09	65714216	65714561	A09p77050.2_BraZ1	34.5	-	188	345	345	1.0000000
A09	65715703	65718979	A09p77060.2_BraZ1	1147.08	-	2213	2896	3276	0.8840049
A09	65722929	65724462	A09p77070.2_BraZ1	153.3	-	60	1099	1533	0.7168950
A09	65726218	65728331	A09p77080.2_BraZ1	13664	-	631	2095	2113	0.9914813
A09	65729237	65733028	A09p77090.2_BraZ1	1416.72	-	720	3013	3791	0.7947771
A09	65737984	65739158	A09p77100.2_BraZ1	1360	-	139	1003	1174	0.8543441
A09	65740667	65741404	A09p77110.2_BraZ1	370.974	-	305	710	737	0.9633650
A09	65743171	65743880	A09p77120.2_BraZ1	525	-	59	579	709	0.8166432
A09	65748061	65750439	A09p77130.2_BraZ1	10444.5	+	1070	2194	2378	0.9226241
A09	65751279	65752641	A09p77140.2_BraZ1	285.545	-	270	1362	1362	1.0000000
A09	65754885	65758165	A09p77150.2_BraZ1	2115.27	-	2515	3193	3280	0.9734756
A09	65759113	65762095	A09p77160.2_BraZ1	704.682	-	1537	2970	2982	0.9959759
A09	65765115	65768148	A09p77170.2_BraZ1	2203.36	-	986	2894	3033	0.9541708
A09	65772118	65775325	A09p77180.2_BraZ1	1524.12	+	1452	3026	3207	0.9435610
A09	65784140	65786979	A09p77190.2_BraZ1	1335.71	-	1768	2839	2839	1.0000000
A09	65790891	65791880	A09p77200.2_BraZ1	897	-	173	687	989	0.6946411
A09	65792708	65795817	A09p77210.2_BraZ1	867.391	+	2306	3009	3109	0.9678353
A09	65796603	65807780	A09p77220.2_BraZ1	3959.62	-	2612	9185	11177	0.8217769
A09	65808928	65810095	A09p77230.2_BraZ1	116.7	-	31	571	1167	0.4892888
A09	65813821	65814982	A09p77240.2_BraZ1	116.1	-	0	0	1161	0.0000000
A09	65819570	65823220	A09p77250.2_BraZ1	2296	+	2389	3574	3650	0.9791781
A09	65823249	65823580	A09p77260.2_BraZ1	198	+	62	277	331	0.8368580
A09	65825007	65827165	A09p77270.2_BraZ1	960.333	-	1012	2118	2158	0.9814643
A09	65828554	65829715	A09p77280.2_BraZ1	116.1	-	57	611	1161	0.5262704
A09	65834636	65835809	A09p77290.2_BraZ1	117.3	-	24	352	1173	0.3000852
A09	65837036	65838823	A09p77300.2_BraZ1	1362.67	+	1778	1787	1787	1.0000000
A09	65842333	65843089	A09p77310.2_BraZ1	75.6	-	619	756	756	1.0000000
A09	65844087	65846938	A09p77320.2_BraZ1	1737.94	+	3869	2851	2851	1.0000000
A09	65847270	65851469	A09p77330.2_BraZ1	2401.81	-	2662	4115	4199	0.9799953
A09	65858497	65860375	A09p77340.2_BraZ1	187.8	-	725	1863	1878	0.9920128
A09	65861499	65863214	A09p77350.2_BraZ1	916.643	-	679	1653	1715	0.9638484
A09	65864068	65870122	A09p77360.2_BraZ1	1586.42	+	3312	6054	6054	1.0000000
A09	65872723	65874180	A09p77370.2_BraZ1	1242	+	777	1457	1457	1.0000000
A09	65877776	65881334	A09p77380.2_BraZ1	1528.86	-	1976	3539	3558	0.9946599
A09	65882213	65884225	A09p77390.2_BraZ1	947.533	+	989	1939	2012	0.9637177
A09	65885448	65891966	A09p77400.2_BraZ1	3246.34	+	3233	6314	6518	0.9687021
A09	65894169	65897210	A09p77410.2_BraZ1	2227.5	+	865	2184	3041	0.7181848
A09	65897603	65898005	A09p77420.2_BraZ1	40.2	-	72	305	402	0.7587065
A09	65900430	65900910	A09p77430.2_BraZ1	78.3871	+	174	480	480	1.0000000
A09	65901707	65903968	A09p77440.2_BraZ1	920.206	+	1003	2223	2261	0.9831933
A09	65904928	65907422	A09p77450.2_BraZ1	624.375	+	912	2494	2494	1.0000000
A09	65908361	65908788	A09p77460.2_BraZ1	39.6	-	550	427	427	1.0000000
A09	65910472	65912283	A09p77470.2_BraZ1	1136.27	+	387	1519	1811	0.8387631
A09	65913236	65913743	A09p77480.2_BraZ1	50.7	+	151	507	507	1.0000000
A09	65915043	65923283	A09p77490.2_BraZ1	2599.08	+	2357	7622	8240	0.9250000
A09	65926992	65930387	A09p77500.2_BraZ1	1450.96	+	1807	3161	3395	0.9310751
A09	65932994	65934976	A09p77510.2_BraZ1	1348.79	+	832	1942	1982	0.9798183
A09	65935557	65937868	A09p77520.2_BraZ1	1211.41	-	1133	2192	2311	0.9485071
A09	65937939	65938479	A09p77530.2_BraZ1	120	-	328	540	540	1.0000000
A09	65938543	65940120	A09p77540.2_BraZ1	1766.47	-	821	1423	1577	0.9023463
A09	65940718	65942696	A09p77550.2_BraZ1	797.143	-	537	1912	1978	0.9666330
A09	65947943	65948534	A09p77560.2_BraZ1	402	-	173	591	591	1.0000000
A09	65951140	65951326	A09p77570.2_BraZ1	18.6	+	323	186	186	1.0000000
A09	65954573	65955043	A09p77580.2_BraZ1	174	-	397	470	470	1.0000000
A09	65956739	65957522	A09p77590.2_BraZ1	333	-	653	783	783	1.0000000
A09	65960045	65963272	A09p77600.2_BraZ1	5070	+	1590	2718	3227	0.8422683
A09	65969437	65971881	A09p77610.2_BraZ1	1529.29	+	340	2092	2444	0.8559738
A09	65972270	65973934	A09p77620.2_BraZ1	942.261	-	577	1554	1664	0.9338942
A09	65975040	65975587	A09p77630.2_BraZ1	11760	+	351	547	547	1.0000000
A09	65978754	65979704	A09p77640.2_BraZ1	534	+	374	923	950	0.9715790
A09	65990423	65991476	A09p77650.2_BraZ1	511.875	+	578	1053	1053	1.0000000
A09	65992218	66003009	A09p77660.2_BraZ1	1550.25	+	6547	10199	10791	0.9451395
A09	66006098	66010445	A09p77670.2_BraZ1	1036.39	+	3057	4347	4347	1.0000000
A09	66013843	66014850	A09p77680.2_BraZ1	501	+	341	1002	1007	0.9950348
A09	66016222	66017292	A09p77690.2_BraZ1	591	-	783	1060	1070	0.9906542
A09	66021943	66022558	A09p77700.2_BraZ1	60.9	-	35	316	615	0.5138211
A09	66025037	66025265	A09p77710.2_BraZ1	22.8	+	194	228	228	1.0000000
A09	66029241	66030436	A09p77720.2_BraZ1	696.87	+	319	1195	1195	1.0000000
A09	66036691	66037351	A09p77730.2_BraZ1	66	+	265	567	660	0.8590909
A09	66039043	66041006	A09p77740.2_BraZ1	886.791	+	1395	1915	1963	0.9755476
A09	66041332	66048440	A09p77750.2_BraZ1	3465.13	-	2484	6035	7108	0.8490433
A09	66053239	66055538	A09p77760.2_BraZ1	1213.34	+	1284	2299	2299	1.0000000
A09	66055853	66056968	A09p77770.2_BraZ1	1354.5	-	589	1115	1115	1.0000000
A09	66059836	66060824	A09p77780.2_BraZ1	3648	+	110	939	988	0.9504049
A09	66063871	66070257	A09p77790.2_BraZ1	2649.86	-	4908	6386	6386	1.0000000
A09	66073643	66076208	A09p77800.2_BraZ1	256.5	-	1631	2350	2565	0.9161794
A09	66076952	66083328	A09p77810.2_BraZ1	2022.41	-	5441	6376	6376	1.0000000
A09	66085448	66088622	A09p77820.2_BraZ1	317.4	+	2741	3174	3174	1.0000000
A09	66091296	66107085	A09p77830.2_BraZ1	3016.62	-	10091	15392	15789	0.9748559
A09	66094742	66095243	A09p77840.2_BraZ1	50.1	+	69	296	501	0.5908183
A09	66112810	66114284	A09p77850.2_BraZ1	871.286	+	1404	1474	1474	1.0000000
A09	66114689	66135751	A09p77860.2_BraZ1	4598.61	-	10901	19253	21062	0.9141107
A09	66137497	66141474	A09p77870.2_BraZ1	1771.23	+	1935	3642	3977	0.9157656
A09	66142728	66145725	A09p77880.2_BraZ1	2922	-	547	2683	2997	0.8952286
A09	66155065	66157537	A09p77890.2_BraZ1	1422.33	-	1425	2370	2472	0.9587379
A09	66160479	66161175	A09p77900.2_BraZ1	69.6	+	394	696	696	1.0000000
A09	66162832	66164890	A09p77910.2_BraZ1	1508.57	+	400	1886	2058	0.9164237
A09	66166550	66167104	A09p77920.2_BraZ1	298.667	+	0	0	554	0.0000000
A09	66171554	66172944	A09p77930.2_BraZ1	611.221	+	1030	1354	1390	0.9741007
A09	66177626	66180440	A09p77940.2_BraZ1	3573.38	+	781	2313	2814	0.8219616
A09	66182410	66184711	A09p77950.2_BraZ1	1389.1	-	879	2249	2301	0.9774011
A09	66188292	66190791	A09p77960.2_BraZ1	986.133	+	1723	2182	2499	0.8731493
A09	66195671	66197163	A09p77970.2_BraZ1	720.72	+	662	1383	1492	0.9269437
A09	66197816	66198455	A09p77980.2_BraZ1	25.8	+	255	631	639	0.9874805
A09	66198908	66199606	A09p77990.2_BraZ1	495	+	249	698	698	1.0000000
A09	66202147	66205989	A09p78000.2_BraZ1	140.1	+	1829	3567	3842	0.9284227
A09	66208791	66210670	A09p78010.2_BraZ1	1098.92	-	526	1736	1879	0.9238957
A09	66211789	66212791	A09p78020.2_BraZ1	439.091	+	613	956	1002	0.9540918
A09	66218602	66220433	A09p78030.2_BraZ1	2178	+	975	1620	1831	0.8847624
A09	66222267	66224033	A09p78040.2_BraZ1	1193.35	-	1562	1766	1766	1.0000000
A09	66224716	66228375	A09p78050.2_BraZ1	3453	+	4171	3659	3659	1.0000000
A09	66229633	66232887	A09p78060.2_BraZ1	1756.81	-	681	2958	3254	0.9090350
A09	66233542	66234257	A09p78070.2_BraZ1	3162.5	-	382	715	715	1.0000000
A09	66236319	66238964	A09p78080.2_BraZ1	7227	+	1261	2596	2645	0.9814745
A09	66238964	66239234	A09p78090.2_BraZ1	171	+	22	207	270	0.7666667
A09	66241144	66241858	A09p78100.2_BraZ1	651	-	265	714	714	1.0000000
A09	66242485	66242665	A09p78110.2_BraZ1	18	+	192	180	180	1.0000000
A09	66242797	66243374	A09p78120.2_BraZ1	2541	+	169	577	577	1.0000000
A09	66244936	66246116	A09p78130.2_BraZ1	984	-	321	1103	1180	0.9347458
A09	66252895	66255008	A09p78140.2_BraZ1	1132.86	-	880	2020	2113	0.9559867
A09	66261180	66261876	A09p78150.2_BraZ1	69.6	+	317	696	696	1.0000000
A09	66263661	66265945	A09p78160.2_BraZ1	960.647	-	888	1490	2284	0.6523643
A09	66266630	66267311	A09p78170.2_BraZ1	534	+	362	680	681	0.9985316
A09	66268939	66272753	A09p78180.2_BraZ1	1051.55	+	1666	3634	3814	0.9528055
A09	66273070	66273732	A09p78190.2_BraZ1	260	-	166	428	662	0.6465257
A09	66274602	66275994	A09p78200.2_BraZ1	1206.11	-	12	193	1392	0.1386494
A09	66277855	66278677	A09p78210.2_BraZ1	422.727	-	185	634	822	0.7712895
A09	66279734	66281827	A09p78220.2_BraZ1	1494	+	411	1356	2093	0.6478739
A09	66285977	66287911	A09p78230.2_BraZ1	1461	+	179	626	1934	0.3236815
A09	66290093	66290564	A09p78240.2_BraZ1	47.1	+	4	111	471	0.2356688
A09	66291856	66292210	A09p78250.2_BraZ1	35.4	+	1	14	354	0.0395480
A09	66292778	66296029	A09p78260.2_BraZ1	580	+	761	2394	3251	0.7363888
A09	66301216	66301330	A09p78270.2_BraZ1	11.4	-	93	114	114	1.0000000
A09	66301627	66306625	A09p78280.2_BraZ1	2231.89	-	1187	2943	4998	0.5888355
A09	66307679	66310376	A09p78290.2_BraZ1	2614.87	+	330	1834	2697	0.6800148
A09	66310646	66311615	A09p78300.2_BraZ1	96.9	-	144	738	969	0.7616099
A09	66313689	66314591	A09p78310.2_BraZ1	618	-	686	858	902	0.9512195
A09	66317231	66321028	A09p78320.2_BraZ1	1429.48	+	1430	3649	3797	0.9610218
A09	66321702	66324239	A09p78330.2_BraZ1	1748.84	-	557	2004	2537	0.7899094
A09	66325365	66327662	A09p78340.2_BraZ1	1152.98	-	611	2188	2297	0.9525468
A09	66328099	66328968	A09p78350.2_BraZ1	717	-	126	833	869	0.9585730
A09	66330115	66332480	A09p78360.2_BraZ1	1581	-	2156	2289	2365	0.9678647
A09	66333990	66337497	A09p78370.2_BraZ1	1356.24	-	1523	3456	3507	0.9854577
A09	66340425	66343276	A09p78380.2_BraZ1	1340.74	-	706	2584	2851	0.9063486
A09	66346718	66350448	A09p78390.2_BraZ1	1996.72	-	2338	3504	3730	0.9394102
A09	66352037	66352536	A09p78400.2_BraZ1	429	-	408	499	499	1.0000000
A09	66352987	66357944	A09p78410.2_BraZ1	1613.57	-	1755	4709	4957	0.9499698
A09	66359760	66361304	A09p78420.2_BraZ1	358.7	-	563	1512	1544	0.9792746
A09	66361918	66369973	A09p78430.2_BraZ1	3255.12	+	4448	7478	8055	0.9283675
A09	66370737	66372319	A09p78440.2_BraZ1	447.122	-	1499	1582	1582	1.0000000
A09	66373427	66375677	A09p78450.2_BraZ1	995.143	+	1111	2072	2250	0.9208889
A09	66376166	66387343	A09p78460.2_BraZ1	3599.23	-	5242	9654	11177	0.8637381
A09	66399511	66400647	A09p78470.2_BraZ1	654.9	+	212	803	1136	0.7068662
A09	66403036	66405836	A09p78480.2_BraZ1	1205.6	+	1371	2601	2800	0.9289286
A09	66407177	66407591	A09p78490.2_BraZ1	264	+	271	414	414	1.0000000
A09	66411997	66413899	A09p78500.2_BraZ1	1007.06	+	229	1669	1902	0.8774974
A09	66415070	66416687	A09p78510.2_BraZ1	161.7	+	483	1593	1617	0.9851577
A09	66417601	66420771	A09p78520.2_BraZ1	1452.75	-	2313	2959	3170	0.9334385
A09	66422130	66422822	A09p78530.2_BraZ1	375	+	775	692	692	1.0000000
A09	66423567	66424613	A09p78540.2_BraZ1	759.8	-	674	1046	1046	1.0000000
A09	66428933	66430559	A09p78550.2_BraZ1	1197.68	+	612	1585	1626	0.9747847
A09	66431936	66433112	A09p78560.2_BraZ1	690	-	542	1145	1176	0.9736394
A09	66436461	66440241	A09p78570.2_BraZ1	560.52	-	1242	3665	3780	0.9695767
A09	66441679	66443752	A09p78580.2_BraZ1	1134.61	-	535	1985	2073	0.9575495
A09	66444467	66447400	A09p78590.2_BraZ1	1078.13	+	2562	2928	2933	0.9982952
A09	66448131	66454482	A09p78600.2_BraZ1	2483.74	-	2051	5786	6351	0.9110376
A09	66455417	66456527	A09p78610.2_BraZ1	459	-	309	1036	1110	0.9333333
A09	66457147	66457766	A09p78620.2_BraZ1	432.081	+	439	619	619	1.0000000
A09	66458277	66464008	A09p78630.2_BraZ1	1265.22	-	2863	5207	5731	0.9085674
A09	66468187	66473645	A09p78640.2_BraZ1	1380.95	+	1463	4799	5458	0.8792598
A09	66475807	66500687	A09p78650.2_BraZ1	1762.72	+	8906	20626	24880	0.8290193
A09	66496025	66497455	A09p78660.2_BraZ1	716.609	+	457	1244	1430	0.8699301
A09	66502045	66504703	A09p78670.2_BraZ1	1128.45	+	1435	2658	2658	1.0000000
A09	66507490	66507726	A09p78680.2_BraZ1	21.6	+	496	236	236	1.0000000
A09	66510336	66510960	A09p78690.2_BraZ1	62.4	+	119	589	624	0.9439102
A09	66511702	66518453	A09p78700.2_BraZ1	4322.68	+	726	4676	6751	0.6926381
A09	66519349	66522722	A09p78710.2_BraZ1	2108.48	+	471	2493	3373	0.7391046
A09	66523450	66527360	A09p78720.2_BraZ1	2339.43	+	1735	3779	3910	0.9664962
A09	66530157	66532127	A09p78730.2_BraZ1	1417.3	+	726	1756	1970	0.8913705
A09	66535310	66537170	A09p78740.2_BraZ1	55252.5	+	407	1681	1860	0.9037634
A09	66538168	66548147	A09p78750.2_BraZ1	3991.02	+	2841	8468	9979	0.8485820
A09	66550497	66551391	A09p78760.2_BraZ1	807	+	112	703	894	0.7863535
A09	66551902	66557556	A09p78770.2_BraZ1	2370.38	-	5065	5629	5654	0.9955783
A09	66558468	66559441	A09p78780.2_BraZ1	549	+	866	964	973	0.9907503
A09	66560165	66561603	A09p78790.2_BraZ1	73.5	-	210	1434	1438	0.9972184
A09	66563613	66565068	A09p78800.2_BraZ1	135	-	483	1455	1455	1.0000000
A09	66566834	66573525	A09p78810.2_BraZ1	2970.94	-	3241	6654	6691	0.9944702
A09	66575243	66577822	A09p78820.2_BraZ1	624	-	423	2269	2579	0.8797984
A09	66581469	66583268	A09p78830.2_BraZ1	633.36	-	626	1617	1799	0.8988327
A09	66584554	66586498	A09p78840.2_BraZ1	1026.72	+	1213	1758	1944	0.9043210
A09	66588270	66590802	A09p78850.2_BraZ1	1303.8	+	968	2458	2532	0.9707741
A09	66591244	66591995	A09p78860.2_BraZ1	1008	-	931	751	751	1.0000000
A09	66592726	66592966	A09p78870.2_BraZ1	24	+	79	240	240	1.0000000
A09	66593562	66597495	A09p78880.2_BraZ1	15662.4	-	1259	3048	3933	0.7749809
A09	66599415	66599987	A09p78890.2_BraZ1	660	+	18	315	572	0.5506993
A09	66600510	66602113	A09p78900.2_BraZ1	1087.73	-	97	1482	1603	0.9245166
A09	66603150	66603628	A09p78910.2_BraZ1	105	-	152	478	478	1.0000000
A09	66603830	66604430	A09p78920.2_BraZ1	15130.5	-	32	416	600	0.6933333
A09	66605526	66605883	A09p78930.2_BraZ1	35.7	+	38	357	357	1.0000000
A09	66606495	66607287	A09p78940.2_BraZ1	2484	+	270	779	792	0.9835858
A09	66611106	66612106	A09p78950.2_BraZ1	487.667	+	201	921	1000	0.9210000
A09	66617724	66618938	A09p78960.2_BraZ1	954	+	376	1179	1214	0.9711697
A09	66621129	66623526	A09p78970.2_BraZ1	1519.96	+	278	1640	2397	0.6841885
A09	66624726	66625032	A09p78980.2_BraZ1	138	+	272	306	306	1.0000000
A09	66625589	66627702	A09p78990.2_BraZ1	1683	+	327	1489	2113	0.7046853
A09	66629861	66631878	A09p79000.2_BraZ1	1190.48	+	207	1306	2017	0.6474963
A09	66632085	66636030	A09p79010.2_BraZ1	2202.17	-	543	1937	3945	0.4910013
A09	66636459	66636798	A09p79020.2_BraZ1	33.9	+	50	296	339	0.8731564
A09	66638095	66641926	A09p79030.2_BraZ1	3368.06	-	1188	3714	3831	0.9694597
A09	66645869	66646494	A09p79040.2_BraZ1	198	-	628	625	625	1.0000000
A09	66647228	66649135	A09p79050.2_BraZ1	10936.5	-	1146	1773	1907	0.9297326
A09	66650500	66652507	A09p79060.2_BraZ1	200.7	+	1452	1944	2007	0.9686099
A09	66654534	66656613	A09p79070.2_BraZ1	207.9	+	713	1896	2079	0.9119769
A09	66657174	66661090	A09p79080.2_BraZ1	2096.18	-	2913	3903	3916	0.9966803
A09	66664479	66664800	A09p79090.2_BraZ1	32.1	+	3	86	321	0.2679128
A09	66668092	66671074	A09p79100.2_BraZ1	955.592	+	3204	2982	2982	1.0000000
A09	66671441	66672089	A09p79110.2_BraZ1	64.8	-	348	648	648	1.0000000
A09	66672980	66674162	A09p79120.2_BraZ1	704.464	+	368	919	1182	0.7774957
A09	66686094	66687832	A09p79130.2_BraZ1	1282.5	+	1477	1738	1738	1.0000000
A09	66689207	66691554	A09p79140.2_BraZ1	136.2	-	0	0	2347	0.0000000
A09	66693594	66697285	A09p79150.2_BraZ1	719.086	-	3421	3691	3691	1.0000000
A09	66697637	66707912	A09p79160.2_BraZ1	2245.66	-	7604	9827	10275	0.9563990
A09	66707873	66709054	A09p79170.2_BraZ1	369.6	-	1059	1181	1181	1.0000000
A09	66709587	66710604	A09p79180.2_BraZ1	101.7	+	139	1012	1017	0.9950836
A09	66711992	66712388	A09p79190.2_BraZ1	39.6	+	694	396	396	1.0000000
A09	66713652	66715424	A09p79200.2_BraZ1	1106.76	+	2571	1772	1772	1.0000000
A09	66715968	66718601	A09p79210.2_BraZ1	9300	-	1556	2513	2633	0.9544246
A09	66723933	66724095	A09p79220.2_BraZ1	16.2	+	62	162	162	1.0000000
A09	66725022	66725391	A09p79230.2_BraZ1	207	-	7	290	369	0.7859079
A09	66726752	66728447	A09p79240.2_BraZ1	558	-	80	1063	1695	0.6271386
A09	66737167	66738036	A09p79250.2_BraZ1	717	-	8	196	869	0.2255466
A09	66739635	66740424	A09p79260.2_BraZ1	485	-	1194	789	789	1.0000000
A09	66742428	66743853	A09p79270.2_BraZ1	142.5	-	613	1425	1425	1.0000000
A09	66745186	66747198	A09p79280.2_BraZ1	1386	+	1710	2012	2012	1.0000000
A09	66747564	66748822	A09p79290.2_BraZ1	617.312	-	1411	1258	1258	1.0000000
A09	66752587	66756153	A09p79300.2_BraZ1	2785.07	+	2545	3548	3566	0.9949523
A09	66757301	66766894	A09p79310.2_BraZ1	1333.59	+	6841	9579	9593	0.9985406
A09	66773252	66773849	A09p79320.2_BraZ1	59.7	+	30	319	597	0.5343384
A09	66776627	66778244	A09p79330.2_BraZ1	727.5	-	979	1571	1617	0.9715523
A09	66778687	66780484	A09p79340.2_BraZ1	11131.5	-	714	1716	1797	0.9549249
A09	66789692	66790709	A09p79350.2_BraZ1	742.5	-	304	582	1017	0.5722714
A09	66792235	66792712	A09p79360.2_BraZ1	47.7	-	108	411	477	0.8616352
A09	66793423	66794000	A09p79370.2_BraZ1	495	-	440	520	577	0.9012132
A09	66796313	66797219	A09p79380.2_BraZ1	90.6	+	309	874	906	0.9646799
A09	66797865	66798501	A09p79390.2_BraZ1	210	-	286	636	636	1.0000000
A09	66798907	66800544	A09p79400.2_BraZ1	1067.5	-	972	1637	1637	1.0000000
A09	66801022	66803062	A09p79410.2_BraZ1	864	+	1627	2040	2040	1.0000000
A09	66803872	66806160	A09p79420.2_BraZ1	1029.35	+	403	1958	2288	0.8557692
A09	66810554	66812415	A09p79430.2_BraZ1	958.5	-	1314	1831	1861	0.9838796
A09	66814341	66816205	A09p79440.2_BraZ1	959.524	-	671	1821	1864	0.9769313
A09	66817148	66817448	A09p79450.2_BraZ1	30	-	118	300	300	1.0000000
A09	66819513	66822610	A09p79460.2_BraZ1	1610.7	+	2152	3060	3097	0.9880530
A09	66822885	66824036	A09p79470.2_BraZ1	608.88	-	1024	1151	1151	1.0000000
A09	66824481	66827295	A09p79480.2_BraZ1	1636.36	-	3443	2814	2814	1.0000000
A09	66828454	66831274	A09p79490.2_BraZ1	1337.89	-	1712	2815	2820	0.9982269
A09	66831993	66834081	A09p79500.2_BraZ1	208.8	-	951	2041	2088	0.9774904
A09	66835276	66841258	A09p79510.2_BraZ1	2444.21	+	1706	4907	5982	0.8202942
A09	66842231	66843798	A09p79520.2_BraZ1	957.185	+	1455	1380	1567	0.8806637
A09	66844123	66845547	A09p79530.2_BraZ1	765.6	-	362	1316	1424	0.9241573
A09	66846190	66847965	A09p79540.2_BraZ1	1056.68	-	709	820	1775	0.4619718
A09	66849266	66850906	A09p79550.2_BraZ1	3568.5	-	607	1252	1640	0.7634146
A09	66851939	66853738	A09p79560.2_BraZ1	332.182	-	202	865	1799	0.4808227
A09	66854705	66861649	A09p79570.2_BraZ1	2405.79	+	3171	6423	6944	0.9249712
A09	66861982	66863476	A09p79580.2_BraZ1	149.4	+	459	1397	1494	0.9350736
A09	66864187	66870476	A09p79590.2_BraZ1	1350	+	1364	3632	6289	0.5775163
A09	66871996	66872510	A09p79600.2_BraZ1	162	+	585	514	514	1.0000000
A09	66873391	66884359	A09p79610.2_BraZ1	5285.85	-	4029	8568	10968	0.7811816
A09	66887283	66888387	A09p79620.2_BraZ1	110.4	-	114	686	1104	0.6213768
A09	66888922	66889816	A09p79630.2_BraZ1	89.4	+	489	892	894	0.9977629
A09	66890219	66890585	A09p79640.2_BraZ1	174	+	71	297	366	0.8114754
A09	66890866	66891487	A09p79650.2_BraZ1	62.1	-	978	621	621	1.0000000
A09	66892204	66893041	A09p79660.2_BraZ1	672	+	468	786	837	0.9390681
A09	66893496	66893988	A09p79670.2_BraZ1	49.2	+	8	115	492	0.2337398
A09	66894867	66895638	A09p79680.2_BraZ1	77.1	-	141	681	771	0.8832685
A09	66899970	66900087	A09p79690.2_BraZ1	11.7	-	3	25	117	0.2136752
A09	66900863	66902930	A09p79700.2_BraZ1	867	+	262	1108	2067	0.5360426
A09	66903435	66904188	A09p79710.2_BraZ1	465.075	-	1116	753	753	1.0000000
A09	66904416	66908611	A09p79720.2_BraZ1	1113.07	+	3729	4148	4195	0.9887962
A09	66909725	66911990	A09p79730.2_BraZ1	1941.69	-	518	1580	2265	0.6975718
A09	66916383	66918279	A09p79740.2_BraZ1	1127.12	-	1168	1880	1896	0.9915612
A09	66920937	66921624	A09p79750.2_BraZ1	68.7	-	64	450	687	0.6550218
A09	66928740	66930489	A09p79760.2_BraZ1	174.9	+	1448	1698	1749	0.9708405
A09	66931636	66931849	A09p79770.2_BraZ1	21.3	+	11	157	213	0.7370892
A09	66933958	66935898	A09p79780.2_BraZ1	880.406	+	2168	1915	1940	0.9871134
A09	66936139	66937690	A09p79790.2_BraZ1	885.635	-	911	1537	1551	0.9909736
A09	66941521	66945690	A09p79800.2_BraZ1	277.846	-	595	2161	4169	0.5183497
A09	66943697	66944876	A09p79810.2_BraZ1	1617	+	40	199	1179	0.1687871
A09	66947152	66950980	A09p79820.2_BraZ1	765.846	-	754	3017	3828	0.7881400
A09	66964563	66965509	A09p79830.2_BraZ1	705	+	777	946	946	1.0000000
A09	66965940	66966916	A09p79840.2_BraZ1	324.8	-	1484	976	976	1.0000000
A09	66968769	66969050	A09p79850.2_BraZ1	24.9	-	152	265	281	0.9430605
A09	66971153	66976311	A09p79860.2_BraZ1	2478.95	+	2217	4346	5158	0.8425747
A09	66977449	66981852	A09p79870.2_BraZ1	1125.53	+	3721	4344	4403	0.9866000
A09	66983017	66988535	A09p79880.2_BraZ1	2548.47	+	1564	5387	5518	0.9762595
A09	66988817	66993684	A09p79890.2_BraZ1	3346.75	-	537	3083	4867	0.6334498
A09	66994702	67011298	A09p79900.2_BraZ1	2773.85	-	8310	14629	16596	0.8814775
A09	66999406	66999931	A09p79910.2_BraZ1	438	+	254	484	525	0.9219047
A09	67001340	67004460	A09p79920.2_BraZ1	1217.5	+	1179	2600	3120	0.8333333
A09	67011880	67013247	A09p79930.2_BraZ1	168	-	477	1036	1367	0.7578639
A09	67019351	67020110	A09p79940.2_BraZ1	5175	-	393	745	759	0.9815547
A09	67020583	67021458	A09p79950.2_BraZ1	516	+	399	780	875	0.8914286
A09	67022432	67027790	A09p79960.2_BraZ1	2508.9	-	298	2599	5358	0.4850691
A09	67028552	67029338	A09p79970.2_BraZ1	78.6	+	193	786	786	1.0000000
A09	67030397	67032221	A09p79980.2_BraZ1	860.853	-	960	1712	1824	0.9385965
A09	67032998	67033904	A09p79990.2_BraZ1	90.6	+	213	788	906	0.8697572
A09	67034505	67036617	A09p80000.2_BraZ1	1749	-	1068	1796	2112	0.8503788
A09	67040777	67043339	A09p80010.2_BraZ1	1149.75	+	603	2105	2562	0.8216237
A09	67044688	67045206	A09p80020.2_BraZ1	142.8	+	64	418	518	0.8069498
A09	67045649	67046781	A09p80030.2_BraZ1	588.571	-	432	1076	1132	0.9505301
A09	67047656	67048094	A09p80040.2_BraZ1	339	+	51	210	438	0.4794520
A09	67057143	67057883	A09p80050.2_BraZ1	68.4	+	103	615	740	0.8310811
A09	67068111	67071041	A09p80060.2_BraZ1	1251	+	1101	2744	2930	0.9365188
A09	67073202	67075377	A09p80070.2_BraZ1	1208.03	-	1605	2175	2175	1.0000000
A09	67075864	67079004	A09p80080.2_BraZ1	1165.96	+	3488	3140	3140	1.0000000
A09	67079483	67081653	A09p80090.2_BraZ1	1632.7	-	876	1864	2170	0.8589862
A09	67084388	67089033	A09p80100.2_BraZ1	1436.83	+	2924	4417	4645	0.9509150
A09	67089790	67163801	A09p80110.2_BraZ1	461.1	+	31337	54050	74011	0.7302969
A09	67140202	67141595	A09p80120.2_BraZ1	3763.17	+	350	993	1393	0.7128500
A09	67142351	67144187	A09p80130.2_BraZ1	975	-	316	1172	1836	0.6383442
A09	67151894	67153321	A09p80140.2_BraZ1	6762	-	230	1219	1427	0.8542396
A09	67164032	67167062	A09p80150.2_BraZ1	2091	-	500	2711	3030	0.8947195
A09	67169027	67170265	A09p80160.2_BraZ1	675	+	771	1238	1238	1.0000000
A09	67170998	67173800	A09p80170.2_BraZ1	977.5	+	1825	2720	2802	0.9707352
A09	67173741	67174082	A09p80180.2_BraZ1	77.625	+	111	341	341	1.0000000
A09	67177591	67178716	A09p80190.2_BraZ1	112.5	+	4317	1125	1125	1.0000000
A09	67182401	67182635	A09p80200.2_BraZ1	23.1	+	277	234	234	1.0000000
A09	67183734	67186206	A09p80210.2_BraZ1	247.2	+	1010	2240	2472	0.9061489
A09	67186996	67187411	A09p80220.2_BraZ1	384	-	0	0	415	0.0000000
A09	67188113	67192601	A09p80230.2_BraZ1	2002.67	+	899	2743	4488	0.6111854
A09	67197114	67199501	A09p80240.2_BraZ1	1434.21	+	463	2191	2387	0.9178886
A09	67200855	67201431	A09p80250.2_BraZ1	57.6	+	494	576	576	1.0000000
A09	67205858	67206311	A09p80260.2_BraZ1	45.3	+	718	421	453	0.9293598
A09	67213741	67215593	A09p80270.2_BraZ1	1224	+	118	1341	1852	0.7240821
A09	67216677	67219416	A09p80280.2_BraZ1	2652	+	787	2281	2739	0.8327857
A09	67221191	67222467	A09p80290.2_BraZ1	663	+	69	855	1276	0.6700627
A09	67227281	67227631	A09p80300.2_BraZ1	20.4	+	22	198	350	0.5657143
A09	67230420	67234024	A09p80310.2_BraZ1	1296	+	137	1732	3604	0.4805771
A09	67236573	67237509	A09p80320.2_BraZ1	380.714	-	123	677	936	0.7232906
A09	67238336	67238990	A09p80330.2_BraZ1	65.4	+	112	633	654	0.9678899
A09	67240658	67241072	A09p80340.2_BraZ1	41.4	+	36	177	414	0.4275362
A09	67241395	67242064	A09p80350.2_BraZ1	7848	+	93	532	669	0.7952167
A09	67244027	67245737	A09p80360.2_BraZ1	1311	-	114	1054	1710	0.6163743
A09	67253483	67255576	A09p80370.2_BraZ1	930.037	+	2983	2093	2093	1.0000000
A09	67255823	67259823	A09p80380.2_BraZ1	1314.23	-	2472	3643	4000	0.9107500
A09	67267723	67269897	A09p80390.2_BraZ1	1782	-	725	1576	2174	0.7249310
A09	67273910	67274174	A09p80400.2_BraZ1	26.4	-	28	264	264	1.0000000
A09	67276521	67277801	A09p80410.2_BraZ1	977.826	+	245	1121	1280	0.8757812
A09	67278908	67279813	A09p80420.2_BraZ1	411	-	103	644	905	0.7116022
A09	67281093	67285190	A09p80430.2_BraZ1	2966.73	+	1624	3521	4097	0.8594093
A09	67286122	67287124	A09p80440.2_BraZ1	115.385	-	28	577	1002	0.5758483
A09	67288348	67289047	A09p80450.2_BraZ1	609	-	14	234	699	0.3347639
A09	67294113	67295736	A09p80460.2_BraZ1	861	-	1573	1534	1623	0.9451632
A09	67299389	67299626	A09p80470.2_BraZ1	23.7	-	0	0	237	0.0000000
A09	67301227	67303974	A09p80480.2_BraZ1	904.5	-	1095	2564	2747	0.9333819
A09	67307626	67308037	A09p80490.2_BraZ1	41.1	-	0	0	411	0.0000000
A09	67315046	67318482	A09p80500.2_BraZ1	1710	+	6118	3188	3436	0.9278231
A09	67322190	67322360	A09p80510.2_BraZ1	13.2	-	0	0	170	0.0000000
A09	67325242	67328676	A09p80520.2_BraZ1	2066.67	+	4	21	3434	0.0061153
A09	67329550	67329745	A09p80530.2_BraZ1	144	+	0	0	195	0.0000000
A09	67336447	67337116	A09p80540.2_BraZ1	576	-	4	194	669	0.2899851
A09	67352236	67352406	A09p80550.2_BraZ1	13.2	-	0	0	170	0.0000000
A09	67355289	67358726	A09p80560.2_BraZ1	2066.67	+	12	261	3437	0.0759383
A09	67359601	67359796	A09p80570.2_BraZ1	144	+	1	15	195	0.0769231
A09	67365529	67370106	A09p80580.2_BraZ1	2730.09	+	1295	3993	4577	0.8724055
A09	67370967	67371922	A09p80590.2_BraZ1	338.8	+	366	838	955	0.8774869
A09	67374092	67376006	A09p80600.2_BraZ1	640.159	-	332	1182	1914	0.6175548
A09	67383050	67384067	A09p80610.2_BraZ1	2534	+	250	1010	1017	0.9931170
A09	67384487	67389048	A09p80620.2_BraZ1	3179.75	-	3429	4322	4561	0.9475992
A09	67390264	67390489	A09p80630.2_BraZ1	22.5	+	224	225	225	1.0000000
A09	67390953	67392344	A09p80640.2_BraZ1	19669.5	-	90	1090	1391	0.7836089
A09	67393850	67394366	A09p80650.2_BraZ1	342	-	57	466	516	0.9031008
A09	67402822	67404863	A09p80660.2_BraZ1	1111.84	-	568	1806	2041	0.8848603
A09	67405674	67413727	A09p80670.2_BraZ1	3783.72	-	3255	6776	8053	0.8414255
A09	67416720	67419678	A09p80680.2_BraZ1	295.8	+	1124	2710	2958	0.9161596
A09	67420778	67424418	A09p80690.2_BraZ1	1975.56	+	2256	3548	3640	0.9747252
A09	67425039	67426680	A09p80700.2_BraZ1	861.6	-	131	1402	1641	0.8543571
A09	67427064	67429382	A09p80710.2_BraZ1	1968	+	1000	2044	2318	0.8817946
A09	67431714	67433378	A09p80720.2_BraZ1	816	+	189	1028	1664	0.6177884
A09	67433606	67438851	A09p80730.2_BraZ1	2838.38	-	2975	5111	5245	0.9744518
A09	67439293	67443656	A09p80740.2_BraZ1	1806.77	+	676	3626	4363	0.8310795
A09	67445993	67446461	A09p80750.2_BraZ1	46.8	+	37	60	468	0.1282051
A09	67447726	67448602	A09p80760.2_BraZ1	488.857	+	94	793	876	0.9052511
A09	67449356	67451729	A09p80770.2_BraZ1	1274.06	+	912	2054	2373	0.8655710
A09	67452503	67455237	A09p80780.2_BraZ1	914	-	1306	2417	2734	0.8840527
A09	67457233	67463049	A09p80790.2_BraZ1	1750.88	-	2210	5114	5816	0.8792985
A09	67461625	67462176	A09p80800.2_BraZ1	246	-	90	340	551	0.6170599
A09	67464191	67464741	A09p80810.2_BraZ1	246	-	81	340	550	0.6181818
A09	67474728	67475274	A09p80820.2_BraZ1	252	-	209	546	546	1.0000000
A09	67475994	67477723	A09p80830.2_BraZ1	1293.4	-	280	1469	1729	0.8496240
A09	67478690	67480266	A09p80840.2_BraZ1	824.307	+	1278	1571	1576	0.9968274
A09	67482211	67482676	A09p80850.2_BraZ1	46.5	+	208	465	465	1.0000000
A09	67484983	67485990	A09p80860.2_BraZ1	228.583	-	773	1007	1007	1.0000000
A09	67491540	67493679	A09p80870.2_BraZ1	1420.39	+	171	1534	2139	0.7171575
A09	67495431	67498797	A09p80880.2_BraZ1	1857.95	+	2922	3358	3366	0.9976233
A09	67499616	67501231	A09p80890.2_BraZ1	882.955	+	737	1544	1615	0.9560372
A09	67501850	67509750	A09p80900.2_BraZ1	3953.75	-	4362	7337	7900	0.9287342
A09	67512733	67513243	A09p80910.2_BraZ1	51	+	112	325	510	0.6372549
A09	67513819	67515926	A09p80920.2_BraZ1	1120.62	-	1072	1949	2107	0.9250119
A09	67516154	67518135	A09p80930.2_BraZ1	695.625	+	1217	1970	1981	0.9944472
A09	67518759	67519092	A09p80940.2_BraZ1	33.3	+	114	223	333	0.6696697
A09	67519437	67523345	A09p80950.2_BraZ1	798.72	+	3306	3790	3908	0.9698055
A09	67524592	67526397	A09p80960.2_BraZ1	1070.79	+	1956	1805	1805	1.0000000
A09	67527889	67528177	A09p80970.2_BraZ1	28.8	+	0	0	288	0.0000000
A09	67529097	67529866	A09p80980.2_BraZ1	516	+	912	769	769	1.0000000
A09	67530062	67533240	A09p80990.2_BraZ1	1317.39	-	2284	3035	3178	0.9550031
A09	67534393	67536788	A09p81000.2_BraZ1	697.232	+	1597	2375	2395	0.9916493
A09	67538737	67540042	A09p81010.2_BraZ1	130.5	+	1095	1305	1305	1.0000000
A09	67540298	67540543	A09p81020.2_BraZ1	144	-	256	245	245	1.0000000
A09	67541075	67542201	A09p81030.2_BraZ1	405	+	217	1068	1126	0.9484902
A09	67541265	67542745	A09p81040.2_BraZ1	792	+	263	1303	1480	0.8804054
A09	67542936	67549512	A09p81050.2_BraZ1	2950.09	-	2320	6235	6576	0.9481448
A09	67553013	67557914	A09p81060.2_BraZ1	4536.36	+	848	4074	4901	0.8312590
A09	67561786	67575316	A09p81070.2_BraZ1	8407	+	302	3420	13530	0.2527716
A09	67576112	67577701	A09p81080.2_BraZ1	782.073	+	137	1208	1589	0.7602265
A09	67578029	67580379	A09p81090.2_BraZ1	11214	-	670	1697	2350	0.7221277
A09	67582484	67583588	A09p81100.2_BraZ1	110.4	-	363	975	1104	0.8831522
A09	67587774	67588083	A09p81110.2_BraZ1	30.9	+	21	205	309	0.6634304
A09	67589091	67592485	A09p81120.2_BraZ1	1537.59	-	1860	3367	3394	0.9920448
A09	67593784	67602477	A09p81130.2_BraZ1	3944.61	+	3696	7787	8693	0.8957782
A09	67604545	67607312	A09p81140.2_BraZ1	1976.62	+	553	1294	2767	0.4676545
A09	67609351	67610952	A09p81150.2_BraZ1	666	-	1	127	1601	0.0793254
A09	67616306	67617696	A09p81160.2_BraZ1	1026	+	191	1048	1390	0.7539569
A09	67619595	67620263	A09p81170.2_BraZ1	321	-	271	668	668	1.0000000
A09	67622761	67625717	A09p81180.2_BraZ1	1460.55	+	2102	2956	2956	1.0000000
A09	67626171	67626633	A09p81190.2_BraZ1	46.2	-	255	462	462	1.0000000
A09	67632634	67638463	A09p81200.2_BraZ1	1144.28	+	1915	4154	5829	0.7126437
A09	67640868	67643263	A09p81210.2_BraZ1	1617.75	-	620	1212	2395	0.5060543
A09	67644212	67647146	A09p81220.2_BraZ1	1215.36	+	392	1772	2934	0.6039537
A09	67647633	67650634	A09p81230.2_BraZ1	2081.27	-	795	2226	3001	0.7417527
A09	67651418	67653948	A09p81240.2_BraZ1	1377	-	1281	2455	2530	0.9703557
A09	67655336	67656666	A09p81250.2_BraZ1	756	+	195	1120	1330	0.8421053
A09	67658819	67660129	A09p81260.2_BraZ1	440	-	1039	1067	1310	0.8145038
A09	67663255	67671176	A09p81270.2_BraZ1	2475.17	+	8079	6748	7921	0.8519126
A09	67671254	67674680	A09p81280.2_BraZ1	1787.5	-	3045	3417	3426	0.9973730
A09	67674970	67676764	A09p81290.2_BraZ1	841.067	-	1311	1794	1794	1.0000000
A09	67680214	67680769	A09p81300.2_BraZ1	294	+	645	555	555	1.0000000
A09	67681116	67681722	A09p81310.2_BraZ1	60.6	-	96	500	606	0.8250825
A09	67683582	67686377	A09p81320.2_BraZ1	1390.65	+	435	2192	2795	0.7842576
A09	67687808	67689442	A09p81330.2_BraZ1	1257	+	54	924	1634	0.5654835
A09	67691074	67692055	A09p81340.2_BraZ1	561	+	344	981	981	1.0000000
A09	67693133	67694432	A09p81350.2_BraZ1	705.714	-	847	1299	1299	1.0000000
A09	67694936	67696965	A09p81360.2_BraZ1	780.242	+	1632	2029	2029	1.0000000
A09	67697532	67698627	A09p81370.2_BraZ1	109.5	-	530	1041	1095	0.9506849
A09	67701542	67702082	A09p81380.2_BraZ1	54	+	237	422	540	0.7814815
A09	67703968	67706245	A09p81390.2_BraZ1	2058	+	1473	2179	2277	0.9569609
A09	67708907	67713122	A09p81400.2_BraZ1	1842.6	-	656	3319	4215	0.7874259
A09	67717825	67717945	A09p81410.2_BraZ1	12	+	0	0	120	0.0000000
A09	67718343	67720554	A09p81420.2_BraZ1	1439.9	+	27	344	2211	0.1555857
A09	67721288	67726874	A09p81430.2_BraZ1	700.174	-	3428	5081	5586	0.9095954
A09	67723108	67724068	A09p81440.2_BraZ1	96	-	411	960	960	1.0000000
A09	67726422	67726806	A09p81450.2_BraZ1	318	-	614	384	384	1.0000000
A09	67727151	67727478	A09p81460.2_BraZ1	32.7	+	0	0	327	0.0000000
A09	67729020	67731340	A09p81470.2_BraZ1	573.222	+	1033	1741	2320	0.7504311
A09	67735957	67741268	A09p81480.2_BraZ1	1312.63	+	410	3074	5311	0.5787987
A09	67746957	67747146	A09p81490.2_BraZ1	18.9	-	0	0	189	0.0000000
A09	67750398	67750912	A09p81500.2_BraZ1	45	+	17	162	514	0.3151751
A09	67751489	67752391	A09p81510.2_BraZ1	541.859	+	227	566	902	0.6274945
A09	67752572	67754006	A09p81520.2_BraZ1	4371	-	788	1270	1434	0.8856346
A09	67754636	67755056	A09p81530.2_BraZ1	42	+	232	415	420	0.9880952
A09	67757903	67769860	A09p81540.2_BraZ1	2028.69	+	10365	11957	11957	1.0000000
A09	67760432	67760906	A09p81550.2_BraZ1	375	-	514	474	474	1.0000000
A09	67772321	67773152	A09p81560.2_BraZ1	632.571	-	15	530	831	0.6377858
A09	67775430	67775643	A09p81570.2_BraZ1	21.3	+	102	213	213	1.0000000
A09	67775785	67776041	A09p81580.2_BraZ1	195	-	6	90	256	0.3515625
A09	67778443	67781037	A09p81590.2_BraZ1	563.062	+	1357	2578	2594	0.9938319
A09	67781404	67782373	A09p81600.2_BraZ1	396	+	946	969	969	1.0000000
A09	67783535	67796009	A09p81610.2_BraZ1	12285	+	1872	2183	12474	0.1750040
A09	67797559	67809036	A09p81620.2_BraZ1	1549.03	+	3427	9523	11477	0.8297464
A09	67809984	67810169	A09p81630.2_BraZ1	108	+	0	0	185	0.0000000
A09	67811546	67812079	A09p81640.2_BraZ1	30.9	+	0	0	533	0.0000000
A09	67814802	67815263	A09p81650.2_BraZ1	306	+	0	0	461	0.0000000
A09	67815765	67816871	A09p81660.2_BraZ1	378	+	42	589	1106	0.5325497
A09	67818587	67819018	A09p81670.2_BraZ1	38.7	+	0	0	431	0.0000000
A09	67820990	67822042	A09p81680.2_BraZ1	8670	+	1890	1052	1052	1.0000000
A09	67823046	67824263	A09p81690.2_BraZ1	571.325	-	894	1217	1217	1.0000000
A09	67828047	67831818	A09p81700.2_BraZ1	1019.17	-	375	2140	3771	0.5674887
A09	67835726	67839304	A09p81710.2_BraZ1	1027.3	-	5242	3578	3578	1.0000000
A09	67843815	67845343	A09p81720.2_BraZ1	27157.5	-	267	1326	1528	0.8678011
A09	67846104	67846780	A09p81730.2_BraZ1	315.692	-	651	676	676	1.0000000
A09	67849413	67849593	A09p81740.2_BraZ1	18	+	22	172	180	0.9555556
A09	67850208	67851795	A09p81750.2_BraZ1	158.7	-	100	979	1587	0.6168872
A09	67858636	67861812	A09p81760.2_BraZ1	1157.1	-	232	1112	3176	0.3501259
A09	67864570	67864909	A09p81770.2_BraZ1	33.9	+	271	339	339	1.0000000
A09	67865673	67866894	A09p81780.2_BraZ1	585.391	+	369	976	1221	0.7993448
A09	67868098	67868251	A09p81790.2_BraZ1	15.3	-	286	153	153	1.0000000
A09	67868374	67868488	A09p81800.2_BraZ1	11.4	-	126	114	114	1.0000000
A09	67875354	67877061	A09p81810.2_BraZ1	1620	-	227	1027	1707	0.6016403
A09	67883046	67885920	A09p81820.2_BraZ1	350.424	+	709	2099	2874	0.7303410
A09	67886306	67889889	A09p81830.2_BraZ1	18160.2	+	1134	3419	3583	0.9542283
A09	67890345	67891400	A09p81840.2_BraZ1	810	+	401	955	1055	0.9052133
A09	67891736	67892663	A09p81850.2_BraZ1	487.167	+	370	889	927	0.9590076
A09	67894197	67895220	A09p81860.2_BraZ1	102.3	+	333	975	1023	0.9530792
A09	67896991	67897564	A09p81870.2_BraZ1	57.3	-	223	461	573	0.8045375
A09	67903083	67904732	A09p81880.2_BraZ1	2295	+	275	1458	1649	0.8841722
A09	67904943	67905834	A09p81890.2_BraZ1	750	+	244	811	891	0.9102132
A09	67906565	67907297	A09p81900.2_BraZ1	73.2	+	52	656	732	0.8961748
A09	67908285	67911455	A09p81910.2_BraZ1	640.1	+	2253	3142	3170	0.9911672
A09	67913625	67914053	A09p81920.2_BraZ1	213	+	347	428	428	1.0000000
A09	68038126	68039151	A09p81930.2_BraZ1	939	+	443	1025	1025	1.0000000
A09	68041031	68043032	A09p81940.2_BraZ1	1243.57	+	1014	2001	2001	1.0000000
A09	68045356	68049472	A09p81950.2_BraZ1	2022.43	+	1110	3065	4116	0.7446550
A09	68049860	68050124	A09p81960.2_BraZ1	26.4	-	124	163	264	0.6174242
A09	68051605	68054771	A09p81970.2_BraZ1	1797.78	+	2470	2679	3166	0.8461781
A09	68060099	68062031	A09p81980.2_BraZ1	1611	+	495	1677	1932	0.8680124
A09	68062774	68065270	A09p81990.2_BraZ1	27108	-	735	2156	2496	0.8637820
A09	68066915	68068008	A09p82000.2_BraZ1	93.6	-	493	1093	1093	1.0000000
A09	68070333	68071915	A09p82010.2_BraZ1	632.2	+	1018	1582	1582	1.0000000
A09	68072880	68076020	A09p82020.2_BraZ1	1443.91	-	1588	3140	3140	1.0000000
A09	68081681	68083382	A09p82030.2_BraZ1	1234.9	+	747	1658	1701	0.9747208
A09	68083844	68089765	A09p82040.2_BraZ1	2152.17	+	3338	5914	5921	0.9988177
A09	68090497	68091645	A09p82050.2_BraZ1	575.864	+	239	1074	1148	0.9355401
A09	68091887	68092459	A09p82060.2_BraZ1	212.727	+	688	572	572	1.0000000
A09	68092475	68098167	A09p82070.2_BraZ1	3234	+	1189	4506	5692	0.7916374
A09	68102932	68106645	A09p82080.2_BraZ1	1339.81	-	1984	3589	3713	0.9666038
A09	68107027	68109396	A09p82090.2_BraZ1	1600	-	892	2330	2369	0.9835374
A09	68110091	68111824	A09p82100.2_BraZ1	772.188	-	1335	1733	1733	1.0000000
A09	68112019	68115193	A09p82110.2_BraZ1	1403.08	+	1738	3174	3174	1.0000000
A09	68115628	68117988	A09p82120.2_BraZ1	1550	-	828	2262	2360	0.9584746
A09	68118315	68119499	A09p82130.2_BraZ1	487.278	+	565	1184	1184	1.0000000
A09	68120114	68124319	A09p82140.2_BraZ1	2350.45	+	1065	4029	4205	0.9581451
A09	68124768	68131407	A09p82150.2_BraZ1	4908.4	-	439	2996	6639	0.4512728
A09	68133132	68136739	A09p82160.2_BraZ1	1477.57	+	1685	3563	3607	0.9878015
A09	68136771	68137222	A09p82170.2_BraZ1	122.062	+	15	305	451	0.6762750
A09	68138800	68139675	A09p82180.2_BraZ1	77.7	-	276	758	875	0.8662857
A09	68145390	68147063	A09p82190.2_BraZ1	1002	+	712	1533	1673	0.9163180
A09	68149210	68149726	A09p82200.2_BraZ1	417	-	28	455	516	0.8817829
A09	68152664	68165667	A09p82210.2_BraZ1	728.1	+	2132	9888	13003	0.7604399
A09	68167227	68167707	A09p82220.2_BraZ1	48	+	93	435	480	0.9062500
A09	68168947	68169916	A09p82230.2_BraZ1	435.484	-	758	969	969	1.0000000
A09	68170170	68173052	A09p82240.2_BraZ1	639.572	+	952	2163	2882	0.7505205
A09	68173817	68177732	A09p82250.2_BraZ1	885.214	-	1498	3504	3915	0.8950192
A09	68177838	68182993	A09p82260.2_BraZ1	1370.14	+	3156	4955	5155	0.9612027
A09	68184543	68189315	A09p82270.2_BraZ1	1790.24	+	1239	3980	4772	0.8340319
A10	9822	10685	A10p00010.2_BraZ1	669	+	337	683	863	0.7914253
A10	11642	12099	A10p00020.2_BraZ1	1998	-	182	442	457	0.9671773
A10	12333	13938	A10p00030.2_BraZ1	19237.5	-	334	933	1605	0.5813084
A10	14249	17646	A10p00040.2_BraZ1	1334.93	-	1716	3397	3397	1.0000000
A10	17907	18728	A10p00050.2_BraZ1	7487.25	+	203	706	821	0.8599269
A10	19484	23364	A10p00060.2_BraZ1	1570.96	-	1048	3199	3880	0.8244845
A10	23675	28629	A10p00070.2_BraZ1	1857.42	-	3077	4367	4954	0.8815099
A10	33864	35496	A10p00080.2_BraZ1	987	+	331	1504	1632	0.9215686
A10	49010	62899	A10p00090.2_BraZ1	5352.88	+	1756	8507	13889	0.6124991
A10	66389	67115	A10p00100.2_BraZ1	72.6	+	492	726	726	1.0000000
A10	67620	68913	A10p00110.2_BraZ1	1212	-	469	1230	1293	0.9512761
A10	69533	69653	A10p00120.2_BraZ1	12	+	32	80	120	0.6666667
A10	79022	83902	A10p00130.2_BraZ1	2738.03	-	1169	3992	4880	0.8180328
A10	86451	87964	A10p00140.2_BraZ1	89.1	+	453	1234	1513	0.8155981
A10	91675	91819	A10p00150.2_BraZ1	14.4	+	1	1	144	0.0069444
A10	92072	94682	A10p00160.2_BraZ1	2307	-	350	2151	2610	0.8241379
A10	96605	97317	A10p00170.2_BraZ1	558	-	220	539	712	0.7570225
A10	108135	110654	A10p00180.2_BraZ1	1836	+	538	1972	2519	0.7828503
A10	110867	112177	A10p00190.2_BraZ1	879	-	568	1302	1310	0.9938931
A10	112820	118370	A10p00200.2_BraZ1	3252.14	-	1107	4417	5550	0.7958559
A10	145391	151584	A10p00210.2_BraZ1	442.9	-	495	4557	6193	0.7358308
A10	151957	152691	A10p00220.2_BraZ1	183.333	+	277	732	734	0.9972752
A10	153518	158933	A10p00230.2_BraZ1	3145.31	-	1132	4885	5415	0.9021237
A10	159942	161090	A10p00240.2_BraZ1	595.39	-	306	1148	1148	1.0000000
A10	162413	164432	A10p00250.2_BraZ1	1016.08	+	680	1860	2019	0.9212481
A10	164685	165218	A10p00260.2_BraZ1	450	-	16	166	533	0.3114446
A10	166735	168875	A10p00270.2_BraZ1	1382.73	+	873	2120	2140	0.9906542
A10	169208	169763	A10p00280.2_BraZ1	186	+	568	555	555	1.0000000
A10	170410	178356	A10p00290.2_BraZ1	2143.8	-	2676	7384	7946	0.9292726
A10	179588	181898	A10p00300.2_BraZ1	919.227	+	2304	2310	2310	1.0000000
A10	182225	185303	A10p00310.2_BraZ1	1136.31	+	1936	3068	3078	0.9967511
A10	185642	188268	A10p00320.2_BraZ1	830.571	+	181	1623	2626	0.6180503
A10	192903	196509	A10p00330.2_BraZ1	1498.15	+	705	3277	3606	0.9087632
A10	197713	198402	A10p00340.2_BraZ1	606	+	226	689	689	1.0000000
A10	198871	200249	A10p00350.2_BraZ1	754.643	-	602	1378	1378	1.0000000
A10	203035	204134	A10p00360.2_BraZ1	18655	+	357	1099	1099	1.0000000
A10	212244	214596	A10p00370.2_BraZ1	1512	+	430	2097	2352	0.8915817
A10	218095	219649	A10p00380.2_BraZ1	153	-	654	1466	1554	0.9433720
A10	219715	221731	A10p00390.2_BraZ1	1668	-	138	1601	2016	0.7941468
A10	223565	224919	A10p00400.2_BraZ1	321	-	167	855	1354	0.6314623
A10	223945	224276	A10p00410.2_BraZ1	255	-	71	242	331	0.7311178
A10	240462	243918	A10p00420.2_BraZ1	1991.11	-	275	2299	3456	0.6652199
A10	245422	247812	A10p00430.2_BraZ1	1502.61	-	296	2123	2390	0.8882845
A10	249180	249639	A10p00440.2_BraZ1	312	+	38	351	459	0.7647059
A10	253518	254727	A10p00450.2_BraZ1	120.9	-	151	996	1209	0.8238214
A10	255003	257223	A10p00460.2_BraZ1	162	-	1567	2200	2220	0.9909910
A10	257457	259559	A10p00470.2_BraZ1	1371.83	-	667	1986	2102	0.9448144
A10	266000	267452	A10p00480.2_BraZ1	992.25	-	314	1289	1452	0.8877410
A10	268273	272443	A10p00490.2_BraZ1	2620.31	-	1024	3660	4170	0.8776978
A10	273486	273675	A10p00500.2_BraZ1	18.9	-	6	189	189	1.0000000
A10	278689	279841	A10p00510.2_BraZ1	9282	+	544	1152	1152	1.0000000
A10	282394	284952	A10p00520.2_BraZ1	1477.27	-	1781	2486	2558	0.9718530
A10	290520	292508	A10p00530.2_BraZ1	1163.89	-	840	1854	1988	0.9325956
A10	293806	294628	A10p00540.2_BraZ1	82.2	+	60	428	822	0.5206813
A10	297356	299356	A10p00550.2_BraZ1	1628.91	+	206	1760	2000	0.8800000
A10	300842	302412	A10p00560.2_BraZ1	1322.25	+	289	1496	1570	0.9528663
A10	303484	304945	A10p00570.2_BraZ1	145.2	+	943	1461	1461	1.0000000
A10	305153	307086	A10p00580.2_BraZ1	288	-	2152	1933	1933	1.0000000
A10	307591	308417	A10p00590.2_BraZ1	579.7	-	1038	826	826	1.0000000
A10	313462	315642	A10p00600.2_BraZ1	922.909	-	1328	1939	2180	0.8894495
A10	316927	325494	A10p00610.2_BraZ1	5237.8	+	2309	8058	8567	0.9405860
A10	326167	326887	A10p00620.2_BraZ1	72	-	280	712	720	0.9888889
A10	328318	329764	A10p00630.2_BraZ1	144.6	-	66	811	1446	0.5608575
A10	336222	337929	A10p00640.2_BraZ1	4073.18	-	1009	1707	1707	1.0000000
A10	338811	340545	A10p00650.2_BraZ1	173.4	-	498	1609	1734	0.9279124
A10	344965	345538	A10p00660.2_BraZ1	56.7	+	56	352	573	0.6143106
A10	347845	348832	A10p00670.2_BraZ1	98.7	-	877	919	987	0.9311044
A10	353059	354218	A10p00680.2_BraZ1	462.714	-	579	1115	1159	0.9620363
A10	355418	356392	A10p00690.2_BraZ1	714	+	88	737	974	0.7566735
A10	364117	365814	A10p00700.2_BraZ1	1623	+	42	360	1697	0.2121391
A10	372203	372791	A10p00710.2_BraZ1	58.8	-	10	431	588	0.7329932
A10	374471	374783	A10p00720.2_BraZ1	31.2	+	352	312	312	1.0000000
A10	375772	375907	A10p00730.2_BraZ1	13.5	+	105	135	135	1.0000000
A10	376265	377186	A10p00740.2_BraZ1	91.5	-	305	666	921	0.7231270
A10	378840	379181	A10p00750.2_BraZ1	261	+	146	341	341	1.0000000
A10	379389	380453	A10p00760.2_BraZ1	419.087	-	350	990	1064	0.9304512
A10	382179	385210	A10p00770.2_BraZ1	1298.51	+	808	2727	3031	0.8997031
A10	388719	390309	A10p00780.2_BraZ1	159	+	38	507	1590	0.3188679
A10	392435	394663	A10p00790.2_BraZ1	1506.42	-	231	1310	2228	0.5879713
A10	395303	396537	A10p00800.2_BraZ1	302.25	+	157	1128	1234	0.9141005
A10	397094	398617	A10p00810.2_BraZ1	129.3	+	263	1368	1523	0.8982272
A10	398926	399951	A10p00820.2_BraZ1	828	+	404	1008	1025	0.9834146
A10	400559	403945	A10p00830.2_BraZ1	997.191	-	1023	3347	3386	0.9884820
A10	420631	421960	A10p00840.2_BraZ1	132.9	-	103	814	1329	0.6124906
A10	423091	424338	A10p00850.2_BraZ1	124.5	-	1711	1247	1247	1.0000000
A10	427808	428155	A10p00860.2_BraZ1	336	-	360	347	347	1.0000000
A10	438036	438489	A10p00870.2_BraZ1	45.3	-	212	453	453	1.0000000
A10	440116	442512	A10p00880.2_BraZ1	938.942	+	423	2108	2396	0.8797997
A10	444121	446969	A10p00890.2_BraZ1	1742.5	+	662	2537	2848	0.8908005
A10	452874	454063	A10p00900.2_BraZ1	561.344	+	871	1189	1189	1.0000000
A10	454495	461468	A10p00910.2_BraZ1	5373.71	-	1873	5642	6973	0.8091209
A10	474109	475144	A10p00920.2_BraZ1	103.5	+	0	0	1035	0.0000000
A10	481104	482211	A10p00930.2_BraZ1	361.446	-	418	493	1107	0.4453478
A10	496468	498365	A10p00940.2_BraZ1	390.6	-	399	1396	1897	0.7358988
A10	499067	500652	A10p00950.2_BraZ1	589.667	+	1960	1585	1585	1.0000000
A10	501244	503500	A10p00960.2_BraZ1	2306.77	-	2553	2239	2256	0.9924645
A10	509002	509590	A10p00970.2_BraZ1	58.8	-	92	567	588	0.9642857
A10	512779	514166	A10p00980.2_BraZ1	707.895	+	173	1114	1387	0.8031723
A10	518504	520048	A10p00990.2_BraZ1	1325	-	289	1261	1544	0.8167098
A10	522983	524045	A10p01000.2_BraZ1	823.333	-	595	1062	1062	1.0000000
A10	534227	536087	A10p01010.2_BraZ1	11640	-	901	1845	1860	0.9919355
A10	543621	544906	A10p01020.2_BraZ1	503.636	-	153	899	1285	0.6996109
A10	548369	549999	A10p01030.2_BraZ1	1533	-	997	1630	1630	1.0000000
A10	555923	565049	A10p01040.2_BraZ1	1181.25	-	2721	6964	9126	0.7630945
A10	569533	571162	A10p01050.2_BraZ1	1006.97	-	916	1629	1629	1.0000000
A10	571917	572223	A10p01060.2_BraZ1	30.6	+	71	277	306	0.9052287
A10	576699	579442	A10p01070.2_BraZ1	1469.1	-	1356	2588	2743	0.9434925
A10	580807	581749	A10p01080.2_BraZ1	94.2	+	252	729	942	0.7738854
A10	581961	583319	A10p01090.2_BraZ1	876.07	-	623	1324	1358	0.9749632
A10	585573	588014	A10p01100.2_BraZ1	1177.47	-	1057	2234	2441	0.9151987
A10	602035	602640	A10p01110.2_BraZ1	288	+	57	433	605	0.7157025
A10	604424	605698	A10p01120.2_BraZ1	828	-	1168	1274	1274	1.0000000
A10	605993	607075	A10p01130.2_BraZ1	657	-	349	778	1082	0.7190388
A10	614265	617425	A10p01140.2_BraZ1	776.889	-	2305	3024	3160	0.9569620
A10	623911	626498	A10p01150.2_BraZ1	1558.47	+	874	2587	2587	1.0000000
A10	626685	626892	A10p01160.2_BraZ1	20.7	-	343	207	207	1.0000000
A10	627723	628636	A10p01170.2_BraZ1	816	-	199	771	913	0.8444688
A10	631496	631712	A10p01180.2_BraZ1	21.6	-	226	216	216	1.0000000
A10	631744	632427	A10p01190.2_BraZ1	480	-	441	394	683	0.5768667
A10	635621	637279	A10p01200.2_BraZ1	16254	+	269	1605	1658	0.9680338
A10	638333	639184	A10p01210.2_BraZ1	678	+	751	851	851	1.0000000
A10	644541	646919	A10p01220.2_BraZ1	1584	+	669	2225	2378	0.9356602
A10	655117	657493	A10p01230.2_BraZ1	1005.97	+	751	1954	2376	0.8223906
A10	659364	660734	A10p01240.2_BraZ1	837.187	+	675	1370	1370	1.0000000
A10	661058	661916	A10p01250.2_BraZ1	85.8	-	644	858	858	1.0000000
A10	670002	671190	A10p01260.2_BraZ1	417.6	-	633	1184	1188	0.9966330
A10	671685	672018	A10p01270.2_BraZ1	33.3	-	170	333	333	1.0000000
A10	674759	676352	A10p01280.2_BraZ1	603.529	-	206	1303	1593	0.8179535
A10	690583	692831	A10p01290.2_BraZ1	1437.09	-	108	1173	2248	0.5217972
A10	704733	705993	A10p01300.2_BraZ1	409.311	-	238	760	1260	0.6031746
A10	706616	707844	A10p01310.2_BraZ1	415.8	-	890	1228	1228	1.0000000
A10	710380	715330	A10p01320.2_BraZ1	3109.38	+	751	3758	4950	0.7591919
A10	716255	717971	A10p01330.2_BraZ1	613.47	+	1064	1645	1716	0.9586247
A10	719916	720735	A10p01340.2_BraZ1	81.9	+	288	775	819	0.9462759
A10	721458	721710	A10p01350.2_BraZ1	25.2	+	252	252	252	1.0000000
A10	724596	729295	A10p01360.2_BraZ1	1701.72	+	672	2389	4699	0.5084060
A10	735811	747349	A10p01370.2_BraZ1	506.571	-	2366	8851	11538	0.7671174
A10	757156	758695	A10p01380.2_BraZ1	477.333	-	1086	1539	1539	1.0000000
A10	760976	764289	A10p01390.2_BraZ1	2069.33	+	357	2592	3313	0.7823725
A10	764493	765677	A10p01400.2_BraZ1	322.48	+	547	1184	1184	1.0000000
A10	765954	766503	A10p01410.2_BraZ1	54.9	-	109	549	549	1.0000000
A10	769553	770174	A10p01420.2_BraZ1	62.1	+	20	129	621	0.2077295
A10	770629	771427	A10p01430.2_BraZ1	5697	+	129	485	798	0.6077694
A10	776606	781060	A10p01440.2_BraZ1	2148.87	+	1597	4112	4454	0.9232151
A10	781418	785114	A10p01450.2_BraZ1	3446.93	-	488	2785	3696	0.7535173
A10	786404	788154	A10p01460.2_BraZ1	3762	+	193	1255	1750	0.7171429
A10	790376	791353	A10p01470.2_BraZ1	68.1	+	205	939	977	0.9611054
A10	792383	793553	A10p01480.2_BraZ1	7110	-	413	1170	1170	1.0000000
A10	795626	797159	A10p01490.2_BraZ1	1206.87	-	199	614	1533	0.4005218
A10	799718	804289	A10p01500.2_BraZ1	3255	+	955	3272	4571	0.7158171
A10	806555	806942	A10p01510.2_BraZ1	297	-	452	387	387	1.0000000
A10	807700	808215	A10p01520.2_BraZ1	378	-	408	515	515	1.0000000
A10	808677	812912	A10p01530.2_BraZ1	1366.7	+	1777	3339	4235	0.7884297
A10	817776	818167	A10p01540.2_BraZ1	162	-	125	291	391	0.7442455
A10	820038	822751	A10p01550.2_BraZ1	1251.39	+	319	2105	2713	0.7758939
A10	824612	826229	A10p01560.2_BraZ1	546.869	+	616	1581	1617	0.9777365
A10	826563	827553	A10p01570.2_BraZ1	576.136	-	886	990	990	1.0000000
A10	828042	829410	A10p01580.2_BraZ1	452.132	-	1016	1368	1368	1.0000000
A10	835143	836281	A10p01590.2_BraZ1	204	+	757	1122	1138	0.9859402
A10	837045	845612	A10p01600.2_BraZ1	3750.44	-	2311	7558	8567	0.8822225
A10	847929	848373	A10p01610.2_BraZ1	36.9	-	23	230	444	0.5180180
A10	850164	851265	A10p01620.2_BraZ1	310	-	68	871	1101	0.7910990
A10	853907	854917	A10p01630.2_BraZ1	617.929	-	85	889	1010	0.8801980
A10	855500	856791	A10p01640.2_BraZ1	682.043	-	406	1245	1291	0.9643687
A10	859960	861184	A10p01650.2_BraZ1	563.062	-	425	1171	1224	0.9566994
A10	861692	862983	A10p01660.2_BraZ1	945	-	203	901	1291	0.6979086
A10	867196	873874	A10p01670.2_BraZ1	3771.18	+	2660	6421	6678	0.9615154
A10	874290	878344	A10p01680.2_BraZ1	2633.55	-	1097	3802	4054	0.9378392
A10	878897	879646	A10p01690.2_BraZ1	51.52	-	293	746	749	0.9959947
A10	879646	882578	A10p01700.2_BraZ1	621.6	-	790	2722	2932	0.9283766
A10	883709	886710	A10p01710.2_BraZ1	1604.93	+	491	2667	3001	0.8887038
A10	887444	887753	A10p01720.2_BraZ1	30.9	-	21	275	309	0.8899676
A10	895066	897044	A10p01730.2_BraZ1	679.855	+	1256	1971	1978	0.9964611
A10	897495	899420	A10p01740.2_BraZ1	856.8	-	520	1817	1925	0.9438961
A10	900535	902849	A10p01750.2_BraZ1	1740.48	+	768	2245	2314	0.9701815
A10	903695	917223	A10p01760.2_BraZ1	8416.33	-	505	4118	13528	0.3044057
A10	920520	921704	A10p01770.2_BraZ1	697	+	325	1184	1184	1.0000000
A10	921829	929231	A10p01780.2_BraZ1	29323.3	-	1966	6540	7402	0.8835450
A10	929231	931314	A10p01790.2_BraZ1	231	-	1226	2083	2083	1.0000000
A10	931670	932039	A10p01800.2_BraZ1	168	-	124	306	369	0.8292683
A10	932688	935031	A10p01810.2_BraZ1	234.3	-	1083	2234	2343	0.9534785
A10	935552	936094	A10p01820.2_BraZ1	194.333	+	322	542	542	1.0000000
A10	936088	937561	A10p01830.2_BraZ1	475.714	+	1063	1473	1473	1.0000000
A10	937882	938742	A10p01840.2_BraZ1	534	+	504	860	860	1.0000000
A10	939347	943700	A10p01850.2_BraZ1	897	-	956	2819	4353	0.6475993
A10	945042	948516	A10p01860.2_BraZ1	649.607	+	2594	3457	3474	0.9951065
A10	951761	952475	A10p01870.2_BraZ1	71.4	+	321	714	714	1.0000000
A10	956480	957802	A10p01880.2_BraZ1	832.174	-	1191	1322	1322	1.0000000
A10	958153	959513	A10p01890.2_BraZ1	684.296	-	914	1261	1360	0.9272059
A10	960557	961793	A10p01900.2_BraZ1	123.6	-	251	1096	1236	0.8867314
A10	963436	980755	A10p01910.2_BraZ1	3102.43	+	8034	16523	17319	0.9540389
A10	981732	984285	A10p01920.2_BraZ1	255.3	+	876	2327	2553	0.9114767
A10	984703	985734	A10p01930.2_BraZ1	348	+	305	899	1031	0.8719690
A10	986001	986855	A10p01940.2_BraZ1	1269	-	150	493	854	0.5772834
A10	987360	988714	A10p01950.2_BraZ1	872.727	+	999	1354	1354	1.0000000
A10	988923	990219	A10p01960.2_BraZ1	70.5	-	369	1267	1296	0.9776235
A10	990512	992155	A10p01970.2_BraZ1	894.857	+	481	1643	1643	1.0000000
A10	992996	995848	A10p01980.2_BraZ1	11193	+	489	1394	2852	0.4887798
A10	999597	1003911	A10p01990.2_BraZ1	2663.86	+	1673	4220	4314	0.9782104
A10	1004401	1005793	A10p02000.2_BraZ1	139.2	-	298	1381	1392	0.9920977
A10	1006106	1007685	A10p02010.2_BraZ1	107.1	-	1393	1579	1579	1.0000000
A10	1015990	1017417	A10p02020.2_BraZ1	2579.25	-	539	1308	1427	0.9166083
A10	1020707	1021813	A10p02030.2_BraZ1	439.6	+	174	965	1106	0.8725135
A10	1026913	1027143	A10p02040.2_BraZ1	21.9	-	91	230	230	1.0000000
A10	1027550	1028738	A10p02050.2_BraZ1	118.8	+	440	1091	1188	0.9183502
A10	1029503	1031962	A10p02060.2_BraZ1	1114.17	-	2626	2459	2459	1.0000000
A10	1034012	1034920	A10p02070.2_BraZ1	8901	-	749	908	908	1.0000000
A10	1036275	1037997	A10p02080.2_BraZ1	1107.83	-	995	1722	1722	1.0000000
A10	1040325	1042554	A10p02090.2_BraZ1	222.9	+	73	814	2229	0.3651862
A10	1043091	1046682	A10p02100.2_BraZ1	436.042	-	332	1820	3591	0.5068226
A10	1046820	1046997	A10p02110.2_BraZ1	15.3	-	8	45	177	0.2542373
A10	1049057	1050875	A10p02120.2_BraZ1	181.8	+	137	1352	1818	0.7436743
A10	1051641	1052073	A10p02130.2_BraZ1	21.9	-	309	432	432	1.0000000
A10	1055227	1055853	A10p02140.2_BraZ1	369	-	762	626	626	1.0000000
A10	1056291	1061880	A10p02150.2_BraZ1	1697.77	-	2217	5146	5589	0.9207371
A10	1063447	1065093	A10p02160.2_BraZ1	772.593	-	838	1628	1646	0.9890644
A10	1070230	1072186	A10p02170.2_BraZ1	195.6	-	723	1905	1956	0.9739264
A10	1072544	1074222	A10p02180.2_BraZ1	1317.86	-	1029	1633	1678	0.9731824
A10	1076496	1077024	A10p02190.2_BraZ1	52.8	+	111	528	528	1.0000000
A10	1078257	1078767	A10p02200.2_BraZ1	432	+	100	510	510	1.0000000
A10	1080033	1081513	A10p02210.2_BraZ1	876.273	+	732	1480	1480	1.0000000
A10	1082508	1084154	A10p02220.2_BraZ1	745.5	-	805	1619	1646	0.9835966
A10	1085795	1087611	A10p02230.2_BraZ1	1070.67	+	666	1816	1816	1.0000000
A10	1088426	1090611	A10p02240.2_BraZ1	6160	-	2374	2185	2185	1.0000000
A10	1107957	1111145	A10p02250.2_BraZ1	309	-	1422	2710	3188	0.8500627
A10	1112395	1112527	A10p02260.2_BraZ1	13.2	-	0	0	132	0.0000000
A10	1113299	1113467	A10p02270.2_BraZ1	16.8	+	4	27	168	0.1607143
A10	1114453	1115656	A10p02280.2_BraZ1	909	-	1457	1203	1203	1.0000000
A10	1122149	1122984	A10p02290.2_BraZ1	405	+	595	835	835	1.0000000
A10	1128892	1129799	A10p02300.2_BraZ1	400.636	+	792	907	907	1.0000000
A10	1130335	1130590	A10p02310.2_BraZ1	25.5	+	186	255	255	1.0000000
A10	1132179	1132514	A10p02320.2_BraZ1	162	-	220	335	335	1.0000000
A10	1134669	1135354	A10p02330.2_BraZ1	216	-	4	206	685	0.3007299
A10	1136356	1136587	A10p02340.2_BraZ1	18.3	-	84	231	231	1.0000000
A10	1138112	1138798	A10p02350.2_BraZ1	216	-	2	246	686	0.3586006
A10	1141555	1142240	A10p02360.2_BraZ1	216	-	59	410	685	0.5985401
A10	1143676	1144040	A10p02370.2_BraZ1	219	-	164	364	364	1.0000000
A10	1152000	1152933	A10p02380.2_BraZ1	579.706	+	737	933	933	1.0000000
A10	1153715	1154773	A10p02390.2_BraZ1	542.8	-	870	1058	1058	1.0000000
A10	1156766	1156976	A10p02400.2_BraZ1	21	-	0	0	210	0.0000000
A10	1163676	1167085	A10p02410.2_BraZ1	293.7	-	588	1836	3409	0.5385743
A10	1182606	1185715	A10p02420.2_BraZ1	1779.97	+	1534	3043	3109	0.9787713
A10	1187170	1188900	A10p02430.2_BraZ1	767.75	-	1621	1726	1730	0.9976879
A10	1191753	1192844	A10p02440.2_BraZ1	420	-	49	709	1091	0.6498625
A10	1194712	1196876	A10p02450.2_BraZ1	931.719	+	2344	2164	2164	1.0000000
A10	1197250	1201220	A10p02460.2_BraZ1	2056.39	-	2682	3914	3970	0.9858942
A10	1202880	1204053	A10p02470.2_BraZ1	117.3	+	311	1119	1173	0.9539642
A10	1205649	1206201	A10p02480.2_BraZ1	55.2	-	248	552	552	1.0000000
A10	1207514	1208024	A10p02490.2_BraZ1	423	+	248	469	510	0.9196078
A10	1208429	1209092	A10p02500.2_BraZ1	66.3	-	280	663	663	1.0000000
A10	1210887	1211187	A10p02510.2_BraZ1	186	-	506	300	300	1.0000000
A10	1211208	1211604	A10p02520.2_BraZ1	39.6	+	703	396	396	1.0000000
A10	1212524	1214681	A10p02530.2_BraZ1	1531.06	-	364	1936	2157	0.8975429
A10	1223802	1225025	A10p02540.2_BraZ1	49.2	-	0	0	1223	0.0000000
A10	1238536	1239004	A10p02550.2_BraZ1	46.8	-	76	398	468	0.8504273
A10	1240828	1242054	A10p02560.2_BraZ1	808.769	-	385	1175	1226	0.9584013
A10	1243760	1244513	A10p02570.2_BraZ1	75.3	-	138	675	753	0.8964143
A10	1246981	1249316	A10p02580.2_BraZ1	1198.27	+	269	1490	2335	0.6381156
A10	1249747	1252037	A10p02590.2_BraZ1	1409.84	-	737	1839	2290	0.8030568
A10	1253073	1260079	A10p02600.2_BraZ1	2188.43	+	2818	5767	7006	0.8231516
A10	1261814	1266730	A10p02610.2_BraZ1	1478.03	+	898	3501	4916	0.7121643
A10	1267278	1269219	A10p02620.2_BraZ1	194.1	-	33	490	1941	0.2524472
A10	1271478	1271829	A10p02630.2_BraZ1	35.1	+	8	162	351	0.4615385
A10	1274018	1276469	A10p02640.2_BraZ1	594.522	-	1421	2377	2451	0.9698082
A10	1278169	1279064	A10p02650.2_BraZ1	80.7	+	399	895	895	1.0000000
A10	1280210	1281093	A10p02660.2_BraZ1	538.273	-	277	862	883	0.9762174
A10	1282049	1283573	A10p02670.2_BraZ1	936	-	1187	1520	1524	0.9973753
A10	1283913	1284455	A10p02680.2_BraZ1	450	+	932	542	542	1.0000000
A10	1285227	1287888	A10p02690.2_BraZ1	1434	+	1271	2568	2661	0.9650508
A10	1288349	1288814	A10p02700.2_BraZ1	46.5	-	14	258	465	0.5548387
A10	1291247	1295518	A10p02710.2_BraZ1	1882.67	-	1699	4030	4271	0.9435729
A10	1295575	1302842	A10p02720.2_BraZ1	126	-	389	3089	7267	0.4250723
A10	1297562	1297909	A10p02730.2_BraZ1	90	-	10	173	347	0.4985591
A10	1297929	1298405	A10p02740.2_BraZ1	219	-	0	0	476	0.0000000
A10	1303852	1308305	A10p02750.2_BraZ1	2097.34	+	1206	4123	4453	0.9258927
A10	1308848	1311519	A10p02760.2_BraZ1	1621.67	+	1349	2655	2671	0.9940097
A10	1311959	1313189	A10p02770.2_BraZ1	5670	+	1492	1230	1230	1.0000000
A10	1313558	1315892	A10p02780.2_BraZ1	233.4	-	335	2004	2334	0.8586118
A10	1317467	1322746	A10p02790.2_BraZ1	4015.34	-	1854	5043	5279	0.9552945
A10	1336937	1337855	A10p02800.2_BraZ1	258	+	6	266	918	0.2897604
A10	1341959	1344050	A10p02810.2_BraZ1	1278.77	+	642	2091	2091	1.0000000
A10	1346757	1349342	A10p02820.2_BraZ1	215	-	720	2188	2585	0.8464217
A10	1364366	1365722	A10p02830.2_BraZ1	1269	+	708	1271	1356	0.9373156
A10	1366796	1371094	A10p02840.2_BraZ1	1468.06	+	1128	3939	4298	0.9164728
A10	1371645	1376572	A10p02850.2_BraZ1	3183.45	+	1627	4489	4927	0.9111021
A10	1377197	1380326	A10p02860.2_BraZ1	27825	-	2635	3029	3129	0.9680409
A10	1391897	1392848	A10p02870.2_BraZ1	548.25	-	867	951	951	1.0000000
A10	1398068	1398389	A10p02880.2_BraZ1	32.1	-	21	267	321	0.8317757
A10	1400772	1402162	A10p02890.2_BraZ1	675	+	513	1382	1390	0.9942446
A10	1405449	1406930	A10p02900.2_BraZ1	244.914	-	778	1481	1481	1.0000000
A10	1407025	1410270	A10p02910.2_BraZ1	1409.05	-	2894	3245	3245	1.0000000
A10	1413314	1413959	A10p02920.2_BraZ1	476.071	-	691	645	645	1.0000000
A10	1414949	1419891	A10p02930.2_BraZ1	2745.04	-	1815	4031	4942	0.8156617
A10	1421038	1422984	A10p02940.2_BraZ1	1860	-	124	1260	1946	0.6474820
A10	1426203	1426701	A10p02950.2_BraZ1	309	+	366	498	498	1.0000000
A10	1429997	1430300	A10p02960.2_BraZ1	30.3	-	50	303	303	1.0000000
A10	1431687	1432838	A10p02970.2_BraZ1	461.216	-	479	1128	1151	0.9800174
A10	1434227	1435684	A10p02980.2_BraZ1	748	+	149	1001	1457	0.6870282
A10	1437277	1438665	A10p02990.2_BraZ1	236	+	481	1346	1388	0.9697406
A10	1439335	1440455	A10p03000.2_BraZ1	111.6	-	178	1073	1120	0.9580357
A10	1442547	1443930	A10p03010.2_BraZ1	480	+	536	1367	1383	0.9884310
A10	1456897	1457302	A10p03020.2_BraZ1	40.5	+	103	384	405	0.9481481
A10	1464206	1465843	A10p03030.2_BraZ1	1038.33	-	1067	1402	1637	0.8564447
A10	1467846	1471354	A10p03040.2_BraZ1	2671.98	-	898	2793	3508	0.7961802
A10	1471729	1474386	A10p03050.2_BraZ1	181.5	-	935	2575	2657	0.9691381
A10	1475300	1477127	A10p03060.2_BraZ1	979.733	-	549	1607	1827	0.8795840
A10	1477456	1479748	A10p03070.2_BraZ1	1163.8	+	1204	2284	2292	0.9965096
A10	1483386	1486527	A10p03080.2_BraZ1	1713.96	+	866	2978	3141	0.9481057
A10	1488486	1491219	A10p03090.2_BraZ1	1136.2	+	824	2444	2733	0.8942554
A10	1491845	1496266	A10p03100.2_BraZ1	2951.81	-	904	3726	4421	0.8427957
A10	1497672	1498610	A10p03110.2_BraZ1	6028	+	680	938	938	1.0000000
A10	1498815	1500118	A10p03120.2_BraZ1	1239	-	1355	1303	1303	1.0000000
A10	1501249	1501540	A10p03130.2_BraZ1	29.1	-	31	291	291	1.0000000
A10	1506328	1506793	A10p03140.2_BraZ1	46.5	+	174	465	465	1.0000000
A10	1507521	1509717	A10p03150.2_BraZ1	781.688	-	844	1959	2196	0.8920765
A10	1512717	1516135	A10p03160.2_BraZ1	1285.93	+	1551	3191	3418	0.9335869
A10	1517321	1519128	A10p03170.2_BraZ1	974.611	+	425	1599	1807	0.8848921
A10	1519743	1521054	A10p03180.2_BraZ1	898.389	-	1146	1311	1311	1.0000000
A10	1529169	1530960	A10p03190.2_BraZ1	179.1	+	440	1600	1791	0.8933557
A10	1532148	1536481	A10p03200.2_BraZ1	798.431	+	3731	4308	4333	0.9942303
A10	1536675	1538732	A10p03210.2_BraZ1	8764.2	-	1416	2057	2057	1.0000000
A10	1539662	1544998	A10p03220.2_BraZ1	3586.87	-	3768	5336	5336	1.0000000
A10	1545890	1548244	A10p03230.2_BraZ1	948.391	-	1298	2241	2354	0.9519966
A10	1549282	1550428	A10p03240.2_BraZ1	114.6	-	403	1019	1146	0.8891798
A10	1550955	1551363	A10p03250.2_BraZ1	40.8	+	758	408	408	1.0000000
A10	1552938	1554193	A10p03260.2_BraZ1	731.25	+	24	265	1255	0.2111554
A10	1563376	1565063	A10p03270.2_BraZ1	1311	+	597	1638	1687	0.9709544
A10	1567371	1568388	A10p03280.2_BraZ1	456	-	931	999	1017	0.9823009
A10	1573918	1577201	A10p03290.2_BraZ1	1348.29	-	3648	3283	3283	1.0000000
A10	1577589	1578742	A10p03300.2_BraZ1	43.2	-	1259	1153	1153	1.0000000
A10	1579071	1580831	A10p03310.2_BraZ1	6443	+	483	1720	1760	0.9772727
A10	1580956	1589779	A10p03320.2_BraZ1	1318.32	-	5000	8229	8823	0.9326760
A10	1594054	1594641	A10p03330.2_BraZ1	40.5	-	108	549	587	0.9352641
A10	1595408	1596499	A10p03340.2_BraZ1	39	+	5	131	1091	0.1200733
A10	1598598	1602224	A10p03350.2_BraZ1	1251.82	-	549	2621	3626	0.7228351
A10	1612395	1613791	A10p03360.2_BraZ1	987	+	405	1321	1396	0.9462751
A10	1616325	1619768	A10p03370.2_BraZ1	2744.42	+	506	1933	3443	0.5614290
A10	1620797	1622819	A10p03380.2_BraZ1	202.2	-	376	1475	2022	0.7294758
A10	1623486	1623687	A10p03390.2_BraZ1	20.1	-	508	201	201	1.0000000
A10	1624703	1630471	A10p03400.2_BraZ1	2570.39	-	7016	5615	5768	0.9734743
A10	1631125	1632413	A10p03410.2_BraZ1	678.894	-	1081	1288	1288	1.0000000
A10	1634617	1635828	A10p03420.2_BraZ1	826.273	-	1501	1211	1211	1.0000000
A10	1636660	1637230	A10p03430.2_BraZ1	315	+	13	254	570	0.4456140
A10	1637329	1639883	A10p03440.2_BraZ1	1954.29	+	61	1327	2554	0.5195771
A10	1642594	1643002	A10p03450.2_BraZ1	40.8	-	0	0	408	0.0000000
A10	1645120	1646348	A10p03460.2_BraZ1	232.5	-	105	1096	1228	0.8925081
A10	1652024	1655763	A10p03470.2_BraZ1	1206	+	2342	3680	3739	0.9842204
A10	1656452	1666925	A10p03480.2_BraZ1	2226	-	8294	10229	10473	0.9767020
A10	1660278	1662731	A10p03490.2_BraZ1	1703.89	+	2063	2429	2453	0.9902161
A10	1663235	1663826	A10p03500.2_BraZ1	59.1	-	1071	591	591	1.0000000
A10	1668334	1669319	A10p03510.2_BraZ1	3840	+	44	602	985	0.6111675
A10	1669705	1669933	A10p03520.2_BraZ1	126	+	21	228	228	1.0000000
A10	1670825	1671536	A10p03530.2_BraZ1	267	+	22	418	711	0.5879043
A10	1676594	1684210	A10p03540.2_BraZ1	1379.49	-	3418	7275	7616	0.9552258
A10	1684788	1695728	A10p03550.2_BraZ1	321.867	-	3803	7993	10940	0.7306216
A10	1695813	1697124	A10p03560.2_BraZ1	131.1	-	887	1311	1311	1.0000000
A10	1697851	1700697	A10p03570.2_BraZ1	816	-	702	2087	2846	0.7333099
A10	1700224	1701466	A10p03580.2_BraZ1	294	-	442	1162	1242	0.9355878
A10	1703138	1703780	A10p03590.2_BraZ1	189	-	365	642	642	1.0000000
A10	1706334	1721176	A10p03600.2_BraZ1	2270.27	-	6669	12361	14842	0.8328393
A10	1712265	1713155	A10p03610.2_BraZ1	2119.5	-	915	890	890	1.0000000
A10	1715586	1716949	A10p03620.2_BraZ1	1479	-	7	369	1363	0.2707264
A10	1722251	1723990	A10p03630.2_BraZ1	1160.11	-	1180	1739	1739	1.0000000
A10	1729556	1731463	A10p03640.2_BraZ1	1699.75	-	1079	1907	1907	1.0000000
A10	1732419	1735640	A10p03650.2_BraZ1	1168.42	+	1992	3099	3221	0.9621236
A10	1736150	1739111	A10p03660.2_BraZ1	1165.01	-	1236	2564	2961	0.8659237
A10	1739446	1744538	A10p03670.2_BraZ1	2852.59	-	2461	4607	5092	0.9047526
A10	1745115	1747386	A10p03680.2_BraZ1	973	-	2576	2249	2271	0.9903126
A10	1747899	1748841	A10p03690.2_BraZ1	831	+	511	942	942	1.0000000
A10	1749298	1752929	A10p03700.2_BraZ1	1475.45	-	3094	3631	3631	1.0000000
A10	1753783	1757673	A10p03710.2_BraZ1	907.5	-	1276	3885	3890	0.9987146
A10	1758213	1759547	A10p03720.2_BraZ1	12537	-	347	1113	1334	0.8343328
A10	1760087	1762138	A10p03730.2_BraZ1	1272.73	+	337	1987	2051	0.9687957
A10	1762580	1767466	A10p03740.2_BraZ1	537.058	+	484	838	4886	0.1715104
A10	1764953	1766450	A10p03750.2_BraZ1	149.7	+	0	0	1497	0.0000000
A10	1772453	1774145	A10p03760.2_BraZ1	405	+	487	1460	1692	0.8628842
A10	1776888	1779321	A10p03770.2_BraZ1	539.963	-	99	707	2433	0.2905878
A10	1779408	1779552	A10p03780.2_BraZ1	14.4	-	0	0	144	0.0000000
A10	1781157	1783889	A10p03790.2_BraZ1	1214.4	-	356	1882	2732	0.6888726
A10	1784496	1786617	A10p03800.2_BraZ1	1161.65	-	1521	2121	2121	1.0000000
A10	1787159	1787573	A10p03810.2_BraZ1	41.4	-	3	37	414	0.0893720
A10	1789902	1790025	A10p03820.2_BraZ1	12.3	-	280	123	123	1.0000000
A10	1792139	1792491	A10p03830.2_BraZ1	186	+	574	352	352	1.0000000
A10	1792986	1793121	A10p03840.2_BraZ1	13.5	+	132	135	135	1.0000000
A10	1795324	1795470	A10p03850.2_BraZ1	13.5	+	96	146	146	1.0000000
A10	1816599	1820496	A10p03860.2_BraZ1	656.906	+	1197	2502	3897	0.6420323
A10	1823241	1824545	A10p03870.2_BraZ1	925.75	-	230	1172	1304	0.8987730
A10	1829386	1829737	A10p03880.2_BraZ1	35.1	+	0	0	351	0.0000000
A10	1833851	1835765	A10p03890.2_BraZ1	191.4	-	223	1522	1914	0.7951933
A10	1836450	1838658	A10p03900.2_BraZ1	1701	-	159	1392	2208	0.6304348
A10	1848490	1848943	A10p03910.2_BraZ1	366	-	250	453	453	1.0000000
A10	1849766	1850518	A10p03920.2_BraZ1	654	+	26	378	752	0.5026596
A10	1852439	1853924	A10p03930.2_BraZ1	148.5	+	946	1485	1485	1.0000000
A10	1854783	1855020	A10p03940.2_BraZ1	23.4	-	160	236	237	0.9957806
A10	1856577	1862479	A10p03950.2_BraZ1	421.091	-	7878	5468	5902	0.9264656
A10	1862847	1863733	A10p03960.2_BraZ1	375.429	-	22	543	886	0.6128668
A10	1864631	1866954	A10p03970.2_BraZ1	1941.21	+	1171	2323	2323	1.0000000
A10	1871503	1872517	A10p03980.2_BraZ1	101.4	+	252	991	1014	0.9773176
A10	1873369	1877304	A10p03990.2_BraZ1	2122.86	-	3120	3935	3935	1.0000000
A10	1887107	1887531	A10p04000.2_BraZ1	267	-	25	323	424	0.7617925
A10	1888228	1888553	A10p04010.2_BraZ1	24.9	+	73	207	325	0.6369231
A10	1893762	1894298	A10p04020.2_BraZ1	285	-	642	536	536	1.0000000
A10	1894524	1895985	A10p04030.2_BraZ1	436	-	537	1461	1461	1.0000000
A10	1895249	1895753	A10p04040.2_BraZ1	47.4	-	146	504	504	1.0000000
A10	1901559	1902941	A10p04050.2_BraZ1	327.286	+	617	1357	1382	0.9819103
A10	1914265	1914473	A10p04060.2_BraZ1	147	+	93	208	208	1.0000000
A10	1915606	1916893	A10p04070.2_BraZ1	128.7	+	161	732	1287	0.5687646
A10	1917138	1924189	A10p04080.2_BraZ1	3382.81	-	5368	6811	7051	0.9659623
A10	1924995	1931540	A10p04090.2_BraZ1	1339.09	-	3156	5971	6545	0.9122995
A10	1935673	1938755	A10p04100.2_BraZ1	1331.51	-	2947	2985	3082	0.9685270
A10	1939760	1940922	A10p04110.2_BraZ1	655.2	-	345	1023	1162	0.8803787
A10	1943163	1946258	A10p04120.2_BraZ1	3115.58	+	1034	2945	3095	0.9515347
A10	1946622	1947445	A10p04130.2_BraZ1	253.946	-	728	823	823	1.0000000
A10	1947702	1948533	A10p04140.2_BraZ1	507	+	350	672	831	0.8086643
A10	1949340	1953025	A10p04150.2_BraZ1	1780.63	-	1926	3558	3685	0.9655359
A10	1963000	1964339	A10p04160.2_BraZ1	8372	+	640	1193	1339	0.8909634
A10	1966616	1980832	A10p04170.2_BraZ1	907.857	-	5255	10538	14216	0.7412775
A10	1970239	1971664	A10p04180.2_BraZ1	922.308	+	19	125	1425	0.0877193
A10	1975546	1976035	A10p04190.2_BraZ1	48.9	+	292	489	489	1.0000000
A10	1981364	1983023	A10p04200.2_BraZ1	1914.75	+	1313	1659	1659	1.0000000
A10	1987817	1993913	A10p04210.2_BraZ1	1301.21	-	1129	4577	6096	0.7508202
A10	1996296	1996548	A10p04220.2_BraZ1	25.2	-	432	252	252	1.0000000
A10	1999885	2002689	A10p04230.2_BraZ1	1457.25	-	1401	2582	2804	0.9208274
A10	2004934	2053716	A10p04240.2_BraZ1	207.635	-	24758	38261	48782	0.7843262
A10	2015001	2015471	A10p04250.2_BraZ1	305.143	-	547	470	470	1.0000000
A10	2028158	2029043	A10p04260.2_BraZ1	3871.5	-	866	885	885	1.0000000
A10	2032253	2060191	A10p04270.2_BraZ1	703.347	-	9630	22189	27938	0.7942230
A10	2041436	2042264	A10p04280.2_BraZ1	882	+	4	19	828	0.0229469
A10	2061610	2062436	A10p04290.2_BraZ1	555.692	-	1078	826	826	1.0000000
A10	2072915	2075938	A10p04300.2_BraZ1	885.167	+	5	74	3023	0.0244790
A10	2086596	2087534	A10p04310.2_BraZ1	453	+	1712	938	938	1.0000000
A10	2087642	2088434	A10p04320.2_BraZ1	558	+	316	763	792	0.9633839
A10	2092975	2093185	A10p04330.2_BraZ1	21	+	51	210	210	1.0000000
A10	2094644	2094888	A10p04340.2_BraZ1	114	-	722	244	244	1.0000000
A10	2096807	2097773	A10p04350.2_BraZ1	420	-	1073	966	966	1.0000000
A10	2099098	2105842	A10p04360.2_BraZ1	1116	-	1689	5131	6744	0.7608244
A10	2111859	2112102	A10p04370.2_BraZ1	15.9	+	89	237	243	0.9753087
A10	2119313	2121292	A10p04380.2_BraZ1	1368	-	118	854	1979	0.4315311
A10	2130549	2133435	A10p04390.2_BraZ1	2202.87	+	670	1926	2886	0.6673597
A10	2134089	2134614	A10p04400.2_BraZ1	52.5	+	277	525	525	1.0000000
A10	2140266	2140717	A10p04410.2_BraZ1	299.25	-	770	435	451	0.9645233
A10	2142449	2142904	A10p04420.2_BraZ1	216	-	287	455	455	1.0000000
A10	2143965	2146877	A10p04430.2_BraZ1	1256.92	-	1334	2894	2912	0.9938187
A10	2150182	2153763	A10p04440.2_BraZ1	1206.5	-	446	3140	3581	0.8768501
A10	2167555	2172179	A10p04450.2_BraZ1	3262.38	+	1641	4042	4624	0.8741350
A10	2172653	2173399	A10p04460.2_BraZ1	562.435	-	537	746	746	1.0000000
A10	2176063	2176804	A10p04470.2_BraZ1	71.1	-	116	625	741	0.8434548
A10	2178563	2179021	A10p04480.2_BraZ1	141	+	42	408	458	0.8908297
A10	2187144	2189067	A10p04490.2_BraZ1	7237.33	+	880	1795	1923	0.9334373
A10	2189402	2190798	A10p04500.2_BraZ1	784.914	-	1335	1396	1396	1.0000000
A10	2191324	2192642	A10p04510.2_BraZ1	1034.55	-	1152	1318	1318	1.0000000
A10	2193226	2194027	A10p04520.2_BraZ1	80.1	+	338	801	801	1.0000000
A10	2196655	2197791	A10p04530.2_BraZ1	595.159	+	467	1136	1136	1.0000000
A10	2198064	2201318	A10p04540.2_BraZ1	2841.72	-	1177	2368	3254	0.7277197
A10	2206065	2208340	A10p04550.2_BraZ1	1722.18	-	846	2214	2275	0.9731868
A10	2219493	2220846	A10p04560.2_BraZ1	978	-	113	798	1353	0.5898004
A10	2224110	2229051	A10p04570.2_BraZ1	51277.5	-	645	3964	4941	0.8022668
A10	2230723	2234441	A10p04580.2_BraZ1	1407.08	+	2271	3384	3718	0.9101667
A10	2234974	2235935	A10p04590.2_BraZ1	726	+	361	701	961	0.7294485
A10	2239021	2244143	A10p04600.2_BraZ1	6371.2	+	5193	5122	5122	1.0000000
A10	2244420	2245842	A10p04610.2_BraZ1	142.2	-	845	1422	1422	1.0000000
A10	2246731	2256776	A10p04620.2_BraZ1	4752.77	-	3538	9075	10045	0.9034345
A10	2258851	2259121	A10p04630.2_BraZ1	27	-	49	256	270	0.9481481
A10	2260494	2260891	A10p04640.2_BraZ1	848	-	42	297	397	0.7481108
A10	2274846	2275687	A10p04650.2_BraZ1	70.8	-	309	737	841	0.8763377
A10	2275700	2277216	A10p04660.2_BraZ1	436.45	+	7	187	1516	0.1233509
A10	2278594	2279881	A10p04670.2_BraZ1	1005	+	1073	1287	1287	1.0000000
A10	2284396	2284693	A10p04680.2_BraZ1	29.7	-	27	190	297	0.6397306
A10	2285455	2287176	A10p04690.2_BraZ1	1008.47	-	314	1112	1721	0.6461360
A10	2296205	2299293	A10p04700.2_BraZ1	2482.53	-	466	2223	3088	0.7198834
A10	2300782	2302300	A10p04710.2_BraZ1	151.8	+	540	1518	1518	1.0000000
A10	2303726	2305908	A10p04720.2_BraZ1	1082.05	-	2082	2002	2182	0.9175069
A10	2307869	2308503	A10p04730.2_BraZ1	36.6	-	755	634	634	1.0000000
A10	2310208	2314881	A10p04740.2_BraZ1	3187.25	+	2751	4658	4673	0.9967901
A10	2315541	2317521	A10p04750.2_BraZ1	1086.25	-	1330	1980	1980	1.0000000
A10	2319665	2320337	A10p04760.2_BraZ1	67.2	-	0	0	672	0.0000000
A10	2320356	2321866	A10p04770.2_BraZ1	224.7	+	84	602	1510	0.3986755
A10	2323607	2324367	A10p04780.2_BraZ1	470.25	-	186	211	760	0.2776316
A10	2325687	2327905	A10p04790.2_BraZ1	219	-	1686	2149	2218	0.9688909
A10	2338391	2339970	A10p04800.2_BraZ1	15663	-	469	1345	1579	0.8518049
A10	2341913	2345142	A10p04810.2_BraZ1	823.45	+	2128	3166	3229	0.9804893
A10	2343958	2347841	A10p04820.2_BraZ1	1497.3	+	1647	3513	3883	0.9047129
A10	2354232	2355018	A10p04830.2_BraZ1	347.667	+	246	769	786	0.9783715
A10	2357942	2358893	A10p04840.2_BraZ1	594	-	218	566	951	0.5951630
A10	2360034	2362350	A10p04850.2_BraZ1	343.35	+	1474	2316	2316	1.0000000
A10	2362350	2366879	A10p04860.2_BraZ1	1588.35	+	3261	4218	4529	0.9313314
A10	2374208	2375630	A10p04870.2_BraZ1	142.2	+	359	1250	1422	0.8790436
A10	2377389	2378289	A10p04880.2_BraZ1	729	+	2	265	900	0.2944444
A10	2393959	2396740	A10p04890.2_BraZ1	1023.75	+	647	2536	2781	0.9119022
A10	2412374	2413964	A10p04900.2_BraZ1	966	-	608	1579	1590	0.9930817
A10	2414813	2415793	A10p04910.2_BraZ1	846	+	923	980	980	1.0000000
A10	2416993	2417628	A10p04920.2_BraZ1	495	-	189	635	635	1.0000000
A10	2420897	2423596	A10p04930.2_BraZ1	1048.91	+	409	2466	2699	0.9136717
A10	2423844	2427456	A10p04940.2_BraZ1	1245.25	-	2506	3612	3612	1.0000000
A10	2425480	2426367	A10p04950.2_BraZ1	246	-	678	887	887	1.0000000
A10	2430608	2432763	A10p04960.2_BraZ1	2204	+	365	2101	2155	0.9749420
A10	2437964	2442476	A10p04970.2_BraZ1	1573.74	+	3790	4512	4512	1.0000000
A10	2443679	2449087	A10p04980.2_BraZ1	3557.7	+	2133	4070	5408	0.7525887
A10	2449650	2450328	A10p04990.2_BraZ1	67.8	+	273	678	678	1.0000000
A10	2451099	2455893	A10p05000.2_BraZ1	2656.45	-	1560	4596	4794	0.9586984
A10	2456733	2459023	A10p05010.2_BraZ1	464.87	-	1619	2290	2290	1.0000000
A10	2461456	2463109	A10p05020.2_BraZ1	1059.84	+	599	1542	1653	0.9328493
A10	2463919	2466540	A10p05030.2_BraZ1	986.586	-	2197	2597	2621	0.9908432
A10	2467488	2467933	A10p05040.2_BraZ1	258	+	336	445	445	1.0000000
A10	2468509	2470080	A10p05050.2_BraZ1	1179	-	2198	1571	1571	1.0000000
A10	2480003	2480561	A10p05060.2_BraZ1	55.8	+	233	221	558	0.3960573
A10	2483080	2485914	A10p05070.2_BraZ1	738	+	975	2724	2834	0.9611856
A10	2487072	2488356	A10p05080.2_BraZ1	582.276	+	332	1226	1284	0.9548287
A10	2488590	2491610	A10p05090.2_BraZ1	829.091	-	915	3002	3020	0.9940397
A10	2496562	2496775	A10p05100.2_BraZ1	21.3	-	58	213	213	1.0000000
A10	2498421	2499802	A10p05110.2_BraZ1	1290	+	348	1139	1381	0.8247647
A10	2500559	2500790	A10p05120.2_BraZ1	23.1	+	180	231	231	1.0000000
A10	2508397	2508733	A10p05130.2_BraZ1	33.6	-	393	336	336	1.0000000
A10	2512991	2513702	A10p05140.2_BraZ1	71.1	+	527	711	711	1.0000000
A10	2516036	2516899	A10p05150.2_BraZ1	252	+	1685	863	863	1.0000000
A10	2516302	2517510	A10p05160.2_BraZ1	102	+	1775	1188	1208	0.9834437
A10	2519443	2521076	A10p05170.2_BraZ1	1165	+	79	538	1633	0.3294550
A10	2521813	2524188	A10p05180.2_BraZ1	1357.2	-	13	184	2375	0.0774737
A10	2528767	2528884	A10p05190.2_BraZ1	11.7	-	12	98	117	0.8376068
A10	2533357	2534988	A10p05200.2_BraZ1	1172.5	+	237	1238	1631	0.7590435
A10	2538010	2539452	A10p05210.2_BraZ1	1305.78	-	574	1392	1442	0.9653260
A10	2543565	2544894	A10p05220.2_BraZ1	741.75	+	538	1282	1329	0.9646351
A10	2546525	2546888	A10p05230.2_BraZ1	36.3	+	450	363	363	1.0000000
A10	2549639	2552911	A10p05240.2_BraZ1	754.5	-	1466	3110	3272	0.9504890
A10	2553444	2554866	A10p05250.2_BraZ1	596.6	+	360	1137	1422	0.7995781
A10	2561810	2562161	A10p05260.2_BraZ1	35.1	+	435	351	351	1.0000000
A10	2568719	2569354	A10p05270.2_BraZ1	339	+	183	635	635	1.0000000
A10	2570734	2571495	A10p05280.2_BraZ1	404.25	+	681	761	761	1.0000000
A10	2583432	2585371	A10p05290.2_BraZ1	430.95	+	1	82	1939	0.0422898
A10	2590368	2592884	A10p05300.2_BraZ1	1984.89	+	591	2063	2516	0.8199523
A10	2593893	2596507	A10p05310.2_BraZ1	2350.93	-	790	2344	2614	0.8967100
A10	2596833	2597950	A10p05320.2_BraZ1	1035	+	255	937	1117	0.8388541
A10	2600895	2601924	A10p05330.2_BraZ1	102.9	-	330	1010	1029	0.9815355
A10	2604112	2604998	A10p05340.2_BraZ1	696	-	10	120	886	0.1354402
A10	2615327	2617153	A10p05350.2_BraZ1	265.743	+	138	1082	1826	0.5925520
A10	2617179	2617517	A10p05360.2_BraZ1	249	+	181	338	338	1.0000000
A10	2629667	2629979	A10p05370.2_BraZ1	31.2	+	49	312	312	1.0000000
A10	2634464	2634776	A10p05380.2_BraZ1	31.2	+	0	0	312	0.0000000
A10	2639262	2639574	A10p05390.2_BraZ1	31.2	+	0	0	312	0.0000000
A10	2644059	2644371	A10p05400.2_BraZ1	31.2	+	46	293	312	0.9391026
A10	2656769	2656898	A10p05410.2_BraZ1	12.9	-	82	129	129	1.0000000
A10	2663827	2667187	A10p05420.2_BraZ1	1859	+	1383	3322	3360	0.9886905
A10	2667858	2669746	A10p05430.2_BraZ1	369.375	+	1233	1888	1888	1.0000000
A10	2670209	2671685	A10p05440.2_BraZ1	847.059	-	360	1287	1476	0.8719512
A10	2672950	2676256	A10p05450.2_BraZ1	1809.71	+	908	3072	3306	0.9292196
A10	2679737	2681496	A10p05460.2_BraZ1	767.274	-	570	1759	1759	1.0000000
A10	2690574	2701522	A10p05470.2_BraZ1	2391	+	3855	8750	10948	0.7992327
A10	2702160	2707734	A10p05480.2_BraZ1	561.6	+	3991	5574	5574	1.0000000
A10	2708133	2710672	A10p05490.2_BraZ1	21081.7	-	1044	2539	2539	1.0000000
A10	2711635	2712811	A10p05500.2_BraZ1	117.6	-	79	823	1176	0.6998299
A10	2713780	2715656	A10p05510.2_BraZ1	883.3	-	1273	1876	1876	1.0000000
A10	2717205	2719782	A10p05520.2_BraZ1	1070.86	+	902	2189	2577	0.8494374
A10	2720054	2720318	A10p05530.2_BraZ1	26.4	-	68	264	264	1.0000000
A10	2721063	2721297	A10p05540.2_BraZ1	23.4	-	288	234	234	1.0000000
A10	2723189	2733694	A10p05550.2_BraZ1	5277.14	+	1718	6324	10505	0.6019990
A10	2734176	2734570	A10p05560.2_BraZ1	216	-	673	394	394	1.0000000
A10	2735061	2735676	A10p05570.2_BraZ1	111.079	-	740	615	615	1.0000000
A10	2736019	2737110	A10p05580.2_BraZ1	725.333	+	492	1091	1091	1.0000000
A10	2737593	2739406	A10p05590.2_BraZ1	1716	-	130	1240	1813	0.6839492
A10	2744962	2745825	A10p05600.2_BraZ1	228	-	637	681	863	0.7891077
A10	2749991	2750951	A10p05610.2_BraZ1	96	+	500	960	960	1.0000000
A10	2751235	2751673	A10p05620.2_BraZ1	351	-	102	348	438	0.7945206
A10	2752328	2755750	A10p05630.2_BraZ1	1645.73	+	2223	3381	3422	0.9880187
A10	2755894	2757306	A10p05640.2_BraZ1	1332	-	471	1390	1412	0.9844193
A10	2757919	2764890	A10p05650.2_BraZ1	2537.63	-	918	6106	6971	0.8759145
A10	2765417	2766844	A10p05660.2_BraZ1	4719	+	610	1416	1427	0.9922915
A10	2767045	2768388	A10p05670.2_BraZ1	2211	+	340	1205	1343	0.8972450
A10	2768926	2769235	A10p05680.2_BraZ1	30.9	+	5	113	309	0.3656958
A10	2771950	2773235	A10p05690.2_BraZ1	3811.5	+	534	1285	1285	1.0000000
A10	2773487	2775861	A10p05700.2_BraZ1	1504.29	-	1674	2330	2374	0.9814659
A10	2780263	2781349	A10p05710.2_BraZ1	792	+	192	871	1086	0.8020258
A10	2781643	2783117	A10p05720.2_BraZ1	528.729	-	736	1474	1474	1.0000000
A10	2783205	2788035	A10p05730.2_BraZ1	1865.14	-	2287	4614	4830	0.9552795
A10	2788522	2794187	A10p05740.2_BraZ1	3106.23	-	1065	4844	5665	0.8550750
A10	2794526	2796788	A10p05750.2_BraZ1	1397.48	+	697	1227	2262	0.5424403
A10	2798039	2798897	A10p05760.2_BraZ1	762	-	527	858	858	1.0000000
A10	2800072	2810276	A10p05770.2_BraZ1	786.429	-	7561	9408	10204	0.9219913
A10	2803643	2804745	A10p05780.2_BraZ1	672	-	853	1102	1102	1.0000000
A10	2823504	2841301	A10p05790.2_BraZ1	635.7	-	12294	12967	17797	0.7286059
A10	2842313	2843074	A10p05800.2_BraZ1	366	+	59	748	761	0.9829172
A10	2844006	2846946	A10p05810.2_BraZ1	1639.14	+	2186	2940	2940	1.0000000
A10	2847504	2847981	A10p05820.2_BraZ1	47.7	+	221	465	477	0.9748428
A10	2848371	2850580	A10p05830.2_BraZ1	18871.5	-	529	1948	2209	0.8818470
A10	2852898	2853481	A10p05840.2_BraZ1	318	+	282	535	583	0.9176672
A10	2854168	2859793	A10p05850.2_BraZ1	2680.43	-	3117	5349	5625	0.9509333
A10	2869440	2874233	A10p05860.2_BraZ1	3941.44	+	722	2898	4793	0.6046318
A10	2878691	2878805	A10p05870.2_BraZ1	11.4	-	0	0	114	0.0000000
A10	2881064	2882684	A10p05880.2_BraZ1	1048.23	+	413	1522	1620	0.9395062
A10	2883755	2885759	A10p05890.2_BraZ1	1023.92	-	492	1898	2004	0.9471058
A10	2886856	2892048	A10p05900.2_BraZ1	2737.89	-	2634	4680	5192	0.9013867
A10	2892384	2894047	A10p05910.2_BraZ1	486	+	1053	1635	1663	0.9831629
A10	2894910	2899672	A10p05920.2_BraZ1	1623.14	-	2703	4728	4762	0.9928601
A10	2904120	2904630	A10p05930.2_BraZ1	51	-	294	477	510	0.9352941
A10	2912458	2920482	A10p05940.2_BraZ1	879.467	-	5049	6676	8024	0.8320040
A10	2921156	2922949	A10p05950.2_BraZ1	1086	+	245	975	1793	0.5437814
A10	2925379	2926757	A10p05960.2_BraZ1	1077	+	599	1255	1378	0.9107402
A10	2926971	2929218	A10p05970.2_BraZ1	19734	-	588	2148	2247	0.9559413
A10	2930350	2932288	A10p05980.2_BraZ1	1129.94	+	1769	1915	1938	0.9881321
A10	2933432	2935077	A10p05990.2_BraZ1	990	-	1404	1645	1645	1.0000000
A10	2935938	2937905	A10p06000.2_BraZ1	1057.94	-	1349	1925	1967	0.9786477
A10	2940658	2941432	A10p06010.2_BraZ1	972.857	-	96	644	774	0.8320413
A10	2942066	2943711	A10p06020.2_BraZ1	711.562	-	320	1591	1645	0.9671733
A10	2944017	2944367	A10p06030.2_BraZ1	192	+	60	12	350	0.0342857
A10	2944512	2946702	A10p06040.2_BraZ1	686.918	+	2003	2188	2190	0.9990867
A10	2948704	2949301	A10p06050.2_BraZ1	59.7	-	12	122	597	0.2043551
A10	2957592	2962639	A10p06060.2_BraZ1	2071.07	-	960	4056	5047	0.8036457
A10	2966709	2970895	A10p06070.2_BraZ1	1044	-	1187	2851	4186	0.6810798
A10	2975276	2975637	A10p06080.2_BraZ1	267	+	33	348	361	0.9639889
A10	2982287	2984248	A10p06090.2_BraZ1	562.071	-	1195	1961	1961	1.0000000
A10	2989496	2991651	A10p06100.2_BraZ1	1524.92	+	197	1455	2155	0.6751740
A10	3004271	3004781	A10p06110.2_BraZ1	51	+	587	510	510	1.0000000
A10	3026601	3028077	A10p06120.2_BraZ1	711	-	787	1476	1476	1.0000000
A10	3037796	3039986	A10p06130.2_BraZ1	1239	+	743	2033	2190	0.9283105
A10	3052322	3053594	A10p06140.2_BraZ1	127.2	-	471	1272	1272	1.0000000
A10	3062684	3064335	A10p06150.2_BraZ1	1152	-	647	1651	1651	1.0000000
A10	3065364	3065718	A10p06160.2_BraZ1	33.3	+	8	185	354	0.5225989
A10	3067440	3067990	A10p06170.2_BraZ1	225	+	27	441	550	0.8018182
A10	3070194	3072745	A10p06180.2_BraZ1	1530	+	877	2446	2551	0.9588397
A10	3073109	3076446	A10p06190.2_BraZ1	17499	-	1656	3325	3337	0.9964039
A10	3084692	3086009	A10p06200.2_BraZ1	700	+	517	1290	1317	0.9794989
A10	3086401	3088644	A10p06210.2_BraZ1	1469.09	-	1275	2203	2243	0.9821668
A10	3090076	3092046	A10p06220.2_BraZ1	1590	-	1151	1970	1970	1.0000000
A10	3093481	3093685	A10p06230.2_BraZ1	20.4	+	149	204	204	1.0000000
A10	3095002	3096738	A10p06240.2_BraZ1	1537.5	-	61	1241	1736	0.7148618
A10	3097443	3098877	A10p06250.2_BraZ1	143.4	+	596	1432	1434	0.9986053
A10	3099120	3100551	A10p06260.2_BraZ1	143.1	-	514	1349	1431	0.9426974
A10	3101337	3104724	A10p06270.2_BraZ1	1042.21	-	3002	3387	3387	1.0000000
A10	3108249	3110993	A10p06280.2_BraZ1	1574.71	+	542	2265	2744	0.8254373
A10	3113467	3113811	A10p06290.2_BraZ1	258	-	7	271	344	0.7877907
A10	3115161	3117684	A10p06300.2_BraZ1	628.462	-	1568	2523	2523	1.0000000
A10	3119362	3119882	A10p06310.2_BraZ1	408	-	178	520	520	1.0000000
A10	3121405	3122194	A10p06320.2_BraZ1	708	+	338	789	789	1.0000000
A10	3122544	3123378	A10p06330.2_BraZ1	83.4	+	335	834	834	1.0000000
A10	3124240	3128228	A10p06340.2_BraZ1	425.25	-	2019	3988	3988	1.0000000
A10	3124729	3125249	A10p06350.2_BraZ1	41.4	+	375	520	520	1.0000000
A10	3129082	3129772	A10p06360.2_BraZ1	633	+	318	690	690	1.0000000
A10	3141496	3143408	A10p06370.2_BraZ1	1468.75	+	840	1912	1912	1.0000000
A10	3152984	3155169	A10p06380.2_BraZ1	798.607	-	2435	2185	2185	1.0000000
A10	3157166	3157792	A10p06390.2_BraZ1	937.5	-	793	626	626	1.0000000
A10	3159760	3160063	A10p06400.2_BraZ1	30.3	+	1	11	303	0.0363036
A10	3160451	3161771	A10p06410.2_BraZ1	562.5	+	17	716	1320	0.5424243
A10	3163031	3166536	A10p06420.2_BraZ1	1120.88	+	1573	3466	3505	0.9888731
A10	3175751	3177184	A10p06430.2_BraZ1	1301.17	-	1304	1433	1433	1.0000000
A10	3180749	3182031	A10p06440.2_BraZ1	655.991	-	455	975	1282	0.7605304
A10	3182673	3183042	A10p06450.2_BraZ1	36.6	-	98	369	369	1.0000000
A10	3185221	3187336	A10p06460.2_BraZ1	761.143	-	1393	2041	2115	0.9650118
A10	3189923	3190244	A10p06470.2_BraZ1	32.1	-	72	294	321	0.9158878
A10	3196848	3197106	A10p06480.2_BraZ1	25.8	-	101	258	258	1.0000000
A10	3199918	3204053	A10p06490.2_BraZ1	1389	-	3624	4135	4135	1.0000000
A10	3206142	3206479	A10p06500.2_BraZ1	195	+	467	337	337	1.0000000
A10	3208150	3210656	A10p06510.2_BraZ1	1671.21	-	1916	2406	2506	0.9600958
A10	3211814	3213263	A10p06520.2_BraZ1	558	+	886	1449	1449	1.0000000
A10	3214073	3217900	A10p06530.2_BraZ1	2032.8	-	385	2587	3827	0.6759864
A10	3218870	3220310	A10p06540.2_BraZ1	304	+	2166	1440	1440	1.0000000
A10	3224706	3238872	A10p06550.2_BraZ1	308	+	8686	13288	14166	0.9380206
A10	3226268	3233127	A10p06560.2_BraZ1	447	+	4102	6359	6859	0.9271031
A10	3235086	3235388	A10p06570.2_BraZ1	213	+	238	302	302	1.0000000
A10	3235669	3236315	A10p06580.2_BraZ1	339.714	+	85	329	646	0.5092880
A10	3239233	3239431	A10p06590.2_BraZ1	19.8	+	216	198	198	1.0000000
A10	3242363	3243351	A10p06600.2_BraZ1	663	-	18	158	988	0.1599190
A10	3244447	3247195	A10p06610.2_BraZ1	461.25	+	1478	2640	2748	0.9606987
A10	3247768	3260984	A10p06620.2_BraZ1	1202.05	-	7807	11525	13216	0.8720490
A10	3275024	3277094	A10p06630.2_BraZ1	1276.08	-	1033	2070	2070	1.0000000
A10	3286621	3288233	A10p06640.2_BraZ1	151.5	-	2628	1612	1612	1.0000000
A10	3290169	3296414	A10p06650.2_BraZ1	366.667	-	4561	6245	6245	1.0000000
A10	3297999	3299768	A10p06660.2_BraZ1	1581.43	-	1377	1769	1769	1.0000000
A10	3300180	3300583	A10p06670.2_BraZ1	312	+	258	403	403	1.0000000
A10	3303633	3305870	A10p06680.2_BraZ1	1905.13	+	1677	2237	2237	1.0000000
A10	3311349	3311549	A10p06690.2_BraZ1	10.8	+	105	200	200	1.0000000
A10	3318690	3319140	A10p06700.2_BraZ1	405	+	577	450	450	1.0000000
A10	3319095	3321362	A10p06710.2_BraZ1	2148	+	1984	2133	2267	0.9408910
A10	3336624	3338922	A10p06720.2_BraZ1	1230	+	230	1189	2298	0.5174065
A10	3357934	3360258	A10p06730.2_BraZ1	1392.84	+	948	2150	2324	0.9251291
A10	3365433	3366783	A10p06740.2_BraZ1	1188	+	647	1350	1350	1.0000000
A10	3372265	3372769	A10p06750.2_BraZ1	50.4	-	247	494	504	0.9801587
A10	3373599	3374448	A10p06760.2_BraZ1	500.83	+	980	849	849	1.0000000
A10	3375172	3375448	A10p06770.2_BraZ1	210	-	124	209	276	0.7572464
A10	3382055	3383143	A10p06780.2_BraZ1	101.1	-	1099	1088	1088	1.0000000
A10	3391025	3392634	A10p06790.2_BraZ1	974.531	+	795	1609	1609	1.0000000
A10	3393430	3394242	A10p06800.2_BraZ1	325.286	-	1182	812	812	1.0000000
A10	3394913	3396513	A10p06810.2_BraZ1	802.56	-	520	1325	1600	0.8281250
A10	3397124	3398745	A10p06820.2_BraZ1	1155.14	-	838	1621	1621	1.0000000
A10	3411344	3412016	A10p06830.2_BraZ1	67.2	-	324	498	672	0.7410714
A10	3416113	3417349	A10p06840.2_BraZ1	619.827	+	811	1219	1236	0.9862459
A10	3422692	3423781	A10p06850.2_BraZ1	108.9	-	211	707	1089	0.6492195
A10	3434379	3435053	A10p06860.2_BraZ1	267	-	662	674	674	1.0000000
A10	3446389	3452596	A10p06870.2_BraZ1	2582.85	-	2160	5737	6207	0.9242790
A10	3468987	3474218	A10p06880.2_BraZ1	1290	-	2249	3711	5231	0.7094246
A10	3483300	3484119	A10p06890.2_BraZ1	293.333	-	957	819	819	1.0000000
A10	3492167	3492314	A10p06900.2_BraZ1	14.7	-	0	0	147	0.0000000
A10	3494841	3495373	A10p06910.2_BraZ1	1220	-	67	485	532	0.9116541
A10	3496062	3496236	A10p06920.2_BraZ1	17.4	-	31	174	174	1.0000000
A10	3503746	3506078	A10p06930.2_BraZ1	907.5	+	227	1691	2332	0.7251287
A10	3522621	3525242	A10p06940.2_BraZ1	216	+	881	2318	2621	0.8843952
A10	3525658	3526332	A10p06950.2_BraZ1	270	+	9	495	674	0.7344214
A10	3532347	3534826	A10p06960.2_BraZ1	957.231	-	34	996	2479	0.4017749
A10	3540956	3543428	A10p06970.2_BraZ1	1114.35	-	64	1325	2472	0.5360032
A10	3549596	3552080	A10p06980.2_BraZ1	1100.82	-	22	600	2484	0.2415459
A10	3558216	3560694	A10p06990.2_BraZ1	1114.35	-	120	1545	2478	0.6234867
A10	3566841	3578729	A10p07000.2_BraZ1	1114.35	-	10511	9055	11888	0.7616925
A10	3583041	3583659	A10p07010.2_BraZ1	362.25	-	26	445	618	0.7200647
A10	3587188	3588412	A10p07020.2_BraZ1	690.444	+	1098	1224	1224	1.0000000
A10	3588643	3589316	A10p07030.2_BraZ1	597	-	711	673	673	1.0000000
A10	3594289	3594448	A10p07040.2_BraZ1	15.9	-	311	159	159	1.0000000
A10	3597039	3597495	A10p07050.2_BraZ1	29.4	+	374	456	456	1.0000000
A10	3599252	3600727	A10p07060.2_BraZ1	225.6	+	328	750	1475	0.5084746
A10	3606849	3607324	A10p07070.2_BraZ1	24.9	-	276	475	475	1.0000000
A10	3610573	3611398	A10p07080.2_BraZ1	82.5	+	536	825	825	1.0000000
A10	3612835	3614857	A10p07090.2_BraZ1	1203.47	+	1554	2022	2022	1.0000000
A10	3618678	3621258	A10p07100.2_BraZ1	1248.75	-	1815	2500	2580	0.9689922
A10	3633642	3634357	A10p07110.2_BraZ1	657	+	1	29	715	0.0405594
A10	3641129	3642608	A10p07120.2_BraZ1	1131.2	-	760	1452	1479	0.9817444
A10	3692343	3692781	A10p07130.2_BraZ1	43.8	-	448	438	438	1.0000000
A10	3698069	3707243	A10p07140.2_BraZ1	42.7059	+	14052	8552	9174	0.9321997
A10	3698499	3698970	A10p07150.2_BraZ1	159	+	355	471	471	1.0000000
A10	3723234	3723708	A10p07160.2_BraZ1	399	-	495	474	474	1.0000000
A10	3723849	3724190	A10p07170.2_BraZ1	20.7	-	66	302	341	0.8856305
A10	3725942	3733050	A10p07180.2_BraZ1	278.318	+	962	5604	7108	0.7884074
A10	3735051	3737024	A10p07190.2_BraZ1	1563.47	+	372	1652	1973	0.8373036
A10	3737377	3739006	A10p07200.2_BraZ1	1178	-	573	1629	1629	1.0000000
A10	3739760	3743779	A10p07210.2_BraZ1	20791.5	+	3845	3604	4019	0.8967405
A10	3744173	3745465	A10p07220.2_BraZ1	1008	+	4669	1276	1292	0.9876161
A10	3746159	3747264	A10p07230.2_BraZ1	870	+	1669	1105	1105	1.0000000
A10	3748732	3751148	A10p07240.2_BraZ1	4510.8	-	1593	2398	2416	0.9925497
A10	3751148	3751697	A10p07250.2_BraZ1	696	-	285	524	549	0.9544626
A10	3755143	3757435	A10p07260.2_BraZ1	309	+	5622	2292	2292	1.0000000
A10	3761153	3762848	A10p07270.2_BraZ1	847	-	1249	1695	1695	1.0000000
A10	3763628	3764129	A10p07280.2_BraZ1	50.1	+	123	501	501	1.0000000
A10	3767834	3768640	A10p07290.2_BraZ1	1097.25	+	747	806	806	1.0000000
A10	3782643	3784888	A10p07300.2_BraZ1	1279.24	+	805	2022	2245	0.9006681
A10	3800703	3802638	A10p07310.2_BraZ1	834.094	-	0	0	1935	0.0000000
A10	3809467	3810137	A10p07320.2_BraZ1	56.1	+	200	670	670	1.0000000
A10	3811174	3811438	A10p07330.2_BraZ1	216	-	57	264	264	1.0000000
A10	3811780	3815498	A10p07340.2_BraZ1	1552	-	485	2838	3718	0.7633136
A10	3821240	3823176	A10p07350.2_BraZ1	797.04	-	2	117	1936	0.0604339
A10	3840005	3841073	A10p07360.2_BraZ1	990	-	199	1051	1068	0.9840824
A10	3843187	3843536	A10p07370.2_BraZ1	177	+	72	349	349	1.0000000
A10	3885528	3885716	A10p07380.2_BraZ1	153	-	17	91	188	0.4840426
A10	3900180	3901407	A10p07390.2_BraZ1	901.136	-	579	1227	1227	1.0000000
A10	3902865	3904937	A10p07400.2_BraZ1	1243	+	2307	2072	2072	1.0000000
A10	3904937	3905645	A10p07410.2_BraZ1	589.5	+	1153	708	708	1.0000000
A10	3905989	3906312	A10p07420.2_BraZ1	243	-	431	323	323	1.0000000
A10	3907522	3909248	A10p07430.2_BraZ1	1069.46	-	728	1726	1726	1.0000000
A10	3911448	3911787	A10p07440.2_BraZ1	33.9	-	341	339	339	1.0000000
A10	3925757	3927657	A10p07450.2_BraZ1	304.5	-	1256	1894	1900	0.9968421
A10	3938256	3940608	A10p07460.2_BraZ1	2280	+	1035	2074	2352	0.8818027
A10	3956335	3957512	A10p07470.2_BraZ1	399	+	551	1177	1177	1.0000000
A10	3957818	3958601	A10p07480.2_BraZ1	657	+	162	783	783	1.0000000
A10	3967506	3968166	A10p07490.2_BraZ1	66	-	518	660	660	1.0000000
A10	3974546	3976417	A10p07500.2_BraZ1	1177.38	+	1087	1871	1871	1.0000000
A10	3977532	3979151	A10p07510.2_BraZ1	1189.6	-	1366	1619	1619	1.0000000
A10	3979528	3980062	A10p07520.2_BraZ1	53.4	+	289	534	534	1.0000000
A10	3983494	3986246	A10p07530.2_BraZ1	1560.56	+	1377	2737	2752	0.9945494
A10	4022116	4024745	A10p07540.2_BraZ1	598	-	388	2567	2629	0.9764169
A10	4025311	4025658	A10p07550.2_BraZ1	19.5	+	196	347	347	1.0000000
A10	4030321	4033939	A10p07560.2_BraZ1	1308.94	+	123082	3021	3618	0.8349917
A10	4037187	4038298	A10p07570.2_BraZ1	304.575	-	452	1072	1111	0.9648965
A10	4041121	4042469	A10p07580.2_BraZ1	507	-	917	1348	1348	1.0000000
A10	4055214	4055830	A10p07590.2_BraZ1	378	+	152	544	616	0.8831169
A10	4061333	4061816	A10p07600.2_BraZ1	48.3	+	56	483	483	1.0000000
A10	4065100	4066276	A10p07610.2_BraZ1	1263.75	-	227	1037	1176	0.8818027
A10	4066827	4067192	A10p07620.2_BraZ1	213	-	69	365	365	1.0000000
A10	4076495	4076933	A10p07630.2_BraZ1	22.5	+	11	239	438	0.5456621
A10	4101711	4101966	A10p07640.2_BraZ1	17.1	+	270	255	255	1.0000000
A10	4103726	4108456	A10p07650.2_BraZ1	1253.2	+	2944	4652	4730	0.9835095
A10	4111050	4112280	A10p07660.2_BraZ1	429	+	798	1230	1230	1.0000000
A10	4140055	4148200	A10p07670.2_BraZ1	1082.4	-	3527	7843	8145	0.9629220
A10	4151555	4152025	A10p07680.2_BraZ1	450	-	13	39	470	0.0829787
A10	4167390	4173185	A10p07690.2_BraZ1	516	+	6517	5795	5795	1.0000000
A10	4190156	4192374	A10p07700.2_BraZ1	1237.5	-	1979	2218	2218	1.0000000
A10	4195843	4196242	A10p07710.2_BraZ1	309	+	374	399	399	1.0000000
A10	4221404	4221846	A10p07720.2_BraZ1	354	+	163	431	442	0.9751131
A10	4222007	4225813	A10p07730.2_BraZ1	2010.25	-	858	3083	3806	0.8100368
A10	4233741	4234015	A10p07740.2_BraZ1	234	+	20	49	274	0.1788321
A10	4242028	4243758	A10p07750.2_BraZ1	853.141	-	1029	1716	1730	0.9919075
A10	4248494	4250932	A10p07760.2_BraZ1	690	+	3339	2438	2438	1.0000000
A10	4254443	4259888	A10p07770.2_BraZ1	398.025	-	3563	5230	5445	0.9605142
A10	4259964	4260558	A10p07780.2_BraZ1	59.4	-	556	594	594	1.0000000
A10	4262000	4262384	A10p07790.2_BraZ1	38.4	-	894	384	384	1.0000000
A10	4267335	4268875	A10p07800.2_BraZ1	678.6	-	294	1314	1540	0.8532467
A10	4269643	4270795	A10p07810.2_BraZ1	774	-	921	1152	1152	1.0000000
A10	4271252	4271543	A10p07820.2_BraZ1	14.7	+	0	0	291	0.0000000
A10	4284810	4286456	A10p07830.2_BraZ1	543.95	+	594	1609	1646	0.9775212
A10	4286861	4287084	A10p07840.2_BraZ1	12.3	+	273	223	223	1.0000000
A10	4291346	4298556	A10p07850.2_BraZ1	2203.78	-	2598	6183	7210	0.8575590
A10	4299399	4299789	A10p07860.2_BraZ1	183	+	90	390	390	1.0000000
A10	4926682	4927822	A10p07870.2_BraZ1	1080	+	932	1103	1140	0.9675438
A10	4997551	4998944	A10p07880.2_BraZ1	833	-	683	1393	1393	1.0000000
A10	5034888	5036964	A10p07890.2_BraZ1	207.6	-	52	826	2076	0.3978806
A10	5048670	5050864	A10p07900.2_BraZ1	2121	-	49	868	2194	0.3956244
A10	5052704	5052907	A10p07910.2_BraZ1	15.3	-	286	203	203	1.0000000
A10	5055121	5056091	A10p07920.2_BraZ1	246	+	1396	970	970	1.0000000
A10	5064405	5071864	A10p07930.2_BraZ1	246	+	14275	5692	7459	0.7631050
A10	5072151	5072496	A10p07940.2_BraZ1	18	+	423	345	345	1.0000000
A10	5072938	5073253	A10p07950.2_BraZ1	31.5	+	359	286	315	0.9079365
A10	5077305	5077509	A10p07960.2_BraZ1	20.4	-	55	204	204	1.0000000
A10	5082314	5082589	A10p07970.2_BraZ1	168	+	225	275	275	1.0000000
A10	5110068	5112806	A10p07980.2_BraZ1	884.348	+	190	1893	2738	0.6913806
A10	5127545	5128396	A10p07990.2_BraZ1	393.75	-	1234	851	851	1.0000000
A10	5139770	5139910	A10p08000.2_BraZ1	12	-	16059	140	140	1.0000000
A10	5140058	5140590	A10p08010.2_BraZ1	272.571	+	282	532	532	1.0000000
A10	5161897	5162337	A10p08020.2_BraZ1	234	-	321	348	440	0.7909091
A10	5197981	5200182	A10p08030.2_BraZ1	885	-	249	1450	2201	0.6587915
A10	5243447	5243837	A10p08040.2_BraZ1	171	+	65	315	390	0.8076923
A10	5243528	5244564	A10p08050.2_BraZ1	306	+	197	1000	1036	0.9652510
A10	5292286	5292751	A10p08060.2_BraZ1	333	-	397	465	465	1.0000000
A10	5292823	5292985	A10p08070.2_BraZ1	16.2	-	122	162	162	1.0000000
A10	5294234	5294628	A10p08080.2_BraZ1	157.368	+	154	394	394	1.0000000
A10	5294535	5295402	A10p08090.2_BraZ1	357.353	+	497	867	867	1.0000000
A10	5296049	5296274	A10p08100.2_BraZ1	126	+	240	225	225	1.0000000
A10	5297032	5297536	A10p08110.2_BraZ1	50.4	-	400	504	504	1.0000000
A10	5300428	5301189	A10p08120.2_BraZ1	58.2	+	56	533	761	0.7003942
A10	5302346	5303832	A10p08130.2_BraZ1	867	+	159	874	1486	0.5881561
A10	5307779	5344247	A10p08140.2_BraZ1	1139.28	+	31745	36229	36468	0.9934463
A10	5354674	5354993	A10p08150.2_BraZ1	264	-	53	115	319	0.3605016
A10	5361873	5364360	A10p08160.2_BraZ1	1592.37	-	176	1609	2487	0.6469642
A10	5373407	5373714	A10p08170.2_BraZ1	30.3	-	74	307	307	1.0000000
A10	5384884	5385401	A10p08180.2_BraZ1	324	+	15	197	517	0.3810445
A10	5385790	5387036	A10p08190.2_BraZ1	372	+	290	910	1246	0.7303371
A10	5400993	5402444	A10p08200.2_BraZ1	1239	+	252	1204	1451	0.8297726
A10	5402787	5408288	A10p08210.2_BraZ1	2026.86	-	2756	5499	5501	0.9996364
A10	5412972	5414094	A10p08220.2_BraZ1	1145.62	+	723	1012	1122	0.9019608
A10	5419241	5421038	A10p08230.2_BraZ1	1628.25	+	345	1120	1797	0.6232610
A10	5421955	5422336	A10p08240.2_BraZ1	281.455	-	530	381	381	1.0000000
A10	5431141	5431372	A10p08250.2_BraZ1	23.1	+	0	0	231	0.0000000
A10	5433346	5435398	A10p08260.2_BraZ1	1691.29	+	1146	2052	2052	1.0000000
A10	5435563	5443227	A10p08270.2_BraZ1	520.8	-	18445	7308	7664	0.9535491
A10	5444405	5451930	A10p08280.2_BraZ1	1424.23	+	2982	7123	7525	0.9465781
A10	5454489	5458350	A10p08290.2_BraZ1	1452.83	+	2808	3644	3861	0.9437969
A10	5459410	5460908	A10p08300.2_BraZ1	831.096	-	784	1466	1498	0.9786382
A10	5486053	5488111	A10p08310.2_BraZ1	870.108	+	1019	1857	2058	0.9023324
A10	5489210	5489864	A10p08320.2_BraZ1	65.4	-	169	460	654	0.7033639
A10	5493248	5493834	A10p08330.2_BraZ1	450	+	91	440	586	0.7508532
A10	5497575	5499083	A10p08340.2_BraZ1	605	-	1022	1508	1508	1.0000000
A10	5515489	5524664	A10p08350.2_BraZ1	324	-	4134	6592	9175	0.7184741
A10	5551824	5557810	A10p08360.2_BraZ1	1320	-	592	3419	5986	0.5711660
A10	5552873	5553385	A10p08370.2_BraZ1	270	+	15	299	512	0.5839844
A10	5553249	5553537	A10p08380.2_BraZ1	201	+	14	240	288	0.8333333
A10	5554294	5555057	A10p08390.2_BraZ1	270	-	0	0	763	0.0000000
A10	5556924	5557436	A10p08400.2_BraZ1	270	+	18	327	512	0.6386719
A10	5557300	5557567	A10p08410.2_BraZ1	180	+	7	242	267	0.9063671
A10	5561775	5561979	A10p08420.2_BraZ1	20.4	+	15	88	204	0.4313726
A10	5565225	5565342	A10p08430.2_BraZ1	11.7	-	44	105	117	0.8974359
A10	5568493	5572022	A10p08440.2_BraZ1	13093.5	+	1708	2624	3529	0.7435534
A10	5572850	5574398	A10p08450.2_BraZ1	1338	-	588	1396	1548	0.9018088
A10	5662428	5662629	A10p08460.2_BraZ1	20.1	+	149	201	201	1.0000000
A10	5765047	5767506	A10p08470.2_BraZ1	429.375	-	884	1986	2459	0.8076454
A10	5813466	5818005	A10p08480.2_BraZ1	333	-	2756	4256	4539	0.9376515
A10	5813553	5814127	A10p08490.2_BraZ1	38.4	-	237	397	574	0.6916376
A10	5819724	5820890	A10p08500.2_BraZ1	990	-	843	1134	1166	0.9725558
A10	5868676	5868877	A10p08510.2_BraZ1	20.1	+	152	201	201	1.0000000
A10	5874119	5874343	A10p08520.2_BraZ1	16.2	-	156	224	224	1.0000000
A10	5908453	5909727	A10p08530.2_BraZ1	1494	-	365	808	1274	0.6342229
A10	5910247	5912862	A10p08540.2_BraZ1	1095	-	288	1999	2615	0.7644359
A10	5913293	5919623	A10p08550.2_BraZ1	266.4	+	735	1819	6330	0.2873618
A10	5914343	5916031	A10p08560.2_BraZ1	362.036	-	4	300	1688	0.1777251
A10	5916794	5917501	A10p08570.2_BraZ1	225	+	0	0	707	0.0000000
A10	5922202	5925174	A10p08580.2_BraZ1	768	+	384	1314	2972	0.4421265
A10	5929887	5930774	A10p08590.2_BraZ1	1291.5	-	78	500	887	0.5636979
A10	5949362	5949884	A10p08600.2_BraZ1	52.2	+	45	506	522	0.9693487
A10	5973635	5973945	A10p08610.2_BraZ1	180	-	13	239	310	0.7709677
A10	5984323	5984446	A10p08620.2_BraZ1	12.3	+	163	118	123	0.9593496
A10	7074358	7080061	A10p08630.2_BraZ1	273	+	1504	4621	5703	0.8102753
A10	7090103	7090646	A10p08640.2_BraZ1	54.3	+	141	460	543	0.8471455
A10	7091520	7091924	A10p08650.2_BraZ1	336	+	85	391	404	0.9678218
A10	7108298	7109003	A10p08660.2_BraZ1	612	-	0	0	705	0.0000000
A10	7115535	7116264	A10p08670.2_BraZ1	621	-	131	98	729	0.1344307
A10	7119594	7119977	A10p08680.2_BraZ1	354	-	0	0	383	0.0000000
A10	7122366	7122881	A10p08690.2_BraZ1	27.9	-	507	435	515	0.8446602
A10	7124390	7125081	A10p08700.2_BraZ1	324	-	2	19	691	0.0274964
A10	7128240	7130169	A10p08710.2_BraZ1	360	+	194	301	1929	0.1560394
A10	7283333	7284304	A10p08720.2_BraZ1	309	+	673	936	971	0.9639547
A10	7287257	7287730	A10p08730.2_BraZ1	387	+	20	456	473	0.9640592
A10	7308132	7311247	A10p08740.2_BraZ1	3027	-	82	847	3115	0.2719101
A10	7312609	7313311	A10p08750.2_BraZ1	570	-	72	674	702	0.9601139
A10	7316222	7316444	A10p08760.2_BraZ1	22.2	+	28	145	222	0.6531532
A10	7316606	7317101	A10p08770.2_BraZ1	49.5	+	58	329	495	0.6646464
A10	7328936	7329407	A10p08780.2_BraZ1	47.1	+	449	442	471	0.9384289
A10	7374714	7374927	A10p08790.2_BraZ1	21.3	-	6	32	213	0.1502347
A10	7376702	7377089	A10p08800.2_BraZ1	38.7	-	9	92	387	0.2377261
A10	7378195	7378716	A10p08810.2_BraZ1	497	+	48	238	521	0.4568138
A10	7382779	7385785	A10p08820.2_BraZ1	1035	-	487	1967	3006	0.6543580
A10	7394744	7399534	A10p08830.2_BraZ1	1773.67	-	1329	4147	4790	0.8657620
A10	7403460	7405433	A10p08840.2_BraZ1	514.25	-	392	1155	1973	0.5854030
A10	7406311	7407263	A10p08850.2_BraZ1	80.7	-	295	952	952	1.0000000
A10	7408095	7408379	A10p08860.2_BraZ1	246	-	1	87	284	0.3063380
A10	7412994	7416087	A10p08870.2_BraZ1	2019.12	-	303	2635	3093	0.8519237
A10	7425288	7441798	A10p08880.2_BraZ1	1817.77	-	10741	16350	16510	0.9903089
A10	7469181	7469422	A10p08890.2_BraZ1	207	-	188	241	241	1.0000000
A10	7472326	7475795	A10p08900.2_BraZ1	1716.23	-	719	2780	3469	0.8013837
A10	7496254	7496434	A10p08910.2_BraZ1	18	+	289	180	180	1.0000000
A10	7497583	7500333	A10p08920.2_BraZ1	808.994	-	1178	2191	2750	0.7967273
A10	7503423	7506439	A10p08930.2_BraZ1	2053.54	+	485	2652	3016	0.8793104
A10	7511754	7513605	A10p08940.2_BraZ1	1446	+	626	1837	1851	0.9924365
A10	7517075	7517384	A10p08950.2_BraZ1	30.9	-	224	309	309	1.0000000
A10	7517783	7530291	A10p08960.2_BraZ1	880.25	-	11069	12176	12508	0.9734570
A10	7533531	7535248	A10p08970.2_BraZ1	931.444	-	887	1717	1717	1.0000000
A10	7552621	7553163	A10p08980.2_BraZ1	333	+	7	183	542	0.3376384
A10	7555949	7556737	A10p08990.2_BraZ1	315	-	37	623	788	0.7906091
A10	7561272	7561446	A10p09000.2_BraZ1	17.4	-	42	174	174	1.0000000
A10	7562006	7563694	A10p09010.2_BraZ1	464.333	+	48	1004	1688	0.5947867
A10	7566348	7566924	A10p09020.2_BraZ1	57.6	+	246	545	576	0.9461806
A10	7568623	7570034	A10p09030.2_BraZ1	736	-	1028	1411	1411	1.0000000
A10	7570830	7571487	A10p09040.2_BraZ1	261	-	42	355	657	0.5403349
A10	7579355	7580003	A10p09050.2_BraZ1	333	-	39	260	648	0.4012346
A10	7584157	7584331	A10p09060.2_BraZ1	17.4	-	82	174	174	1.0000000
A10	7584890	7586579	A10p09070.2_BraZ1	525.25	+	899	1600	1689	0.9473061
A10	7589229	7589805	A10p09080.2_BraZ1	57.6	+	52	519	576	0.9010417
A10	7590948	7592312	A10p09090.2_BraZ1	533.333	-	91	1006	1364	0.7375367
A10	7611032	7611674	A10p09100.2_BraZ1	327	-	11	431	642	0.6713396
A10	7614278	7614452	A10p09110.2_BraZ1	17.4	-	5	127	174	0.7298850
A10	7615066	7615372	A10p09120.2_BraZ1	30.6	+	1	137	306	0.4477124
A10	7617373	7617716	A10p09130.2_BraZ1	189	-	0	0	343	0.0000000
A10	7619397	7619973	A10p09140.2_BraZ1	57.6	+	31	386	576	0.6701389
A10	7621670	7623082	A10p09150.2_BraZ1	640	-	500	865	1412	0.6126062
A10	7633038	7633837	A10p09160.2_BraZ1	315	+	134	593	799	0.7421777
A10	7638462	7639113	A10p09170.2_BraZ1	336	-	75	447	651	0.6866360
A10	7641404	7641578	A10p09180.2_BraZ1	17.4	-	93	174	174	1.0000000
A10	7642139	7642445	A10p09190.2_BraZ1	30.6	+	1	20	306	0.0653595
A10	7644427	7649673	A10p09200.2_BraZ1	324	-	668	3650	5246	0.6957682
A10	7646468	7647044	A10p09210.2_BraZ1	57.6	+	127	489	576	0.8489583
A10	7662381	7663032	A10p09220.2_BraZ1	336	-	16	419	651	0.6436252
A10	7665306	7665480	A10p09230.2_BraZ1	16.8	-	4	152	174	0.8735632
A10	7666040	7667723	A10p09240.2_BraZ1	594	+	337	1467	1683	0.8716577
A10	7668331	7673582	A10p09250.2_BraZ1	162	-	568	3222	5251	0.6135974
A10	7670372	7670948	A10p09260.2_BraZ1	57.6	+	1	76	576	0.1319444
A10	7680598	7680906	A10p09270.2_BraZ1	210	+	0	0	308	0.0000000
A10	7687300	7687474	A10p09280.2_BraZ1	17.4	-	66	173	174	0.9942529
A10	7688034	7689718	A10p09290.2_BraZ1	594	+	36	1257	1684	0.7464371
A10	7690325	7690669	A10p09300.2_BraZ1	192	-	8	209	344	0.6075581
A10	7692367	7692943	A10p09310.2_BraZ1	57.6	+	25	474	576	0.8229167
A10	7694658	7696055	A10p09320.2_BraZ1	320	-	11	750	1397	0.5368647
A10	7704829	7705318	A10p09330.2_BraZ1	237	+	3	335	489	0.6850716
A10	7707853	7708636	A10p09340.2_BraZ1	315	-	115	625	783	0.7982120
A10	7713417	7715112	A10p09350.2_BraZ1	511.875	+	235	1474	1695	0.8696165
A10	7715719	7716063	A10p09360.2_BraZ1	192	-	130	344	344	1.0000000
A10	7717757	7718333	A10p09370.2_BraZ1	57.6	+	902	576	576	1.0000000
A10	7721051	7724745	A10p09380.2_BraZ1	2464.29	-	1314	2900	3694	0.7850568
A10	7725034	7725603	A10p09390.2_BraZ1	486	+	364	569	569	1.0000000
A10	7729959	7730425	A10p09400.2_BraZ1	213	-	207	466	466	1.0000000
A10	7750932	7752897	A10p09410.2_BraZ1	1116.13	+	336	1871	1965	0.9521629
A10	7753982	7754576	A10p09420.2_BraZ1	59.4	-	1132	594	594	1.0000000
A10	7757722	7759395	A10p09430.2_BraZ1	1177.31	+	1349	1673	1673	1.0000000
A10	7760001	7761985	A10p09440.2_BraZ1	1638	-	328	1655	1984	0.8341734
A10	7768194	7770329	A10p09450.2_BraZ1	1623	-	383	1378	2135	0.6454332
A10	7776684	7777130	A10p09460.2_BraZ1	405	+	217	446	446	1.0000000
A10	7786186	7787060	A10p09470.2_BraZ1	539.5	-	415	874	874	1.0000000
A10	7787641	7789038	A10p09480.2_BraZ1	75	-	1084	1397	1397	1.0000000
A10	7789882	7790974	A10p09490.2_BraZ1	580.718	+	384	1092	1092	1.0000000
A10	7802193	7802928	A10p09500.2_BraZ1	645	-	1	35	735	0.0476190
A10	7811901	7812465	A10p09510.2_BraZ1	432	-	56	564	564	1.0000000
A10	7814530	7815820	A10p09520.2_BraZ1	129	-	981	1290	1290	1.0000000
A10	7816897	7817286	A10p09530.2_BraZ1	213.6	-	339	389	389	1.0000000
A10	7830834	7832525	A10p09540.2_BraZ1	906	+	1022	1382	1691	0.8172679
A10	7837253	7839290	A10p09550.2_BraZ1	470.087	-	1323	2014	2037	0.9887089
A10	7843612	7844323	A10p09560.2_BraZ1	8432	+	317	711	711	1.0000000
A10	7851481	7854189	A10p09570.2_BraZ1	2355.16	+	348	2419	2708	0.8932792
A10	7859675	7859954	A10p09580.2_BraZ1	27.9	+	566	279	279	1.0000000
A10	7861803	7864025	A10p09590.2_BraZ1	1274.64	-	591	2220	2222	0.9990999
A10	7877127	7879011	A10p09600.2_BraZ1	188.1	+	1203	1875	1884	0.9952229
A10	7880902	7890274	A10p09610.2_BraZ1	3001.91	+	1519	6468	9372	0.6901408
A10	7894404	7895437	A10p09620.2_BraZ1	963	+	183	941	1033	0.9109390
A10	7896010	7897520	A10p09630.2_BraZ1	626.365	-	1215	1460	1510	0.9668874
A10	7906460	7907367	A10p09640.2_BraZ1	327	+	532	885	907	0.9757442
A10	7910716	7914720	A10p09650.2_BraZ1	630	-	153	2992	4004	0.7472528
A10	7911204	7911759	A10p09660.2_BraZ1	55.5	+	30	552	555	0.9945946
A10	7915744	7916437	A10p09670.2_BraZ1	69	+	49	442	693	0.6378067
A10	7918009	7919685	A10p09680.2_BraZ1	1326.86	+	481	1643	1676	0.9803103
A10	7923803	7924378	A10p09690.2_BraZ1	697.5	+	1444	575	575	1.0000000
A10	7926696	7927003	A10p09700.2_BraZ1	25.2	+	316	307	307	1.0000000
A10	7930313	7932641	A10p09710.2_BraZ1	232.8	+	244	1459	2328	0.6267182
A10	7938706	7942321	A10p09720.2_BraZ1	2828.34	+	0	0	3615	0.0000000
A10	7943061	7943633	A10p09730.2_BraZ1	225.136	+	0	0	572	0.0000000
A10	7944725	7946377	A10p09740.2_BraZ1	1008	-	26	448	1652	0.2711864
A10	7947248	7949823	A10p09750.2_BraZ1	746.2	-	2	50	2575	0.0194175
A10	7956315	7959579	A10p09760.2_BraZ1	567	+	1394	2864	3264	0.8774510
A10	7979574	7988549	A10p09770.2_BraZ1	2789.82	+	169	2845	8975	0.3169917
A10	7997584	7998982	A10p09780.2_BraZ1	1091.05	-	36	707	1398	0.5057225
A10	8022699	8027073	A10p09790.2_BraZ1	1761.23	-	2051	3598	4374	0.8225880
A10	8034351	8035806	A10p09800.2_BraZ1	951.867	+	634	1415	1455	0.9725086
A10	8036378	8037356	A10p09810.2_BraZ1	388.125	+	1485	978	978	1.0000000
A10	8057670	8059323	A10p09820.2_BraZ1	1429.14	+	673	1519	1653	0.9189353
A10	8071912	8074285	A10p09830.2_BraZ1	478.118	-	1363	2343	2373	0.9873578
A10	8078403	8081923	A10p09840.2_BraZ1	633.321	-	1188	3342	3520	0.9494318
A10	8090027	8091174	A10p09850.2_BraZ1	678.04	+	462	1064	1147	0.9276373
A10	8091407	8092586	A10p09860.2_BraZ1	872.1	-	5	182	1179	0.1543681
A10	8105711	8105870	A10p09870.2_BraZ1	15.9	-	431	159	159	1.0000000
A10	8105877	8110764	A10p09880.2_BraZ1	1105.31	-	1550	3572	4887	0.7309188
A10	8113225	8113702	A10p09890.2_BraZ1	258	+	2	20	477	0.0419287
A10	8120373	8120750	A10p09900.2_BraZ1	3150	+	286	377	377	1.0000000
A10	8121437	8122841	A10p09910.2_BraZ1	920.795	+	1068	1386	1404	0.9871795
A10	8123375	8126400	A10p09920.2_BraZ1	2937	+	641	1145	3025	0.3785124
A10	8126743	8128763	A10p09930.2_BraZ1	1000.58	-	1366	2020	2020	1.0000000
A10	8131766	8132429	A10p09940.2_BraZ1	66.3	-	246	547	663	0.8250377
A10	8136361	8137075	A10p09950.2_BraZ1	71.4	-	195	427	714	0.5980392
A10	8152980	8156718	A10p09960.2_BraZ1	666.643	-	1980	3443	3738	0.9210808
A10	8162378	8162865	A10p09970.2_BraZ1	924	+	687	487	487	1.0000000
A10	8163716	8164089	A10p09980.2_BraZ1	147	+	2428	373	373	1.0000000
A10	8167911	8168700	A10p09990.2_BraZ1	277.5	+	172	789	789	1.0000000
A10	8168869	8169178	A10p10000.2_BraZ1	30.9	+	338	309	309	1.0000000
A10	8169750	8170309	A10p10010.2_BraZ1	255	+	9	32	559	0.0572451
A10	8172988	8173276	A10p10020.2_BraZ1	28.8	+	48	288	288	1.0000000
A10	8175946	8176560	A10p10030.2_BraZ1	162	-	5	74	614	0.1205212
A10	8189145	8192126	A10p10040.2_BraZ1	1972.64	+	664	2659	2981	0.8919826
A10	8192325	8193642	A10p10050.2_BraZ1	131.7	-	196	1225	1317	0.9301443
A10	8201607	8204411	A10p10060.2_BraZ1	976.597	-	1330	2804	2804	1.0000000
A10	8218378	8219383	A10p10070.2_BraZ1	502.143	-	292	696	1005	0.6925373
A10	8219888	8221368	A10p10080.2_BraZ1	557.78	+	570	1145	1480	0.7736486
A10	8221730	8222259	A10p10090.2_BraZ1	384	-	133	529	529	1.0000000
A10	8222665	8224949	A10p10100.2_BraZ1	1727.05	-	1141	2267	2284	0.9925569
A10	8245515	8246472	A10p10110.2_BraZ1	657	+	123	722	957	0.7544410
A10	8247774	8248489	A10p10120.2_BraZ1	42	+	727	715	715	1.0000000
A10	8253876	8255436	A10p10130.2_BraZ1	156	-	173	993	1560	0.6365384
A10	8269191	8269779	A10p10140.2_BraZ1	103.522	-	9	140	588	0.2380952
A10	8287199	8288662	A10p10150.2_BraZ1	1612.5	+	516	1344	1463	0.9186603
A10	8288954	8292343	A10p10160.2_BraZ1	172.42	-	2498	3371	3389	0.9946887
A10	8292597	8293905	A10p10170.2_BraZ1	4784	+	1549	1308	1308	1.0000000
A10	8294319	8295081	A10p10180.2_BraZ1	47.7	+	1089	762	762	1.0000000
A10	8301865	8302730	A10p10190.2_BraZ1	780	+	180	550	865	0.6358382
A10	8303181	8304835	A10p10200.2_BraZ1	1224	-	454	1654	1654	1.0000000
A10	8310595	8310943	A10p10210.2_BraZ1	201	+	1105	348	348	1.0000000
A10	8313004	8315791	A10p10220.2_BraZ1	1341.62	-	469	2164	2787	0.7764621
A10	8316592	8316817	A10p10230.2_BraZ1	22.5	+	77	225	225	1.0000000
A10	8320605	8320804	A10p10240.2_BraZ1	16.8	+	117	199	199	1.0000000
A10	8321808	8323587	A10p10250.2_BraZ1	856.875	+	549	1766	1779	0.9926925
A10	8324291	8324532	A10p10260.2_BraZ1	207	+	99	241	241	1.0000000
A10	8331023	8331179	A10p10270.2_BraZ1	15.6	-	393	156	156	1.0000000
A10	8340886	8342299	A10p10280.2_BraZ1	541.227	+	1009	1413	1413	1.0000000
A10	8353175	8353852	A10p10290.2_BraZ1	322.875	+	595	677	677	1.0000000
A10	8359915	8360095	A10p10300.2_BraZ1	18	+	208	180	180	1.0000000
A10	8361525	8363352	A10p10310.2_BraZ1	182.7	+	253	1176	1827	0.6436782
A10	8370133	8372638	A10p10320.2_BraZ1	943.5	+	1631	2479	2505	0.9896207
A10	8390706	8393051	A10p10330.2_BraZ1	2118	+	142	1981	2345	0.8447761
A10	8401333	8403673	A10p10340.2_BraZ1	1719	+	185	1908	2340	0.8153846
A10	8417393	8424743	A10p10350.2_BraZ1	679.2	+	4737	7138	7350	0.9711565
A10	8430907	8433225	A10p10360.2_BraZ1	3168	+	131	1887	2318	0.8140638
A10	8445640	8447895	A10p10370.2_BraZ1	1388.25	+	418	2180	2255	0.9667405
A10	8453536	8453899	A10p10380.2_BraZ1	36.3	-	988	363	363	1.0000000
A10	8463652	8465458	A10p10390.2_BraZ1	1208.07	-	1059	1806	1806	1.0000000
A10	8474368	8476924	A10p10400.2_BraZ1	746.087	-	1054	2395	2556	0.9370109
A10	8497184	8498960	A10p10410.2_BraZ1	177.6	+	129	998	1776	0.5619369
A10	8500709	8503197	A10p10420.2_BraZ1	1439.45	+	1569	2393	2488	0.9618167
A10	8503901	8505457	A10p10430.2_BraZ1	561.273	-	1463	1556	1556	1.0000000
A10	8507106	8509130	A10p10440.2_BraZ1	658.599	-	988	2011	2024	0.9935771
A10	8513272	8515479	A10p10450.2_BraZ1	671.408	+	383	1946	2207	0.8817399
A10	8516103	8516907	A10p10460.2_BraZ1	2880	-	150	804	804	1.0000000
A10	8516933	8517284	A10p10470.2_BraZ1	35.1	-	53	349	351	0.9943020
A10	8531326	8531514	A10p10480.2_BraZ1	15.9	+	43	188	188	1.0000000
A10	8531637	8532051	A10p10490.2_BraZ1	41.4	+	49	363	414	0.8768116
A10	8541438	8541852	A10p10500.2_BraZ1	41.4	+	0	0	414	0.0000000
A10	8549493	8549681	A10p10510.2_BraZ1	15.9	+	1	93	188	0.4946809
A10	8563175	8563334	A10p10520.2_BraZ1	15.9	-	196	159	159	1.0000000
A10	8568576	8571405	A10p10530.2_BraZ1	1418.87	-	53	912	2829	0.3223754
A10	8575488	8577944	A10p10540.2_BraZ1	6420.7	+	516	2111	2456	0.8595277
A10	8591523	8604433	A10p10550.2_BraZ1	664.05	+	1867	10469	12910	0.8109218
A10	8629659	8632895	A10p10560.2_BraZ1	2703.41	+	941	2696	3236	0.8331273
A10	8639836	8641262	A10p10570.2_BraZ1	510	+	899	1426	1426	1.0000000
A10	8641386	8644071	A10p10580.2_BraZ1	268.5	-	667	1512	2685	0.5631285
A10	8652585	8653203	A10p10590.2_BraZ1	299.25	+	502	577	618	0.9336569
A10	8654402	8654543	A10p10600.2_BraZ1	14.1	-	5	141	141	1.0000000
A10	8666416	8670646	A10p10610.2_BraZ1	524.333	+	2779	3759	4230	0.8886525
A10	8671614	8672715	A10p10620.2_BraZ1	918	-	304	815	1101	0.7402362
A10	8676428	8676643	A10p10630.2_BraZ1	12	-	252	215	215	1.0000000
A10	8678475	8678755	A10p10640.2_BraZ1	666	+	108	280	280	1.0000000
A10	8678587	8684134	A10p10650.2_BraZ1	804.6	+	816	4370	5547	0.7878132
A10	8678895	8679531	A10p10660.2_BraZ1	94	+	131	544	636	0.8553459
A10	8679817	8680900	A10p10670.2_BraZ1	1261	+	84	991	1083	0.9150508
A10	8720044	8724573	A10p10680.2_BraZ1	2270.11	-	2163	4490	4529	0.9913888
A10	8761945	8763399	A10p10690.2_BraZ1	717.231	-	1230	1439	1454	0.9896836
A10	8767124	8767584	A10p10700.2_BraZ1	156	+	1110	460	460	1.0000000
A10	8788070	8788655	A10p10710.2_BraZ1	58.5	-	342	585	585	1.0000000
A10	8793718	8793946	A10p10720.2_BraZ1	22.8	+	190	228	228	1.0000000
A10	8795036	8795732	A10p10730.2_BraZ1	69.6	-	79	505	696	0.7255747
A10	8798072	8798348	A10p10740.2_BraZ1	22.2	-	305	276	276	1.0000000
A10	8807716	8808061	A10p10750.2_BraZ1	34.5	+	174	270	345	0.7826087
A10	8815671	8821199	A10p10760.2_BraZ1	3258.4	-	171	2637	5528	0.4770260
A10	8821639	8824432	A10p10770.2_BraZ1	1101.08	+	1156	2762	2793	0.9889008
A10	8825269	8830394	A10p10780.2_BraZ1	1366.23	-	1715	4448	5125	0.8679025
A10	8828098	8829331	A10p10790.2_BraZ1	674.667	-	334	874	1233	0.7088403
A10	8830394	8831969	A10p10800.2_BraZ1	1284	-	978	1575	1575	1.0000000
A10	8832047	8832905	A10p10810.2_BraZ1	507	+	339	850	858	0.9906760
A10	8833565	8834797	A10p10820.2_BraZ1	629.75	-	564	1232	1232	1.0000000
A10	8835225	8836035	A10p10830.2_BraZ1	81	+	302	810	810	1.0000000
A10	8836672	8838774	A10p10840.2_BraZ1	1182.87	-	1031	2102	2102	1.0000000
A10	8840685	8842893	A10p10850.2_BraZ1	2130	+	98	1092	2208	0.4945652
A10	8851236	8852196	A10p10860.2_BraZ1	714	+	124	446	960	0.4645833
A10	8857211	8857953	A10p10870.2_BraZ1	536.25	-	0	0	742	0.0000000
A10	8859593	8860678	A10p10880.2_BraZ1	682.357	-	274	958	1085	0.8829493
A10	8876931	8877784	A10p10890.2_BraZ1	278.875	-	206	718	853	0.8417351
A10	8880828	8881513	A10p10900.2_BraZ1	216	-	41	303	685	0.4423358
A10	8883330	8886079	A10p10910.2_BraZ1	992.5	-	874	2662	2749	0.9683521
A10	8893768	8896292	A10p10920.2_BraZ1	1902.21	+	322	2163	2524	0.8569731
A10	8899124	8900179	A10p10930.2_BraZ1	657.977	+	257	779	1055	0.7383886
A10	8907280	8908950	A10p10940.2_BraZ1	2862.51	-	3	9	1670	0.0053892
A10	8909418	8914798	A10p10950.2_BraZ1	1155	+	3782	4910	5380	0.9126394
A10	8920410	8920572	A10p10960.2_BraZ1	11.7	+	159	162	162	1.0000000
A10	8921794	8923940	A10p10970.2_BraZ1	995.968	+	487	1920	2146	0.8946878
A10	8924062	8926717	A10p10980.2_BraZ1	1963.34	-	3568	2655	2655	1.0000000
A10	8930185	8930302	A10p10990.2_BraZ1	11.7	+	395	117	117	1.0000000
A10	8942619	8944749	A10p11000.2_BraZ1	213	+	75	523	2130	0.2455399
A10	8950272	8953078	A10p11010.2_BraZ1	220	+	2035	2806	2806	1.0000000
A10	8958779	8959753	A10p11020.2_BraZ1	555	+	525	974	974	1.0000000
A10	8960943	8965959	A10p11030.2_BraZ1	1181.43	-	3264	4760	5016	0.9489633
A10	8965960	8971197	A10p11040.2_BraZ1	698.762	-	2040	4745	5237	0.9060531
A10	8990947	8991979	A10p11050.2_BraZ1	351	+	145	487	1032	0.4718992
A10	8999941	9000667	A10p11060.2_BraZ1	1040	+	743	726	726	1.0000000
A10	9008082	9010032	A10p11070.2_BraZ1	979	-	401	1755	1950	0.9000000
A10	9041824	9042172	A10p11080.2_BraZ1	162	+	161	348	348	1.0000000
A10	9042075	9042465	A10p11090.2_BraZ1	204	+	64	390	390	1.0000000
A10	9056672	9057701	A10p11100.2_BraZ1	102.9	-	501	1029	1029	1.0000000
A10	9063315	9063840	A10p11110.2_BraZ1	52.5	-	143	514	525	0.9790476
A10	9063859	9064384	A10p11120.2_BraZ1	33.6	+	282	525	525	1.0000000
A10	9068087	9068385	A10p11130.2_BraZ1	192	+	21	227	298	0.7617450
A10	9070512	9071014	A10p11140.2_BraZ1	414	-	507	492	502	0.9800797
A10	9074995	9075311	A10p11150.2_BraZ1	20.7	+	26	316	316	1.0000000
A10	9076566	9077572	A10p11160.2_BraZ1	7800	+	419	999	1006	0.9930418
A10	9087227	9087767	A10p11170.2_BraZ1	238.875	+	106	245	540	0.4537037
A10	9102331	9103405	A10p11180.2_BraZ1	107.4	-	133	1074	1074	1.0000000
A10	9138026	9138350	A10p11190.2_BraZ1	32.4	+	343	324	324	1.0000000
A10	9138404	9138611	A10p11200.2_BraZ1	20.7	+	208	207	207	1.0000000
A10	9140858	9141941	A10p11210.2_BraZ1	448.91	-	444	1059	1083	0.9778394
A10	9149401	9150632	A10p11220.2_BraZ1	616.179	+	679	1231	1231	1.0000000
A10	9151095	9153280	A10p11230.2_BraZ1	927.658	-	1285	2185	2185	1.0000000
A10	9156779	9157046	A10p11240.2_BraZ1	26.7	-	75	267	267	1.0000000
A10	9159971	9163454	A10p11250.2_BraZ1	1507.3	+	1760	3384	3483	0.9715762
A10	9164694	9166553	A10p11260.2_BraZ1	1773	-	206	1540	1859	0.8284023
A10	9180257	9191569	A10p11270.2_BraZ1	1405.34	+	13989	10832	11312	0.9575672
A10	9195634	9196064	A10p11280.2_BraZ1	219	-	66	276	430	0.6418605
A10	9216315	9217925	A10p11290.2_BraZ1	18732	+	732	1538	1610	0.9552795
A10	9260917	9261718	A10p11300.2_BraZ1	1372	+	442	801	801	1.0000000
A10	9265396	9266420	A10p11310.2_BraZ1	6862.8	+	210	876	1024	0.8554688
A10	9270774	9275999	A10p11320.2_BraZ1	2385.31	+	1155	4152	5225	0.7946411
A10	9277620	9284658	A10p11330.2_BraZ1	3454.31	+	2268	4302	7038	0.6112532
A10	9291794	9293100	A10p11340.2_BraZ1	972	+	204	1127	1306	0.8629403
A10	9298274	9298939	A10p11350.2_BraZ1	255.553	+	217	663	665	0.9969925
A10	9300169	9301401	A10p11360.2_BraZ1	818.19	-	448	1182	1232	0.9594156
A10	9303072	9305263	A10p11370.2_BraZ1	1887.52	-	95	1160	2191	0.5294386
A10	9322419	9323378	A10p11380.2_BraZ1	339	+	733	959	959	1.0000000
A10	9329751	9332989	A10p11390.2_BraZ1	2077.6	+	149	1492	3238	0.4607783
A10	9337181	9355781	A10p11400.2_BraZ1	1553.66	-	1674	8343	18600	0.4485484
A10	9359125	9360556	A10p11410.2_BraZ1	519	-	96	863	1431	0.6030748
A10	9360560	9360877	A10p11420.2_BraZ1	159	-	80	174	317	0.5488959
A10	9374671	9375167	A10p11430.2_BraZ1	288	+	61	394	496	0.7943549
A10	9375268	9379823	A10p11440.2_BraZ1	1557.75	+	2212	4283	4555	0.9402854
A10	9380389	9382422	A10p11450.2_BraZ1	1373.4	-	824	1866	2033	0.9178554
A10	9384801	9386320	A10p11460.2_BraZ1	981.145	-	344	1238	1519	0.8150099
A10	9396697	9398049	A10p11470.2_BraZ1	504	-	1065	1352	1352	1.0000000
A10	9424293	9424904	A10p11480.2_BraZ1	453	+	337	595	611	0.9738134
A10	9432805	9433594	A10p11490.2_BraZ1	297.5	+	703	789	789	1.0000000
A10	9440342	9441706	A10p11500.2_BraZ1	188.077	+	1802	1364	1364	1.0000000
A10	9442743	9444260	A10p11510.2_BraZ1	196.615	+	534	1013	1517	0.6677653
A10	9445512	9447062	A10p11520.2_BraZ1	1127.08	+	1579	1549	1550	0.9993548
A10	9447239	9449380	A10p11530.2_BraZ1	27.1154	+	868	1810	2141	0.8453993
A10	9448112	9448421	A10p11540.2_BraZ1	30.9	+	44	309	309	1.0000000
A10	9455802	9456267	A10p11550.2_BraZ1	46.5	-	425	465	465	1.0000000
A10	9463808	9467214	A10p11560.2_BraZ1	1548.09	-	1411	3040	3406	0.8925426
A10	9473183	9473629	A10p11570.2_BraZ1	294	-	164	431	446	0.9663677
A10	9475254	9475896	A10p11580.2_BraZ1	64.2	-	45	518	642	0.8068536
A10	9481798	9489827	A10p11590.2_BraZ1	418.5	-	2000	6883	8029	0.8572674
A10	9497794	9501052	A10p11600.2_BraZ1	1599.31	+	176	1978	3258	0.6071209
A10	9510788	9511878	A10p11610.2_BraZ1	516	+	1777	1090	1090	1.0000000
A10	9514509	9517290	A10p11620.2_BraZ1	1500.22	+	867	2598	2781	0.9341964
A10	9517630	9520549	A10p11630.2_BraZ1	1077.91	+	1879	2919	2919	1.0000000
A10	9522837	9523099	A10p11640.2_BraZ1	165	-	163	246	262	0.9389313
A10	9523159	9523379	A10p11650.2_BraZ1	18	-	19	220	220	1.0000000
A10	9541670	9542053	A10p11660.2_BraZ1	204	+	11	271	383	0.7075718
A10	9547066	9547522	A10p11670.2_BraZ1	381	-	345	456	456	1.0000000
A10	9557041	9559007	A10p11680.2_BraZ1	1183.64	-	168	1299	1966	0.6607324
A10	9560775	9561511	A10p11690.2_BraZ1	73.2	+	19	293	736	0.3980978
A10	9569217	9572300	A10p11700.2_BraZ1	1876.16	+	439	2026	3083	0.6571521
A10	9572799	9576477	A10p11710.2_BraZ1	1264.83	-	1206	3647	3678	0.9915715
A10	9581592	9584487	A10p11720.2_BraZ1	1132.01	+	1126	2841	2895	0.9813471
A10	9593200	9594228	A10p11730.2_BraZ1	948	-	137	979	1028	0.9523346
A10	9614524	9617527	A10p11740.2_BraZ1	300.3	+	310	2365	3003	0.7875458
A10	9621000	9621739	A10p11750.2_BraZ1	393.429	-	186	739	739	1.0000000
A10	9622084	9622992	A10p11760.2_BraZ1	306	-	392	853	908	0.9394273
A10	9631716	9633061	A10p11770.2_BraZ1	369.57	-	87	537	1345	0.3992565
A10	9634766	9634952	A10p11780.2_BraZ1	18.6	-	5	185	186	0.9946237
A10	9640816	9642546	A10p11790.2_BraZ1	1107	-	28	729	1730	0.4213873
A10	9652777	9653284	A10p11800.2_BraZ1	50.7	-	10	235	507	0.4635108
A10	9657676	9658647	A10p11810.2_BraZ1	564	-	117	895	971	0.9217302
A10	9663274	9664681	A10p11820.2_BraZ1	140.7	-	1275	1054	1407	0.7491116
A10	9668369	9669602	A10p11830.2_BraZ1	123.3	-	760	1233	1233	1.0000000
A10	9669988	9670483	A10p11840.2_BraZ1	49.5	+	53	239	495	0.4828283
A10	9672397	9672565	A10p11850.2_BraZ1	16.8	+	47	168	168	1.0000000
A10	9674915	9676497	A10p11860.2_BraZ1	1491	-	397	1242	1582	0.7850822
A10	9679258	9679363	A10p11870.2_BraZ1	10.5	-	19	105	105	1.0000000
A10	9679718	9680823	A10p11880.2_BraZ1	321.6	+	251	921	1105	0.8334842
A10	9681269	9681797	A10p11890.2_BraZ1	408	-	83	439	528	0.8314394
A10	9682401	9684845	A10p11900.2_BraZ1	1056.39	-	723	2306	2444	0.9435352
A10	9690088	9691345	A10p11910.2_BraZ1	590.042	+	448	1219	1257	0.9697693
A10	9702897	9704982	A10p11920.2_BraZ1	1128.2	+	165	1113	2085	0.5338129
A10	9710361	9710997	A10p11930.2_BraZ1	63.6	+	26	264	636	0.4150943
A10	9712696	9714142	A10p11940.2_BraZ1	1256.09	+	248	1446	1446	1.0000000
A10	9715381	9716971	A10p11950.2_BraZ1	1464	-	252	1215	1590	0.7641509
A10	9723189	9723381	A10p11960.2_BraZ1	19.2	+	41	192	192	1.0000000
A10	9741497	9747237	A10p11970.2_BraZ1	1051.45	+	4068	5285	5740	0.9207317
A10	9747962	9748572	A10p11980.2_BraZ1	386.224	-	213	459	610	0.7524590
A10	9763371	9766428	A10p11990.2_BraZ1	1077.62	+	1137	2521	3057	0.8246647
A10	9768207	9770054	A10p12000.2_BraZ1	1308.83	-	355	1238	1847	0.6702761
A10	9773095	9774682	A10p12010.2_BraZ1	1488	+	68	792	1587	0.4990548
A10	9776116	9779921	A10p12020.2_BraZ1	793.571	-	1063	3139	3805	0.8249671
A10	9780617	9783918	A10p12030.2_BraZ1	2436	-	433	2367	3301	0.7170554
A10	9788846	9788969	A10p12040.2_BraZ1	12.3	-	60	123	123	1.0000000
A10	9792747	9794125	A10p12050.2_BraZ1	843	-	219	982	1378	0.7126270
A10	9794808	9801240	A10p12060.2_BraZ1	1896	-	2302	4646	6432	0.7223259
A10	9812762	9821245	A10p12070.2_BraZ1	507	+	527	3885	8483	0.4579748
A10	9819919	9820197	A10p12080.2_BraZ1	246	+	12	258	278	0.9280576
A10	9820238	9820586	A10p12090.2_BraZ1	34.8	+	8	103	348	0.2959770
A10	9826206	9830421	A10p12100.2_BraZ1	1849.09	+	394	2486	4215	0.5897983
A10	9832873	9833844	A10p12110.2_BraZ1	839.276	+	89	920	971	0.9474768
A10	9834052	9839772	A10p12120.2_BraZ1	2818.62	-	1534	4367	5720	0.7634615
A10	9848441	9848585	A10p12130.2_BraZ1	14.4	-	63	144	144	1.0000000
A10	9862771	9863834	A10p12140.2_BraZ1	975	-	135	846	1063	0.7958608
A10	9864610	9865651	A10p12150.2_BraZ1	323	+	238	811	1041	0.7790586
A10	9868753	9872332	A10p12160.2_BraZ1	1275	-	790	2856	3579	0.7979882
A10	9878233	9879392	A10p12170.2_BraZ1	4929.75	+	805	1159	1159	1.0000000
A10	9882915	9885480	A10p12180.2_BraZ1	256.5	-	212	2017	2565	0.7863548
A10	9897789	9899986	A10p12190.2_BraZ1	156.343	-	701	2079	2197	0.9462904
A10	9900942	9901268	A10p12200.2_BraZ1	58.6286	-	14	183	326	0.5613497
A10	9906287	9907833	A10p12210.2_BraZ1	1125	+	234	1268	1546	0.8201811
A10	9908532	9915489	A10p12220.2_BraZ1	3615.34	-	2513	4801	6957	0.6900963
A10	9921480	9922602	A10p12230.2_BraZ1	112.2	-	306	1081	1122	0.9634581
A10	9930552	9931632	A10p12240.2_BraZ1	108	+	727	1080	1080	1.0000000
A10	9941892	9942663	A10p12250.2_BraZ1	77.1	-	0	0	771	0.0000000
A10	9954021	9955119	A10p12260.2_BraZ1	109.8	-	860	1098	1098	1.0000000
A10	9956650	9957199	A10p12270.2_BraZ1	54.9	-	571	549	549	1.0000000
A10	9965511	9967698	A10p12280.2_BraZ1	218.7	+	276	2004	2187	0.9163237
A10	9973223	9980387	A10p12290.2_BraZ1	86.4	+	4280	6636	7164	0.9262981
A10	9980783	9981714	A10p12300.2_BraZ1	729	-	693	783	931	0.8410311
A10	9985673	9985931	A10p12310.2_BraZ1	25.8	+	53	247	258	0.9573643
A10	9985967	9988090	A10p12320.2_BraZ1	536.25	-	1630	2123	2123	1.0000000
A10	9988033	9988551	A10p12330.2_BraZ1	211.75	-	551	518	518	1.0000000
A10	9994013	9995485	A10p12340.2_BraZ1	528	+	294	1082	1472	0.7350544
A10	9997596	9999001	A10p12350.2_BraZ1	737.083	+	400	1247	1405	0.8875445
A10	9999546	10002199	A10p12360.2_BraZ1	1441.16	-	770	2528	2653	0.9528835
A10	10004771	10006931	A10p12370.2_BraZ1	312	-	2638	2160	2160	1.0000000
A10	10011336	10011964	A10p12380.2_BraZ1	42.3	-	339	628	628	1.0000000
A10	10012203	10014663	A10p12390.2_BraZ1	9043.31	-	1085	2454	2460	0.9975610
A10	10014712	10015624	A10p12400.2_BraZ1	91.2	-	853	912	912	1.0000000
A10	10019349	10020367	A10p12410.2_BraZ1	8800	-	640	1018	1018	1.0000000
A10	10020929	10022899	A10p12420.2_BraZ1	1181.44	-	1211	1914	1970	0.9715736
A10	10029094	10029408	A10p12430.2_BraZ1	192	-	337	314	314	1.0000000
A10	10033697	10034562	A10p12440.2_BraZ1	393	-	131	660	865	0.7630058
A10	10037062	10038314	A10p12450.2_BraZ1	454.103	-	1003	1252	1252	1.0000000
A10	10038790	10039096	A10p12460.2_BraZ1	201	+	58	306	306	1.0000000
A10	10039072	10039647	A10p12470.2_BraZ1	159	+	553	575	575	1.0000000
A10	10043427	10043724	A10p12480.2_BraZ1	29.7	+	100	297	297	1.0000000
A10	10048178	10050298	A10p12490.2_BraZ1	8175	-	393	1506	2120	0.7103773
A10	10057901	10058559	A10p12500.2_BraZ1	393	+	310	658	658	1.0000000
A10	10059094	10062148	A10p12510.2_BraZ1	2298.76	-	1266	2531	3054	0.8287492
A10	10072915	10073092	A10p12520.2_BraZ1	17.7	+	69	177	177	1.0000000
A10	10075778	10076308	A10p12530.2_BraZ1	201	+	327	530	530	1.0000000
A10	10076407	10083092	A10p12540.2_BraZ1	1016.19	+	2811	6658	6685	0.9959611
A10	10086728	10087448	A10p12550.2_BraZ1	72	+	90	526	720	0.7305555
A10	10098740	10102624	A10p12560.2_BraZ1	2105.18	+	583	2975	3884	0.7659629
A10	10107293	10108795	A10p12570.2_BraZ1	680.062	+	1127	1502	1502	1.0000000
A10	10109272	10111942	A10p12580.2_BraZ1	1375.26	-	375	2197	2670	0.8228464
A10	10118027	10119443	A10p12590.2_BraZ1	141.6	+	1807	1416	1416	1.0000000
A10	10123279	10124096	A10p12600.2_BraZ1	489	+	539	817	817	1.0000000
A10	10126726	10128182	A10p12610.2_BraZ1	430.667	-	22	795	1456	0.5460165
A10	10134945	10137046	A10p12620.2_BraZ1	1204.29	-	3514	2101	2101	1.0000000
A10	10139806	10140040	A10p12630.2_BraZ1	23.4	-	363	234	234	1.0000000
A10	10145886	10148732	A10p12640.2_BraZ1	15025.5	-	676	2655	2846	0.9328883
A10	10154116	10156991	A10p12650.2_BraZ1	500.4	-	687	2487	2875	0.8650435
A10	10158245	10159913	A10p12660.2_BraZ1	1068.13	+	128	986	1668	0.5911271
A10	10187333	10188383	A10p12670.2_BraZ1	2445	+	4403	1050	1050	1.0000000
A10	10191622	10200863	A10p12680.2_BraZ1	662.444	-	4730	5895	9241	0.6379180
A10	10208040	10208838	A10p12690.2_BraZ1	459	+	1378	798	798	1.0000000
A10	10213049	10213166	A10p12700.2_BraZ1	11.7	+	7	111	117	0.9487180
A10	10243937	10245906	A10p12710.2_BraZ1	13383.8	+	503	1699	1969	0.8628746
A10	10260960	10262798	A10p12720.2_BraZ1	1631	-	539	1752	1838	0.9532100
A10	10264738	10265215	A10p12730.2_BraZ1	197.143	-	422	477	477	1.0000000
A10	10265994	10266376	A10p12740.2_BraZ1	84.8571	-	377	382	382	1.0000000
A10	10272898	10275650	A10p12750.2_BraZ1	608.559	-	319	1841	2752	0.6689680
A10	10279753	10282545	A10p12760.2_BraZ1	623.25	-	1613	2792	2792	1.0000000
A10	10283736	10284264	A10p12770.2_BraZ1	52.8	-	22	62	528	0.1174242
A10	10285543	10286636	A10p12780.2_BraZ1	441	+	602	1093	1093	1.0000000
A10	10288343	10290666	A10p12790.2_BraZ1	1376.14	+	956	1837	2323	0.7907878
A10	10296804	10299273	A10p12800.2_BraZ1	1264.67	+	226	1580	2469	0.6399352
A10	10299796	10302084	A10p12810.2_BraZ1	1085.59	+	570	1942	2288	0.8487762
A10	10302740	10305701	A10p12820.2_BraZ1	2099.92	-	147	1355	2961	0.4576157
A10	10311514	10312396	A10p12830.2_BraZ1	3975	-	76	616	882	0.6984127
A10	10315677	10316486	A10p12840.2_BraZ1	420	-	253	770	809	0.9517924
A10	10317912	10319736	A10p12850.2_BraZ1	182.4	-	135	1512	1824	0.8289474
A10	10322379	10324334	A10p12860.2_BraZ1	634.95	-	757	1910	1955	0.9769821
A10	10326515	10327433	A10p12870.2_BraZ1	579	+	111	868	918	0.9455338
A10	10329212	10329844	A10p12880.2_BraZ1	522	+	323	614	632	0.9715190
A10	10335001	10336955	A10p12890.2_BraZ1	17280	-	61	681	1954	0.3485159
A10	10351854	10354182	A10p12900.2_BraZ1	1242	+	365	2027	2328	0.8707045
A10	10356646	10374499	A10p12910.2_BraZ1	3044.11	+	12267	16374	17853	0.9171568
A10	10379217	10380662	A10p12920.2_BraZ1	132.6	-	275	1180	1445	0.8166090
A10	10382521	10385028	A10p12930.2_BraZ1	1042.57	+	217	1046	2507	0.4172317
A10	10388319	10392311	A10p12940.2_BraZ1	402	-	830	3533	3992	0.8850200
A10	10399760	10400246	A10p12950.2_BraZ1	48.6	+	5	157	486	0.3230453
A10	10403280	10404389	A10p12960.2_BraZ1	43.8	+	574	1105	1109	0.9963931
A10	10404795	10407459	A10p12970.2_BraZ1	1364.85	-	1240	2505	2664	0.9403153
A10	10408282	10408740	A10p12980.2_BraZ1	348	+	191	458	458	1.0000000
A10	10410196	10410526	A10p12990.2_BraZ1	33	+	143	330	330	1.0000000
A10	10411474	10412462	A10p13000.2_BraZ1	301.875	-	670	988	988	1.0000000
A10	10423355	10425191	A10p13010.2_BraZ1	139.8	+	427	1489	1836	0.8110022
A10	10429574	10430006	A10p13020.2_BraZ1	2124	+	9	162	432	0.3750000
A10	10431608	10432941	A10p13030.2_BraZ1	640.988	+	428	1333	1333	1.0000000
A10	10434564	10436283	A10p13040.2_BraZ1	703.2	+	584	1668	1719	0.9703316
A10	10436712	10437376	A10p13050.2_BraZ1	5166	-	311	664	664	1.0000000
A10	10444351	10445239	A10p13060.2_BraZ1	467.818	+	1129	888	888	1.0000000
A10	10445242	10448182	A10p13070.2_BraZ1	75.6364	+	741	2527	2940	0.8595238
A10	10446404	10447518	A10p13080.2_BraZ1	264	-	84	817	1114	0.7333932
A10	10451323	10453570	A10p13090.2_BraZ1	1569.64	+	362	1711	2247	0.7614597
A10	10455677	10457035	A10p13100.2_BraZ1	728	+	145	1130	1358	0.8321061
A10	10457562	10461366	A10p13110.2_BraZ1	1093.7	-	438	1926	3804	0.5063092
A10	10476112	10477809	A10p13120.2_BraZ1	1159.09	-	405	1494	1697	0.8803771
A10	10478275	10482214	A10p13130.2_BraZ1	2634.2	-	918	3449	3939	0.8756030
A10	10482586	10482947	A10p13140.2_BraZ1	18.9	+	75	322	361	0.8919668
A10	10485641	10487763	A10p13150.2_BraZ1	1002.54	-	669	1729	2122	0.8147973
A10	10490232	10491336	A10p13160.2_BraZ1	110.4	-	178	544	1104	0.4927536
A10	10506562	10506871	A10p13170.2_BraZ1	30.9	-	7	53	309	0.1715210
A10	10512588	10512897	A10p13180.2_BraZ1	30.9	+	0	0	309	0.0000000
A10	10522815	10523848	A10p13190.2_BraZ1	102	-	95	692	1033	0.6698935
A10	10527276	10528290	A10p13200.2_BraZ1	101.4	-	321	924	1014	0.9112426
A10	10531219	10532254	A10p13210.2_BraZ1	103.5	-	335	653	1035	0.6309178
A10	10533879	10538778	A10p13220.2_BraZ1	3619.02	-	2206	4596	4899	0.9381506
A10	10544534	10544879	A10p13230.2_BraZ1	30.9	+	8	54	345	0.1565217
A10	10554184	10554517	A10p13240.2_BraZ1	33.3	+	461	333	333	1.0000000
A10	10555241	10558098	A10p13250.2_BraZ1	1274.29	-	1194	2558	2857	0.8953448
A10	10563516	10563935	A10p13260.2_BraZ1	345	+	23	67	419	0.1599045
A10	10568626	10572529	A10p13270.2_BraZ1	2307	+	775	3488	3903	0.8936715
A10	10573302	10575317	A10p13280.2_BraZ1	1716.8	-	888	1970	2015	0.9776675
A10	10576557	10577919	A10p13290.2_BraZ1	1113	+	942	1362	1362	1.0000000
A10	10579210	10580530	A10p13300.2_BraZ1	539.864	-	723	1320	1320	1.0000000
A10	10583089	10584277	A10p13310.2_BraZ1	118.8	+	260	1188	1188	1.0000000
A10	10584953	10589143	A10p13320.2_BraZ1	45309	-	617	3346	4190	0.7985680
A10	10595699	10596629	A10p13330.2_BraZ1	92.7	-	185	867	930	0.9322581
A10	10601688	10602948	A10p13340.2_BraZ1	125.7	-	329	1157	1260	0.9182540
A10	10604404	10605847	A10p13350.2_BraZ1	1305	-	292	1435	1443	0.9944560
A10	10608869	10609398	A10p13360.2_BraZ1	441	+	744	529	529	1.0000000
A10	10609630	10609822	A10p13370.2_BraZ1	19.2	-	229	192	192	1.0000000
A10	10615083	10616577	A10p13380.2_BraZ1	149.4	-	151	672	1494	0.4497992
A10	10624088	10625352	A10p13390.2_BraZ1	118.5	-	143	1117	1264	0.8837025
A10	10628607	10629313	A10p13400.2_BraZ1	313.391	-	33	539	706	0.7634561
A10	10647203	10647533	A10p13410.2_BraZ1	234	+	59	227	330	0.6878788
A10	10648561	10650393	A10p13420.2_BraZ1	650.875	-	366	1726	1832	0.9421397
A10	10658722	10659046	A10p13430.2_BraZ1	32.4	+	502	324	324	1.0000000
A10	10659080	10659544	A10p13440.2_BraZ1	306	+	648	464	464	1.0000000
A10	10663476	10665183	A10p13450.2_BraZ1	1132.98	+	770	1560	1707	0.9138840
A10	10665646	10668150	A10p13460.2_BraZ1	1660.15	-	2409	2504	2504	1.0000000
A10	10668280	10668515	A10p13470.2_BraZ1	18	-	118	235	235	1.0000000
A10	10669033	10670716	A10p13480.2_BraZ1	961.655	+	659	1506	1683	0.8948306
A10	10671235	10673817	A10p13490.2_BraZ1	1099.69	-	303	1751	2582	0.6781565
A10	10676346	10677538	A10p13500.2_BraZ1	118.2	-	54	621	1192	0.5209731
A10	10679173	10679704	A10p13510.2_BraZ1	321	+	453	531	531	1.0000000
A10	10680902	10681208	A10p13520.2_BraZ1	30.6	+	68	306	306	1.0000000
A10	10687409	10688561	A10p13530.2_BraZ1	1074	+	282	1116	1152	0.9687500
A10	10688935	10689598	A10p13540.2_BraZ1	454.773	-	983	663	663	1.0000000
A10	10692880	10693699	A10p13550.2_BraZ1	81.9	-	245	773	819	0.9438339
A10	10693910	10694375	A10p13560.2_BraZ1	46.5	-	346	465	465	1.0000000
A10	10704195	10704336	A10p13570.2_BraZ1	14.1	-	27	60	141	0.4255319
A10	10705035	10705539	A10p13580.2_BraZ1	50.4	+	183	504	504	1.0000000
A10	10710982	10711156	A10p13590.2_BraZ1	17.4	-	26	174	174	1.0000000
A10	10713391	10717673	A10p13600.2_BraZ1	1941.16	+	3156	4198	4282	0.9803830
A10	10718447	10718612	A10p13610.2_BraZ1	16.5	+	66	165	165	1.0000000
A10	10719201	10721205	A10p13620.2_BraZ1	200.4	-	445	1838	2004	0.9171657
A10	10722257	10724211	A10p13630.2_BraZ1	1284	-	564	1776	1954	0.9089048
A10	10727793	10730268	A10p13640.2_BraZ1	247.5	-	445	2218	2475	0.8961616
A10	10730827	10731298	A10p13650.2_BraZ1	47.1	-	233	471	471	1.0000000
A10	10732634	10734378	A10p13660.2_BraZ1	165.6	-	643	1717	1744	0.9845183
A10	10734812	10736558	A10p13670.2_BraZ1	625.177	-	336	1513	1746	0.8665521
A10	10738135	10740789	A10p13680.2_BraZ1	5557.5	+	784	2451	2654	0.9235117
A10	10741427	10742236	A10p13690.2_BraZ1	208	+	326	396	809	0.4894932
A10	10743199	10746688	A10p13700.2_BraZ1	3396	+	1268	3468	3489	0.9939811
A10	10746826	10747493	A10p13710.2_BraZ1	684	+	1070	667	667	1.0000000
A10	10751566	10760054	A10p13720.2_BraZ1	760.2	+	2556	5489	8488	0.6466777
A10	10761669	10763347	A10p13730.2_BraZ1	1106.35	+	549	1678	1678	1.0000000
A10	10763675	10765368	A10p13740.2_BraZ1	1617	-	94	930	1693	0.5493208
A10	10770594	10774011	A10p13750.2_BraZ1	735.281	-	863	2693	3417	0.7881182
A10	10774628	10776250	A10p13760.2_BraZ1	569.25	-	634	1573	1622	0.9697904
A10	10776652	10778654	A10p13770.2_BraZ1	1123.11	-	785	1976	2002	0.9870130
A10	10780992	10781488	A10p13780.2_BraZ1	237	+	581	496	496	1.0000000
A10	10781569	10781983	A10p13790.2_BraZ1	41.4	+	480	414	414	1.0000000
A10	10783985	10786387	A10p13800.2_BraZ1	2005	+	908	2201	2402	0.9163197
A10	10787706	10789737	A10p13810.2_BraZ1	20538	+	371	1685	2031	0.8296406
A10	10791571	10794174	A10p13820.2_BraZ1	1041.86	-	89	845	2603	0.3246254
A10	10801450	10802437	A10p13830.2_BraZ1	98.7	+	752	987	987	1.0000000
A10	10806651	10807626	A10p13840.2_BraZ1	97.5	+	477	938	975	0.9620513
A10	10808584	10808991	A10p13850.2_BraZ1	484	-	106	407	407	1.0000000
A10	10824702	10825962	A10p13860.2_BraZ1	946.957	+	327	1101	1260	0.8738095
A10	10827506	10828082	A10p13870.2_BraZ1	420	+	509	576	576	1.0000000
A10	10852662	10856008	A10p13880.2_BraZ1	40800	+	2291	3275	3346	0.9787806
A10	10858710	10861754	A10p13890.2_BraZ1	1376.08	-	2282	3024	3044	0.9934297
A10	10863889	10864735	A10p13900.2_BraZ1	84.6	-	164	704	846	0.8321513
A10	10869668	10870955	A10p13910.2_BraZ1	807	+	221	725	1287	0.5633256
A10	10876588	10877551	A10p13920.2_BraZ1	96.3	-	35	207	963	0.2149533
A10	10879610	10881553	A10p13930.2_BraZ1	907.636	+	1640	1943	1943	1.0000000
A10	10882330	10889964	A10p13940.2_BraZ1	3451.56	+	2411	5778	7634	0.7568771
A10	10891447	10891855	A10p13950.2_BraZ1	1029	+	429	408	408	1.0000000
A10	10900463	10901965	A10p13960.2_BraZ1	2968	-	59	971	1502	0.6464714
A10	10903737	10907523	A10p13970.2_BraZ1	342	+	44757	3040	3786	0.8029583
A10	10906189	10906720	A10p13980.2_BraZ1	53.1	+	31312	531	531	1.0000000
A10	10906981	10907287	A10p13990.2_BraZ1	30.6	+	10425	306	306	1.0000000
A10	10908476	10909454	A10p14000.2_BraZ1	97.8	-	482	965	978	0.9867076
A10	10911329	10912790	A10p14010.2_BraZ1	11760	+	57	329	1461	0.2251882
A10	10914143	10914851	A10p14020.2_BraZ1	70.8	+	209	708	708	1.0000000
A10	10915430	10917610	A10p14030.2_BraZ1	895.05	-	732	1787	2180	0.8197248
A10	10918065	10920564	A10p14040.2_BraZ1	873.519	+	1636	2325	2499	0.9303722
A10	10923984	10924873	A10p14050.2_BraZ1	442.743	+	451	889	889	1.0000000
A10	10926555	10934188	A10p14060.2_BraZ1	1575.57	+	997	5060	7633	0.6629111
A10	10929630	10930633	A10p14070.2_BraZ1	192	+	58	488	1003	0.4865404
A10	10931835	10932220	A10p14080.2_BraZ1	213	+	19	218	385	0.5662338
A10	10945005	10945347	A10p14090.2_BraZ1	34.2	+	0	0	342	0.0000000
A10	10951492	10951930	A10p14100.2_BraZ1	234	+	4	90	438	0.2054795
A10	10968271	10969349	A10p14110.2_BraZ1	423	+	28	480	1078	0.4452690
A10	10970171	10970994	A10p14120.2_BraZ1	609	-	502	823	823	1.0000000
A10	10976821	10978971	A10p14130.2_BraZ1	1245.94	+	399	1896	2150	0.8818605
A10	10982265	10983657	A10p14140.2_BraZ1	139.2	+	108	989	1392	0.7104885
A10	10985285	10986281	A10p14150.2_BraZ1	843	-	517	855	996	0.8584337
A10	10988351	10989003	A10p14160.2_BraZ1	177	-	67	401	652	0.6150306
A10	10989140	10992059	A10p14170.2_BraZ1	291.9	+	489	2647	2919	0.9068174
A10	10993142	10993709	A10p14180.2_BraZ1	56.7	-	93	486	567	0.8571429
A10	10995147	10996900	A10p14190.2_BraZ1	986.667	+	3	327	1753	0.1865374
A10	10998636	10999044	A10p14200.2_BraZ1	40.8	+	2	31	408	0.0759804
A10	11001758	11004312	A10p14210.2_BraZ1	1165.33	-	45	642	2554	0.2513704
A10	11004834	11004981	A10p14220.2_BraZ1	14.7	-	35	138	147	0.9387755
A10	11009701	11010075	A10p14230.2_BraZ1	198	-	52	304	374	0.8128342
A10	11013813	11017349	A10p14240.2_BraZ1	2124.06	-	1250	3206	3536	0.9066742
A10	11038123	11040584	A10p14250.2_BraZ1	1475.18	-	1620	2461	2461	1.0000000
A10	11048766	11051162	A10p14260.2_BraZ1	1623.82	+	31	470	2396	0.1961603
A10	11055194	11055449	A10p14270.2_BraZ1	22.5	-	556	255	255	1.0000000
A10	11057549	11057891	A10p14280.2_BraZ1	34.2	+	514	342	342	1.0000000
A10	11058187	11058490	A10p14290.2_BraZ1	30.3	+	429	303	303	1.0000000
A10	11063217	11065473	A10p14300.2_BraZ1	1959.32	+	284	1878	2256	0.8324468
A10	11065925	11067837	A10p14310.2_BraZ1	934.065	-	1658	1888	1912	0.9874477
A10	11069111	11069800	A10p14320.2_BraZ1	297	-	291	689	689	1.0000000
A10	11075394	11080228	A10p14330.2_BraZ1	1642.5	+	2037	3858	4834	0.7980968
A10	11081994	11084965	A10p14340.2_BraZ1	1577.37	-	16	490	2971	0.1649276
A10	11087075	11087387	A10p14350.2_BraZ1	31.2	-	111	245	312	0.7852564
A10	11090942	11091272	A10p14360.2_BraZ1	237	+	77	315	330	0.9545454
A10	11097505	11097835	A10p14370.2_BraZ1	237	+	3	163	330	0.4939394
A10	11101596	11111424	A10p14380.2_BraZ1	821.7	+	2006	5487	9828	0.5583028
A10	11111706	11112486	A10p14390.2_BraZ1	78	-	12	299	780	0.3833333
A10	11117573	11118657	A10p14400.2_BraZ1	105.6	+	360	1084	1084	1.0000000
A10	11119403	11121838	A10p14410.2_BraZ1	15531.4	-	1139	2263	2435	0.9293634
A10	11123117	11127438	A10p14420.2_BraZ1	1876.43	-	2391	3882	4321	0.8984032
A10	11130607	11132028	A10p14430.2_BraZ1	909.9	-	175	1251	1421	0.8803660
A10	11132970	11134108	A10p14440.2_BraZ1	5037.5	-	168	706	1138	0.6203867
A10	11140034	11142127	A10p14450.2_BraZ1	1647.3	-	161	1114	2093	0.5322503
A10	11146676	11146961	A10p14460.2_BraZ1	237	+	596	285	285	1.0000000
A10	11147028	11148612	A10p14470.2_BraZ1	943.25	+	280	1532	1584	0.9671717
A10	11149233	11150205	A10p14480.2_BraZ1	97.2	+	436	964	972	0.9917696
A10	11155631	11157890	A10p14490.2_BraZ1	1243.98	+	677	2158	2259	0.9552900
A10	11158660	11159275	A10p14500.2_BraZ1	324	+	465	615	615	1.0000000
A10	11166637	11168642	A10p14510.2_BraZ1	1736	+	276	1359	2005	0.6778055
A10	11169090	11170065	A10p14520.2_BraZ1	333	-	481	958	975	0.9825641
A10	11171637	11171978	A10p14530.2_BraZ1	258	+	490	341	341	1.0000000
A10	11177824	11178382	A10p14540.2_BraZ1	339	-	1184	558	558	1.0000000
A10	11188023	11188329	A10p14550.2_BraZ1	28.5	+	53	75	306	0.2450980
A10	11189540	11191481	A10p14560.2_BraZ1	1639.17	+	848	1909	1941	0.9835137
A10	11192750	11193050	A10p14570.2_BraZ1	30	+	238	300	300	1.0000000
A10	11203539	11204416	A10p14580.2_BraZ1	1224	-	28	570	877	0.6499430
A10	11207300	11209174	A10p14590.2_BraZ1	995.609	+	856	1804	1874	0.9626467
A10	11213061	11213244	A10p14600.2_BraZ1	18.3	+	14	120	183	0.6557377
A10	11223362	11223825	A10p14610.2_BraZ1	441	-	9	352	463	0.7602592
A10	11235417	11237621	A10p14620.2_BraZ1	1509.55	+	2564	2204	2204	1.0000000
A10	11238363	11240258	A10p14630.2_BraZ1	1109.25	-	1341	1895	1895	1.0000000
A10	11241088	11243079	A10p14640.2_BraZ1	1493.33	+	466	1911	1991	0.9598192
A10	11243573	11244529	A10p14650.2_BraZ1	46.8	-	664	956	956	1.0000000
A10	11244763	11246338	A10p14660.2_BraZ1	785.88	+	426	1450	1575	0.9206349
A10	11246381	11249333	A10p14670.2_BraZ1	1082.7	-	486	2274	2952	0.7703252
A10	11255788	11257161	A10p14680.2_BraZ1	1077	-	80	193	1373	0.1405681
A10	11259335	11261494	A10p14690.2_BraZ1	1410.09	+	380	1870	2159	0.8661417
A10	11264450	11266126	A10p14700.2_BraZ1	1091.11	+	983	1650	1676	0.9844869
A10	11266481	11266954	A10p14710.2_BraZ1	189	-	459	473	473	1.0000000
A10	11267330	11269901	A10p14720.2_BraZ1	1405.44	+	598	2293	2571	0.8918709
A10	11271127	11271832	A10p14730.2_BraZ1	10800	-	181	705	705	1.0000000
A10	11272805	11274032	A10p14740.2_BraZ1	1122	+	68	972	1227	0.7921761
A10	11274181	11279454	A10p14750.2_BraZ1	2988.68	-	898	3652	5273	0.6925849
A10	11279856	11284398	A10p14760.2_BraZ1	834.191	-	1285	3550	4542	0.7815940
A10	11286406	11288849	A10p14770.2_BraZ1	1010.74	+	1421	2330	2443	0.9537454
A10	11289737	11290753	A10p14780.2_BraZ1	927	-	405	1016	1016	1.0000000
A10	11291076	11292959	A10p14790.2_BraZ1	10548.8	-	755	1703	1883	0.9044079
A10	11295126	11306929	A10p14800.2_BraZ1	1775.86	+	6430	10610	11803	0.8989240
A10	11310983	11311148	A10p14810.2_BraZ1	16.5	+	50	165	165	1.0000000
A10	11316718	11317363	A10p14820.2_BraZ1	64.5	+	14	119	645	0.1844961
A10	11319885	11320056	A10p14830.2_BraZ1	17.1	+	195	171	171	1.0000000
A10	11335218	11336583	A10p14840.2_BraZ1	735	+	991	1365	1365	1.0000000
A10	11345445	11347290	A10p14850.2_BraZ1	301.4	+	839	1676	1845	0.9084011
A10	11367392	11369015	A10p14860.2_BraZ1	1164	-	848	1623	1623	1.0000000
A10	11379603	11380440	A10p14870.2_BraZ1	414	-	651	768	837	0.9175627
A10	11392979	11397546	A10p14880.2_BraZ1	2915.94	-	1979	4299	4567	0.9413182
A10	11402493	11405438	A10p14890.2_BraZ1	1843.2	-	1011	2301	2945	0.7813243
A10	11406818	11407817	A10p14900.2_BraZ1	1542.75	+	270	878	999	0.8788789
A10	11417611	11418672	A10p14910.2_BraZ1	1384.5	+	184	773	1061	0.7285579
A10	11419651	11420975	A10p14920.2_BraZ1	439.5	+	1088	1324	1324	1.0000000
A10	11429149	11430178	A10p14930.2_BraZ1	621.794	+	688	1029	1029	1.0000000
A10	11432745	11433459	A10p14940.2_BraZ1	71.4	-	230	714	714	1.0000000
A10	11435752	11437193	A10p14950.2_BraZ1	781.442	-	494	1040	1441	0.7217211
A10	11447248	11448416	A10p14960.2_BraZ1	289.333	-	828	1168	1168	1.0000000
A10	11449457	11450498	A10p14970.2_BraZ1	4851	+	584	1041	1041	1.0000000
A10	11451911	11454020	A10p14980.2_BraZ1	983.067	+	1043	2072	2109	0.9824561
A10	11461614	11464447	A10p14990.2_BraZ1	1560	-	121	1043	2833	0.3681610
A10	11468071	11468403	A10p15000.2_BraZ1	228	+	102	321	332	0.9668674
A10	11489591	11490713	A10p15010.2_BraZ1	112.2	-	57	702	1122	0.6256685
A10	11491601	11491898	A10p15020.2_BraZ1	18.6	+	241	297	297	1.0000000
A10	11498006	11498747	A10p15030.2_BraZ1	135	-	1274	741	741	1.0000000
A10	11498747	11498927	A10p15040.2_BraZ1	18	-	306	180	180	1.0000000
A10	11516979	11517645	A10p15050.2_BraZ1	5700	-	325	657	666	0.9864865
A10	11526891	11527101	A10p15060.2_BraZ1	21	-	280	210	210	1.0000000
A10	11534266	11540058	A10p15070.2_BraZ1	2049.6	+	2436	5662	5792	0.9775553
A10	11541165	11543519	A10p15080.2_BraZ1	1541.38	+	1034	2306	2354	0.9796092
A10	11553929	11557439	A10p15090.2_BraZ1	1525.18	+	1601	2976	3510	0.8478633
A10	11558035	11559023	A10p15100.2_BraZ1	4998	-	560	894	988	0.9048583
A10	11560017	11560436	A10p15110.2_BraZ1	324	-	18	220	419	0.5250596
A10	11561381	11561804	A10p15120.2_BraZ1	42.3	-	0	0	423	0.0000000
A10	11565614	11567214	A10p15130.2_BraZ1	1237.67	+	543	1474	1600	0.9212500
A10	11568786	11569517	A10p15140.2_BraZ1	419.75	+	1515	731	731	1.0000000
A10	11575392	11577111	A10p15150.2_BraZ1	171.9	+	123	1102	1719	0.6410704
A10	11582299	11585717	A10p15160.2_BraZ1	1670.24	+	1537	3387	3418	0.9909304
A10	11597893	11604462	A10p15170.2_BraZ1	3042.24	-	1434	4392	6569	0.6685949
A10	11610887	11612075	A10p15180.2_BraZ1	276	-	1354	1148	1188	0.9663300
A10	11623900	11624104	A10p15190.2_BraZ1	20.4	-	97	204	204	1.0000000
A10	11639719	11639896	A10p15200.2_BraZ1	17.7	-	40	177	177	1.0000000
A10	11652551	11653651	A10p15210.2_BraZ1	618	-	1693	1100	1100	1.0000000
A10	11657476	11661538	A10p15220.2_BraZ1	2970	+	523	3390	4062	0.8345643
A10	11662284	11664149	A10p15230.2_BraZ1	976.5	+	841	1806	1865	0.9683646
A10	11665233	11668004	A10p15240.2_BraZ1	663.812	+	701	2507	2771	0.9047275
A10	11668573	11675187	A10p15250.2_BraZ1	3267.03	-	2306	5925	6614	0.8958271
A10	11676763	11678467	A10p15260.2_BraZ1	341.667	+	1160	1704	1704	1.0000000
A10	11678908	11679603	A10p15270.2_BraZ1	34.8	-	258	669	695	0.9625899
A10	11686716	11688740	A10p15280.2_BraZ1	1329.75	+	1015	2016	2024	0.9960474
A10	11689492	11693244	A10p15290.2_BraZ1	1474.18	-	2547	3674	3752	0.9792111
A10	11696217	11699207	A10p15300.2_BraZ1	1528.12	+	1380	2964	2990	0.9913043
A10	11700101	11702899	A10p15310.2_BraZ1	2519.05	-	851	2562	2798	0.9156541
A10	11704082	11704620	A10p15320.2_BraZ1	438	-	650	538	538	1.0000000
A10	11715755	11717953	A10p15330.2_BraZ1	1476	+	431	1942	2198	0.8835305
A10	11721660	11722928	A10p15340.2_BraZ1	527.118	+	1128	1268	1268	1.0000000
A10	11731420	11733452	A10p15350.2_BraZ1	800	-	756	2032	2032	1.0000000
A10	11735003	11735411	A10p15360.2_BraZ1	405	-	278	408	408	1.0000000
A10	11736696	11738523	A10p15370.2_BraZ1	873.955	+	1044	1693	1827	0.9266557
A10	11738710	11741602	A10p15380.2_BraZ1	289.2	-	1351	2892	2892	1.0000000
A10	11742433	11744463	A10p15390.2_BraZ1	1127.14	-	691	2030	2030	1.0000000
A10	11746629	11747187	A10p15400.2_BraZ1	8487	-	290	558	558	1.0000000
A10	11747589	11750161	A10p15410.2_BraZ1	757.969	-	1112	2288	2572	0.8895801
A10	11751267	11756007	A10p15420.2_BraZ1	2473.71	+	841	3552	4740	0.7493671
A10	11756460	11757239	A10p15430.2_BraZ1	244.125	-	485	652	779	0.8369704
A10	11757826	11760104	A10p15440.2_BraZ1	920.178	+	1245	2248	2278	0.9868305
A10	11765893	11767954	A10p15450.2_BraZ1	303.75	+	1107	1931	2061	0.9369238
A10	11767954	11769080	A10p15460.2_BraZ1	528	+	354	864	1126	0.7673180
A10	11770756	11773298	A10p15470.2_BraZ1	804	-	1503	2542	2542	1.0000000
A10	11781468	11782870	A10p15480.2_BraZ1	763	+	726	1254	1402	0.8944365
A10	11784597	11789417	A10p15490.2_BraZ1	2644.96	-	1728	4113	4820	0.8533195
A10	11796963	11797551	A10p15500.2_BraZ1	58.8	+	790	588	588	1.0000000
A10	11798736	11800445	A10p15510.2_BraZ1	558	-	311	1056	1709	0.6179052
A10	11804767	11807528	A10p15520.2_BraZ1	1085.85	+	204	2113	2761	0.7653024
A10	11816073	11821657	A10p15530.2_BraZ1	914.571	+	3347	4973	5584	0.8905802
A10	11822307	11823950	A10p15540.2_BraZ1	717	-	498	1620	1643	0.9860012
A10	11824325	11826248	A10p15550.2_BraZ1	192.3	+	362	1501	1923	0.7805512
A10	11829372	11830914	A10p15560.2_BraZ1	154.2	-	533	1483	1542	0.9617380
A10	11832072	11832663	A10p15570.2_BraZ1	601.2	-	813	591	591	1.0000000
A10	11834247	11834850	A10p15580.2_BraZ1	262.286	-	0	0	603	0.0000000
A10	11837610	11841490	A10p15590.2_BraZ1	1062.6	-	1168	3847	3880	0.9914948
A10	11848486	11849534	A10p15600.2_BraZ1	861	-	82	710	1048	0.6774809
A10	11850491	11851900	A10p15610.2_BraZ1	855	-	355	1182	1409	0.8388928
A10	11861071	11862965	A10p15620.2_BraZ1	1353	+	1074	1894	1894	1.0000000
A10	11869844	11870774	A10p15630.2_BraZ1	93	-	71	310	930	0.3333333
A10	11877018	11877951	A10p15640.2_BraZ1	852	-	39	439	933	0.4705252
A10	11879433	11882241	A10p15650.2_BraZ1	1871.43	-	1056	2646	2808	0.9423077
A10	11883106	11887246	A10p15660.2_BraZ1	2461.68	-	3100	4112	4140	0.9932367
A10	11892722	11898261	A10p15670.2_BraZ1	1284.83	-	3006	5433	5539	0.9808630
A10	11899788	11907245	A10p15680.2_BraZ1	18.6	+	919	3910	7457	0.5243396
A10	11905015	11907059	A10p15690.2_BraZ1	104.4	-	86	665	2044	0.3253425
A10	11908465	11909144	A10p15700.2_BraZ1	453.724	-	26	300	679	0.4418262
A10	11915215	11915359	A10p15710.2_BraZ1	14.4	+	196	144	144	1.0000000
A10	11915768	11927676	A10p15720.2_BraZ1	1064.59	-	4208	10852	11908	0.9113201
A10	11930342	11930789	A10p15730.2_BraZ1	44.7	-	226	447	447	1.0000000
A10	11931488	11932112	A10p15740.2_BraZ1	62.4	+	132	349	624	0.5592949
A10	11933644	11936444	A10p15750.2_BraZ1	1161.81	+	1775	2691	2800	0.9610714
A10	11956201	11957346	A10p15760.2_BraZ1	1071	+	240	998	1145	0.8716157
A10	11962041	11964861	A10p15770.2_BraZ1	1146.03	-	942	1957	2820	0.6939716
A10	11970540	11970891	A10p15780.2_BraZ1	35.1	+	225	351	351	1.0000000
A10	11972977	11973421	A10p15790.2_BraZ1	44.4	-	33	280	444	0.6306306
A10	11979538	11979718	A10p15800.2_BraZ1	18	-	203	180	180	1.0000000
A10	11999353	12000350	A10p15810.2_BraZ1	342	+	143	921	997	0.9237713
A10	12000495	12000693	A10p15820.2_BraZ1	19.8	+	163	198	198	1.0000000
A10	12009183	12012285	A10p15830.2_BraZ1	3003.86	+	306	2173	3102	0.7005158
A10	12015526	12016723	A10p15840.2_BraZ1	460	-	612	1197	1197	1.0000000
A10	12025270	12027449	A10p15850.2_BraZ1	1474.29	-	796	2142	2179	0.9830197
A10	12031334	12031566	A10p15860.2_BraZ1	117	+	107	232	232	1.0000000
A10	12031679	12033718	A10p15870.2_BraZ1	1224.99	-	179	1448	2039	0.7101520
A10	12037849	12038335	A10p15880.2_BraZ1	48.6	-	40	173	486	0.3559671
A10	12042992	12043214	A10p15890.2_BraZ1	22.2	-	35	207	222	0.9324324
A10	12052519	12053282	A10p15900.2_BraZ1	1755	-	677	760	763	0.9960682
A10	12065583	12068808	A10p15910.2_BraZ1	1714.52	+	1044	2457	3225	0.7618605
A10	12069307	12070589	A10p15920.2_BraZ1	945	-	194	799	1282	0.6232449
A10	12072521	12073086	A10p15930.2_BraZ1	456	+	34	547	565	0.9681416
A10	12073520	12075157	A10p15940.2_BraZ1	808.962	-	589	1604	1637	0.9798412
A10	12076800	12078789	A10p15950.2_BraZ1	123	+	388	1377	1989	0.6923077
A10	12079155	12082315	A10p15960.2_BraZ1	868.269	+	1179	3152	3160	0.9974684
A10	12082542	12085169	A10p15970.2_BraZ1	903	-	831	2434	2627	0.9265321
A10	12085509	12086702	A10p15980.2_BraZ1	585	-	658	1070	1193	0.8968986
A10	12088096	12089195	A10p15990.2_BraZ1	342	-	1308	1099	1099	1.0000000
A10	12089588	12090821	A10p16000.2_BraZ1	618.545	+	753	1233	1233	1.0000000
A10	12092117	12096001	A10p16010.2_BraZ1	2632	-	958	3666	3884	0.9438723
A10	12099242	12099952	A10p16020.2_BraZ1	478.5	+	3	17	710	0.0239437
A10	12102047	12102194	A10p16030.2_BraZ1	14.7	+	87	147	147	1.0000000
A10	12102206	12104442	A10p16040.2_BraZ1	1578.67	+	672	2102	2236	0.9400716
A10	12108790	12111213	A10p16050.2_BraZ1	1318.46	+	493	2018	2423	0.8328518
A10	12116727	12117988	A10p16060.2_BraZ1	851.875	-	242	1114	1261	0.8834258
A10	12119359	12120427	A10p16070.2_BraZ1	106.8	+	194	993	1068	0.9297753
A10	12120784	12121246	A10p16080.2_BraZ1	120	-	105	215	462	0.4653680
A10	12122193	12126868	A10p16090.2_BraZ1	3474.14	+	2610	4454	4675	0.9527273
A10	12127545	12131138	A10p16100.2_BraZ1	1860.47	-	808	2424	3593	0.6746451
A10	12131859	12133286	A10p16110.2_BraZ1	600	+	711	1394	1427	0.9768746
A10	12133663	12134308	A10p16120.2_BraZ1	543	-	224	645	645	1.0000000
A10	12135864	12138005	A10p16130.2_BraZ1	1443	-	712	1994	2141	0.9313405
A10	12140690	12147522	A10p16140.2_BraZ1	2504.72	+	1661	5756	6832	0.8425059
A10	12147930	12149029	A10p16150.2_BraZ1	541.867	+	457	1099	1099	1.0000000
A10	12149342	12151868	A10p16160.2_BraZ1	1672.68	-	869	2482	2526	0.9825811
A10	12152759	12157740	A10p16170.2_BraZ1	2486.7	+	2869	4869	4981	0.9775146
A10	12158818	12164617	A10p16180.2_BraZ1	3642.95	+	2408	5146	5799	0.8873944
A10	12166569	12170562	A10p16190.2_BraZ1	1659.73	+	1814	3657	3993	0.9158527
A10	12168613	12169541	A10p16200.2_BraZ1	465.562	-	467	928	928	1.0000000
A10	12171773	12177067	A10p16210.2_BraZ1	2035.43	+	1824	4893	5294	0.9242539
A10	12183364	12185454	A10p16220.2_BraZ1	1151.26	+	768	1856	2090	0.8880383
A10	12188485	12190208	A10p16230.2_BraZ1	1647	+	536	1723	1723	1.0000000
A10	12190604	12193014	A10p16240.2_BraZ1	1229.33	-	1279	2279	2410	0.9456431
A10	12193334	12198259	A10p16250.2_BraZ1	2399.43	+	1698	4770	4925	0.9685279
A10	12198378	12199407	A10p16260.2_BraZ1	102.9	-	270	940	1029	0.9135082
A10	12200556	12202836	A10p16270.2_BraZ1	1303.94	+	484	2152	2280	0.9438596
A10	12203509	12203847	A10p16280.2_BraZ1	264	+	33	267	338	0.7899408
A10	12204246	12205635	A10p16290.2_BraZ1	138.9	-	367	1205	1389	0.8675306
A10	12209165	12209555	A10p16300.2_BraZ1	285	+	327	390	390	1.0000000
A10	12210454	12210649	A10p16310.2_BraZ1	19.5	-	18	178	195	0.9128205
A10	12210694	12219800	A10p16320.2_BraZ1	6097.15	+	1818	5467	9106	0.6003734
A10	12220654	12223088	A10p16330.2_BraZ1	1489.37	-	541	2060	2434	0.8463435
A10	12223450	12228329	A10p16340.2_BraZ1	2888.89	+	962	4353	4879	0.8921911
A10	12228475	12229210	A10p16350.2_BraZ1	487.333	-	512	735	735	1.0000000
A10	12229977	12232748	A10p16360.2_BraZ1	2523	-	198	1759	2771	0.6347889
A10	12237524	12263093	A10p16370.2_BraZ1	4064.06	-	14239	21287	25569	0.8325316
A10	12240194	12241762	A10p16380.2_BraZ1	1437	-	250	1239	1568	0.7901786
A10	12242060	12243439	A10p16390.2_BraZ1	963.164	+	270	1125	1379	0.8158085
A10	12244499	12245063	A10p16400.2_BraZ1	56.4	-	92	482	564	0.8546099
A10	12250382	12250934	A10p16410.2_BraZ1	55.2	-	123	408	552	0.7391304
A10	12266248	12266835	A10p16420.2_BraZ1	231	-	27	103	587	0.1754685
A10	12267534	12267919	A10p16430.2_BraZ1	783	-	115	371	385	0.9636363
A10	12269037	12269340	A10p16440.2_BraZ1	30.3	+	24	303	303	1.0000000
A10	12270102	12271404	A10p16450.2_BraZ1	1155	+	20	399	1302	0.3064516
A10	12272587	12275781	A10p16460.2_BraZ1	7200	-	1487	2946	3194	0.9223544
A10	12278094	12279611	A10p16470.2_BraZ1	9747	-	34	837	1517	0.5517468
A10	12284314	12285172	A10p16480.2_BraZ1	81	+	51	522	858	0.6083916
A10	12288139	12289938	A10p16490.2_BraZ1	1240.69	+	534	1618	1799	0.8993886
A10	12290513	12293983	A10p16500.2_BraZ1	2553	-	458	3053	3470	0.8798271
A10	12295587	12298504	A10p16510.2_BraZ1	318	+	0	0	2917	0.0000000
A10	12296795	12299202	A10p16520.2_BraZ1	588.6	+	0	0	2407	0.0000000
A10	12304219	12304432	A10p16530.2_BraZ1	21.3	-	0	0	213	0.0000000
A10	12307025	12309057	A10p16540.2_BraZ1	847.023	+	1115	1906	2032	0.9379922
A10	12309247	12309523	A10p16550.2_BraZ1	27.6	-	39	276	276	1.0000000
A10	12309653	12309782	A10p16560.2_BraZ1	12.9	+	27	129	129	1.0000000
A10	12310910	12311635	A10p16570.2_BraZ1	484	-	297	725	725	1.0000000
A10	12320047	12320989	A10p16580.2_BraZ1	94.2	-	613	942	942	1.0000000
A10	12326632	12327040	A10p16590.2_BraZ1	40.8	-	256	408	408	1.0000000
A10	12328097	12331630	A10p16600.2_BraZ1	2110.5	-	3574	3459	3533	0.9790546
A10	12336868	12337175	A10p16610.2_BraZ1	19.2	-	330	307	307	1.0000000
A10	12340411	12347523	A10p16620.2_BraZ1	3168.39	-	3005	6364	7112	0.8948256
A10	12350465	12352184	A10p16630.2_BraZ1	171.9	+	455	1719	1719	1.0000000
A10	12352584	12353860	A10p16640.2_BraZ1	1059	-	1228	1276	1276	1.0000000
A10	12359289	12360449	A10p16650.2_BraZ1	668.276	+	386	977	1160	0.8422414
A10	12360826	12361133	A10p16660.2_BraZ1	222	-	50	284	307	0.9250814
A10	12362152	12362681	A10p16670.2_BraZ1	33.6	-	0	0	529	0.0000000
A10	12367757	12368214	A10p16680.2_BraZ1	384	+	0	0	457	0.0000000
A10	12369075	12371481	A10p16690.2_BraZ1	1418.67	-	271	1440	2406	0.5985038
A10	12373668	12374138	A10p16700.2_BraZ1	330	+	451	462	470	0.9829787
A10	12374950	12377472	A10p16710.2_BraZ1	1383.75	-	465	2405	2522	0.9536083
A10	12378479	12380951	A10p16720.2_BraZ1	1517.14	-	217	2007	2472	0.8118932
A10	12381868	12383442	A10p16730.2_BraZ1	533.6	+	200	995	1574	0.6321474
A10	12384021	12385521	A10p16740.2_BraZ1	1029	-	829	1389	1500	0.9260000
A10	12386049	12387465	A10p16750.2_BraZ1	477	-	1527	1416	1416	1.0000000
A10	12389467	12390628	A10p16760.2_BraZ1	116.1	+	241	825	1161	0.7105943
A10	12392400	12392682	A10p16770.2_BraZ1	28.2	-	0	0	282	0.0000000
A10	12394485	12394695	A10p16780.2_BraZ1	13.2	+	0	0	210	0.0000000
A10	12401510	12402776	A10p16790.2_BraZ1	14742	+	1321	1266	1266	1.0000000
A10	12403003	12404575	A10p16800.2_BraZ1	892.387	-	1645	1572	1572	1.0000000
A10	12406960	12407218	A10p16810.2_BraZ1	25.8	+	77	258	258	1.0000000
A10	12411886	12412383	A10p16820.2_BraZ1	25.5	-	79	444	497	0.8933601
A10	12425061	12428653	A10p16830.2_BraZ1	1722	+	694	2446	3592	0.6809577
A10	12433058	12433500	A10p16840.2_BraZ1	30.6	+	1627	365	442	0.8257918
A10	12434108	12437554	A10p16850.2_BraZ1	2264.9	-	1596	2922	3446	0.8479396
A10	12440283	12440520	A10p16860.2_BraZ1	23.7	-	360	237	237	1.0000000
A10	12442285	12443046	A10p16870.2_BraZ1	1813.5	-	0	0	761	0.0000000
A10	12444101	12451833	A10p16880.2_BraZ1	1217.41	-	793	3794	7732	0.4906881
A10	12447866	12448904	A10p16890.2_BraZ1	468	+	13	196	1038	0.1888247
A10	12454351	12458320	A10p16900.2_BraZ1	3675	+	1021	3528	3969	0.8888889
A10	12459704	12460613	A10p16910.2_BraZ1	90.9	+	124	793	909	0.8723872
A10	12461345	12462591	A10p16920.2_BraZ1	870	-	419	1241	1246	0.9959872
A10	12472879	12475514	A10p16930.2_BraZ1	1698	-	167	1259	2635	0.4777988
A10	12477688	12478149	A10p16940.2_BraZ1	225.5	+	547	461	461	1.0000000
A10	12479041	12480586	A10p16950.2_BraZ1	154.5	-	1451	1545	1545	1.0000000
A10	12486867	12489973	A10p16960.2_BraZ1	1292.92	+	1018	2187	3106	0.7041211
A10	12490554	12492209	A10p16970.2_BraZ1	1470	-	927	1655	1655	1.0000000
A10	12493664	12495107	A10p16980.2_BraZ1	144.3	-	365	1434	1443	0.9937630
A10	12497859	12499194	A10p16990.2_BraZ1	133.5	-	522	1335	1335	1.0000000
A10	12503027	12505605	A10p17000.2_BraZ1	1659	+	834	2461	2578	0.9546160
A10	12505850	12508723	A10p17010.2_BraZ1	935.313	-	2215	2873	2873	1.0000000
A10	12516665	12519377	A10p17020.2_BraZ1	1604.88	+	3948	2712	2712	1.0000000
A10	12525229	12525852	A10p17030.2_BraZ1	471	+	0	0	623	0.0000000
A10	12532619	12533173	A10p17040.2_BraZ1	182.5	+	238	400	554	0.7220216
A10	12542090	12543332	A10p17050.2_BraZ1	7659	+	246	1079	1242	0.8687600
A10	12543731	12544838	A10p17060.2_BraZ1	628.172	-	373	1018	1107	0.9196025
A10	12544654	12545936	A10p17070.2_BraZ1	496.172	-	805	1282	1282	1.0000000
A10	12546233	12547974	A10p17080.2_BraZ1	699	+	12	60	1741	0.0344630
A10	12560385	12571855	A10p17090.2_BraZ1	3172.71	-	3882	8866	11470	0.7729730
A10	12566902	12569011	A10p17100.2_BraZ1	210	+	93	1281	2109	0.6073968
A10	12572942	12573908	A10p17110.2_BraZ1	511.705	-	738	966	966	1.0000000
A10	12577499	12578689	A10p17120.2_BraZ1	210	+	2028	1190	1190	1.0000000
A10	12596248	12598935	A10p17130.2_BraZ1	1135.75	+	479	2268	2687	0.8440640
A10	12600781	12605358	A10p17140.2_BraZ1	2242.29	+	2221	4525	4577	0.9886388
A10	12605388	12608505	A10p17150.2_BraZ1	1553.14	-	1297	2797	3117	0.8973372
A10	12610641	12614589	A10p17160.2_BraZ1	896.4	-	2620	3803	3948	0.9632726
A10	12616011	12617808	A10p17170.2_BraZ1	410.727	-	1752	1797	1797	1.0000000
A10	12618252	12618898	A10p17180.2_BraZ1	169.615	-	0	0	646	0.0000000
A10	12621213	12622044	A10p17190.2_BraZ1	291	+	1006	760	831	0.9145608
A10	12622403	12622640	A10p17200.2_BraZ1	23.7	-	310	237	237	1.0000000
A10	12626565	12629650	A10p17210.2_BraZ1	1926.03	+	692	2796	3085	0.9063209
A10	12630282	12631610	A10p17220.2_BraZ1	252.96	+	770	1328	1328	1.0000000
A10	12634155	12634881	A10p17230.2_BraZ1	376.875	+	397	726	726	1.0000000
A10	12638033	12640811	A10p17240.2_BraZ1	887.95	+	2010	2778	2778	1.0000000
A10	12647863	12649083	A10p17250.2_BraZ1	474	-	617	993	1220	0.8139344
A10	12652263	12653702	A10p17260.2_BraZ1	282	-	3	78	1439	0.0542043
A10	12653527	12653861	A10p17270.2_BraZ1	249	-	0	0	334	0.0000000
A10	12657490	12659368	A10p17280.2_BraZ1	537	+	308	1364	1878	0.7263046
A10	12661500	12664273	A10p17290.2_BraZ1	2237.01	+	533	2403	2773	0.8665705
A10	12664455	12665793	A10p17300.2_BraZ1	133.8	-	789	1322	1338	0.9880419
A10	12667111	12668023	A10p17310.2_BraZ1	511.329	-	615	912	912	1.0000000
A10	12669742	12670250	A10p17320.2_BraZ1	273	+	11	209	508	0.4114173
A10	12682165	12683293	A10p17330.2_BraZ1	112.8	+	136	520	1128	0.4609929
A10	12683524	12683662	A10p17340.2_BraZ1	13.8	-	275	138	138	1.0000000
A10	12684322	12684576	A10p17350.2_BraZ1	141	-	188	254	254	1.0000000
A10	12684639	12685244	A10p17360.2_BraZ1	504	-	267	605	605	1.0000000
A10	12685553	12686158	A10p17370.2_BraZ1	410.4	-	46	404	605	0.6677686
A10	12687046	12687696	A10p17380.2_BraZ1	39.3	+	503	650	650	1.0000000
A10	12689244	12690562	A10p17390.2_BraZ1	633	-	145	814	1318	0.6176024
A10	12706156	12706978	A10p17400.2_BraZ1	82.2	+	55	631	822	0.7676399
A10	12714486	12714969	A10p17410.2_BraZ1	48.3	-	70	385	483	0.7971014
A10	12720424	12722164	A10p17420.2_BraZ1	11196	+	317	1585	1740	0.9109195
A10	12725751	12727875	A10p17430.2_BraZ1	1422.77	+	507	1929	2124	0.9081921
A10	12728597	12730204	A10p17440.2_BraZ1	705.259	+	438	1236	1607	0.7691351
A10	12731010	12749774	A10p17450.2_BraZ1	1980.33	+	10522	18252	18764	0.9727137
A10	12734484	12735618	A10p17460.2_BraZ1	624.75	+	482	1134	1134	1.0000000
A10	12751924	12752092	A10p17470.2_BraZ1	16.8	-	260	168	168	1.0000000
A10	12754265	12756059	A10p17480.2_BraZ1	179.4	+	441	1602	1794	0.8929766
A10	12756389	12757588	A10p17490.2_BraZ1	424.421	-	534	1199	1199	1.0000000
A10	12758074	12759637	A10p17500.2_BraZ1	670.625	-	1293	1549	1563	0.9910429
A10	12762060	12763513	A10p17510.2_BraZ1	723.36	-	386	1331	1453	0.9160358
A10	12764802	12765978	A10p17520.2_BraZ1	117.6	+	362	1039	1176	0.8835034
A10	12768910	12769336	A10p17530.2_BraZ1	42.6	+	7	206	426	0.4835681
A10	12770156	12770594	A10p17540.2_BraZ1	111	-	282	438	438	1.0000000
A10	12777049	12778517	A10p17550.2_BraZ1	119.4	-	524	1380	1468	0.9400545
A10	12779187	12785388	A10p17560.2_BraZ1	840	-	6919	6199	6201	0.9996775
A10	12787288	12788173	A10p17570.2_BraZ1	88.5	-	215	885	885	1.0000000
A10	12793394	12795033	A10p17580.2_BraZ1	160.5	-	585	1638	1639	0.9993899
A10	12795264	12796926	A10p17590.2_BraZ1	1129.8	+	783	1608	1662	0.9675090
A10	12797217	12799001	A10p17600.2_BraZ1	1077	+	430	1663	1784	0.9321749
A10	12799945	12800542	A10p17610.2_BraZ1	495	+	246	557	597	0.9329983
A10	12801652	12802699	A10p17620.2_BraZ1	104.7	+	357	1021	1047	0.9751672
A10	12806923	12808024	A10p17630.2_BraZ1	110.1	+	1034	1101	1101	1.0000000
A10	12809532	12811254	A10p17640.2_BraZ1	172.2	+	1	4	1722	0.0023229
A10	12814627	12814921	A10p17650.2_BraZ1	29.4	+	0	0	294	0.0000000
A10	12815223	12816279	A10p17660.2_BraZ1	105.6	+	204	1056	1056	1.0000000
A10	12816940	12817286	A10p17670.2_BraZ1	168	-	176	346	346	1.0000000
A10	12819500	12824263	A10p17680.2_BraZ1	269.4	+	1787	4282	4763	0.8990132
A10	12825536	12826095	A10p17690.2_BraZ1	33.9	+	468	559	559	1.0000000
A10	12835756	12844713	A10p17700.2_BraZ1	45	+	2275	7394	8957	0.8254996
A10	12843582	12846485	A10p17710.2_BraZ1	101.4	+	3513	2903	2903	1.0000000
A10	12846580	12876834	A10p17720.2_BraZ1	551.7	+	19032	22802	30254	0.7536855
A10	12873042	12877563	A10p17730.2_BraZ1	416	+	498	3404	4521	0.7529308
A10	12880633	12881104	A10p17740.2_BraZ1	47.1	+	434	471	471	1.0000000
A10	12881250	12881766	A10p17750.2_BraZ1	501	+	824	516	516	1.0000000
A10	12881751	12882423	A10p17760.2_BraZ1	636	+	606	672	672	1.0000000
A10	12891904	12894412	A10p17770.2_BraZ1	250.8	-	401	2132	2508	0.8500797
A10	12896952	12897618	A10p17780.2_BraZ1	465	+	787	666	666	1.0000000
A10	12898599	12899082	A10p17790.2_BraZ1	48.3	+	141	471	483	0.9751553
A10	12901198	12902254	A10p17800.2_BraZ1	57.3	-	170	1034	1056	0.9791667
A10	12905417	12908777	A10p17810.2_BraZ1	450	-	363	2074	3360	0.6172619
A10	12911295	12913182	A10p17820.2_BraZ1	188.7	-	154	1058	1887	0.5606783
A10	12916638	12918594	A10p17830.2_BraZ1	991.529	-	1648	1922	1956	0.9826176
A10	12919865	12920660	A10p17840.2_BraZ1	720	-	315	760	795	0.9559748
A10	12926190	12927154	A10p17850.2_BraZ1	76.2	-	317	964	964	1.0000000
A10	12929338	12930281	A10p17860.2_BraZ1	514.5	-	37	468	943	0.4962884
A10	12944651	12946487	A10p17870.2_BraZ1	1264.58	+	373	1505	1836	0.8197168
A10	12948966	12950978	A10p17880.2_BraZ1	831.333	-	1022	1926	2012	0.9572564
A10	12951014	12952323	A10p17890.2_BraZ1	484.8	+	987	1309	1309	1.0000000
A10	12959452	12959935	A10p17900.2_BraZ1	48.3	+	378	483	483	1.0000000
A10	12961770	12975900	A10p17910.2_BraZ1	1132.05	-	8109	13802	14130	0.9767870
A10	12965600	12965994	A10p17920.2_BraZ1	279	+	140	394	394	1.0000000
A10	12971892	12972269	A10p17930.2_BraZ1	279	+	304	377	377	1.0000000
A10	12979145	12980741	A10p17940.2_BraZ1	486	+	1053	1596	1596	1.0000000
A10	12981814	12984511	A10p17950.2_BraZ1	269.7	-	2411	2547	2697	0.9443827
A10	12985042	12985423	A10p17960.2_BraZ1	38.1	+	103	381	381	1.0000000
A10	12986404	12986798	A10p17970.2_BraZ1	35.7	+	429	331	394	0.8401015
A10	12987517	12988613	A10p17980.2_BraZ1	579.15	+	1035	1096	1096	1.0000000
A10	12989315	12991696	A10p17990.2_BraZ1	1047.57	-	852	2268	2381	0.9525409
A10	12992321	12994629	A10p18000.2_BraZ1	1637.88	+	1115	2251	2308	0.9753033
A10	12997665	12999566	A10p18010.2_BraZ1	723	-	1873	1827	1901	0.9610731
A10	13008578	13008789	A10p18020.2_BraZ1	20.7	-	26	211	211	1.0000000
A10	13029628	13029787	A10p18030.2_BraZ1	15.9	+	12	159	159	1.0000000
A10	13030352	13030568	A10p18040.2_BraZ1	159	+	142	216	216	1.0000000
A10	13030850	13034727	A10p18050.2_BraZ1	2619.5	+	1010	3320	3877	0.8563322
A10	13035124	13037396	A10p18060.2_BraZ1	1428.9	-	3298	2093	2272	0.9212148
A10	13039366	13039586	A10p18070.2_BraZ1	19.2	-	151	220	220	1.0000000
A10	13041259	13041904	A10p18080.2_BraZ1	291	-	126	645	645	1.0000000
A10	13053285	13055533	A10p18090.2_BraZ1	1688.01	+	833	2104	2248	0.9359431
A10	13062838	13067645	A10p18100.2_BraZ1	2268.84	+	2760	4687	4807	0.9750364
A10	13070798	13072491	A10p18110.2_BraZ1	1078	-	841	1693	1693	1.0000000
A10	13073275	13075456	A10p18120.2_BraZ1	1216.14	-	1056	2181	2181	1.0000000
A10	13076619	13077621	A10p18130.2_BraZ1	100.2	+	208	947	1002	0.9451098
A10	13094652	13097393	A10p18140.2_BraZ1	1071.52	+	2167	2642	2741	0.9638818
A10	13098213	13099255	A10p18150.2_BraZ1	2011.88	-	326	707	1042	0.6785029
A10	13100996	13102232	A10p18160.2_BraZ1	692.875	-	291	1164	1236	0.9417475
A10	13102572	13107647	A10p18170.2_BraZ1	2838.1	+	353	3060	5075	0.6029556
A10	13114071	13116494	A10p18180.2_BraZ1	710.417	+	1859	2058	2423	0.8493603
A10	13122163	13123171	A10p18190.2_BraZ1	100.8	-	324	1008	1008	1.0000000
A10	13124089	13125471	A10p18200.2_BraZ1	126.3	-	243	1037	1382	0.7503618
A10	13126780	13127452	A10p18210.2_BraZ1	67.2	+	728	672	672	1.0000000
A10	13142922	13143827	A10p18220.2_BraZ1	777	+	257	734	905	0.8110497
A10	13145544	13149573	A10p18230.2_BraZ1	11050	-	675	3610	4029	0.8960040
A10	13150462	13153820	A10p18240.2_BraZ1	9984.6	+	810	2999	3358	0.8930911
A10	13153972	13154856	A10p18250.2_BraZ1	69.6	+	40	350	884	0.3959276
A10	13157368	13160041	A10p18260.2_BraZ1	14469.5	+	1116	2284	2673	0.8544706
A10	13162263	13164264	A10p18270.2_BraZ1	200.1	+	1515	1987	2001	0.9930035
A10	13164886	13170297	A10p18280.2_BraZ1	1642	-	4954	5389	5411	0.9959342
A10	13175464	13177462	A10p18290.2_BraZ1	199.8	+	367	1862	1998	0.9319319
A10	13184399	13186409	A10p18300.2_BraZ1	146.7	+	296	1710	2010	0.8507463
A10	13187174	13193163	A10p18310.2_BraZ1	2979	+	1414	5531	5989	0.9235265
A10	13193962	13194462	A10p18320.2_BraZ1	159.75	+	309	500	500	1.0000000
A10	13194688	13195644	A10p18330.2_BraZ1	35.4	+	317	912	956	0.9539749
A10	13197490	13198377	A10p18340.2_BraZ1	36.9	+	412	887	887	1.0000000
A10	13206755	13209395	A10p18350.2_BraZ1	264	+	222	1329	2640	0.5034091
A10	13211011	13212483	A10p18360.2_BraZ1	105.3	+	1122	1472	1472	1.0000000
A10	13212117	13214997	A10p18370.2_BraZ1	1355.75	+	1930	2517	2880	0.8739583
A10	13220927	13221842	A10p18380.2_BraZ1	91.5	+	167	886	915	0.9683060
A10	13225439	13226372	A10p18390.2_BraZ1	93.3	-	413	933	933	1.0000000
A10	13226645	13230941	A10p18400.2_BraZ1	1998	+	2909	4177	4296	0.9722998
A10	13231500	13237084	A10p18410.2_BraZ1	790.364	-	4801	5524	5584	0.9892550
A10	13234327	13238207	A10p18420.2_BraZ1	306	-	3011	3880	3880	1.0000000
A10	13234612	13235747	A10p18430.2_BraZ1	3178.5	-	950	1135	1135	1.0000000
A10	13240383	13240722	A10p18440.2_BraZ1	285	-	362	339	339	1.0000000
A10	13242953	13244952	A10p18450.2_BraZ1	1017.69	+	767	1510	1999	0.7553777
A10	13245443	13246664	A10p18460.2_BraZ1	1357.5	-	566	1163	1221	0.9524980
A10	13250487	13251924	A10p18470.2_BraZ1	1287	+	863	1366	1437	0.9505915
A10	13252604	13253007	A10p18480.2_BraZ1	312	-	57	303	403	0.7518610
A10	13254082	13254274	A10p18490.2_BraZ1	19.2	-	81	192	192	1.0000000
A10	13254353	13260747	A10p18500.2_BraZ1	2324.33	+	3081	5839	6394	0.9131999
A10	13265810	13267002	A10p18510.2_BraZ1	840	+	673	828	1192	0.6946309
A10	13273623	13274416	A10p18520.2_BraZ1	156	-	1906	793	793	1.0000000
A10	13274691	13278117	A10p18530.2_BraZ1	1824	-	2268	3426	3426	1.0000000
A10	13283756	13284086	A10p18540.2_BraZ1	33	-	40	197	330	0.5969697
A10	13284901	13285717	A10p18550.2_BraZ1	81.6	+	183	799	816	0.9791667
A10	13288486	13289317	A10p18560.2_BraZ1	83.1	+	117	584	831	0.7027677
A10	13289731	13290813	A10p18570.2_BraZ1	10489.5	-	224	906	1082	0.8373383
A10	13292126	13293544	A10p18580.2_BraZ1	18705	-	415	1159	1418	0.8173484
A10	13294650	13296211	A10p18590.2_BraZ1	668.741	-	1357	1561	1561	1.0000000
A10	13299095	13301254	A10p18600.2_BraZ1	1147.78	+	973	2133	2159	0.9879574
A10	13302726	13303854	A10p18610.2_BraZ1	112.8	+	75	810	1128	0.7180851
A10	13314815	13317086	A10p18620.2_BraZ1	1508.84	+	1364	2232	2271	0.9828269
A10	13317874	13319640	A10p18630.2_BraZ1	2095.97	+	1171	1636	1766	0.9263873
A10	13320724	13324525	A10p18640.2_BraZ1	1789.91	+	1433	3499	3801	0.9205472
A10	13324975	13325374	A10p18650.2_BraZ1	234	-	310	399	399	1.0000000
A10	13325637	13328192	A10p18660.2_BraZ1	258	+	2449	2555	2555	1.0000000
A10	13330269	13332737	A10p18670.2_BraZ1	1292.21	+	348	2126	2468	0.8614262
A10	13333489	13334779	A10p18680.2_BraZ1	129	+	38	352	1290	0.2728682
A10	13336290	13336614	A10p18690.2_BraZ1	32.4	-	214	324	324	1.0000000
A10	13338438	13342371	A10p18700.2_BraZ1	858.462	+	2296	3746	3933	0.9524536
A10	13342851	13345726	A10p18710.2_BraZ1	1744.28	-	1244	2745	2875	0.9547826
A10	13346253	13346697	A10p18720.2_BraZ1	44.4	-	352	444	444	1.0000000
A10	13348112	13349538	A10p18730.2_BraZ1	888.103	-	499	1426	1426	1.0000000
A10	13352730	13353231	A10p18740.2_BraZ1	50.1	-	74	343	501	0.6846308
A10	13371172	13371660	A10p18750.2_BraZ1	48.3	+	96	466	488	0.9549180
A10	13389235	13393459	A10p18760.2_BraZ1	2473.22	+	966	3951	4224	0.9353693
A10	13393965	13397281	A10p18770.2_BraZ1	3010.16	-	352	3000	3316	0.9047045
A10	13407927	13426705	A10p18780.2_BraZ1	2557.89	-	4954	16459	18778	0.8765044
A10	13438900	13442312	A10p18790.2_BraZ1	2047.32	+	717	2896	3412	0.8487691
A10	13446173	13448540	A10p18800.2_BraZ1	1478.4	+	408	1319	2367	0.5572454
A10	13454120	13455322	A10p18810.2_BraZ1	747.889	-	17	125	1202	0.1039933
A10	13456862	13458839	A10p18820.2_BraZ1	11599.2	+	305	1228	1977	0.6211432
A10	13474298	13475458	A10p18830.2_BraZ1	603	-	390	970	1160	0.8362069
A10	13484398	13485933	A10p18840.2_BraZ1	1005	-	346	1383	1535	0.9009772
A10	13493326	13494328	A10p18850.2_BraZ1	100.2	+	436	751	1002	0.7495010
A10	13502458	13502861	A10p18860.2_BraZ1	285	-	244	403	403	1.0000000
A10	13504339	13504819	A10p18870.2_BraZ1	48	+	16	244	480	0.5083333
A10	13506363	13508494	A10p18880.2_BraZ1	1039.5	-	866	1824	2131	0.8559362
A10	13509561	13510311	A10p18890.2_BraZ1	351	+	422	750	750	1.0000000
A10	13510864	13512137	A10p18900.2_BraZ1	690	-	330	1273	1273	1.0000000
A10	13513939	13515560	A10p18910.2_BraZ1	1407	-	611	1354	1621	0.8352869
A10	13524107	13525436	A10p18920.2_BraZ1	714	+	442	1158	1329	0.8713318
A10	13526303	13528198	A10p18930.2_BraZ1	735.429	-	569	1855	1895	0.9788918
A10	13529739	13532952	A10p18940.2_BraZ1	2330.18	+	1566	2319	3213	0.7217554
A10	13535994	13537125	A10p18950.2_BraZ1	113.1	+	20	355	1131	0.3138815
A10	13542416	13543574	A10p18960.2_BraZ1	115.8	+	195	1064	1158	0.9188256
A10	13549202	13549628	A10p18970.2_BraZ1	42.6	+	163	426	426	1.0000000
A10	13550059	13550355	A10p18980.2_BraZ1	210	-	289	296	296	1.0000000
A10	13553869	13556105	A10p18990.2_BraZ1	1397.04	+	891	2196	2236	0.9821109
A10	13557072	13559183	A10p19000.2_BraZ1	1579.41	+	840	2110	2111	0.9995263
A10	13559645	13562973	A10p19010.2_BraZ1	1353.62	-	2444	3328	3328	1.0000000
A10	13564915	13566173	A10p19020.2_BraZ1	123.6	+	348	1032	1258	0.8203498
A10	13566808	13567367	A10p19030.2_BraZ1	38.7	-	739	559	559	1.0000000
A10	13570305	13572090	A10p19040.2_BraZ1	1216	+	676	1769	1785	0.9910364
A10	13572465	13572810	A10p19050.2_BraZ1	34.5	+	356	345	345	1.0000000
A10	13573214	13574555	A10p19060.2_BraZ1	134.1	+	1330	1341	1341	1.0000000
A10	13577658	13585273	A10p19070.2_BraZ1	2953.7	+	2394	6204	7615	0.8147078
A10	13586353	13586639	A10p19080.2_BraZ1	225	+	2	236	286	0.8251748
A10	13595068	13603159	A10p19090.2_BraZ1	1776.5	+	3775	7228	8091	0.8933383
A10	13603219	13604568	A10p19100.2_BraZ1	973.457	-	1241	1349	1349	1.0000000
A10	13605421	13609225	A10p19110.2_BraZ1	2319.3	-	1303	3627	3804	0.9534701
A10	13615319	13616609	A10p19120.2_BraZ1	129	-	186	965	1290	0.7480620
A10	13616714	13616972	A10p19130.2_BraZ1	189	+	344	258	258	1.0000000
A10	13623847	13624271	A10p19140.2_BraZ1	336	-	60	423	424	0.9976415
A10	13655541	13656679	A10p19150.2_BraZ1	818.833	+	29	753	1138	0.6616872
A10	13659561	13661027	A10p19160.2_BraZ1	144	+	123	562	1466	0.3833561
A10	13665405	13666752	A10p19170.2_BraZ1	134.7	+	44	842	1347	0.6250928
A10	13666907	13667737	A10p19180.2_BraZ1	384	-	55	593	830	0.7144578
A10	13670106	13670256	A10p19190.2_BraZ1	15	+	112	150	150	1.0000000
A10	13670742	13673052	A10p19200.2_BraZ1	1549.18	+	671	1825	2310	0.7900433
A10	13676191	13680838	A10p19210.2_BraZ1	1334.37	-	1253	3658	4647	0.7871745
A10	13689708	13693608	A10p19220.2_BraZ1	1447.86	+	1925	3820	3900	0.9794872
A10	13696059	13699662	A10p19230.2_BraZ1	2259.76	-	2057	3603	3603	1.0000000
A10	13705081	13705279	A10p19240.2_BraZ1	19.8	-	0	0	198	0.0000000
A10	13706594	13708602	A10p19250.2_BraZ1	1068.47	+	1091	1863	2008	0.9277889
A10	13709287	13713139	A10p19260.2_BraZ1	156	-	462	1396	3852	0.3624091
A10	13721487	13727203	A10p19270.2_BraZ1	2920.73	+	347	3023	5716	0.5288664
A10	13729683	13729963	A10p19280.2_BraZ1	18.9	-	257	280	280	1.0000000
A10	13732970	13733889	A10p19290.2_BraZ1	212	+	407	888	919	0.9662677
A10	13735104	13735314	A10p19300.2_BraZ1	21	-	298	210	210	1.0000000
A10	13737144	13738522	A10p19310.2_BraZ1	522	-	184	791	1378	0.5740203
A10	13737823	13738411	A10p19320.2_BraZ1	165	-	27	210	588	0.3571429
A10	13740977	13744585	A10p19330.2_BraZ1	1197.81	-	5240	3608	3608	1.0000000
A10	13759865	13760426	A10p19340.2_BraZ1	56.1	+	134	561	561	1.0000000
A10	13769499	13770496	A10p19350.2_BraZ1	708	+	5	224	997	0.2246740
A10	13772256	13772514	A10p19360.2_BraZ1	25.8	-	3040	258	258	1.0000000
A10	13773215	13773326	A10p19370.2_BraZ1	11.1	-	69	111	111	1.0000000
A10	13774729	13777368	A10p19380.2_BraZ1	1217.73	+	1523	2476	2639	0.9382342
A10	13778313	13781009	A10p19390.2_BraZ1	1277.65	+	1664	2656	2696	0.9851632
A10	13781384	13783498	A10p19400.2_BraZ1	1269.48	+	1282	2059	2114	0.9739830
A10	13785944	13787590	A10p19410.2_BraZ1	1411.77	+	622	1583	1646	0.9617254
A10	13790207	13791750	A10p19420.2_BraZ1	974.4	+	993	1543	1543	1.0000000
A10	13794054	13794330	A10p19430.2_BraZ1	27.6	+	294	276	276	1.0000000
A10	13798072	13800865	A10p19440.2_BraZ1	2004	+	987	2746	2793	0.9831722
A10	13801626	13802478	A10p19450.2_BraZ1	85.2	+	182	836	852	0.9812207
A10	13802788	13803361	A10p19460.2_BraZ1	44.4	-	168	499	573	0.8708552
A10	13804398	13807798	A10p19470.2_BraZ1	1287.45	-	915	2198	3400	0.6464706
A10	13809041	13809284	A10p19480.2_BraZ1	24.3	-	36	243	243	1.0000000
A10	13811100	13812025	A10p19490.2_BraZ1	624	-	211	759	925	0.8205405
A10	13814197	13814902	A10p19500.2_BraZ1	609	-	482	705	705	1.0000000
A10	13815392	13816040	A10p19510.2_BraZ1	64.8	+	499	648	648	1.0000000
A10	13816538	13819833	A10p19520.2_BraZ1	7272	-	2000	2981	3295	0.9047041
A10	13821635	13821761	A10p19530.2_BraZ1	12.6	-	180	126	126	1.0000000
A10	13822242	13824481	A10p19540.2_BraZ1	1017	-	404	1960	2239	0.8753908
A10	13825172	13826053	A10p19550.2_BraZ1	405.167	+	814	874	881	0.9920545
A10	13825965	13827622	A10p19560.2_BraZ1	553.929	+	920	1431	1657	0.8636090
A10	13844991	13846368	A10p19570.2_BraZ1	137.7	+	511	1343	1377	0.9753087
A10	13853778	13856072	A10p19580.2_BraZ1	701.634	+	2283	2294	2294	1.0000000
A10	13862586	13864401	A10p19590.2_BraZ1	1181.48	+	207	1369	1815	0.7542700
A10	13867516	13869302	A10p19600.2_BraZ1	796.407	+	14	309	1786	0.1730123
A10	13871491	13877045	A10p19610.2_BraZ1	2473.14	+	1958	4981	5554	0.8968311
A10	13877338	13877453	A10p19620.2_BraZ1	11.4	+	69	115	115	1.0000000
A10	13877692	13879418	A10p19630.2_BraZ1	1188	+	461	1586	1726	0.9188876
A10	13880219	13887265	A10p19640.2_BraZ1	1502.95	-	4556	6502	7046	0.9227931
A10	13899365	13900730	A10p19650.2_BraZ1	879	+	460	1364	1365	0.9992674
A10	13900932	13902273	A10p19660.2_BraZ1	134.1	-	305	1335	1341	0.9955257
A10	13905434	13906152	A10p19670.2_BraZ1	68.7	+	36	349	718	0.4860724
A10	13908957	13909748	A10p19680.2_BraZ1	177	-	82	531	791	0.6713021
A10	13911257	13915718	A10p19690.2_BraZ1	600	+	8910	4461	4461	1.0000000
A10	13919638	13920486	A10p19700.2_BraZ1	750	+	317	848	848	1.0000000
A10	13921334	13927108	A10p19710.2_BraZ1	2011.55	-	1390	4779	5774	0.8276758
A10	13927565	13928687	A10p19720.2_BraZ1	779.864	+	565	1122	1122	1.0000000
A10	13928937	13929264	A10p19730.2_BraZ1	32.7	-	85	273	327	0.8348624
A10	13947426	13950545	A10p19740.2_BraZ1	1694.89	-	505	2747	3119	0.8807310
A10	13963164	13963380	A10p19750.2_BraZ1	21.6	+	3	187	216	0.8657407
A10	13964126	13964315	A10p19760.2_BraZ1	18.9	+	142	189	189	1.0000000
A10	13966527	13967665	A10p19770.2_BraZ1	633.029	-	557	1125	1138	0.9885765
A10	13968180	13971326	A10p19780.2_BraZ1	1130.87	-	1835	3112	3146	0.9891926
A10	13972794	13973656	A10p19790.2_BraZ1	546	+	533	862	862	1.0000000
A10	13974230	13978344	A10p19800.2_BraZ1	2137.97	-	2270	4068	4114	0.9888186
A10	13979466	13981781	A10p19810.2_BraZ1	572	-	545	1964	2315	0.8483801
A10	13984835	13989375	A10p19820.2_BraZ1	1825.07	+	1622	4358	4540	0.9599119
A10	13990256	13994983	A10p19830.2_BraZ1	1640.78	-	1857	4250	4727	0.8990903
A10	14005191	14011387	A10p19840.2_BraZ1	1947.82	-	1157	4746	6196	0.7659780
A10	14016407	14018085	A10p19850.2_BraZ1	905.714	+	523	1509	1678	0.8992848
A10	14018298	14019834	A10p19860.2_BraZ1	153.6	-	206	1212	1536	0.7890625
A10	14023566	14027381	A10p19870.2_BraZ1	2023	-	1315	3189	3815	0.8359109
A10	14028926	14032439	A10p19880.2_BraZ1	1495	-	2095	3270	3513	0.9308283
A10	14039010	14041435	A10p19890.2_BraZ1	1494	-	800	2425	2425	1.0000000
A10	14044038	14044251	A10p19900.2_BraZ1	21.3	+	0	0	213	0.0000000
A10	14047075	14050195	A10p19910.2_BraZ1	643.86	-	988	3103	3120	0.9945513
A10	14051620	14052709	A10p19920.2_BraZ1	6204	-	815	1089	1089	1.0000000
A10	14055154	14058265	A10p19930.2_BraZ1	1062.15	+	1955	2603	3111	0.8367084
A10	14058470	14059514	A10p19940.2_BraZ1	104.4	-	637	1044	1044	1.0000000
A10	14060061	14061663	A10p19950.2_BraZ1	160.2	+	359	1494	1602	0.9325843
A10	14063019	14063184	A10p19960.2_BraZ1	16.5	+	93	165	165	1.0000000
A10	14064168	14068535	A10p19970.2_BraZ1	1794.19	+	470	3217	4367	0.7366613
A10	14069111	14070292	A10p19980.2_BraZ1	42.4138	+	633	1156	1181	0.9788315
A10	14070219	14076333	A10p19990.2_BraZ1	1325.59	+	1699	5952	6114	0.9735034
A10	14076586	14077507	A10p20000.2_BraZ1	786	-	159	647	921	0.7024973
A10	14078080	14085243	A10p20010.2_BraZ1	3391.45	-	2260	6454	7163	0.9010191
A10	14092772	14093887	A10p20020.2_BraZ1	1207.5	+	1362	1115	1115	1.0000000
A10	14098001	14101129	A10p20030.2_BraZ1	1394.96	+	1357	2951	3128	0.9434143
A10	14104800	14109079	A10p20040.2_BraZ1	1779.54	-	1773	3194	4279	0.7464361
A10	14110755	14113985	A10p20050.2_BraZ1	1701.82	-	1445	2986	3230	0.9244582
A10	14116008	14117747	A10p20060.2_BraZ1	759	+	5153	1408	1739	0.8096607
A10	14118269	14123132	A10p20070.2_BraZ1	1458.91	+	1226	4694	4863	0.9652478
A10	14118836	14119902	A10p20080.2_BraZ1	577.227	-	228	1066	1066	1.0000000
A10	14125218	14125740	A10p20090.2_BraZ1	52.2	+	26	287	522	0.5498084
A10	14127761	14129184	A10p20100.2_BraZ1	396	-	718	1411	1423	0.9915671
A10	14131962	14132695	A10p20110.2_BraZ1	768	-	358	733	733	1.0000000
A10	14134062	14134608	A10p20120.2_BraZ1	891	+	338	546	546	1.0000000
A10	14138209	14138824	A10p20130.2_BraZ1	195	+	270	615	615	1.0000000
A10	14141859	14150747	A10p20140.2_BraZ1	1711.7	+	4249	8035	8888	0.9040279
A10	14161752	14166424	A10p20150.2_BraZ1	1819.7	+	829	4093	4672	0.8760702
A10	14172479	14172863	A10p20160.2_BraZ1	38.4	+	127	361	384	0.9401042
A10	14175576	14176080	A10p20170.2_BraZ1	50.4	-	251	466	504	0.9246032
A10	14179431	14179995	A10p20180.2_BraZ1	56.4	+	481	564	564	1.0000000
A10	14184489	14185206	A10p20190.2_BraZ1	71.7	+	733	717	717	1.0000000
A10	14189578	14194328	A10p20200.2_BraZ1	3432.14	+	1848	4480	4750	0.9431579
A10	14194667	14195922	A10p20210.2_BraZ1	770.538	-	121	1215	1255	0.9681275
A10	14196836	14200437	A10p20220.2_BraZ1	1398.23	-	958	2921	3601	0.8111635
A10	14202326	14206047	A10p20230.2_BraZ1	1061.1	-	1400	3719	3721	0.9994625
A10	14213254	14214093	A10p20240.2_BraZ1	747	+	526	839	839	1.0000000
A10	14215565	14217899	A10p20250.2_BraZ1	1947	-	53	815	2334	0.3491859
A10	14218990	14221419	A10p20260.2_BraZ1	1249.97	-	905	1999	2429	0.8229724
A10	14226511	14230651	A10p20270.2_BraZ1	1143	+	1630	3989	4140	0.9635265
A10	14232085	14235195	A10p20280.2_BraZ1	2624.4	+	980	2590	3110	0.8327974
A10	14237867	14238503	A10p20290.2_BraZ1	63.6	+	49	629	636	0.9889937
A10	14239631	14243293	A10p20300.2_BraZ1	3573	-	1017	3601	3662	0.9833424
A10	14245173	14246727	A10p20310.2_BraZ1	155.4	+	277	1174	1554	0.7554697
A10	14246980	14249409	A10p20320.2_BraZ1	1343.16	-	791	2384	2429	0.9814739
A10	14251357	14252328	A10p20330.2_BraZ1	343.939	+	285	829	971	0.8537590
A10	14253070	14254117	A10p20340.2_BraZ1	104.7	-	432	1047	1047	1.0000000
A10	14254485	14255890	A10p20350.2_BraZ1	603	+	1590	1405	1405	1.0000000
A10	14258153	14258760	A10p20360.2_BraZ1	391	+	92	572	607	0.9423394
A10	14261105	14261479	A10p20370.2_BraZ1	186	-	593	374	374	1.0000000
A10	14267624	14269560	A10p20380.2_BraZ1	824.189	+	994	1936	1936	1.0000000
A10	14270550	14272381	A10p20390.2_BraZ1	681.12	+	1628	1816	1831	0.9918078
A10	14272657	14273779	A10p20400.2_BraZ1	399	-	430	1122	1122	1.0000000
A10	14276775	14279953	A10p20410.2_BraZ1	27864	-	822	2709	3178	0.8524229
A10	14300504	14302987	A10p20420.2_BraZ1	1160	+	219	1926	2483	0.7756746
A10	14303489	14305017	A10p20430.2_BraZ1	2100	-	166	715	1528	0.4679319
A10	14309402	14314011	A10p20440.2_BraZ1	3769.07	+	640	3612	4609	0.7836841
A10	14314417	14316802	A10p20450.2_BraZ1	560.422	-	2013	2350	2385	0.9853249
A10	14319905	14320493	A10p20460.2_BraZ1	165	+	608	523	588	0.8894558
A10	14322343	14323664	A10p20470.2_BraZ1	1093.75	-	898	1321	1321	1.0000000
A10	14323904	14325830	A10p20480.2_BraZ1	573	+	1293	1826	1926	0.9480789
A10	14327981	14332005	A10p20490.2_BraZ1	1803.29	-	763	3119	4024	0.7750994
A10	14333434	14334472	A10p20500.2_BraZ1	103.8	-	177	870	1038	0.8381503
A10	14335479	14335779	A10p20510.2_BraZ1	30	+	4	40	300	0.1333333
A10	14338129	14347427	A10p20520.2_BraZ1	4865.32	+	1786	5601	9298	0.6023876
A10	14347941	14349384	A10p20530.2_BraZ1	1172.36	-	181	841	1443	0.5828136
A10	14350933	14353415	A10p20540.2_BraZ1	2352	+	391	2059	2482	0.8295729
A10	14354155	14355323	A10p20550.2_BraZ1	3938.75	+	351	1114	1168	0.9537671
A10	14357709	14362888	A10p20560.2_BraZ1	2711.8	+	1267	4145	5179	0.8003476
A10	14368652	14370881	A10p20570.2_BraZ1	1005	+	712	1224	2229	0.5491252
A10	14372040	14375208	A10p20580.2_BraZ1	1376.82	+	348	1847	3168	0.5830176
A10	14375654	14378767	A10p20590.2_BraZ1	1940.28	-	386	2683	3113	0.8618696
A10	14382265	14384334	A10p20600.2_BraZ1	315.871	-	326	1697	2069	0.8202030
A10	14386019	14387587	A10p20610.2_BraZ1	537	-	748	1266	1568	0.8073980
A10	14392752	14392893	A10p20620.2_BraZ1	14.1	+	295	141	141	1.0000000
A10	14395258	14403440	A10p20630.2_BraZ1	1984.82	-	2835	6043	8182	0.7385725
A10	14406751	14407772	A10p20640.2_BraZ1	822.929	-	485	1021	1021	1.0000000
A10	14410950	14411636	A10p20650.2_BraZ1	218.7	+	458	622	686	0.9067056
A10	14413609	14416125	A10p20660.2_BraZ1	1222.2	-	675	2370	2516	0.9419714
A10	14419957	14421019	A10p20670.2_BraZ1	1111.5	+	1	126	1062	0.1186441
A10	14423273	14424308	A10p20680.2_BraZ1	103.5	+	92	633	1035	0.6115942
A10	14424792	14427090	A10p20690.2_BraZ1	1283.65	+	1171	2191	2298	0.9534377
A10	14427279	14428204	A10p20700.2_BraZ1	637	-	335	867	925	0.9372973
A10	14428432	14430049	A10p20710.2_BraZ1	677.344	+	905	1617	1617	1.0000000
A10	14430763	14435342	A10p20720.2_BraZ1	1355.96	+	2141	4573	4579	0.9986897
A10	14436592	14437939	A10p20730.2_BraZ1	134.7	+	376	1202	1347	0.8923534
A10	14441129	14442835	A10p20740.2_BraZ1	1073.58	+	263	956	1706	0.5603752
A10	14445215	14447040	A10p20750.2_BraZ1	827.5	+	348	1442	1825	0.7901370
A10	14449754	14451660	A10p20760.2_BraZ1	860.6	+	576	1766	1906	0.9265478
A10	14452258	14452426	A10p20770.2_BraZ1	16.8	+	84	168	168	1.0000000
A10	14454266	14454683	A10p20780.2_BraZ1	41.7	-	166	396	417	0.9496403
A10	14456786	14457836	A10p20790.2_BraZ1	723	-	374	868	1050	0.8266667
A10	14462761	14464030	A10p20800.2_BraZ1	633	+	387	1221	1269	0.9621750
A10	14465767	14467470	A10p20810.2_BraZ1	976.929	+	209	1187	1703	0.6970053
A10	14470254	14476052	A10p20820.2_BraZ1	3128.5	+	804	4446	5798	0.7668161
A10	14477406	14478171	A10p20830.2_BraZ1	76.5	+	270	765	765	1.0000000
A10	14478482	14480158	A10p20840.2_BraZ1	141.9	-	77	560	1676	0.3341289
A10	14485317	14486971	A10p20850.2_BraZ1	54965.6	+	154	1356	1654	0.8198307
A10	14487941	14489504	A10p20860.2_BraZ1	900	+	724	1475	1563	0.9436980
A10	14490010	14491124	A10p20870.2_BraZ1	262.491	-	298	1114	1114	1.0000000
A10	14491226	14491535	A10p20880.2_BraZ1	30.9	-	289	309	309	1.0000000
A10	14491535	14494533	A10p20890.2_BraZ1	581.349	-	2411	2881	2998	0.9609740
A10	14495010	14497740	A10p20900.2_BraZ1	1183.47	-	117	1348	2730	0.4937729
A10	14497823	14497980	A10p20910.2_BraZ1	102	+	0	0	157	0.0000000
A10	14500864	14502391	A10p20920.2_BraZ1	152.7	-	256	1181	1527	0.7734119
A10	14506896	14512565	A10p20930.2_BraZ1	2119.09	-	1643	4382	5669	0.7729759
A10	14513492	14515214	A10p20940.2_BraZ1	814.275	-	821	1722	1722	1.0000000
A10	14515730	14518109	A10p20950.2_BraZ1	1761	-	670	2068	2379	0.8692728
A10	14518697	14519071	A10p20960.2_BraZ1	228.25	+	173	374	374	1.0000000
A10	14519442	14519910	A10p20970.2_BraZ1	247.929	+	585	468	468	1.0000000
A10	14524843	14525488	A10p20980.2_BraZ1	64.5	+	12	216	645	0.3348837
A10	14526013	14528346	A10p20990.2_BraZ1	1824	-	708	1755	2333	0.7522503
A10	14531936	14536344	A10p21000.2_BraZ1	1964.45	-	2234	4080	4408	0.9255899
A10	14538772	14543142	A10p21010.2_BraZ1	4122	+	426	2957	4370	0.6766590
A10	14545936	14546392	A10p21020.2_BraZ1	45.6	+	42	379	456	0.8311403
A10	14548980	14551070	A10p21030.2_BraZ1	1773	+	146	1256	2090	0.6009569
A10	14551780	14554445	A10p21040.2_BraZ1	1514.34	-	605	1783	2665	0.6690431
A10	14557102	14560447	A10p21050.2_BraZ1	1174.79	-	623	2941	3345	0.8792227
A10	14566340	14573815	A10p21060.2_BraZ1	844.743	+	5833	7160	7475	0.9578595
A10	14574905	14577577	A10p21070.2_BraZ1	1816.36	-	302	1691	2672	0.6328593
A10	14579602	14582598	A10p21080.2_BraZ1	929.045	-	283	1675	2996	0.5590788
A10	14586209	14587380	A10p21090.2_BraZ1	600.727	+	423	1125	1171	0.9607173
A10	14587776	14589739	A10p21100.2_BraZ1	1845	-	922	1883	1963	0.9592460
A10	14591210	14593896	A10p21110.2_BraZ1	1050.01	+	1506	2515	2686	0.9363366
A10	14594461	14595497	A10p21120.2_BraZ1	681.6	-	148	753	1036	0.7268340
A10	14600759	14601637	A10p21130.2_BraZ1	179.308	-	144	878	878	1.0000000
A10	14602279	14604343	A10p21140.2_BraZ1	1032.84	-	319	1983	2064	0.9607558
A10	14605866	14608164	A10p21150.2_BraZ1	1572.11	+	387	1828	2298	0.7954744
A10	14608713	14610308	A10p21160.2_BraZ1	902.727	-	934	1587	1595	0.9949843
A10	14611382	14611874	A10p21170.2_BraZ1	294	-	379	492	492	1.0000000
A10	14612525	14617229	A10p21180.2_BraZ1	2377.16	+	2096	4289	4704	0.9117772
A10	14617821	14619711	A10p21190.2_BraZ1	189	+	557	1648	1890	0.8719577
A10	14620563	14624125	A10p21200.2_BraZ1	6302.05	-	3231	2759	3562	0.7745649
A10	14625864	14631737	A10p21210.2_BraZ1	2520.16	-	1241	4784	5873	0.8145752
A10	14634072	14636196	A10p21220.2_BraZ1	1481.16	+	987	1912	2124	0.9001883
A10	14636735	14638864	A10p21230.2_BraZ1	1144.8	-	1309	2129	2129	1.0000000
A10	14648298	14649072	A10p21240.2_BraZ1	77.4	+	116	754	774	0.9741602
A10	14651041	14658071	A10p21250.2_BraZ1	2909.25	+	632	4718	7030	0.6711237
A10	14658727	14659348	A10p21260.2_BraZ1	558	-	461	621	621	1.0000000
A10	14660308	14662643	A10p21270.2_BraZ1	1136.31	-	1627	2284	2335	0.9781585
A10	14663088	14664096	A10p21280.2_BraZ1	100.8	-	147	709	1008	0.7033730
A10	14664937	14667986	A10p21290.2_BraZ1	1805.45	-	1768	3049	3049	1.0000000
A10	14674324	14675164	A10p21300.2_BraZ1	84	+	101	587	840	0.6988095
A10	14685930	14688603	A10p21310.2_BraZ1	1448.74	+	692	2162	2673	0.8088290
A10	14690834	14691383	A10p21320.2_BraZ1	450	-	127	498	549	0.9071038
A10	14692816	14695152	A10p21330.2_BraZ1	1290.94	-	766	2235	2336	0.9567637
A10	14695815	14697387	A10p21340.2_BraZ1	1379.35	-	237	1431	1572	0.9103053
A10	14700799	14701147	A10p21350.2_BraZ1	243	+	126	348	348	1.0000000
A10	14702208	14704637	A10p21360.2_BraZ1	13072	-	1737	2303	2429	0.9481268
A10	14711048	14713940	A10p21370.2_BraZ1	2048.14	+	2180	2844	2892	0.9834025
A10	14714167	14715310	A10p21380.2_BraZ1	114.3	-	345	1101	1143	0.9632546
A10	14730701	14732986	A10p21390.2_BraZ1	1251	+	3738	2254	2285	0.9864333
A10	14734553	14735933	A10p21400.2_BraZ1	1314	-	536	1328	1380	0.9623188
A10	14745569	14748215	A10p21410.2_BraZ1	1034.18	-	1274	2323	2646	0.8779290
A10	14768548	14770196	A10p21420.2_BraZ1	819.918	-	709	1343	1648	0.8149272
A10	14770910	14771174	A10p21430.2_BraZ1	26.4	-	0	0	264	0.0000000
A10	14771808	14773782	A10p21440.2_BraZ1	728.462	-	1060	1974	1974	1.0000000
A10	14777177	14778863	A10p21450.2_BraZ1	168.6	-	531	1583	1686	0.9389086
A10	14780603	14782760	A10p21460.2_BraZ1	1039.93	-	748	2049	2157	0.9499304
A10	14792329	14792611	A10p21470.2_BraZ1	186	+	444	282	282	1.0000000
A10	14794902	14795907	A10p21480.2_BraZ1	100.5	+	237	952	1005	0.9472637
A10	14800968	14802632	A10p21490.2_BraZ1	678	+	1419	1500	1664	0.9014423
A10	14803002	14805087	A10p21500.2_BraZ1	208.5	+	1080	2085	2085	1.0000000
A10	14807212	14809662	A10p21510.2_BraZ1	1548.25	+	1321	2450	2450	1.0000000
A10	14810036	14813234	A10p21520.2_BraZ1	1067.22	-	1780	3141	3198	0.9821764
A10	14815640	14818483	A10p21530.2_BraZ1	2345.84	+	1341	2757	2843	0.9697503
A10	14818823	14819573	A10p21540.2_BraZ1	529.286	+	368	662	750	0.8826666
A10	14821594	14823088	A10p21550.2_BraZ1	149.4	+	782	1494	1494	1.0000000
A10	14823508	14825486	A10p21560.2_BraZ1	1033.28	-	1180	1978	1978	1.0000000
A10	14853132	14854173	A10p21570.2_BraZ1	104.1	+	201	1041	1041	1.0000000
A10	14861879	14862180	A10p21580.2_BraZ1	375	-	158	301	301	1.0000000
A10	14863674	14863959	A10p21590.2_BraZ1	28.5	-	0	0	285	0.0000000
A10	14864550	14866114	A10p21600.2_BraZ1	852.273	+	256	1552	1564	0.9923274
A10	14866432	14871533	A10p21610.2_BraZ1	2020.76	-	2864	4581	5101	0.8980592
A10	14877507	14877693	A10p21620.2_BraZ1	126	-	400	186	186	1.0000000
A10	14879599	14884684	A10p21630.2_BraZ1	5501.4	-	1418	3569	5085	0.7018682
A10	14887645	14890724	A10p21640.2_BraZ1	1333.03	-	1189	2949	3079	0.9577785
A10	14897172	14901183	A10p21650.2_BraZ1	2129.7	-	1945	3809	4011	0.9496385
A10	14905276	14906107	A10p21660.2_BraZ1	321	-	384	831	831	1.0000000
A10	14906758	14906935	A10p21670.2_BraZ1	17.7	+	89	177	177	1.0000000
A10	14907931	14910454	A10p21680.2_BraZ1	252.3	-	893	2048	2523	0.8117321
A10	14912268	14913983	A10p21690.2_BraZ1	147.9	-	820	1671	1715	0.9743440
A10	14914953	14918332	A10p21700.2_BraZ1	3318	-	1985	3367	3379	0.9964486
A10	14919066	14924373	A10p21710.2_BraZ1	3313.94	+	641	3879	5307	0.7309214
A10	14926974	14927382	A10p21720.2_BraZ1	40.8	+	4	174	408	0.4264706
A10	14933661	14935366	A10p21730.2_BraZ1	1115.39	+	631	1494	1705	0.8762463
A10	14937798	14939649	A10p21740.2_BraZ1	7249.5	-	746	1501	1851	0.8109130
A10	14943651	14943816	A10p21750.2_BraZ1	16.5	+	126	165	165	1.0000000
A10	14944214	14945459	A10p21760.2_BraZ1	124.5	+	611	1245	1245	1.0000000
A10	14945770	14955514	A10p21770.2_BraZ1	2097.58	-	4864	9210	9744	0.9451970
A10	14956230	14961808	A10p21780.2_BraZ1	2640.76	+	886	4001	5578	0.7172822
A10	14962628	14964864	A10p21790.2_BraZ1	1538.08	-	623	2076	2236	0.9284437
A10	14972631	14979474	A10p21800.2_BraZ1	1905.35	+	4954	6820	6843	0.9966389
A10	14974386	14974695	A10p21810.2_BraZ1	30.9	+	68	286	309	0.9255663
A10	14979822	14982659	A10p21820.2_BraZ1	1187.54	-	1275	2747	2837	0.9682763
A10	14987661	14995184	A10p21830.2_BraZ1	1131	+	3523	6567	7523	0.8729230
A10	14995899	14997897	A10p21840.2_BraZ1	1176.54	-	1011	1956	1998	0.9789790
A10	15005885	15007894	A10p21850.2_BraZ1	1198.5	-	892	1958	2009	0.9746143
A10	15009565	15016113	A10p21860.2_BraZ1	4604.91	+	892	4328	6548	0.6609652
A10	15016633	15017962	A10p21870.2_BraZ1	132.9	-	366	961	1329	0.7231001
A10	15028020	15030270	A10p21880.2_BraZ1	1473.35	+	144	1511	2250	0.6715556
A10	15035952	15036518	A10p21890.2_BraZ1	261	-	436	221	566	0.3904594
A10	15040303	15040599	A10p21900.2_BraZ1	15.6	-	217	296	296	1.0000000
A10	15040635	15042605	A10p21910.2_BraZ1	1321.69	-	356	1597	1970	0.8106599
A10	15044968	15047401	A10p21920.2_BraZ1	1650	+	914	2075	2433	0.8528566
A10	15047878	15049530	A10p21930.2_BraZ1	1488	+	11	83	1652	0.0502421
A10	15050146	15050585	A10p21940.2_BraZ1	102.857	+	66	248	439	0.5649202
A10	15050961	15052776	A10p21950.2_BraZ1	407	-	188	1530	1815	0.8429752
A10	15054086	15057541	A10p21960.2_BraZ1	1174.5	-	659	2838	3455	0.8214182
A10	15061324	15061835	A10p21970.2_BraZ1	441	+	472	511	511	1.0000000
A10	15063279	15075297	A10p21980.2_BraZ1	881.25	+	3354	11357	12018	0.9449992
A10	15064538	15066916	A10p21990.2_BraZ1	1636.11	-	542	2287	2378	0.9617326
A10	15067779	15071267	A10p22000.2_BraZ1	1098.9	+	600	3145	3488	0.9016628
A10	15072058	15072406	A10p22010.2_BraZ1	198	-	158	316	348	0.9080459
A10	15075642	15076320	A10p22020.2_BraZ1	288	+	544	639	678	0.9424779
A10	15077761	15082310	A10p22030.2_BraZ1	14910	+	1513	4130	4549	0.9078919
A10	15085364	15086375	A10p22040.2_BraZ1	570	-	49	490	1011	0.4846686
A10	15087026	15089180	A10p22050.2_BraZ1	213.3	+	1109	1879	2154	0.8723305
A10	15089718	15094310	A10p22060.2_BraZ1	813.587	+	2553	3843	4592	0.8368902
A10	15096248	15096997	A10p22070.2_BraZ1	954.5	-	13	251	749	0.3351135
A10	15102908	15104473	A10p22080.2_BraZ1	732	+	247	1276	1565	0.8153355
A10	15105525	15108534	A10p22090.2_BraZ1	1395.86	+	334	2271	3009	0.7547358
A10	15121891	15123403	A10p22100.2_BraZ1	1011	+	66	906	1512	0.5992063
A10	15127536	15129054	A10p22110.2_BraZ1	1655.33	+	698	1480	1518	0.9749671
A10	15129274	15129497	A10p22120.2_BraZ1	18.6	-	66	223	223	1.0000000
A10	15130022	15131344	A10p22130.2_BraZ1	387.111	-	483	1322	1322	1.0000000
A10	15139977	15141756	A10p22140.2_BraZ1	1048.9	+	1850	1779	1779	1.0000000
A10	15142964	15148139	A10p22150.2_BraZ1	2332.4	+	1688	4766	5175	0.9209662
A10	15149062	15150663	A10p22160.2_BraZ1	1479	+	531	1455	1601	0.9088070
A10	15151021	15151882	A10p22170.2_BraZ1	795	-	359	861	861	1.0000000
A10	15152765	15154047	A10p22180.2_BraZ1	1035	-	466	1219	1282	0.9508581
A10	15154416	15155639	A10p22190.2_BraZ1	1041	-	253	988	1223	0.8078495
A10	15158026	15161175	A10p22200.2_BraZ1	2036.47	+	925	2769	3149	0.8793268
A10	15167278	15169314	A10p22210.2_BraZ1	1092.16	-	1164	2036	2036	1.0000000
A10	15172998	15173303	A10p22220.2_BraZ1	237	+	352	305	305	1.0000000
A10	15173572	15175079	A10p22230.2_BraZ1	1038.14	-	1293	1456	1507	0.9661579
A10	15175621	15177234	A10p22240.2_BraZ1	831	-	132	571	1613	0.3539988
A10	15179520	15180844	A10p22250.2_BraZ1	5194	-	1246	1324	1324	1.0000000
A10	15181539	15182983	A10p22260.2_BraZ1	590.64	+	1174	1383	1444	0.9577562
A10	15183527	15184884	A10p22270.2_BraZ1	422.727	-	2241	1357	1357	1.0000000
A10	15185212	15186459	A10p22280.2_BraZ1	813.333	-	1128	1247	1247	1.0000000
A10	15187873	15188173	A10p22290.2_BraZ1	30	-	128	300	300	1.0000000
A10	15189405	15189722	A10p22300.2_BraZ1	29.4	-	132	317	317	1.0000000
A10	15190728	15192408	A10p22310.2_BraZ1	168	-	187	1578	1680	0.9392857
A10	15195728	15196007	A10p22320.2_BraZ1	27.9	+	71	279	279	1.0000000
A10	15196903	15197200	A10p22330.2_BraZ1	29.7	-	9	227	297	0.7643098
A10	15198332	15198611	A10p22340.2_BraZ1	27.9	-	90	279	279	1.0000000
A10	15200120	15204216	A10p22350.2_BraZ1	267	-	1361	3689	4096	0.9006348
A10	15202669	15202993	A10p22360.2_BraZ1	32.4	+	22	221	324	0.6820987
A10	15205297	15205672	A10p22370.2_BraZ1	37.5	+	29	375	375	1.0000000
A10	15206646	15207048	A10p22380.2_BraZ1	40.2	+	62	400	402	0.9950249
A10	15207881	15210162	A10p22390.2_BraZ1	1263.25	-	1208	2281	2281	1.0000000
A10	15210876	15214029	A10p22400.2_BraZ1	314.4	-	712	2960	3153	0.9387885
A10	15220544	15223893	A10p22410.2_BraZ1	2285.33	+	2021	3322	3349	0.9919379
A10	15225387	15228864	A10p22420.2_BraZ1	2148.63	-	298	2704	3477	0.7776819
A10	15232291	15236813	A10p22430.2_BraZ1	4140	-	1760	4279	4522	0.9462627
A10	15241391	15241810	A10p22440.2_BraZ1	336	-	0	0	419	0.0000000
A10	15242874	15244685	A10p22450.2_BraZ1	900	-	1699	1780	1811	0.9828824
A10	15246274	15247770	A10p22460.2_BraZ1	1290	-	456	1443	1496	0.9645722
A10	15248929	15249262	A10p22470.2_BraZ1	33.3	-	192	333	333	1.0000000
A10	15256566	15258294	A10p22480.2_BraZ1	172.8	+	61	1195	1728	0.6915509
A10	15261340	15262969	A10p22490.2_BraZ1	162.9	-	580	1629	1629	1.0000000
A10	15263208	15263441	A10p22500.2_BraZ1	156	-	271	233	233	1.0000000
A10	15266278	15267905	A10p22510.2_BraZ1	13081.5	-	637	1559	1627	0.9582053
A10	15275837	15276761	A10p22520.2_BraZ1	852	+	86	465	924	0.5032467
A10	15279654	15281534	A10p22530.2_BraZ1	6825	-	124	1188	1880	0.6319149
A10	15296297	15298865	A10p22540.2_BraZ1	2028.78	+	1313	2478	2568	0.9649532
A10	15299224	15302170	A10p22550.2_BraZ1	807.47	+	918	2824	2946	0.9585879
A10	15302287	15303513	A10p22560.2_BraZ1	448.623	+	346	1215	1226	0.9910277
A10	15305912	15307633	A10p22570.2_BraZ1	9600	+	651	1588	1721	0.9227194
A10	15308581	15310154	A10p22580.2_BraZ1	1389.46	-	510	1573	1573	1.0000000
A10	15313578	15315385	A10p22590.2_BraZ1	966	+	990	1803	1807	0.9977864
A10	15330389	15334525	A10p22600.2_BraZ1	1103.26	+	879	3562	4136	0.8612186
A10	15337262	15337546	A10p22610.2_BraZ1	138	-	0	0	284	0.0000000
A10	15339392	15341238	A10p22620.2_BraZ1	1195.89	+	666	1846	1846	1.0000000
A10	15341857	15343607	A10p22630.2_BraZ1	777.988	+	955	1750	1750	1.0000000
A10	15344345	15345059	A10p22640.2_BraZ1	51.6	+	190	447	714	0.6260504
A10	15349106	15349478	A10p22650.2_BraZ1	37.2	+	6	234	372	0.6290323
A10	15358772	15360174	A10p22660.2_BraZ1	1302	+	90	846	1402	0.6034237
A10	15360427	15361630	A10p22670.2_BraZ1	120.3	-	139	900	1203	0.7481297
A10	15362004	15364358	A10p22680.2_BraZ1	716.56	+	905	1509	2354	0.6410365
A10	15364793	15366901	A10p22690.2_BraZ1	401.375	-	190	849	2108	0.4027514
A10	15367924	15368989	A10p22700.2_BraZ1	495	+	409	1052	1065	0.9877934
A10	15371158	15371731	A10p22710.2_BraZ1	57.3	+	105	513	573	0.8952879
A10	15372227	15376182	A10p22720.2_BraZ1	1205.72	-	469	3016	3955	0.7625790
A10	15378301	15379446	A10p22730.2_BraZ1	534	-	602	1145	1145	1.0000000
A10	15380293	15381480	A10p22740.2_BraZ1	679.615	+	882	1187	1187	1.0000000
A10	15382110	15384280	A10p22750.2_BraZ1	1162.03	+	1654	2154	2170	0.9926267
A10	15384685	15386441	A10p22760.2_BraZ1	1116	+	682	1620	1756	0.9225513
A10	15387590	15390529	A10p22770.2_BraZ1	1575	-	161	1597	2939	0.5433821
A10	15391136	15391466	A10p22780.2_BraZ1	33	+	0	0	330	0.0000000
A10	15393294	15394875	A10p22790.2_BraZ1	157.8	+	455	1516	1581	0.9588868
A10	15395787	15397921	A10p22800.2_BraZ1	216	-	800	1750	2134	0.8200563
A10	15400372	15401577	A10p22810.2_BraZ1	342	+	1046	1144	1205	0.9493776
A10	15402470	15402722	A10p22820.2_BraZ1	171	+	362	252	252	1.0000000
A10	15402725	15402974	A10p22830.2_BraZ1	24.9	+	224	249	249	1.0000000
A10	15403942	15405389	A10p22840.2_BraZ1	412.5	-	56	694	1447	0.4796130
A10	15407306	15411010	A10p22850.2_BraZ1	1026.14	-	1858	3497	3704	0.9441144
A10	15415350	15418556	A10p22860.2_BraZ1	1634.24	+	893	2611	3206	0.8144105
A10	15419071	15419457	A10p22870.2_BraZ1	330	-	563	386	386	1.0000000
A10	15424668	15425704	A10p22880.2_BraZ1	681.286	-	789	1036	1036	1.0000000
A10	15427268	15431098	A10p22890.2_BraZ1	337.757	-	2463	3378	3830	0.8819844
A10	15431526	15432857	A10p22900.2_BraZ1	2948.4	+	455	1331	1331	1.0000000
A10	15433059	15434080	A10p22910.2_BraZ1	870	-	315	866	1021	0.8481880
A10	15435155	15436950	A10p22920.2_BraZ1	1722	+	272	1611	1795	0.8974931
A10	15437637	15440042	A10p22930.2_BraZ1	859.5	-	1030	2091	2405	0.8694386
A10	15442247	15443159	A10p22940.2_BraZ1	91.2	-	0	0	912	0.0000000
A10	15444334	15445206	A10p22950.2_BraZ1	199.8	-	0	0	872	0.0000000
A10	15444734	15446863	A10p22960.2_BraZ1	812.7	-	0	0	2129	0.0000000
A10	15454552	15455206	A10p22970.2_BraZ1	65.4	+	287	654	654	1.0000000
A10	15455688	15459316	A10p22980.2_BraZ1	1552.11	-	1503	3283	3628	0.9049063
A10	15470013	15474580	A10p22990.2_BraZ1	2040.36	+	327	2892	4567	0.6332384
A10	15478957	15480714	A10p23000.2_BraZ1	904.891	+	744	1757	1757	1.0000000
A10	15481284	15483677	A10p23010.2_BraZ1	904.32	+	1715	2333	2393	0.9749269
A10	15483909	15484299	A10p23020.2_BraZ1	39	-	174	390	390	1.0000000
A10	15484509	15489819	A10p23030.2_BraZ1	1818.85	-	1984	4994	5310	0.9404896
A10	15492391	15495106	A10p23040.2_BraZ1	1326.99	+	1052	2458	2715	0.9053407
A10	15497198	15501493	A10p23050.2_BraZ1	2693.32	+	3004	4280	4295	0.9965076
A10	15505736	15507815	A10p23060.2_BraZ1	1150.1	+	1216	2079	2079	1.0000000
A10	15508353	15509153	A10p23070.2_BraZ1	627.409	-	479	800	800	1.0000000
A10	15510080	15511413	A10p23080.2_BraZ1	273.913	-	1214	1333	1333	1.0000000
A10	15513286	15515647	A10p23090.2_BraZ1	1044	+	1456	1457	2361	0.6171114
A10	15518041	15518434	A10p23100.2_BraZ1	39.3	-	52	373	393	0.9491094
A10	15518847	15519264	A10p23110.2_BraZ1	41.7	-	366	417	417	1.0000000
A10	15519554	15520506	A10p23120.2_BraZ1	573	-	661	952	952	1.0000000
A10	15521805	15526699	A10p23130.2_BraZ1	387	+	2568	4792	4894	0.9791582
A10	15527572	15527881	A10p23140.2_BraZ1	30.9	+	25	309	309	1.0000000
A10	15529182	15529903	A10p23150.2_BraZ1	485.55	+	31	188	721	0.2607490
A10	15531093	15531348	A10p23160.2_BraZ1	25.5	+	466	255	255	1.0000000
A10	15535938	15536379	A10p23170.2_BraZ1	44.1	+	88	245	441	0.5555556
A10	15540416	15540842	A10p23180.2_BraZ1	42.6	+	4	250	426	0.5868545
A10	15541406	15542252	A10p23190.2_BraZ1	237	-	196	823	846	0.9728132
A10	15543887	15551191	A10p23200.2_BraZ1	3132.82	-	1455	5282	7304	0.7231654
A10	15553955	15555506	A10p23210.2_BraZ1	987.083	+	675	1460	1551	0.9413282
A10	15555876	15558750	A10p23220.2_BraZ1	1549.67	-	667	2670	2874	0.9290188
A10	15559701	15563926	A10p23230.2_BraZ1	3300.48	-	1067	3791	4225	0.8972781
A10	15565461	15567734	A10p23240.2_BraZ1	1398.04	-	1052	2262	2273	0.9951606
A10	15571266	15572686	A10p23250.2_BraZ1	1207.22	-	529	1350	1420	0.9507042
A10	15574835	15576330	A10p23260.2_BraZ1	388.593	+	1007	1495	1495	1.0000000
A10	15577204	15579757	A10p23270.2_BraZ1	255.3	-	927	2553	2553	1.0000000
A10	15580236	15585257	A10p23280.2_BraZ1	2977.26	+	2056	4767	5021	0.9494125
A10	15585416	15586642	A10p23290.2_BraZ1	526	-	847	1164	1226	0.9494290
A10	15588393	15590068	A10p23300.2_BraZ1	1076.09	+	955	1675	1675	1.0000000
A10	15590941	15592887	A10p23310.2_BraZ1	793.333	+	1031	1873	1946	0.9624872
A10	15593294	15595554	A10p23320.2_BraZ1	13311	-	1096	2260	2260	1.0000000
A10	15596254	15597814	A10p23330.2_BraZ1	734.37	+	999	1517	1560	0.9724359
A10	15599111	15602987	A10p23340.2_BraZ1	2365.09	+	319	2375	3876	0.6127451
A10	15604263	15605837	A10p23350.2_BraZ1	2890	-	552	1329	1574	0.8443456
A10	15609518	15610478	A10p23360.2_BraZ1	96	-	69	428	960	0.4458333
A10	15611022	15615517	A10p23370.2_BraZ1	2490.43	+	738	3386	4495	0.7532814
A10	15616134	15623949	A10p23380.2_BraZ1	4477.5	-	1433	6392	7815	0.8179142
A10	15624448	15627060	A10p23390.2_BraZ1	2448	-	536	2448	2612	0.9372129
A10	15628468	15631036	A10p23400.2_BraZ1	19948.5	-	737	2332	2568	0.9080997
A10	15632168	15643798	A10p23410.2_BraZ1	1512.9	-	2725	9322	11630	0.8015477
A10	15644437	15645537	A10p23420.2_BraZ1	73.8	-	292	993	1100	0.9027272
A10	15646633	15654997	A10p23430.2_BraZ1	2975.26	-	2523	7266	8364	0.8687231
A10	15659025	15664126	A10p23440.2_BraZ1	3321.3	+	1538	4189	5101	0.8212115
A10	15664531	15665529	A10p23450.2_BraZ1	506.158	+	551	994	998	0.9959920
A10	15666061	15667424	A10p23460.2_BraZ1	330.4	+	1328	1340	1363	0.9831254
A10	15668458	15669955	A10p23470.2_BraZ1	149.7	-	529	1497	1497	1.0000000
A10	15671696	15674725	A10p23480.2_BraZ1	1199.29	-	1159	2974	3029	0.9818422
A10	15675261	15678309	A10p23490.2_BraZ1	1196.77	-	2463	3048	3048	1.0000000
A10	15681578	15684345	A10p23500.2_BraZ1	1591.83	+	1229	2748	2767	0.9931334
A10	15688931	15690911	A10p23510.2_BraZ1	942	-	149	1044	1980	0.5272727
A10	15694019	15696019	A10p23520.2_BraZ1	1860	-	523	1841	2000	0.9205000
A10	15700615	15703123	A10p23530.2_BraZ1	979.851	+	794	2346	2508	0.9354067
A10	15717231	15722026	A10p23540.2_BraZ1	1139.02	+	1813	4315	4795	0.8998957
A10	15722743	15723655	A10p23550.2_BraZ1	679.429	-	440	912	912	1.0000000
A10	15724399	15726342	A10p23560.2_BraZ1	936.26	-	1424	1701	1943	0.8754503
A10	15730611	15731658	A10p23570.2_BraZ1	104.7	-	211	938	1047	0.8958930
A10	15733078	15734869	A10p23580.2_BraZ1	179.1	-	351	1549	1791	0.8648800
A10	15735873	15738075	A10p23590.2_BraZ1	1620	+	287	1911	2202	0.8678474
A10	15739409	15740112	A10p23600.2_BraZ1	481.95	+	22	351	703	0.4992888
A10	15741002	15742187	A10p23610.2_BraZ1	559	+	1024	1185	1185	1.0000000
A10	15743334	15743646	A10p23620.2_BraZ1	31.2	-	84	312	312	1.0000000
A10	15744434	15745453	A10p23630.2_BraZ1	408	+	463	889	1019	0.8724239
A10	15744639	15745097	A10p23640.2_BraZ1	1218	+	358	437	458	0.9541485
A10	15752049	15753010	A10p23650.2_BraZ1	93	+	542	961	961	1.0000000
A10	15753344	15753902	A10p23660.2_BraZ1	462	-	205	554	558	0.9928315
A10	15754739	15754886	A10p23670.2_BraZ1	11.7	-	47	147	147	1.0000000
A10	15755271	15756645	A10p23680.2_BraZ1	3589	+	230	822	1374	0.5982533
A10	15757327	15762325	A10p23690.2_BraZ1	171	+	1398	2317	4998	0.4635854
A10	15769990	15771360	A10p23700.2_BraZ1	252	-	475	971	1370	0.7087591
A10	15770556	15771382	A10p23710.2_BraZ1	738	+	427	732	826	0.8861985
A10	15772084	15778516	A10p23720.2_BraZ1	3372.12	-	1550	5310	6432	0.8255597
A10	15779761	15781147	A10p23730.2_BraZ1	628.421	+	158	666	1386	0.4805195
A10	15782614	15789942	A10p23740.2_BraZ1	3018.36	+	3000	5164	7328	0.7046943
A10	15792103	15793921	A10p23750.2_BraZ1	835.762	+	269	1445	1818	0.7948295
A10	15796065	15805950	A10p23760.2_BraZ1	3383.91	-	6669	9747	9885	0.9860395
A10	15806696	15807251	A10p23770.2_BraZ1	55.5	+	107	492	555	0.8864865
A10	15807746	15810736	A10p23780.2_BraZ1	1154.2	-	1580	2650	2990	0.8862876
A10	15812445	15815289	A10p23790.2_BraZ1	1329	-	581	2446	2844	0.8600563
A10	15819288	15821278	A10p23800.2_BraZ1	1458	+	586	1870	1990	0.9396985
A10	15821974	15824815	A10p23810.2_BraZ1	743.973	+	1213	2815	2841	0.9908483
A10	15825921	15826404	A10p23820.2_BraZ1	48.3	+	142	483	483	1.0000000
A10	15828159	15828785	A10p23830.2_BraZ1	340.909	-	84	344	626	0.5495208
A10	15829342	15829627	A10p23840.2_BraZ1	28.5	+	0	0	285	0.0000000
A10	15830603	15833455	A10p23850.2_BraZ1	1309.65	+	263	1415	2852	0.4961430
A10	15834133	15835735	A10p23860.2_BraZ1	5278	-	946	1448	1602	0.9038702
A10	15836694	15839454	A10p23870.2_BraZ1	1330.36	-	1342	2745	2760	0.9945652
A10	15845261	15846474	A10p23880.2_BraZ1	701.091	+	676	1213	1213	1.0000000
A10	15846832	15851159	A10p23890.2_BraZ1	763.81	-	1093	4118	4327	0.9516987
A10	15853361	15854192	A10p23900.2_BraZ1	402	+	343	831	831	1.0000000
A10	15858434	15859104	A10p23910.2_BraZ1	484.239	+	288	670	670	1.0000000
A10	15860907	15862750	A10p23920.2_BraZ1	1195.6	+	443	1666	1843	0.9039609
A10	15863322	15865429	A10p23930.2_BraZ1	751.556	+	1177	2067	2107	0.9810157
A10	15866321	15874685	A10p23940.2_BraZ1	1408.25	+	4486	8189	8364	0.9790770
A10	15875021	15879974	A10p23950.2_BraZ1	246	+	2267	4493	4953	0.9071270
A10	15880175	15881252	A10p23960.2_BraZ1	107.7	+	389	1033	1077	0.9591458
A10	15883254	15886648	A10p23970.2_BraZ1	1571.99	+	2251	3365	3394	0.9914555
A10	15886984	15887822	A10p23980.2_BraZ1	294.857	-	644	838	838	1.0000000
A10	15888181	15890720	A10p23990.2_BraZ1	1139.73	+	1390	2392	2539	0.9421032
A10	15890949	15893309	A10p24000.2_BraZ1	1022.63	-	1324	2184	2360	0.9254237
A10	15904027	15904180	A10p24010.2_BraZ1	15.3	+	48	153	153	1.0000000
A10	15904512	15907020	A10p24020.2_BraZ1	1947	-	1021	2311	2508	0.9214513
A10	15908165	15909099	A10p24030.2_BraZ1	822	-	314	934	934	1.0000000
A10	15909807	15913369	A10p24040.2_BraZ1	1630.75	-	1679	3468	3562	0.9736103
A10	15915184	15917713	A10p24050.2_BraZ1	1703.85	-	1036	2252	2529	0.8904706
A10	15927331	15927568	A10p24060.2_BraZ1	23.7	-	382	237	237	1.0000000
A10	15928563	15930507	A10p24070.2_BraZ1	194.4	-	907	1860	1944	0.9567901
A10	15931893	15932491	A10p24080.2_BraZ1	193.5	-	357	598	598	1.0000000
A10	15935456	15936563	A10p24090.2_BraZ1	110.7	-	350	1107	1107	1.0000000
A10	15936654	15938161	A10p24100.2_BraZ1	252	-	1014	1484	1507	0.9847379
A10	15941101	15943438	A10p24110.2_BraZ1	1278	+	559	2142	2337	0.9165597
A10	15944293	15945727	A10p24120.2_BraZ1	1291.5	+	173	1315	1434	0.9170153
A10	15948745	15960636	A10p24130.2_BraZ1	1028.38	+	1048	8474	11891	0.7126398
A10	15962173	15965136	A10p24140.2_BraZ1	2259	+	1377	2942	2963	0.9929126
A10	15967083	15968097	A10p24150.2_BraZ1	101.4	+	809	1014	1014	1.0000000
A10	15971289	15972577	A10p24160.2_BraZ1	1107	+	684	1101	1288	0.8548136
A10	15975206	15975758	A10p24170.2_BraZ1	55.2	-	152	552	552	1.0000000
A10	15978038	15978377	A10p24180.2_BraZ1	33.9	+	271	339	339	1.0000000
A10	15984435	15985302	A10p24190.2_BraZ1	86.7	-	1327	867	867	1.0000000
A10	15987920	15990691	A10p24200.2_BraZ1	1564.62	-	2032	2766	2771	0.9981956
A10	15991390	15992350	A10p24210.2_BraZ1	309	+	520	938	960	0.9770833
A10	15995672	15997758	A10p24220.2_BraZ1	727.375	+	701	1713	2086	0.8211889
A10	15998445	15999352	A10p24230.2_BraZ1	772.435	-	518	907	907	1.0000000
A10	16002465	16003641	A10p24240.2_BraZ1	1083	+	161	1074	1176	0.9132653
A10	16004181	16004664	A10p24250.2_BraZ1	48.3	+	176	483	483	1.0000000
A10	16004778	16005639	A10p24260.2_BraZ1	540	-	268	809	861	0.9396051
A10	16013879	16015974	A10p24270.2_BraZ1	1183.93	+	1016	2014	2095	0.9613365
A10	16017323	16018916	A10p24280.2_BraZ1	1327.68	-	892	1593	1593	1.0000000
A10	16020496	16021285	A10p24290.2_BraZ1	230	-	93	671	789	0.8504436
A10	16023047	16025161	A10p24300.2_BraZ1	854	+	1632	2114	2114	1.0000000
A10	16025433	16026591	A10p24310.2_BraZ1	115.8	-	1788	1098	1158	0.9481865
A10	16029448	16030927	A10p24320.2_BraZ1	1047.15	-	315	1396	1479	0.9438810
A10	16032885	16034930	A10p24330.2_BraZ1	1128.15	-	793	2043	2045	0.9990220
A10	16036416	16036881	A10p24340.2_BraZ1	390	-	261	465	465	1.0000000
A10	16038791	16039646	A10p24350.2_BraZ1	780	+	323	855	855	1.0000000
A10	16043984	16049227	A10p24360.2_BraZ1	4075.5	-	2002	4371	5243	0.8336830
A10	16056584	16056854	A10p24370.2_BraZ1	27	-	0	0	270	0.0000000
A10	16059596	16062829	A10p24380.2_BraZ1	2342.17	+	1490	3233	3233	1.0000000
A10	16070155	16072861	A10p24390.2_BraZ1	2586.24	+	1239	2694	2706	0.9955654
A10	16074819	16084314	A10p24400.2_BraZ1	5181.77	+	3232	7191	9495	0.7573460
A10	16085219	16086864	A10p24410.2_BraZ1	612	-	1519	1645	1645	1.0000000
A10	16092535	16094597	A10p24420.2_BraZ1	4320	+	636	1795	2062	0.8705140
A10	16096803	16099108	A10p24430.2_BraZ1	1473.75	+	460	2180	2305	0.9457701
A10	16099874	16101048	A10p24440.2_BraZ1	3925	-	113	538	1174	0.4582624
A10	16103661	16107351	A10p24450.2_BraZ1	2748.07	+	1256	3420	3690	0.9268293
A10	16109636	16112574	A10p24460.2_BraZ1	1999.54	+	979	2938	2938	1.0000000
A10	16113349	16118436	A10p24470.2_BraZ1	3010.22	+	1833	4187	5087	0.8230785
A10	16118849	16120270	A10p24480.2_BraZ1	1054.77	-	441	1267	1421	0.8916256
A10	16121544	16122395	A10p24490.2_BraZ1	489	+	180	792	851	0.9306698
A10	16123229	16125089	A10p24500.2_BraZ1	186	+	230	1790	1860	0.9623656
A10	16125345	16126786	A10p24510.2_BraZ1	1023	-	457	1287	1441	0.8931298
A10	16127746	16131747	A10p24520.2_BraZ1	640.5	-	1776	3977	4001	0.9940015
A10	16134133	16134637	A10p24530.2_BraZ1	151.667	-	515	504	504	1.0000000
A10	16136660	16137829	A10p24540.2_BraZ1	11385.8	-	790	1091	1169	0.9332763
A10	16140902	16142516	A10p24550.2_BraZ1	161.4	+	915	1614	1614	1.0000000
A10	16142876	16143642	A10p24560.2_BraZ1	481.059	-	648	766	766	1.0000000
A10	16145452	16145724	A10p24570.2_BraZ1	174	-	324	272	272	1.0000000
A10	16146428	16148473	A10p24580.2_BraZ1	1439.1	-	1504	2031	2045	0.9931540
A10	16150250	16151319	A10p24590.2_BraZ1	249.205	-	1247	1069	1069	1.0000000
A10	16153050	16153701	A10p24600.2_BraZ1	65.1	+	413	651	651	1.0000000
A10	16154534	16161462	A10p24610.2_BraZ1	1756.54	+	2920	6695	6928	0.9663684
A10	16162680	16163472	A10p24620.2_BraZ1	79.2	+	42	348	792	0.4393939
A10	16164360	16165251	A10p24630.2_BraZ1	594	+	259	785	891	0.8810325
A10	16167286	16167601	A10p24640.2_BraZ1	31.5	+	214	315	315	1.0000000
A10	16168231	16171325	A10p24650.2_BraZ1	974.286	-	309	1538	3094	0.4970911
A10	16168939	16170340	A10p24660.2_BraZ1	115.5	+	182	876	1401	0.6252677
A10	16176081	16177155	A10p24670.2_BraZ1	285	+	12	439	1074	0.4087523
A10	16193880	16195454	A10p24680.2_BraZ1	957.353	+	125	431	1574	0.2738247
A10	16201183	16204047	A10p24690.2_BraZ1	1503	-	425	2529	2864	0.8830307
A10	16204563	16206991	A10p24700.2_BraZ1	1577.14	-	161	1514	2428	0.6235585
A10	16213302	16215325	A10p24710.2_BraZ1	891	-	320	1712	2023	0.8462679
A10	16219310	16221118	A10p24720.2_BraZ1	1239.13	-	210	1384	1808	0.7654867
A10	16223011	16227314	A10p24730.2_BraZ1	1323.83	+	2125	3316	4303	0.7706252
A10	16227958	16228375	A10p24740.2_BraZ1	327	-	511	417	417	1.0000000
A10	16228940	16230155	A10p24750.2_BraZ1	912	+	298	1151	1215	0.9473251
A10	16234231	16235480	A10p24760.2_BraZ1	924	+	507	1249	1249	1.0000000
A10	16237836	16253300	A10p24770.2_BraZ1	477.9	-	7677	14800	15464	0.9570616
A10	16259123	16259738	A10p24780.2_BraZ1	61.5	+	1358	615	615	1.0000000
A10	16263505	16265460	A10p24790.2_BraZ1	880.714	+	1041	1821	1955	0.9314578
A10	16268669	16271758	A10p24800.2_BraZ1	1110	+	673	2047	3089	0.6626740
A10	16272228	16274112	A10p24810.2_BraZ1	2673	-	1980	1800	1884	0.9554140
A10	16276198	16276369	A10p24820.2_BraZ1	17.1	-	49	160	171	0.9356725
A10	16276625	16278494	A10p24830.2_BraZ1	3467.57	-	975	1754	1869	0.9384698
A10	16280711	16281889	A10p24840.2_BraZ1	425.143	-	401	1174	1178	0.9966044
A10	16284304	16286659	A10p24850.2_BraZ1	1325.71	-	1159	2107	2355	0.8946921
A10	16287928	16291147	A10p24860.2_BraZ1	1948.38	+	1569	2877	3219	0.8937559
A10	16291443	16293271	A10p24870.2_BraZ1	1473	-	357	1505	1828	0.8233042
A10	16296557	16297984	A10p24880.2_BraZ1	12534.2	+	851	1396	1427	0.9782761
A10	16298630	16300747	A10p24890.2_BraZ1	719.005	-	699	2055	2117	0.9707133
A10	16302266	16304235	A10p24900.2_BraZ1	613.317	-	592	1887	1969	0.9583545
A10	16304759	16307549	A10p24910.2_BraZ1	278.7	+	454	2428	2790	0.8702509
A10	16308305	16311254	A10p24920.2_BraZ1	1746.87	-	1292	2842	2949	0.9637165
A10	16328191	16329503	A10p24930.2_BraZ1	3366	+	850	1304	1312	0.9939024
A10	16332424	16333228	A10p24940.2_BraZ1	80.4	-	414	804	804	1.0000000
A10	16336222	16340495	A10p24950.2_BraZ1	1863	+	1491	3290	4273	0.7699509
A10	16341001	16341856	A10p24960.2_BraZ1	363.833	-	599	855	855	1.0000000
A10	16346014	16348634	A10p24970.2_BraZ1	948.857	+	679	2270	2620	0.8664122
A10	16355522	16356119	A10p24980.2_BraZ1	59.7	+	147	592	597	0.9916248
A10	16356724	16357934	A10p24990.2_BraZ1	528	+	786	1174	1210	0.9702479
A10	16360477	16362214	A10p25000.2_BraZ1	797.739	+	422	1724	1737	0.9925158
A10	16362977	16364933	A10p25010.2_BraZ1	1280	-	100	1186	1956	0.6063395
A10	16367546	16370703	A10p25020.2_BraZ1	1661.53	+	335	2194	3157	0.6949636
A10	16371085	16372336	A10p25030.2_BraZ1	96.3	-	592	1214	1251	0.9704236
A10	16372982	16377614	A10p25040.2_BraZ1	2862.93	+	820	3429	4632	0.7402850
A10	16383697	16386530	A10p25050.2_BraZ1	970.882	+	1934	2799	2833	0.9879986
A10	16391576	16392986	A10p25060.2_BraZ1	141	-	97	1158	1410	0.8212766
A10	16393609	16395174	A10p25070.2_BraZ1	4947	-	613	1565	1565	1.0000000
A10	16399769	16401798	A10p25080.2_BraZ1	1496	+	895	2000	2029	0.9857072
A10	16402526	16410568	A10p25090.2_BraZ1	1601.85	+	4175	7821	8042	0.9725193
A10	16404915	16406429	A10p25100.2_BraZ1	1154.61	-	444	1446	1514	0.9550859
A10	16411372	16411947	A10p25110.2_BraZ1	5106	+	370	515	575	0.8956522
A10	16412664	16415652	A10p25120.2_BraZ1	1289.62	-	843	2878	2988	0.9631861
A10	16421718	16422177	A10p25130.2_BraZ1	45.9	+	94	434	459	0.9455338
A10	16424432	16425947	A10p25140.2_BraZ1	940.737	+	484	1229	1515	0.8112211
A10	16426374	16430007	A10p25150.2_BraZ1	189.474	+	2811	3547	3633	0.9763281
A10	16431590	16432858	A10p25160.2_BraZ1	6834	-	225	1107	1268	0.8730284
A10	16437553	16438123	A10p25170.2_BraZ1	216	+	906	570	570	1.0000000
A10	16439459	16440198	A10p25180.2_BraZ1	10455	+	404	739	739	1.0000000
A10	16440580	16442256	A10p25190.2_BraZ1	8303	-	877	1647	1676	0.9826969
A10	16446786	16446936	A10p25200.2_BraZ1	15	-	6	108	150	0.7200000
A10	16452353	16454908	A10p25210.2_BraZ1	621.133	+	0	0	2555	0.0000000
A10	16457168	16458071	A10p25220.2_BraZ1	90.3	-	347	903	903	1.0000000
A10	16458677	16464361	A10p25230.2_BraZ1	2266.9	-	2796	5552	5684	0.9767769
A10	16467647	16468746	A10p25240.2_BraZ1	787.063	+	182	1009	1099	0.9181074
A10	16469124	16472787	A10p25250.2_BraZ1	2043.1	-	1434	3606	3663	0.9844390
A10	16476302	16479992	A10p25260.2_BraZ1	1440.63	+	3217	3690	3690	1.0000000
A10	16481984	16484819	A10p25270.2_BraZ1	1652.59	+	911	2786	2835	0.9827160
A10	16490317	16492072	A10p25280.2_BraZ1	17787	+	271	1672	1755	0.9527066
A10	16493406	16496409	A10p25290.2_BraZ1	905.22	+	697	2588	3003	0.8618048
A10	16496631	16499666	A10p25300.2_BraZ1	1795.82	-	1619	2956	3035	0.9739704
A10	16500818	16501336	A10p25310.2_BraZ1	363	-	338	518	518	1.0000000
A10	16503019	16503232	A10p25320.2_BraZ1	21.3	+	11	113	213	0.5305164
A10	16503986	16504548	A10p25330.2_BraZ1	228	+	139	472	562	0.8398576
A10	16505256	16507204	A10p25340.2_BraZ1	813.542	+	623	1618	1948	0.8305955
A10	16507591	16509478	A10p25350.2_BraZ1	3572	-	844	1797	1887	0.9523053
A10	16509469	16509891	A10p25360.2_BraZ1	162	+	573	422	422	1.0000000
A10	16512838	16514854	A10p25370.2_BraZ1	1923	+	748	1940	2016	0.9623016
A10	16515488	16515893	A10p25380.2_BraZ1	40.5	-	269	405	405	1.0000000
A10	16520091	16521722	A10p25390.2_BraZ1	1043.62	+	515	1523	1631	0.9337829
A10	16522739	16524116	A10p25400.2_BraZ1	617.437	-	1065	1373	1377	0.9970951
A10	16525162	16525465	A10p25410.2_BraZ1	30.3	+	56	282	303	0.9306931
A10	16525469	16527366	A10p25420.2_BraZ1	613.038	+	974	1843	1897	0.9715340
A10	16528348	16528816	A10p25430.2_BraZ1	46.8	-	559	468	468	1.0000000
A10	16531763	16532321	A10p25440.2_BraZ1	55.8	+	263	558	558	1.0000000
A10	16535823	16536779	A10p25450.2_BraZ1	800.471	-	493	936	956	0.9790795
A10	16537714	16538171	A10p25460.2_BraZ1	369	-	165	457	457	1.0000000
A10	16538736	16548024	A10p25470.2_BraZ1	2034.02	+	3375	8635	9288	0.9296942
A10	16542161	16543492	A10p25480.2_BraZ1	1173	+	587	1331	1331	1.0000000
A10	16548761	16550024	A10p25490.2_BraZ1	1188	-	430	1226	1263	0.9707047
A10	16554719	16556449	A10p25500.2_BraZ1	2698.8	+	1347	1681	1730	0.9716763
A10	16558980	16559904	A10p25510.2_BraZ1	92.4	+	288	924	924	1.0000000
A10	16561723	16562409	A10p25520.2_BraZ1	53.7	+	468	686	686	1.0000000
A10	16563155	16563474	A10p25530.2_BraZ1	31.5	-	1	74	319	0.2319749
A10	16565390	16566918	A10p25540.2_BraZ1	615.079	+	478	1418	1528	0.9280105
A10	16567449	16568506	A10p25550.2_BraZ1	483.333	-	813	1026	1057	0.9706717
A10	16568907	16570030	A10p25560.2_BraZ1	612.864	-	611	1123	1123	1.0000000
A10	16571619	16572447	A10p25570.2_BraZ1	399	+	66	690	828	0.8333333
A10	16574312	16576796	A10p25580.2_BraZ1	1301.74	-	2142	2484	2484	1.0000000
A10	16582636	16583440	A10p25590.2_BraZ1	80.4	-	544	776	804	0.9651741
A10	16584773	16586402	A10p25600.2_BraZ1	716.374	+	1181	1629	1629	1.0000000
A10	16589658	16601526	A10p25610.2_BraZ1	2433.24	-	3857	10181	11868	0.8578531
A10	16608358	16610232	A10p25620.2_BraZ1	950	+	1530	1834	1874	0.9786553
A10	16610542	16611641	A10p25630.2_BraZ1	708.367	-	669	1099	1099	1.0000000
A10	16615742	16620230	A10p25640.2_BraZ1	3793.57	+	1378	4335	4488	0.9659091
A10	16620979	16623826	A10p25650.2_BraZ1	903.429	+	1181	2690	2847	0.9448543
A10	16624374	16627601	A10p25660.2_BraZ1	1861.36	-	1899	3227	3227	1.0000000
A10	16628834	16632310	A10p25670.2_BraZ1	1758.45	-	1529	3289	3476	0.9462025
A10	16644787	16647446	A10p25680.2_BraZ1	891	+	2435	2659	2659	1.0000000
A10	16647973	16649804	A10p25690.2_BraZ1	1230	-	681	1763	1831	0.9628618
A10	16651032	16653205	A10p25700.2_BraZ1	1824	-	755	2055	2173	0.9456972
A10	16654153	16654662	A10p25710.2_BraZ1	405	+	0	0	509	0.0000000
A10	16656013	16656496	A10p25720.2_BraZ1	180	+	0	0	483	0.0000000
A10	16659156	16662691	A10p25730.2_BraZ1	3109.26	+	1555	3432	3535	0.9708628
A10	16664033	16666202	A10p25740.2_BraZ1	216.9	-	375	2031	2169	0.9363762
A10	16667270	16669292	A10p25750.2_BraZ1	724.571	-	2310	2022	2022	1.0000000
A10	16669781	16674218	A10p25760.2_BraZ1	1910.29	+	2461	4298	4437	0.9686725
A10	16674719	16678913	A10p25770.2_BraZ1	1979.04	+	1322	3720	4194	0.8869814
A10	16679584	16680664	A10p25780.2_BraZ1	531	+	355	1056	1080	0.9777778
A10	16682766	16684014	A10p25790.2_BraZ1	934.839	+	255	997	1248	0.7988782
A10	16685978	16688283	A10p25800.2_BraZ1	1513.69	+	777	2305	2305	1.0000000
A10	16688439	16689096	A10p25810.2_BraZ1	65.7	-	141	657	657	1.0000000
A10	16689531	16694443	A10p25820.2_BraZ1	1854.79	-	2124	4218	4912	0.8587133
A10	16697884	16699027	A10p25830.2_BraZ1	64.8	+	817	1143	1143	1.0000000
A10	16701009	16701955	A10p25840.2_BraZ1	513.525	-	666	940	946	0.9936575
A10	16702540	16703947	A10p25850.2_BraZ1	727.829	+	794	1336	1407	0.9495381
A10	16704326	16705606	A10p25860.2_BraZ1	555.988	+	499	1280	1280	1.0000000
A10	16706457	16708543	A10p25870.2_BraZ1	1290.67	+	842	2053	2086	0.9841803
A10	16709070	16713178	A10p25880.2_BraZ1	3285.91	-	547	3137	4108	0.7636319
A10	16714117	16716550	A10p25890.2_BraZ1	1651.13	-	1248	2192	2433	0.9009453
A10	16717159	16719243	A10p25900.2_BraZ1	698.182	+	1389	2045	2084	0.9812860
A10	16723504	16725608	A10p25910.2_BraZ1	654	-	1867	2104	2104	1.0000000
A10	16728840	16731006	A10p25920.2_BraZ1	1679.41	-	1110	1986	2166	0.9168975
A10	16739279	16740899	A10p25930.2_BraZ1	4747.2	-	1907	1620	1620	1.0000000
A10	16742521	16746969	A10p25940.2_BraZ1	2293.9	+	1517	4217	4448	0.9480665
A10	16748389	16749681	A10p25950.2_BraZ1	1209	+	208	747	1292	0.5781734
A10	16749910	16752917	A10p25960.2_BraZ1	1361.18	-	833	2896	3007	0.9630861
A10	16753203	16755459	A10p25970.2_BraZ1	225.6	+	405	2221	2256	0.9844858
A10	16755716	16757856	A10p25980.2_BraZ1	815.843	-	1402	2140	2140	1.0000000
A10	16760206	16768035	A10p25990.2_BraZ1	1056	-	5715	7559	7829	0.9655128
A10	16771749	16775430	A10p26000.2_BraZ1	524.398	+	1249	3396	3681	0.9225754
A10	16775695	16778154	A10p26010.2_BraZ1	239.7	-	660	2197	2459	0.8934526
A10	16781228	16794519	A10p26020.2_BraZ1	355.943	-	2409	9292	13291	0.6991197
A10	16799002	16801003	A10p26030.2_BraZ1	200.1	-	486	1975	2001	0.9870065
A10	16801805	16802663	A10p26040.2_BraZ1	405	+	622	858	858	1.0000000
A10	16804072	16804343	A10p26050.2_BraZ1	17.1	+	12	254	271	0.9372694
A10	16808267	16809280	A10p26060.2_BraZ1	831	-	331	998	1013	0.9851925
A10	16825923	16826097	A10p26070.2_BraZ1	17.4	-	0	0	174	0.0000000
A10	16826519	16826645	A10p26080.2_BraZ1	12.6	-	0	0	126	0.0000000
A10	16836896	16838957	A10p26090.2_BraZ1	929.898	+	996	2058	2061	0.9985444
A10	16840364	16842512	A10p26100.2_BraZ1	1266.67	-	1194	2106	2148	0.9804469
A10	16843993	16845916	A10p26110.2_BraZ1	192.3	+	478	1789	1923	0.9303172
A10	16846892	16848002	A10p26120.2_BraZ1	798	+	260	775	1110	0.6981982
A10	16850308	16854437	A10p26130.2_BraZ1	1977.82	-	1311	3795	4129	0.9191087
A10	16855538	16859897	A10p26140.2_BraZ1	2338.9	-	1908	4258	4359	0.9768295
A10	16861968	16862712	A10p26150.2_BraZ1	74.4	+	369	744	744	1.0000000
A10	16865419	16866420	A10p26160.2_BraZ1	444	+	356	998	1001	0.9970030
A10	16867036	16867797	A10p26170.2_BraZ1	7020	-	45	385	761	0.5059133
A10	16868899	16872743	A10p26180.2_BraZ1	2024.63	-	3631	3594	3844	0.9349636
A10	16875841	16877970	A10p26190.2_BraZ1	672.37	+	962	2035	2129	0.9558478
A10	16878388	16881239	A10p26200.2_BraZ1	1929	-	980	2640	2851	0.9259909
A10	16882253	16884251	A10p26210.2_BraZ1	1014.09	+	1158	1998	1998	1.0000000
A10	16885425	16895510	A10p26220.2_BraZ1	586.8	+	3891	9776	10085	0.9693604
A10	16896166	16902995	A10p26230.2_BraZ1	277.2	+	188	627	6829	0.0918143
A10	16904720	16906854	A10p26240.2_BraZ1	735.656	+	808	2134	2134	1.0000000
A10	16907124	16909434	A10p26250.2_BraZ1	231	-	272	1939	2310	0.8393939
A10	16912883	16914216	A10p26260.2_BraZ1	4944	+	641	1311	1333	0.9834959
A10	16914895	16916026	A10p26270.2_BraZ1	112.5	-	554	1070	1131	0.9460654
A10	16922991	16924116	A10p26280.2_BraZ1	112.5	-	423	1120	1125	0.9955556
A10	16929729	16930134	A10p26290.2_BraZ1	40.5	-	59	405	405	1.0000000
A10	16938816	16941083	A10p26300.2_BraZ1	1713	+	634	2117	2267	0.9338332
A10	16943651	16945109	A10p26310.2_BraZ1	145.8	+	183	1136	1458	0.7791495
A10	16946159	16946390	A10p26320.2_BraZ1	23.1	+	133	231	231	1.0000000
A10	16947153	16947303	A10p26330.2_BraZ1	15	+	185	150	150	1.0000000
A10	16949598	16951718	A10p26340.2_BraZ1	837	+	2081	2083	2120	0.9825472
A10	16953667	16955821	A10p26350.2_BraZ1	1659	+	439	1769	2154	0.8212628
A10	16956357	16958301	A10p26360.2_BraZ1	194.4	-	454	1901	1944	0.9778807
A10	16960740	16965466	A10p26370.2_BraZ1	1427.86	+	1549	4552	4726	0.9631824
A10	16965967	16968140	A10p26380.2_BraZ1	1072.25	+	2132	2173	2173	1.0000000
A10	16968445	16970219	A10p26390.2_BraZ1	8101.5	-	689	1731	1774	0.9757610
A10	16970839	16972861	A10p26400.2_BraZ1	908.687	-	943	2015	2022	0.9965381
A10	16975668	16977769	A10p26410.2_BraZ1	900	-	869	1973	2101	0.9390766
A10	16978421	16979297	A10p26420.2_BraZ1	87.6	+	15	245	876	0.2796804
A10	16980782	16983974	A10p26430.2_BraZ1	1382.87	-	828	2811	3192	0.8806391
A10	16989730	16991584	A10p26440.2_BraZ1	915.75	-	1228	1690	1854	0.9115426
A10	16992411	16992900	A10p26450.2_BraZ1	165	+	400	489	489	1.0000000
A10	16995517	16997759	A10p26460.2_BraZ1	1650.38	+	409	1900	2242	0.8474576
A10	16999332	17004515	A10p26470.2_BraZ1	3332.1	+	1421	4320	5183	0.8334941
A10	17005516	17007461	A10p26480.2_BraZ1	1067.64	+	1819	1945	1945	1.0000000
A10	17008336	17015615	A10p26490.2_BraZ1	5104.17	-	2384	6771	7279	0.9302102
A10	17019067	17019983	A10p26500.2_BraZ1	479.511	+	368	900	916	0.9825327
A10	17020263	17021736	A10p26510.2_BraZ1	862.773	-	431	1460	1473	0.9911745
A10	17021925	17027649	A10p26520.2_BraZ1	2391.84	+	2747	5533	5724	0.9666317
A10	17028450	17029519	A10p26530.2_BraZ1	522.5	+	1042	1069	1069	1.0000000
A10	17029887	17036471	A10p26540.2_BraZ1	2232	-	2533	5339	6584	0.8109052
A10	17036623	17037298	A10p26550.2_BraZ1	66.9	+	43	249	675	0.3688889
A10	17040832	17041153	A10p26560.2_BraZ1	32.1	-	31	140	321	0.4361371
A10	17042856	17044119	A10p26570.2_BraZ1	927	+	215	1163	1263	0.9208235
A10	17048761	17049722	A10p26580.2_BraZ1	396.129	-	810	961	961	1.0000000
A10	17050140	17051538	A10p26590.2_BraZ1	752.632	+	603	1340	1398	0.9585122
A10	17052336	17053425	A10p26600.2_BraZ1	108.9	+	84	891	1089	0.8181818
A10	17053804	17055958	A10p26610.2_BraZ1	1851	-	625	2154	2154	1.0000000
A10	17059648	17061033	A10p26620.2_BraZ1	519	+	73	770	1385	0.5559567
A10	17061291	17066911	A10p26630.2_BraZ1	607.5	+	382	2833	5620	0.5040925
A10	17062147	17062756	A10p26640.2_BraZ1	60.9	+	179	583	609	0.9573070
A10	17068517	17070148	A10p26650.2_BraZ1	17848	+	546	1623	1631	0.9950950
A10	17070847	17076496	A10p26660.2_BraZ1	4554	+	4165	5649	5649	1.0000000
A10	17077052	17078679	A10p26670.2_BraZ1	571.2	+	1884	1627	1627	1.0000000
A10	17079404	17080121	A10p26680.2_BraZ1	381	-	64	288	717	0.4016736
A10	17082754	17084310	A10p26690.2_BraZ1	590.4	+	1244	1556	1556	1.0000000
A10	17085084	17085581	A10p26700.2_BraZ1	330	-	231	497	497	1.0000000
A10	17085641	17087650	A10p26710.2_BraZ1	445.143	-	1343	2009	2009	1.0000000
A10	17088310	17091382	A10p26720.2_BraZ1	1534.09	+	1696	3022	3072	0.9837239
A10	17091902	17092277	A10p26730.2_BraZ1	37.5	+	78	364	375	0.9706666
A10	17093200	17095240	A10p26740.2_BraZ1	1457.43	-	367	1752	2040	0.8588235
A10	17096000	17100959	A10p26750.2_BraZ1	2307.75	+	2503	4878	4959	0.9836661
A10	17101371	17102008	A10p26760.2_BraZ1	363	-	212	623	637	0.9780220
A10	17102294	17102702	A10p26770.2_BraZ1	306	+	127	408	408	1.0000000
A10	17103354	17105892	A10p26780.2_BraZ1	1050.14	-	1784	2538	2538	1.0000000
A10	17107447	17109391	A10p26790.2_BraZ1	193.8	+	340	1716	1944	0.8827161
A10	17109816	17111123	A10p26800.2_BraZ1	677.16	-	375	1210	1307	0.9257842
A10	17111655	17114094	A10p26810.2_BraZ1	243.9	-	235	2226	2439	0.9126691
A10	17115970	17120645	A10p26820.2_BraZ1	1207.76	+	1016	4291	4675	0.9178610
A10	17123308	17124331	A10p26830.2_BraZ1	102.3	-	245	1023	1023	1.0000000
A10	17125917	17126162	A10p26840.2_BraZ1	123	+	367	245	245	1.0000000
A10	17126188	17129014	A10p26850.2_BraZ1	970.256	-	2277	2813	2826	0.9953998
A10	17129607	17130072	A10p26860.2_BraZ1	46.5	+	195	465	465	1.0000000
A10	17132949	17134467	A10p26870.2_BraZ1	151.8	+	339	1390	1518	0.9156785
A10	17135813	17138445	A10p26880.2_BraZ1	1775.71	+	844	2334	2632	0.8867781
A10	17144428	17144758	A10p26890.2_BraZ1	33	-	473	330	330	1.0000000
A10	17145839	17148129	A10p26900.2_BraZ1	1003.95	+	1141	2219	2290	0.9689956
A10	17149926	17151406	A10p26910.2_BraZ1	566.611	-	519	1477	1480	0.9979730
A10	17156787	17157210	A10p26920.2_BraZ1	42.3	+	33	177	423	0.4184397
A10	17158858	17159080	A10p26930.2_BraZ1	22.2	-	441	222	222	1.0000000
A10	17160179	17162502	A10p26940.2_BraZ1	1544.7	-	771	2109	2323	0.9078777
A10	17167370	17168972	A10p26950.2_BraZ1	672.727	+	227	1491	1602	0.9307116
A10	17169368	17171121	A10p26960.2_BraZ1	577.1	-	812	1692	1753	0.9652025
A10	17171858	17172713	A10p26970.2_BraZ1	85.5	-	165	823	855	0.9625731
A10	17174503	17177058	A10p26980.2_BraZ1	2121	-	2046	2555	2555	1.0000000
A10	17178307	17180308	A10p26990.2_BraZ1	1458	+	569	1981	2001	0.9900050
A10	17180734	17182286	A10p27000.2_BraZ1	701.25	-	1116	1404	1552	0.9046392
A10	17183857	17184962	A10p27010.2_BraZ1	901	+	206	1096	1105	0.9918552
A10	17186132	17186642	A10p27020.2_BraZ1	50.1	+	320	510	510	1.0000000
A10	17186901	17188475	A10p27030.2_BraZ1	868.224	-	1024	1574	1574	1.0000000
A10	17189303	17195849	A10p27040.2_BraZ1	1653.24	+	2375	4084	6546	0.6238924
A10	17197383	17199341	A10p27050.2_BraZ1	651	+	423	1502	1958	0.7671093
A10	17200178	17201387	A10p27060.2_BraZ1	661.2	-	445	1116	1209	0.9230769
A10	17204579	17204774	A10p27070.2_BraZ1	19.5	-	57	195	195	1.0000000
A10	17207553	17209213	A10p27080.2_BraZ1	309	-	636	1632	1660	0.9831325
A10	17210797	17213516	A10p27090.2_BraZ1	1024.53	-	736	2458	2719	0.9040088
A10	17216031	17216184	A10p27100.2_BraZ1	15.3	+	19	153	153	1.0000000
A10	17223873	17231821	A10p27110.2_BraZ1	3643.59	+	1214	6014	7948	0.7566683
A10	17233352	17235715	A10p27120.2_BraZ1	858.4	-	649	2112	2363	0.8937791
A10	17238666	17245977	A10p27130.2_BraZ1	201	+	2563	5500	7311	0.7522911
A10	17248233	17250673	A10p27140.2_BraZ1	1104	-	1007	1663	2440	0.6815574
A10	17253757	17260721	A10p27150.2_BraZ1	104.087	-	1181	4506	6964	0.6470419
A10	17255416	17256019	A10p27160.2_BraZ1	441	+	355	603	603	1.0000000
A10	17256194	17256577	A10p27170.2_BraZ1	234	+	9	273	383	0.7127937
A10	17261171	17261483	A10p27180.2_BraZ1	186	-	19	273	312	0.8750000
A10	17267529	17269238	A10p27190.2_BraZ1	875.5	-	286	1615	1709	0.9449971
A10	17270803	17272496	A10p27200.2_BraZ1	720.09	-	974	1602	1693	0.9462492
A10	17273495	17273913	A10p27210.2_BraZ1	650.769	-	168	418	418	1.0000000
A10	17274293	17275374	A10p27220.2_BraZ1	2919	+	360	992	1081	0.9176688
A10	17276300	17278606	A10p27230.2_BraZ1	1599.48	+	865	2052	2306	0.8898526
A10	17283678	17284401	A10p27240.2_BraZ1	72.3	+	107	598	723	0.8271093
A10	17291953	17300207	A10p27250.2_BraZ1	3916.15	+	4002	8241	8254	0.9984250
A10	17301490	17302947	A10p27260.2_BraZ1	594.286	+	335	1430	1457	0.9814688
A10	17305407	17306421	A10p27270.2_BraZ1	101.4	+	205	1005	1014	0.9911243
A10	17310449	17316751	A10p27280.2_BraZ1	2356	-	1235	3521	6302	0.5587115
A10	17323065	17327039	A10p27290.2_BraZ1	2078.87	-	1709	3823	3974	0.9620030
A10	17328168	17329509	A10p27300.2_BraZ1	598.516	-	771	1341	1341	1.0000000
A10	17330259	17332043	A10p27310.2_BraZ1	969	+	1143	1784	1784	1.0000000
A10	17334015	17337500	A10p27320.2_BraZ1	1573.59	+	2143	3411	3485	0.9787661
A10	17343732	17344714	A10p27330.2_BraZ1	831	+	437	982	982	1.0000000
A10	17345612	17345792	A10p27340.2_BraZ1	18	-	64	180	180	1.0000000
A10	17346684	17348613	A10p27350.2_BraZ1	835.696	-	1928	1923	1929	0.9968896
A10	17349140	17349837	A10p27360.2_BraZ1	576	+	571	697	697	1.0000000
A10	17350851	17354523	A10p27370.2_BraZ1	2691.59	-	1117	3049	3672	0.8303377
A10	17354852	17357779	A10p27380.2_BraZ1	452.682	-	1403	2741	2927	0.9364537
A10	17357900	17358265	A10p27390.2_BraZ1	129	-	618	365	365	1.0000000
A10	17360356	17366585	A10p27400.2_BraZ1	1524	+	3656	5896	6229	0.9465404
A10	17367135	17368558	A10p27410.2_BraZ1	157.832	+	942	1423	1423	1.0000000
A10	17369056	17371273	A10p27420.2_BraZ1	2002.29	-	407	1825	2217	0.8231845
A10	17372139	17375038	A10p27430.2_BraZ1	1858.67	-	1560	2868	2899	0.9893066
A10	17375485	17379388	A10p27440.2_BraZ1	2192.79	-	1613	3526	3903	0.9034076
A10	17380534	17381839	A10p27450.2_BraZ1	448.594	-	714	1295	1305	0.9923372
A10	17382167	17383613	A10p27460.2_BraZ1	1043.54	+	480	1394	1446	0.9640387
A10	17387814	17389854	A10p27470.2_BraZ1	1137.9	+	723	1878	2040	0.9205883
A10	17394308	17396170	A10p27480.2_BraZ1	1791	-	897	1737	1862	0.9328679
A10	17398471	17404345	A10p27490.2_BraZ1	1682.18	+	2459	5435	5874	0.9252639
A10	17401820	17402731	A10p27500.2_BraZ1	613.219	-	171	556	911	0.6103183
A10	17405305	17405467	A10p27510.2_BraZ1	16.2	+	52	162	162	1.0000000
A10	17407658	17408372	A10p27520.2_BraZ1	71.4	+	484	714	714	1.0000000
A10	17409529	17412756	A10p27530.2_BraZ1	1676.05	-	3114	3227	3227	1.0000000
A10	17413342	17414555	A10p27540.2_BraZ1	691.429	+	1230	1213	1213	1.0000000
A10	17415370	17416423	A10p27550.2_BraZ1	105.3	-	186	1007	1053	0.9563153
A10	17423263	17424191	A10p27560.2_BraZ1	798	-	148	928	928	1.0000000
A10	17427608	17430901	A10p27570.2_BraZ1	1134.47	-	1070	2942	3293	0.8934103
A10	17431548	17434503	A10p27580.2_BraZ1	1098.96	+	601	1993	2955	0.6744501
A10	17435058	17435987	A10p27590.2_BraZ1	3948	-	602	929	929	1.0000000
A10	17440463	17441663	A10p27600.2_BraZ1	530.434	+	1039	1200	1200	1.0000000
A10	17442611	17443900	A10p27610.2_BraZ1	640.385	+	363	1158	1289	0.8983708
A10	17444235	17447506	A10p27620.2_BraZ1	2020.43	-	937	3256	3271	0.9954143
A10	17448786	17449437	A10p27630.2_BraZ1	594	-	496	651	651	1.0000000
A10	17452641	17454159	A10p27640.2_BraZ1	288.585	+	11	388	1518	0.2555995
A10	17455932	17457046	A10p27650.2_BraZ1	222	+	979	1114	1114	1.0000000
A10	17457348	17458017	A10p27660.2_BraZ1	66.9	-	392	669	669	1.0000000
A10	17463241	17463762	A10p27670.2_BraZ1	964.8	+	54	429	521	0.8234165
A10	17464907	17465681	A10p27680.2_BraZ1	442.55	-	329	769	774	0.9935400
A10	17467173	17467620	A10p27690.2_BraZ1	44.7	+	76	314	447	0.7024608
A10	17471068	17475812	A10p27700.2_BraZ1	3514.41	-	429	3928	4744	0.8279933
A10	17476171	17479593	A10p27710.2_BraZ1	1338.33	+	2004	3422	3422	1.0000000
A10	17481549	17483908	A10p27720.2_BraZ1	1133.47	+	1207	2359	2359	1.0000000
A10	17484658	17489261	A10p27730.2_BraZ1	371.111	-	1730	4495	4603	0.9765370
A10	17491561	17492725	A10p27740.2_BraZ1	116.4	+	418	1164	1164	1.0000000
A10	17494748	17495195	A10p27750.2_BraZ1	44.7	-	16	415	447	0.9284117
A10	17506600	17507329	A10p27760.2_BraZ1	72.9	-	105	570	729	0.7818930
A10	17512052	17512889	A10p27770.2_BraZ1	83.7	-	440	837	837	1.0000000
A10	17517478	17517805	A10p27780.2_BraZ1	32.7	-	820	327	327	1.0000000
A10	17518505	17522926	A10p27790.2_BraZ1	2020.59	+	1865	4023	4421	0.9099751
A10	17525088	17526390	A10p27800.2_BraZ1	130.2	+	154	1118	1302	0.8586789
A10	17528091	17532158	A10p27810.2_BraZ1	2041.95	-	3207	4012	4067	0.9864765
A10	17532920	17538879	A10p27820.2_BraZ1	1997.52	+	2516	5472	5959	0.9182749
A10	17539740	17539869	A10p27830.2_BraZ1	12.9	+	94	129	129	1.0000000
A10	17550830	17551319	A10p27840.2_BraZ1	48.9	+	114	489	489	1.0000000
A10	17555083	17557151	A10p27850.2_BraZ1	1453.5	+	422	1962	2068	0.9487427
A10	17557347	17561283	A10p27860.2_BraZ1	250.362	+	1952	3781	3936	0.9606199
A10	17561305	17563701	A10p27870.2_BraZ1	171	+	2093	2396	2396	1.0000000
A10	17563138	17564099	A10p27880.2_BraZ1	333	+	585	961	961	1.0000000
A10	17566201	17567156	A10p27890.2_BraZ1	491.4	+	114	317	955	0.3319372
A10	17570457	17574101	A10p27900.2_BraZ1	595.904	+	3571	3644	3644	1.0000000
A10	17575328	17586546	A10p27910.2_BraZ1	578.592	+	8340	11059	11218	0.9858264
A10	17577473	17577782	A10p27920.2_BraZ1	30.9	-	145	309	309	1.0000000
A10	17582404	17583844	A10p27930.2_BraZ1	144	-	1230	1440	1440	1.0000000
A10	17586760	17590052	A10p27940.2_BraZ1	2487.23	-	1056	3072	3292	0.9331713
A10	17594853	17595391	A10p27950.2_BraZ1	288	+	261	514	538	0.9553903
A10	17595601	17595805	A10p27960.2_BraZ1	132	-	148	204	204	1.0000000
A10	17596360	17597428	A10p27970.2_BraZ1	106.8	-	609	1068	1068	1.0000000
A10	17600938	17602890	A10p27980.2_BraZ1	1391.37	+	2811	1952	1952	1.0000000
A10	17603249	17603728	A10p27990.2_BraZ1	219	-	948	479	479	1.0000000
A10	17605269	17605599	A10p28000.2_BraZ1	33	-	709	330	330	1.0000000
A10	17610180	17614621	A10p28010.2_BraZ1	1500	-	1440	3616	4441	0.8142310
A10	17615988	17628507	A10p28020.2_BraZ1	1123.2	-	455	4532	12519	0.3620097
A10	17633000	17634473	A10p28030.2_BraZ1	1191.86	-	359	1416	1473	0.9613035
A10	17636379	17639411	A10p28040.2_BraZ1	2138.4	+	1661	2955	3032	0.9746042
A10	17644032	17645665	A10p28050.2_BraZ1	855	+	625	1496	1633	0.9161053
A10	17646000	17646461	A10p28060.2_BraZ1	435.6	-	299	461	461	1.0000000
A10	17646572	17646716	A10p28070.2_BraZ1	14.4	+	242	144	144	1.0000000
A10	17648995	17651095	A10p28080.2_BraZ1	1230.17	+	860	1983	2100	0.9442857
A10	17651675	17655600	A10p28090.2_BraZ1	1599.48	-	1912	3925	3925	1.0000000
A10	17664006	17666642	A10p28100.2_BraZ1	25590	-	665	1926	2636	0.7306525
A10	17667645	17671138	A10p28110.2_BraZ1	1989.63	+	2466	3491	3493	0.9994274
A10	17671349	17673246	A10p28120.2_BraZ1	592.266	+	1630	1742	1897	0.9182920
A10	17673810	17682819	A10p28130.2_BraZ1	3087.36	-	4928	8152	9009	0.9048729
A10	17680266	17681157	A10p28140.2_BraZ1	240	+	966	891	891	1.0000000
A10	17687991	17688348	A10p28150.2_BraZ1	129	+	577	357	357	1.0000000
A10	17691734	17693400	A10p28160.2_BraZ1	808.176	+	1194	1602	1666	0.9615846
A10	17696310	17696742	A10p28170.2_BraZ1	43.2	+	461	432	432	1.0000000
A10	17698265	17701765	A10p28180.2_BraZ1	298.125	+	3168	3500	3500	1.0000000
A10	17702647	17705019	A10p28190.2_BraZ1	1221.29	+	1600	2289	2372	0.9650084
A10	17706185	17716483	A10p28200.2_BraZ1	1844.46	+	3103	8556	10298	0.8308409
A10	17709422	17710166	A10p28210.2_BraZ1	74.4	-	89	295	744	0.3965054
A10	17710590	17711334	A10p28220.2_BraZ1	74.4	+	97	261	744	0.3508064
A10	17716908	17718114	A10p28230.2_BraZ1	1059	-	87	634	1206	0.5257048
A10	17719536	17719950	A10p28240.2_BraZ1	41.1	+	266	414	414	1.0000000
A10	17720887	17721304	A10p28250.2_BraZ1	41.1	+	241	417	417	1.0000000
A10	17723045	17723900	A10p28260.2_BraZ1	85.5	-	466	855	855	1.0000000
A10	17724522	17730106	A10p28270.2_BraZ1	4483.14	-	2336	5366	5584	0.9609599
A10	17731061	17732398	A10p28280.2_BraZ1	719.489	+	756	1337	1337	1.0000000
A10	17732698	17733523	A10p28290.2_BraZ1	672	-	113	799	825	0.9684848
A10	17733884	17736313	A10p28300.2_BraZ1	1039.41	+	2110	2429	2429	1.0000000
A10	17743389	17743875	A10p28310.2_BraZ1	366	+	223	486	486	1.0000000
A10	17744707	17745782	A10p28320.2_BraZ1	795.5	-	365	837	1075	0.7786046
A10	17748121	17748647	A10p28330.2_BraZ1	195	-	266	526	526	1.0000000
A10	17754152	17755520	A10p28340.2_BraZ1	97.8	-	149	836	1368	0.6111111
A10	17760127	17761598	A10p28350.2_BraZ1	282	-	536	1344	1471	0.9136642
A10	17762904	17765595	A10p28360.2_BraZ1	1415.1	+	666	2616	2691	0.9721293
A10	17765945	17767398	A10p28370.2_BraZ1	585.514	-	1191	1453	1453	1.0000000
A10	17768491	17771058	A10p28380.2_BraZ1	1362.96	+	2993	2544	2567	0.9910401
A10	17772912	17775418	A10p28390.2_BraZ1	1446.31	+	748	1904	2506	0.7597765
A10	17775468	17777224	A10p28400.2_BraZ1	957	+	111	1239	1756	0.7055809
A10	17777425	17778007	A10p28410.2_BraZ1	58.2	-	38	331	582	0.5687285
A10	17787586	17789593	A10p28420.2_BraZ1	1896	-	68	739	2007	0.3682113
A10	17797988	17801452	A10p28430.2_BraZ1	1534.53	-	1175	2011	3464	0.5805427
A10	17804659	17806650	A10p28440.2_BraZ1	790.769	+	522	1900	1991	0.9542943
A10	17817908	17818192	A10p28450.2_BraZ1	195	-	30	284	284	1.0000000
A10	17822305	17823969	A10p28460.2_BraZ1	326.4	+	962	1409	1664	0.8467548
A10	17825276	17826127	A10p28470.2_BraZ1	8365.5	+	381	851	851	1.0000000
A10	17827142	17827440	A10p28480.2_BraZ1	156	+	33	298	298	1.0000000
A10	17841140	17843069	A10p28490.2_BraZ1	1683	+	637	1542	1929	0.7993779
A10	17845080	17847384	A10p28500.2_BraZ1	1440.13	-	2538	2304	2304	1.0000000
A10	17847908	17850564	A10p28510.2_BraZ1	807.913	+	1262	2656	2656	1.0000000
A10	17851124	17851397	A10p28520.2_BraZ1	27.3	-	268	273	273	1.0000000
A10	17855587	17857228	A10p28530.2_BraZ1	852.266	+	784	1578	1641	0.9616088
A10	17860091	17863403	A10p28540.2_BraZ1	3242.13	-	1584	3312	3312	1.0000000
A10	17866911	17870608	A10p28550.2_BraZ1	1165.96	-	1651	2980	3697	0.8060589
A10	17871668	17872109	A10p28560.2_BraZ1	43.8	-	328	441	441	1.0000000
A10	17872436	17873583	A10p28570.2_BraZ1	645.938	+	929	1147	1147	1.0000000
A10	17873799	17874135	A10p28580.2_BraZ1	255	-	86	316	336	0.9404762
A10	17875556	17875978	A10p28590.2_BraZ1	212.143	-	54	345	422	0.8175355
A10	17879950	17881672	A10p28600.2_BraZ1	1605	-	172	1059	1722	0.6149826
A10	17887424	17889671	A10p28610.2_BraZ1	585.083	-	779	2216	2247	0.9862038
A10	17890732	17893669	A10p28620.2_BraZ1	1867.21	+	1791	2907	2937	0.9897855
A10	17894210	17895330	A10p28630.2_BraZ1	5971.68	-	251	1094	1120	0.9767857
A10	17895954	17898117	A10p28640.2_BraZ1	1272.39	+	1119	2163	2163	1.0000000
A10	17898812	17901873	A10p28650.2_BraZ1	1541	+	1740	2821	3061	0.9215943
A10	17902784	17903069	A10p28660.2_BraZ1	28.5	-	201	285	285	1.0000000
A10	17905086	17906552	A10p28670.2_BraZ1	892.368	+	953	1466	1466	1.0000000
A10	17907401	17907714	A10p28680.2_BraZ1	240	+	74	309	313	0.9872205
A10	17909468	17909975	A10p28690.2_BraZ1	33.9	+	1016	507	507	1.0000000
A10	17910792	17913523	A10p28700.2_BraZ1	2556	-	1694	2730	2731	0.9996338
A10	17913749	17914616	A10p28710.2_BraZ1	287.206	+	605	867	867	1.0000000
A10	17915722	17917133	A10p28720.2_BraZ1	113.4	-	620	1345	1411	0.9532247
A10	17921916	17922228	A10p28730.2_BraZ1	31.2	-	293	312	312	1.0000000
A10	17924843	17926566	A10p28740.2_BraZ1	926.4	+	758	1714	1723	0.9947765
A10	17928428	17929646	A10p28750.2_BraZ1	121.8	-	307	596	1218	0.4893268
A10	17930873	17932557	A10p28760.2_BraZ1	1356	-	157	1463	1684	0.8687648
A10	17946472	17948693	A10p28770.2_BraZ1	1203.22	+	806	2029	2221	0.9135525
A10	17949563	17955929	A10p28780.2_BraZ1	2395.28	+	3018	6278	6366	0.9861766
A10	17956551	17958021	A10p28790.2_BraZ1	798.891	+	419	1470	1470	1.0000000
A10	17958563	17961622	A10p28800.2_BraZ1	709.125	-	1789	2939	3059	0.9607715
A10	17960850	17962235	A10p28810.2_BraZ1	281.782	-	615	1347	1385	0.9725631
A10	17967360	17968794	A10p28820.2_BraZ1	143.4	+	752	1434	1434	1.0000000
A10	17970376	17971621	A10p28830.2_BraZ1	611.059	-	581	1140	1245	0.9156626
A10	17972315	17973378	A10p28840.2_BraZ1	424.65	-	801	1063	1063	1.0000000
A10	17974122	17976653	A10p28850.2_BraZ1	1214.19	-	1496	2426	2531	0.9585144
A10	17977174	17978050	A10p28860.2_BraZ1	87.6	+	637	876	876	1.0000000
A10	17979105	17981573	A10p28870.2_BraZ1	1023	+	1732	2394	2468	0.9700162
A10	17984485	17986018	A10p28880.2_BraZ1	705.231	+	1383	1521	1533	0.9921722
A10	17988705	17989344	A10p28890.2_BraZ1	35	+	0	0	639	0.0000000
A10	17990610	17991504	A10p28900.2_BraZ1	89.4	-	117	701	894	0.7841163
A10	17997427	18000582	A10p28910.2_BraZ1	1265.76	-	1750	3152	3155	0.9990491
A10	18000443	18002173	A10p28920.2_BraZ1	824.056	-	518	1698	1730	0.9815029
A10	18003725	18008559	A10p28930.2_BraZ1	2376	-	2063	4800	4834	0.9929665
A10	18009156	18011146	A10p28940.2_BraZ1	946.098	-	361	1887	1990	0.9482412
A10	18011686	18013486	A10p28950.2_BraZ1	786.806	+	828	1800	1800	1.0000000
A10	18014644	18017180	A10p28960.2_BraZ1	1600.39	+	1602	2529	2536	0.9972398
A10	18019119	18020827	A10p28970.2_BraZ1	1038.4	+	515	1708	1708	1.0000000
A10	18021342	18023398	A10p28980.2_BraZ1	1522.97	+	797	2002	2056	0.9737354
A10	18023683	18024551	A10p28990.2_BraZ1	45.9	+	267	868	868	1.0000000
A10	18025216	18025816	A10p29000.2_BraZ1	432	+	402	600	600	1.0000000
A10	18026362	18027676	A10p29010.2_BraZ1	1108.58	+	179	930	1314	0.7077625
A10	18027931	18030735	A10p29020.2_BraZ1	1046.4	-	1810	2545	2804	0.9076319
A10	18031077	18031905	A10p29030.2_BraZ1	2862	+	407	662	828	0.7995169
A10	18033124	18033284	A10p29040.2_BraZ1	12.9	+	91	160	160	1.0000000
A10	18033530	18035490	A10p29050.2_BraZ1	1442.24	-	329	1506	1960	0.7683674
A10	18036624	18037017	A10p29060.2_BraZ1	39.3	+	28	172	393	0.4376590
A10	18044640	18045643	A10p29070.2_BraZ1	795.15	+	354	1003	1003	1.0000000
A10	18045883	18047588	A10p29080.2_BraZ1	1188.07	-	1479	1705	1705	1.0000000
A10	18048015	18048900	A10p29090.2_BraZ1	88.5	+	215	885	885	1.0000000
A10	18049745	18050064	A10p29100.2_BraZ1	204	-	531	319	319	1.0000000
A10	18051030	18052291	A10p29110.2_BraZ1	1101	-	595	1245	1261	0.9873117
A10	18053937	18056193	A10p29120.2_BraZ1	1457.61	+	522	2091	2256	0.9268617
A10	18057065	18059151	A10p29130.2_BraZ1	2016	+	1446	2079	2086	0.9966443
A10	18059632	18063410	A10p29140.2_BraZ1	2187	+	1717	3699	3778	0.9790894
A10	18071901	18074434	A10p29150.2_BraZ1	1642.23	-	605	2222	2533	0.8772207
A10	18074863	18077285	A10p29160.2_BraZ1	1600.96	+	1298	2422	2422	1.0000000
A10	18077746	18080634	A10p29170.2_BraZ1	1822.6	-	1103	2735	2888	0.9470221
A10	18083453	18085014	A10p29180.2_BraZ1	12132	-	410	1547	1561	0.9910314
A10	18086665	18089702	A10p29190.2_BraZ1	1964.53	+	267	2306	3037	0.7593020
A10	18090205	18096954	A10p29200.2_BraZ1	3691.45	-	1884	6187	6749	0.9167284
A10	18099545	18101612	A10p29210.2_BraZ1	910.8	-	1294	2064	2067	0.9985486
A10	18102109	18103781	A10p29220.2_BraZ1	995.28	+	681	1672	1672	1.0000000
A10	18104407	18106300	A10p29230.2_BraZ1	1470.43	-	884	1863	1893	0.9841521
A10	18108881	18111193	A10p29240.2_BraZ1	1743	+	1023	2312	2312	1.0000000
A10	18111962	18116003	A10p29250.2_BraZ1	2556.29	+	856	3592	4041	0.8888889
A10	18116449	18117997	A10p29260.2_BraZ1	973.356	-	1248	1548	1548	1.0000000
A10	18118560	18119549	A10p29270.2_BraZ1	359.9	-	806	989	989	1.0000000
A10	18120572	18122033	A10p29280.2_BraZ1	146.1	+	136	1034	1461	0.7077344
A10	18124127	18125709	A10p29290.2_BraZ1	885	+	920	1442	1582	0.9115044
A10	18125932	18127566	A10p29300.2_BraZ1	1539	-	663	1562	1634	0.9559364
A10	18128112	18128429	A10p29310.2_BraZ1	237	+	141	311	317	0.9810725
A10	18129860	18131453	A10p29320.2_BraZ1	1131.3	+	181	1224	1593	0.7683616
A10	18132039	18134863	A10p29330.2_BraZ1	1739.64	-	380	2140	2824	0.7577904
A10	18135617	18136104	A10p29340.2_BraZ1	411	+	39	397	487	0.8151951
A10	18136184	18144628	A10p29350.2_BraZ1	3530.36	-	1680	5715	8444	0.6768119
A10	18144967	18147004	A10p29360.2_BraZ1	1058.18	-	1223	1992	2037	0.9779087
A10	18148527	18151317	A10p29370.2_BraZ1	922.636	+	879	2541	2790	0.9107527
A10	18151979	18153841	A10p29380.2_BraZ1	1458	+	130	791	1862	0.4248120
A10	18154105	18159139	A10p29390.2_BraZ1	1859.12	-	2897	4882	5034	0.9698053
A10	18162121	18164247	A10p29400.2_BraZ1	6324.6	-	139	1445	2126	0.6796802
A10	18164771	18167147	A10p29410.2_BraZ1	773.333	-	562	2007	2376	0.8446970
A10	18168504	18169209	A10p29420.2_BraZ1	70.5	-	134	599	705	0.8496454
A10	18170953	18171282	A10p29430.2_BraZ1	243	+	154	329	329	1.0000000
A10	18171915	18174381	A10p29440.2_BraZ1	246.6	+	383	2154	2466	0.8734793
A10	18174728	18174941	A10p29450.2_BraZ1	21.3	+	115	194	213	0.9107981
A10	18175309	18177239	A10p29460.2_BraZ1	1004.71	-	785	1829	1930	0.9476684
A10	18178560	18179102	A10p29470.2_BraZ1	3432	-	280	541	542	0.9981550
A10	18179538	18181238	A10p29480.2_BraZ1	931.622	+	1165	1700	1700	1.0000000
A10	18181446	18182993	A10p29490.2_BraZ1	713.696	-	370	1547	1547	1.0000000
A10	18183789	18188906	A10p29500.2_BraZ1	1296.43	-	2333	5028	5117	0.9826070
A10	18189743	18192229	A10p29510.2_BraZ1	942.875	-	91	784	2486	0.3153661
A10	18193761	18194824	A10p29520.2_BraZ1	822	+	128	923	1063	0.8682973
A10	18197516	18198710	A10p29530.2_BraZ1	717	+	227	1107	1194	0.9271357
A10	18199499	18205292	A10p29540.2_BraZ1	3658.37	+	1340	4788	5793	0.8265148
A10	18207819	18209823	A10p29550.2_BraZ1	1263	-	1278	1916	2004	0.9560878
A10	18211600	18212365	A10p29560.2_BraZ1	6012	-	608	765	765	1.0000000
A10	18215029	18216399	A10p29570.2_BraZ1	376.8	+	901	1366	1370	0.9970803
A10	18216852	18218970	A10p29580.2_BraZ1	874.194	+	1044	2008	2118	0.9480642
A10	18219310	18219686	A10p29590.2_BraZ1	27.9	+	164	376	376	1.0000000
A10	18220127	18222029	A10p29600.2_BraZ1	1027.09	+	749	1895	1902	0.9963197
A10	18222796	18223093	A10p29610.2_BraZ1	237	+	144	272	297	0.9158249
A10	18231026	18231434	A10p29620.2_BraZ1	40.8	+	727	408	408	1.0000000
A10	18233388	18234528	A10p29630.2_BraZ1	114	-	502	1140	1140	1.0000000
A10	18240642	18243457	A10p29640.2_BraZ1	1305.78	+	1804	2695	2815	0.9573712
A10	18244654	18246473	A10p29650.2_BraZ1	959.04	+	1353	1819	1819	1.0000000
A10	18247042	18254771	A10p29660.2_BraZ1	3582.43	+	4148	7536	7729	0.9750291
A10	18255308	18256839	A10p29670.2_BraZ1	790	+	1294	1531	1531	1.0000000
A10	18261616	18262009	A10p29680.2_BraZ1	39.3	-	250	393	393	1.0000000
A10	18262182	18262664	A10p29690.2_BraZ1	222	+	348	482	482	1.0000000
A10	18262976	18264588	A10p29700.2_BraZ1	897.75	+	530	1612	1612	1.0000000
A10	18265278	18267022	A10p29710.2_BraZ1	1553.18	-	1614	1744	1744	1.0000000
A10	18269461	18270251	A10p29720.2_BraZ1	281.571	-	27	276	790	0.3493671
A10	18270803	18272385	A10p29730.2_BraZ1	470.524	-	245	1363	1582	0.8615676
A10	18273470	18276221	A10p29740.2_BraZ1	1582.55	-	259	1661	2751	0.6037804
A10	18281264	18282400	A10p29750.2_BraZ1	215.25	-	690	1136	1136	1.0000000
A10	18282425	18288685	A10p29760.2_BraZ1	1585.09	+	2331	5852	6260	0.9348243
A10	18288894	18291458	A10p29770.2_BraZ1	1445.76	-	932	2367	2564	0.9231669
A10	18296309	18297806	A10p29780.2_BraZ1	149.7	+	821	1488	1497	0.9939880
A10	18301068	18303848	A10p29790.2_BraZ1	1378.03	+	813	2108	2780	0.7582734
A10	18304545	18307146	A10p29800.2_BraZ1	7390.5	-	2807	2601	2601	1.0000000
A10	18308039	18315172	A10p29810.2_BraZ1	3514.01	-	4664	6953	7133	0.9747652
A10	18316631	18322566	A10p29820.2_BraZ1	2702.16	+	3326	5825	5935	0.9814659
A10	18323280	18324648	A10p29830.2_BraZ1	136.8	-	245	1095	1368	0.8004386
A10	18325170	18325997	A10p29840.2_BraZ1	623.025	-	296	827	827	1.0000000
A10	18326641	18333437	A10p29850.2_BraZ1	3229.75	-	1344	5241	6796	0.7711889
A10	18341389	18342703	A10p29860.2_BraZ1	889.988	+	946	1314	1314	1.0000000
A10	18343255	18344017	A10p29870.2_BraZ1	76.2	+	140	705	762	0.9251968
A10	18346105	18347197	A10p29880.2_BraZ1	109.2	-	77	651	1092	0.5961539
A10	18355506	18357125	A10p29890.2_BraZ1	800.609	-	356	1243	1619	0.7677579
A10	18359035	18361077	A10p29900.2_BraZ1	1290	-	498	1640	2042	0.8031342
A10	18362993	18363467	A10p29910.2_BraZ1	47.4	+	87	405	474	0.8544304
A10	18363759	18365749	A10p29920.2_BraZ1	1123.81	-	1142	1661	1990	0.8346733
A10	18370382	18372036	A10p29930.2_BraZ1	1013.68	-	851	1654	1654	1.0000000
A10	18372870	18374193	A10p29940.2_BraZ1	132.3	-	84	801	1323	0.6054422
A10	18375143	18376541	A10p29950.2_BraZ1	139.8	-	251	1292	1398	0.9241774
A10	18379158	18380980	A10p29960.2_BraZ1	1350	+	418	1611	1822	0.8841932
A10	18381485	18382716	A10p29970.2_BraZ1	83.4	+	340	1178	1231	0.9569456
A10	18383202	18385166	A10p29980.2_BraZ1	1474	-	386	1942	1964	0.9887984
A10	18386105	18388045	A10p29990.2_BraZ1	1228.5	+	613	1836	1940	0.9463918
A10	18388396	18393288	A10p30000.2_BraZ1	3397.82	+	942	4253	4892	0.8693786
A10	18394277	18394965	A10p30010.2_BraZ1	400	-	130	617	688	0.8968023
A10	18396236	18401420	A10p30020.2_BraZ1	2826.62	-	3353	5079	5184	0.9797454
A10	18403956	18405663	A10p30030.2_BraZ1	750.545	+	935	1707	1707	1.0000000
A10	18409973	18412468	A10p30040.2_BraZ1	310.857	-	316	1606	2495	0.6436874
A10	18417160	18418586	A10p30050.2_BraZ1	1115.22	-	113	1017	1426	0.7131837
A10	18424338	18428386	A10p30060.2_BraZ1	2322	+	1921	3473	4048	0.8579546
A10	18434532	18435729	A10p30070.2_BraZ1	739.2	-	104	1047	1197	0.8746867
A10	18436881	18437193	A10p30080.2_BraZ1	31.2	+	131	257	312	0.8237180
A10	18437979	18439462	A10p30090.2_BraZ1	1065	+	177	1058	1483	0.7134187
A10	18439848	18441476	A10p30100.2_BraZ1	805.816	-	1493	1216	1628	0.7469288
A10	18442797	18444180	A10p30110.2_BraZ1	1008.41	-	859	1262	1383	0.9125090
A10	18444656	18447320	A10p30120.2_BraZ1	1417.1	+	867	2517	2664	0.9448198
A10	18449247	18452949	A10p30130.2_BraZ1	370.2	+	657	3112	3702	0.8406267
A10	18456053	18459838	A10p30140.2_BraZ1	1427.05	+	455	2793	3785	0.7379128
A10	18466864	18467885	A10p30150.2_BraZ1	99.6	-	392	1021	1021	1.0000000
A10	18472130	18476302	A10p30160.2_BraZ1	2207.17	+	1902	4018	4172	0.9630873
A10	18477875	18481288	A10p30170.2_BraZ1	1611.96	+	2195	3309	3413	0.9695283
A10	18482962	18484049	A10p30180.2_BraZ1	762	+	112	700	1087	0.6439742
A10	18484100	18495903	A10p30190.2_BraZ1	376	+	5734	10445	11803	0.8849445
A10	18496618	18497140	A10p30200.2_BraZ1	52.2	+	509	522	522	1.0000000
A10	18499155	18502141	A10p30210.2_BraZ1	1808.06	-	1400	2986	2986	1.0000000
A10	18507370	18508240	A10p30220.2_BraZ1	85.2	+	264	797	870	0.9160920
A10	18508642	18511740	A10p30230.2_BraZ1	1849.7	+	1307	3049	3098	0.9841834
A10	18517602	18521437	A10p30240.2_BraZ1	2143.69	-	2806	3644	3835	0.9501956
A10	18522519	18524168	A10p30250.2_BraZ1	1049.56	+	368	1543	1649	0.9357186
A10	18529862	18531500	A10p30260.2_BraZ1	1054.67	+	572	960	1638	0.5860806
A10	18533456	18535296	A10p30270.2_BraZ1	1193.22	+	541	1528	1840	0.8304348
A10	18535805	18536549	A10p30280.2_BraZ1	651	-	157	604	744	0.8118280
A10	18539264	18539967	A10p30290.2_BraZ1	615	-	182	701	703	0.9971551
A10	18540811	18541758	A10p30300.2_BraZ1	660	-	359	912	947	0.9630412
A10	18542134	18543003	A10p30310.2_BraZ1	594	-	451	869	869	1.0000000
A10	18546228	18548412	A10p30320.2_BraZ1	1038.78	+	859	1773	2184	0.8118132
A10	18550103	18550844	A10p30330.2_BraZ1	74.1	+	95	674	741	0.9095817
A10	18551209	18552113	A10p30340.2_BraZ1	528	-	292	842	904	0.9314159
A10	18557538	18558276	A10p30350.2_BraZ1	588	-	528	731	738	0.9905149
A10	18563479	18564614	A10p30360.2_BraZ1	113.4	-	616	1068	1135	0.9409692
A10	18570642	18571511	A10p30370.2_BraZ1	141	-	86	745	869	0.8573073
A10	18574325	18576502	A10p30380.2_BraZ1	1041	-	2241	1988	2177	0.9131833
A10	18579087	18579791	A10p30390.2_BraZ1	327	-	5	124	704	0.1761364
A10	18582280	18582916	A10p30400.2_BraZ1	63.6	+	79	515	636	0.8097484
A10	18583998	18586458	A10p30410.2_BraZ1	1326.93	-	1131	2103	2460	0.8548781
A10	18587726	18589473	A10p30420.2_BraZ1	10146	-	1075	1723	1747	0.9862621
A10	18591722	18595829	A10p30430.2_BraZ1	1126.34	+	3239	4107	4107	1.0000000
A10	18596253	18597710	A10p30440.2_BraZ1	1386	+	378	1448	1457	0.9938229
A10	18599189	18599838	A10p30450.2_BraZ1	30	+	1	58	649	0.0893683
A10	18602430	18603449	A10p30460.2_BraZ1	811.429	+	487	1019	1019	1.0000000
A10	18610157	18611720	A10p30470.2_BraZ1	988	+	483	1402	1563	0.8969930
A10	18620004	18621487	A10p30480.2_BraZ1	676.446	+	1471	1483	1483	1.0000000
A10	18621866	18623895	A10p30490.2_BraZ1	1294.13	+	1049	1982	2029	0.9768359
A10	18624659	18625139	A10p30500.2_BraZ1	48	+	230	480	480	1.0000000
A10	18625829	18627503	A10p30510.2_BraZ1	874.667	-	1259	1674	1674	1.0000000
A10	18628739	18631452	A10p30520.2_BraZ1	2619	+	1180	2621	2713	0.9660892
A10	18631576	18634166	A10p30530.2_BraZ1	2100.4	-	1123	2307	2590	0.8907336
A10	18636214	18637305	A10p30540.2_BraZ1	3996	-	67	912	1091	0.8359303
A10	18639011	18640172	A10p30550.2_BraZ1	1011	-	233	904	1161	0.7786391
A10	18641190	18642292	A10p30560.2_BraZ1	456.818	-	352	966	1102	0.8765880
A10	18644385	18645491	A10p30570.2_BraZ1	1005	-	946	809	1106	0.7314647
A10	18646279	18647347	A10p30580.2_BraZ1	999	-	142	933	1068	0.8735955
A10	18648083	18648559	A10p30590.2_BraZ1	228	+	746	476	476	1.0000000
A10	18649310	18649807	A10p30600.2_BraZ1	174	+	38	261	497	0.5251509
A10	18649833	18656969	A10p30610.2_BraZ1	1208.61	-	746	4127	7136	0.5783352
A10	18657959	18660368	A10p30620.2_BraZ1	1601.97	+	1810	2409	2409	1.0000000
A10	18661274	18664817	A10p30630.2_BraZ1	1967.47	-	1621	3351	3543	0.9458086
A10	18665197	18668532	A10p30640.2_BraZ1	1616.78	-	2652	3335	3335	1.0000000
A10	18670594	18673063	A10p30650.2_BraZ1	803.571	-	2779	2469	2469	1.0000000
A10	18677957	18678596	A10p30660.2_BraZ1	63.9	+	565	639	639	1.0000000
A10	18681032	18682731	A10p30670.2_BraZ1	854.7	+	1215	1632	1699	0.9605650
A10	18683417	18683984	A10p30680.2_BraZ1	480	+	277	567	567	1.0000000
A10	18685101	18686833	A10p30690.2_BraZ1	1134.74	+	986	1451	1732	0.8377598
A10	18687021	18688980	A10p30700.2_BraZ1	195.9	-	282	1387	1959	0.7080143
A10	18694461	18695919	A10p30710.2_BraZ1	635.5	-	989	1367	1458	0.9375857
A10	18697067	18698529	A10p30720.2_BraZ1	979.091	+	269	1287	1462	0.8803009
A10	18700880	18702148	A10p30730.2_BraZ1	862.909	+	616	1257	1268	0.9913249
A10	18707982	18710069	A10p30740.2_BraZ1	717.182	+	839	1860	2087	0.8912314
A10	18711881	18714356	A10p30750.2_BraZ1	1994.17	-	541	2184	2475	0.8824242
A10	18716180	18717486	A10p30760.2_BraZ1	386.629	+	1302	1306	1306	1.0000000
A10	18718577	18720659	A10p30770.2_BraZ1	1449	-	587	1027	2082	0.4932757
A10	18721840	18723430	A10p30780.2_BraZ1	636.632	-	22	120	1590	0.0754717
A10	18733465	18751266	A10p30790.2_BraZ1	990.723	+	4961	8889	17801	0.4993540
A10	18747150	18748801	A10p30800.2_BraZ1	606.583	-	19	61	1651	0.0369473
A10	18753893	18755273	A10p30810.2_BraZ1	370.938	-	658	1371	1380	0.9934782
A10	18757132	18765325	A10p30820.2_BraZ1	3237.1	+	1830	6393	8193	0.7803003
A10	18765855	18767471	A10p30830.2_BraZ1	888	-	796	1594	1616	0.9863861
A10	18767734	18771393	A10p30840.2_BraZ1	1241.76	+	2480	3659	3659	1.0000000
A10	18771761	18774527	A10p30850.2_BraZ1	999	+	1178	2624	2766	0.9486623
A10	18776752	18778243	A10p30860.2_BraZ1	1267.83	+	522	1491	1491	1.0000000
A10	18778752	18780593	A10p30870.2_BraZ1	1509	+	351	1501	1841	0.8153177
A10	18780759	18782598	A10p30880.2_BraZ1	183.9	+	487	1806	1839	0.9820555
A10	18788933	18794102	A10p30890.2_BraZ1	1756.25	+	1594	4721	5169	0.9133295
A10	18795117	18795538	A10p30900.2_BraZ1	327	-	208	421	421	1.0000000
A10	18796054	18797666	A10p30910.2_BraZ1	852.533	+	355	1144	1612	0.7096774
A10	18797728	18798506	A10p30920.2_BraZ1	307.8	+	138	603	778	0.7750643
A10	18798799	18799868	A10p30930.2_BraZ1	781.667	-	531	1069	1069	1.0000000
A10	18801651	18802260	A10p30940.2_BraZ1	60.9	-	100	246	609	0.4039409
A10	18804731	18805703	A10p30950.2_BraZ1	501.895	+	860	958	972	0.9855967
A10	18806594	18807323	A10p30960.2_BraZ1	72.9	+	87	597	729	0.8189300
A10	18807483	18811266	A10p30970.2_BraZ1	3216	-	710	3160	3783	0.8353159
A10	18814080	18816270	A10p30980.2_BraZ1	1237.5	+	858	2116	2190	0.9662101
A10	18817217	18817884	A10p30990.2_BraZ1	588	+	145	667	667	1.0000000
A10	18818828	18821241	A10p31000.2_BraZ1	1700.09	+	926	2413	2413	1.0000000
A10	18822856	18826210	A10p31010.2_BraZ1	3081	-	1714	3354	3354	1.0000000
A10	18827775	18829789	A10p31020.2_BraZ1	1374	-	808	1831	2014	0.9091361
A10	18832379	18832880	A10p31030.2_BraZ1	50.1	-	432	501	501	1.0000000
A10	18834457	18836010	A10p31040.2_BraZ1	481.025	-	762	1553	1553	1.0000000
A10	18836893	18837208	A10p31050.2_BraZ1	31.5	+	309	315	315	1.0000000
A10	18837388	18841848	A10p31060.2_BraZ1	2338.14	-	1327	4135	4460	0.9271300
A10	18842531	18843999	A10p31070.2_BraZ1	697.852	-	1564	1468	1468	1.0000000
A10	18845453	18845648	A10p31080.2_BraZ1	19.5	+	114	195	195	1.0000000
A10	18847808	18848594	A10p31090.2_BraZ1	78.6	+	60	630	786	0.8015267
A10	18849285	18850250	A10p31100.2_BraZ1	6342	+	627	899	965	0.9316062
A10	18850351	18850714	A10p31110.2_BraZ1	192	+	115	363	363	1.0000000
A10	18851293	18853549	A10p31120.2_BraZ1	1117.4	-	1746	2256	2256	1.0000000
A10	18855813	18855960	A10p31130.2_BraZ1	14.7	-	33	145	147	0.9863946
A10	18856615	18859964	A10p31140.2_BraZ1	602.1	+	1606	3187	3349	0.9516274
A10	18860740	18862313	A10p31150.2_BraZ1	812.213	-	965	1573	1573	1.0000000
A10	18863282	18863744	A10p31160.2_BraZ1	46.2	+	104	462	462	1.0000000
A10	18863930	18864823	A10p31170.2_BraZ1	460.75	-	896	893	893	1.0000000
A10	18869041	18869413	A10p31180.2_BraZ1	37.2	-	27	309	372	0.8306451
A10	18874718	18875297	A10p31190.2_BraZ1	228	+	695	579	579	1.0000000
A10	18876365	18876944	A10p31200.2_BraZ1	57.9	+	5	350	579	0.6044905
A10	18879151	18881164	A10p31210.2_BraZ1	474	-	1265	2013	2013	1.0000000
A10	18881277	18896413	A10p31220.2_BraZ1	511.875	+	1096	5063	15136	0.3345005
A10	18897021	18897365	A10p31230.2_BraZ1	192	-	141	344	344	1.0000000
A10	18899046	18899622	A10p31240.2_BraZ1	57.6	+	632	576	576	1.0000000
A10	18901174	18901588	A10p31250.2_BraZ1	318	-	291	414	414	1.0000000
A10	18902125	18904443	A10p31260.2_BraZ1	1168.86	+	1256	2303	2318	0.9935289
A10	18910888	18912739	A10p31270.2_BraZ1	9970.5	+	850	1747	1851	0.9438142
A10	18915091	18915858	A10p31280.2_BraZ1	482.16	-	444	767	767	1.0000000
A10	18916093	18920692	A10p31290.2_BraZ1	2337.55	-	2844	4462	4599	0.9702109
A10	18921302	18923477	A10p31300.2_BraZ1	1099.75	-	1715	2175	2175	1.0000000
A10	18923993	18925786	A10p31310.2_BraZ1	1588.56	-	337	1501	1793	0.8371444
A10	18928787	18931541	A10p31320.2_BraZ1	1089.06	+	1865	2722	2754	0.9883806
A10	18932274	18933086	A10p31330.2_BraZ1	457.875	+	528	698	812	0.8596059
A10	18933612	18934609	A10p31340.2_BraZ1	921	-	446	997	997	1.0000000
A10	18936597	18948537	A10p31350.2_BraZ1	3841.64	-	1751	7658	11940	0.6413735
A10	18954327	18954962	A10p31360.2_BraZ1	552	+	13	314	635	0.4944882
A10	18959918	18960748	A10p31370.2_BraZ1	771	+	222	803	830	0.9674699
A10	18964042	18965376	A10p31380.2_BraZ1	756.125	+	1460	1334	1334	1.0000000
A10	18965648	18970612	A10p31390.2_BraZ1	2190.65	-	3063	4448	4964	0.8960516
A10	18970848	18971767	A10p31400.2_BraZ1	788.333	+	972	919	919	1.0000000
A10	18972285	19002075	A10p31410.2_BraZ1	1813.13	+	18004	28163	29790	0.9453844
A10	18977062	18977731	A10p31420.2_BraZ1	66.9	+	701	669	669	1.0000000
A10	18977990	18981843	A10p31430.2_BraZ1	2037.89	-	1564	3397	3853	0.8816507
A10	18985827	18987129	A10p31440.2_BraZ1	396	+	636	994	1302	0.7634408
A10	18987523	18988074	A10p31450.2_BraZ1	45	-	397	551	551	1.0000000
A10	18993049	18995470	A10p31460.2_BraZ1	1565.57	-	1524	2322	2421	0.9591078
A10	19002598	19004535	A10p31470.2_BraZ1	1467	-	124	1120	1937	0.5782138
A10	19008180	19010220	A10p31480.2_BraZ1	1494	-	410	1485	2040	0.7279412
A10	19011938	19013805	A10p31490.2_BraZ1	1350	-	1529	1814	1867	0.9716122
A10	19016892	19018401	A10p31500.2_BraZ1	348	-	216	1383	1509	0.9165010
A10	19019682	19023614	A10p31510.2_BraZ1	2124	-	1632	3834	3932	0.9750763
A10	19025954	19027913	A10p31520.2_BraZ1	13650	-	1819	1959	1959	1.0000000
A10	19030334	19034770	A10p31530.2_BraZ1	1505	-	1047	3024	4436	0.6816952
A10	19035553	19037378	A10p31540.2_BraZ1	1422	-	543	1623	1825	0.8893151
A10	19038969	19042784	A10p31550.2_BraZ1	2705.14	-	200	1922	3815	0.5038008
A10	19043818	19046004	A10p31560.2_BraZ1	1480.57	+	363	1883	2186	0.8613907
A10	19048866	19051221	A10p31570.2_BraZ1	1300.29	+	349	1708	2355	0.7252654
A10	19051581	19052428	A10p31580.2_BraZ1	6000	-	538	847	847	1.0000000
A10	19053956	19055863	A10p31590.2_BraZ1	1011.98	+	1180	1856	1907	0.9732564
A10	19060158	19061364	A10p31600.2_BraZ1	120.6	-	177	1105	1206	0.9162521
A10	19062787	19065694	A10p31610.2_BraZ1	647.5	+	1749	2891	2907	0.9944960
A10	19067435	19068371	A10p31620.2_BraZ1	813	+	95	550	936	0.5876068
A10	19070388	19072586	A10p31630.2_BraZ1	898.909	-	1682	2002	2198	0.9108281
A10	19073534	19074226	A10p31640.2_BraZ1	579	-	268	426	692	0.6156070
A10	19078390	19079410	A10p31650.2_BraZ1	102	-	420	1020	1020	1.0000000
A10	19081588	19084508	A10p31660.2_BraZ1	1599.11	+	1227	2862	2920	0.9801370
A10	19085013	19086161	A10p31670.2_BraZ1	78.3	-	575	1148	1148	1.0000000
A10	19088034	19088562	A10p31680.2_BraZ1	310.5	-	954	528	528	1.0000000
A10	19089438	19090350	A10p31690.2_BraZ1	741	-	976	912	912	1.0000000
A10	19091625	19094483	A10p31700.2_BraZ1	1834.36	+	1881	2807	2858	0.9821554
A10	19102169	19106119	A10p31710.2_BraZ1	1552.04	+	1600	3655	3950	0.9253165
A10	19106485	19109955	A10p31720.2_BraZ1	990.161	-	1572	3202	3470	0.9227666
A10	19111024	19112346	A10p31730.2_BraZ1	647.345	+	298	1284	1322	0.9712557
A10	19113132	19117104	A10p31740.2_BraZ1	2534.78	+	958	3842	3972	0.9672709
A10	19117585	19119052	A10p31750.2_BraZ1	146.7	-	445	1467	1467	1.0000000
A10	19121105	19122489	A10p31760.2_BraZ1	614.55	+	600	1337	1384	0.9660405
A10	19122967	19129172	A10p31770.2_BraZ1	2898.52	-	1043	4497	6205	0.7247381
A10	19129834	19130741	A10p31780.2_BraZ1	75	+	957	907	907	1.0000000
A10	19131482	19133523	A10p31790.2_BraZ1	1376.06	-	1158	2019	2041	0.9892210
A10	19133903	19135796	A10p31800.2_BraZ1	1359	+	791	1804	1893	0.9529847
A10	19136226	19136781	A10p31810.2_BraZ1	55.5	-	159	555	555	1.0000000
A10	19137270	19146050	A10p31820.2_BraZ1	2084.17	-	7118	8668	8780	0.9872437
A10	19148036	19148651	A10p31830.2_BraZ1	61.5	-	46	506	615	0.8227642
A10	19151543	19152548	A10p31840.2_BraZ1	100.5	-	871	1005	1005	1.0000000
A10	19154536	19157182	A10p31850.2_BraZ1	264.6	+	26	107	2646	0.0404384
A10	19157924	19160201	A10p31860.2_BraZ1	1467.95	-	724	2064	2277	0.9064559
A10	19162485	19163178	A10p31870.2_BraZ1	69.3	-	194	693	693	1.0000000
A10	19163473	19164135	A10p31880.2_BraZ1	219	+	172	632	662	0.9546828
A10	19164513	19165533	A10p31890.2_BraZ1	247	-	282	812	1020	0.7960784
A10	19166056	19166833	A10p31900.2_BraZ1	483	-	95	544	777	0.7001287
A10	19167462	19167678	A10p31910.2_BraZ1	21.6	-	93	216	216	1.0000000
A10	19168556	19169926	A10p31920.2_BraZ1	130.5	-	737	1314	1370	0.9591241
A10	19174194	19174513	A10p31930.2_BraZ1	31.5	-	65	319	319	1.0000000
A10	19176182	19179538	A10p31940.2_BraZ1	793.568	+	2767	3253	3356	0.9693087
A10	19179885	19182705	A10p31950.2_BraZ1	1195.34	-	2607	2820	2820	1.0000000
A10	19183210	19183546	A10p31960.2_BraZ1	33.6	+	800	336	336	1.0000000
A10	19184123	19185312	A10p31970.2_BraZ1	788.211	-	807	1101	1189	0.9259882
A10	19187876	19188419	A10p31980.2_BraZ1	54.3	+	199	522	543	0.9613259
A10	19189155	19190154	A10p31990.2_BraZ1	559.143	-	814	999	999	1.0000000
A10	19191953	19193793	A10p32000.2_BraZ1	4208	+	469	1144	1840	0.6217391
A10	19194951	19195641	A10p32010.2_BraZ1	69	+	569	690	690	1.0000000
A10	19197462	19199518	A10p32020.2_BraZ1	1319.36	+	988	2056	2056	1.0000000
A10	19200007	19201689	A10p32030.2_BraZ1	1047.84	-	1684	1682	1682	1.0000000
A10	19202372	19202780	A10p32040.2_BraZ1	40.8	-	311	408	408	1.0000000
A10	19203324	19207595	A10p32050.2_BraZ1	1919.28	-	1257	4016	4271	0.9402950
A10	19208071	19210626	A10p32060.2_BraZ1	1288.8	+	332	1942	2555	0.7600783
A10	19210850	19212710	A10p32070.2_BraZ1	10944	-	609	1742	1860	0.9365591
A10	19215553	19216024	A10p32080.2_BraZ1	47.1	-	628	471	471	1.0000000
A10	19216371	19218324	A10p32090.2_BraZ1	1875	-	251	1599	1953	0.8187404
A10	19220933	19222840	A10p32100.2_BraZ1	1214.12	-	1158	1890	1907	0.9910855
A10	19226150	19228865	A10p32110.2_BraZ1	21649.5	-	566	2435	2715	0.8968692
A10	19231159	19231963	A10p32120.2_BraZ1	80.4	-	83	655	804	0.8146766
A10	19236128	19237287	A10p32130.2_BraZ1	735.115	+	160	565	1159	0.4874892
A10	19240892	19241199	A10p32140.2_BraZ1	177	-	68	307	307	1.0000000
A10	19244720	19246111	A10p32150.2_BraZ1	57.6	-	1216	1309	1391	0.9410496
A10	19249227	19249559	A10p32160.2_BraZ1	243	-	149	332	332	1.0000000
A10	19251989	19269503	A10p32170.2_BraZ1	1389.72	-	3699	8635	17514	0.4930342
A10	19258278	19263739	A10p32180.2_BraZ1	1856.55	+	459	1221	5461	0.2235854
A10	19264296	19264895	A10p32190.2_BraZ1	268	-	393	599	599	1.0000000
A10	19270229	19274113	A10p32200.2_BraZ1	2197.14	+	1521	3687	3884	0.9492791
A10	19275720	19276050	A10p32210.2_BraZ1	33	+	134	57	330	0.1727273
A10	19276983	19280678	A10p32220.2_BraZ1	1885.29	+	557	3310	3695	0.8958051
A10	19282105	19283367	A10p32230.2_BraZ1	933	+	481	1174	1262	0.9302694
A10	19284912	19289645	A10p32240.2_BraZ1	3339.6	+	1499	4536	4733	0.9583774
A10	19290004	19293909	A10p32250.2_BraZ1	3226.36	-	573	3376	3905	0.8645326
A10	19299214	19301251	A10p32260.2_BraZ1	1244.82	+	931	2024	2037	0.9936181
A10	19301565	19302566	A10p32270.2_BraZ1	630.333	-	312	997	1001	0.9960040
A10	19303059	19304613	A10p32280.2_BraZ1	155.4	+	176	1260	1554	0.8108108
A10	19304980	19310114	A10p32290.2_BraZ1	3171.27	-	926	4712	5134	0.9178029
A10	19310801	19311952	A10p32300.2_BraZ1	7000.5	-	349	848	1151	0.7367507
A10	19313460	19314079	A10p32310.2_BraZ1	745.5	+	106	499	619	0.8061389
A10	19317517	19319791	A10p32320.2_BraZ1	16461	-	1475	2148	2274	0.9445910
A10	19320751	19321386	A10p32330.2_BraZ1	381.333	-	0	0	635	0.0000000
A10	19322952	19333356	A10p32340.2_BraZ1	1009.26	-	5604	9781	10404	0.9401192
A10	19327053	19327843	A10p32350.2_BraZ1	7011	+	1251	790	790	1.0000000
A10	19328905	19329391	A10p32360.2_BraZ1	48.6	+	467	486	486	1.0000000
A10	19330151	19332491	A10p32370.2_BraZ1	1741.94	+	573	2060	2340	0.8803419
A10	19337630	19340417	A10p32380.2_BraZ1	2065.83	+	1367	2747	2787	0.9856477
A10	19344455	19345868	A10p32390.2_BraZ1	13320	+	1359	1413	1413	1.0000000
A10	19346530	19351397	A10p32400.2_BraZ1	1792.56	-	88	602	4867	0.1236902
A10	19352580	19352906	A10p32410.2_BraZ1	237	+	74	326	326	1.0000000
A10	19354499	19356484	A10p32420.2_BraZ1	3738	+	158	1303	1985	0.6564232
A10	19356985	19357302	A10p32430.2_BraZ1	228	-	146	317	317	1.0000000
A10	19366725	19367859	A10p32440.2_BraZ1	113.4	+	602	1134	1134	1.0000000
A10	19369237	19370783	A10p32450.2_BraZ1	952	-	607	1546	1546	1.0000000
A10	19373680	19375049	A10p32460.2_BraZ1	572.727	+	1341	1369	1369	1.0000000
A10	19377123	19377912	A10p32470.2_BraZ1	78.9	-	183	756	789	0.9581749
A10	19385458	19386661	A10p32480.2_BraZ1	786.462	+	1475	1203	1203	1.0000000
A10	19387108	19391241	A10p32490.2_BraZ1	2567.68	-	1267	3922	4133	0.9489475
A10	19391857	19392268	A10p32500.2_BraZ1	41.1	-	96	411	411	1.0000000
A10	19393663	19398270	A10p32510.2_BraZ1	1098.98	+	2870	4458	4607	0.9676579
A10	19398697	19401951	A10p32520.2_BraZ1	1733.22	-	1860	3237	3254	0.9947757
A10	19402316	19404627	A10p32530.2_BraZ1	1459.47	+	1305	2294	2311	0.9926439
A10	19405551	19406673	A10p32540.2_BraZ1	112.2	-	797	1122	1122	1.0000000
A10	19407067	19408573	A10p32550.2_BraZ1	150.6	-	571	1501	1506	0.9966800
A10	19409199	19411559	A10p32560.2_BraZ1	1326.45	-	974	2232	2360	0.9457627
A10	19411831	19413055	A10p32570.2_BraZ1	122.4	+	645	1224	1224	1.0000000
A10	19413190	19414617	A10p32580.2_BraZ1	551.314	-	1478	1385	1427	0.9705676
A10	19415215	19418059	A10p32590.2_BraZ1	1263.56	-	2048	2805	2844	0.9862869
A10	19420016	19427741	A10p32600.2_BraZ1	5340.78	-	3466	7390	7725	0.9566343
A10	19439024	19440731	A10p32610.2_BraZ1	3142.8	+	48	928	1707	0.5436438
A10	19443774	19445562	A10p32620.2_BraZ1	178.8	+	1671	1788	1788	1.0000000
A10	19446773	19451851	A10p32630.2_BraZ1	2339.42	+	2788	4937	5078	0.9722332
A10	19453933	19455325	A10p32640.2_BraZ1	139.2	+	1002	1392	1392	1.0000000
A10	19456475	19462800	A10p32650.2_BraZ1	1691.71	-	3683	5659	6325	0.8947036
A10	19464354	19466274	A10p32660.2_BraZ1	743.226	-	436	1595	1920	0.8307292
A10	19468483	19474065	A10p32670.2_BraZ1	2752.65	+	2320	5227	5582	0.9364027
A10	19477878	19478280	A10p32680.2_BraZ1	40.2	+	32	147	402	0.3656716
A10	19481560	19484824	A10p32690.2_BraZ1	2391.89	-	328	2995	3264	0.9175858
A10	19487944	19489410	A10p32700.2_BraZ1	842.682	-	1288	1466	1466	1.0000000
A10	19490673	19493857	A10p32710.2_BraZ1	753.778	+	1536	3024	3184	0.9497488
A10	19494664	19496645	A10p32720.2_BraZ1	477.5	+	2678	1981	1981	1.0000000
A10	19498487	19498661	A10p32730.2_BraZ1	17.4	-	393	174	174	1.0000000
A10	19502612	19504771	A10p32740.2_BraZ1	1474.71	-	842	2135	2159	0.9888837
A10	19505956	19506994	A10p32750.2_BraZ1	103.8	-	13	282	1038	0.2716763
A10	19510212	19516351	A10p32760.2_BraZ1	280.5	-	3653	6025	6139	0.9814302
A10	19516793	19518470	A10p32770.2_BraZ1	379.2	-	668	1516	1677	0.9039952
A10	19521597	19523586	A10p32780.2_BraZ1	825.3	-	488	1768	1989	0.8888889
A10	19526447	19533132	A10p32790.2_BraZ1	1937.13	-	3686	6516	6685	0.9747195
A10	19533038	19535700	A10p32800.2_BraZ1	908.437	-	1312	2573	2662	0.9665665
A10	19536283	19536670	A10p32810.2_BraZ1	38.7	-	166	387	387	1.0000000
A10	19538139	19538307	A10p32820.2_BraZ1	15.3	+	46	168	168	1.0000000
A10	19540447	19540843	A10p32830.2_BraZ1	39.6	-	120	396	396	1.0000000
A10	19542350	19544767	A10p32840.2_BraZ1	630	-	1634	2417	2417	1.0000000
A10	19545514	19545928	A10p32850.2_BraZ1	41.4	-	161	414	414	1.0000000
A10	19547090	19551255	A10p32860.2_BraZ1	705	+	2654	4165	4165	1.0000000
A10	19548582	19554501	A10p32870.2_BraZ1	676.875	-	6429	5917	5919	0.9996621
A10	19551478	19553082	A10p32880.2_BraZ1	243	-	2346	1604	1604	1.0000000
A10	19572953	19579155	A10p32890.2_BraZ1	429	-	8972	6202	6202	1.0000000
A10	19574082	19574669	A10p32900.2_BraZ1	195	+	1485	587	587	1.0000000
A10	19575512	19577030	A10p32910.2_BraZ1	957	-	3352	1518	1518	1.0000000
A10	19580850	19581120	A10p32920.2_BraZ1	27	-	616	270	270	1.0000000
A10	19585535	19589490	A10p32930.2_BraZ1	1674.4	-	1181	3530	3955	0.8925411
A10	19591562	19595849	A10p32940.2_BraZ1	1279.69	+	2075	4187	4287	0.9766737
A10	19596544	19603097	A10p32950.2_BraZ1	3885.43	-	3496	5685	6553	0.8675416
A10	19613118	19614912	A10p32960.2_BraZ1	806	+	1807	1794	1794	1.0000000
A10	19615200	19616165	A10p32970.2_BraZ1	410.182	+	1221	965	965	1.0000000
A10	19616557	19618319	A10p32980.2_BraZ1	851.036	-	2267	1762	1762	1.0000000
A10	19619716	19623989	A10p32990.2_BraZ1	2984.23	-	2427	4200	4273	0.9829160
A10	19627004	19629734	A10p33000.2_BraZ1	1485.85	+	2413	2702	2730	0.9897436
A10	19630137	19631112	A10p33010.2_BraZ1	97.5	-	377	966	975	0.9907692
A10	19631774	19632983	A10p33020.2_BraZ1	120.9	-	216	1087	1209	0.8990902
A10	19634385	19635930	A10p33030.2_BraZ1	774.341	+	280	1087	1545	0.7035599
A10	19637314	19639119	A10p33040.2_BraZ1	10889.6	-	777	1805	1805	1.0000000
A10	19640268	19642006	A10p33050.2_BraZ1	99.6	+	1279	1738	1738	1.0000000
A10	19643472	19644549	A10p33060.2_BraZ1	107.7	-	955	1077	1077	1.0000000
A10	19645037	19652680	A10p33070.2_BraZ1	4689.72	-	1092	6105	7643	0.7987701
A10	19654319	19655644	A10p33080.2_BraZ1	699	-	273	616	1325	0.4649056
A10	19662506	19665304	A10p33090.2_BraZ1	1418.73	+	225	2323	2798	0.8302359
A10	19666701	19666934	A10p33100.2_BraZ1	153	-	24	233	233	1.0000000
A10	19667827	19667938	A10p33110.2_BraZ1	11.1	+	33	98	111	0.8828829
A10	19668436	19668835	A10p33120.2_BraZ1	198	-	90	240	399	0.6015037
A10	19669795	19674418	A10p33130.2_BraZ1	2415.03	-	3012	4523	4623	0.9783690
A10	19675350	19677606	A10p33140.2_BraZ1	225.6	-	699	1797	2256	0.7965425
A10	19678736	19678966	A10p33150.2_BraZ1	219	-	277	230	230	1.0000000
A10	19679780	19682496	A10p33160.2_BraZ1	439.773	-	1984	2703	2716	0.9952136
A10	19683445	19686643	A10p33170.2_BraZ1	2356.77	-	1416	3180	3198	0.9943715
A10	19688124	19688370	A10p33180.2_BraZ1	24.6	+	355	246	246	1.0000000
A10	19690641	19695152	A10p33190.2_BraZ1	33300	+	2221	4390	4511	0.9731767
A10	19696562	19698991	A10p33200.2_BraZ1	924.75	+	1437	2222	2429	0.9147797
A10	19700692	19702326	A10p33210.2_BraZ1	98.4	-	1533	1634	1634	1.0000000
A10	19705103	19706207	A10p33220.2_BraZ1	110.4	+	517	1104	1104	1.0000000
A10	19706273	19708772	A10p33230.2_BraZ1	1416	+	1182	2487	2499	0.9951981
A10	19709982	19710570	A10p33240.2_BraZ1	378	+	356	588	588	1.0000000
A10	19713309	19714780	A10p33250.2_BraZ1	1169.16	+	776	1471	1471	1.0000000
A10	19715464	19715776	A10p33260.2_BraZ1	186	-	346	312	312	1.0000000
A10	19719687	19722681	A10p33270.2_BraZ1	1580.62	+	2079	2885	2994	0.9635938
A10	19723332	19726155	A10p33280.2_BraZ1	1794.13	+	1343	2781	2823	0.9851222
A10	19726437	19727592	A10p33290.2_BraZ1	477.357	-	979	1155	1155	1.0000000
A10	19728405	19731244	A10p33300.2_BraZ1	1432.75	-	1641	2676	2839	0.9425854
A10	19731950	19732466	A10p33310.2_BraZ1	51.6	-	51	403	516	0.7810078
A10	19735276	19737458	A10p33320.2_BraZ1	935.424	+	1030	2182	2182	1.0000000
A10	19738897	19740334	A10p33330.2_BraZ1	1062	+	510	1045	1437	0.7272094
A10	19741279	19741770	A10p33340.2_BraZ1	291	+	469	491	491	1.0000000
A10	19744892	19745958	A10p33350.2_BraZ1	537	+	61	837	1066	0.7851782
A10	19750804	19753173	A10p33360.2_BraZ1	1460.36	+	1164	2001	2369	0.8446602
A10	19762293	19763680	A10p33370.2_BraZ1	7276.5	-	101	502	1387	0.3619322
A10	19763764	19765013	A10p33380.2_BraZ1	234	+	1425	952	1249	0.7622098
A10	19765085	19765436	A10p33390.2_BraZ1	24	+	388	351	351	1.0000000
A10	19771861	19774310	A10p33400.2_BraZ1	1165.5	-	1348	2283	2449	0.9322172
A10	19779912	19784197	A10p33410.2_BraZ1	1390.8	+	2312	3925	4285	0.9159860
A10	19788176	19789596	A10p33420.2_BraZ1	928.65	-	880	1420	1420	1.0000000
A10	19795098	19799697	A10p33430.2_BraZ1	2183.84	+	2025	4269	4599	0.9282452
A10	19801091	19802830	A10p33440.2_BraZ1	9894	+	1092	1340	1739	0.7705578
A10	19803468	19804308	A10p33450.2_BraZ1	300	-	305	840	840	1.0000000
A10	19808823	19810272	A10p33460.2_BraZ1	144.9	+	184	1219	1449	0.8412699
A10	19810853	19812261	A10p33470.2_BraZ1	1080	+	174	1293	1408	0.9183239
A10	19815006	19817849	A10p33480.2_BraZ1	16302	-	578	2055	2843	0.7228280
A10	19826856	19830175	A10p33490.2_BraZ1	1140.75	-	1167	3047	3319	0.9180476
A10	19836663	19838107	A10p33500.2_BraZ1	552.261	-	1110	1444	1444	1.0000000
A10	19839115	19844981	A10p33510.2_BraZ1	2324.45	-	3175	5609	5866	0.9561882
A10	19845944	19848995	A10p33520.2_BraZ1	25564.5	-	1029	2450	3051	0.8030154
A10	19851899	19852492	A10p33530.2_BraZ1	117	-	902	593	593	1.0000000
A10	19854620	19858437	A10p33540.2_BraZ1	1717.16	-	2967	3817	3817	1.0000000
A10	19863730	19864994	A10p33550.2_BraZ1	633	+	927	1264	1264	1.0000000
A10	19865619	19866417	A10p33560.2_BraZ1	79.8	-	173	622	798	0.7794486
A10	19869933	19870905	A10p33570.2_BraZ1	97.2	-	1014	972	972	1.0000000
A10	19871668	19872415	A10p33580.2_BraZ1	249.205	-	678	747	747	1.0000000
A10	19873795	19874507	A10p33590.2_BraZ1	282.182	+	1046	712	712	1.0000000
A10	19875590	19879042	A10p33600.2_BraZ1	1412.5	+	1806	3447	3452	0.9985515
A10	19879523	19884829	A10p33610.2_BraZ1	1839.93	-	4500	5301	5306	0.9990577
A10	19885464	19887014	A10p33620.2_BraZ1	971.579	+	1334	1525	1550	0.9838710
A10	19890998	19895221	A10p33630.2_BraZ1	1844.33	-	2207	3670	4223	0.8690504
A10	19901187	19902962	A10p33640.2_BraZ1	998.214	-	2244	1775	1775	1.0000000
A10	19906251	19906575	A10p33650.2_BraZ1	32.4	+	547	324	324	1.0000000
A10	19906830	19909298	A10p33660.2_BraZ1	992.25	-	1608	2359	2468	0.9558347
A10	19909951	19911609	A10p33670.2_BraZ1	1074.67	-	991	1658	1658	1.0000000
A10	19912493	19916977	A10p33680.2_BraZ1	3812.75	-	742	3362	4484	0.7497770
A10	19919119	19919302	A10p33690.2_BraZ1	18.3	+	39	183	183	1.0000000
A10	19922462	19924833	A10p33700.2_BraZ1	1576.64	+	480	1962	2371	0.8274990
A10	19925150	19932929	A10p33710.2_BraZ1	1657.61	-	62941	7766	7779	0.9983288
A10	19938663	19939194	A10p33720.2_BraZ1	53.1	-	99	476	531	0.8964218
A10	19940107	19944787	A10p33730.2_BraZ1	352.882	+	1388	4140	4680	0.8846154
A10	19947926	19949164	A10p33740.2_BraZ1	419.143	+	833	1043	1238	0.8424879
A10	19949993	19951088	A10p33750.2_BraZ1	507	+	674	1047	1095	0.9561644
A10	19954520	19955002	A10p33760.2_BraZ1	309	+	667	482	482	1.0000000
A10	19955049	19955517	A10p33770.2_BraZ1	222	+	665	468	468	1.0000000
A10	19956033	19958268	A10p33780.2_BraZ1	1347.22	-	809	2000	2235	0.8948546
A10	19960081	19962877	A10p33790.2_BraZ1	1292.5	-	756	2528	2796	0.9041488
A10	19968280	19968961	A10p33800.2_BraZ1	68.1	-	86	542	681	0.7958884
A10	19970648	19971805	A10p33810.2_BraZ1	728.64	+	153	1067	1157	0.9222126
A10	19973118	19979850	A10p33820.2_BraZ1	1232.25	+	3669	6698	6732	0.9949495
A10	19980650	19981199	A10p33830.2_BraZ1	327	+	350	549	549	1.0000000
A10	19981654	19983800	A10p33840.2_BraZ1	1485.68	-	841	1941	2146	0.9044734
A10	19984888	19985505	A10p33850.2_BraZ1	445.552	+	396	617	617	1.0000000
A10	19985965	19987710	A10p33860.2_BraZ1	1405.27	-	681	1745	1745	1.0000000
A10	19990564	19991903	A10p33870.2_BraZ1	1107	+	365	1227	1339	0.9163555
A10	19992315	19993852	A10p33880.2_BraZ1	1221	-	477	1537	1537	1.0000000
A10	19994581	19998445	A10p33890.2_BraZ1	1226.63	-	2988	3864	3864	1.0000000
A10	19998759	20002628	A10p33900.2_BraZ1	2527.06	+	1515	3637	3869	0.9400362
A10	20002899	20004333	A10p33910.2_BraZ1	1290	-	481	1383	1434	0.9644352
A10	20005484	20008365	A10p33920.2_BraZ1	1694.3	+	972	2859	2881	0.9923638
A10	20013576	20013882	A10p33930.2_BraZ1	30.6	-	358	306	306	1.0000000
A10	20015561	20017817	A10p33940.2_BraZ1	225.6	+	806	2193	2256	0.9720744
A10	20019914	20020863	A10p33950.2_BraZ1	766.333	+	561	949	949	1.0000000
A10	20022111	20023454	A10p33960.2_BraZ1	750.75	-	161	1296	1343	0.9650037
A10	20029125	20029974	A10p33970.2_BraZ1	84.9	-	117	573	849	0.6749117
A10	20031607	20033074	A10p33980.2_BraZ1	670.371	-	1223	1467	1467	1.0000000
A10	20033395	20033956	A10p33990.2_BraZ1	56.1	-	50	365	561	0.6506239
A10	20034526	20035626	A10p34000.2_BraZ1	862.75	+	622	801	1100	0.7281818
A10	20035840	20036810	A10p34010.2_BraZ1	468.878	-	979	970	970	1.0000000
A10	20040537	20041026	A10p34020.2_BraZ1	48.9	+	375	489	489	1.0000000
A10	20043238	20045312	A10p34030.2_BraZ1	10276.5	-	796	1996	2074	0.9623915
A10	20046946	20048355	A10p34040.2_BraZ1	3927	-	1208	1409	1409	1.0000000
A10	20048435	20049655	A10p34050.2_BraZ1	1035	+	810	1161	1220	0.9516394
A10	20051928	20052455	A10p34060.2_BraZ1	276	-	431	527	527	1.0000000
A10	20058247	20060709	A10p34070.2_BraZ1	919.652	-	1639	2323	2462	0.9435418
A10	20072806	20074005	A10p34080.2_BraZ1	618.545	+	1044	1199	1199	1.0000000
A10	20074359	20077148	A10p34090.2_BraZ1	621.704	+	1203	2727	2789	0.9777698
A10	20078733	20080995	A10p34100.2_BraZ1	75816	-	366	2063	2262	0.9120247
A10	20083635	20083740	A10p34110.2_BraZ1	10.5	+	201	105	105	1.0000000
A10	20086223	20088469	A10p34120.2_BraZ1	77640	+	343	1968	2246	0.8762244
A10	20089480	20091037	A10p34130.2_BraZ1	155.7	-	641	1514	1557	0.9723828
A10	20094931	20096705	A10p34140.2_BraZ1	782.694	+	1771	1664	1774	0.9379932
A10	20098468	20099890	A10p34150.2_BraZ1	1074	+	425	1294	1422	0.9099860
A10	20103860	20105726	A10p34160.2_BraZ1	1247	-	783	1853	1866	0.9930332
A10	20108451	20108778	A10p34170.2_BraZ1	32.7	-	340	327	327	1.0000000
A10	20110205	20114110	A10p34180.2_BraZ1	1298.68	-	334	1334	3905	0.3416133
A10	20115811	20117507	A10p34190.2_BraZ1	896	+	120	626	1696	0.3691038
A10	20117898	20118293	A10p34200.2_BraZ1	95	-	169	363	395	0.9189873
A10	20118861	20120757	A10p34210.2_BraZ1	682.5	-	742	1848	1896	0.9746835
A10	20122613	20123908	A10p34220.2_BraZ1	879	-	13	531	1295	0.4100386
A10	20125706	20128539	A10p34230.2_BraZ1	804	+	1664	2205	2833	0.7783269
A10	20137141	20137748	A10p34240.2_BraZ1	456	-	27	210	607	0.3459637
A10	20141427	20143794	A10p34250.2_BraZ1	2228.73	-	1112	2160	2367	0.9125475
A10	20145817	20149103	A10p34260.2_BraZ1	2529	+	1798	3042	3286	0.9257456
A10	20153226	20153622	A10p34270.2_BraZ1	2916	+	120	396	396	1.0000000
A10	20154008	20157149	A10p34280.2_BraZ1	1799	-	2868	2972	3141	0.9461955
A10	20157972	20158436	A10p34290.2_BraZ1	258	-	541	464	464	1.0000000
A10	20160259	20162663	A10p34300.2_BraZ1	1296.39	+	2226	2187	2404	0.9097338
A10	20163135	20171876	A10p34310.2_BraZ1	5734.8	-	806	5964	8741	0.6823018
A10	20175244	20176898	A10p34320.2_BraZ1	1173	+	757	1544	1654	0.9334946
A10	20177175	20177997	A10p34330.2_BraZ1	5538	-	490	793	822	0.9647202
A10	20178220	20180099	A10p34340.2_BraZ1	924.677	+	861	1878	1879	0.9994678
A10	20181866	20183723	A10p34350.2_BraZ1	777	-	1303	1592	1857	0.8572967
A10	20186628	20190672	A10p34360.2_BraZ1	2403	-	1186	2980	4044	0.7368942
A10	20191019	20192422	A10p34370.2_BraZ1	762	-	746	1337	1403	0.9529579
A10	20193379	20194758	A10p34380.2_BraZ1	730.6	-	732	1365	1379	0.9898477
A10	20209379	20209601	A10p34390.2_BraZ1	22.2	+	64	208	222	0.9369369
A10	20210108	20211085	A10p34400.2_BraZ1	61.2	-	468	685	977	0.7011259
A10	20212412	20215072	A10p34410.2_BraZ1	1630.3	-	1881	2435	2660	0.9154136
A10	20216271	20216891	A10p34420.2_BraZ1	396	-	358	620	620	1.0000000
A10	20217164	20217998	A10p34430.2_BraZ1	747	-	282	683	834	0.8189449
A10	20220426	20222647	A10p34440.2_BraZ1	1147.11	+	1233	2105	2221	0.9477713
A10	20223239	20224779	A10p34450.2_BraZ1	1013.16	-	963	1475	1540	0.9577922
A10	20226663	20228854	A10p34460.2_BraZ1	1225.8	-	1132	2187	2191	0.9981744
A10	20230117	20230708	A10p34470.2_BraZ1	59.1	-	829	591	591	1.0000000
A10	20231900	20232155	A10p34480.2_BraZ1	25.5	+	321	255	255	1.0000000
A10	20232856	20234465	A10p34490.2_BraZ1	776.669	-	1181	1438	1609	0.8937228
A10	20236120	20241039	A10p34500.2_BraZ1	2437.36	+	743	4249	4919	0.8637934
A10	20243759	20247311	A10p34510.2_BraZ1	1707.64	-	531	2288	3552	0.6441441
A10	20255037	20256260	A10p34520.2_BraZ1	365.962	+	1211	1054	1223	0.8618152
A10	20257136	20259368	A10p34530.2_BraZ1	1619.25	-	585	1370	2232	0.6137993
A10	20266354	20268687	A10p34540.2_BraZ1	2201.43	+	2124	2086	2333	0.8941277
A10	20269072	20269366	A10p34550.2_BraZ1	29.4	-	122	249	294	0.8469388
A10	20270040	20272414	A10p34560.2_BraZ1	1371.72	+	1125	2354	2374	0.9915754
A10	20273819	20274142	A10p34570.2_BraZ1	267	-	144	323	323	1.0000000
A10	20281334	20284115	A10p34580.2_BraZ1	1764.29	-	2066	2610	2781	0.9385113
A10	20290283	20292002	A10p34590.2_BraZ1	1453.73	+	882	1476	1719	0.8586388
A10	20292701	20296242	A10p34600.2_BraZ1	2671.5	+	2811	2935	3541	0.8288619
A10	20296618	20296747	A10p34610.2_BraZ1	12.9	+	163	129	129	1.0000000
A10	20298969	20300550	A10p34620.2_BraZ1	158.1	+	1387	1553	1581	0.9822897
A10	20300952	20303505	A10p34630.2_BraZ1	1239.27	-	368	2204	2553	0.8632981
A10	20305874	20306285	A10p34640.2_BraZ1	41.1	+	0	0	411	0.0000000
A10	20307966	20309327	A10p34650.2_BraZ1	124.8	+	124	310	1361	0.2277737
A10	20310130	20312858	A10p34660.2_BraZ1	746.182	-	1048	2567	2728	0.9409824
A10	20314914	20315430	A10p34670.2_BraZ1	45.6	+	105	470	516	0.9108527
A10	20317952	20335187	A10p34680.2_BraZ1	1378.97	-	2238	10851	17235	0.6295909
A10	20326984	20330532	A10p34690.2_BraZ1	1323.43	+	113	1017	3548	0.2866403
A10	20335513	20338098	A10p34700.2_BraZ1	1632.23	+	507	2316	2585	0.8959381
A10	20338788	20339439	A10p34710.2_BraZ1	237	+	44	486	651	0.7465438
A10	20339774	20340410	A10p34720.2_BraZ1	405	-	262	591	636	0.9292453
A10	20340894	20341189	A10p34730.2_BraZ1	18.6	-	26	236	295	0.8000000
A10	20354091	20359197	A10p34740.2_BraZ1	1181.74	+	1566	3947	5106	0.7730122
A10	20359908	20361022	A10p34750.2_BraZ1	513	+	73	824	1114	0.7396768
A10	20363198	20367056	A10p34760.2_BraZ1	1360.64	-	712	2302	3858	0.5966822
A10	20374605	20376120	A10p34770.2_BraZ1	1040.75	-	27	745	1515	0.4917492
A10	20377363	20379172	A10p34780.2_BraZ1	748.364	+	158	1016	1809	0.5616363
A10	20379478	20381057	A10p34790.2_BraZ1	590.7	-	4	131	1579	0.0829639
A10	20381970	20382509	A10p34800.2_BraZ1	243.6	-	0	0	539	0.0000000
